time,subj_course_id,sec_code,sec_id,prof,available,waitlist,total,enrolled_ct
1745782717501,AESE 279B,A00,891859,Staff,13,0,35,22
1745782718526,AIP 197,001,891854,Staff,70,0,70,0
1745782719554,ANTH 289S,A00,891856,Gagneux; Pascal,12,0,12,0
1745782720579,BENG 196,001,957946,Engler; Adam J.,9996,0,9999,3
1745782721607,CAT 124RS,A01,956906,Staff,8,0,25,17
1745782722639,CAT 125RS,A01,922013,Staff,8,0,25,17
1745782723675,CLRE 250,A00,891860,Morris; Sheldon,9995,0,9999,4
1745782725732,CLRE 251R,A00,907817,Mehta; Ravindra L.,9994,0,9999,5
1745782726760,CLRE 252,A00,891864,Cuomo; Raphael Eduardo,9993,0,9999,6
1745782727785,CLRE 253,A00,891867,Vaida; Florin,9994,0,9999,5
1745782727785,CLRE 253,B00,907819,Staff,9999,0,9999,0
1745782728814,CLRE 259,A00,891868,Patel; Hemal,9998,0,9999,1
1745782729842,CLRE 260,A00,891872,Cuomo; Raphael Eduardo,9999,0,9999,0
1745782730870,CLRE 297,001,891888,Cuomo; Raphael Eduardo,9999,0,9999,0
1745782731898,CSE 191,A00,958773,Minnes Kemp; Mor Mia,9999,0,9999,0
1745782732925,CSS 201S,A01,892054,Mignozzetti; Umberto,30,0,30,0
1745782733953,CSS 202S,A01,892056,Mignozzetti; Umberto,30,0,30,0
1745782734979,DSC 197,001,956898,Eldridge; Justin Matthew,9998,0,9999,1
1745782736004,DSC 297,001,958000,Mazumdar; Arya,9998,0,9999,1
1745782737030,EAP 100,A00,905686,Staff,9776,0,9999,223
1745782738055,ECE 45,A01,892618,Staff,0,12,50,50
1745782739083,ECE 109,A01,892620,Staff,0,43,0,0
1745782740109,ECE 111,A01,892719,Staff,0,7,50,50
1745782741138,ECE 197,001,957920,Mercier; Patrick Philip,9992,0,9999,7
1745782742171,ECON 178,A01,907814,Zhu; Ying,28,0,35,7
1745782743213,EDS 115,A00,895312,Staff,41,0,45,4
1745782744243,EDS 117,A01,895337,Staff,30,0,30,0
1745782745272,EDS 125,A00,895341,Jones; Gabrielle Anastasia,43,0,45,2
1745782746320,EDS 128A,A01,895459,Fargason; Sharon Gayle,44,0,45,1
1745782747344,EDS 128B,A01,895543,Pappas; Elizabeth,44,0,45,1
1745782748373,EDS 139,A00,897203,Pappas; Elizabeth,44,0,45,1
1745782748373,EDS 139,B00,897209,Fargason; Sharon Gayle,44,0,45,1
1745782749399,EDS 201,A00,895545,Staff,43,0,45,2
1745782750430,EDS 203,A01,895581,Halter; Christopher P.,43,0,45,2
1745782751459,EDS 204R,A01,895625,Heinzman; Erica M.,44,0,45,1
1745782751459,EDS 204R,B01,895693,Halter; Christopher P.,18,0,45,27
1745782752489,EDS 206R,A00,895694,Fargason; Sharon Gayle,9,0,30,21
1745782752489,EDS 206R,B00,895695,Choi; Bailey Miyeon,20,0,30,10
1745782753517,EDS 250,A00,895697,Hemans; Patricia Ann Benitez,43,0,45,2
1745782754546,EDS 281,A00,895701,Meyerott; Theresa Ann,15,0,15,0
1745782755573,EDS 284,A00,895736,Meyerott; Theresa Ann,15,0,15,0
1745782756599,EDS 286,A00,897210,Fine; Sarah,15,0,15,0
1745782757629,EDS 289C,A01,895770,Daly; Alan J.,15,0,15,0
1745782758655,EDS 290,A00,897211,Hofstetter; Carolyn,15,0,15,0
1745782759685,LIGM 5A,A00,896162,Fischer-Grunski; Eva K,15,0,20,5
1745782760712,LIGM 5B,A00,896260,Fischer-Grunski; Eva K,17,0,20,3
1745782761738,LIGM 5C,A00,896308,Fischer-Grunski; Eva K,18,0,20,2
1745782762769,LIIT 5AS,A00,896313,Carnelos; Chiara,18,0,20,2
1745782763801,LIIT 5BS,A00,896416,Carnelos; Chiara,20,0,20,0
1745782764831,LIIT 5CS,A00,896564,Carnelos; Chiara,20,0,20,0
1745782765858,LISP 5A,A00,896588,Munoz Sanchez; Alicia,4,0,20,16
1745782766887,LISP 5B,A00,896653,Munoz Sanchez; Alicia,10,0,20,10
1745782767919,LISP 5C,A00,896655,Munoz Sanchez; Alicia,4,0,20,16
1745782768948,MAE 197,001,957918,Kleissl; Jan,9998,0,9999,1
1745782769979,MATH 2,A01,957937,Staff,34,0,35,1
1745782771008,MATH 197,001,957876,Kedlaya; Kiran S.,9993,0,9999,6
1745782772037,MCWP 40,A00,892729,Duru; Nur,13,0,20,7
1745782772037,MCWP 40,B00,893304,Montejo; Carolina,20,0,20,0
1745782773065,MCWP 40R,A00,893757,Redela; Pamela Morgan,0,6,20,20
1745782774095,MCWP 50,A00,893758,Morshed; Michael James,2,0,20,18
1745782774095,MCWP 50,B00,893761,Bartulis; Jason Michael,17,0,20,3
1745782775129,MCWP 50R,A00,893766,Compas; Sean Matthew,0,1,20,20
1745782775129,MCWP 50R,B00,893769,Carter; Jennifer A,0,0,20,20
1745782775129,MCWP 50R,C00,893771,Krone; Jarret,0,3,20,20
1745782775129,MCWP 50R,D00,893772,Miller; Elizabeth Deen,3,0,20,17
1745782775129,MCWP 50R,E00,893775,Carter; Andrea L,0,0,20,20
1745782776157,MMW 11R,A01,892721,Herbst; Matthew,11,0,27,16
1745782776157,MMW 11R,A02,892722,Herbst; Matthew,0,0,0,3
1745782777187,MMW 12R,A01,892724,Herbst; Matthew,0,9,16,16
1745782777187,MMW 12R,A02,892725,Herbst; Matthew,0,9,16,16
1745782778217,MMW 13R,A01,892727,Staff,0,3,16,16
1745782778217,MMW 13R,A02,892728,Staff,0,4,16,16
1745782778217,MMW 13R,A03,958032,Staff,0,3,16,16
1745782778217,MMW 13R,A04,958033,Staff,0,2,16,16
1745782778217,MMW 13R,A05,958034,Staff,0,3,16,16
1745782779250,SIO 295LS,A00,894015,Staff,7,0,25,18
1745782780281,SIO 295S,A00,894020,Staff,7,0,25,18
1745782781311,SIOC 290S,B01,958918,Staff,0,0,0,0
1745782782339,SIOC 291S,B01,958922,Staff,0,0,0,0
1745782783368,SOCI 117,A01,895339,Staff,4,0,5,1
1745782784394,WES 237B,A00,894149,Staff,11,0,20,9
1745782786461,AESE 279B,A00,891859,Staff,13,0,35,22
1745782787487,AIP 197,001,891854,Staff,70,0,70,0
1745782788516,ANTH 289S,A00,891856,Gagneux; Pascal,12,0,12,0
1745782789540,BENG 196,001,957946,Engler; Adam J.,9996,0,9999,3
1745782790569,CAT 124RS,A01,956906,Staff,8,0,25,17
1745782791599,CAT 125RS,A01,922013,Staff,8,0,25,17
1745782792623,CLRE 250,A00,891860,Morris; Sheldon,9995,0,9999,4
1745782794678,CLRE 251R,A00,907817,Mehta; Ravindra L.,9994,0,9999,5
1745782795705,CLRE 252,A00,891864,Cuomo; Raphael Eduardo,9993,0,9999,6
1745782796732,CLRE 253,A00,891867,Vaida; Florin,9994,0,9999,5
1745782796732,CLRE 253,B00,907819,Staff,9999,0,9999,0
1745782797765,CLRE 259,A00,891868,Patel; Hemal,9998,0,9999,1
1745782798792,CLRE 260,A00,891872,Cuomo; Raphael Eduardo,9999,0,9999,0
1745782799820,CLRE 297,001,891888,Cuomo; Raphael Eduardo,9999,0,9999,0
1745782800848,CSE 191,A00,958773,Minnes Kemp; Mor Mia,9999,0,9999,0
1745782801882,CSS 201S,A01,892054,Mignozzetti; Umberto,30,0,30,0
1745782802938,CSS 202S,A01,892056,Mignozzetti; Umberto,30,0,30,0
1745782803968,DSC 197,001,956898,Eldridge; Justin Matthew,9998,0,9999,1
1745782804995,DSC 297,001,958000,Mazumdar; Arya,9998,0,9999,1
1745782806020,EAP 100,A00,905686,Staff,9776,0,9999,223
1745782807047,ECE 45,A01,892618,Staff,0,12,50,50
1745782808075,ECE 109,A01,892620,Staff,0,43,0,0
1745782809101,ECE 111,A01,892719,Staff,0,7,50,50
1745782810126,ECE 197,001,957920,Mercier; Patrick Philip,9992,0,9999,7
1745782811152,ECON 178,A01,907814,Zhu; Ying,28,0,35,7
1745782812177,EDS 115,A00,895312,Staff,41,0,45,4
1745782813205,EDS 117,A01,895337,Staff,30,0,30,0
1745782814232,EDS 125,A00,895341,Jones; Gabrielle Anastasia,43,0,45,2
1745782815259,EDS 128A,A01,895459,Fargason; Sharon Gayle,44,0,45,1
1745782816288,EDS 128B,A01,895543,Pappas; Elizabeth,44,0,45,1
1745782817319,EDS 139,A00,897203,Pappas; Elizabeth,44,0,45,1
1745782817319,EDS 139,B00,897209,Fargason; Sharon Gayle,44,0,45,1
1745782818347,EDS 201,A00,895545,Staff,43,0,45,2
1745782819378,EDS 203,A01,895581,Halter; Christopher P.,43,0,45,2
1745782820406,EDS 204R,A01,895625,Heinzman; Erica M.,44,0,45,1
1745782820406,EDS 204R,B01,895693,Halter; Christopher P.,18,0,45,27
1745782821434,EDS 206R,A00,895694,Fargason; Sharon Gayle,9,0,30,21
1745782821434,EDS 206R,B00,895695,Choi; Bailey Miyeon,20,0,30,10
1745782822461,EDS 250,A00,895697,Hemans; Patricia Ann Benitez,43,0,45,2
1745782823487,EDS 281,A00,895701,Meyerott; Theresa Ann,15,0,15,0
1745782824514,EDS 284,A00,895736,Meyerott; Theresa Ann,15,0,15,0
1745782825543,EDS 286,A00,897210,Fine; Sarah,15,0,15,0
1745782826573,EDS 289C,A01,895770,Daly; Alan J.,15,0,15,0
1745782827599,EDS 290,A00,897211,Hofstetter; Carolyn,15,0,15,0
1745782828625,LIGM 5A,A00,896162,Fischer-Grunski; Eva K,15,0,20,5
1745782829653,LIGM 5B,A00,896260,Fischer-Grunski; Eva K,17,0,20,3
1745782830682,LIGM 5C,A00,896308,Fischer-Grunski; Eva K,18,0,20,2
1745782831709,LIIT 5AS,A00,896313,Carnelos; Chiara,18,0,20,2
1745782832736,LIIT 5BS,A00,896416,Carnelos; Chiara,20,0,20,0
1745782833764,LIIT 5CS,A00,896564,Carnelos; Chiara,20,0,20,0
1745782834791,LISP 5A,A00,896588,Munoz Sanchez; Alicia,4,0,20,16
1745782835823,LISP 5B,A00,896653,Munoz Sanchez; Alicia,10,0,20,10
1745782836851,LISP 5C,A00,896655,Munoz Sanchez; Alicia,4,0,20,16
1745782837881,MAE 197,001,957918,Kleissl; Jan,9998,0,9999,1
1745782838911,MATH 2,A01,957937,Staff,34,0,35,1
1745782839939,MATH 197,001,957876,Kedlaya; Kiran S.,9993,0,9999,6
1745782840966,MCWP 40,A00,892729,Duru; Nur,13,0,20,7
1745782840966,MCWP 40,B00,893304,Montejo; Carolina,20,0,20,0
1745782841993,MCWP 40R,A00,893757,Redela; Pamela Morgan,0,6,20,20
1745782843021,MCWP 50,A00,893758,Morshed; Michael James,2,0,20,18
1745782843021,MCWP 50,B00,893761,Bartulis; Jason Michael,17,0,20,3
1745782844046,MCWP 50R,A00,893766,Compas; Sean Matthew,0,1,20,20
1745782844046,MCWP 50R,B00,893769,Carter; Jennifer A,0,0,20,20
1745782844046,MCWP 50R,C00,893771,Krone; Jarret,0,3,20,20
1745782844046,MCWP 50R,D00,893772,Miller; Elizabeth Deen,3,0,20,17
1745782844046,MCWP 50R,E00,893775,Carter; Andrea L,0,0,20,20
1745782845074,MMW 11R,A01,892721,Herbst; Matthew,11,0,27,16
1745782845074,MMW 11R,A02,892722,Herbst; Matthew,0,0,0,3
1745782846101,MMW 12R,A01,892724,Herbst; Matthew,0,9,16,16
1745782846101,MMW 12R,A02,892725,Herbst; Matthew,0,9,16,16
1745782847130,MMW 13R,A01,892727,Staff,0,3,16,16
1745782847130,MMW 13R,A02,892728,Staff,0,4,16,16
1745782847130,MMW 13R,A03,958032,Staff,0,3,16,16
1745782847130,MMW 13R,A04,958033,Staff,0,2,16,16
1745782847130,MMW 13R,A05,958034,Staff,0,3,16,16
1745782848159,SIO 295LS,A00,894015,Staff,7,0,25,18
1745782849189,SIO 295S,A00,894020,Staff,7,0,25,18
1745782850220,SIOC 290S,B01,958918,Staff,0,0,0,0
1745782851251,SIOC 291S,B01,958922,Staff,0,0,0,0
1745782852277,SOCI 117,A01,895339,Staff,4,0,5,1
1745782853305,WES 237B,A00,894149,Staff,11,0,20,9
1745782855366,AESE 279B,A00,891859,Staff,13,0,35,22
1745782856396,AIP 197,001,891854,Staff,70,0,70,0
1745782857422,ANTH 289S,A00,891856,Gagneux; Pascal,12,0,12,0
1745782858451,BENG 196,001,957946,Engler; Adam J.,9996,0,9999,3
1745782859480,CAT 124RS,A01,956906,Staff,8,0,25,17
1745782860506,CAT 125RS,A01,922013,Staff,8,0,25,17
1745782861535,CLRE 250,A00,891860,Morris; Sheldon,9995,0,9999,4
1745782863592,CLRE 251R,A00,907817,Mehta; Ravindra L.,9994,0,9999,5
1745782864620,CLRE 252,A00,891864,Cuomo; Raphael Eduardo,9993,0,9999,6
1745782865646,CLRE 253,A00,891867,Vaida; Florin,9994,0,9999,5
1745782865646,CLRE 253,B00,907819,Staff,9999,0,9999,0
1745782866671,CLRE 259,A00,891868,Patel; Hemal,9998,0,9999,1
1745782867700,CLRE 260,A00,891872,Cuomo; Raphael Eduardo,9999,0,9999,0
1745782868726,CLRE 297,001,891888,Cuomo; Raphael Eduardo,9999,0,9999,0
1745782869755,CSE 191,A00,958773,Minnes Kemp; Mor Mia,9999,0,9999,0
1745782870784,CSS 201S,A01,892054,Mignozzetti; Umberto,30,0,30,0
1745782871814,CSS 202S,A01,892056,Mignozzetti; Umberto,30,0,30,0
1745782872840,DSC 197,001,956898,Eldridge; Justin Matthew,9998,0,9999,1
1745782873867,DSC 297,001,958000,Mazumdar; Arya,9998,0,9999,1
1745782874896,EAP 100,A00,905686,Staff,9776,0,9999,223
1745782875923,ECE 45,A01,892618,Staff,0,12,50,50
1745782876950,ECE 109,A01,892620,Staff,0,43,0,0
1745782877977,ECE 111,A01,892719,Staff,0,7,50,50
1745782879005,ECE 197,001,957920,Mercier; Patrick Philip,9992,0,9999,7
1745782880032,ECON 178,A01,907814,Zhu; Ying,28,0,35,7
1745782881059,EDS 115,A00,895312,Staff,41,0,45,4
1745782882089,EDS 117,A01,895337,Staff,30,0,30,0
1745782883116,EDS 125,A00,895341,Jones; Gabrielle Anastasia,43,0,45,2
1745782884145,EDS 128A,A01,895459,Fargason; Sharon Gayle,44,0,45,1
1745782885178,EDS 128B,A01,895543,Pappas; Elizabeth,44,0,45,1
1745782886208,EDS 139,A00,897203,Pappas; Elizabeth,44,0,45,1
1745782886208,EDS 139,B00,897209,Fargason; Sharon Gayle,44,0,45,1
1745782887240,EDS 201,A00,895545,Staff,43,0,45,2
1745782888269,EDS 203,A01,895581,Halter; Christopher P.,43,0,45,2
1745782889296,EDS 204R,A01,895625,Heinzman; Erica M.,44,0,45,1
1745782889296,EDS 204R,B01,895693,Halter; Christopher P.,18,0,45,27
1745782890324,EDS 206R,A00,895694,Fargason; Sharon Gayle,9,0,30,21
1745782890324,EDS 206R,B00,895695,Choi; Bailey Miyeon,20,0,30,10
1745782891353,EDS 250,A00,895697,Hemans; Patricia Ann Benitez,43,0,45,2
1745782892393,EDS 281,A00,895701,Meyerott; Theresa Ann,15,0,15,0
1745782893421,EDS 284,A00,895736,Meyerott; Theresa Ann,15,0,15,0
1745782894449,EDS 286,A00,897210,Fine; Sarah,15,0,15,0
1745782895474,EDS 289C,A01,895770,Daly; Alan J.,15,0,15,0
1745782896502,EDS 290,A00,897211,Hofstetter; Carolyn,15,0,15,0
1745782897528,LIGM 5A,A00,896162,Fischer-Grunski; Eva K,15,0,20,5
1745782898555,LIGM 5B,A00,896260,Fischer-Grunski; Eva K,17,0,20,3
1745782899586,LIGM 5C,A00,896308,Fischer-Grunski; Eva K,18,0,20,2
1745782900615,LIIT 5AS,A00,896313,Carnelos; Chiara,18,0,20,2
1745782901640,LIIT 5BS,A00,896416,Carnelos; Chiara,20,0,20,0
1745782902669,LIIT 5CS,A00,896564,Carnelos; Chiara,20,0,20,0
1745782903695,LISP 5A,A00,896588,Munoz Sanchez; Alicia,4,0,20,16
1745782904722,LISP 5B,A00,896653,Munoz Sanchez; Alicia,10,0,20,10
1745782905749,LISP 5C,A00,896655,Munoz Sanchez; Alicia,4,0,20,16
1745782906776,MAE 197,001,957918,Kleissl; Jan,9998,0,9999,1
1745782907804,MATH 2,A01,957937,Staff,34,0,35,1
1745782908833,MATH 197,001,957876,Kedlaya; Kiran S.,9993,0,9999,6
1745782909863,MCWP 40,A00,892729,Duru; Nur,13,0,20,7
1745782909863,MCWP 40,B00,893304,Montejo; Carolina,20,0,20,0
1745782910915,MCWP 40R,A00,893757,Redela; Pamela Morgan,0,6,20,20
1745782911944,MCWP 50,A00,893758,Morshed; Michael James,2,0,20,18
1745782911944,MCWP 50,B00,893761,Bartulis; Jason Michael,17,0,20,3
1745782912974,MCWP 50R,A00,893766,Compas; Sean Matthew,0,1,20,20
1745782912974,MCWP 50R,B00,893769,Carter; Jennifer A,0,0,20,20
1745782912974,MCWP 50R,C00,893771,Krone; Jarret,0,3,20,20
1745782912974,MCWP 50R,D00,893772,Miller; Elizabeth Deen,3,0,20,17
1745782912974,MCWP 50R,E00,893775,Carter; Andrea L,0,0,20,20
1745782913998,MMW 11R,A01,892721,Herbst; Matthew,11,0,27,16
1745782913998,MMW 11R,A02,892722,Herbst; Matthew,0,0,0,3
1745782915025,MMW 12R,A01,892724,Herbst; Matthew,0,9,16,16
1745782915025,MMW 12R,A02,892725,Herbst; Matthew,0,9,16,16
1745782916055,MMW 13R,A01,892727,Staff,0,3,16,16
1745782916055,MMW 13R,A02,892728,Staff,0,4,16,16
1745782916055,MMW 13R,A03,958032,Staff,0,3,16,16
1745782916055,MMW 13R,A04,958033,Staff,0,2,16,16
1745782916055,MMW 13R,A05,958034,Staff,0,3,16,16
1745782917079,SIO 295LS,A00,894015,Staff,7,0,25,18
1745782918104,SIO 295S,A00,894020,Staff,7,0,25,18
1745782919144,SIOC 290S,B01,958918,Staff,0,0,0,0
1745782920169,SIOC 291S,B01,958922,Staff,0,0,0,0
1745782921196,SOCI 117,A01,895339,Staff,4,0,5,1
1745782922221,WES 237B,A00,894149,Staff,11,0,20,9
1745782924278,AESE 279B,A00,891859,Staff,13,0,35,22
1745782925305,AIP 197,001,891854,Staff,70,0,70,0
1745782926330,ANTH 289S,A00,891856,Gagneux; Pascal,12,0,12,0
1745782927357,BENG 196,001,957946,Engler; Adam J.,9996,0,9999,3
1745782928388,CAT 124RS,A01,956906,Staff,8,0,25,17
1745782929414,CAT 125RS,A01,922013,Staff,8,0,25,17
1745782930441,CLRE 250,A00,891860,Morris; Sheldon,9995,0,9999,4
1745782932498,CLRE 251R,A00,907817,Mehta; Ravindra L.,9994,0,9999,5
1745782933527,CLRE 252,A00,891864,Cuomo; Raphael Eduardo,9993,0,9999,6
1745782934553,CLRE 253,A00,891867,Vaida; Florin,9994,0,9999,5
1745782934553,CLRE 253,B00,907819,Staff,9999,0,9999,0
1745782935579,CLRE 259,A00,891868,Patel; Hemal,9998,0,9999,1
1745782936608,CLRE 260,A00,891872,Cuomo; Raphael Eduardo,9999,0,9999,0
1745782937631,CLRE 297,001,891888,Cuomo; Raphael Eduardo,9999,0,9999,0
1745782938661,CSE 191,A00,958773,Minnes Kemp; Mor Mia,9999,0,9999,0
1745782939687,CSS 201S,A01,892054,Mignozzetti; Umberto,30,0,30,0
1745782940718,CSS 202S,A01,892056,Mignozzetti; Umberto,30,0,30,0
1745782941762,DSC 197,001,956898,Eldridge; Justin Matthew,9998,0,9999,1
1745782942792,DSC 297,001,958000,Mazumdar; Arya,9998,0,9999,1
1745782943818,EAP 100,A00,905686,Staff,9776,0,9999,223
1745782944844,ECE 45,A01,892618,Staff,0,12,50,50
1745782945870,ECE 109,A01,892620,Staff,0,43,0,0
1745782946896,ECE 111,A01,892719,Staff,0,7,50,50
1745782947923,ECE 197,001,957920,Mercier; Patrick Philip,9992,0,9999,7
1745782948949,ECON 178,A01,907814,Zhu; Ying,28,0,35,7
1745782949976,EDS 115,A00,895312,Staff,41,0,45,4
1745782951002,EDS 117,A01,895337,Staff,30,0,30,0
1745782952028,EDS 125,A00,895341,Jones; Gabrielle Anastasia,43,0,45,2
1745782953055,EDS 128A,A01,895459,Fargason; Sharon Gayle,44,0,45,1
1745782954085,EDS 128B,A01,895543,Pappas; Elizabeth,44,0,45,1
1745782955112,EDS 139,A00,897203,Pappas; Elizabeth,44,0,45,1
1745782955112,EDS 139,B00,897209,Fargason; Sharon Gayle,44,0,45,1
1745782956141,EDS 201,A00,895545,Staff,43,0,45,2
1745782957169,EDS 203,A01,895581,Halter; Christopher P.,43,0,45,2
1745782958197,EDS 204R,A01,895625,Heinzman; Erica M.,44,0,45,1
1745782958197,EDS 204R,B01,895693,Halter; Christopher P.,18,0,45,27
1745782959223,EDS 206R,A00,895694,Fargason; Sharon Gayle,9,0,30,21
1745782959223,EDS 206R,B00,895695,Choi; Bailey Miyeon,20,0,30,10
1745782960251,EDS 250,A00,895697,Hemans; Patricia Ann Benitez,43,0,45,2
1745782961278,EDS 281,A00,895701,Meyerott; Theresa Ann,15,0,15,0
1745782962303,EDS 284,A00,895736,Meyerott; Theresa Ann,15,0,15,0
1745782963329,EDS 286,A00,897210,Fine; Sarah,15,0,15,0
1745782964355,EDS 289C,A01,895770,Daly; Alan J.,15,0,15,0
1745782965383,EDS 290,A00,897211,Hofstetter; Carolyn,15,0,15,0
1745782966412,LIGM 5A,A00,896162,Fischer-Grunski; Eva K,15,0,20,5
1745782967439,LIGM 5B,A00,896260,Fischer-Grunski; Eva K,17,0,20,3
1745782968468,LIGM 5C,A00,896308,Fischer-Grunski; Eva K,18,0,20,2
1745782969491,LIIT 5AS,A00,896313,Carnelos; Chiara,18,0,20,2
1745782970519,LIIT 5BS,A00,896416,Carnelos; Chiara,20,0,20,0
1745782971548,LIIT 5CS,A00,896564,Carnelos; Chiara,20,0,20,0
1745782972573,LISP 5A,A00,896588,Munoz Sanchez; Alicia,4,0,20,16
1745782973601,LISP 5B,A00,896653,Munoz Sanchez; Alicia,10,0,20,10
1745782974632,LISP 5C,A00,896655,Munoz Sanchez; Alicia,4,0,20,16
1745782975660,MAE 197,001,957918,Kleissl; Jan,9998,0,9999,1
1745782976685,MATH 2,A01,957937,Staff,34,0,35,1
1745782977714,MATH 197,001,957876,Kedlaya; Kiran S.,9993,0,9999,6
1745782978742,MCWP 40,A00,892729,Duru; Nur,13,0,20,7
1745782978742,MCWP 40,B00,893304,Montejo; Carolina,20,0,20,0
1745782979771,MCWP 40R,A00,893757,Redela; Pamela Morgan,0,6,20,20
1745782980796,MCWP 50,A00,893758,Morshed; Michael James,2,0,20,18
1745782980796,MCWP 50,B00,893761,Bartulis; Jason Michael,17,0,20,3
1745782981823,MCWP 50R,A00,893766,Compas; Sean Matthew,0,1,20,20
1745782981823,MCWP 50R,B00,893769,Carter; Jennifer A,0,0,20,20
1745782981823,MCWP 50R,C00,893771,Krone; Jarret,0,3,20,20
1745782981823,MCWP 50R,D00,893772,Miller; Elizabeth Deen,3,0,20,17
1745782981823,MCWP 50R,E00,893775,Carter; Andrea L,0,0,20,20
1745782982849,MMW 11R,A01,892721,Herbst; Matthew,11,0,27,16
1745782982849,MMW 11R,A02,892722,Herbst; Matthew,0,0,0,3
1745782983881,MMW 12R,A01,892724,Herbst; Matthew,0,9,16,16
1745782983881,MMW 12R,A02,892725,Herbst; Matthew,0,9,16,16
1745782984909,MMW 13R,A01,892727,Staff,0,3,16,16
1745782984909,MMW 13R,A02,892728,Staff,0,4,16,16
1745782984909,MMW 13R,A03,958032,Staff,0,3,16,16
1745782984909,MMW 13R,A04,958033,Staff,0,2,16,16
1745782984909,MMW 13R,A05,958034,Staff,0,3,16,16
1745782985940,SIO 295LS,A00,894015,Staff,7,0,25,18
1745782986971,SIO 295S,A00,894020,Staff,7,0,25,18
1745782988002,SIOC 290S,B01,958918,Staff,0,0,0,0
1745782989032,SIOC 291S,B01,958922,Staff,0,0,0,0
1745782990059,SOCI 117,A01,895339,Staff,4,0,5,1
1745782991088,WES 237B,A00,894149,Staff,11,0,20,9
1745782993151,AESE 279B,A00,891859,Staff,13,0,35,22
1745782994177,AIP 197,001,891854,Staff,70,0,70,0
1745782995203,ANTH 289S,A00,891856,Gagneux; Pascal,12,0,12,0
1745782996229,BENG 196,001,957946,Engler; Adam J.,9996,0,9999,3
1745782997258,CAT 124RS,A01,956906,Staff,8,0,25,17
1745782998286,CAT 125RS,A01,922013,Staff,8,0,25,17
1745782999314,CLRE 250,A00,891860,Morris; Sheldon,9995,0,9999,4
1745783001369,CLRE 251R,A00,907817,Mehta; Ravindra L.,9994,0,9999,5
1745783002398,CLRE 252,A00,891864,Cuomo; Raphael Eduardo,9993,0,9999,6
1745783003425,CLRE 253,A00,891867,Vaida; Florin,9994,0,9999,5
1745783003425,CLRE 253,B00,907819,Staff,9999,0,9999,0
1745783004454,CLRE 259,A00,891868,Patel; Hemal,9998,0,9999,1
1745783005479,CLRE 260,A00,891872,Cuomo; Raphael Eduardo,9999,0,9999,0
1745783006507,CLRE 297,001,891888,Cuomo; Raphael Eduardo,9999,0,9999,0
1745783007534,CSE 191,A00,958773,Minnes Kemp; Mor Mia,9999,0,9999,0
1745783008565,CSS 201S,A01,892054,Mignozzetti; Umberto,30,0,30,0
1745783009593,CSS 202S,A01,892056,Mignozzetti; Umberto,30,0,30,0
1745783010621,DSC 197,001,956898,Eldridge; Justin Matthew,9998,0,9999,1
1745783011646,DSC 297,001,958000,Mazumdar; Arya,9998,0,9999,1
1745783012674,EAP 100,A00,905686,Staff,9776,0,9999,223
1745783013701,ECE 45,A01,892618,Staff,0,12,50,50
1745783014727,ECE 109,A01,892620,Staff,0,43,0,0
1745783015754,ECE 111,A01,892719,Staff,0,7,50,50
1745783016783,ECE 197,001,957920,Mercier; Patrick Philip,9992,0,9999,7
1745783017814,ECON 178,A01,907814,Zhu; Ying,28,0,35,7
1745783018845,EDS 115,A00,895312,Staff,41,0,45,4
1745783019873,EDS 117,A01,895337,Staff,30,0,30,0
1745783020904,EDS 125,A00,895341,Jones; Gabrielle Anastasia,43,0,45,2
1745783021931,EDS 128A,A01,895459,Fargason; Sharon Gayle,44,0,45,1
1745783022958,EDS 128B,A01,895543,Pappas; Elizabeth,44,0,45,1
1745783023986,EDS 139,A00,897203,Pappas; Elizabeth,44,0,45,1
1745783023986,EDS 139,B00,897209,Fargason; Sharon Gayle,44,0,45,1
1745783025013,EDS 201,A00,895545,Staff,43,0,45,2
1745783026039,EDS 203,A01,895581,Halter; Christopher P.,43,0,45,2
1745783027068,EDS 204R,A01,895625,Heinzman; Erica M.,44,0,45,1
1745783027068,EDS 204R,B01,895693,Halter; Christopher P.,18,0,45,27
1745783028100,EDS 206R,A00,895694,Fargason; Sharon Gayle,9,0,30,21
1745783028100,EDS 206R,B00,895695,Choi; Bailey Miyeon,20,0,30,10
1745783029126,EDS 250,A00,895697,Hemans; Patricia Ann Benitez,43,0,45,2
1745783030156,EDS 281,A00,895701,Meyerott; Theresa Ann,15,0,15,0
1745783031184,EDS 284,A00,895736,Meyerott; Theresa Ann,15,0,15,0
1745783032211,EDS 286,A00,897210,Fine; Sarah,15,0,15,0
1745783033241,EDS 289C,A01,895770,Daly; Alan J.,15,0,15,0
1745783034270,EDS 290,A00,897211,Hofstetter; Carolyn,15,0,15,0
1745783035296,LIGM 5A,A00,896162,Fischer-Grunski; Eva K,15,0,20,5
1745783036332,LIGM 5B,A00,896260,Fischer-Grunski; Eva K,17,0,20,3
1745783037360,LIGM 5C,A00,896308,Fischer-Grunski; Eva K,18,0,20,2
1745783038390,LIIT 5AS,A00,896313,Carnelos; Chiara,18,0,20,2
1745783039418,LIIT 5BS,A00,896416,Carnelos; Chiara,20,0,20,0
1745783040449,LIIT 5CS,A00,896564,Carnelos; Chiara,20,0,20,0
1745783041481,LISP 5A,A00,896588,Munoz Sanchez; Alicia,4,0,20,16
1745783042510,LISP 5B,A00,896653,Munoz Sanchez; Alicia,10,0,20,10
1745783043538,LISP 5C,A00,896655,Munoz Sanchez; Alicia,4,0,20,16
1745783044568,MAE 197,001,957918,Kleissl; Jan,9998,0,9999,1
1745783045597,MATH 2,A01,957937,Staff,34,0,35,1
1745783046623,MATH 197,001,957876,Kedlaya; Kiran S.,9993,0,9999,6
1745783047653,MCWP 40,A00,892729,Duru; Nur,13,0,20,7
1745783047653,MCWP 40,B00,893304,Montejo; Carolina,20,0,20,0
1745783048682,MCWP 40R,A00,893757,Redela; Pamela Morgan,0,6,20,20
1745783049709,MCWP 50,A00,893758,Morshed; Michael James,2,0,20,18
1745783049709,MCWP 50,B00,893761,Bartulis; Jason Michael,17,0,20,3
1745783050741,MCWP 50R,A00,893766,Compas; Sean Matthew,0,1,20,20
1745783050741,MCWP 50R,B00,893769,Carter; Jennifer A,0,0,20,20
1745783050741,MCWP 50R,C00,893771,Krone; Jarret,0,3,20,20
1745783050741,MCWP 50R,D00,893772,Miller; Elizabeth Deen,3,0,20,17
1745783050741,MCWP 50R,E00,893775,Carter; Andrea L,0,0,20,20
1745783051768,MMW 11R,A01,892721,Herbst; Matthew,11,0,27,16
1745783051768,MMW 11R,A02,892722,Herbst; Matthew,0,0,0,3
1745783052794,MMW 12R,A01,892724,Herbst; Matthew,0,9,16,16
1745783052794,MMW 12R,A02,892725,Herbst; Matthew,0,9,16,16
1745783053826,MMW 13R,A01,892727,Staff,0,3,16,16
1745783053826,MMW 13R,A02,892728,Staff,0,4,16,16
1745783053826,MMW 13R,A03,958032,Staff,0,3,16,16
1745783053826,MMW 13R,A04,958033,Staff,0,2,16,16
1745783053826,MMW 13R,A05,958034,Staff,0,3,16,16
1745783054856,SIO 295LS,A00,894015,Staff,7,0,25,18
1745783055882,SIO 295S,A00,894020,Staff,7,0,25,18
1745783056913,SIOC 290S,B01,958918,Staff,0,0,0,0
1745783057945,SIOC 291S,B01,958922,Staff,0,0,0,0
1745783058973,SOCI 117,A01,895339,Staff,4,0,5,1
1745783060004,WES 237B,A00,894149,Staff,11,0,20,9
1745783062068,AESE 279B,A00,891859,Staff,13,0,35,22
1745783063092,AIP 197,001,891854,Staff,70,0,70,0
1745783064118,ANTH 289S,A00,891856,Gagneux; Pascal,12,0,12,0
1745783065149,BENG 196,001,957946,Engler; Adam J.,9996,0,9999,3
1745783066175,CAT 124RS,A01,956906,Staff,8,0,25,17
1745783067204,CAT 125RS,A01,922013,Staff,8,0,25,17
1745783068235,CLRE 250,A00,891860,Morris; Sheldon,9995,0,9999,4
1745783070294,CLRE 251R,A00,907817,Mehta; Ravindra L.,9994,0,9999,5
1745783071319,CLRE 252,A00,891864,Cuomo; Raphael Eduardo,9993,0,9999,6
1745783072349,CLRE 253,A00,891867,Vaida; Florin,9994,0,9999,5
1745783072349,CLRE 253,B00,907819,Staff,9999,0,9999,0
1745783073377,CLRE 259,A00,891868,Patel; Hemal,9998,0,9999,1
1745783074404,CLRE 260,A00,891872,Cuomo; Raphael Eduardo,9999,0,9999,0
1745783075431,CLRE 297,001,891888,Cuomo; Raphael Eduardo,9999,0,9999,0
1745783076463,CSE 191,A00,958773,Minnes Kemp; Mor Mia,9999,0,9999,0
1745783077490,CSS 201S,A01,892054,Mignozzetti; Umberto,30,0,30,0
1745783078521,CSS 202S,A01,892056,Mignozzetti; Umberto,30,0,30,0
1745783079546,DSC 197,001,956898,Eldridge; Justin Matthew,9998,0,9999,1
1745783080572,DSC 297,001,958000,Mazumdar; Arya,9998,0,9999,1
1745783081600,EAP 100,A00,905686,Staff,9776,0,9999,223
1745783082627,ECE 45,A01,892618,Staff,0,12,50,50
1745783083658,ECE 109,A01,892620,Staff,0,43,0,0
1745783084684,ECE 111,A01,892719,Staff,0,7,50,50
1745783085712,ECE 197,001,957920,Mercier; Patrick Philip,9992,0,9999,7
1745783086740,ECON 178,A01,907814,Zhu; Ying,28,0,35,7
1745783087770,EDS 115,A00,895312,Staff,41,0,45,4
1745783088797,EDS 117,A01,895337,Staff,30,0,30,0
1745783089823,EDS 125,A00,895341,Jones; Gabrielle Anastasia,43,0,45,2
1745783090851,EDS 128A,A01,895459,Fargason; Sharon Gayle,44,0,45,1
1745783091883,EDS 128B,A01,895543,Pappas; Elizabeth,44,0,45,1
1745783092910,EDS 139,A00,897203,Pappas; Elizabeth,44,0,45,1
1745783092910,EDS 139,B00,897209,Fargason; Sharon Gayle,44,0,45,1
1745783093937,EDS 201,A00,895545,Staff,43,0,45,2
1745783094965,EDS 203,A01,895581,Halter; Christopher P.,43,0,45,2
1745783095996,EDS 204R,A01,895625,Heinzman; Erica M.,44,0,45,1
1745783095996,EDS 204R,B01,895693,Halter; Christopher P.,18,0,45,27
1745783097022,EDS 206R,A00,895694,Fargason; Sharon Gayle,9,0,30,21
1745783097022,EDS 206R,B00,895695,Choi; Bailey Miyeon,20,0,30,10
1745783098050,EDS 250,A00,895697,Hemans; Patricia Ann Benitez,43,0,45,2
1745783099080,EDS 281,A00,895701,Meyerott; Theresa Ann,15,0,15,0
1745783100106,EDS 284,A00,895736,Meyerott; Theresa Ann,15,0,15,0
1745783101135,EDS 286,A00,897210,Fine; Sarah,15,0,15,0
1745783102170,EDS 289C,A01,895770,Daly; Alan J.,15,0,15,0
1745783103200,EDS 290,A00,897211,Hofstetter; Carolyn,15,0,15,0
1745783104228,LIGM 5A,A00,896162,Fischer-Grunski; Eva K,15,0,20,5
1745783105255,LIGM 5B,A00,896260,Fischer-Grunski; Eva K,17,0,20,3
1745783106285,LIGM 5C,A00,896308,Fischer-Grunski; Eva K,18,0,20,2
1745783107313,LIIT 5AS,A00,896313,Carnelos; Chiara,18,0,20,2
1745783108338,LIIT 5BS,A00,896416,Carnelos; Chiara,20,0,20,0
1745783109366,LIIT 5CS,A00,896564,Carnelos; Chiara,20,0,20,0
1745783110392,LISP 5A,A00,896588,Munoz Sanchez; Alicia,4,0,20,16
1745783111419,LISP 5B,A00,896653,Munoz Sanchez; Alicia,10,0,20,10
1745783112449,LISP 5C,A00,896655,Munoz Sanchez; Alicia,4,0,20,16
1745783113477,MAE 197,001,957918,Kleissl; Jan,9998,0,9999,1
1745783114504,MATH 2,A01,957937,Staff,34,0,35,1
1745783115537,MATH 197,001,957876,Kedlaya; Kiran S.,9993,0,9999,6
1745783116566,MCWP 40,A00,892729,Duru; Nur,13,0,20,7
1745783116566,MCWP 40,B00,893304,Montejo; Carolina,20,0,20,0
1745783117617,MCWP 40R,A00,893757,Redela; Pamela Morgan,0,6,20,20
1745783118646,MCWP 50,A00,893758,Morshed; Michael James,2,0,20,18
1745783118646,MCWP 50,B00,893761,Bartulis; Jason Michael,17,0,20,3
1745783119671,MCWP 50R,A00,893766,Compas; Sean Matthew,0,1,20,20
1745783119671,MCWP 50R,B00,893769,Carter; Jennifer A,0,0,20,20
1745783119671,MCWP 50R,C00,893771,Krone; Jarret,0,3,20,20
1745783119671,MCWP 50R,D00,893772,Miller; Elizabeth Deen,3,0,20,17
1745783119671,MCWP 50R,E00,893775,Carter; Andrea L,0,0,20,20
1745783120699,MMW 11R,A01,892721,Herbst; Matthew,11,0,27,16
1745783120699,MMW 11R,A02,892722,Herbst; Matthew,0,0,0,3
1745783121728,MMW 12R,A01,892724,Herbst; Matthew,0,9,16,16
1745783121728,MMW 12R,A02,892725,Herbst; Matthew,0,9,16,16
1745783122758,MMW 13R,A01,892727,Staff,0,3,16,16
1745783122758,MMW 13R,A02,892728,Staff,0,4,16,16
1745783122758,MMW 13R,A03,958032,Staff,0,3,16,16
1745783122758,MMW 13R,A04,958033,Staff,0,2,16,16
1745783122758,MMW 13R,A05,958034,Staff,0,3,16,16
1745783123788,SIO 295LS,A00,894015,Staff,7,0,25,18
1745783124813,SIO 295S,A00,894020,Staff,7,0,25,18
1745783125838,SIOC 290S,B01,958918,Staff,0,0,0,0
1745783126863,SIOC 291S,B01,958922,Staff,0,0,0,0
1745783127888,SOCI 117,A01,895339,Staff,4,0,5,1
1745783128914,WES 237B,A00,894149,Staff,11,0,20,9
1745783130970,AESE 279B,A00,891859,Staff,13,0,35,22
1745783131995,AIP 197,001,891854,Staff,70,0,70,0
1745783133020,ANTH 289S,A00,891856,Gagneux; Pascal,12,0,12,0
1745783134047,BENG 196,001,957946,Engler; Adam J.,9996,0,9999,3
1745783135077,CAT 124RS,A01,956906,Staff,8,0,25,17
1745783136104,CAT 125RS,A01,922013,Staff,8,0,25,17
1745783137128,CLRE 250,A00,891860,Morris; Sheldon,9995,0,9999,4
1745783139180,CLRE 251R,A00,907817,Mehta; Ravindra L.,9994,0,9999,5
1745783140209,CLRE 252,A00,891864,Cuomo; Raphael Eduardo,9993,0,9999,6
1745783141234,CLRE 253,A00,891867,Vaida; Florin,9994,0,9999,5
1745783141234,CLRE 253,B00,907819,Staff,9999,0,9999,0
1745783142262,CLRE 259,A00,891868,Patel; Hemal,9998,0,9999,1
1745783143286,CLRE 260,A00,891872,Cuomo; Raphael Eduardo,9999,0,9999,0
1745783144316,CLRE 297,001,891888,Cuomo; Raphael Eduardo,9999,0,9999,0
1745783145346,CSE 191,A00,958773,Minnes Kemp; Mor Mia,9999,0,9999,0
1745783146417,CSS 201S,A01,892054,Mignozzetti; Umberto,30,0,30,0
1745783147442,CSS 202S,A01,892056,Mignozzetti; Umberto,30,0,30,0
1745783148470,DSC 197,001,956898,Eldridge; Justin Matthew,9998,0,9999,1
1745783149495,DSC 297,001,958000,Mazumdar; Arya,9998,0,9999,1
1745783150521,EAP 100,A00,905686,Staff,9776,0,9999,223
1745783151549,ECE 45,A01,892618,Staff,0,12,50,50
1745783152576,ECE 109,A01,892620,Staff,0,43,0,0
1745783153601,ECE 111,A01,892719,Staff,0,7,50,50
1745783154628,ECE 197,001,957920,Mercier; Patrick Philip,9992,0,9999,7
1745783155654,ECON 178,A01,907814,Zhu; Ying,28,0,35,7
1745783156679,EDS 115,A00,895312,Staff,41,0,45,4
1745783157704,EDS 117,A01,895337,Staff,30,0,30,0
1745783158728,EDS 125,A00,895341,Jones; Gabrielle Anastasia,43,0,45,2
1745783159754,EDS 128A,A01,895459,Fargason; Sharon Gayle,44,0,45,1
1745783160782,EDS 128B,A01,895543,Pappas; Elizabeth,44,0,45,1
1745783161810,EDS 139,A00,897203,Pappas; Elizabeth,44,0,45,1
1745783161810,EDS 139,B00,897209,Fargason; Sharon Gayle,44,0,45,1
1745783162837,EDS 201,A00,895545,Staff,43,0,45,2
1745783163867,EDS 203,A01,895581,Halter; Christopher P.,43,0,45,2
1745783164893,EDS 204R,A01,895625,Heinzman; Erica M.,44,0,45,1
1745783164893,EDS 204R,B01,895693,Halter; Christopher P.,18,0,45,27
1745783165918,EDS 206R,A00,895694,Fargason; Sharon Gayle,9,0,30,21
1745783165918,EDS 206R,B00,895695,Choi; Bailey Miyeon,20,0,30,10
1745783166943,EDS 250,A00,895697,Hemans; Patricia Ann Benitez,43,0,45,2
1745783167971,EDS 281,A00,895701,Meyerott; Theresa Ann,15,0,15,0
1745783168996,EDS 284,A00,895736,Meyerott; Theresa Ann,15,0,15,0
1745783170022,EDS 286,A00,897210,Fine; Sarah,15,0,15,0
1745783171047,EDS 289C,A01,895770,Daly; Alan J.,15,0,15,0
1745783172075,EDS 290,A00,897211,Hofstetter; Carolyn,15,0,15,0
1745783173104,LIGM 5A,A00,896162,Fischer-Grunski; Eva K,15,0,20,5
1745783174133,LIGM 5B,A00,896260,Fischer-Grunski; Eva K,17,0,20,3
1745783175163,LIGM 5C,A00,896308,Fischer-Grunski; Eva K,18,0,20,2
1745783176193,LIIT 5AS,A00,896313,Carnelos; Chiara,18,0,20,2
1745783177219,LIIT 5BS,A00,896416,Carnelos; Chiara,20,0,20,0
1745783178246,LIIT 5CS,A00,896564,Carnelos; Chiara,20,0,20,0
1745783179274,LISP 5A,A00,896588,Munoz Sanchez; Alicia,4,0,20,16
1745783180306,LISP 5B,A00,896653,Munoz Sanchez; Alicia,10,0,20,10
1745783181331,LISP 5C,A00,896655,Munoz Sanchez; Alicia,4,0,20,16
1745783182361,MAE 197,001,957918,Kleissl; Jan,9998,0,9999,1
1745783183392,MATH 2,A01,957937,Staff,34,0,35,1
1745783184424,MATH 197,001,957876,Kedlaya; Kiran S.,9993,0,9999,6
1745783185455,MCWP 40,A00,892729,Duru; Nur,13,0,20,7
1745783185455,MCWP 40,B00,893304,Montejo; Carolina,20,0,20,0
1745783186481,MCWP 40R,A00,893757,Redela; Pamela Morgan,0,6,20,20
1745783187511,MCWP 50,A00,893758,Morshed; Michael James,2,0,20,18
1745783187511,MCWP 50,B00,893761,Bartulis; Jason Michael,17,0,20,3
1745783188537,MCWP 50R,A00,893766,Compas; Sean Matthew,0,1,20,20
1745783188537,MCWP 50R,B00,893769,Carter; Jennifer A,0,0,20,20
1745783188537,MCWP 50R,C00,893771,Krone; Jarret,0,3,20,20
1745783188537,MCWP 50R,D00,893772,Miller; Elizabeth Deen,3,0,20,17
1745783188537,MCWP 50R,E00,893775,Carter; Andrea L,0,0,20,20
1745783189563,MMW 11R,A01,892721,Herbst; Matthew,11,0,27,16
1745783189563,MMW 11R,A02,892722,Herbst; Matthew,0,0,0,3
1745783190591,MMW 12R,A01,892724,Herbst; Matthew,0,9,16,16
1745783190591,MMW 12R,A02,892725,Herbst; Matthew,0,9,16,16
1745783191616,MMW 13R,A01,892727,Staff,0,3,16,16
1745783191616,MMW 13R,A02,892728,Staff,0,4,16,16
1745783191616,MMW 13R,A03,958032,Staff,0,3,16,16
1745783191616,MMW 13R,A04,958033,Staff,0,2,16,16
1745783191616,MMW 13R,A05,958034,Staff,0,3,16,16
1745783192642,SIO 295LS,A00,894015,Staff,7,0,25,18
1745783193667,SIO 295S,A00,894020,Staff,7,0,25,18
1745783194695,SIOC 290S,B01,958918,Staff,0,0,0,0
1745783195723,SIOC 291S,B01,958922,Staff,0,0,0,0
1745783196749,SOCI 117,A01,895339,Staff,4,0,5,1
1745783197778,WES 237B,A00,894149,Staff,11,0,20,9
1745783199836,AESE 279B,A00,891859,Staff,13,0,35,22
1745783200860,AIP 197,001,891854,Staff,70,0,70,0
1745783201887,ANTH 289S,A00,891856,Gagneux; Pascal,12,0,12,0
1745783202913,BENG 196,001,957946,Engler; Adam J.,9996,0,9999,3
1745783203941,CAT 124RS,A01,956906,Staff,8,0,25,17
1745783204964,CAT 125RS,A01,922013,Staff,8,0,25,17
1745783205994,CLRE 250,A00,891860,Morris; Sheldon,9995,0,9999,4
1745783208051,CLRE 251R,A00,907817,Mehta; Ravindra L.,9994,0,9999,5
1745783209078,CLRE 252,A00,891864,Cuomo; Raphael Eduardo,9993,0,9999,6
1745783210104,CLRE 253,A00,891867,Vaida; Florin,9994,0,9999,5
1745783210104,CLRE 253,B00,907819,Staff,9999,0,9999,0
1745783211130,CLRE 259,A00,891868,Patel; Hemal,9998,0,9999,1
1745783212159,CLRE 260,A00,891872,Cuomo; Raphael Eduardo,9999,0,9999,0
1745783213189,CLRE 297,001,891888,Cuomo; Raphael Eduardo,9999,0,9999,0
1745783214215,CSE 191,A00,958773,Minnes Kemp; Mor Mia,9999,0,9999,0
1745783215242,CSS 201S,A01,892054,Mignozzetti; Umberto,30,0,30,0
1745783216273,CSS 202S,A01,892056,Mignozzetti; Umberto,30,0,30,0
1745783217298,DSC 197,001,956898,Eldridge; Justin Matthew,9998,0,9999,1
1745783218326,DSC 297,001,958000,Mazumdar; Arya,9998,0,9999,1
1745783219355,EAP 100,A00,905686,Staff,9776,0,9999,223
1745783220383,ECE 45,A01,892618,Staff,0,12,50,50
1745783221410,ECE 109,A01,892620,Staff,0,43,0,0
1745783222437,ECE 111,A01,892719,Staff,0,7,50,50
1745783223464,ECE 197,001,957920,Mercier; Patrick Philip,9992,0,9999,7
1745783224494,ECON 178,A01,907814,Zhu; Ying,28,0,35,7
1745783225521,EDS 115,A00,895312,Staff,41,0,45,4
1745783226547,EDS 117,A01,895337,Staff,30,0,30,0
1745783227573,EDS 125,A00,895341,Jones; Gabrielle Anastasia,43,0,45,2
1745783228602,EDS 128A,A01,895459,Fargason; Sharon Gayle,44,0,45,1
1745783229626,EDS 128B,A01,895543,Pappas; Elizabeth,44,0,45,1
1745783230655,EDS 139,A00,897203,Pappas; Elizabeth,44,0,45,1
1745783230655,EDS 139,B00,897209,Fargason; Sharon Gayle,44,0,45,1
1745783231680,EDS 201,A00,895545,Staff,43,0,45,2
1745783232706,EDS 203,A01,895581,Halter; Christopher P.,43,0,45,2
1745783233733,EDS 204R,A01,895625,Heinzman; Erica M.,44,0,45,1
1745783233733,EDS 204R,B01,895693,Halter; Christopher P.,18,0,45,27
1745783234763,EDS 206R,A00,895694,Fargason; Sharon Gayle,9,0,30,21
1745783234763,EDS 206R,B00,895695,Choi; Bailey Miyeon,20,0,30,10
1745783235793,EDS 250,A00,895697,Hemans; Patricia Ann Benitez,43,0,45,2
1745783236818,EDS 281,A00,895701,Meyerott; Theresa Ann,15,0,15,0
1745783237843,EDS 284,A00,895736,Meyerott; Theresa Ann,15,0,15,0
1745783238872,EDS 286,A00,897210,Fine; Sarah,15,0,15,0
1745783239899,EDS 289C,A01,895770,Daly; Alan J.,15,0,15,0
1745783240928,EDS 290,A00,897211,Hofstetter; Carolyn,15,0,15,0
1745783241954,LIGM 5A,A00,896162,Fischer-Grunski; Eva K,15,0,20,5
1745783242979,LIGM 5B,A00,896260,Fischer-Grunski; Eva K,17,0,20,3
1745783244009,LIGM 5C,A00,896308,Fischer-Grunski; Eva K,18,0,20,2
1745783245036,LIIT 5AS,A00,896313,Carnelos; Chiara,18,0,20,2
1745783246062,LIIT 5BS,A00,896416,Carnelos; Chiara,20,0,20,0
1745783247088,LIIT 5CS,A00,896564,Carnelos; Chiara,20,0,20,0
1745783248113,LISP 5A,A00,896588,Munoz Sanchez; Alicia,4,0,20,16
1745783249142,LISP 5B,A00,896653,Munoz Sanchez; Alicia,10,0,20,10
1745783250167,LISP 5C,A00,896655,Munoz Sanchez; Alicia,4,0,20,16
1745783251193,MAE 197,001,957918,Kleissl; Jan,9998,0,9999,1
1745783252221,MATH 2,A01,957937,Staff,34,0,35,1
1745783253251,MATH 197,001,957876,Kedlaya; Kiran S.,9993,0,9999,6
1745783254277,MCWP 40,A00,892729,Duru; Nur,13,0,20,7
1745783254277,MCWP 40,B00,893304,Montejo; Carolina,20,0,20,0
1745783255305,MCWP 40R,A00,893757,Redela; Pamela Morgan,0,6,20,20
1745783256332,MCWP 50,A00,893758,Morshed; Michael James,2,0,20,18
1745783256332,MCWP 50,B00,893761,Bartulis; Jason Michael,17,0,20,3
1745783257358,MCWP 50R,A00,893766,Compas; Sean Matthew,0,1,20,20
1745783257358,MCWP 50R,B00,893769,Carter; Jennifer A,0,0,20,20
1745783257358,MCWP 50R,C00,893771,Krone; Jarret,0,3,20,20
1745783257358,MCWP 50R,D00,893772,Miller; Elizabeth Deen,3,0,20,17
1745783257358,MCWP 50R,E00,893775,Carter; Andrea L,0,0,20,20
1745783258385,MMW 11R,A01,892721,Herbst; Matthew,11,0,27,16
1745783258385,MMW 11R,A02,892722,Herbst; Matthew,0,0,0,3
1745783259409,MMW 12R,A01,892724,Herbst; Matthew,0,9,16,16
1745783259409,MMW 12R,A02,892725,Herbst; Matthew,0,9,16,16
1745783260433,MMW 13R,A01,892727,Staff,0,3,16,16
1745783260433,MMW 13R,A02,892728,Staff,0,4,16,16
1745783260433,MMW 13R,A03,958032,Staff,0,3,16,16
1745783260433,MMW 13R,A04,958033,Staff,0,2,16,16
1745783260433,MMW 13R,A05,958034,Staff,0,3,16,16
1745783261463,SIO 295LS,A00,894015,Staff,7,0,25,18
1745783262490,SIO 295S,A00,894020,Staff,7,0,25,18
1745783263516,SIOC 290S,B01,958918,Staff,0,0,0,0
1745783264543,SIOC 291S,B01,958922,Staff,0,0,0,0
1745783265570,SOCI 117,A01,895339,Staff,4,0,5,1
1745783266596,WES 237B,A00,894149,Staff,11,0,20,9
1745783268655,AESE 279B,A00,891859,Staff,13,0,35,22
1745783269683,AIP 197,001,891854,Staff,70,0,70,0
1745783270708,ANTH 289S,A00,891856,Gagneux; Pascal,12,0,12,0
1745783271737,BENG 196,001,957946,Engler; Adam J.,9996,0,9999,3
1745783272765,CAT 124RS,A01,956906,Staff,8,0,25,17
1745783273797,CAT 125RS,A01,922013,Staff,8,0,25,17
1745783274822,CLRE 250,A00,891860,Morris; Sheldon,9995,0,9999,4
1745783276875,CLRE 251R,A00,907817,Mehta; Ravindra L.,9994,0,9999,5
1745783277901,CLRE 252,A00,891864,Cuomo; Raphael Eduardo,9993,0,9999,6
1745783278929,CLRE 253,A00,891867,Vaida; Florin,9994,0,9999,5
1745783278929,CLRE 253,B00,907819,Staff,9999,0,9999,0
1745783279959,CLRE 259,A00,891868,Patel; Hemal,9998,0,9999,1
1745783280986,CLRE 260,A00,891872,Cuomo; Raphael Eduardo,9999,0,9999,0
1745783282012,CLRE 297,001,891888,Cuomo; Raphael Eduardo,9999,0,9999,0
1745783283038,CSE 191,A00,958773,Minnes Kemp; Mor Mia,9999,0,9999,0
1745783284065,CSS 201S,A01,892054,Mignozzetti; Umberto,30,0,30,0
1745783285093,CSS 202S,A01,892056,Mignozzetti; Umberto,30,0,30,0
1745783286123,DSC 197,001,956898,Eldridge; Justin Matthew,9998,0,9999,1
1745783287149,DSC 297,001,958000,Mazumdar; Arya,9998,0,9999,1
1745783288175,EAP 100,A00,905686,Staff,9776,0,9999,223
1745783289204,ECE 45,A01,892618,Staff,0,12,50,50
1745783290229,ECE 109,A01,892620,Staff,0,43,0,0
1745783291257,ECE 111,A01,892719,Staff,0,7,50,50
1745783292285,ECE 197,001,957920,Mercier; Patrick Philip,9992,0,9999,7
1745783293314,ECON 178,A01,907814,Zhu; Ying,28,0,35,7
1745783294341,EDS 115,A00,895312,Staff,41,0,45,4
1745783295367,EDS 117,A01,895337,Staff,30,0,30,0
1745783296393,EDS 125,A00,895341,Jones; Gabrielle Anastasia,43,0,45,2
1745783297422,EDS 128A,A01,895459,Fargason; Sharon Gayle,44,0,45,1
1745783298452,EDS 128B,A01,895543,Pappas; Elizabeth,44,0,45,1
1745783299480,EDS 139,A00,897203,Pappas; Elizabeth,44,0,45,1
1745783299480,EDS 139,B00,897209,Fargason; Sharon Gayle,44,0,45,1
1745783300505,EDS 201,A00,895545,Staff,43,0,45,2
1745783301533,EDS 203,A01,895581,Halter; Christopher P.,43,0,45,2
1745783302561,EDS 204R,A01,895625,Heinzman; Erica M.,44,0,45,1
1745783302561,EDS 204R,B01,895693,Halter; Christopher P.,18,0,45,27
1745783303587,EDS 206R,A00,895694,Fargason; Sharon Gayle,9,0,30,21
1745783303587,EDS 206R,B00,895695,Choi; Bailey Miyeon,20,0,30,10
1745783304614,EDS 250,A00,895697,Hemans; Patricia Ann Benitez,43,0,45,2
1745783305640,EDS 281,A00,895701,Meyerott; Theresa Ann,15,0,15,0
1745783306666,EDS 284,A00,895736,Meyerott; Theresa Ann,15,0,15,0
1745783307691,EDS 286,A00,897210,Fine; Sarah,15,0,15,0
1745783308718,EDS 289C,A01,895770,Daly; Alan J.,15,0,15,0
1745783309744,EDS 290,A00,897211,Hofstetter; Carolyn,15,0,15,0
1745783310774,LIGM 5A,A00,896162,Fischer-Grunski; Eva K,15,0,20,5
1745783311799,LIGM 5B,A00,896260,Fischer-Grunski; Eva K,17,0,20,3
1745783312827,LIGM 5C,A00,896308,Fischer-Grunski; Eva K,18,0,20,2
1745783313854,LIIT 5AS,A00,896313,Carnelos; Chiara,18,0,20,2
1745783314879,LIIT 5BS,A00,896416,Carnelos; Chiara,20,0,20,0
1745783315905,LIIT 5CS,A00,896564,Carnelos; Chiara,20,0,20,0
1745783316932,LISP 5A,A00,896588,Munoz Sanchez; Alicia,4,0,20,16
1745783317962,LISP 5B,A00,896653,Munoz Sanchez; Alicia,10,0,20,10
1745783318987,LISP 5C,A00,896655,Munoz Sanchez; Alicia,4,0,20,16
1745783320015,MAE 197,001,957918,Kleissl; Jan,9998,0,9999,1
1745783321041,MATH 2,A01,957937,Staff,34,0,35,1
1745783322071,MATH 197,001,957876,Kedlaya; Kiran S.,9993,0,9999,6
1745783323097,MCWP 40,A00,892729,Duru; Nur,13,0,20,7
1745783323097,MCWP 40,B00,893304,Montejo; Carolina,20,0,20,0
1745783324125,MCWP 40R,A00,893757,Redela; Pamela Morgan,0,6,20,20
1745783325151,MCWP 50,A00,893758,Morshed; Michael James,2,0,20,18
1745783325151,MCWP 50,B00,893761,Bartulis; Jason Michael,17,0,20,3
1745783326178,MCWP 50R,A00,893766,Compas; Sean Matthew,0,1,20,20
1745783326178,MCWP 50R,B00,893769,Carter; Jennifer A,0,0,20,20
1745783326178,MCWP 50R,C00,893771,Krone; Jarret,0,3,20,20
1745783326178,MCWP 50R,D00,893772,Miller; Elizabeth Deen,3,0,20,17
1745783326178,MCWP 50R,E00,893775,Carter; Andrea L,0,0,20,20
1745783327205,MMW 11R,A01,892721,Herbst; Matthew,11,0,27,16
1745783327205,MMW 11R,A02,892722,Herbst; Matthew,0,0,0,3
1745783328230,MMW 12R,A01,892724,Herbst; Matthew,0,9,16,16
1745783328230,MMW 12R,A02,892725,Herbst; Matthew,0,9,16,16
1745783329257,MMW 13R,A01,892727,Staff,0,3,16,16
1745783329257,MMW 13R,A02,892728,Staff,0,4,16,16
1745783329257,MMW 13R,A03,958032,Staff,0,3,16,16
1745783329257,MMW 13R,A04,958033,Staff,0,2,16,16
1745783329257,MMW 13R,A05,958034,Staff,0,3,16,16
1745783330283,SIO 295LS,A00,894015,Staff,7,0,25,18
1745783331310,SIO 295S,A00,894020,Staff,7,0,25,18
1745783332337,SIOC 290S,B01,958918,Staff,0,0,0,0
1745783333365,SIOC 291S,B01,958922,Staff,0,0,0,0
1745783334391,SOCI 117,A01,895339,Staff,4,0,5,1
1745783335417,WES 237B,A00,894149,Staff,11,0,20,9
1745783337483,AESE 279B,A00,891859,Staff,13,0,35,22
1745783338508,AIP 197,001,891854,Staff,70,0,70,0
1745783339534,ANTH 289S,A00,891856,Gagneux; Pascal,12,0,12,0
1745783340561,BENG 196,001,957946,Engler; Adam J.,9996,0,9999,3
1745783341588,CAT 124RS,A01,956906,Staff,8,0,25,17
1745783342619,CAT 125RS,A01,922013,Staff,8,0,25,17
1745783343646,CLRE 250,A00,891860,Morris; Sheldon,9995,0,9999,4
1745783345698,CLRE 251R,A00,907817,Mehta; Ravindra L.,9994,0,9999,5
1745783346725,CLRE 252,A00,891864,Cuomo; Raphael Eduardo,9993,0,9999,6
1745783347751,CLRE 253,A00,891867,Vaida; Florin,9994,0,9999,5
1745783347751,CLRE 253,B00,907819,Staff,9999,0,9999,0
1745783348782,CLRE 259,A00,891868,Patel; Hemal,9998,0,9999,1
1745783349812,CLRE 260,A00,891872,Cuomo; Raphael Eduardo,9999,0,9999,0
1745783350838,CLRE 297,001,891888,Cuomo; Raphael Eduardo,9999,0,9999,0
1745783351865,CSE 191,A00,958773,Minnes Kemp; Mor Mia,9999,0,9999,0
1745783352893,CSS 201S,A01,892054,Mignozzetti; Umberto,30,0,30,0
1745783353923,CSS 202S,A01,892056,Mignozzetti; Umberto,30,0,30,0
1745783354948,DSC 197,001,956898,Eldridge; Justin Matthew,9998,0,9999,1
1745783355973,DSC 297,001,958000,Mazumdar; Arya,9998,0,9999,1
1745783357002,EAP 100,A00,905686,Staff,9776,0,9999,223
1745783358028,ECE 45,A01,892618,Staff,0,12,50,50
1745783359053,ECE 109,A01,892620,Staff,0,43,0,0
1745783360082,ECE 111,A01,892719,Staff,0,7,50,50
1745783361109,ECE 197,001,957920,Mercier; Patrick Philip,9992,0,9999,7
1745783362136,ECON 178,A01,907814,Zhu; Ying,28,0,35,7
1745783363164,EDS 115,A00,895312,Staff,41,0,45,4
1745783364190,EDS 117,A01,895337,Staff,30,0,30,0
1745783365215,EDS 125,A00,895341,Jones; Gabrielle Anastasia,43,0,45,2
1745783366242,EDS 128A,A01,895459,Fargason; Sharon Gayle,44,0,45,1
1745783367269,EDS 128B,A01,895543,Pappas; Elizabeth,44,0,45,1
1745783368295,EDS 139,A00,897203,Pappas; Elizabeth,44,0,45,1
1745783368295,EDS 139,B00,897209,Fargason; Sharon Gayle,44,0,45,1
1745783369319,EDS 201,A00,895545,Staff,43,0,45,2
1745783370348,EDS 203,A01,895581,Halter; Christopher P.,43,0,45,2
1745783371378,EDS 204R,A01,895625,Heinzman; Erica M.,44,0,45,1
1745783371378,EDS 204R,B01,895693,Halter; Christopher P.,18,0,45,27
1745783372404,EDS 206R,A00,895694,Fargason; Sharon Gayle,9,0,30,21
1745783372404,EDS 206R,B00,895695,Choi; Bailey Miyeon,20,0,30,10
1745783373434,EDS 250,A00,895697,Hemans; Patricia Ann Benitez,43,0,45,2
1745783374461,EDS 281,A00,895701,Meyerott; Theresa Ann,15,0,15,0
1745783375490,EDS 284,A00,895736,Meyerott; Theresa Ann,15,0,15,0
1745783376517,EDS 286,A00,897210,Fine; Sarah,15,0,15,0
1745783377541,EDS 289C,A01,895770,Daly; Alan J.,15,0,15,0
1745783378567,EDS 290,A00,897211,Hofstetter; Carolyn,15,0,15,0
1745783379597,LIGM 5A,A00,896162,Fischer-Grunski; Eva K,15,0,20,5
1745783380622,LIGM 5B,A00,896260,Fischer-Grunski; Eva K,17,0,20,3
1745783381650,LIGM 5C,A00,896308,Fischer-Grunski; Eva K,18,0,20,2
1745783382677,LIIT 5AS,A00,896313,Carnelos; Chiara,18,0,20,2
1745783383706,LIIT 5BS,A00,896416,Carnelos; Chiara,20,0,20,0
1745783384734,LIIT 5CS,A00,896564,Carnelos; Chiara,20,0,20,0
1745783385762,LISP 5A,A00,896588,Munoz Sanchez; Alicia,4,0,20,16
1745783386793,LISP 5B,A00,896653,Munoz Sanchez; Alicia,10,0,20,10
1745783387824,LISP 5C,A00,896655,Munoz Sanchez; Alicia,4,0,20,16
1745783388850,MAE 197,001,957918,Kleissl; Jan,9998,0,9999,1
1745783389875,MATH 2,A01,957937,Staff,34,0,35,1
1745783390902,MATH 197,001,957876,Kedlaya; Kiran S.,9993,0,9999,6
1745783391929,MCWP 40,A00,892729,Duru; Nur,13,0,20,7
1745783391929,MCWP 40,B00,893304,Montejo; Carolina,20,0,20,0
1745783392956,MCWP 40R,A00,893757,Redela; Pamela Morgan,0,6,20,20
1745783393982,MCWP 50,A00,893758,Morshed; Michael James,2,0,20,18
1745783393982,MCWP 50,B00,893761,Bartulis; Jason Michael,17,0,20,3
1745783395009,MCWP 50R,A00,893766,Compas; Sean Matthew,0,1,20,20
1745783395009,MCWP 50R,B00,893769,Carter; Jennifer A,0,0,20,20
1745783395009,MCWP 50R,C00,893771,Krone; Jarret,0,3,20,20
1745783395009,MCWP 50R,D00,893772,Miller; Elizabeth Deen,3,0,20,17
1745783395009,MCWP 50R,E00,893775,Carter; Andrea L,0,0,20,20
1745783396038,MMW 11R,A01,892721,Herbst; Matthew,11,0,27,16
1745783396038,MMW 11R,A02,892722,Herbst; Matthew,0,0,0,3
1745783397064,MMW 12R,A01,892724,Herbst; Matthew,0,9,16,16
1745783397064,MMW 12R,A02,892725,Herbst; Matthew,0,9,16,16
1745783398093,MMW 13R,A01,892727,Staff,0,3,16,16
1745783398093,MMW 13R,A02,892728,Staff,0,4,16,16
1745783398093,MMW 13R,A03,958032,Staff,0,3,16,16
1745783398093,MMW 13R,A04,958033,Staff,0,2,16,16
1745783398093,MMW 13R,A05,958034,Staff,0,3,16,16
1745783399121,SIO 295LS,A00,894015,Staff,7,0,25,18
1745783400149,SIO 295S,A00,894020,Staff,7,0,25,18
1745783401178,SIOC 290S,B01,958918,Staff,0,0,0,0
1745783402207,SIOC 291S,B01,958922,Staff,0,0,0,0
1745783403236,SOCI 117,A01,895339,Staff,4,0,5,1
1745783404265,WES 237B,A00,894149,Staff,11,0,20,9
1745783406325,AESE 279B,A00,891859,Staff,13,0,35,22
1745783407353,AIP 197,001,891854,Staff,70,0,70,0
1745783408379,ANTH 289S,A00,891856,Gagneux; Pascal,12,0,12,0
1745783409411,BENG 196,001,957946,Engler; Adam J.,9996,0,9999,3
1745783410441,CAT 124RS,A01,956906,Staff,8,0,25,17
1745783411469,CAT 125RS,A01,922013,Staff,8,0,25,17
1745783412496,CLRE 250,A00,891860,Morris; Sheldon,9995,0,9999,4
1745783414549,CLRE 251R,A00,907817,Mehta; Ravindra L.,9994,0,9999,5
1745783415576,CLRE 252,A00,891864,Cuomo; Raphael Eduardo,9993,0,9999,6
1745783416601,CLRE 253,A00,891867,Vaida; Florin,9994,0,9999,5
1745783416601,CLRE 253,B00,907819,Staff,9999,0,9999,0
1745783417631,CLRE 259,A00,891868,Patel; Hemal,9998,0,9999,1
1745783418656,CLRE 260,A00,891872,Cuomo; Raphael Eduardo,9999,0,9999,0
1745783419683,CLRE 297,001,891888,Cuomo; Raphael Eduardo,9999,0,9999,0
1745783420709,CSE 191,A00,958773,Minnes Kemp; Mor Mia,9999,0,9999,0
1745783421737,CSS 201S,A01,892054,Mignozzetti; Umberto,30,0,30,0
1745783422768,CSS 202S,A01,892056,Mignozzetti; Umberto,30,0,30,0
1745783423797,DSC 197,001,956898,Eldridge; Justin Matthew,9998,0,9999,1
1745783424824,DSC 297,001,958000,Mazumdar; Arya,9998,0,9999,1
1745783425852,EAP 100,A00,905686,Staff,9776,0,9999,223
1745783426878,ECE 45,A01,892618,Staff,0,12,50,50
1745783427902,ECE 109,A01,892620,Staff,0,43,0,0
1745783428928,ECE 111,A01,892719,Staff,0,7,50,50
1745783429953,ECE 197,001,957920,Mercier; Patrick Philip,9992,0,9999,7
1745783430980,ECON 178,A01,907814,Zhu; Ying,28,0,35,7
1745783432005,EDS 115,A00,895312,Staff,41,0,45,4
1745783433034,EDS 117,A01,895337,Staff,30,0,30,0
1745783434060,EDS 125,A00,895341,Jones; Gabrielle Anastasia,43,0,45,2
1745783435088,EDS 128A,A01,895459,Fargason; Sharon Gayle,44,0,45,1
1745783436116,EDS 128B,A01,895543,Pappas; Elizabeth,44,0,45,1
1745783437145,EDS 139,A00,897203,Pappas; Elizabeth,44,0,45,1
1745783437145,EDS 139,B00,897209,Fargason; Sharon Gayle,44,0,45,1
1745783438171,EDS 201,A00,895545,Staff,43,0,45,2
1745783439196,EDS 203,A01,895581,Halter; Christopher P.,43,0,45,2
1745783440223,EDS 204R,A01,895625,Heinzman; Erica M.,44,0,45,1
1745783440223,EDS 204R,B01,895693,Halter; Christopher P.,18,0,45,27
1745783441249,EDS 206R,A00,895694,Fargason; Sharon Gayle,9,0,30,21
1745783441249,EDS 206R,B00,895695,Choi; Bailey Miyeon,20,0,30,10
1745783442276,EDS 250,A00,895697,Hemans; Patricia Ann Benitez,43,0,45,2
1745783443300,EDS 281,A00,895701,Meyerott; Theresa Ann,15,0,15,0
1745783444324,EDS 284,A00,895736,Meyerott; Theresa Ann,15,0,15,0
1745783445349,EDS 286,A00,897210,Fine; Sarah,15,0,15,0
1745783446374,EDS 289C,A01,895770,Daly; Alan J.,15,0,15,0
1745783447400,EDS 290,A00,897211,Hofstetter; Carolyn,15,0,15,0
1745783448429,LIGM 5A,A00,896162,Fischer-Grunski; Eva K,15,0,20,5
1745783449455,LIGM 5B,A00,896260,Fischer-Grunski; Eva K,17,0,20,3
1745783450480,LIGM 5C,A00,896308,Fischer-Grunski; Eva K,18,0,20,2
1745783451510,LIIT 5AS,A00,896313,Carnelos; Chiara,18,0,20,2
1745783452539,LIIT 5BS,A00,896416,Carnelos; Chiara,20,0,20,0
1745783453565,LIIT 5CS,A00,896564,Carnelos; Chiara,20,0,20,0
1745783454591,LISP 5A,A00,896588,Munoz Sanchez; Alicia,4,0,20,16
1745783455620,LISP 5B,A00,896653,Munoz Sanchez; Alicia,10,0,20,10
1745783456652,LISP 5C,A00,896655,Munoz Sanchez; Alicia,4,0,20,16
1745783457686,MAE 197,001,957918,Kleissl; Jan,9998,0,9999,1
1745783458715,MATH 2,A01,957937,Staff,34,0,35,1
1745783459743,MATH 197,001,957876,Kedlaya; Kiran S.,9993,0,9999,6
1745783460770,MCWP 40,A00,892729,Duru; Nur,13,0,20,7
1745783460770,MCWP 40,B00,893304,Montejo; Carolina,20,0,20,0
1745783461796,MCWP 40R,A00,893757,Redela; Pamela Morgan,0,6,20,20
1745783462822,MCWP 50,A00,893758,Morshed; Michael James,2,0,20,18
1745783462822,MCWP 50,B00,893761,Bartulis; Jason Michael,17,0,20,3
1745783463850,MCWP 50R,A00,893766,Compas; Sean Matthew,0,1,20,20
1745783463850,MCWP 50R,B00,893769,Carter; Jennifer A,0,0,20,20
1745783463850,MCWP 50R,C00,893771,Krone; Jarret,0,3,20,20
1745783463850,MCWP 50R,D00,893772,Miller; Elizabeth Deen,3,0,20,17
1745783463850,MCWP 50R,E00,893775,Carter; Andrea L,0,0,20,20
1745783464875,MMW 11R,A01,892721,Herbst; Matthew,11,0,27,16
1745783464875,MMW 11R,A02,892722,Herbst; Matthew,0,0,0,3
1745783465900,MMW 12R,A01,892724,Herbst; Matthew,0,9,16,16
1745783465900,MMW 12R,A02,892725,Herbst; Matthew,0,9,16,16
1745783466927,MMW 13R,A01,892727,Staff,0,3,16,16
1745783466927,MMW 13R,A02,892728,Staff,0,4,16,16
1745783466927,MMW 13R,A03,958032,Staff,0,3,16,16
1745783466927,MMW 13R,A04,958033,Staff,0,2,16,16
1745783466927,MMW 13R,A05,958034,Staff,0,3,16,16
1745783467953,SIO 295LS,A00,894015,Staff,7,0,25,18
1745783468982,SIO 295S,A00,894020,Staff,7,0,25,18
1745783470009,SIOC 290S,B01,958918,Staff,0,0,0,0
1745783471036,SIOC 291S,B01,958922,Staff,0,0,0,0
1745783472062,SOCI 117,A01,895339,Staff,4,0,5,1
1745783473091,WES 237B,A00,894149,Staff,11,0,20,9
1745783475152,AESE 279B,A00,891859,Staff,13,0,35,22
1745783476178,AIP 197,001,891854,Staff,70,0,70,0
1745783477203,ANTH 289S,A00,891856,Gagneux; Pascal,12,0,12,0
1745783478230,BENG 196,001,957946,Engler; Adam J.,9996,0,9999,3
1745783479257,CAT 124RS,A01,956906,Staff,8,0,25,17
1745783480282,CAT 125RS,A01,922013,Staff,8,0,25,17
1745783481313,CLRE 250,A00,891860,Morris; Sheldon,9995,0,9999,4
1745783483369,CLRE 251R,A00,907817,Mehta; Ravindra L.,9994,0,9999,5
1745783484394,CLRE 252,A00,891864,Cuomo; Raphael Eduardo,9993,0,9999,6
1745783485424,CLRE 253,A00,891867,Vaida; Florin,9994,0,9999,5
1745783485424,CLRE 253,B00,907819,Staff,9999,0,9999,0
1745783486452,CLRE 259,A00,891868,Patel; Hemal,9998,0,9999,1
1745783487482,CLRE 260,A00,891872,Cuomo; Raphael Eduardo,9999,0,9999,0
1745783488506,CLRE 297,001,891888,Cuomo; Raphael Eduardo,9999,0,9999,0
1745783489534,CSE 191,A00,958773,Minnes Kemp; Mor Mia,9999,0,9999,0
1745783490566,CSS 201S,A01,892054,Mignozzetti; Umberto,30,0,30,0
1745783491594,CSS 202S,A01,892056,Mignozzetti; Umberto,30,0,30,0
1745783492621,DSC 197,001,956898,Eldridge; Justin Matthew,9998,0,9999,1
1745783493649,DSC 297,001,958000,Mazumdar; Arya,9998,0,9999,1
1745783494676,EAP 100,A00,905686,Staff,9776,0,9999,223
1745783495704,ECE 45,A01,892618,Staff,0,12,50,50
1745783496731,ECE 109,A01,892620,Staff,0,43,0,0
1745783497759,ECE 111,A01,892719,Staff,0,7,50,50
1745783498787,ECE 197,001,957920,Mercier; Patrick Philip,9992,0,9999,7
1745783499813,ECON 178,A01,907814,Zhu; Ying,28,0,35,7
1745783500841,EDS 115,A00,895312,Staff,41,0,45,4
1745783501870,EDS 117,A01,895337,Staff,30,0,30,0
1745783502898,EDS 125,A00,895341,Jones; Gabrielle Anastasia,43,0,45,2
1745783503929,EDS 128A,A01,895459,Fargason; Sharon Gayle,44,0,45,1
1745783504956,EDS 128B,A01,895543,Pappas; Elizabeth,44,0,45,1
1745783505981,EDS 139,A00,897203,Pappas; Elizabeth,44,0,45,1
1745783505981,EDS 139,B00,897209,Fargason; Sharon Gayle,44,0,45,1
1745783507009,EDS 201,A00,895545,Staff,43,0,45,2
1745783508037,EDS 203,A01,895581,Halter; Christopher P.,43,0,45,2
1745783509063,EDS 204R,A01,895625,Heinzman; Erica M.,44,0,45,1
1745783509063,EDS 204R,B01,895693,Halter; Christopher P.,18,0,45,27
1745783510089,EDS 206R,A00,895694,Fargason; Sharon Gayle,9,0,30,21
1745783510089,EDS 206R,B00,895695,Choi; Bailey Miyeon,20,0,30,10
1745783511115,EDS 250,A00,895697,Hemans; Patricia Ann Benitez,43,0,45,2
1745783512141,EDS 281,A00,895701,Meyerott; Theresa Ann,15,0,15,0
1745783513168,EDS 284,A00,895736,Meyerott; Theresa Ann,15,0,15,0
1745783514194,EDS 286,A00,897210,Fine; Sarah,15,0,15,0
1745783515218,EDS 289C,A01,895770,Daly; Alan J.,15,0,15,0
1745783516243,EDS 290,A00,897211,Hofstetter; Carolyn,15,0,15,0
1745783517271,LIGM 5A,A00,896162,Fischer-Grunski; Eva K,15,0,20,5
1745783518297,LIGM 5B,A00,896260,Fischer-Grunski; Eva K,17,0,20,3
1745783519327,LIGM 5C,A00,896308,Fischer-Grunski; Eva K,18,0,20,2
1745783520355,LIIT 5AS,A00,896313,Carnelos; Chiara,18,0,20,2
1745783521386,LIIT 5BS,A00,896416,Carnelos; Chiara,20,0,20,0
1745783522414,LIIT 5CS,A00,896564,Carnelos; Chiara,20,0,20,0
1745783523440,LISP 5A,A00,896588,Munoz Sanchez; Alicia,4,0,20,16
1745783524468,LISP 5B,A00,896653,Munoz Sanchez; Alicia,10,0,20,10
1745783525499,LISP 5C,A00,896655,Munoz Sanchez; Alicia,4,0,20,16
1745783526524,MAE 197,001,957918,Kleissl; Jan,9998,0,9999,1
1745783527549,MATH 2,A01,957937,Staff,34,0,35,1
1745783528576,MATH 197,001,957876,Kedlaya; Kiran S.,9993,0,9999,6
1745783529602,MCWP 40,A00,892729,Duru; Nur,13,0,20,7
1745783529602,MCWP 40,B00,893304,Montejo; Carolina,20,0,20,0
1745783530627,MCWP 40R,A00,893757,Redela; Pamela Morgan,0,6,20,20
1745783531652,MCWP 50,A00,893758,Morshed; Michael James,2,0,20,18
1745783531652,MCWP 50,B00,893761,Bartulis; Jason Michael,17,0,20,3
1745783532682,MCWP 50R,A00,893766,Compas; Sean Matthew,0,1,20,20
1745783532682,MCWP 50R,B00,893769,Carter; Jennifer A,0,0,20,20
1745783532682,MCWP 50R,C00,893771,Krone; Jarret,0,3,20,20
1745783532682,MCWP 50R,D00,893772,Miller; Elizabeth Deen,3,0,20,17
1745783532682,MCWP 50R,E00,893775,Carter; Andrea L,0,0,20,20
1745783533708,MMW 11R,A01,892721,Herbst; Matthew,11,0,27,16
1745783533708,MMW 11R,A02,892722,Herbst; Matthew,0,0,0,3
1745783534734,MMW 12R,A01,892724,Herbst; Matthew,0,9,16,16
1745783534734,MMW 12R,A02,892725,Herbst; Matthew,0,9,16,16
1745783535762,MMW 13R,A01,892727,Staff,0,3,16,16
1745783535762,MMW 13R,A02,892728,Staff,0,4,16,16
1745783535762,MMW 13R,A03,958032,Staff,0,3,16,16
1745783535762,MMW 13R,A04,958033,Staff,0,2,16,16
1745783535762,MMW 13R,A05,958034,Staff,0,3,16,16
1745783536787,SIO 295LS,A00,894015,Staff,7,0,25,18
1745783537816,SIO 295S,A00,894020,Staff,7,0,25,18
1745783538842,SIOC 290S,B01,958918,Staff,0,0,0,0
1745783539872,SIOC 291S,B01,958922,Staff,0,0,0,0
1745783540897,SOCI 117,A01,895339,Staff,4,0,5,1
1745783541924,WES 237B,A00,894149,Staff,11,0,20,9
1745783543991,AESE 279B,A00,891859,Staff,13,0,35,22
1745783545019,AIP 197,001,891854,Staff,70,0,70,0
1745783546049,ANTH 289S,A00,891856,Gagneux; Pascal,12,0,12,0
1745783547075,BENG 196,001,957946,Engler; Adam J.,9996,0,9999,3
1745783548103,CAT 124RS,A01,956906,Staff,8,0,25,17
1745783549128,CAT 125RS,A01,922013,Staff,8,0,25,17
1745783550157,CLRE 250,A00,891860,Morris; Sheldon,9995,0,9999,4
1745783552211,CLRE 251R,A00,907817,Mehta; Ravindra L.,9994,0,9999,5
1745783553238,CLRE 252,A00,891864,Cuomo; Raphael Eduardo,9993,0,9999,6
1745783554266,CLRE 253,A00,891867,Vaida; Florin,9994,0,9999,5
1745783554266,CLRE 253,B00,907819,Staff,9999,0,9999,0
1745783555292,CLRE 259,A00,891868,Patel; Hemal,9998,0,9999,1
1745783556320,CLRE 260,A00,891872,Cuomo; Raphael Eduardo,9999,0,9999,0
1745783557347,CLRE 297,001,891888,Cuomo; Raphael Eduardo,9999,0,9999,0
1745783558374,CSE 191,A00,958773,Minnes Kemp; Mor Mia,9999,0,9999,0
1745783559403,CSS 201S,A01,892054,Mignozzetti; Umberto,30,0,30,0
1745783560435,CSS 202S,A01,892056,Mignozzetti; Umberto,30,0,30,0
1745783561461,DSC 197,001,956898,Eldridge; Justin Matthew,9998,0,9999,1
1745783562488,DSC 297,001,958000,Mazumdar; Arya,9998,0,9999,1
1745783563514,EAP 100,A00,905686,Staff,9776,0,9999,223
1745783564540,ECE 45,A01,892618,Staff,0,12,50,50
1745783565567,ECE 109,A01,892620,Staff,0,43,0,0
1745783566593,ECE 111,A01,892719,Staff,0,7,50,50
1745783567622,ECE 197,001,957920,Mercier; Patrick Philip,9992,0,9999,7
1745783568651,ECON 178,A01,907814,Zhu; Ying,28,0,35,7
1745783569678,EDS 115,A00,895312,Staff,41,0,45,4
1745783570705,EDS 117,A01,895337,Staff,30,0,30,0
1745783571731,EDS 125,A00,895341,Jones; Gabrielle Anastasia,43,0,45,2
1745783572757,EDS 128A,A01,895459,Fargason; Sharon Gayle,44,0,45,1
1745783573784,EDS 128B,A01,895543,Pappas; Elizabeth,44,0,45,1
1745783574814,EDS 139,A00,897203,Pappas; Elizabeth,44,0,45,1
1745783574814,EDS 139,B00,897209,Fargason; Sharon Gayle,44,0,45,1
1745783575842,EDS 201,A00,895545,Staff,43,0,45,2
1745783576872,EDS 203,A01,895581,Halter; Christopher P.,43,0,45,2
1745783577899,EDS 204R,A01,895625,Heinzman; Erica M.,44,0,45,1
1745783577899,EDS 204R,B01,895693,Halter; Christopher P.,18,0,45,27
1745783578927,EDS 206R,A00,895694,Fargason; Sharon Gayle,9,0,30,21
1745783578927,EDS 206R,B00,895695,Choi; Bailey Miyeon,20,0,30,10
1745783579957,EDS 250,A00,895697,Hemans; Patricia Ann Benitez,43,0,45,2
1745783580981,EDS 281,A00,895701,Meyerott; Theresa Ann,15,0,15,0
1745783582007,EDS 284,A00,895736,Meyerott; Theresa Ann,15,0,15,0
1745783583033,EDS 286,A00,897210,Fine; Sarah,15,0,15,0
1745783584061,EDS 289C,A01,895770,Daly; Alan J.,15,0,15,0
1745783585091,EDS 290,A00,897211,Hofstetter; Carolyn,15,0,15,0
1745783586120,LIGM 5A,A00,896162,Fischer-Grunski; Eva K,15,0,20,5
1745783587147,LIGM 5B,A00,896260,Fischer-Grunski; Eva K,17,0,20,3
1745783588173,LIGM 5C,A00,896308,Fischer-Grunski; Eva K,18,0,20,2
1745783589200,LIIT 5AS,A00,896313,Carnelos; Chiara,18,0,20,2
1745783590225,LIIT 5BS,A00,896416,Carnelos; Chiara,20,0,20,0
1745783591251,LIIT 5CS,A00,896564,Carnelos; Chiara,20,0,20,0
1745783592280,LISP 5A,A00,896588,Munoz Sanchez; Alicia,4,0,20,16
1745783593310,LISP 5B,A00,896653,Munoz Sanchez; Alicia,10,0,20,10
1745783594336,LISP 5C,A00,896655,Munoz Sanchez; Alicia,4,0,20,16
1745783595364,MAE 197,001,957918,Kleissl; Jan,9998,0,9999,1
1745783596389,MATH 2,A01,957937,Staff,34,0,35,1
1745783597417,MATH 197,001,957876,Kedlaya; Kiran S.,9993,0,9999,6
1745783598444,MCWP 40,A00,892729,Duru; Nur,13,0,20,7
1745783598444,MCWP 40,B00,893304,Montejo; Carolina,20,0,20,0
1745783599470,MCWP 40R,A00,893757,Redela; Pamela Morgan,0,6,20,20
1745783600494,MCWP 50,A00,893758,Morshed; Michael James,2,0,20,18
1745783600494,MCWP 50,B00,893761,Bartulis; Jason Michael,17,0,20,3
1745783601524,MCWP 50R,A00,893766,Compas; Sean Matthew,0,1,20,20
1745783601524,MCWP 50R,B00,893769,Carter; Jennifer A,0,0,20,20
1745783601524,MCWP 50R,C00,893771,Krone; Jarret,0,3,20,20
1745783601524,MCWP 50R,D00,893772,Miller; Elizabeth Deen,3,0,20,17
1745783601524,MCWP 50R,E00,893775,Carter; Andrea L,0,0,20,20
1745783602551,MMW 11R,A01,892721,Herbst; Matthew,11,0,27,16
1745783602551,MMW 11R,A02,892722,Herbst; Matthew,0,0,0,3
1745783603581,MMW 12R,A01,892724,Herbst; Matthew,0,9,16,16
1745783603581,MMW 12R,A02,892725,Herbst; Matthew,0,9,16,16
1745783604611,MMW 13R,A01,892727,Staff,0,3,16,16
1745783604611,MMW 13R,A02,892728,Staff,0,4,16,16
1745783604611,MMW 13R,A03,958032,Staff,0,3,16,16
1745783604611,MMW 13R,A04,958033,Staff,0,2,16,16
1745783604611,MMW 13R,A05,958034,Staff,0,3,16,16
1745783605636,SIO 295LS,A00,894015,Staff,7,0,25,18
1745783606666,SIO 295S,A00,894020,Staff,7,0,25,18
1745783607694,SIOC 290S,B01,958918,Staff,0,0,0,0
1745783608718,SIOC 291S,B01,958922,Staff,0,0,0,0
1745783609745,SOCI 117,A01,895339,Staff,4,0,5,1
1745783610773,WES 237B,A00,894149,Staff,11,0,20,9
1745783612842,AESE 279B,A00,891859,Staff,13,0,35,22
1745783613869,AIP 197,001,891854,Staff,70,0,70,0
1745783614898,ANTH 289S,A00,891856,Gagneux; Pascal,12,0,12,0
1745783615924,BENG 196,001,957946,Engler; Adam J.,9996,0,9999,3
1745783616952,CAT 124RS,A01,956906,Staff,8,0,25,17
1745783617979,CAT 125RS,A01,922013,Staff,8,0,25,17
1745783619008,CLRE 250,A00,891860,Morris; Sheldon,9995,0,9999,4
1745783621066,CLRE 251R,A00,907817,Mehta; Ravindra L.,9994,0,9999,5
1745783622092,CLRE 252,A00,891864,Cuomo; Raphael Eduardo,9993,0,9999,6
1745783623118,CLRE 253,A00,891867,Vaida; Florin,9994,0,9999,5
1745783623118,CLRE 253,B00,907819,Staff,9999,0,9999,0
1745783624144,CLRE 259,A00,891868,Patel; Hemal,9998,0,9999,1
1745783625173,CLRE 260,A00,891872,Cuomo; Raphael Eduardo,9999,0,9999,0
1745783626201,CLRE 297,001,891888,Cuomo; Raphael Eduardo,9999,0,9999,0
1745783627225,CSE 191,A00,958773,Minnes Kemp; Mor Mia,9999,0,9999,0
1745783628252,CSS 201S,A01,892054,Mignozzetti; Umberto,30,0,30,0
1745783629283,CSS 202S,A01,892056,Mignozzetti; Umberto,30,0,30,0
1745783630312,DSC 197,001,956898,Eldridge; Justin Matthew,9998,0,9999,1
1745783631337,DSC 297,001,958000,Mazumdar; Arya,9998,0,9999,1
1745783632368,EAP 100,A00,905686,Staff,9776,0,9999,223
1745783633395,ECE 45,A01,892618,Staff,0,12,50,50
1745783634422,ECE 109,A01,892620,Staff,0,43,0,0
1745783635451,ECE 111,A01,892719,Staff,0,7,50,50
1745783636480,ECE 197,001,957920,Mercier; Patrick Philip,9992,0,9999,7
1745783637510,ECON 178,A01,907814,Zhu; Ying,28,0,35,7
1745783638558,EDS 115,A00,895312,Staff,41,0,45,4
1745783639584,EDS 117,A01,895337,Staff,30,0,30,0
1745783640610,EDS 125,A00,895341,Jones; Gabrielle Anastasia,43,0,45,2
1745783641638,EDS 128A,A01,895459,Fargason; Sharon Gayle,44,0,45,1
1745783642664,EDS 128B,A01,895543,Pappas; Elizabeth,44,0,45,1
1745783643691,EDS 139,A00,897203,Pappas; Elizabeth,44,0,45,1
1745783643691,EDS 139,B00,897209,Fargason; Sharon Gayle,44,0,45,1
1745783644715,EDS 201,A00,895545,Staff,43,0,45,2
1745783645744,EDS 203,A01,895581,Halter; Christopher P.,43,0,45,2
1745783646773,EDS 204R,A01,895625,Heinzman; Erica M.,44,0,45,1
1745783646773,EDS 204R,B01,895693,Halter; Christopher P.,18,0,45,27
1745783647801,EDS 206R,A00,895694,Fargason; Sharon Gayle,9,0,30,21
1745783647801,EDS 206R,B00,895695,Choi; Bailey Miyeon,20,0,30,10
1745783648826,EDS 250,A00,895697,Hemans; Patricia Ann Benitez,43,0,45,2
1745783649852,EDS 281,A00,895701,Meyerott; Theresa Ann,15,0,15,0
1745783650876,EDS 284,A00,895736,Meyerott; Theresa Ann,15,0,15,0
1745783651902,EDS 286,A00,897210,Fine; Sarah,15,0,15,0
1745783652931,EDS 289C,A01,895770,Daly; Alan J.,15,0,15,0
1745783653962,EDS 290,A00,897211,Hofstetter; Carolyn,15,0,15,0
1745783654988,LIGM 5A,A00,896162,Fischer-Grunski; Eva K,15,0,20,5
1745783656017,LIGM 5B,A00,896260,Fischer-Grunski; Eva K,17,0,20,3
1745783657046,LIGM 5C,A00,896308,Fischer-Grunski; Eva K,18,0,20,2
1745783658073,LIIT 5AS,A00,896313,Carnelos; Chiara,18,0,20,2
1745783659103,LIIT 5BS,A00,896416,Carnelos; Chiara,20,0,20,0
1745783660133,LIIT 5CS,A00,896564,Carnelos; Chiara,20,0,20,0
1745783661162,LISP 5A,A00,896588,Munoz Sanchez; Alicia,4,0,20,16
1745783662187,LISP 5B,A00,896653,Munoz Sanchez; Alicia,10,0,20,10
1745783663214,LISP 5C,A00,896655,Munoz Sanchez; Alicia,4,0,20,16
1745783664242,MAE 197,001,957918,Kleissl; Jan,9998,0,9999,1
1745783665270,MATH 2,A01,957937,Staff,34,0,35,1
1745783666297,MATH 197,001,957876,Kedlaya; Kiran S.,9993,0,9999,6
1745783667326,MCWP 40,A00,892729,Duru; Nur,13,0,20,7
1745783667326,MCWP 40,B00,893304,Montejo; Carolina,20,0,20,0
1745783668356,MCWP 40R,A00,893757,Redela; Pamela Morgan,0,6,20,20
1745783669381,MCWP 50,A00,893758,Morshed; Michael James,2,0,20,18
1745783669381,MCWP 50,B00,893761,Bartulis; Jason Michael,17,0,20,3
1745783670409,MCWP 50R,A00,893766,Compas; Sean Matthew,0,1,20,20
1745783670409,MCWP 50R,B00,893769,Carter; Jennifer A,0,0,20,20
1745783670409,MCWP 50R,C00,893771,Krone; Jarret,0,3,20,20
1745783670409,MCWP 50R,D00,893772,Miller; Elizabeth Deen,3,0,20,17
1745783670409,MCWP 50R,E00,893775,Carter; Andrea L,0,0,20,20
1745783671438,MMW 11R,A01,892721,Herbst; Matthew,11,0,27,16
1745783671438,MMW 11R,A02,892722,Herbst; Matthew,0,0,0,3
1745783672466,MMW 12R,A01,892724,Herbst; Matthew,0,9,16,16
1745783672466,MMW 12R,A02,892725,Herbst; Matthew,0,9,16,16
1745783673495,MMW 13R,A01,892727,Staff,0,3,16,16
1745783673495,MMW 13R,A02,892728,Staff,0,4,16,16
1745783673495,MMW 13R,A03,958032,Staff,0,3,16,16
1745783673495,MMW 13R,A04,958033,Staff,0,2,16,16
1745783673495,MMW 13R,A05,958034,Staff,0,3,16,16
1745783674520,SIO 295LS,A00,894015,Staff,7,0,25,18
1745783675549,SIO 295S,A00,894020,Staff,7,0,25,18
1745783676576,SIOC 290S,B01,958918,Staff,0,0,0,0
1745783677601,SIOC 291S,B01,958922,Staff,0,0,0,0
1745783678630,SOCI 117,A01,895339,Staff,4,0,5,1
1745783679656,WES 237B,A00,894149,Staff,11,0,20,9
1745783681723,AESE 279B,A00,891859,Staff,13,0,35,22
1745783682751,AIP 197,001,891854,Staff,70,0,70,0
1745783683782,ANTH 289S,A00,891856,Gagneux; Pascal,12,0,12,0
1745783684807,BENG 196,001,957946,Engler; Adam J.,9996,0,9999,3
1745783685833,CAT 124RS,A01,956906,Staff,8,0,25,17
1745783686859,CAT 125RS,A01,922013,Staff,8,0,25,17
1745783687885,CLRE 250,A00,891860,Morris; Sheldon,9995,0,9999,4
1745783689939,CLRE 251R,A00,907817,Mehta; Ravindra L.,9994,0,9999,5
1745783690965,CLRE 252,A00,891864,Cuomo; Raphael Eduardo,9993,0,9999,6
1745783691995,CLRE 253,A00,891867,Vaida; Florin,9994,0,9999,5
1745783691995,CLRE 253,B00,907819,Staff,9999,0,9999,0
1745783693021,CLRE 259,A00,891868,Patel; Hemal,9998,0,9999,1
1745783694047,CLRE 260,A00,891872,Cuomo; Raphael Eduardo,9999,0,9999,0
1745783695130,CLRE 297,001,891888,Cuomo; Raphael Eduardo,9999,0,9999,0
1745783696160,CSE 191,A00,958773,Minnes Kemp; Mor Mia,9999,0,9999,0
1745783697187,CSS 201S,A01,892054,Mignozzetti; Umberto,30,0,30,0
1745783698214,CSS 202S,A01,892056,Mignozzetti; Umberto,30,0,30,0
1745783699241,DSC 197,001,956898,Eldridge; Justin Matthew,9998,0,9999,1
1745783700266,DSC 297,001,958000,Mazumdar; Arya,9998,0,9999,1
1745783701297,EAP 100,A00,905686,Staff,9776,0,9999,223
1745783702326,ECE 45,A01,892618,Staff,0,12,50,50
1745783703352,ECE 109,A01,892620,Staff,0,43,0,0
1745783704378,ECE 111,A01,892719,Staff,0,7,50,50
1745783705406,ECE 197,001,957920,Mercier; Patrick Philip,9992,0,9999,7
1745783706434,ECON 178,A01,907814,Zhu; Ying,28,0,35,7
1745783707461,EDS 115,A00,895312,Staff,41,0,45,4
1745783708488,EDS 117,A01,895337,Staff,30,0,30,0
1745783709515,EDS 125,A00,895341,Jones; Gabrielle Anastasia,43,0,45,2
1745783710542,EDS 128A,A01,895459,Fargason; Sharon Gayle,44,0,45,1
1745783711568,EDS 128B,A01,895543,Pappas; Elizabeth,44,0,45,1
1745783712594,EDS 139,A00,897203,Pappas; Elizabeth,44,0,45,1
1745783712594,EDS 139,B00,897209,Fargason; Sharon Gayle,44,0,45,1
1745783713621,EDS 201,A00,895545,Staff,43,0,45,2
1745783714648,EDS 203,A01,895581,Halter; Christopher P.,43,0,45,2
1745783715678,EDS 204R,A01,895625,Heinzman; Erica M.,44,0,45,1
1745783715678,EDS 204R,B01,895693,Halter; Christopher P.,18,0,45,27
1745783716703,EDS 206R,A00,895694,Fargason; Sharon Gayle,9,0,30,21
1745783716703,EDS 206R,B00,895695,Choi; Bailey Miyeon,20,0,30,10
1745783717731,EDS 250,A00,895697,Hemans; Patricia Ann Benitez,43,0,45,2
1745783718761,EDS 281,A00,895701,Meyerott; Theresa Ann,15,0,15,0
1745783719787,EDS 284,A00,895736,Meyerott; Theresa Ann,15,0,15,0
1745783720813,EDS 286,A00,897210,Fine; Sarah,15,0,15,0
1745783721840,EDS 289C,A01,895770,Daly; Alan J.,15,0,15,0
1745783722873,EDS 290,A00,897211,Hofstetter; Carolyn,15,0,15,0
1745783723903,LIGM 5A,A00,896162,Fischer-Grunski; Eva K,15,0,20,5
1745783724930,LIGM 5B,A00,896260,Fischer-Grunski; Eva K,17,0,20,3
1745783725959,LIGM 5C,A00,896308,Fischer-Grunski; Eva K,18,0,20,2
1745783726989,LIIT 5AS,A00,896313,Carnelos; Chiara,18,0,20,2
1745783728019,LIIT 5BS,A00,896416,Carnelos; Chiara,20,0,20,0
1745783729045,LIIT 5CS,A00,896564,Carnelos; Chiara,20,0,20,0
1745783730073,LISP 5A,A00,896588,Munoz Sanchez; Alicia,4,0,20,16
1745783731103,LISP 5B,A00,896653,Munoz Sanchez; Alicia,10,0,20,10
1745783732128,LISP 5C,A00,896655,Munoz Sanchez; Alicia,4,0,20,16
1745783733155,MAE 197,001,957918,Kleissl; Jan,9998,0,9999,1
1745783734181,MATH 2,A01,957937,Staff,34,0,35,1
1745783735206,MATH 197,001,957876,Kedlaya; Kiran S.,9993,0,9999,6
1745783736234,MCWP 40,A00,892729,Duru; Nur,13,0,20,7
1745783736234,MCWP 40,B00,893304,Montejo; Carolina,20,0,20,0
1745783737263,MCWP 40R,A00,893757,Redela; Pamela Morgan,0,6,20,20
1745783738287,MCWP 50,A00,893758,Morshed; Michael James,2,0,20,18
1745783738287,MCWP 50,B00,893761,Bartulis; Jason Michael,17,0,20,3
1745783739314,MCWP 50R,A00,893766,Compas; Sean Matthew,0,1,20,20
1745783739314,MCWP 50R,B00,893769,Carter; Jennifer A,0,0,20,20
1745783739314,MCWP 50R,C00,893771,Krone; Jarret,0,3,20,20
1745783739314,MCWP 50R,D00,893772,Miller; Elizabeth Deen,3,0,20,17
1745783739314,MCWP 50R,E00,893775,Carter; Andrea L,0,0,20,20
1745783740340,MMW 11R,A01,892721,Herbst; Matthew,11,0,27,16
1745783740340,MMW 11R,A02,892722,Herbst; Matthew,0,0,0,3
1745783741367,MMW 12R,A01,892724,Herbst; Matthew,0,9,16,16
1745783741367,MMW 12R,A02,892725,Herbst; Matthew,0,9,16,16
1745783742395,MMW 13R,A01,892727,Staff,0,3,16,16
1745783742395,MMW 13R,A02,892728,Staff,0,4,16,16
1745783742395,MMW 13R,A03,958032,Staff,0,3,16,16
1745783742395,MMW 13R,A04,958033,Staff,0,2,16,16
1745783742395,MMW 13R,A05,958034,Staff,0,3,16,16
1745783743420,SIO 295LS,A00,894015,Staff,7,0,25,18
1745783744446,SIO 295S,A00,894020,Staff,7,0,25,18
1745783745476,SIOC 290S,B01,958918,Staff,0,0,0,0
1745783746506,SIOC 291S,B01,958922,Staff,0,0,0,0
1745783747530,SOCI 117,A01,895339,Staff,4,0,5,1
1745783748557,WES 237B,A00,894149,Staff,11,0,20,9
1745783750621,AESE 279B,A00,891859,Staff,13,0,35,22
1745783751650,AIP 197,001,891854,Staff,70,0,70,0
1745783752678,ANTH 289S,A00,891856,Gagneux; Pascal,12,0,12,0
1745783753705,BENG 196,001,957946,Engler; Adam J.,9996,0,9999,3
1745783754731,CAT 124RS,A01,956906,Staff,8,0,25,17
1745783755759,CAT 125RS,A01,922013,Staff,8,0,25,17
1745783756788,CLRE 250,A00,891860,Morris; Sheldon,9995,0,9999,4
1745783758839,CLRE 251R,A00,907817,Mehta; Ravindra L.,9994,0,9999,5
1745783759865,CLRE 252,A00,891864,Cuomo; Raphael Eduardo,9993,0,9999,6
1745783760893,CLRE 253,A00,891867,Vaida; Florin,9994,0,9999,5
1745783760893,CLRE 253,B00,907819,Staff,9999,0,9999,0
1745783761920,CLRE 259,A00,891868,Patel; Hemal,9998,0,9999,1
1745783762956,CLRE 260,A00,891872,Cuomo; Raphael Eduardo,9999,0,9999,0
1745783763985,CLRE 297,001,891888,Cuomo; Raphael Eduardo,9999,0,9999,0
1745783765012,CSE 191,A00,958773,Minnes Kemp; Mor Mia,9999,0,9999,0
1745783766038,CSS 201S,A01,892054,Mignozzetti; Umberto,30,0,30,0
1745783767067,CSS 202S,A01,892056,Mignozzetti; Umberto,30,0,30,0
1745783768094,DSC 197,001,956898,Eldridge; Justin Matthew,9998,0,9999,1
1745783769131,DSC 297,001,958000,Mazumdar; Arya,9998,0,9999,1
1745783770158,EAP 100,A00,905686,Staff,9776,0,9999,223
1745783771187,ECE 45,A01,892618,Staff,0,12,50,50
1745783772216,ECE 109,A01,892620,Staff,0,43,0,0
1745783773243,ECE 111,A01,892719,Staff,0,7,50,50
1745783774274,ECE 197,001,957920,Mercier; Patrick Philip,9992,0,9999,7
1745783775303,ECON 178,A01,907814,Zhu; Ying,28,0,35,7
1745783776331,EDS 115,A00,895312,Staff,41,0,45,4
1745783777361,EDS 117,A01,895337,Staff,30,0,30,0
1745783778389,EDS 125,A00,895341,Jones; Gabrielle Anastasia,43,0,45,2
1745783779416,EDS 128A,A01,895459,Fargason; Sharon Gayle,44,0,45,1
1745783780442,EDS 128B,A01,895543,Pappas; Elizabeth,44,0,45,1
1745783781467,EDS 139,A00,897203,Pappas; Elizabeth,44,0,45,1
1745783781467,EDS 139,B00,897209,Fargason; Sharon Gayle,44,0,45,1
1745783782491,EDS 201,A00,895545,Staff,43,0,45,2
1745783783517,EDS 203,A01,895581,Halter; Christopher P.,43,0,45,2
1745783784544,EDS 204R,A01,895625,Heinzman; Erica M.,44,0,45,1
1745783784544,EDS 204R,B01,895693,Halter; Christopher P.,18,0,45,27
1745783785569,EDS 206R,A00,895694,Fargason; Sharon Gayle,9,0,30,21
1745783785569,EDS 206R,B00,895695,Choi; Bailey Miyeon,20,0,30,10
1745783786595,EDS 250,A00,895697,Hemans; Patricia Ann Benitez,43,0,45,2
1745783787623,EDS 281,A00,895701,Meyerott; Theresa Ann,15,0,15,0
1745783788648,EDS 284,A00,895736,Meyerott; Theresa Ann,15,0,15,0
1745783789677,EDS 286,A00,897210,Fine; Sarah,15,0,15,0
1745783790704,EDS 289C,A01,895770,Daly; Alan J.,15,0,15,0
1745783791731,EDS 290,A00,897211,Hofstetter; Carolyn,15,0,15,0
1745783792759,LIGM 5A,A00,896162,Fischer-Grunski; Eva K,15,0,20,5
1745783793785,LIGM 5B,A00,896260,Fischer-Grunski; Eva K,17,0,20,3
1745783794811,LIGM 5C,A00,896308,Fischer-Grunski; Eva K,18,0,20,2
1745783795840,LIIT 5AS,A00,896313,Carnelos; Chiara,18,0,20,2
1745783796870,LIIT 5BS,A00,896416,Carnelos; Chiara,20,0,20,0
1745783797896,LIIT 5CS,A00,896564,Carnelos; Chiara,20,0,20,0
1745783798924,LISP 5A,A00,896588,Munoz Sanchez; Alicia,4,0,20,16
1745783799951,LISP 5B,A00,896653,Munoz Sanchez; Alicia,10,0,20,10
1745783800980,LISP 5C,A00,896655,Munoz Sanchez; Alicia,4,0,20,16
1745783802009,MAE 197,001,957918,Kleissl; Jan,9998,0,9999,1
1745783803034,MATH 2,A01,957937,Staff,34,0,35,1
1745783804060,MATH 197,001,957876,Kedlaya; Kiran S.,9993,0,9999,6
1745783805091,MCWP 40,A00,892729,Duru; Nur,13,0,20,7
1745783805091,MCWP 40,B00,893304,Montejo; Carolina,20,0,20,0
1745783806119,MCWP 40R,A00,893757,Redela; Pamela Morgan,0,6,20,20
1745783807147,MCWP 50,A00,893758,Morshed; Michael James,2,0,20,18
1745783807147,MCWP 50,B00,893761,Bartulis; Jason Michael,17,0,20,3
1745783808183,MCWP 50R,A00,893766,Compas; Sean Matthew,0,1,20,20
1745783808183,MCWP 50R,B00,893769,Carter; Jennifer A,0,0,20,20
1745783808183,MCWP 50R,C00,893771,Krone; Jarret,0,3,20,20
1745783808183,MCWP 50R,D00,893772,Miller; Elizabeth Deen,3,0,20,17
1745783808183,MCWP 50R,E00,893775,Carter; Andrea L,0,0,20,20
1745783809209,MMW 11R,A01,892721,Herbst; Matthew,11,0,27,16
1745783809209,MMW 11R,A02,892722,Herbst; Matthew,0,0,0,3
1745783810237,MMW 12R,A01,892724,Herbst; Matthew,0,9,16,16
1745783810237,MMW 12R,A02,892725,Herbst; Matthew,0,9,16,16
1745783811264,MMW 13R,A01,892727,Staff,0,3,16,16
1745783811264,MMW 13R,A02,892728,Staff,0,4,16,16
1745783811264,MMW 13R,A03,958032,Staff,0,3,16,16
1745783811264,MMW 13R,A04,958033,Staff,0,2,16,16
1745783811264,MMW 13R,A05,958034,Staff,0,3,16,16
1745783812291,SIO 295LS,A00,894015,Staff,7,0,25,18
1745783813319,SIO 295S,A00,894020,Staff,7,0,25,18
1745783814346,SIOC 290S,B01,958918,Staff,0,0,0,0
1745783815376,SIOC 291S,B01,958922,Staff,0,0,0,0
1745783816404,SOCI 117,A01,895339,Staff,4,0,5,1
1745783817429,WES 237B,A00,894149,Staff,11,0,20,9
1745783819495,AESE 279B,A00,891859,Staff,13,0,35,22
1745783820521,AIP 197,001,891854,Staff,70,0,70,0
1745783821546,ANTH 289S,A00,891856,Gagneux; Pascal,12,0,12,0
1745783822575,BENG 196,001,957946,Engler; Adam J.,9996,0,9999,3
1745783823601,CAT 124RS,A01,956906,Staff,8,0,25,17
1745783824632,CAT 125RS,A01,922013,Staff,8,0,25,17
1745783825660,CLRE 250,A00,891860,Morris; Sheldon,9995,0,9999,4
1745783827716,CLRE 251R,A00,907817,Mehta; Ravindra L.,9994,0,9999,5
1745783828743,CLRE 252,A00,891864,Cuomo; Raphael Eduardo,9993,0,9999,6
1745783829775,CLRE 253,A00,891867,Vaida; Florin,9994,0,9999,5
1745783829775,CLRE 253,B00,907819,Staff,9999,0,9999,0
1745783830801,CLRE 259,A00,891868,Patel; Hemal,9998,0,9999,1
1745783831827,CLRE 260,A00,891872,Cuomo; Raphael Eduardo,9999,0,9999,0
1745783832855,CLRE 297,001,891888,Cuomo; Raphael Eduardo,9999,0,9999,0
1745783833884,CSE 191,A00,958773,Minnes Kemp; Mor Mia,9999,0,9999,0
1745783834910,CSS 201S,A01,892054,Mignozzetti; Umberto,30,0,30,0
1745783835935,CSS 202S,A01,892056,Mignozzetti; Umberto,30,0,30,0
1745783836962,DSC 197,001,956898,Eldridge; Justin Matthew,9998,0,9999,1
1745783837987,DSC 297,001,958000,Mazumdar; Arya,9998,0,9999,1
1745783839015,EAP 100,A00,905686,Staff,9776,0,9999,223
1745783840043,ECE 45,A01,892618,Staff,0,12,50,50
1745783841070,ECE 109,A01,892620,Staff,0,43,0,0
1745783842097,ECE 111,A01,892719,Staff,0,7,50,50
1745783843125,ECE 197,001,957920,Mercier; Patrick Philip,9992,0,9999,7
1745783844151,ECON 178,A01,907814,Zhu; Ying,28,0,35,7
1745783845180,EDS 115,A00,895312,Staff,41,0,45,4
1745783846207,EDS 117,A01,895337,Staff,30,0,30,0
1745783847237,EDS 125,A00,895341,Jones; Gabrielle Anastasia,43,0,45,2
1745783848261,EDS 128A,A01,895459,Fargason; Sharon Gayle,44,0,45,1
1745783849288,EDS 128B,A01,895543,Pappas; Elizabeth,44,0,45,1
1745783850317,EDS 139,A00,897203,Pappas; Elizabeth,44,0,45,1
1745783850317,EDS 139,B00,897209,Fargason; Sharon Gayle,44,0,45,1
1745783851343,EDS 201,A00,895545,Staff,43,0,45,2
1745783852382,EDS 203,A01,895581,Halter; Christopher P.,43,0,45,2
1745783853409,EDS 204R,A01,895625,Heinzman; Erica M.,44,0,45,1
1745783853409,EDS 204R,B01,895693,Halter; Christopher P.,18,0,45,27
1745783854434,EDS 206R,A00,895694,Fargason; Sharon Gayle,9,0,30,21
1745783854434,EDS 206R,B00,895695,Choi; Bailey Miyeon,20,0,30,10
1745783855462,EDS 250,A00,895697,Hemans; Patricia Ann Benitez,43,0,45,2
1745783856490,EDS 281,A00,895701,Meyerott; Theresa Ann,15,0,15,0
1745783857516,EDS 284,A00,895736,Meyerott; Theresa Ann,15,0,15,0
1745783858542,EDS 286,A00,897210,Fine; Sarah,15,0,15,0
1745783859569,EDS 289C,A01,895770,Daly; Alan J.,15,0,15,0
1745783860593,EDS 290,A00,897211,Hofstetter; Carolyn,15,0,15,0
1745783861623,LIGM 5A,A00,896162,Fischer-Grunski; Eva K,15,0,20,5
1745783862652,LIGM 5B,A00,896260,Fischer-Grunski; Eva K,17,0,20,3
1745783863679,LIGM 5C,A00,896308,Fischer-Grunski; Eva K,18,0,20,2
1745783864705,LIIT 5AS,A00,896313,Carnelos; Chiara,18,0,20,2
1745783865734,LIIT 5BS,A00,896416,Carnelos; Chiara,20,0,20,0
1745783866762,LIIT 5CS,A00,896564,Carnelos; Chiara,20,0,20,0
1745783867788,LISP 5A,A00,896588,Munoz Sanchez; Alicia,4,0,20,16
1745783868814,LISP 5B,A00,896653,Munoz Sanchez; Alicia,10,0,20,10
1745783869880,LISP 5C,A00,896655,Munoz Sanchez; Alicia,4,0,20,16
1745783870905,MAE 197,001,957918,Kleissl; Jan,9998,0,9999,1
1745783871933,MATH 2,A01,957937,Staff,34,0,35,1
1745783872961,MATH 197,001,957876,Kedlaya; Kiran S.,9993,0,9999,6
1745783873987,MCWP 40,A00,892729,Duru; Nur,13,0,20,7
1745783873987,MCWP 40,B00,893304,Montejo; Carolina,20,0,20,0
1745783875015,MCWP 40R,A00,893757,Redela; Pamela Morgan,0,6,20,20
1745783876040,MCWP 50,A00,893758,Morshed; Michael James,2,0,20,18
1745783876040,MCWP 50,B00,893761,Bartulis; Jason Michael,17,0,20,3
1745783877069,MCWP 50R,A00,893766,Compas; Sean Matthew,0,1,20,20
1745783877069,MCWP 50R,B00,893769,Carter; Jennifer A,0,0,20,20
1745783877069,MCWP 50R,C00,893771,Krone; Jarret,0,3,20,20
1745783877069,MCWP 50R,D00,893772,Miller; Elizabeth Deen,3,0,20,17
1745783877069,MCWP 50R,E00,893775,Carter; Andrea L,0,0,20,20
1745783878094,MMW 11R,A01,892721,Herbst; Matthew,11,0,27,16
1745783878094,MMW 11R,A02,892722,Herbst; Matthew,0,0,0,3
1745783879124,MMW 12R,A01,892724,Herbst; Matthew,0,9,16,16
1745783879124,MMW 12R,A02,892725,Herbst; Matthew,0,9,16,16
1745783880153,MMW 13R,A01,892727,Staff,0,3,16,16
1745783880153,MMW 13R,A02,892728,Staff,0,4,16,16
1745783880153,MMW 13R,A03,958032,Staff,0,3,16,16
1745783880153,MMW 13R,A04,958033,Staff,0,2,16,16
1745783880153,MMW 13R,A05,958034,Staff,0,3,16,16
1745783881181,SIO 295LS,A00,894015,Staff,7,0,25,18
1745783882208,SIO 295S,A00,894020,Staff,7,0,25,18
1745783883233,SIOC 290S,B01,958918,Staff,0,0,0,0
1745783884263,SIOC 291S,B01,958922,Staff,0,0,0,0
1745783885291,SOCI 117,A01,895339,Staff,4,0,5,1
1745783886317,WES 237B,A00,894149,Staff,11,0,20,9
1745783888375,AESE 279B,A00,891859,Staff,13,0,35,22
1745783889399,AIP 197,001,891854,Staff,70,0,70,0
1745783890425,ANTH 289S,A00,891856,Gagneux; Pascal,12,0,12,0
1745783891453,BENG 196,001,957946,Engler; Adam J.,9996,0,9999,3
1745783892479,CAT 124RS,A01,956906,Staff,8,0,25,17
1745783893505,CAT 125RS,A01,922013,Staff,8,0,25,17
1745783894530,CLRE 250,A00,891860,Morris; Sheldon,9995,0,9999,4
1745783896581,CLRE 251R,A00,907817,Mehta; Ravindra L.,9994,0,9999,5
1745783897606,CLRE 252,A00,891864,Cuomo; Raphael Eduardo,9993,0,9999,6
1745783898631,CLRE 253,A00,891867,Vaida; Florin,9994,0,9999,5
1745783898631,CLRE 253,B00,907819,Staff,9999,0,9999,0
1745783899657,CLRE 259,A00,891868,Patel; Hemal,9998,0,9999,1
1745783900686,CLRE 260,A00,891872,Cuomo; Raphael Eduardo,9999,0,9999,0
1745783901714,CLRE 297,001,891888,Cuomo; Raphael Eduardo,9999,0,9999,0
1745783902739,CSE 191,A00,958773,Minnes Kemp; Mor Mia,9999,0,9999,0
1745783903766,CSS 201S,A01,892054,Mignozzetti; Umberto,30,0,30,0
1745783904794,CSS 202S,A01,892056,Mignozzetti; Umberto,30,0,30,0
1745783905818,DSC 197,001,956898,Eldridge; Justin Matthew,9998,0,9999,1
1745783906844,DSC 297,001,958000,Mazumdar; Arya,9998,0,9999,1
1745783907871,EAP 100,A00,905686,Staff,9776,0,9999,223
1745783908896,ECE 45,A01,892618,Staff,0,12,50,50
1745783909923,ECE 109,A01,892620,Staff,0,43,0,0
1745783910953,ECE 111,A01,892719,Staff,0,7,50,50
1745783911979,ECE 197,001,957920,Mercier; Patrick Philip,9992,0,9999,7
1745783913004,ECON 178,A01,907814,Zhu; Ying,28,0,35,7
1745783914029,EDS 115,A00,895312,Staff,41,0,45,4
1745783915055,EDS 117,A01,895337,Staff,30,0,30,0
1745783916081,EDS 125,A00,895341,Jones; Gabrielle Anastasia,43,0,45,2
1745783917106,EDS 128A,A01,895459,Fargason; Sharon Gayle,44,0,45,1
1745783918136,EDS 128B,A01,895543,Pappas; Elizabeth,44,0,45,1
1745783919161,EDS 139,A00,897203,Pappas; Elizabeth,44,0,45,1
1745783919161,EDS 139,B00,897209,Fargason; Sharon Gayle,44,0,45,1
1745783920187,EDS 201,A00,895545,Staff,43,0,45,2
1745783921215,EDS 203,A01,895581,Halter; Christopher P.,43,0,45,2
1745783922239,EDS 204R,A01,895625,Heinzman; Erica M.,44,0,45,1
1745783922239,EDS 204R,B01,895693,Halter; Christopher P.,18,0,45,27
1745783923266,EDS 206R,A00,895694,Fargason; Sharon Gayle,9,0,30,21
1745783923266,EDS 206R,B00,895695,Choi; Bailey Miyeon,20,0,30,10
1745783924292,EDS 250,A00,895697,Hemans; Patricia Ann Benitez,43,0,45,2
1745783925321,EDS 281,A00,895701,Meyerott; Theresa Ann,15,0,15,0
1745783926377,EDS 284,A00,895736,Meyerott; Theresa Ann,15,0,15,0
1745783927403,EDS 286,A00,897210,Fine; Sarah,15,0,15,0
1745783928432,EDS 289C,A01,895770,Daly; Alan J.,15,0,15,0
1745783929460,EDS 290,A00,897211,Hofstetter; Carolyn,15,0,15,0
1745783930490,LIGM 5A,A00,896162,Fischer-Grunski; Eva K,15,0,20,5
1745783931519,LIGM 5B,A00,896260,Fischer-Grunski; Eva K,17,0,20,3
1745783932545,LIGM 5C,A00,896308,Fischer-Grunski; Eva K,18,0,20,2
1745783933570,LIIT 5AS,A00,896313,Carnelos; Chiara,18,0,20,2
1745783934595,LIIT 5BS,A00,896416,Carnelos; Chiara,20,0,20,0
1745783935621,LIIT 5CS,A00,896564,Carnelos; Chiara,20,0,20,0
1745783936646,LISP 5A,A00,896588,Munoz Sanchez; Alicia,4,0,20,16
1745783937677,LISP 5B,A00,896653,Munoz Sanchez; Alicia,10,0,20,10
1745783938701,LISP 5C,A00,896655,Munoz Sanchez; Alicia,4,0,20,16
1745783939728,MAE 197,001,957918,Kleissl; Jan,9998,0,9999,1
1745783940753,MATH 2,A01,957937,Staff,34,0,35,1
1745783941779,MATH 197,001,957876,Kedlaya; Kiran S.,9993,0,9999,6
1745783942807,MCWP 40,A00,892729,Duru; Nur,13,0,20,7
1745783942807,MCWP 40,B00,893304,Montejo; Carolina,20,0,20,0
1745783943838,MCWP 40R,A00,893757,Redela; Pamela Morgan,0,6,20,20
1745783944865,MCWP 50,A00,893758,Morshed; Michael James,2,0,20,18
1745783944865,MCWP 50,B00,893761,Bartulis; Jason Michael,17,0,20,3
1745783945892,MCWP 50R,A00,893766,Compas; Sean Matthew,0,1,20,20
1745783945892,MCWP 50R,B00,893769,Carter; Jennifer A,0,0,20,20
1745783945892,MCWP 50R,C00,893771,Krone; Jarret,0,3,20,20
1745783945892,MCWP 50R,D00,893772,Miller; Elizabeth Deen,3,0,20,17
1745783945892,MCWP 50R,E00,893775,Carter; Andrea L,0,0,20,20
1745783946919,MMW 11R,A01,892721,Herbst; Matthew,11,0,27,16
1745783946919,MMW 11R,A02,892722,Herbst; Matthew,0,0,0,3
1745783947946,MMW 12R,A01,892724,Herbst; Matthew,0,9,16,16
1745783947946,MMW 12R,A02,892725,Herbst; Matthew,0,9,16,16
1745783948973,MMW 13R,A01,892727,Staff,0,3,16,16
1745783948973,MMW 13R,A02,892728,Staff,0,4,16,16
1745783948973,MMW 13R,A03,958032,Staff,0,3,16,16
1745783948973,MMW 13R,A04,958033,Staff,0,2,16,16
1745783948973,MMW 13R,A05,958034,Staff,0,3,16,16
1745783950007,SIO 295LS,A00,894015,Staff,7,0,25,18
1745783951034,SIO 295S,A00,894020,Staff,7,0,25,18
1745783952063,SIOC 290S,B01,958918,Staff,0,0,0,0
1745783953093,SIOC 291S,B01,958922,Staff,0,0,0,0
1745783954122,SOCI 117,A01,895339,Staff,4,0,5,1
1745783955149,WES 237B,A00,894149,Staff,11,0,20,9
1745783957213,AESE 279B,A00,891859,Staff,13,0,35,22
1745783958242,AIP 197,001,891854,Staff,70,0,70,0
1745783959266,ANTH 289S,A00,891856,Gagneux; Pascal,12,0,12,0
1745783960294,BENG 196,001,957946,Engler; Adam J.,9996,0,9999,3
1745783961326,CAT 124RS,A01,956906,Staff,8,0,25,17
1745783962352,CAT 125RS,A01,922013,Staff,8,0,25,17
1745783963380,CLRE 250,A00,891860,Morris; Sheldon,9995,0,9999,4
1745783965439,CLRE 251R,A00,907817,Mehta; Ravindra L.,9994,0,9999,5
1745783966463,CLRE 252,A00,891864,Cuomo; Raphael Eduardo,9993,0,9999,6
1745783967492,CLRE 253,A00,891867,Vaida; Florin,9994,0,9999,5
1745783967492,CLRE 253,B00,907819,Staff,9999,0,9999,0
1745783968516,CLRE 259,A00,891868,Patel; Hemal,9998,0,9999,1
1745783969544,CLRE 260,A00,891872,Cuomo; Raphael Eduardo,9999,0,9999,0
1745783970570,CLRE 297,001,891888,Cuomo; Raphael Eduardo,9999,0,9999,0
1745783971596,CSE 191,A00,958773,Minnes Kemp; Mor Mia,9999,0,9999,0
1745783972623,CSS 201S,A01,892054,Mignozzetti; Umberto,30,0,30,0
1745783973653,CSS 202S,A01,892056,Mignozzetti; Umberto,30,0,30,0
1745783974679,DSC 197,001,956898,Eldridge; Justin Matthew,9998,0,9999,1
1745783975707,DSC 297,001,958000,Mazumdar; Arya,9998,0,9999,1
1745783976734,EAP 100,A00,905686,Staff,9776,0,9999,223
1745783977761,ECE 45,A01,892618,Staff,0,12,50,50
1745783978789,ECE 109,A01,892620,Staff,0,43,0,0
1745783979816,ECE 111,A01,892719,Staff,0,7,50,50
1745783980843,ECE 197,001,957920,Mercier; Patrick Philip,9992,0,9999,7
1745783981870,ECON 178,A01,907814,Zhu; Ying,28,0,35,7
1745783982899,EDS 115,A00,895312,Staff,41,0,45,4
1745783983929,EDS 117,A01,895337,Staff,30,0,30,0
1745783984957,EDS 125,A00,895341,Jones; Gabrielle Anastasia,43,0,45,2
1745783985984,EDS 128A,A01,895459,Fargason; Sharon Gayle,44,0,45,1
1745783987009,EDS 128B,A01,895543,Pappas; Elizabeth,44,0,45,1
1745783988035,EDS 139,A00,897203,Pappas; Elizabeth,44,0,45,1
1745783988035,EDS 139,B00,897209,Fargason; Sharon Gayle,44,0,45,1
1745783989064,EDS 201,A00,895545,Staff,43,0,45,2
1745783990092,EDS 203,A01,895581,Halter; Christopher P.,43,0,45,2
1745783991123,EDS 204R,A01,895625,Heinzman; Erica M.,44,0,45,1
1745783991123,EDS 204R,B01,895693,Halter; Christopher P.,18,0,45,27
1745783992149,EDS 206R,A00,895694,Fargason; Sharon Gayle,9,0,30,21
1745783992149,EDS 206R,B00,895695,Choi; Bailey Miyeon,20,0,30,10
1745783993178,EDS 250,A00,895697,Hemans; Patricia Ann Benitez,43,0,45,2
1745783994204,EDS 281,A00,895701,Meyerott; Theresa Ann,15,0,15,0
1745783995230,EDS 284,A00,895736,Meyerott; Theresa Ann,15,0,15,0
1745783996257,EDS 286,A00,897210,Fine; Sarah,15,0,15,0
1745783997283,EDS 289C,A01,895770,Daly; Alan J.,15,0,15,0
1745783998310,EDS 290,A00,897211,Hofstetter; Carolyn,15,0,15,0
1745783999335,LIGM 5A,A00,896162,Fischer-Grunski; Eva K,15,0,20,5
1745784000364,LIGM 5B,A00,896260,Fischer-Grunski; Eva K,17,0,20,3
1745784001395,LIGM 5C,A00,896308,Fischer-Grunski; Eva K,18,0,20,2
1745784002426,LIIT 5AS,A00,896313,Carnelos; Chiara,18,0,20,2
1745784003452,LIIT 5BS,A00,896416,Carnelos; Chiara,20,0,20,0
1745784004484,LIIT 5CS,A00,896564,Carnelos; Chiara,20,0,20,0
1745784005512,LISP 5A,A00,896588,Munoz Sanchez; Alicia,4,0,20,16
1745784006543,LISP 5B,A00,896653,Munoz Sanchez; Alicia,10,0,20,10
1745784007572,LISP 5C,A00,896655,Munoz Sanchez; Alicia,4,0,20,16
1745784008602,MAE 197,001,957918,Kleissl; Jan,9998,0,9999,1
1745784009631,MATH 2,A01,957937,Staff,34,0,35,1
1745784010657,MATH 197,001,957876,Kedlaya; Kiran S.,9993,0,9999,6
1745784011685,MCWP 40,A00,892729,Duru; Nur,13,0,20,7
1745784011685,MCWP 40,B00,893304,Montejo; Carolina,20,0,20,0
1745784012715,MCWP 40R,A00,893757,Redela; Pamela Morgan,0,6,20,20
1745784013765,MCWP 50,A00,893758,Morshed; Michael James,2,0,20,18
1745784013765,MCWP 50,B00,893761,Bartulis; Jason Michael,17,0,20,3
1745784014795,MCWP 50R,A00,893766,Compas; Sean Matthew,0,1,20,20
1745784014795,MCWP 50R,B00,893769,Carter; Jennifer A,0,0,20,20
1745784014795,MCWP 50R,C00,893771,Krone; Jarret,0,3,20,20
1745784014795,MCWP 50R,D00,893772,Miller; Elizabeth Deen,3,0,20,17
1745784014795,MCWP 50R,E00,893775,Carter; Andrea L,0,0,20,20
1745784015822,MMW 11R,A01,892721,Herbst; Matthew,11,0,27,16
1745784015822,MMW 11R,A02,892722,Herbst; Matthew,0,0,0,3
1745784016849,MMW 12R,A01,892724,Herbst; Matthew,0,9,16,16
1745784016849,MMW 12R,A02,892725,Herbst; Matthew,0,9,16,16
1745784017874,MMW 13R,A01,892727,Staff,0,3,16,16
1745784017874,MMW 13R,A02,892728,Staff,0,4,16,16
1745784017874,MMW 13R,A03,958032,Staff,0,3,16,16
1745784017874,MMW 13R,A04,958033,Staff,0,2,16,16
1745784017874,MMW 13R,A05,958034,Staff,0,3,16,16
1745784018900,SIO 295LS,A00,894015,Staff,7,0,25,18
1745784019929,SIO 295S,A00,894020,Staff,7,0,25,18
1745784020956,SIOC 290S,B01,958918,Staff,0,0,0,0
1745784021981,SIOC 291S,B01,958922,Staff,0,0,0,0
1745784023010,SOCI 117,A01,895339,Staff,4,0,5,1
1745784024036,WES 237B,A00,894149,Staff,11,0,20,9
1745784026108,AESE 279B,A00,891859,Staff,13,0,35,22
1745784027135,AIP 197,001,891854,Staff,70,0,70,0
1745784028163,ANTH 289S,A00,891856,Gagneux; Pascal,12,0,12,0
1745784029188,BENG 196,001,957946,Engler; Adam J.,9996,0,9999,3
1745784030214,CAT 124RS,A01,956906,Staff,8,0,25,17
1745784031241,CAT 125RS,A01,922013,Staff,8,0,25,17
1745784032266,CLRE 250,A00,891860,Morris; Sheldon,9995,0,9999,4
1745784034318,CLRE 251R,A00,907817,Mehta; Ravindra L.,9994,0,9999,5
1745784035345,CLRE 252,A00,891864,Cuomo; Raphael Eduardo,9993,0,9999,6
1745784036369,CLRE 253,A00,891867,Vaida; Florin,9994,0,9999,5
1745784036369,CLRE 253,B00,907819,Staff,9999,0,9999,0
1745784037393,CLRE 259,A00,891868,Patel; Hemal,9998,0,9999,1
1745784038417,CLRE 260,A00,891872,Cuomo; Raphael Eduardo,9999,0,9999,0
1745784039444,CLRE 297,001,891888,Cuomo; Raphael Eduardo,9999,0,9999,0
1745784040471,CSE 191,A00,958773,Minnes Kemp; Mor Mia,9999,0,9999,0
1745784041495,CSS 201S,A01,892054,Mignozzetti; Umberto,30,0,30,0
1745784042521,CSS 202S,A01,892056,Mignozzetti; Umberto,30,0,30,0
1745784043562,DSC 197,001,956898,Eldridge; Justin Matthew,9998,0,9999,1
1745784044588,DSC 297,001,958000,Mazumdar; Arya,9998,0,9999,1
1745784045612,EAP 100,A00,905686,Staff,9776,0,9999,223
1745784046635,ECE 45,A01,892618,Staff,0,12,50,50
1745784047660,ECE 109,A01,892620,Staff,0,43,0,0
1745784048687,ECE 111,A01,892719,Staff,0,7,50,50
1745784049713,ECE 197,001,957920,Mercier; Patrick Philip,9992,0,9999,7
1745784050740,ECON 178,A01,907814,Zhu; Ying,28,0,35,7
1745784051769,EDS 115,A00,895312,Staff,41,0,45,4
1745784052794,EDS 117,A01,895337,Staff,30,0,30,0
1745784053818,EDS 125,A00,895341,Jones; Gabrielle Anastasia,43,0,45,2
1745784054842,EDS 128A,A01,895459,Fargason; Sharon Gayle,44,0,45,1
1745784055867,EDS 128B,A01,895543,Pappas; Elizabeth,44,0,45,1
1745784056892,EDS 139,A00,897203,Pappas; Elizabeth,44,0,45,1
1745784056892,EDS 139,B00,897209,Fargason; Sharon Gayle,44,0,45,1
1745784057943,EDS 201,A00,895545,Staff,43,0,45,2
1745784058971,EDS 203,A01,895581,Halter; Christopher P.,43,0,45,2
1745784059997,EDS 204R,A01,895625,Heinzman; Erica M.,44,0,45,1
1745784059997,EDS 204R,B01,895693,Halter; Christopher P.,18,0,45,27
1745784061024,EDS 206R,A00,895694,Fargason; Sharon Gayle,9,0,30,21
1745784061024,EDS 206R,B00,895695,Choi; Bailey Miyeon,20,0,30,10
1745784062052,EDS 250,A00,895697,Hemans; Patricia Ann Benitez,43,0,45,2
1745784063079,EDS 281,A00,895701,Meyerott; Theresa Ann,15,0,15,0
1745784064105,EDS 284,A00,895736,Meyerott; Theresa Ann,15,0,15,0
1745784065132,EDS 286,A00,897210,Fine; Sarah,15,0,15,0
1745784066156,EDS 289C,A01,895770,Daly; Alan J.,15,0,15,0
1745784067182,EDS 290,A00,897211,Hofstetter; Carolyn,15,0,15,0
1745784068210,LIGM 5A,A00,896162,Fischer-Grunski; Eva K,15,0,20,5
1745784069235,LIGM 5B,A00,896260,Fischer-Grunski; Eva K,17,0,20,3
1745784070260,LIGM 5C,A00,896308,Fischer-Grunski; Eva K,18,0,20,2
1745784071285,LIIT 5AS,A00,896313,Carnelos; Chiara,18,0,20,2
1745784072309,LIIT 5BS,A00,896416,Carnelos; Chiara,20,0,20,0
1745784073333,LIIT 5CS,A00,896564,Carnelos; Chiara,20,0,20,0
1745784074360,LISP 5A,A00,896588,Munoz Sanchez; Alicia,4,0,20,16
1745784075386,LISP 5B,A00,896653,Munoz Sanchez; Alicia,10,0,20,10
1745784076412,LISP 5C,A00,896655,Munoz Sanchez; Alicia,4,0,20,16
1745784077440,MAE 197,001,957918,Kleissl; Jan,9998,0,9999,1
1745784078467,MATH 2,A01,957937,Staff,34,0,35,1
1745784079496,MATH 197,001,957876,Kedlaya; Kiran S.,9993,0,9999,6
1745784080523,MCWP 40,A00,892729,Duru; Nur,13,0,20,7
1745784080523,MCWP 40,B00,893304,Montejo; Carolina,20,0,20,0
1745784081553,MCWP 40R,A00,893757,Redela; Pamela Morgan,0,6,20,20
1745784082581,MCWP 50,A00,893758,Morshed; Michael James,2,0,20,18
1745784082581,MCWP 50,B00,893761,Bartulis; Jason Michael,17,0,20,3
1745784083611,MCWP 50R,A00,893766,Compas; Sean Matthew,0,1,20,20
1745784083611,MCWP 50R,B00,893769,Carter; Jennifer A,0,0,20,20
1745784083611,MCWP 50R,C00,893771,Krone; Jarret,0,3,20,20
1745784083611,MCWP 50R,D00,893772,Miller; Elizabeth Deen,3,0,20,17
1745784083611,MCWP 50R,E00,893775,Carter; Andrea L,0,0,20,20
1745784084640,MMW 11R,A01,892721,Herbst; Matthew,11,0,27,16
1745784084640,MMW 11R,A02,892722,Herbst; Matthew,0,0,0,3
1745784085663,MMW 12R,A01,892724,Herbst; Matthew,0,9,16,16
1745784085663,MMW 12R,A02,892725,Herbst; Matthew,0,9,16,16
1745784086691,MMW 13R,A01,892727,Staff,0,3,16,16
1745784086691,MMW 13R,A02,892728,Staff,0,4,16,16
1745784086691,MMW 13R,A03,958032,Staff,0,3,16,16
1745784086691,MMW 13R,A04,958033,Staff,0,2,16,16
1745784086691,MMW 13R,A05,958034,Staff,0,3,16,16
1745784087716,SIO 295LS,A00,894015,Staff,7,0,25,18
1745784088742,SIO 295S,A00,894020,Staff,7,0,25,18
1745784089770,SIOC 290S,B01,958918,Staff,0,0,0,0
1745784090801,SIOC 291S,B01,958922,Staff,0,0,0,0
1745784091843,SOCI 117,A01,895339,Staff,4,0,5,1
1745784092872,WES 237B,A00,894149,Staff,11,0,20,9
1745784094933,AESE 279B,A00,891859,Staff,13,0,35,22
1745784095958,AIP 197,001,891854,Staff,70,0,70,0
1745784096985,ANTH 289S,A00,891856,Gagneux; Pascal,12,0,12,0
1745784098012,BENG 196,001,957946,Engler; Adam J.,9996,0,9999,3
1745784099041,CAT 124RS,A01,956906,Staff,8,0,25,17
1745784100065,CAT 125RS,A01,922013,Staff,8,0,25,17
1745784101088,CLRE 250,A00,891860,Morris; Sheldon,9995,0,9999,4
1745784103142,CLRE 251R,A00,907817,Mehta; Ravindra L.,9994,0,9999,5
1745784104170,CLRE 252,A00,891864,Cuomo; Raphael Eduardo,9993,0,9999,6
1745784105195,CLRE 253,A00,891867,Vaida; Florin,9994,0,9999,5
1745784105195,CLRE 253,B00,907819,Staff,9999,0,9999,0
1745784106220,CLRE 259,A00,891868,Patel; Hemal,9998,0,9999,1
1745784107245,CLRE 260,A00,891872,Cuomo; Raphael Eduardo,9999,0,9999,0
1745784108272,CLRE 297,001,891888,Cuomo; Raphael Eduardo,9999,0,9999,0
1745784109296,CSE 191,A00,958773,Minnes Kemp; Mor Mia,9999,0,9999,0
1745784110325,CSS 201S,A01,892054,Mignozzetti; Umberto,30,0,30,0
1745784111351,CSS 202S,A01,892056,Mignozzetti; Umberto,30,0,30,0
1745784112392,DSC 197,001,956898,Eldridge; Justin Matthew,9998,0,9999,1
1745784113418,DSC 297,001,958000,Mazumdar; Arya,9998,0,9999,1
1745784114445,EAP 100,A00,905686,Staff,9776,0,9999,223
1745784115471,ECE 45,A01,892618,Staff,0,12,50,50
1745784116497,ECE 109,A01,892620,Staff,0,43,0,0
1745784117523,ECE 111,A01,892719,Staff,0,7,50,50
1745784118546,ECE 197,001,957920,Mercier; Patrick Philip,9992,0,9999,7
1745784119572,ECON 178,A01,907814,Zhu; Ying,28,0,35,7
1745784120601,EDS 115,A00,895312,Staff,41,0,45,4
1745784121625,EDS 117,A01,895337,Staff,30,0,30,0
1745784122651,EDS 125,A00,895341,Jones; Gabrielle Anastasia,43,0,45,2
1745784123678,EDS 128A,A01,895459,Fargason; Sharon Gayle,44,0,45,1
1745784124706,EDS 128B,A01,895543,Pappas; Elizabeth,44,0,45,1
1745784125732,EDS 139,A00,897203,Pappas; Elizabeth,44,0,45,1
1745784125732,EDS 139,B00,897209,Fargason; Sharon Gayle,44,0,45,1
1745784126761,EDS 201,A00,895545,Staff,43,0,45,2
1745784127792,EDS 203,A01,895581,Halter; Christopher P.,43,0,45,2
1745784128821,EDS 204R,A01,895625,Heinzman; Erica M.,44,0,45,1
1745784128821,EDS 204R,B01,895693,Halter; Christopher P.,18,0,45,27
1745784129851,EDS 206R,A00,895694,Fargason; Sharon Gayle,9,0,30,21
1745784129851,EDS 206R,B00,895695,Choi; Bailey Miyeon,20,0,30,10
1745784130879,EDS 250,A00,895697,Hemans; Patricia Ann Benitez,43,0,45,2
1745784131907,EDS 281,A00,895701,Meyerott; Theresa Ann,15,0,15,0
1745784132936,EDS 284,A00,895736,Meyerott; Theresa Ann,15,0,15,0
1745784133962,EDS 286,A00,897210,Fine; Sarah,15,0,15,0
1745784134990,EDS 289C,A01,895770,Daly; Alan J.,15,0,15,0
1745784136019,EDS 290,A00,897211,Hofstetter; Carolyn,15,0,15,0
1745784137049,LIGM 5A,A00,896162,Fischer-Grunski; Eva K,15,0,20,5
1745784138073,LIGM 5B,A00,896260,Fischer-Grunski; Eva K,17,0,20,3
1745784139100,LIGM 5C,A00,896308,Fischer-Grunski; Eva K,18,0,20,2
1745784140131,LIIT 5AS,A00,896313,Carnelos; Chiara,18,0,20,2
1745784141157,LIIT 5BS,A00,896416,Carnelos; Chiara,20,0,20,0
1745784142184,LIIT 5CS,A00,896564,Carnelos; Chiara,20,0,20,0
1745784143213,LISP 5A,A00,896588,Munoz Sanchez; Alicia,4,0,20,16
1745784144241,LISP 5B,A00,896653,Munoz Sanchez; Alicia,10,0,20,10
1745784145268,LISP 5C,A00,896655,Munoz Sanchez; Alicia,4,0,20,16
1745784146296,MAE 197,001,957918,Kleissl; Jan,9998,0,9999,1
1745784147322,MATH 2,A01,957937,Staff,34,0,35,1
1745784148348,MATH 197,001,957876,Kedlaya; Kiran S.,9993,0,9999,6
1745784149373,MCWP 40,A00,892729,Duru; Nur,13,0,20,7
1745784149373,MCWP 40,B00,893304,Montejo; Carolina,20,0,20,0
1745784150399,MCWP 40R,A00,893757,Redela; Pamela Morgan,0,6,20,20
1745784151428,MCWP 50,A00,893758,Morshed; Michael James,2,0,20,18
1745784151428,MCWP 50,B00,893761,Bartulis; Jason Michael,17,0,20,3
1745784152483,MCWP 50R,A00,893766,Compas; Sean Matthew,0,1,20,20
1745784152483,MCWP 50R,B00,893769,Carter; Jennifer A,0,0,20,20
1745784152483,MCWP 50R,C00,893771,Krone; Jarret,0,3,20,20
1745784152483,MCWP 50R,D00,893772,Miller; Elizabeth Deen,3,0,20,17
1745784152483,MCWP 50R,E00,893775,Carter; Andrea L,0,0,20,20
1745784153511,MMW 11R,A01,892721,Herbst; Matthew,11,0,27,16
1745784153511,MMW 11R,A02,892722,Herbst; Matthew,0,0,0,3
1745784154539,MMW 12R,A01,892724,Herbst; Matthew,0,9,16,16
1745784154539,MMW 12R,A02,892725,Herbst; Matthew,0,9,16,16
1745784155570,MMW 13R,A01,892727,Staff,0,3,16,16
1745784155570,MMW 13R,A02,892728,Staff,0,4,16,16
1745784155570,MMW 13R,A03,958032,Staff,0,3,16,16
1745784155570,MMW 13R,A04,958033,Staff,0,2,16,16
1745784155570,MMW 13R,A05,958034,Staff,0,3,16,16
1745784156598,SIO 295LS,A00,894015,Staff,7,0,25,18
1745784157624,SIO 295S,A00,894020,Staff,7,0,25,18
1745784158649,SIOC 290S,B01,958918,Staff,0,0,0,0
1745784159675,SIOC 291S,B01,958922,Staff,0,0,0,0
1745784160702,SOCI 117,A01,895339,Staff,4,0,5,1
1745784161731,WES 237B,A00,894149,Staff,11,0,20,9
1745784163789,AESE 279B,A00,891859,Staff,13,0,35,22
1745784164814,AIP 197,001,891854,Staff,70,0,70,0
1745784165843,ANTH 289S,A00,891856,Gagneux; Pascal,12,0,12,0
1745784166869,BENG 196,001,957946,Engler; Adam J.,9996,0,9999,3
1745784167899,CAT 124RS,A01,956906,Staff,8,0,25,17
1745784168927,CAT 125RS,A01,922013,Staff,8,0,25,17
1745784169956,CLRE 250,A00,891860,Morris; Sheldon,9995,0,9999,4
1745784172013,CLRE 251R,A00,907817,Mehta; Ravindra L.,9994,0,9999,5
1745784173042,CLRE 252,A00,891864,Cuomo; Raphael Eduardo,9993,0,9999,6
1745784174071,CLRE 253,A00,891867,Vaida; Florin,9994,0,9999,5
1745784174071,CLRE 253,B00,907819,Staff,9999,0,9999,0
1745784175097,CLRE 259,A00,891868,Patel; Hemal,9998,0,9999,1
1745784176125,CLRE 260,A00,891872,Cuomo; Raphael Eduardo,9999,0,9999,0
1745784177151,CLRE 297,001,891888,Cuomo; Raphael Eduardo,9999,0,9999,0
1745784178179,CSE 191,A00,958773,Minnes Kemp; Mor Mia,9999,0,9999,0
1745784179208,CSS 201S,A01,892054,Mignozzetti; Umberto,30,0,30,0
1745784180235,CSS 202S,A01,892056,Mignozzetti; Umberto,30,0,30,0
1745784181264,DSC 197,001,956898,Eldridge; Justin Matthew,9998,0,9999,1
1745784182289,DSC 297,001,958000,Mazumdar; Arya,9998,0,9999,1
1745784183316,EAP 100,A00,905686,Staff,9776,0,9999,223
1745784184344,ECE 45,A01,892618,Staff,0,12,50,50
1745784185371,ECE 109,A01,892620,Staff,0,43,0,0
1745784186400,ECE 111,A01,892719,Staff,0,7,50,50
1745784187425,ECE 197,001,957920,Mercier; Patrick Philip,9992,0,9999,7
1745784188451,ECON 178,A01,907814,Zhu; Ying,28,0,35,7
1745784189481,EDS 115,A00,895312,Staff,41,0,45,4
1745784190510,EDS 117,A01,895337,Staff,30,0,30,0
1745784191538,EDS 125,A00,895341,Jones; Gabrielle Anastasia,43,0,45,2
1745784192563,EDS 128A,A01,895459,Fargason; Sharon Gayle,44,0,45,1
1745784193591,EDS 128B,A01,895543,Pappas; Elizabeth,44,0,45,1
1745784194619,EDS 139,A00,897203,Pappas; Elizabeth,44,0,45,1
1745784194619,EDS 139,B00,897209,Fargason; Sharon Gayle,44,0,45,1
1745784195646,EDS 201,A00,895545,Staff,43,0,45,2
1745784196675,EDS 203,A01,895581,Halter; Christopher P.,43,0,45,2
1745784197701,EDS 204R,A01,895625,Heinzman; Erica M.,44,0,45,1
1745784197701,EDS 204R,B01,895693,Halter; Christopher P.,18,0,45,27
1745784198732,EDS 206R,A00,895694,Fargason; Sharon Gayle,9,0,30,21
1745784198732,EDS 206R,B00,895695,Choi; Bailey Miyeon,20,0,30,10
1745784199759,EDS 250,A00,895697,Hemans; Patricia Ann Benitez,43,0,45,2
1745784200789,EDS 281,A00,895701,Meyerott; Theresa Ann,15,0,15,0
1745784201816,EDS 284,A00,895736,Meyerott; Theresa Ann,15,0,15,0
1745784202872,EDS 286,A00,897210,Fine; Sarah,15,0,15,0
1745784203896,EDS 289C,A01,895770,Daly; Alan J.,15,0,15,0
1745784204922,EDS 290,A00,897211,Hofstetter; Carolyn,15,0,15,0
1745784205951,LIGM 5A,A00,896162,Fischer-Grunski; Eva K,15,0,20,5
1745784206976,LIGM 5B,A00,896260,Fischer-Grunski; Eva K,17,0,20,3
1745784208003,LIGM 5C,A00,896308,Fischer-Grunski; Eva K,18,0,20,2
1745784209029,LIIT 5AS,A00,896313,Carnelos; Chiara,18,0,20,2
1745784210057,LIIT 5BS,A00,896416,Carnelos; Chiara,20,0,20,0
1745784211081,LIIT 5CS,A00,896564,Carnelos; Chiara,20,0,20,0
1745784212111,LISP 5A,A00,896588,Munoz Sanchez; Alicia,4,0,20,16
1745784213136,LISP 5B,A00,896653,Munoz Sanchez; Alicia,10,0,20,10
1745784214161,LISP 5C,A00,896655,Munoz Sanchez; Alicia,4,0,20,16
1745784215187,MAE 197,001,957918,Kleissl; Jan,9998,0,9999,1
1745784216214,MATH 2,A01,957937,Staff,34,0,35,1
1745784217245,MATH 197,001,957876,Kedlaya; Kiran S.,9993,0,9999,6
1745784218273,MCWP 40,A00,892729,Duru; Nur,13,0,20,7
1745784218273,MCWP 40,B00,893304,Montejo; Carolina,20,0,20,0
1745784219300,MCWP 40R,A00,893757,Redela; Pamela Morgan,0,6,20,20
1745784220328,MCWP 50,A00,893758,Morshed; Michael James,2,0,20,18
1745784220328,MCWP 50,B00,893761,Bartulis; Jason Michael,17,0,20,3
1745784221356,MCWP 50R,A00,893766,Compas; Sean Matthew,0,1,20,20
1745784221356,MCWP 50R,B00,893769,Carter; Jennifer A,0,0,20,20
1745784221356,MCWP 50R,C00,893771,Krone; Jarret,0,3,20,20
1745784221356,MCWP 50R,D00,893772,Miller; Elizabeth Deen,3,0,20,17
1745784221356,MCWP 50R,E00,893775,Carter; Andrea L,0,0,20,20
1745784222390,MMW 11R,A01,892721,Herbst; Matthew,11,0,27,16
1745784222390,MMW 11R,A02,892722,Herbst; Matthew,0,0,0,3
1745784223414,MMW 12R,A01,892724,Herbst; Matthew,0,9,16,16
1745784223414,MMW 12R,A02,892725,Herbst; Matthew,0,9,16,16
1745784224446,MMW 13R,A01,892727,Staff,0,3,16,16
1745784224446,MMW 13R,A02,892728,Staff,0,4,16,16
1745784224446,MMW 13R,A03,958032,Staff,0,3,16,16
1745784224446,MMW 13R,A04,958033,Staff,0,2,16,16
1745784224446,MMW 13R,A05,958034,Staff,0,3,16,16
1745784225475,SIO 295LS,A00,894015,Staff,7,0,25,18
1745784226502,SIO 295S,A00,894020,Staff,7,0,25,18
1745784227529,SIOC 290S,B01,958918,Staff,0,0,0,0
1745784228559,SIOC 291S,B01,958922,Staff,0,0,0,0
1745784229585,SOCI 117,A01,895339,Staff,4,0,5,1
1745784230614,WES 237B,A00,894149,Staff,11,0,20,9
1745784232674,AESE 279B,A00,891859,Staff,13,0,35,22
1745784233700,AIP 197,001,891854,Staff,70,0,70,0
1745784234726,ANTH 289S,A00,891856,Gagneux; Pascal,12,0,12,0
1745784235752,BENG 196,001,957946,Engler; Adam J.,9996,0,9999,3
1745784236778,CAT 124RS,A01,956906,Staff,8,0,25,17
1745784237803,CAT 125RS,A01,922013,Staff,8,0,25,17
1745784238830,CLRE 250,A00,891860,Morris; Sheldon,9995,0,9999,4
1745784240884,CLRE 251R,A00,907817,Mehta; Ravindra L.,9994,0,9999,5
1745784241914,CLRE 252,A00,891864,Cuomo; Raphael Eduardo,9993,0,9999,6
1745784242944,CLRE 253,A00,891867,Vaida; Florin,9994,0,9999,5
1745784242944,CLRE 253,B00,907819,Staff,9999,0,9999,0
1745784243974,CLRE 259,A00,891868,Patel; Hemal,9998,0,9999,1
1745784245003,CLRE 260,A00,891872,Cuomo; Raphael Eduardo,9999,0,9999,0
1745784246032,CLRE 297,001,891888,Cuomo; Raphael Eduardo,9999,0,9999,0
1745784247058,CSE 191,A00,958773,Minnes Kemp; Mor Mia,9999,0,9999,0
1745784248086,CSS 201S,A01,892054,Mignozzetti; Umberto,30,0,30,0
1745784249117,CSS 202S,A01,892056,Mignozzetti; Umberto,30,0,30,0
1745784250142,DSC 197,001,956898,Eldridge; Justin Matthew,9998,0,9999,1
1745784251172,DSC 297,001,958000,Mazumdar; Arya,9998,0,9999,1
1745784252199,EAP 100,A00,905686,Staff,9776,0,9999,223
1745784253226,ECE 45,A01,892618,Staff,0,12,50,50
1745784254253,ECE 109,A01,892620,Staff,0,43,0,0
1745784255280,ECE 111,A01,892719,Staff,0,7,50,50
1745784256308,ECE 197,001,957920,Mercier; Patrick Philip,9992,0,9999,7
1745784257338,ECON 178,A01,907814,Zhu; Ying,28,0,35,7
1745784258368,EDS 115,A00,895312,Staff,41,0,45,4
1745784259394,EDS 117,A01,895337,Staff,30,0,30,0
1745784260424,EDS 125,A00,895341,Jones; Gabrielle Anastasia,43,0,45,2
1745784261452,EDS 128A,A01,895459,Fargason; Sharon Gayle,44,0,45,1
1745784262482,EDS 128B,A01,895543,Pappas; Elizabeth,44,0,45,1
1745784263510,EDS 139,A00,897203,Pappas; Elizabeth,44,0,45,1
1745784263510,EDS 139,B00,897209,Fargason; Sharon Gayle,44,0,45,1
1745784264537,EDS 201,A00,895545,Staff,43,0,45,2
1745784265566,EDS 203,A01,895581,Halter; Christopher P.,43,0,45,2
1745784266595,EDS 204R,A01,895625,Heinzman; Erica M.,44,0,45,1
1745784266595,EDS 204R,B01,895693,Halter; Christopher P.,18,0,45,27
1745784267623,EDS 206R,A00,895694,Fargason; Sharon Gayle,9,0,30,21
1745784267623,EDS 206R,B00,895695,Choi; Bailey Miyeon,20,0,30,10
1745784268647,EDS 250,A00,895697,Hemans; Patricia Ann Benitez,43,0,45,2
1745784269672,EDS 281,A00,895701,Meyerott; Theresa Ann,15,0,15,0
1745784270702,EDS 284,A00,895736,Meyerott; Theresa Ann,15,0,15,0
1745784271728,EDS 286,A00,897210,Fine; Sarah,15,0,15,0
1745784272755,EDS 289C,A01,895770,Daly; Alan J.,15,0,15,0
1745784273783,EDS 290,A00,897211,Hofstetter; Carolyn,15,0,15,0
1745784274810,LIGM 5A,A00,896162,Fischer-Grunski; Eva K,15,0,20,5
1745784275838,LIGM 5B,A00,896260,Fischer-Grunski; Eva K,17,0,20,3
1745784276866,LIGM 5C,A00,896308,Fischer-Grunski; Eva K,18,0,20,2
1745784277892,LIIT 5AS,A00,896313,Carnelos; Chiara,18,0,20,2
1745784278917,LIIT 5BS,A00,896416,Carnelos; Chiara,20,0,20,0
1745784279946,LIIT 5CS,A00,896564,Carnelos; Chiara,20,0,20,0
1745784280973,LISP 5A,A00,896588,Munoz Sanchez; Alicia,4,0,20,16
1745784281998,LISP 5B,A00,896653,Munoz Sanchez; Alicia,10,0,20,10
1745784283026,LISP 5C,A00,896655,Munoz Sanchez; Alicia,4,0,20,16
1745784284051,MAE 197,001,957918,Kleissl; Jan,9998,0,9999,1
1745784285076,MATH 2,A01,957937,Staff,34,0,35,1
1745784286102,MATH 197,001,957876,Kedlaya; Kiran S.,9993,0,9999,6
1745784287132,MCWP 40,A00,892729,Duru; Nur,13,0,20,7
1745784287132,MCWP 40,B00,893304,Montejo; Carolina,20,0,20,0
1745784288157,MCWP 40R,A00,893757,Redela; Pamela Morgan,0,6,20,20
1745784289185,MCWP 50,A00,893758,Morshed; Michael James,2,0,20,18
1745784289185,MCWP 50,B00,893761,Bartulis; Jason Michael,17,0,20,3
1745784290213,MCWP 50R,A00,893766,Compas; Sean Matthew,0,1,20,20
1745784290213,MCWP 50R,B00,893769,Carter; Jennifer A,0,0,20,20
1745784290213,MCWP 50R,C00,893771,Krone; Jarret,0,3,20,20
1745784290213,MCWP 50R,D00,893772,Miller; Elizabeth Deen,3,0,20,17
1745784290213,MCWP 50R,E00,893775,Carter; Andrea L,0,0,20,20
1745784291241,MMW 11R,A01,892721,Herbst; Matthew,11,0,27,16
1745784291241,MMW 11R,A02,892722,Herbst; Matthew,0,0,0,3
1745784292269,MMW 12R,A01,892724,Herbst; Matthew,0,9,16,16
1745784292269,MMW 12R,A02,892725,Herbst; Matthew,0,9,16,16
1745784293295,MMW 13R,A01,892727,Staff,0,3,16,16
1745784293295,MMW 13R,A02,892728,Staff,0,4,16,16
1745784293295,MMW 13R,A03,958032,Staff,0,3,16,16
1745784293295,MMW 13R,A04,958033,Staff,0,2,16,16
1745784293295,MMW 13R,A05,958034,Staff,0,3,16,16
1745784294323,SIO 295LS,A00,894015,Staff,7,0,25,18
1745784295349,SIO 295S,A00,894020,Staff,7,0,25,18
1745784296379,SIOC 290S,B01,958918,Staff,0,0,0,0
1745784297405,SIOC 291S,B01,958922,Staff,0,0,0,0
1745784298430,SOCI 117,A01,895339,Staff,4,0,5,1
1745784299461,WES 237B,A00,894149,Staff,11,0,20,9
1745784301530,AESE 279B,A00,891859,Staff,13,0,35,22
1745784302556,AIP 197,001,891854,Staff,70,0,70,0
1745784303585,ANTH 289S,A00,891856,Gagneux; Pascal,12,0,12,0
1745784304611,BENG 196,001,957946,Engler; Adam J.,9996,0,9999,3
1745784305641,CAT 124RS,A01,956906,Staff,8,0,25,17
1745784306670,CAT 125RS,A01,922013,Staff,8,0,25,17
1745784307698,CLRE 250,A00,891860,Morris; Sheldon,9995,0,9999,4
1745784309777,CLRE 251R,A00,907817,Mehta; Ravindra L.,9994,0,9999,5
1745784310803,CLRE 252,A00,891864,Cuomo; Raphael Eduardo,9993,0,9999,6
1745784311829,CLRE 253,A00,891867,Vaida; Florin,9994,0,9999,5
1745784311829,CLRE 253,B00,907819,Staff,9999,0,9999,0
1745784312852,CLRE 259,A00,891868,Patel; Hemal,9998,0,9999,1
1745784313879,CLRE 260,A00,891872,Cuomo; Raphael Eduardo,9999,0,9999,0
1745784314917,CLRE 297,001,891888,Cuomo; Raphael Eduardo,9999,0,9999,0
1745784315945,CSE 191,A00,958773,Minnes Kemp; Mor Mia,9999,0,9999,0
1745784316974,CSS 201S,A01,892054,Mignozzetti; Umberto,30,0,30,0
1745784318002,CSS 202S,A01,892056,Mignozzetti; Umberto,30,0,30,0
1745784319029,DSC 197,001,956898,Eldridge; Justin Matthew,9998,0,9999,1
1745784320055,DSC 297,001,958000,Mazumdar; Arya,9998,0,9999,1
1745784321080,EAP 100,A00,905686,Staff,9776,0,9999,223
1745784322106,ECE 45,A01,892618,Staff,0,12,50,50
1745784323131,ECE 109,A01,892620,Staff,0,43,0,0
1745784324159,ECE 111,A01,892719,Staff,0,7,50,50
1745784325183,ECE 197,001,957920,Mercier; Patrick Philip,9992,0,9999,7
1745784326210,ECON 178,A01,907814,Zhu; Ying,28,0,35,7
1745784327238,EDS 115,A00,895312,Staff,41,0,45,4
1745784328261,EDS 117,A01,895337,Staff,30,0,30,0
1745784329286,EDS 125,A00,895341,Jones; Gabrielle Anastasia,43,0,45,2
1745784330313,EDS 128A,A01,895459,Fargason; Sharon Gayle,44,0,45,1
1745784331337,EDS 128B,A01,895543,Pappas; Elizabeth,44,0,45,1
1745784332361,EDS 139,A00,897203,Pappas; Elizabeth,44,0,45,1
1745784332361,EDS 139,B00,897209,Fargason; Sharon Gayle,44,0,45,1
1745784333386,EDS 201,A00,895545,Staff,43,0,45,2
1745784334416,EDS 203,A01,895581,Halter; Christopher P.,43,0,45,2
1745784335446,EDS 204R,A01,895625,Heinzman; Erica M.,44,0,45,1
1745784335446,EDS 204R,B01,895693,Halter; Christopher P.,18,0,45,27
1745784336470,EDS 206R,A00,895694,Fargason; Sharon Gayle,9,0,30,21
1745784336470,EDS 206R,B00,895695,Choi; Bailey Miyeon,20,0,30,10
1745784337493,EDS 250,A00,895697,Hemans; Patricia Ann Benitez,43,0,45,2
1745784338521,EDS 281,A00,895701,Meyerott; Theresa Ann,15,0,15,0
1745784339547,EDS 284,A00,895736,Meyerott; Theresa Ann,15,0,15,0
1745784340574,EDS 286,A00,897210,Fine; Sarah,15,0,15,0
1745784341599,EDS 289C,A01,895770,Daly; Alan J.,15,0,15,0
1745784342626,EDS 290,A00,897211,Hofstetter; Carolyn,15,0,15,0
1745784343655,LIGM 5A,A00,896162,Fischer-Grunski; Eva K,15,0,20,5
1745784344686,LIGM 5B,A00,896260,Fischer-Grunski; Eva K,17,0,20,3
1745784345714,LIGM 5C,A00,896308,Fischer-Grunski; Eva K,18,0,20,2
1745784346740,LIIT 5AS,A00,896313,Carnelos; Chiara,18,0,20,2
1745784347769,LIIT 5BS,A00,896416,Carnelos; Chiara,20,0,20,0
1745784348795,LIIT 5CS,A00,896564,Carnelos; Chiara,20,0,20,0
1745784349822,LISP 5A,A00,896588,Munoz Sanchez; Alicia,4,0,20,16
1745784350853,LISP 5B,A00,896653,Munoz Sanchez; Alicia,10,0,20,10
1745784351904,LISP 5C,A00,896655,Munoz Sanchez; Alicia,4,0,20,16
1745784352953,MAE 197,001,957918,Kleissl; Jan,9998,0,9999,1
1745784353981,MATH 2,A01,957937,Staff,34,0,35,1
1745784355007,MATH 197,001,957876,Kedlaya; Kiran S.,9993,0,9999,6
1745784356034,MCWP 40,A00,892729,Duru; Nur,13,0,20,7
1745784356034,MCWP 40,B00,893304,Montejo; Carolina,20,0,20,0
1745784357062,MCWP 40R,A00,893757,Redela; Pamela Morgan,0,6,20,20
1745784358089,MCWP 50,A00,893758,Morshed; Michael James,2,0,20,18
1745784358089,MCWP 50,B00,893761,Bartulis; Jason Michael,17,0,20,3
1745784359115,MCWP 50R,A00,893766,Compas; Sean Matthew,0,1,20,20
1745784359115,MCWP 50R,B00,893769,Carter; Jennifer A,0,0,20,20
1745784359115,MCWP 50R,C00,893771,Krone; Jarret,0,3,20,20
1745784359115,MCWP 50R,D00,893772,Miller; Elizabeth Deen,3,0,20,17
1745784359115,MCWP 50R,E00,893775,Carter; Andrea L,0,0,20,20
1745784360140,MMW 11R,A01,892721,Herbst; Matthew,11,0,27,16
1745784360140,MMW 11R,A02,892722,Herbst; Matthew,0,0,0,3
1745784361168,MMW 12R,A01,892724,Herbst; Matthew,0,9,16,16
1745784361168,MMW 12R,A02,892725,Herbst; Matthew,0,9,16,16
1745784362201,MMW 13R,A01,892727,Staff,0,3,16,16
1745784362201,MMW 13R,A02,892728,Staff,0,4,16,16
1745784362201,MMW 13R,A03,958032,Staff,0,3,16,16
1745784362201,MMW 13R,A04,958033,Staff,0,2,16,16
1745784362201,MMW 13R,A05,958034,Staff,0,3,16,16
1745784363226,SIO 295LS,A00,894015,Staff,7,0,25,18
1745784364253,SIO 295S,A00,894020,Staff,7,0,25,18
1745784365279,SIOC 290S,B01,958918,Staff,0,0,0,0
1745784366309,SIOC 291S,B01,958922,Staff,0,0,0,0
1745784367348,SOCI 117,A01,895339,Staff,4,0,5,1
1745784368373,WES 237B,A00,894149,Staff,11,0,20,9
1745784370430,AESE 279B,A00,891859,Staff,13,0,35,22
1745784371462,AIP 197,001,891854,Staff,70,0,70,0
1745784372489,ANTH 289S,A00,891856,Gagneux; Pascal,12,0,12,0
1745784373514,BENG 196,001,957946,Engler; Adam J.,9996,0,9999,3
1745784374541,CAT 124RS,A01,956906,Staff,8,0,25,17
1745784375567,CAT 125RS,A01,922013,Staff,8,0,25,17
1745784376594,CLRE 250,A00,891860,Morris; Sheldon,9995,0,9999,4
1745784378647,CLRE 251R,A00,907817,Mehta; Ravindra L.,9994,0,9999,5
1745784379676,CLRE 252,A00,891864,Cuomo; Raphael Eduardo,9993,0,9999,6
1745784380701,CLRE 253,A00,891867,Vaida; Florin,9994,0,9999,5
1745784380701,CLRE 253,B00,907819,Staff,9999,0,9999,0
1745784381731,CLRE 259,A00,891868,Patel; Hemal,9998,0,9999,1
1745784382758,CLRE 260,A00,891872,Cuomo; Raphael Eduardo,9999,0,9999,0
1745784383786,CLRE 297,001,891888,Cuomo; Raphael Eduardo,9999,0,9999,0
1745784384811,CSE 191,A00,958773,Minnes Kemp; Mor Mia,9999,0,9999,0
1745784385839,CSS 201S,A01,892054,Mignozzetti; Umberto,30,0,30,0
1745784386870,CSS 202S,A01,892056,Mignozzetti; Umberto,30,0,30,0
1745784387897,DSC 197,001,956898,Eldridge; Justin Matthew,9998,0,9999,1
1745784388925,DSC 297,001,958000,Mazumdar; Arya,9998,0,9999,1
1745784389954,EAP 100,A00,905686,Staff,9776,0,9999,223
1745784390979,ECE 45,A01,892618,Staff,0,12,50,50
1745784392007,ECE 109,A01,892620,Staff,0,43,0,0
1745784393034,ECE 111,A01,892719,Staff,0,7,50,50
1745784394059,ECE 197,001,957920,Mercier; Patrick Philip,9992,0,9999,7
1745784395094,ECON 178,A01,907814,Zhu; Ying,28,0,35,7
1745784396122,EDS 115,A00,895312,Staff,41,0,45,4
1745784397147,EDS 117,A01,895337,Staff,30,0,30,0
1745784398174,EDS 125,A00,895341,Jones; Gabrielle Anastasia,43,0,45,2
1745784399202,EDS 128A,A01,895459,Fargason; Sharon Gayle,44,0,45,1
1745784400228,EDS 128B,A01,895543,Pappas; Elizabeth,44,0,45,1
1745784401255,EDS 139,A00,897203,Pappas; Elizabeth,44,0,45,1
1745784401255,EDS 139,B00,897209,Fargason; Sharon Gayle,44,0,45,1
1745784402285,EDS 201,A00,895545,Staff,43,0,45,2
1745784403310,EDS 203,A01,895581,Halter; Christopher P.,43,0,45,2
1745784404340,EDS 204R,A01,895625,Heinzman; Erica M.,44,0,45,1
1745784404340,EDS 204R,B01,895693,Halter; Christopher P.,18,0,45,27
1745784405365,EDS 206R,A00,895694,Fargason; Sharon Gayle,9,0,30,21
1745784405365,EDS 206R,B00,895695,Choi; Bailey Miyeon,20,0,30,10
1745784406392,EDS 250,A00,895697,Hemans; Patricia Ann Benitez,43,0,45,2
1745784407424,EDS 281,A00,895701,Meyerott; Theresa Ann,15,0,15,0
1745784408450,EDS 284,A00,895736,Meyerott; Theresa Ann,15,0,15,0
1745784409477,EDS 286,A00,897210,Fine; Sarah,15,0,15,0
1745784410503,EDS 289C,A01,895770,Daly; Alan J.,15,0,15,0
1745784411530,EDS 290,A00,897211,Hofstetter; Carolyn,15,0,15,0
1745784412557,LIGM 5A,A00,896162,Fischer-Grunski; Eva K,15,0,20,5
1745784413587,LIGM 5B,A00,896260,Fischer-Grunski; Eva K,17,0,20,3
1745784414639,LIGM 5C,A00,896308,Fischer-Grunski; Eva K,18,0,20,2
1745784415667,LIIT 5AS,A00,896313,Carnelos; Chiara,18,0,20,2
1745784416691,LIIT 5BS,A00,896416,Carnelos; Chiara,20,0,20,0
1745784417717,LIIT 5CS,A00,896564,Carnelos; Chiara,20,0,20,0
1745784418745,LISP 5A,A00,896588,Munoz Sanchez; Alicia,4,0,20,16
1745784419769,LISP 5B,A00,896653,Munoz Sanchez; Alicia,10,0,20,10
1745784420798,LISP 5C,A00,896655,Munoz Sanchez; Alicia,4,0,20,16
1745784421821,MAE 197,001,957918,Kleissl; Jan,9998,0,9999,1
1745784422847,MATH 2,A01,957937,Staff,34,0,35,1
1745784423871,MATH 197,001,957876,Kedlaya; Kiran S.,9993,0,9999,6
1745784424895,MCWP 40,A00,892729,Duru; Nur,13,0,20,7
1745784424895,MCWP 40,B00,893304,Montejo; Carolina,20,0,20,0
1745784425922,MCWP 40R,A00,893757,Redela; Pamela Morgan,0,6,20,20
1745784426946,MCWP 50,A00,893758,Morshed; Michael James,2,0,20,18
1745784426946,MCWP 50,B00,893761,Bartulis; Jason Michael,17,0,20,3
1745784427976,MCWP 50R,A00,893766,Compas; Sean Matthew,0,1,20,20
1745784427976,MCWP 50R,B00,893769,Carter; Jennifer A,0,0,20,20
1745784427976,MCWP 50R,C00,893771,Krone; Jarret,0,3,20,20
1745784427976,MCWP 50R,D00,893772,Miller; Elizabeth Deen,3,0,20,17
1745784427976,MCWP 50R,E00,893775,Carter; Andrea L,0,0,20,20
1745784429005,MMW 11R,A01,892721,Herbst; Matthew,11,0,27,16
1745784429005,MMW 11R,A02,892722,Herbst; Matthew,0,0,0,3
1745784430033,MMW 12R,A01,892724,Herbst; Matthew,0,9,16,16
1745784430033,MMW 12R,A02,892725,Herbst; Matthew,0,9,16,16
1745784431061,MMW 13R,A01,892727,Staff,0,3,16,16
1745784431061,MMW 13R,A02,892728,Staff,0,4,16,16
1745784431061,MMW 13R,A03,958032,Staff,0,3,16,16
1745784431061,MMW 13R,A04,958033,Staff,0,2,16,16
1745784431061,MMW 13R,A05,958034,Staff,0,3,16,16
1745784432085,SIO 295LS,A00,894015,Staff,7,0,25,18
1745784433112,SIO 295S,A00,894020,Staff,7,0,25,18
1745784434141,SIOC 290S,B01,958918,Staff,0,0,0,0
1745784435164,SIOC 291S,B01,958922,Staff,0,0,0,0
1745784436188,SOCI 117,A01,895339,Staff,4,0,5,1
1745784437215,WES 237B,A00,894149,Staff,11,0,20,9
1745784439282,AESE 279B,A00,891859,Staff,13,0,35,22
1745784440309,AIP 197,001,891854,Staff,70,0,70,0
1745784441337,ANTH 289S,A00,891856,Gagneux; Pascal,12,0,12,0
1745784442363,BENG 196,001,957946,Engler; Adam J.,9996,0,9999,3
1745784443388,CAT 124RS,A01,956906,Staff,8,0,25,17
1745784444414,CAT 125RS,A01,922013,Staff,8,0,25,17
1745784445441,CLRE 250,A00,891860,Morris; Sheldon,9995,0,9999,4
1745784447490,CLRE 251R,A00,907817,Mehta; Ravindra L.,9994,0,9999,5
1745784448515,CLRE 252,A00,891864,Cuomo; Raphael Eduardo,9993,0,9999,6
1745784449541,CLRE 253,A00,891867,Vaida; Florin,9994,0,9999,5
1745784449541,CLRE 253,B00,907819,Staff,9999,0,9999,0
1745784450566,CLRE 259,A00,891868,Patel; Hemal,9998,0,9999,1
1745784451592,CLRE 260,A00,891872,Cuomo; Raphael Eduardo,9999,0,9999,0
1745784452618,CLRE 297,001,891888,Cuomo; Raphael Eduardo,9999,0,9999,0
1745784453645,CSE 191,A00,958773,Minnes Kemp; Mor Mia,9999,0,9999,0
1745784454669,CSS 201S,A01,892054,Mignozzetti; Umberto,30,0,30,0
1745784455694,CSS 202S,A01,892056,Mignozzetti; Umberto,30,0,30,0
1745784456738,DSC 197,001,956898,Eldridge; Justin Matthew,9998,0,9999,1
1745784457767,DSC 297,001,958000,Mazumdar; Arya,9998,0,9999,1
1745784458794,EAP 100,A00,905686,Staff,9776,0,9999,223
1745784459821,ECE 45,A01,892618,Staff,0,12,50,50
1745784460850,ECE 109,A01,892620,Staff,0,43,0,0
1745784461877,ECE 111,A01,892719,Staff,0,7,50,50
1745784462904,ECE 197,001,957920,Mercier; Patrick Philip,9992,0,9999,7
1745784463928,ECON 178,A01,907814,Zhu; Ying,28,0,35,7
1745784464954,EDS 115,A00,895312,Staff,41,0,45,4
1745784465981,EDS 117,A01,895337,Staff,30,0,30,0
1745784467009,EDS 125,A00,895341,Jones; Gabrielle Anastasia,43,0,45,2
1745784468036,EDS 128A,A01,895459,Fargason; Sharon Gayle,44,0,45,1
1745784469064,EDS 128B,A01,895543,Pappas; Elizabeth,44,0,45,1
1745784470089,EDS 139,A00,897203,Pappas; Elizabeth,44,0,45,1
1745784470089,EDS 139,B00,897209,Fargason; Sharon Gayle,44,0,45,1
1745784471113,EDS 201,A00,895545,Staff,43,0,45,2
1745784472137,EDS 203,A01,895581,Halter; Christopher P.,43,0,45,2
1745784473162,EDS 204R,A01,895625,Heinzman; Erica M.,44,0,45,1
1745784473162,EDS 204R,B01,895693,Halter; Christopher P.,18,0,45,27
1745784474187,EDS 206R,A00,895694,Fargason; Sharon Gayle,9,0,30,21
1745784474187,EDS 206R,B00,895695,Choi; Bailey Miyeon,20,0,30,10
1745784475213,EDS 250,A00,895697,Hemans; Patricia Ann Benitez,43,0,45,2
1745784476238,EDS 281,A00,895701,Meyerott; Theresa Ann,15,0,15,0
1745784477262,EDS 284,A00,895736,Meyerott; Theresa Ann,15,0,15,0
1745784478285,EDS 286,A00,897210,Fine; Sarah,15,0,15,0
1745784479312,EDS 289C,A01,895770,Daly; Alan J.,15,0,15,0
1745784480340,EDS 290,A00,897211,Hofstetter; Carolyn,15,0,15,0
1745784481366,LIGM 5A,A00,896162,Fischer-Grunski; Eva K,15,0,20,5
1745784482403,LIGM 5B,A00,896260,Fischer-Grunski; Eva K,17,0,20,3
1745784483428,LIGM 5C,A00,896308,Fischer-Grunski; Eva K,18,0,20,2
1745784484456,LIIT 5AS,A00,896313,Carnelos; Chiara,18,0,20,2
1745784485481,LIIT 5BS,A00,896416,Carnelos; Chiara,20,0,20,0
1745784486507,LIIT 5CS,A00,896564,Carnelos; Chiara,20,0,20,0
1745784487533,LISP 5A,A00,896588,Munoz Sanchez; Alicia,4,0,20,16
1745784488558,LISP 5B,A00,896653,Munoz Sanchez; Alicia,10,0,20,10
1745784489585,LISP 5C,A00,896655,Munoz Sanchez; Alicia,4,0,20,16
1745784490610,MAE 197,001,957918,Kleissl; Jan,9998,0,9999,1
1745784491636,MATH 2,A01,957937,Staff,34,0,35,1
1745784492663,MATH 197,001,957876,Kedlaya; Kiran S.,9993,0,9999,6
1745784493687,MCWP 40,A00,892729,Duru; Nur,13,0,20,7
1745784493687,MCWP 40,B00,893304,Montejo; Carolina,20,0,20,0
1745784494710,MCWP 40R,A00,893757,Redela; Pamela Morgan,0,6,20,20
1745784495734,MCWP 50,A00,893758,Morshed; Michael James,2,0,20,18
1745784495734,MCWP 50,B00,893761,Bartulis; Jason Michael,17,0,20,3
1745784496760,MCWP 50R,A00,893766,Compas; Sean Matthew,0,1,20,20
1745784496760,MCWP 50R,B00,893769,Carter; Jennifer A,0,0,20,20
1745784496760,MCWP 50R,C00,893771,Krone; Jarret,0,3,20,20
1745784496760,MCWP 50R,D00,893772,Miller; Elizabeth Deen,3,0,20,17
1745784496760,MCWP 50R,E00,893775,Carter; Andrea L,0,0,20,20
1745784497785,MMW 11R,A01,892721,Herbst; Matthew,11,0,27,16
1745784497785,MMW 11R,A02,892722,Herbst; Matthew,0,0,0,3
1745784498811,MMW 12R,A01,892724,Herbst; Matthew,0,9,16,16
1745784498811,MMW 12R,A02,892725,Herbst; Matthew,0,9,16,16
1745784499837,MMW 13R,A01,892727,Staff,0,3,16,16
1745784499837,MMW 13R,A02,892728,Staff,0,4,16,16
1745784499837,MMW 13R,A03,958032,Staff,0,3,16,16
1745784499837,MMW 13R,A04,958033,Staff,0,2,16,16
1745784499837,MMW 13R,A05,958034,Staff,0,3,16,16
1745784500865,SIO 295LS,A00,894015,Staff,7,0,25,18
1745784501892,SIO 295S,A00,894020,Staff,7,0,25,18
1745784502919,SIOC 290S,B01,958918,Staff,0,0,0,0
1745784503944,SIOC 291S,B01,958922,Staff,0,0,0,0
1745784504972,SOCI 117,A01,895339,Staff,4,0,5,1
1745784505998,WES 237B,A00,894149,Staff,11,0,20,9
1745784508055,AESE 279B,A00,891859,Staff,13,0,35,22
1745784509081,AIP 197,001,891854,Staff,70,0,70,0
1745784510107,ANTH 289S,A00,891856,Gagneux; Pascal,12,0,12,0
1745784511133,BENG 196,001,957946,Engler; Adam J.,9996,0,9999,3
1745784512162,CAT 124RS,A01,956906,Staff,8,0,25,17
1745784513188,CAT 125RS,A01,922013,Staff,8,0,25,17
1745784514214,CLRE 250,A00,891860,Morris; Sheldon,9995,0,9999,4
1745784516272,CLRE 251R,A00,907817,Mehta; Ravindra L.,9994,0,9999,5
1745784517299,CLRE 252,A00,891864,Cuomo; Raphael Eduardo,9993,0,9999,6
1745784518328,CLRE 253,A00,891867,Vaida; Florin,9994,0,9999,5
1745784518328,CLRE 253,B00,907819,Staff,9999,0,9999,0
1745784519355,CLRE 259,A00,891868,Patel; Hemal,9998,0,9999,1
1745784520382,CLRE 260,A00,891872,Cuomo; Raphael Eduardo,9999,0,9999,0
1745784521412,CLRE 297,001,891888,Cuomo; Raphael Eduardo,9999,0,9999,0
1745784522439,CSE 191,A00,958773,Minnes Kemp; Mor Mia,9999,0,9999,0
1745784523468,CSS 201S,A01,892054,Mignozzetti; Umberto,30,0,30,0
1745784524495,CSS 202S,A01,892056,Mignozzetti; Umberto,30,0,30,0
1745784525522,DSC 197,001,956898,Eldridge; Justin Matthew,9998,0,9999,1
1745784526548,DSC 297,001,958000,Mazumdar; Arya,9998,0,9999,1
1745784527576,EAP 100,A00,905686,Staff,9776,0,9999,223
1745784528606,ECE 45,A01,892618,Staff,0,12,50,50
1745784529631,ECE 109,A01,892620,Staff,0,43,0,0
1745784530660,ECE 111,A01,892719,Staff,0,7,50,50
1745784531685,ECE 197,001,957920,Mercier; Patrick Philip,9992,0,9999,7
1745784532716,ECON 178,A01,907814,Zhu; Ying,28,0,35,7
1745784533745,EDS 115,A00,895312,Staff,41,0,45,4
1745784534772,EDS 117,A01,895337,Staff,30,0,30,0
1745784535802,EDS 125,A00,895341,Jones; Gabrielle Anastasia,43,0,45,2
1745784536830,EDS 128A,A01,895459,Fargason; Sharon Gayle,44,0,45,1
1745784537854,EDS 128B,A01,895543,Pappas; Elizabeth,44,0,45,1
1745784538884,EDS 139,A00,897203,Pappas; Elizabeth,44,0,45,1
1745784538884,EDS 139,B00,897209,Fargason; Sharon Gayle,44,0,45,1
1745784539910,EDS 201,A00,895545,Staff,43,0,45,2
1745784540936,EDS 203,A01,895581,Halter; Christopher P.,43,0,45,2
1745784541970,EDS 204R,A01,895625,Heinzman; Erica M.,44,0,45,1
1745784541970,EDS 204R,B01,895693,Halter; Christopher P.,18,0,45,27
1745784543003,EDS 206R,A00,895694,Fargason; Sharon Gayle,9,0,30,21
1745784543003,EDS 206R,B00,895695,Choi; Bailey Miyeon,20,0,30,10
1745784544032,EDS 250,A00,895697,Hemans; Patricia Ann Benitez,43,0,45,2
1745784545058,EDS 281,A00,895701,Meyerott; Theresa Ann,15,0,15,0
1745784546084,EDS 284,A00,895736,Meyerott; Theresa Ann,15,0,15,0
1745784547113,EDS 286,A00,897210,Fine; Sarah,15,0,15,0
1745784548138,EDS 289C,A01,895770,Daly; Alan J.,15,0,15,0
1745784549167,EDS 290,A00,897211,Hofstetter; Carolyn,15,0,15,0
1745784550193,LIGM 5A,A00,896162,Fischer-Grunski; Eva K,15,0,20,5
1745784551225,LIGM 5B,A00,896260,Fischer-Grunski; Eva K,17,0,20,3
1745784552253,LIGM 5C,A00,896308,Fischer-Grunski; Eva K,18,0,20,2
1745784553281,LIIT 5AS,A00,896313,Carnelos; Chiara,18,0,20,2
1745784554335,LIIT 5BS,A00,896416,Carnelos; Chiara,20,0,20,0
1745784555361,LIIT 5CS,A00,896564,Carnelos; Chiara,20,0,20,0
1745784556389,LISP 5A,A00,896588,Munoz Sanchez; Alicia,4,0,20,16
1745784557414,LISP 5B,A00,896653,Munoz Sanchez; Alicia,10,0,20,10
1745784558440,LISP 5C,A00,896655,Munoz Sanchez; Alicia,4,0,20,16
1745784559463,MAE 197,001,957918,Kleissl; Jan,9998,0,9999,1
1745784560488,MATH 2,A01,957937,Staff,34,0,35,1
1745784561518,MATH 197,001,957876,Kedlaya; Kiran S.,9993,0,9999,6
1745784562545,MCWP 40,A00,892729,Duru; Nur,13,0,20,7
1745784562545,MCWP 40,B00,893304,Montejo; Carolina,20,0,20,0
1745784563571,MCWP 40R,A00,893757,Redela; Pamela Morgan,0,6,20,20
1745784564595,MCWP 50,A00,893758,Morshed; Michael James,2,0,20,18
1745784564595,MCWP 50,B00,893761,Bartulis; Jason Michael,17,0,20,3
1745784565620,MCWP 50R,A00,893766,Compas; Sean Matthew,0,1,20,20
1745784565620,MCWP 50R,B00,893769,Carter; Jennifer A,0,0,20,20
1745784565620,MCWP 50R,C00,893771,Krone; Jarret,0,3,20,20
1745784565620,MCWP 50R,D00,893772,Miller; Elizabeth Deen,3,0,20,17
1745784565620,MCWP 50R,E00,893775,Carter; Andrea L,0,0,20,20
1745784566648,MMW 11R,A01,892721,Herbst; Matthew,11,0,27,16
1745784566648,MMW 11R,A02,892722,Herbst; Matthew,0,0,0,3
1745784567673,MMW 12R,A01,892724,Herbst; Matthew,0,9,16,16
1745784567673,MMW 12R,A02,892725,Herbst; Matthew,0,9,16,16
1745784568700,MMW 13R,A01,892727,Staff,0,3,16,16
1745784568700,MMW 13R,A02,892728,Staff,0,4,16,16
1745784568700,MMW 13R,A03,958032,Staff,0,3,16,16
1745784568700,MMW 13R,A04,958033,Staff,0,2,16,16
1745784568700,MMW 13R,A05,958034,Staff,0,3,16,16
1745784569725,SIO 295LS,A00,894015,Staff,7,0,25,18
1745784570753,SIO 295S,A00,894020,Staff,7,0,25,18
1745784571781,SIOC 290S,B01,958918,Staff,0,0,0,0
1745784572813,SIOC 291S,B01,958922,Staff,0,0,0,0
1745784573838,SOCI 117,A01,895339,Staff,4,0,5,1
1745784574865,WES 237B,A00,894149,Staff,11,0,20,9
1745784576922,AESE 279B,A00,891859,Staff,13,0,35,22
1745784577945,AIP 197,001,891854,Staff,70,0,70,0
1745784578971,ANTH 289S,A00,891856,Gagneux; Pascal,12,0,12,0
1745784580003,BENG 196,001,957946,Engler; Adam J.,9996,0,9999,3
1745784581027,CAT 124RS,A01,956906,Staff,8,0,25,17
1745784582056,CAT 125RS,A01,922013,Staff,8,0,25,17
1745784583083,CLRE 250,A00,891860,Morris; Sheldon,9995,0,9999,4
1745784585139,CLRE 251R,A00,907817,Mehta; Ravindra L.,9994,0,9999,5
1745784586169,CLRE 252,A00,891864,Cuomo; Raphael Eduardo,9993,0,9999,6
1745784587197,CLRE 253,A00,891867,Vaida; Florin,9994,0,9999,5
1745784587197,CLRE 253,B00,907819,Staff,9999,0,9999,0
1745784588225,CLRE 259,A00,891868,Patel; Hemal,9998,0,9999,1
1745784589250,CLRE 260,A00,891872,Cuomo; Raphael Eduardo,9999,0,9999,0
1745784590278,CLRE 297,001,891888,Cuomo; Raphael Eduardo,9999,0,9999,0
1745784591304,CSE 191,A00,958773,Minnes Kemp; Mor Mia,9999,0,9999,0
1745784592334,CSS 201S,A01,892054,Mignozzetti; Umberto,30,0,30,0
1745784593361,CSS 202S,A01,892056,Mignozzetti; Umberto,30,0,30,0
1745784594388,DSC 197,001,956898,Eldridge; Justin Matthew,9998,0,9999,1
1745784595413,DSC 297,001,958000,Mazumdar; Arya,9998,0,9999,1
1745784596441,EAP 100,A00,905686,Staff,9776,0,9999,223
1745784597468,ECE 45,A01,892618,Staff,0,12,50,50
1745784598494,ECE 109,A01,892620,Staff,0,43,0,0
1745784599522,ECE 111,A01,892719,Staff,0,7,50,50
1745784600550,ECE 197,001,957920,Mercier; Patrick Philip,9992,0,9999,7
1745784601579,ECON 178,A01,907814,Zhu; Ying,28,0,35,7
1745784602610,EDS 115,A00,895312,Staff,41,0,45,4
1745784603637,EDS 117,A01,895337,Staff,30,0,30,0
1745784604665,EDS 125,A00,895341,Jones; Gabrielle Anastasia,43,0,45,2
1745784605696,EDS 128A,A01,895459,Fargason; Sharon Gayle,44,0,45,1
1745784606724,EDS 128B,A01,895543,Pappas; Elizabeth,44,0,45,1
1745784607755,EDS 139,A00,897203,Pappas; Elizabeth,44,0,45,1
1745784607755,EDS 139,B00,897209,Fargason; Sharon Gayle,44,0,45,1
1745784608781,EDS 201,A00,895545,Staff,43,0,45,2
1745784609810,EDS 203,A01,895581,Halter; Christopher P.,43,0,45,2
1745784610841,EDS 204R,A01,895625,Heinzman; Erica M.,44,0,45,1
1745784610841,EDS 204R,B01,895693,Halter; Christopher P.,18,0,45,27
1745784611869,EDS 206R,A00,895694,Fargason; Sharon Gayle,9,0,30,21
1745784611869,EDS 206R,B00,895695,Choi; Bailey Miyeon,20,0,30,10
1745784612897,EDS 250,A00,895697,Hemans; Patricia Ann Benitez,43,0,45,2
1745784613922,EDS 281,A00,895701,Meyerott; Theresa Ann,15,0,15,0
1745784614949,EDS 284,A00,895736,Meyerott; Theresa Ann,15,0,15,0
1745784615975,EDS 286,A00,897210,Fine; Sarah,15,0,15,0
1745784617003,EDS 289C,A01,895770,Daly; Alan J.,15,0,15,0
1745784618033,EDS 290,A00,897211,Hofstetter; Carolyn,15,0,15,0
1745784619061,LIGM 5A,A00,896162,Fischer-Grunski; Eva K,15,0,20,5
1745784620090,LIGM 5B,A00,896260,Fischer-Grunski; Eva K,17,0,20,3
1745784621117,LIGM 5C,A00,896308,Fischer-Grunski; Eva K,18,0,20,2
1745784622143,LIIT 5AS,A00,896313,Carnelos; Chiara,18,0,20,2
1745784623168,LIIT 5BS,A00,896416,Carnelos; Chiara,20,0,20,0
1745784624194,LIIT 5CS,A00,896564,Carnelos; Chiara,20,0,20,0
1745784625221,LISP 5A,A00,896588,Munoz Sanchez; Alicia,4,0,20,16
1745784626251,LISP 5B,A00,896653,Munoz Sanchez; Alicia,10,0,20,10
1745784627275,LISP 5C,A00,896655,Munoz Sanchez; Alicia,4,0,20,16
1745784628300,MAE 197,001,957918,Kleissl; Jan,9998,0,9999,1
1745784629326,MATH 2,A01,957937,Staff,34,0,35,1
1745784630354,MATH 197,001,957876,Kedlaya; Kiran S.,9993,0,9999,6
1745784631379,MCWP 40,A00,892729,Duru; Nur,13,0,20,7
1745784631379,MCWP 40,B00,893304,Montejo; Carolina,20,0,20,0
1745784632404,MCWP 40R,A00,893757,Redela; Pamela Morgan,0,6,20,20
1745784633434,MCWP 50,A00,893758,Morshed; Michael James,2,0,20,18
1745784633434,MCWP 50,B00,893761,Bartulis; Jason Michael,17,0,20,3
1745784634461,MCWP 50R,A00,893766,Compas; Sean Matthew,0,1,20,20
1745784634461,MCWP 50R,B00,893769,Carter; Jennifer A,0,0,20,20
1745784634461,MCWP 50R,C00,893771,Krone; Jarret,0,3,20,20
1745784634461,MCWP 50R,D00,893772,Miller; Elizabeth Deen,3,0,20,17
1745784634461,MCWP 50R,E00,893775,Carter; Andrea L,0,0,20,20
1745784635491,MMW 11R,A01,892721,Herbst; Matthew,11,0,27,16
1745784635491,MMW 11R,A02,892722,Herbst; Matthew,0,0,0,3
1745784636517,MMW 12R,A01,892724,Herbst; Matthew,0,9,16,16
1745784636517,MMW 12R,A02,892725,Herbst; Matthew,0,9,16,16
1745784637545,MMW 13R,A01,892727,Staff,0,3,16,16
1745784637545,MMW 13R,A02,892728,Staff,0,4,16,16
1745784637545,MMW 13R,A03,958032,Staff,0,3,16,16
1745784637545,MMW 13R,A04,958033,Staff,0,2,16,16
1745784637545,MMW 13R,A05,958034,Staff,0,3,16,16
1745784638571,SIO 295LS,A00,894015,Staff,7,0,25,18
1745784639598,SIO 295S,A00,894020,Staff,7,0,25,18
1745784640626,SIOC 290S,B01,958918,Staff,0,0,0,0
1745784641653,SIOC 291S,B01,958922,Staff,0,0,0,0
1745784642678,SOCI 117,A01,895339,Staff,4,0,5,1
1745784643705,WES 237B,A00,894149,Staff,11,0,20,9
1745784645771,AESE 279B,A00,891859,Staff,13,0,35,22
1745784646799,AIP 197,001,891854,Staff,70,0,70,0
1745784647825,ANTH 289S,A00,891856,Gagneux; Pascal,12,0,12,0
1745784648853,BENG 196,001,957946,Engler; Adam J.,9996,0,9999,3
1745784649883,CAT 124RS,A01,956906,Staff,8,0,25,17
1745784650911,CAT 125RS,A01,922013,Staff,8,0,25,17
1745784651938,CLRE 250,A00,891860,Morris; Sheldon,9995,0,9999,4
1745784653996,CLRE 251R,A00,907817,Mehta; Ravindra L.,9994,0,9999,5
1745784655025,CLRE 252,A00,891864,Cuomo; Raphael Eduardo,9993,0,9999,6
1745784656051,CLRE 253,A00,891867,Vaida; Florin,9994,0,9999,5
1745784656051,CLRE 253,B00,907819,Staff,9999,0,9999,0
1745784657077,CLRE 259,A00,891868,Patel; Hemal,9998,0,9999,1
1745784658105,CLRE 260,A00,891872,Cuomo; Raphael Eduardo,9999,0,9999,0
1745784659132,CLRE 297,001,891888,Cuomo; Raphael Eduardo,9999,0,9999,0
1745784660157,CSE 191,A00,958773,Minnes Kemp; Mor Mia,9999,0,9999,0
1745784661183,CSS 201S,A01,892054,Mignozzetti; Umberto,30,0,30,0
1745784662210,CSS 202S,A01,892056,Mignozzetti; Umberto,30,0,30,0
1745784663236,DSC 197,001,956898,Eldridge; Justin Matthew,9998,0,9999,1
1745784664268,DSC 297,001,958000,Mazumdar; Arya,9998,0,9999,1
1745784665295,EAP 100,A00,905686,Staff,9776,0,9999,223
1745784666321,ECE 45,A01,892618,Staff,0,12,50,50
1745784667349,ECE 109,A01,892620,Staff,0,43,0,0
1745784668376,ECE 111,A01,892719,Staff,0,7,50,50
1745784669402,ECE 197,001,957920,Mercier; Patrick Philip,9992,0,9999,7
1745784670433,ECON 178,A01,907814,Zhu; Ying,28,0,35,7
1745784671461,EDS 115,A00,895312,Staff,41,0,45,4
1745784672488,EDS 117,A01,895337,Staff,30,0,30,0
1745784673515,EDS 125,A00,895341,Jones; Gabrielle Anastasia,43,0,45,2
1745784674541,EDS 128A,A01,895459,Fargason; Sharon Gayle,44,0,45,1
1745784675569,EDS 128B,A01,895543,Pappas; Elizabeth,44,0,45,1
1745784676596,EDS 139,A00,897203,Pappas; Elizabeth,44,0,45,1
1745784676596,EDS 139,B00,897209,Fargason; Sharon Gayle,44,0,45,1
1745784677624,EDS 201,A00,895545,Staff,43,0,45,2
1745784678650,EDS 203,A01,895581,Halter; Christopher P.,43,0,45,2
1745784679676,EDS 204R,A01,895625,Heinzman; Erica M.,44,0,45,1
1745784679676,EDS 204R,B01,895693,Halter; Christopher P.,18,0,45,27
1745784680702,EDS 206R,A00,895694,Fargason; Sharon Gayle,9,0,30,21
1745784680702,EDS 206R,B00,895695,Choi; Bailey Miyeon,20,0,30,10
1745784681732,EDS 250,A00,895697,Hemans; Patricia Ann Benitez,43,0,45,2
1745784682759,EDS 281,A00,895701,Meyerott; Theresa Ann,15,0,15,0
1745784683785,EDS 284,A00,895736,Meyerott; Theresa Ann,15,0,15,0
1745784684815,EDS 286,A00,897210,Fine; Sarah,15,0,15,0
1745784685843,EDS 289C,A01,895770,Daly; Alan J.,15,0,15,0
1745784686869,EDS 290,A00,897211,Hofstetter; Carolyn,15,0,15,0
1745784687898,LIGM 5A,A00,896162,Fischer-Grunski; Eva K,15,0,20,5
1745784688926,LIGM 5B,A00,896260,Fischer-Grunski; Eva K,17,0,20,3
1745784689954,LIGM 5C,A00,896308,Fischer-Grunski; Eva K,18,0,20,2
1745784690982,LIIT 5AS,A00,896313,Carnelos; Chiara,18,0,20,2
1745784692012,LIIT 5BS,A00,896416,Carnelos; Chiara,20,0,20,0
1745784693036,LIIT 5CS,A00,896564,Carnelos; Chiara,20,0,20,0
1745784694063,LISP 5A,A00,896588,Munoz Sanchez; Alicia,4,0,20,16
1745784695093,LISP 5B,A00,896653,Munoz Sanchez; Alicia,10,0,20,10
1745784696125,LISP 5C,A00,896655,Munoz Sanchez; Alicia,4,0,20,16
1745784697154,MAE 197,001,957918,Kleissl; Jan,9998,0,9999,1
1745784698184,MATH 2,A01,957937,Staff,34,0,35,1
1745784699211,MATH 197,001,957876,Kedlaya; Kiran S.,9993,0,9999,6
1745784700241,MCWP 40,A00,892729,Duru; Nur,13,0,20,7
1745784700241,MCWP 40,B00,893304,Montejo; Carolina,20,0,20,0
1745784701270,MCWP 40R,A00,893757,Redela; Pamela Morgan,0,6,20,20
1745784702296,MCWP 50,A00,893758,Morshed; Michael James,2,0,20,18
1745784702296,MCWP 50,B00,893761,Bartulis; Jason Michael,17,0,20,3
1745784703326,MCWP 50R,A00,893766,Compas; Sean Matthew,0,1,20,20
1745784703326,MCWP 50R,B00,893769,Carter; Jennifer A,0,0,20,20
1745784703326,MCWP 50R,C00,893771,Krone; Jarret,0,3,20,20
1745784703326,MCWP 50R,D00,893772,Miller; Elizabeth Deen,3,0,20,17
1745784703326,MCWP 50R,E00,893775,Carter; Andrea L,0,0,20,20
1745784704355,MMW 11R,A01,892721,Herbst; Matthew,11,0,27,16
1745784704355,MMW 11R,A02,892722,Herbst; Matthew,0,0,0,3
1745784705382,MMW 12R,A01,892724,Herbst; Matthew,0,9,16,16
1745784705382,MMW 12R,A02,892725,Herbst; Matthew,0,9,16,16
1745784706411,MMW 13R,A01,892727,Staff,0,3,16,16
1745784706411,MMW 13R,A02,892728,Staff,0,4,16,16
1745784706411,MMW 13R,A03,958032,Staff,0,3,16,16
1745784706411,MMW 13R,A04,958033,Staff,0,2,16,16
1745784706411,MMW 13R,A05,958034,Staff,0,3,16,16
1745784707436,SIO 295LS,A00,894015,Staff,7,0,25,18
1745784708465,SIO 295S,A00,894020,Staff,7,0,25,18
1745784709494,SIOC 290S,B01,958918,Staff,0,0,0,0
1745784710522,SIOC 291S,B01,958922,Staff,0,0,0,0
1745784711546,SOCI 117,A01,895339,Staff,4,0,5,1
1745784712572,WES 237B,A00,894149,Staff,11,0,20,9
1745784714637,AESE 279B,A00,891859,Staff,13,0,35,22
1745784715660,AIP 197,001,891854,Staff,70,0,70,0
1745784716686,ANTH 289S,A00,891856,Gagneux; Pascal,12,0,12,0
1745784717711,BENG 196,001,957946,Engler; Adam J.,9996,0,9999,3
1745784718738,CAT 124RS,A01,956906,Staff,8,0,25,17
1745784719763,CAT 125RS,A01,922013,Staff,8,0,25,17
1745784720788,CLRE 250,A00,891860,Morris; Sheldon,9995,0,9999,4
1745784722855,CLRE 251R,A00,907817,Mehta; Ravindra L.,9994,0,9999,5
1745784723883,CLRE 252,A00,891864,Cuomo; Raphael Eduardo,9993,0,9999,6
1745784724912,CLRE 253,A00,891867,Vaida; Florin,9994,0,9999,5
1745784724912,CLRE 253,B00,907819,Staff,9999,0,9999,0
1745784725942,CLRE 259,A00,891868,Patel; Hemal,9998,0,9999,1
1745784726967,CLRE 260,A00,891872,Cuomo; Raphael Eduardo,9999,0,9999,0
1745784727994,CLRE 297,001,891888,Cuomo; Raphael Eduardo,9999,0,9999,0
1745784729024,CSE 191,A00,958773,Minnes Kemp; Mor Mia,9999,0,9999,0
1745784730053,CSS 201S,A01,892054,Mignozzetti; Umberto,30,0,30,0
1745784731081,CSS 202S,A01,892056,Mignozzetti; Umberto,30,0,30,0
1745784732106,DSC 197,001,956898,Eldridge; Justin Matthew,9998,0,9999,1
1745784733130,DSC 297,001,958000,Mazumdar; Arya,9998,0,9999,1
1745784734157,EAP 100,A00,905686,Staff,9776,0,9999,223
1745784735185,ECE 45,A01,892618,Staff,0,12,50,50
1745784736211,ECE 109,A01,892620,Staff,0,43,0,0
1745784737240,ECE 111,A01,892719,Staff,0,7,50,50
1745784738267,ECE 197,001,957920,Mercier; Patrick Philip,9992,0,9999,7
1745784739297,ECON 178,A01,907814,Zhu; Ying,28,0,35,7
1745784740322,EDS 115,A00,895312,Staff,41,0,45,4
1745784741375,EDS 117,A01,895337,Staff,30,0,30,0
1745784742402,EDS 125,A00,895341,Jones; Gabrielle Anastasia,43,0,45,2
1745784743428,EDS 128A,A01,895459,Fargason; Sharon Gayle,44,0,45,1
1745784744453,EDS 128B,A01,895543,Pappas; Elizabeth,44,0,45,1
1745784745481,EDS 139,A00,897203,Pappas; Elizabeth,44,0,45,1
1745784745481,EDS 139,B00,897209,Fargason; Sharon Gayle,44,0,45,1
1745784746507,EDS 201,A00,895545,Staff,43,0,45,2
1745784747534,EDS 203,A01,895581,Halter; Christopher P.,43,0,45,2
1745784748559,EDS 204R,A01,895625,Heinzman; Erica M.,44,0,45,1
1745784748559,EDS 204R,B01,895693,Halter; Christopher P.,18,0,45,27
1745784749585,EDS 206R,A00,895694,Fargason; Sharon Gayle,9,0,30,21
1745784749585,EDS 206R,B00,895695,Choi; Bailey Miyeon,20,0,30,10
1745784750610,EDS 250,A00,895697,Hemans; Patricia Ann Benitez,43,0,45,2
1745784751638,EDS 281,A00,895701,Meyerott; Theresa Ann,15,0,15,0
1745784752662,EDS 284,A00,895736,Meyerott; Theresa Ann,15,0,15,0
1745784753690,EDS 286,A00,897210,Fine; Sarah,15,0,15,0
1745784754718,EDS 289C,A01,895770,Daly; Alan J.,15,0,15,0
1745784755743,EDS 290,A00,897211,Hofstetter; Carolyn,15,0,15,0
1745784756767,LIGM 5A,A00,896162,Fischer-Grunski; Eva K,15,0,20,5
1745784757793,LIGM 5B,A00,896260,Fischer-Grunski; Eva K,17,0,20,3
1745784758821,LIGM 5C,A00,896308,Fischer-Grunski; Eva K,18,0,20,2
1745784759849,LIIT 5AS,A00,896313,Carnelos; Chiara,18,0,20,2
1745784760875,LIIT 5BS,A00,896416,Carnelos; Chiara,20,0,20,0
1745784761906,LIIT 5CS,A00,896564,Carnelos; Chiara,20,0,20,0
1745784762933,LISP 5A,A00,896588,Munoz Sanchez; Alicia,4,0,20,16
1745784763957,LISP 5B,A00,896653,Munoz Sanchez; Alicia,10,0,20,10
1745784764981,LISP 5C,A00,896655,Munoz Sanchez; Alicia,4,0,20,16
1745784766007,MAE 197,001,957918,Kleissl; Jan,9998,0,9999,1
1745784767030,MATH 2,A01,957937,Staff,34,0,35,1
1745784768056,MATH 197,001,957876,Kedlaya; Kiran S.,9993,0,9999,6
1745784769081,MCWP 40,A00,892729,Duru; Nur,13,0,20,7
1745784769081,MCWP 40,B00,893304,Montejo; Carolina,20,0,20,0
1745784770105,MCWP 40R,A00,893757,Redela; Pamela Morgan,0,6,20,20
1745784771128,MCWP 50,A00,893758,Morshed; Michael James,2,0,20,18
1745784771128,MCWP 50,B00,893761,Bartulis; Jason Michael,17,0,20,3
1745784772154,MCWP 50R,A00,893766,Compas; Sean Matthew,0,1,20,20
1745784772154,MCWP 50R,B00,893769,Carter; Jennifer A,0,0,20,20
1745784772154,MCWP 50R,C00,893771,Krone; Jarret,0,3,20,20
1745784772154,MCWP 50R,D00,893772,Miller; Elizabeth Deen,3,0,20,17
1745784772154,MCWP 50R,E00,893775,Carter; Andrea L,0,0,20,20
1745784773180,MMW 11R,A01,892721,Herbst; Matthew,11,0,27,16
1745784773180,MMW 11R,A02,892722,Herbst; Matthew,0,0,0,3
1745784774206,MMW 12R,A01,892724,Herbst; Matthew,0,9,16,16
1745784774206,MMW 12R,A02,892725,Herbst; Matthew,0,9,16,16
1745784775232,MMW 13R,A01,892727,Staff,0,3,16,16
1745784775232,MMW 13R,A02,892728,Staff,0,4,16,16
1745784775232,MMW 13R,A03,958032,Staff,0,3,16,16
1745784775232,MMW 13R,A04,958033,Staff,0,2,16,16
1745784775232,MMW 13R,A05,958034,Staff,0,3,16,16
1745784776262,SIO 295LS,A00,894015,Staff,7,0,25,18
1745784777289,SIO 295S,A00,894020,Staff,7,0,25,18
1745784778318,SIOC 290S,B01,958918,Staff,0,0,0,0
1745784779348,SIOC 291S,B01,958922,Staff,0,0,0,0
1745784780372,SOCI 117,A01,895339,Staff,4,0,5,1
1745784781400,WES 237B,A00,894149,Staff,11,0,20,9
1745784783477,AESE 279B,A00,891859,Staff,13,0,35,22
1745784784502,AIP 197,001,891854,Staff,70,0,70,0
1745784785527,ANTH 289S,A00,891856,Gagneux; Pascal,12,0,12,0
1745784786552,BENG 196,001,957946,Engler; Adam J.,9996,0,9999,3
1745784787576,CAT 124RS,A01,956906,Staff,8,0,25,17
1745784788601,CAT 125RS,A01,922013,Staff,8,0,25,17
1745784789625,CLRE 250,A00,891860,Morris; Sheldon,9995,0,9999,4
1745784791676,CLRE 251R,A00,907817,Mehta; Ravindra L.,9994,0,9999,5
1745784792701,CLRE 252,A00,891864,Cuomo; Raphael Eduardo,9993,0,9999,6
1745784793726,CLRE 253,A00,891867,Vaida; Florin,9994,0,9999,5
1745784793726,CLRE 253,B00,907819,Staff,9999,0,9999,0
1745784794753,CLRE 259,A00,891868,Patel; Hemal,9998,0,9999,1
1745784795776,CLRE 260,A00,891872,Cuomo; Raphael Eduardo,9999,0,9999,0
1745784796804,CLRE 297,001,891888,Cuomo; Raphael Eduardo,9999,0,9999,0
1745784797830,CSE 191,A00,958773,Minnes Kemp; Mor Mia,9999,0,9999,0
1745784798860,CSS 201S,A01,892054,Mignozzetti; Umberto,30,0,30,0
1745784799895,CSS 202S,A01,892056,Mignozzetti; Umberto,30,0,30,0
1745784800925,DSC 197,001,956898,Eldridge; Justin Matthew,9998,0,9999,1
1745784801951,DSC 297,001,958000,Mazumdar; Arya,9998,0,9999,1
1745784802978,EAP 100,A00,905686,Staff,9776,0,9999,223
1745784804006,ECE 45,A01,892618,Staff,0,12,50,50
1745784805033,ECE 109,A01,892620,Staff,0,43,0,0
1745784806063,ECE 111,A01,892719,Staff,0,7,50,50
1745784807091,ECE 197,001,957920,Mercier; Patrick Philip,9992,0,9999,7
1745784808117,ECON 178,A01,907814,Zhu; Ying,28,0,35,7
1745784809145,EDS 115,A00,895312,Staff,41,0,45,4
1745784810173,EDS 117,A01,895337,Staff,30,0,30,0
1745784811202,EDS 125,A00,895341,Jones; Gabrielle Anastasia,43,0,45,2
1745784812231,EDS 128A,A01,895459,Fargason; Sharon Gayle,44,0,45,1
1745784813258,EDS 128B,A01,895543,Pappas; Elizabeth,44,0,45,1
1745784814289,EDS 139,A00,897203,Pappas; Elizabeth,44,0,45,1
1745784814289,EDS 139,B00,897209,Fargason; Sharon Gayle,44,0,45,1
1745784815317,EDS 201,A00,895545,Staff,43,0,45,2
1745784816348,EDS 203,A01,895581,Halter; Christopher P.,43,0,45,2
1745784817373,EDS 204R,A01,895625,Heinzman; Erica M.,44,0,45,1
1745784817373,EDS 204R,B01,895693,Halter; Christopher P.,18,0,45,27
1745784818402,EDS 206R,A00,895694,Fargason; Sharon Gayle,9,0,30,21
1745784818402,EDS 206R,B00,895695,Choi; Bailey Miyeon,20,0,30,10
1745784819428,EDS 250,A00,895697,Hemans; Patricia Ann Benitez,43,0,45,2
1745784820456,EDS 281,A00,895701,Meyerott; Theresa Ann,15,0,15,0
1745784821486,EDS 284,A00,895736,Meyerott; Theresa Ann,15,0,15,0
1745784822513,EDS 286,A00,897210,Fine; Sarah,15,0,15,0
1745784823538,EDS 289C,A01,895770,Daly; Alan J.,15,0,15,0
1745784824564,EDS 290,A00,897211,Hofstetter; Carolyn,15,0,15,0
1745784825592,LIGM 5A,A00,896162,Fischer-Grunski; Eva K,15,0,20,5
1745784826617,LIGM 5B,A00,896260,Fischer-Grunski; Eva K,17,0,20,3
1745784827643,LIGM 5C,A00,896308,Fischer-Grunski; Eva K,18,0,20,2
1745784828670,LIIT 5AS,A00,896313,Carnelos; Chiara,18,0,20,2
1745784829697,LIIT 5BS,A00,896416,Carnelos; Chiara,20,0,20,0
1745784830725,LIIT 5CS,A00,896564,Carnelos; Chiara,20,0,20,0
1745784831750,LISP 5A,A00,896588,Munoz Sanchez; Alicia,4,0,20,16
1745784832777,LISP 5B,A00,896653,Munoz Sanchez; Alicia,10,0,20,10
1745784833808,LISP 5C,A00,896655,Munoz Sanchez; Alicia,4,0,20,16
1745784834834,MAE 197,001,957918,Kleissl; Jan,9998,0,9999,1
1745784835864,MATH 2,A01,957937,Staff,34,0,35,1
1745784836889,MATH 197,001,957876,Kedlaya; Kiran S.,9993,0,9999,6
1745784837918,MCWP 40,A00,892729,Duru; Nur,13,0,20,7
1745784837918,MCWP 40,B00,893304,Montejo; Carolina,20,0,20,0
1745784838948,MCWP 40R,A00,893757,Redela; Pamela Morgan,0,6,20,20
1745784839974,MCWP 50,A00,893758,Morshed; Michael James,2,0,20,18
1745784839974,MCWP 50,B00,893761,Bartulis; Jason Michael,17,0,20,3
1745784841004,MCWP 50R,A00,893766,Compas; Sean Matthew,0,1,20,20
1745784841004,MCWP 50R,B00,893769,Carter; Jennifer A,0,0,20,20
1745784841004,MCWP 50R,C00,893771,Krone; Jarret,0,3,20,20
1745784841004,MCWP 50R,D00,893772,Miller; Elizabeth Deen,3,0,20,17
1745784841004,MCWP 50R,E00,893775,Carter; Andrea L,0,0,20,20
1745784842034,MMW 11R,A01,892721,Herbst; Matthew,11,0,27,16
1745784842034,MMW 11R,A02,892722,Herbst; Matthew,0,0,0,3
1745784843063,MMW 12R,A01,892724,Herbst; Matthew,0,9,16,16
1745784843063,MMW 12R,A02,892725,Herbst; Matthew,0,9,16,16
1745784844096,MMW 13R,A01,892727,Staff,0,3,16,16
1745784844096,MMW 13R,A02,892728,Staff,0,4,16,16
1745784844096,MMW 13R,A03,958032,Staff,0,3,16,16
1745784844096,MMW 13R,A04,958033,Staff,0,2,16,16
1745784844096,MMW 13R,A05,958034,Staff,0,3,16,16
1745784845127,SIO 295LS,A00,894015,Staff,7,0,25,18
1745784846155,SIO 295S,A00,894020,Staff,7,0,25,18
1745784847183,SIOC 290S,B01,958918,Staff,0,0,0,0
1745784848215,SIOC 291S,B01,958922,Staff,0,0,0,0
1745784849241,SOCI 117,A01,895339,Staff,4,0,5,1
1745784850267,WES 237B,A00,894149,Staff,11,0,20,9
1745784852337,AESE 279B,A00,891859,Staff,13,0,35,22
1745784853370,AIP 197,001,891854,Staff,70,0,70,0
1745784854395,ANTH 289S,A00,891856,Gagneux; Pascal,12,0,12,0
1745784855420,BENG 196,001,957946,Engler; Adam J.,9996,0,9999,3
1745784856445,CAT 124RS,A01,956906,Staff,8,0,25,17
1745784857473,CAT 125RS,A01,922013,Staff,8,0,25,17
1745784858496,CLRE 250,A00,891860,Morris; Sheldon,9995,0,9999,4
1745784860550,CLRE 251R,A00,907817,Mehta; Ravindra L.,9994,0,9999,5
1745784861576,CLRE 252,A00,891864,Cuomo; Raphael Eduardo,9993,0,9999,6
1745784862604,CLRE 253,A00,891867,Vaida; Florin,9994,0,9999,5
1745784862604,CLRE 253,B00,907819,Staff,9999,0,9999,0
1745784863630,CLRE 259,A00,891868,Patel; Hemal,9998,0,9999,1
1745784864658,CLRE 260,A00,891872,Cuomo; Raphael Eduardo,9999,0,9999,0
1745784865685,CLRE 297,001,891888,Cuomo; Raphael Eduardo,9999,0,9999,0
1745784866712,CSE 191,A00,958773,Minnes Kemp; Mor Mia,9999,0,9999,0
1745784867742,CSS 201S,A01,892054,Mignozzetti; Umberto,30,0,30,0
1745784868769,CSS 202S,A01,892056,Mignozzetti; Umberto,30,0,30,0
1745784869802,DSC 197,001,956898,Eldridge; Justin Matthew,9998,0,9999,1
1745784870829,DSC 297,001,958000,Mazumdar; Arya,9998,0,9999,1
1745784871856,EAP 100,A00,905686,Staff,9776,0,9999,223
1745784872881,ECE 45,A01,892618,Staff,0,12,50,50
1745784873911,ECE 109,A01,892620,Staff,0,43,0,0
1745784874937,ECE 111,A01,892719,Staff,0,7,50,50
1745784875967,ECE 197,001,957920,Mercier; Patrick Philip,9992,0,9999,7
1745784876995,ECON 178,A01,907814,Zhu; Ying,28,0,35,7
1745784878024,EDS 115,A00,895312,Staff,41,0,45,4
1745784879055,EDS 117,A01,895337,Staff,30,0,30,0
1745784880082,EDS 125,A00,895341,Jones; Gabrielle Anastasia,43,0,45,2
1745784881111,EDS 128A,A01,895459,Fargason; Sharon Gayle,44,0,45,1
1745784882140,EDS 128B,A01,895543,Pappas; Elizabeth,44,0,45,1
1745784883168,EDS 139,A00,897203,Pappas; Elizabeth,44,0,45,1
1745784883168,EDS 139,B00,897209,Fargason; Sharon Gayle,44,0,45,1
1745784884197,EDS 201,A00,895545,Staff,43,0,45,2
1745784885224,EDS 203,A01,895581,Halter; Christopher P.,43,0,45,2
1745784886250,EDS 204R,A01,895625,Heinzman; Erica M.,44,0,45,1
1745784886250,EDS 204R,B01,895693,Halter; Christopher P.,18,0,45,27
1745784887277,EDS 206R,A00,895694,Fargason; Sharon Gayle,9,0,30,21
1745784887277,EDS 206R,B00,895695,Choi; Bailey Miyeon,20,0,30,10
1745784888304,EDS 250,A00,895697,Hemans; Patricia Ann Benitez,43,0,45,2
1745784889333,EDS 281,A00,895701,Meyerott; Theresa Ann,15,0,15,0
1745784890360,EDS 284,A00,895736,Meyerott; Theresa Ann,15,0,15,0
1745784891386,EDS 286,A00,897210,Fine; Sarah,15,0,15,0
1745784892415,EDS 289C,A01,895770,Daly; Alan J.,15,0,15,0
1745784893443,EDS 290,A00,897211,Hofstetter; Carolyn,15,0,15,0
1745784894470,LIGM 5A,A00,896162,Fischer-Grunski; Eva K,15,0,20,5
1745784895497,LIGM 5B,A00,896260,Fischer-Grunski; Eva K,17,0,20,3
1745784896523,LIGM 5C,A00,896308,Fischer-Grunski; Eva K,18,0,20,2
1745784897550,LIIT 5AS,A00,896313,Carnelos; Chiara,18,0,20,2
1745784898576,LIIT 5BS,A00,896416,Carnelos; Chiara,20,0,20,0
1745784899603,LIIT 5CS,A00,896564,Carnelos; Chiara,20,0,20,0
1745784900633,LISP 5A,A00,896588,Munoz Sanchez; Alicia,4,0,20,16
1745784901661,LISP 5B,A00,896653,Munoz Sanchez; Alicia,10,0,20,10
1745784902685,LISP 5C,A00,896655,Munoz Sanchez; Alicia,4,0,20,16
1745784903714,MAE 197,001,957918,Kleissl; Jan,9998,0,9999,1
1745784904743,MATH 2,A01,957937,Staff,34,0,35,1
1745784905776,MATH 197,001,957876,Kedlaya; Kiran S.,9993,0,9999,6
1745784906803,MCWP 40,A00,892729,Duru; Nur,13,0,20,7
1745784906803,MCWP 40,B00,893304,Montejo; Carolina,20,0,20,0
1745784907828,MCWP 40R,A00,893757,Redela; Pamela Morgan,0,6,20,20
1745784908855,MCWP 50,A00,893758,Morshed; Michael James,2,0,20,18
1745784908855,MCWP 50,B00,893761,Bartulis; Jason Michael,17,0,20,3
1745784909887,MCWP 50R,A00,893766,Compas; Sean Matthew,0,1,20,20
1745784909887,MCWP 50R,B00,893769,Carter; Jennifer A,0,0,20,20
1745784909887,MCWP 50R,C00,893771,Krone; Jarret,0,3,20,20
1745784909887,MCWP 50R,D00,893772,Miller; Elizabeth Deen,3,0,20,17
1745784909887,MCWP 50R,E00,893775,Carter; Andrea L,0,0,20,20
1745784910914,MMW 11R,A01,892721,Herbst; Matthew,11,0,27,16
1745784910914,MMW 11R,A02,892722,Herbst; Matthew,0,0,0,3
1745784911941,MMW 12R,A01,892724,Herbst; Matthew,0,9,16,16
1745784911941,MMW 12R,A02,892725,Herbst; Matthew,0,9,16,16
1745784912969,MMW 13R,A01,892727,Staff,0,3,16,16
1745784912969,MMW 13R,A02,892728,Staff,0,4,16,16
1745784912969,MMW 13R,A03,958032,Staff,0,3,16,16
1745784912969,MMW 13R,A04,958033,Staff,0,2,16,16
1745784912969,MMW 13R,A05,958034,Staff,0,3,16,16
1745784914002,SIO 295LS,A00,894015,Staff,7,0,25,18
1745784915028,SIO 295S,A00,894020,Staff,7,0,25,18
1745784916057,SIOC 290S,B01,958918,Staff,0,0,0,0
1745784917085,SIOC 291S,B01,958922,Staff,0,0,0,0
1745784918113,SOCI 117,A01,895339,Staff,4,0,5,1
1745784919141,WES 237B,A00,894149,Staff,11,0,20,9
1745784921204,AESE 279B,A00,891859,Staff,13,0,35,22
1745784922229,AIP 197,001,891854,Staff,70,0,70,0
1745784923259,ANTH 289S,A00,891856,Gagneux; Pascal,12,0,12,0
1745784924284,BENG 196,001,957946,Engler; Adam J.,9996,0,9999,3
1745784925310,CAT 124RS,A01,956906,Staff,8,0,25,17
1745784926339,CAT 125RS,A01,922013,Staff,8,0,25,17
1745784927367,CLRE 250,A00,891860,Morris; Sheldon,9995,0,9999,4
1745784929469,CLRE 251R,A00,907817,Mehta; Ravindra L.,9994,0,9999,5
1745784930499,CLRE 252,A00,891864,Cuomo; Raphael Eduardo,9993,0,9999,6
1745784931528,CLRE 253,A00,891867,Vaida; Florin,9994,0,9999,5
1745784931528,CLRE 253,B00,907819,Staff,9999,0,9999,0
1745784932557,CLRE 259,A00,891868,Patel; Hemal,9998,0,9999,1
1745784933586,CLRE 260,A00,891872,Cuomo; Raphael Eduardo,9999,0,9999,0
1745784934611,CLRE 297,001,891888,Cuomo; Raphael Eduardo,9999,0,9999,0
1745784935643,CSE 191,A00,958773,Minnes Kemp; Mor Mia,9999,0,9999,0
1745784936671,CSS 201S,A01,892054,Mignozzetti; Umberto,30,0,30,0
1745784937696,CSS 202S,A01,892056,Mignozzetti; Umberto,30,0,30,0
1745784938725,DSC 197,001,956898,Eldridge; Justin Matthew,9998,0,9999,1
1745784939750,DSC 297,001,958000,Mazumdar; Arya,9998,0,9999,1
1745784940778,EAP 100,A00,905686,Staff,9776,0,9999,223
1745784941807,ECE 45,A01,892618,Staff,0,12,50,50
1745784942834,ECE 109,A01,892620,Staff,0,43,0,0
1745784943858,ECE 111,A01,892719,Staff,0,7,50,50
1745784944883,ECE 197,001,957920,Mercier; Patrick Philip,9992,0,9999,7
1745784945907,ECON 178,A01,907814,Zhu; Ying,28,0,35,7
1745784946933,EDS 115,A00,895312,Staff,41,0,45,4
1745784947960,EDS 117,A01,895337,Staff,30,0,30,0
1745784948988,EDS 125,A00,895341,Jones; Gabrielle Anastasia,43,0,45,2
1745784950015,EDS 128A,A01,895459,Fargason; Sharon Gayle,44,0,45,1
1745784951042,EDS 128B,A01,895543,Pappas; Elizabeth,44,0,45,1
1745784952072,EDS 139,A00,897203,Pappas; Elizabeth,44,0,45,1
1745784952072,EDS 139,B00,897209,Fargason; Sharon Gayle,44,0,45,1
1745784953098,EDS 201,A00,895545,Staff,43,0,45,2
1745784954125,EDS 203,A01,895581,Halter; Christopher P.,43,0,45,2
1745784955155,EDS 204R,A01,895625,Heinzman; Erica M.,44,0,45,1
1745784955155,EDS 204R,B01,895693,Halter; Christopher P.,18,0,45,27
1745784956181,EDS 206R,A00,895694,Fargason; Sharon Gayle,9,0,30,21
1745784956181,EDS 206R,B00,895695,Choi; Bailey Miyeon,20,0,30,10
1745784957208,EDS 250,A00,895697,Hemans; Patricia Ann Benitez,43,0,45,2
1745784958238,EDS 281,A00,895701,Meyerott; Theresa Ann,15,0,15,0
1745784959263,EDS 284,A00,895736,Meyerott; Theresa Ann,15,0,15,0
1745784960290,EDS 286,A00,897210,Fine; Sarah,15,0,15,0
1745784961317,EDS 289C,A01,895770,Daly; Alan J.,15,0,15,0
1745784962342,EDS 290,A00,897211,Hofstetter; Carolyn,15,0,15,0
1745784963370,LIGM 5A,A00,896162,Fischer-Grunski; Eva K,15,0,20,5
1745784964396,LIGM 5B,A00,896260,Fischer-Grunski; Eva K,17,0,20,3
1745784965422,LIGM 5C,A00,896308,Fischer-Grunski; Eva K,18,0,20,2
1745784966448,LIIT 5AS,A00,896313,Carnelos; Chiara,18,0,20,2
1745784967474,LIIT 5BS,A00,896416,Carnelos; Chiara,20,0,20,0
1745784968499,LIIT 5CS,A00,896564,Carnelos; Chiara,20,0,20,0
1745784969525,LISP 5A,A00,896588,Munoz Sanchez; Alicia,4,0,20,16
1745784970553,LISP 5B,A00,896653,Munoz Sanchez; Alicia,10,0,20,10
1745784971583,LISP 5C,A00,896655,Munoz Sanchez; Alicia,4,0,20,16
1745784972609,MAE 197,001,957918,Kleissl; Jan,9998,0,9999,1
1745784973638,MATH 2,A01,957937,Staff,34,0,35,1
1745784974669,MATH 197,001,957876,Kedlaya; Kiran S.,9993,0,9999,6
1745784975695,MCWP 40,A00,892729,Duru; Nur,13,0,20,7
1745784975695,MCWP 40,B00,893304,Montejo; Carolina,20,0,20,0
1745784976725,MCWP 40R,A00,893757,Redela; Pamela Morgan,0,6,20,20
1745784977751,MCWP 50,A00,893758,Morshed; Michael James,2,0,20,18
1745784977751,MCWP 50,B00,893761,Bartulis; Jason Michael,17,0,20,3
1745784978780,MCWP 50R,A00,893766,Compas; Sean Matthew,0,1,20,20
1745784978780,MCWP 50R,B00,893769,Carter; Jennifer A,0,0,20,20
1745784978780,MCWP 50R,C00,893771,Krone; Jarret,0,3,20,20
1745784978780,MCWP 50R,D00,893772,Miller; Elizabeth Deen,3,0,20,17
1745784978780,MCWP 50R,E00,893775,Carter; Andrea L,0,0,20,20
1745784979808,MMW 11R,A01,892721,Herbst; Matthew,11,0,27,16
1745784979808,MMW 11R,A02,892722,Herbst; Matthew,0,0,0,3
1745784980837,MMW 12R,A01,892724,Herbst; Matthew,0,9,16,16
1745784980837,MMW 12R,A02,892725,Herbst; Matthew,0,9,16,16
1745784981865,MMW 13R,A01,892727,Staff,0,3,16,16
1745784981865,MMW 13R,A02,892728,Staff,0,4,16,16
1745784981865,MMW 13R,A03,958032,Staff,0,3,16,16
1745784981865,MMW 13R,A04,958033,Staff,0,2,16,16
1745784981865,MMW 13R,A05,958034,Staff,0,3,16,16
1745784982893,SIO 295LS,A00,894015,Staff,7,0,25,18
1745784983924,SIO 295S,A00,894020,Staff,7,0,25,18
1745784984955,SIOC 290S,B01,958918,Staff,0,0,0,0
1745784985985,SIOC 291S,B01,958922,Staff,0,0,0,0
1745784987013,SOCI 117,A01,895339,Staff,4,0,5,1
1745784988040,WES 237B,A00,894149,Staff,11,0,20,9
1745784990106,AESE 279B,A00,891859,Staff,13,0,35,22
1745784991133,AIP 197,001,891854,Staff,70,0,70,0
1745784992158,ANTH 289S,A00,891856,Gagneux; Pascal,12,0,12,0
1745784993184,BENG 196,001,957946,Engler; Adam J.,9996,0,9999,3
1745784994213,CAT 124RS,A01,956906,Staff,8,0,25,17
1745784995238,CAT 125RS,A01,922013,Staff,8,0,25,17
1745784996266,CLRE 250,A00,891860,Morris; Sheldon,9995,0,9999,4
1745784998321,CLRE 251R,A00,907817,Mehta; Ravindra L.,9994,0,9999,5
1745784999345,CLRE 252,A00,891864,Cuomo; Raphael Eduardo,9993,0,9999,6
1745785000375,CLRE 253,A00,891867,Vaida; Florin,9994,0,9999,5
1745785000375,CLRE 253,B00,907819,Staff,9999,0,9999,0
1745785001399,CLRE 259,A00,891868,Patel; Hemal,9998,0,9999,1
1745785002424,CLRE 260,A00,891872,Cuomo; Raphael Eduardo,9999,0,9999,0
1745785003452,CLRE 297,001,891888,Cuomo; Raphael Eduardo,9999,0,9999,0
1745785004477,CSE 191,A00,958773,Minnes Kemp; Mor Mia,9999,0,9999,0
1745785005502,CSS 201S,A01,892054,Mignozzetti; Umberto,30,0,30,0
1745785006530,CSS 202S,A01,892056,Mignozzetti; Umberto,30,0,30,0
1745785007555,DSC 197,001,956898,Eldridge; Justin Matthew,9998,0,9999,1
1745785008579,DSC 297,001,958000,Mazumdar; Arya,9998,0,9999,1
1745785009604,EAP 100,A00,905686,Staff,9776,0,9999,223
1745785010629,ECE 45,A01,892618,Staff,0,12,50,50
1745785011655,ECE 109,A01,892620,Staff,0,43,0,0
1745785012685,ECE 111,A01,892719,Staff,0,7,50,50
1745785013710,ECE 197,001,957920,Mercier; Patrick Philip,9992,0,9999,7
1745785014739,ECON 178,A01,907814,Zhu; Ying,28,0,35,7
1745785015768,EDS 115,A00,895312,Staff,41,0,45,4
1745785016794,EDS 117,A01,895337,Staff,30,0,30,0
1745785017850,EDS 125,A00,895341,Jones; Gabrielle Anastasia,43,0,45,2
1745785018875,EDS 128A,A01,895459,Fargason; Sharon Gayle,44,0,45,1
1745785019906,EDS 128B,A01,895543,Pappas; Elizabeth,44,0,45,1
1745785020935,EDS 139,A00,897203,Pappas; Elizabeth,44,0,45,1
1745785020935,EDS 139,B00,897209,Fargason; Sharon Gayle,44,0,45,1
1745785021965,EDS 201,A00,895545,Staff,43,0,45,2
1745785022994,EDS 203,A01,895581,Halter; Christopher P.,43,0,45,2
1745785024022,EDS 204R,A01,895625,Heinzman; Erica M.,44,0,45,1
1745785024022,EDS 204R,B01,895693,Halter; Christopher P.,18,0,45,27
1745785025048,EDS 206R,A00,895694,Fargason; Sharon Gayle,9,0,30,21
1745785025048,EDS 206R,B00,895695,Choi; Bailey Miyeon,20,0,30,10
1745785026075,EDS 250,A00,895697,Hemans; Patricia Ann Benitez,43,0,45,2
1745785027103,EDS 281,A00,895701,Meyerott; Theresa Ann,15,0,15,0
1745785028130,EDS 284,A00,895736,Meyerott; Theresa Ann,15,0,15,0
1745785029158,EDS 286,A00,897210,Fine; Sarah,15,0,15,0
1745785030189,EDS 289C,A01,895770,Daly; Alan J.,15,0,15,0
1745785031217,EDS 290,A00,897211,Hofstetter; Carolyn,15,0,15,0
1745785032247,LIGM 5A,A00,896162,Fischer-Grunski; Eva K,15,0,20,5
1745785033271,LIGM 5B,A00,896260,Fischer-Grunski; Eva K,17,0,20,3
1745785034302,LIGM 5C,A00,896308,Fischer-Grunski; Eva K,18,0,20,2
1745785035330,LIIT 5AS,A00,896313,Carnelos; Chiara,18,0,20,2
1745785036359,LIIT 5BS,A00,896416,Carnelos; Chiara,20,0,20,0
1745785037383,LIIT 5CS,A00,896564,Carnelos; Chiara,20,0,20,0
1745785038411,LISP 5A,A00,896588,Munoz Sanchez; Alicia,4,0,20,16
1745785039434,LISP 5B,A00,896653,Munoz Sanchez; Alicia,10,0,20,10
1745785040460,LISP 5C,A00,896655,Munoz Sanchez; Alicia,4,0,20,16
1745785041485,MAE 197,001,957918,Kleissl; Jan,9998,0,9999,1
1745785042514,MATH 2,A01,957937,Staff,34,0,35,1
1745785043541,MATH 197,001,957876,Kedlaya; Kiran S.,9993,0,9999,6
1745785044568,MCWP 40,A00,892729,Duru; Nur,13,0,20,7
1745785044568,MCWP 40,B00,893304,Montejo; Carolina,20,0,20,0
1745785045593,MCWP 40R,A00,893757,Redela; Pamela Morgan,0,6,20,20
1745785046620,MCWP 50,A00,893758,Morshed; Michael James,2,0,20,18
1745785046620,MCWP 50,B00,893761,Bartulis; Jason Michael,17,0,20,3
1745785047645,MCWP 50R,A00,893766,Compas; Sean Matthew,0,1,20,20
1745785047645,MCWP 50R,B00,893769,Carter; Jennifer A,0,0,20,20
1745785047645,MCWP 50R,C00,893771,Krone; Jarret,0,3,20,20
1745785047645,MCWP 50R,D00,893772,Miller; Elizabeth Deen,3,0,20,17
1745785047645,MCWP 50R,E00,893775,Carter; Andrea L,0,0,20,20
1745785048673,MMW 11R,A01,892721,Herbst; Matthew,11,0,27,16
1745785048673,MMW 11R,A02,892722,Herbst; Matthew,0,0,0,3
1745785049701,MMW 12R,A01,892724,Herbst; Matthew,0,9,16,16
1745785049701,MMW 12R,A02,892725,Herbst; Matthew,0,9,16,16
1745785050726,MMW 13R,A01,892727,Staff,0,3,16,16
1745785050726,MMW 13R,A02,892728,Staff,0,4,16,16
1745785050726,MMW 13R,A03,958032,Staff,0,3,16,16
1745785050726,MMW 13R,A04,958033,Staff,0,2,16,16
1745785050726,MMW 13R,A05,958034,Staff,0,3,16,16
1745785051752,SIO 295LS,A00,894015,Staff,7,0,25,18
1745785052780,SIO 295S,A00,894020,Staff,7,0,25,18
1745785053808,SIOC 290S,B01,958918,Staff,0,0,0,0
1745785054836,SIOC 291S,B01,958922,Staff,0,0,0,0
1745785055863,SOCI 117,A01,895339,Staff,4,0,5,1
1745785056890,WES 237B,A00,894149,Staff,11,0,20,9
1745785058954,AESE 279B,A00,891859,Staff,13,0,35,22
1745785059980,AIP 197,001,891854,Staff,70,0,70,0
1745785061007,ANTH 289S,A00,891856,Gagneux; Pascal,12,0,12,0
1745785062034,BENG 196,001,957946,Engler; Adam J.,9996,0,9999,3
1745785063063,CAT 124RS,A01,956906,Staff,8,0,25,17
1745785064091,CAT 125RS,A01,922013,Staff,8,0,25,17
1745785065119,CLRE 250,A00,891860,Morris; Sheldon,9995,0,9999,4
1745785067171,CLRE 251R,A00,907817,Mehta; Ravindra L.,9994,0,9999,5
1745785068198,CLRE 252,A00,891864,Cuomo; Raphael Eduardo,9993,0,9999,6
1745785069226,CLRE 253,A00,891867,Vaida; Florin,9994,0,9999,5
1745785069226,CLRE 253,B00,907819,Staff,9999,0,9999,0
1745785070251,CLRE 259,A00,891868,Patel; Hemal,9998,0,9999,1
1745785071277,CLRE 260,A00,891872,Cuomo; Raphael Eduardo,9999,0,9999,0
1745785072307,CLRE 297,001,891888,Cuomo; Raphael Eduardo,9999,0,9999,0
1745785073332,CSE 191,A00,958773,Minnes Kemp; Mor Mia,9999,0,9999,0
1745785074358,CSS 201S,A01,892054,Mignozzetti; Umberto,30,0,30,0
1745785075388,CSS 202S,A01,892056,Mignozzetti; Umberto,30,0,30,0
1745785076415,DSC 197,001,956898,Eldridge; Justin Matthew,9998,0,9999,1
1745785077440,DSC 297,001,958000,Mazumdar; Arya,9998,0,9999,1
1745785078463,EAP 100,A00,905686,Staff,9776,0,9999,223
1745785079489,ECE 45,A01,892618,Staff,0,12,50,50
1745785080516,ECE 109,A01,892620,Staff,0,43,0,0
1745785081543,ECE 111,A01,892719,Staff,0,7,50,50
1745785082568,ECE 197,001,957920,Mercier; Patrick Philip,9992,0,9999,7
1745785083594,ECON 178,A01,907814,Zhu; Ying,28,0,35,7
1745785084622,EDS 115,A00,895312,Staff,41,0,45,4
1745785085650,EDS 117,A01,895337,Staff,30,0,30,0
1745785086676,EDS 125,A00,895341,Jones; Gabrielle Anastasia,43,0,45,2
1745785087702,EDS 128A,A01,895459,Fargason; Sharon Gayle,44,0,45,1
1745785088732,EDS 128B,A01,895543,Pappas; Elizabeth,44,0,45,1
1745785089760,EDS 139,A00,897203,Pappas; Elizabeth,44,0,45,1
1745785089760,EDS 139,B00,897209,Fargason; Sharon Gayle,44,0,45,1
1745785090787,EDS 201,A00,895545,Staff,43,0,45,2
1745785091815,EDS 203,A01,895581,Halter; Christopher P.,43,0,45,2
1745785092844,EDS 204R,A01,895625,Heinzman; Erica M.,44,0,45,1
1745785092844,EDS 204R,B01,895693,Halter; Christopher P.,18,0,45,27
1745785093873,EDS 206R,A00,895694,Fargason; Sharon Gayle,9,0,30,21
1745785093873,EDS 206R,B00,895695,Choi; Bailey Miyeon,20,0,30,10
1745785094899,EDS 250,A00,895697,Hemans; Patricia Ann Benitez,43,0,45,2
1745785095928,EDS 281,A00,895701,Meyerott; Theresa Ann,15,0,15,0
1745785096957,EDS 284,A00,895736,Meyerott; Theresa Ann,15,0,15,0
1745785097984,EDS 286,A00,897210,Fine; Sarah,15,0,15,0
1745785099011,EDS 289C,A01,895770,Daly; Alan J.,15,0,15,0
1745785100040,EDS 290,A00,897211,Hofstetter; Carolyn,15,0,15,0
1745785101069,LIGM 5A,A00,896162,Fischer-Grunski; Eva K,15,0,20,5
1745785102096,LIGM 5B,A00,896260,Fischer-Grunski; Eva K,17,0,20,3
1745785103125,LIGM 5C,A00,896308,Fischer-Grunski; Eva K,18,0,20,2
1745785104153,LIIT 5AS,A00,896313,Carnelos; Chiara,18,0,20,2
1745785105184,LIIT 5BS,A00,896416,Carnelos; Chiara,20,0,20,0
1745785106210,LIIT 5CS,A00,896564,Carnelos; Chiara,20,0,20,0
1745785107236,LISP 5A,A00,896588,Munoz Sanchez; Alicia,4,0,20,16
1745785108266,LISP 5B,A00,896653,Munoz Sanchez; Alicia,10,0,20,10
1745785109294,LISP 5C,A00,896655,Munoz Sanchez; Alicia,4,0,20,16
1745785110321,MAE 197,001,957918,Kleissl; Jan,9998,0,9999,1
1745785111350,MATH 2,A01,957937,Staff,34,0,35,1
1745785112405,MATH 197,001,957876,Kedlaya; Kiran S.,9993,0,9999,6
1745785113431,MCWP 40,A00,892729,Duru; Nur,13,0,20,7
1745785113431,MCWP 40,B00,893304,Montejo; Carolina,20,0,20,0
1745785114458,MCWP 40R,A00,893757,Redela; Pamela Morgan,0,6,20,20
1745785115483,MCWP 50,A00,893758,Morshed; Michael James,2,0,20,18
1745785115483,MCWP 50,B00,893761,Bartulis; Jason Michael,17,0,20,3
1745785116510,MCWP 50R,A00,893766,Compas; Sean Matthew,0,1,20,20
1745785116510,MCWP 50R,B00,893769,Carter; Jennifer A,0,0,20,20
1745785116510,MCWP 50R,C00,893771,Krone; Jarret,0,3,20,20
1745785116510,MCWP 50R,D00,893772,Miller; Elizabeth Deen,3,0,20,17
1745785116510,MCWP 50R,E00,893775,Carter; Andrea L,0,0,20,20
1745785117534,MMW 11R,A01,892721,Herbst; Matthew,11,0,27,16
1745785117534,MMW 11R,A02,892722,Herbst; Matthew,0,0,0,3
1745785118558,MMW 12R,A01,892724,Herbst; Matthew,0,9,16,16
1745785118558,MMW 12R,A02,892725,Herbst; Matthew,0,9,16,16
1745785119582,MMW 13R,A01,892727,Staff,0,3,16,16
1745785119582,MMW 13R,A02,892728,Staff,0,4,16,16
1745785119582,MMW 13R,A03,958032,Staff,0,3,16,16
1745785119582,MMW 13R,A04,958033,Staff,0,2,16,16
1745785119582,MMW 13R,A05,958034,Staff,0,3,16,16
1745785120609,SIO 295LS,A00,894015,Staff,7,0,25,18
1745785121632,SIO 295S,A00,894020,Staff,7,0,25,18
1745785122661,SIOC 290S,B01,958918,Staff,0,0,0,0
1745785123685,SIOC 291S,B01,958922,Staff,0,0,0,0
1745785124714,SOCI 117,A01,895339,Staff,4,0,5,1
1745785125740,WES 237B,A00,894149,Staff,11,0,20,9
1745785127800,AESE 279B,A00,891859,Staff,13,0,35,22
1745785128827,AIP 197,001,891854,Staff,70,0,70,0
1745785129853,ANTH 289S,A00,891856,Gagneux; Pascal,12,0,12,0
1745785130883,BENG 196,001,957946,Engler; Adam J.,9996,0,9999,3
1745785131908,CAT 124RS,A01,956906,Staff,8,0,25,17
1745785132937,CAT 125RS,A01,922013,Staff,8,0,25,17
1745785133964,CLRE 250,A00,891860,Morris; Sheldon,9995,0,9999,4
1745785136026,CLRE 251R,A00,907817,Mehta; Ravindra L.,9994,0,9999,5
1745785137055,CLRE 252,A00,891864,Cuomo; Raphael Eduardo,9993,0,9999,6
1745785138085,CLRE 253,A00,891867,Vaida; Florin,9994,0,9999,5
1745785138085,CLRE 253,B00,907819,Staff,9999,0,9999,0
1745785139113,CLRE 259,A00,891868,Patel; Hemal,9998,0,9999,1
1745785140143,CLRE 260,A00,891872,Cuomo; Raphael Eduardo,9999,0,9999,0
1745785141170,CLRE 297,001,891888,Cuomo; Raphael Eduardo,9999,0,9999,0
1745785142198,CSE 191,A00,958773,Minnes Kemp; Mor Mia,9999,0,9999,0
1745785143226,CSS 201S,A01,892054,Mignozzetti; Umberto,30,0,30,0
1745785144254,CSS 202S,A01,892056,Mignozzetti; Umberto,30,0,30,0
1745785145281,DSC 197,001,956898,Eldridge; Justin Matthew,9998,0,9999,1
1745785146312,DSC 297,001,958000,Mazumdar; Arya,9998,0,9999,1
1745785147341,EAP 100,A00,905686,Staff,9776,0,9999,223
1745785148372,ECE 45,A01,892618,Staff,0,12,50,50
1745785149398,ECE 109,A01,892620,Staff,0,43,0,0
1745785150425,ECE 111,A01,892719,Staff,0,7,50,50
1745785151453,ECE 197,001,957920,Mercier; Patrick Philip,9992,0,9999,7
1745785152478,ECON 178,A01,907814,Zhu; Ying,28,0,35,7
1745785153506,EDS 115,A00,895312,Staff,41,0,45,4
1745785154533,EDS 117,A01,895337,Staff,30,0,30,0
1745785155559,EDS 125,A00,895341,Jones; Gabrielle Anastasia,43,0,45,2
1745785156584,EDS 128A,A01,895459,Fargason; Sharon Gayle,44,0,45,1
1745785157613,EDS 128B,A01,895543,Pappas; Elizabeth,44,0,45,1
1745785158638,EDS 139,A00,897203,Pappas; Elizabeth,44,0,45,1
1745785158638,EDS 139,B00,897209,Fargason; Sharon Gayle,44,0,45,1
1745785159664,EDS 201,A00,895545,Staff,43,0,45,2
1745785160689,EDS 203,A01,895581,Halter; Christopher P.,43,0,45,2
1745785161715,EDS 204R,A01,895625,Heinzman; Erica M.,44,0,45,1
1745785161715,EDS 204R,B01,895693,Halter; Christopher P.,18,0,45,27
1745785162741,EDS 206R,A00,895694,Fargason; Sharon Gayle,9,0,30,21
1745785162741,EDS 206R,B00,895695,Choi; Bailey Miyeon,20,0,30,10
1745785163765,EDS 250,A00,895697,Hemans; Patricia Ann Benitez,43,0,45,2
1745785164792,EDS 281,A00,895701,Meyerott; Theresa Ann,15,0,15,0
1745785165819,EDS 284,A00,895736,Meyerott; Theresa Ann,15,0,15,0
1745785166844,EDS 286,A00,897210,Fine; Sarah,15,0,15,0
1745785167871,EDS 289C,A01,895770,Daly; Alan J.,15,0,15,0
1745785168897,EDS 290,A00,897211,Hofstetter; Carolyn,15,0,15,0
1745785169928,LIGM 5A,A00,896162,Fischer-Grunski; Eva K,15,0,20,5
1745785170955,LIGM 5B,A00,896260,Fischer-Grunski; Eva K,17,0,20,3
1745785171987,LIGM 5C,A00,896308,Fischer-Grunski; Eva K,18,0,20,2
1745785173017,LIIT 5AS,A00,896313,Carnelos; Chiara,18,0,20,2
1745785174043,LIIT 5BS,A00,896416,Carnelos; Chiara,20,0,20,0
1745785175073,LIIT 5CS,A00,896564,Carnelos; Chiara,20,0,20,0
1745785176100,LISP 5A,A00,896588,Munoz Sanchez; Alicia,4,0,20,16
1745785177132,LISP 5B,A00,896653,Munoz Sanchez; Alicia,10,0,20,10
1745785178159,LISP 5C,A00,896655,Munoz Sanchez; Alicia,4,0,20,16
1745785179184,MAE 197,001,957918,Kleissl; Jan,9998,0,9999,1
1745785180212,MATH 2,A01,957937,Staff,34,0,35,1
1745785181239,MATH 197,001,957876,Kedlaya; Kiran S.,9993,0,9999,6
1745785182264,MCWP 40,A00,892729,Duru; Nur,13,0,20,7
1745785182264,MCWP 40,B00,893304,Montejo; Carolina,20,0,20,0
1745785183290,MCWP 40R,A00,893757,Redela; Pamela Morgan,0,6,20,20
1745785184321,MCWP 50,A00,893758,Morshed; Michael James,2,0,20,18
1745785184321,MCWP 50,B00,893761,Bartulis; Jason Michael,17,0,20,3
1745785185348,MCWP 50R,A00,893766,Compas; Sean Matthew,0,1,20,20
1745785185348,MCWP 50R,B00,893769,Carter; Jennifer A,0,0,20,20
1745785185348,MCWP 50R,C00,893771,Krone; Jarret,0,3,20,20
1745785185348,MCWP 50R,D00,893772,Miller; Elizabeth Deen,3,0,20,17
1745785185348,MCWP 50R,E00,893775,Carter; Andrea L,0,0,20,20
1745785186374,MMW 11R,A01,892721,Herbst; Matthew,11,0,27,16
1745785186374,MMW 11R,A02,892722,Herbst; Matthew,0,0,0,3
1745785187401,MMW 12R,A01,892724,Herbst; Matthew,0,9,16,16
1745785187401,MMW 12R,A02,892725,Herbst; Matthew,0,9,16,16
1745785188426,MMW 13R,A01,892727,Staff,0,3,16,16
1745785188426,MMW 13R,A02,892728,Staff,0,4,16,16
1745785188426,MMW 13R,A03,958032,Staff,0,3,16,16
1745785188426,MMW 13R,A04,958033,Staff,0,2,16,16
1745785188426,MMW 13R,A05,958034,Staff,0,3,16,16
1745785189451,SIO 295LS,A00,894015,Staff,7,0,25,18
1745785190480,SIO 295S,A00,894020,Staff,7,0,25,18
1745785191512,SIOC 290S,B01,958918,Staff,0,0,0,0
1745785192541,SIOC 291S,B01,958922,Staff,0,0,0,0
1745785193571,SOCI 117,A01,895339,Staff,4,0,5,1
1745785194597,WES 237B,A00,894149,Staff,11,0,20,9
1745785196659,AESE 279B,A00,891859,Staff,13,0,35,22
1745785197685,AIP 197,001,891854,Staff,70,0,70,0
1745785198711,ANTH 289S,A00,891856,Gagneux; Pascal,12,0,12,0
1745785199736,BENG 196,001,957946,Engler; Adam J.,9996,0,9999,3
1745785200762,CAT 124RS,A01,956906,Staff,8,0,25,17
1745785201787,CAT 125RS,A01,922013,Staff,8,0,25,17
1745785202818,CLRE 250,A00,891860,Morris; Sheldon,9995,0,9999,4
1745785204878,CLRE 251R,A00,907817,Mehta; Ravindra L.,9994,0,9999,5
1745785205905,CLRE 252,A00,891864,Cuomo; Raphael Eduardo,9993,0,9999,6
1745785206933,CLRE 253,A00,891867,Vaida; Florin,9994,0,9999,5
1745785206933,CLRE 253,B00,907819,Staff,9999,0,9999,0
1745785207963,CLRE 259,A00,891868,Patel; Hemal,9998,0,9999,1
1745785208989,CLRE 260,A00,891872,Cuomo; Raphael Eduardo,9999,0,9999,0
1745785210018,CLRE 297,001,891888,Cuomo; Raphael Eduardo,9999,0,9999,0
1745785211047,CSE 191,A00,958773,Minnes Kemp; Mor Mia,9999,0,9999,0
1745785212077,CSS 201S,A01,892054,Mignozzetti; Umberto,30,0,30,0
1745785213105,CSS 202S,A01,892056,Mignozzetti; Umberto,30,0,30,0
1745785214132,DSC 197,001,956898,Eldridge; Justin Matthew,9998,0,9999,1
1745785215181,DSC 297,001,958000,Mazumdar; Arya,9998,0,9999,1
1745785216206,EAP 100,A00,905686,Staff,9776,0,9999,223
1745785217231,ECE 45,A01,892618,Staff,0,12,50,50
1745785218254,ECE 109,A01,892620,Staff,0,43,0,0
1745785219283,ECE 111,A01,892719,Staff,0,7,50,50
1745785220306,ECE 197,001,957920,Mercier; Patrick Philip,9992,0,9999,7
1745785221334,ECON 178,A01,907814,Zhu; Ying,28,0,35,7
1745785222357,EDS 115,A00,895312,Staff,41,0,45,4
1745785223385,EDS 117,A01,895337,Staff,30,0,30,0
1745785224410,EDS 125,A00,895341,Jones; Gabrielle Anastasia,43,0,45,2
1745785225435,EDS 128A,A01,895459,Fargason; Sharon Gayle,44,0,45,1
1745785226464,EDS 128B,A01,895543,Pappas; Elizabeth,44,0,45,1
1745785227491,EDS 139,A00,897203,Pappas; Elizabeth,44,0,45,1
1745785227491,EDS 139,B00,897209,Fargason; Sharon Gayle,44,0,45,1
1745785228516,EDS 201,A00,895545,Staff,43,0,45,2
1745785229540,EDS 203,A01,895581,Halter; Christopher P.,43,0,45,2
1745785230569,EDS 204R,A01,895625,Heinzman; Erica M.,44,0,45,1
1745785230569,EDS 204R,B01,895693,Halter; Christopher P.,18,0,45,27
1745785231594,EDS 206R,A00,895694,Fargason; Sharon Gayle,9,0,30,21
1745785231594,EDS 206R,B00,895695,Choi; Bailey Miyeon,20,0,30,10
1745785232620,EDS 250,A00,895697,Hemans; Patricia Ann Benitez,43,0,45,2
1745785233647,EDS 281,A00,895701,Meyerott; Theresa Ann,15,0,15,0
1745785234673,EDS 284,A00,895736,Meyerott; Theresa Ann,15,0,15,0
1745785235704,EDS 286,A00,897210,Fine; Sarah,15,0,15,0
1745785236733,EDS 289C,A01,895770,Daly; Alan J.,15,0,15,0
1745785237759,EDS 290,A00,897211,Hofstetter; Carolyn,15,0,15,0
1745785238789,LIGM 5A,A00,896162,Fischer-Grunski; Eva K,15,0,20,5
1745785239814,LIGM 5B,A00,896260,Fischer-Grunski; Eva K,17,0,20,3
1745785240844,LIGM 5C,A00,896308,Fischer-Grunski; Eva K,18,0,20,2
1745785241872,LIIT 5AS,A00,896313,Carnelos; Chiara,18,0,20,2
1745785242899,LIIT 5BS,A00,896416,Carnelos; Chiara,20,0,20,0
1745785243924,LIIT 5CS,A00,896564,Carnelos; Chiara,20,0,20,0
1745785244952,LISP 5A,A00,896588,Munoz Sanchez; Alicia,4,0,20,16
1745785245982,LISP 5B,A00,896653,Munoz Sanchez; Alicia,10,0,20,10
1745785247009,LISP 5C,A00,896655,Munoz Sanchez; Alicia,4,0,20,16
1745785248037,MAE 197,001,957918,Kleissl; Jan,9998,0,9999,1
1745785249063,MATH 2,A01,957937,Staff,34,0,35,1
1745785250090,MATH 197,001,957876,Kedlaya; Kiran S.,9993,0,9999,6
1745785251119,MCWP 40,A00,892729,Duru; Nur,13,0,20,7
1745785251119,MCWP 40,B00,893304,Montejo; Carolina,20,0,20,0
1745785252144,MCWP 40R,A00,893757,Redela; Pamela Morgan,0,6,20,20
1745785253172,MCWP 50,A00,893758,Morshed; Michael James,2,0,20,18
1745785253172,MCWP 50,B00,893761,Bartulis; Jason Michael,17,0,20,3
1745785254198,MCWP 50R,A00,893766,Compas; Sean Matthew,0,1,20,20
1745785254198,MCWP 50R,B00,893769,Carter; Jennifer A,0,0,20,20
1745785254198,MCWP 50R,C00,893771,Krone; Jarret,0,3,20,20
1745785254198,MCWP 50R,D00,893772,Miller; Elizabeth Deen,3,0,20,17
1745785254198,MCWP 50R,E00,893775,Carter; Andrea L,0,0,20,20
1745785255225,MMW 11R,A01,892721,Herbst; Matthew,11,0,27,16
1745785255225,MMW 11R,A02,892722,Herbst; Matthew,0,0,0,3
1745785256253,MMW 12R,A01,892724,Herbst; Matthew,0,9,16,16
1745785256253,MMW 12R,A02,892725,Herbst; Matthew,0,9,16,16
1745785257280,MMW 13R,A01,892727,Staff,0,3,16,16
1745785257280,MMW 13R,A02,892728,Staff,0,4,16,16
1745785257280,MMW 13R,A03,958032,Staff,0,3,16,16
1745785257280,MMW 13R,A04,958033,Staff,0,2,16,16
1745785257280,MMW 13R,A05,958034,Staff,0,3,16,16
1745785258308,SIO 295LS,A00,894015,Staff,7,0,25,18
1745785259333,SIO 295S,A00,894020,Staff,7,0,25,18
1745785260359,SIOC 290S,B01,958918,Staff,0,0,0,0
1745785261389,SIOC 291S,B01,958922,Staff,0,0,0,0
1745785262413,SOCI 117,A01,895339,Staff,4,0,5,1
1745785263437,WES 237B,A00,894149,Staff,11,0,20,9
1745785265497,AESE 279B,A00,891859,Staff,13,0,35,22
1745785266524,AIP 197,001,891854,Staff,70,0,70,0
1745785267548,ANTH 289S,A00,891856,Gagneux; Pascal,12,0,12,0
1745785268575,BENG 196,001,957946,Engler; Adam J.,9996,0,9999,3
1745785269601,CAT 124RS,A01,956906,Staff,8,0,25,17
1745785270628,CAT 125RS,A01,922013,Staff,8,0,25,17
1745785271654,CLRE 250,A00,891860,Morris; Sheldon,9995,0,9999,4
1745785273714,CLRE 251R,A00,907817,Mehta; Ravindra L.,9994,0,9999,5
1745785274739,CLRE 252,A00,891864,Cuomo; Raphael Eduardo,9993,0,9999,6
1745785275765,CLRE 253,A00,891867,Vaida; Florin,9994,0,9999,5
1745785275765,CLRE 253,B00,907819,Staff,9999,0,9999,0
1745785276792,CLRE 259,A00,891868,Patel; Hemal,9998,0,9999,1
1745785277818,CLRE 260,A00,891872,Cuomo; Raphael Eduardo,9999,0,9999,0
1745785278846,CLRE 297,001,891888,Cuomo; Raphael Eduardo,9999,0,9999,0
1745785279873,CSE 191,A00,958773,Minnes Kemp; Mor Mia,9999,0,9999,0
1745785280901,CSS 201S,A01,892054,Mignozzetti; Umberto,30,0,30,0
1745785281931,CSS 202S,A01,892056,Mignozzetti; Umberto,30,0,30,0
1745785282956,DSC 197,001,956898,Eldridge; Justin Matthew,9998,0,9999,1
1745785283983,DSC 297,001,958000,Mazumdar; Arya,9998,0,9999,1
1745785285012,EAP 100,A00,905686,Staff,9776,0,9999,223
1745785286040,ECE 45,A01,892618,Staff,0,12,50,50
1745785287066,ECE 109,A01,892620,Staff,0,43,0,0
1745785288093,ECE 111,A01,892719,Staff,0,7,50,50
1745785289117,ECE 197,001,957920,Mercier; Patrick Philip,9992,0,9999,7
1745785290149,ECON 178,A01,907814,Zhu; Ying,28,0,35,7
1745785291173,EDS 115,A00,895312,Staff,41,0,45,4
1745785292200,EDS 117,A01,895337,Staff,30,0,30,0
1745785293230,EDS 125,A00,895341,Jones; Gabrielle Anastasia,43,0,45,2
1745785294257,EDS 128A,A01,895459,Fargason; Sharon Gayle,44,0,45,1
1745785295283,EDS 128B,A01,895543,Pappas; Elizabeth,44,0,45,1
1745785296312,EDS 139,A00,897203,Pappas; Elizabeth,44,0,45,1
1745785296312,EDS 139,B00,897209,Fargason; Sharon Gayle,44,0,45,1
1745785297339,EDS 201,A00,895545,Staff,43,0,45,2
1745785298365,EDS 203,A01,895581,Halter; Christopher P.,43,0,45,2
1745785299390,EDS 204R,A01,895625,Heinzman; Erica M.,44,0,45,1
1745785299390,EDS 204R,B01,895693,Halter; Christopher P.,18,0,45,27
1745785300418,EDS 206R,A00,895694,Fargason; Sharon Gayle,9,0,30,21
1745785300418,EDS 206R,B00,895695,Choi; Bailey Miyeon,20,0,30,10
1745785301447,EDS 250,A00,895697,Hemans; Patricia Ann Benitez,43,0,45,2
1745785302476,EDS 281,A00,895701,Meyerott; Theresa Ann,15,0,15,0
1745785303502,EDS 284,A00,895736,Meyerott; Theresa Ann,15,0,15,0
1745785304530,EDS 286,A00,897210,Fine; Sarah,15,0,15,0
1745785305558,EDS 289C,A01,895770,Daly; Alan J.,15,0,15,0
1745785306584,EDS 290,A00,897211,Hofstetter; Carolyn,15,0,15,0
1745785307611,LIGM 5A,A00,896162,Fischer-Grunski; Eva K,15,0,20,5
1745785308638,LIGM 5B,A00,896260,Fischer-Grunski; Eva K,17,0,20,3
1745785309663,LIGM 5C,A00,896308,Fischer-Grunski; Eva K,18,0,20,2
1745785310692,LIIT 5AS,A00,896313,Carnelos; Chiara,18,0,20,2
1745785311717,LIIT 5BS,A00,896416,Carnelos; Chiara,20,0,20,0
1745785312743,LIIT 5CS,A00,896564,Carnelos; Chiara,20,0,20,0
1745785313773,LISP 5A,A00,896588,Munoz Sanchez; Alicia,4,0,20,16
1745785314802,LISP 5B,A00,896653,Munoz Sanchez; Alicia,10,0,20,10
1745785315831,LISP 5C,A00,896655,Munoz Sanchez; Alicia,4,0,20,16
1745785316855,MAE 197,001,957918,Kleissl; Jan,9998,0,9999,1
1745785317885,MATH 2,A01,957937,Staff,34,0,35,1
1745785318910,MATH 197,001,957876,Kedlaya; Kiran S.,9993,0,9999,6
1745785319937,MCWP 40,A00,892729,Duru; Nur,13,0,20,7
1745785319937,MCWP 40,B00,893304,Montejo; Carolina,20,0,20,0
1745785320966,MCWP 40R,A00,893757,Redela; Pamela Morgan,0,6,20,20
1745785321992,MCWP 50,A00,893758,Morshed; Michael James,2,0,20,18
1745785321992,MCWP 50,B00,893761,Bartulis; Jason Michael,17,0,20,3
1745785323024,MCWP 50R,A00,893766,Compas; Sean Matthew,0,1,20,20
1745785323024,MCWP 50R,B00,893769,Carter; Jennifer A,0,0,20,20
1745785323024,MCWP 50R,C00,893771,Krone; Jarret,0,3,20,20
1745785323024,MCWP 50R,D00,893772,Miller; Elizabeth Deen,3,0,20,17
1745785323024,MCWP 50R,E00,893775,Carter; Andrea L,0,0,20,20
1745785324052,MMW 11R,A01,892721,Herbst; Matthew,11,0,27,16
1745785324052,MMW 11R,A02,892722,Herbst; Matthew,0,0,0,3
1745785325077,MMW 12R,A01,892724,Herbst; Matthew,0,9,16,16
1745785325077,MMW 12R,A02,892725,Herbst; Matthew,0,9,16,16
1745785326104,MMW 13R,A01,892727,Staff,0,3,16,16
1745785326104,MMW 13R,A02,892728,Staff,0,4,16,16
1745785326104,MMW 13R,A03,958032,Staff,0,3,16,16
1745785326104,MMW 13R,A04,958033,Staff,0,2,16,16
1745785326104,MMW 13R,A05,958034,Staff,0,3,16,16
1745785327133,SIO 295LS,A00,894015,Staff,7,0,25,18
1745785328157,SIO 295S,A00,894020,Staff,7,0,25,18
1745785329206,SIOC 290S,B01,958918,Staff,0,0,0,0
1745785330235,SIOC 291S,B01,958922,Staff,0,0,0,0
1745785331262,SOCI 117,A01,895339,Staff,4,0,5,1
1745785332287,WES 237B,A00,894149,Staff,11,0,20,9
1745785334346,AESE 279B,A00,891859,Staff,13,0,35,22
1745785335371,AIP 197,001,891854,Staff,70,0,70,0
1745785336398,ANTH 289S,A00,891856,Gagneux; Pascal,12,0,12,0
1745785337423,BENG 196,001,957946,Engler; Adam J.,9996,0,9999,3
1745785338447,CAT 124RS,A01,956906,Staff,8,0,25,17
1745785339475,CAT 125RS,A01,922013,Staff,8,0,25,17
1745785340499,CLRE 250,A00,891860,Morris; Sheldon,9995,0,9999,4
1745785342554,CLRE 251R,A00,907817,Mehta; Ravindra L.,9994,0,9999,5
1745785343579,CLRE 252,A00,891864,Cuomo; Raphael Eduardo,9993,0,9999,6
1745785344604,CLRE 253,A00,891867,Vaida; Florin,9994,0,9999,5
1745785344604,CLRE 253,B00,907819,Staff,9999,0,9999,0
1745785345631,CLRE 259,A00,891868,Patel; Hemal,9998,0,9999,1
1745785346655,CLRE 260,A00,891872,Cuomo; Raphael Eduardo,9999,0,9999,0
1745785347683,CLRE 297,001,891888,Cuomo; Raphael Eduardo,9999,0,9999,0
1745785348710,CSE 191,A00,958773,Minnes Kemp; Mor Mia,9999,0,9999,0
1745785349742,CSS 201S,A01,892054,Mignozzetti; Umberto,30,0,30,0
1745785350772,CSS 202S,A01,892056,Mignozzetti; Umberto,30,0,30,0
1745785351797,DSC 197,001,956898,Eldridge; Justin Matthew,9998,0,9999,1
1745785352824,DSC 297,001,958000,Mazumdar; Arya,9998,0,9999,1
1745785353852,EAP 100,A00,905686,Staff,9776,0,9999,223
1745785354877,ECE 45,A01,892618,Staff,0,12,50,50
1745785355905,ECE 109,A01,892620,Staff,0,43,0,0
1745785356935,ECE 111,A01,892719,Staff,0,7,50,50
1745785357961,ECE 197,001,957920,Mercier; Patrick Philip,9992,0,9999,7
1745785358989,ECON 178,A01,907814,Zhu; Ying,28,0,35,7
1745785360018,EDS 115,A00,895312,Staff,41,0,45,4
1745785361045,EDS 117,A01,895337,Staff,30,0,30,0
1745785362074,EDS 125,A00,895341,Jones; Gabrielle Anastasia,43,0,45,2
1745785363101,EDS 128A,A01,895459,Fargason; Sharon Gayle,44,0,45,1
1745785364128,EDS 128B,A01,895543,Pappas; Elizabeth,44,0,45,1
1745785365152,EDS 139,A00,897203,Pappas; Elizabeth,44,0,45,1
1745785365152,EDS 139,B00,897209,Fargason; Sharon Gayle,44,0,45,1
1745785366181,EDS 201,A00,895545,Staff,43,0,45,2
1745785367206,EDS 203,A01,895581,Halter; Christopher P.,43,0,45,2
1745785368231,EDS 204R,A01,895625,Heinzman; Erica M.,44,0,45,1
1745785368231,EDS 204R,B01,895693,Halter; Christopher P.,18,0,45,27
1745785369257,EDS 206R,A00,895694,Fargason; Sharon Gayle,9,0,30,21
1745785369257,EDS 206R,B00,895695,Choi; Bailey Miyeon,20,0,30,10
1745785370286,EDS 250,A00,895697,Hemans; Patricia Ann Benitez,43,0,45,2
1745785371310,EDS 281,A00,895701,Meyerott; Theresa Ann,15,0,15,0
1745785372334,EDS 284,A00,895736,Meyerott; Theresa Ann,15,0,15,0
1745785373361,EDS 286,A00,897210,Fine; Sarah,15,0,15,0
1745785374389,EDS 289C,A01,895770,Daly; Alan J.,15,0,15,0
1745785375414,EDS 290,A00,897211,Hofstetter; Carolyn,15,0,15,0
1745785376440,LIGM 5A,A00,896162,Fischer-Grunski; Eva K,15,0,20,5
1745785377467,LIGM 5B,A00,896260,Fischer-Grunski; Eva K,17,0,20,3
1745785378493,LIGM 5C,A00,896308,Fischer-Grunski; Eva K,18,0,20,2
1745785379519,LIIT 5AS,A00,896313,Carnelos; Chiara,18,0,20,2
1745785380546,LIIT 5BS,A00,896416,Carnelos; Chiara,20,0,20,0
1745785381571,LIIT 5CS,A00,896564,Carnelos; Chiara,20,0,20,0
1745785382602,LISP 5A,A00,896588,Munoz Sanchez; Alicia,4,0,20,16
1745785383629,LISP 5B,A00,896653,Munoz Sanchez; Alicia,10,0,20,10
1745785384653,LISP 5C,A00,896655,Munoz Sanchez; Alicia,4,0,20,16
1745785385681,MAE 197,001,957918,Kleissl; Jan,9998,0,9999,1
1745785386708,MATH 2,A01,957937,Staff,34,0,35,1
1745785387736,MATH 197,001,957876,Kedlaya; Kiran S.,9993,0,9999,6
1745785388762,MCWP 40,A00,892729,Duru; Nur,13,0,20,7
1745785388762,MCWP 40,B00,893304,Montejo; Carolina,20,0,20,0
1745785389788,MCWP 40R,A00,893757,Redela; Pamela Morgan,0,6,20,20
1745785390814,MCWP 50,A00,893758,Morshed; Michael James,2,0,20,18
1745785390814,MCWP 50,B00,893761,Bartulis; Jason Michael,17,0,20,3
1745785391845,MCWP 50R,A00,893766,Compas; Sean Matthew,0,1,20,20
1745785391845,MCWP 50R,B00,893769,Carter; Jennifer A,0,0,20,20
1745785391845,MCWP 50R,C00,893771,Krone; Jarret,0,3,20,20
1745785391845,MCWP 50R,D00,893772,Miller; Elizabeth Deen,3,0,20,17
1745785391845,MCWP 50R,E00,893775,Carter; Andrea L,0,0,20,20
1745785392872,MMW 11R,A01,892721,Herbst; Matthew,11,0,27,16
1745785392872,MMW 11R,A02,892722,Herbst; Matthew,0,0,0,3
1745785393897,MMW 12R,A01,892724,Herbst; Matthew,0,9,16,16
1745785393897,MMW 12R,A02,892725,Herbst; Matthew,0,9,16,16
1745785394929,MMW 13R,A01,892727,Staff,0,3,16,16
1745785394929,MMW 13R,A02,892728,Staff,0,4,16,16
1745785394929,MMW 13R,A03,958032,Staff,0,3,16,16
1745785394929,MMW 13R,A04,958033,Staff,0,2,16,16
1745785394929,MMW 13R,A05,958034,Staff,0,3,16,16
1745785395955,SIO 295LS,A00,894015,Staff,7,0,25,18
1745785396980,SIO 295S,A00,894020,Staff,7,0,25,18
1745785398006,SIOC 290S,B01,958918,Staff,0,0,0,0
1745785399037,SIOC 291S,B01,958922,Staff,0,0,0,0
1745785400063,SOCI 117,A01,895339,Staff,4,0,5,1
1745785401088,WES 237B,A00,894149,Staff,11,0,20,9
1745785403149,AESE 279B,A00,891859,Staff,13,0,35,22
1745785404175,AIP 197,001,891854,Staff,70,0,70,0
1745785405202,ANTH 289S,A00,891856,Gagneux; Pascal,12,0,12,0
1745785406230,BENG 196,001,957946,Engler; Adam J.,9996,0,9999,3
1745785407258,CAT 124RS,A01,956906,Staff,8,0,25,17
1745785408284,CAT 125RS,A01,922013,Staff,8,0,25,17
1745785409315,CLRE 250,A00,891860,Morris; Sheldon,9995,0,9999,4
1745785411368,CLRE 251R,A00,907817,Mehta; Ravindra L.,9994,0,9999,5
1745785412403,CLRE 252,A00,891864,Cuomo; Raphael Eduardo,9993,0,9999,6
1745785413430,CLRE 253,A00,891867,Vaida; Florin,9994,0,9999,5
1745785413430,CLRE 253,B00,907819,Staff,9999,0,9999,0
1745785414455,CLRE 259,A00,891868,Patel; Hemal,9998,0,9999,1
1745785415481,CLRE 260,A00,891872,Cuomo; Raphael Eduardo,9999,0,9999,0
1745785416508,CLRE 297,001,891888,Cuomo; Raphael Eduardo,9999,0,9999,0
1745785417534,CSE 191,A00,958773,Minnes Kemp; Mor Mia,9999,0,9999,0
1745785418560,CSS 201S,A01,892054,Mignozzetti; Umberto,30,0,30,0
1745785419587,CSS 202S,A01,892056,Mignozzetti; Umberto,30,0,30,0
1745785420612,DSC 197,001,956898,Eldridge; Justin Matthew,9998,0,9999,1
1745785421638,DSC 297,001,958000,Mazumdar; Arya,9998,0,9999,1
1745785422665,EAP 100,A00,905686,Staff,9776,0,9999,223
1745785423692,ECE 45,A01,892618,Staff,0,12,50,50
1745785424715,ECE 109,A01,892620,Staff,0,43,0,0
1745785425742,ECE 111,A01,892719,Staff,0,7,50,50
1745785426768,ECE 197,001,957920,Mercier; Patrick Philip,9992,0,9999,7
1745785427797,ECON 178,A01,907814,Zhu; Ying,28,0,35,7
1745785428823,EDS 115,A00,895312,Staff,41,0,45,4
1745785429849,EDS 117,A01,895337,Staff,30,0,30,0
1745785430878,EDS 125,A00,895341,Jones; Gabrielle Anastasia,43,0,45,2
1745785431904,EDS 128A,A01,895459,Fargason; Sharon Gayle,44,0,45,1
1745785432931,EDS 128B,A01,895543,Pappas; Elizabeth,44,0,45,1
1745785433960,EDS 139,A00,897203,Pappas; Elizabeth,44,0,45,1
1745785433960,EDS 139,B00,897209,Fargason; Sharon Gayle,44,0,45,1
1745785434986,EDS 201,A00,895545,Staff,43,0,45,2
1745785436015,EDS 203,A01,895581,Halter; Christopher P.,43,0,45,2
1745785437044,EDS 204R,A01,895625,Heinzman; Erica M.,44,0,45,1
1745785437044,EDS 204R,B01,895693,Halter; Christopher P.,18,0,45,27
1745785438108,EDS 206R,A00,895694,Fargason; Sharon Gayle,9,0,30,21
1745785438108,EDS 206R,B00,895695,Choi; Bailey Miyeon,20,0,30,10
1745785439135,EDS 250,A00,895697,Hemans; Patricia Ann Benitez,43,0,45,2
1745785440159,EDS 281,A00,895701,Meyerott; Theresa Ann,15,0,15,0
1745785441189,EDS 284,A00,895736,Meyerott; Theresa Ann,15,0,15,0
1745785442219,EDS 286,A00,897210,Fine; Sarah,15,0,15,0
1745785443246,EDS 289C,A01,895770,Daly; Alan J.,15,0,15,0
1745785444274,EDS 290,A00,897211,Hofstetter; Carolyn,15,0,15,0
1745785445304,LIGM 5A,A00,896162,Fischer-Grunski; Eva K,15,0,20,5
1745785446332,LIGM 5B,A00,896260,Fischer-Grunski; Eva K,17,0,20,3
1745785447359,LIGM 5C,A00,896308,Fischer-Grunski; Eva K,18,0,20,2
1745785448390,LIIT 5AS,A00,896313,Carnelos; Chiara,18,0,20,2
1745785449418,LIIT 5BS,A00,896416,Carnelos; Chiara,20,0,20,0
1745785450448,LIIT 5CS,A00,896564,Carnelos; Chiara,20,0,20,0
1745785451478,LISP 5A,A00,896588,Munoz Sanchez; Alicia,4,0,20,16
1745785452506,LISP 5B,A00,896653,Munoz Sanchez; Alicia,10,0,20,10
1745785453534,LISP 5C,A00,896655,Munoz Sanchez; Alicia,4,0,20,16
1745785454560,MAE 197,001,957918,Kleissl; Jan,9998,0,9999,1
1745785455587,MATH 2,A01,957937,Staff,34,0,35,1
1745785456612,MATH 197,001,957876,Kedlaya; Kiran S.,9993,0,9999,6
1745785457640,MCWP 40,A00,892729,Duru; Nur,13,0,20,7
1745785457640,MCWP 40,B00,893304,Montejo; Carolina,20,0,20,0
1745785458666,MCWP 40R,A00,893757,Redela; Pamela Morgan,0,6,20,20
1745785459694,MCWP 50,A00,893758,Morshed; Michael James,2,0,20,18
1745785459694,MCWP 50,B00,893761,Bartulis; Jason Michael,17,0,20,3
1745785460721,MCWP 50R,A00,893766,Compas; Sean Matthew,0,1,20,20
1745785460721,MCWP 50R,B00,893769,Carter; Jennifer A,0,0,20,20
1745785460721,MCWP 50R,C00,893771,Krone; Jarret,0,3,20,20
1745785460721,MCWP 50R,D00,893772,Miller; Elizabeth Deen,3,0,20,17
1745785460721,MCWP 50R,E00,893775,Carter; Andrea L,0,0,20,20
1745785461749,MMW 11R,A01,892721,Herbst; Matthew,11,0,27,16
1745785461749,MMW 11R,A02,892722,Herbst; Matthew,0,0,0,3
1745785462775,MMW 12R,A01,892724,Herbst; Matthew,0,9,16,16
1745785462775,MMW 12R,A02,892725,Herbst; Matthew,0,9,16,16
1745785463804,MMW 13R,A01,892727,Staff,0,3,16,16
1745785463804,MMW 13R,A02,892728,Staff,0,4,16,16
1745785463804,MMW 13R,A03,958032,Staff,0,3,16,16
1745785463804,MMW 13R,A04,958033,Staff,0,2,16,16
1745785463804,MMW 13R,A05,958034,Staff,0,3,16,16
1745785464831,SIO 295LS,A00,894015,Staff,7,0,25,18
1745785465861,SIO 295S,A00,894020,Staff,7,0,25,18
1745785466891,SIOC 290S,B01,958918,Staff,0,0,0,0
1745785467918,SIOC 291S,B01,958922,Staff,0,0,0,0
1745785468947,SOCI 117,A01,895339,Staff,4,0,5,1
1745785469974,WES 237B,A00,894149,Staff,11,0,20,9
1745785472034,AESE 279B,A00,891859,Staff,13,0,35,22
1745785473063,AIP 197,001,891854,Staff,70,0,70,0
1745785474090,ANTH 289S,A00,891856,Gagneux; Pascal,12,0,12,0
1745785475122,BENG 196,001,957946,Engler; Adam J.,9996,0,9999,3
1745785476150,CAT 124RS,A01,956906,Staff,8,0,25,17
1745785477175,CAT 125RS,A01,922013,Staff,8,0,25,17
1745785478201,CLRE 250,A00,891860,Morris; Sheldon,9995,0,9999,4
1745785480260,CLRE 251R,A00,907817,Mehta; Ravindra L.,9994,0,9999,5
1745785481285,CLRE 252,A00,891864,Cuomo; Raphael Eduardo,9993,0,9999,6
1745785482315,CLRE 253,A00,891867,Vaida; Florin,9994,0,9999,5
1745785482315,CLRE 253,B00,907819,Staff,9999,0,9999,0
1745785483341,CLRE 259,A00,891868,Patel; Hemal,9998,0,9999,1
1745785484371,CLRE 260,A00,891872,Cuomo; Raphael Eduardo,9999,0,9999,0
1745785485399,CLRE 297,001,891888,Cuomo; Raphael Eduardo,9999,0,9999,0
1745785486426,CSE 191,A00,958773,Minnes Kemp; Mor Mia,9999,0,9999,0
1745785487453,CSS 201S,A01,892054,Mignozzetti; Umberto,30,0,30,0
1745785488481,CSS 202S,A01,892056,Mignozzetti; Umberto,30,0,30,0
1745785489506,DSC 197,001,956898,Eldridge; Justin Matthew,9998,0,9999,1
1745785490532,DSC 297,001,958000,Mazumdar; Arya,9998,0,9999,1
1745785491559,EAP 100,A00,905686,Staff,9776,0,9999,223
1745785492586,ECE 45,A01,892618,Staff,0,12,50,50
1745785493613,ECE 109,A01,892620,Staff,0,43,0,0
1745785494640,ECE 111,A01,892719,Staff,0,7,50,50
1745785495668,ECE 197,001,957920,Mercier; Patrick Philip,9992,0,9999,7
1745785496696,ECON 178,A01,907814,Zhu; Ying,28,0,35,7
1745785497722,EDS 115,A00,895312,Staff,41,0,45,4
1745785498749,EDS 117,A01,895337,Staff,30,0,30,0
1745785499775,EDS 125,A00,895341,Jones; Gabrielle Anastasia,43,0,45,2
1745785500801,EDS 128A,A01,895459,Fargason; Sharon Gayle,44,0,45,1
1745785501830,EDS 128B,A01,895543,Pappas; Elizabeth,44,0,45,1
1745785502858,EDS 139,A00,897203,Pappas; Elizabeth,44,0,45,1
1745785502858,EDS 139,B00,897209,Fargason; Sharon Gayle,44,0,45,1
1745785503885,EDS 201,A00,895545,Staff,43,0,45,2
1745785504913,EDS 203,A01,895581,Halter; Christopher P.,43,0,45,2
1745785505947,EDS 204R,A01,895625,Heinzman; Erica M.,44,0,45,1
1745785505947,EDS 204R,B01,895693,Halter; Christopher P.,18,0,45,27
1745785506976,EDS 206R,A00,895694,Fargason; Sharon Gayle,9,0,30,21
1745785506976,EDS 206R,B00,895695,Choi; Bailey Miyeon,20,0,30,10
1745785508000,EDS 250,A00,895697,Hemans; Patricia Ann Benitez,43,0,45,2
1745785509029,EDS 281,A00,895701,Meyerott; Theresa Ann,15,0,15,0
1745785510054,EDS 284,A00,895736,Meyerott; Theresa Ann,15,0,15,0
1745785511080,EDS 286,A00,897210,Fine; Sarah,15,0,15,0
1745785512107,EDS 289C,A01,895770,Daly; Alan J.,15,0,15,0
1745785513132,EDS 290,A00,897211,Hofstetter; Carolyn,15,0,15,0
1745785514163,LIGM 5A,A00,896162,Fischer-Grunski; Eva K,15,0,20,5
1745785515188,LIGM 5B,A00,896260,Fischer-Grunski; Eva K,17,0,20,3
1745785516214,LIGM 5C,A00,896308,Fischer-Grunski; Eva K,18,0,20,2
1745785517244,LIIT 5AS,A00,896313,Carnelos; Chiara,18,0,20,2
1745785518271,LIIT 5BS,A00,896416,Carnelos; Chiara,20,0,20,0
1745785519301,LIIT 5CS,A00,896564,Carnelos; Chiara,20,0,20,0
1745785520327,LISP 5A,A00,896588,Munoz Sanchez; Alicia,4,0,20,16
1745785521355,LISP 5B,A00,896653,Munoz Sanchez; Alicia,10,0,20,10
1745785522461,LISP 5C,A00,896655,Munoz Sanchez; Alicia,4,0,20,16
1745785523486,MAE 197,001,957918,Kleissl; Jan,9998,0,9999,1
1745785524512,MATH 2,A01,957937,Staff,34,0,35,1
1745785525538,MATH 197,001,957876,Kedlaya; Kiran S.,9993,0,9999,6
1745785526564,MCWP 40,A00,892729,Duru; Nur,13,0,20,7
1745785526564,MCWP 40,B00,893304,Montejo; Carolina,20,0,20,0
1745785527594,MCWP 40R,A00,893757,Redela; Pamela Morgan,0,6,20,20
1745785528620,MCWP 50,A00,893758,Morshed; Michael James,2,0,20,18
1745785528620,MCWP 50,B00,893761,Bartulis; Jason Michael,17,0,20,3
1745785529650,MCWP 50R,A00,893766,Compas; Sean Matthew,0,1,20,20
1745785529650,MCWP 50R,B00,893769,Carter; Jennifer A,0,0,20,20
1745785529650,MCWP 50R,C00,893771,Krone; Jarret,0,3,20,20
1745785529650,MCWP 50R,D00,893772,Miller; Elizabeth Deen,3,0,20,17
1745785529650,MCWP 50R,E00,893775,Carter; Andrea L,0,0,20,20
1745785530675,MMW 11R,A01,892721,Herbst; Matthew,11,0,27,16
1745785530675,MMW 11R,A02,892722,Herbst; Matthew,0,0,0,3
1745785531705,MMW 12R,A01,892724,Herbst; Matthew,0,9,16,16
1745785531705,MMW 12R,A02,892725,Herbst; Matthew,0,9,16,16
1745785532731,MMW 13R,A01,892727,Staff,0,3,16,16
1745785532731,MMW 13R,A02,892728,Staff,0,4,16,16
1745785532731,MMW 13R,A03,958032,Staff,0,3,16,16
1745785532731,MMW 13R,A04,958033,Staff,0,2,16,16
1745785532731,MMW 13R,A05,958034,Staff,0,3,16,16
1745785533759,SIO 295LS,A00,894015,Staff,7,0,25,18
1745785534785,SIO 295S,A00,894020,Staff,7,0,25,18
1745785535812,SIOC 290S,B01,958918,Staff,0,0,0,0
1745785536839,SIOC 291S,B01,958922,Staff,0,0,0,0
1745785537866,SOCI 117,A01,895339,Staff,4,0,5,1
1745785538892,WES 237B,A00,894149,Staff,11,0,20,9
1745785540952,AESE 279B,A00,891859,Staff,13,0,35,22
1745785541977,AIP 197,001,891854,Staff,70,0,70,0
1745785543009,ANTH 289S,A00,891856,Gagneux; Pascal,12,0,12,0
1745785544036,BENG 196,001,957946,Engler; Adam J.,9996,0,9999,3
1745785545061,CAT 124RS,A01,956906,Staff,8,0,25,17
1745785546090,CAT 125RS,A01,922013,Staff,8,0,25,17
1745785547115,CLRE 250,A00,891860,Morris; Sheldon,9995,0,9999,4
1745785549168,CLRE 251R,A00,907817,Mehta; Ravindra L.,9994,0,9999,5
1745785550196,CLRE 252,A00,891864,Cuomo; Raphael Eduardo,9993,0,9999,6
1745785551222,CLRE 253,A00,891867,Vaida; Florin,9994,0,9999,5
1745785551222,CLRE 253,B00,907819,Staff,9999,0,9999,0
1745785552247,CLRE 259,A00,891868,Patel; Hemal,9998,0,9999,1
1745785553274,CLRE 260,A00,891872,Cuomo; Raphael Eduardo,9999,0,9999,0
1745785554303,CLRE 297,001,891888,Cuomo; Raphael Eduardo,9999,0,9999,0
1745785555330,CSE 191,A00,958773,Minnes Kemp; Mor Mia,9999,0,9999,0
1745785556360,CSS 201S,A01,892054,Mignozzetti; Umberto,30,0,30,0
1745785557387,CSS 202S,A01,892056,Mignozzetti; Umberto,30,0,30,0
1745785558413,DSC 197,001,956898,Eldridge; Justin Matthew,9998,0,9999,1
1745785559443,DSC 297,001,958000,Mazumdar; Arya,9998,0,9999,1
1745785560470,EAP 100,A00,905686,Staff,9776,0,9999,223
1745785561496,ECE 45,A01,892618,Staff,0,12,50,50
1745785562522,ECE 109,A01,892620,Staff,0,43,0,0
1745785563547,ECE 111,A01,892719,Staff,0,7,50,50
1745785564576,ECE 197,001,957920,Mercier; Patrick Philip,9992,0,9999,7
1745785565606,ECON 178,A01,907814,Zhu; Ying,28,0,35,7
1745785566632,EDS 115,A00,895312,Staff,41,0,45,4
1745785567658,EDS 117,A01,895337,Staff,30,0,30,0
1745785568684,EDS 125,A00,895341,Jones; Gabrielle Anastasia,43,0,45,2
1745785569710,EDS 128A,A01,895459,Fargason; Sharon Gayle,44,0,45,1
1745785570737,EDS 128B,A01,895543,Pappas; Elizabeth,44,0,45,1
1745785571770,EDS 139,A00,897203,Pappas; Elizabeth,44,0,45,1
1745785571770,EDS 139,B00,897209,Fargason; Sharon Gayle,44,0,45,1
1745785572795,EDS 201,A00,895545,Staff,43,0,45,2
1745785573821,EDS 203,A01,895581,Halter; Christopher P.,43,0,45,2
1745785574846,EDS 204R,A01,895625,Heinzman; Erica M.,44,0,45,1
1745785574846,EDS 204R,B01,895693,Halter; Christopher P.,18,0,45,27
1745785575877,EDS 206R,A00,895694,Fargason; Sharon Gayle,9,0,30,21
1745785575877,EDS 206R,B00,895695,Choi; Bailey Miyeon,20,0,30,10
1745785576906,EDS 250,A00,895697,Hemans; Patricia Ann Benitez,43,0,45,2
1745785577932,EDS 281,A00,895701,Meyerott; Theresa Ann,15,0,15,0
1745785578957,EDS 284,A00,895736,Meyerott; Theresa Ann,15,0,15,0
1745785579982,EDS 286,A00,897210,Fine; Sarah,15,0,15,0
1745785581008,EDS 289C,A01,895770,Daly; Alan J.,15,0,15,0
1745785582035,EDS 290,A00,897211,Hofstetter; Carolyn,15,0,15,0
1745785583061,LIGM 5A,A00,896162,Fischer-Grunski; Eva K,15,0,20,5
1745785584088,LIGM 5B,A00,896260,Fischer-Grunski; Eva K,17,0,20,3
1745785585117,LIGM 5C,A00,896308,Fischer-Grunski; Eva K,18,0,20,2
1745785586143,LIIT 5AS,A00,896313,Carnelos; Chiara,18,0,20,2
1745785587169,LIIT 5BS,A00,896416,Carnelos; Chiara,20,0,20,0
1745785588196,LIIT 5CS,A00,896564,Carnelos; Chiara,20,0,20,0
1745785589225,LISP 5A,A00,896588,Munoz Sanchez; Alicia,4,0,20,16
1745785590251,LISP 5B,A00,896653,Munoz Sanchez; Alicia,10,0,20,10
1745785591277,LISP 5C,A00,896655,Munoz Sanchez; Alicia,4,0,20,16
1745785592304,MAE 197,001,957918,Kleissl; Jan,9998,0,9999,1
1745785593330,MATH 2,A01,957937,Staff,34,0,35,1
1745785594357,MATH 197,001,957876,Kedlaya; Kiran S.,9993,0,9999,6
1745785595382,MCWP 40,A00,892729,Duru; Nur,13,0,20,7
1745785595382,MCWP 40,B00,893304,Montejo; Carolina,20,0,20,0
1745785596409,MCWP 40R,A00,893757,Redela; Pamela Morgan,0,6,20,20
1745785597434,MCWP 50,A00,893758,Morshed; Michael James,2,0,20,18
1745785597434,MCWP 50,B00,893761,Bartulis; Jason Michael,17,0,20,3
1745785598462,MCWP 50R,A00,893766,Compas; Sean Matthew,0,1,20,20
1745785598462,MCWP 50R,B00,893769,Carter; Jennifer A,0,0,20,20
1745785598462,MCWP 50R,C00,893771,Krone; Jarret,0,3,20,20
1745785598462,MCWP 50R,D00,893772,Miller; Elizabeth Deen,3,0,20,17
1745785598462,MCWP 50R,E00,893775,Carter; Andrea L,0,0,20,20
1745785599487,MMW 11R,A01,892721,Herbst; Matthew,11,0,27,16
1745785599487,MMW 11R,A02,892722,Herbst; Matthew,0,0,0,3
1745785600511,MMW 12R,A01,892724,Herbst; Matthew,0,9,16,16
1745785600511,MMW 12R,A02,892725,Herbst; Matthew,0,9,16,16
1745785601541,MMW 13R,A01,892727,Staff,0,3,16,16
1745785601541,MMW 13R,A02,892728,Staff,0,4,16,16
1745785601541,MMW 13R,A03,958032,Staff,0,3,16,16
1745785601541,MMW 13R,A04,958033,Staff,0,2,16,16
1745785601541,MMW 13R,A05,958034,Staff,0,3,16,16
1745785602569,SIO 295LS,A00,894015,Staff,7,0,25,18
1745785603595,SIO 295S,A00,894020,Staff,7,0,25,18
1745785604621,SIOC 290S,B01,958918,Staff,0,0,0,0
1745785605647,SIOC 291S,B01,958922,Staff,0,0,0,0
1745785606673,SOCI 117,A01,895339,Staff,4,0,5,1
1745785607698,WES 237B,A00,894149,Staff,11,0,20,9
1745785609755,AESE 279B,A00,891859,Staff,13,0,35,22
1745785610781,AIP 197,001,891854,Staff,70,0,70,0
1745785611806,ANTH 289S,A00,891856,Gagneux; Pascal,12,0,12,0
1745785612832,BENG 196,001,957946,Engler; Adam J.,9996,0,9999,3
1745785613859,CAT 124RS,A01,956906,Staff,8,0,25,17
1745785614884,CAT 125RS,A01,922013,Staff,8,0,25,17
1745785615910,CLRE 250,A00,891860,Morris; Sheldon,9995,0,9999,4
1745785617962,CLRE 251R,A00,907817,Mehta; Ravindra L.,9994,0,9999,5
1745785618987,CLRE 252,A00,891864,Cuomo; Raphael Eduardo,9993,0,9999,6
1745785620019,CLRE 253,A00,891867,Vaida; Florin,9994,0,9999,5
1745785620019,CLRE 253,B00,907819,Staff,9999,0,9999,0
1745785621045,CLRE 259,A00,891868,Patel; Hemal,9998,0,9999,1
1745785622074,CLRE 260,A00,891872,Cuomo; Raphael Eduardo,9999,0,9999,0
1745785623102,CLRE 297,001,891888,Cuomo; Raphael Eduardo,9999,0,9999,0
1745785624127,CSE 191,A00,958773,Minnes Kemp; Mor Mia,9999,0,9999,0
1745785625156,CSS 201S,A01,892054,Mignozzetti; Umberto,30,0,30,0
1745785626183,CSS 202S,A01,892056,Mignozzetti; Umberto,30,0,30,0
1745785627211,DSC 197,001,956898,Eldridge; Justin Matthew,9998,0,9999,1
1745785628239,DSC 297,001,958000,Mazumdar; Arya,9998,0,9999,1
1745785629267,EAP 100,A00,905686,Staff,9776,0,9999,223
1745785630296,ECE 45,A01,892618,Staff,0,12,50,50
1745785631324,ECE 109,A01,892620,Staff,0,43,0,0
1745785632351,ECE 111,A01,892719,Staff,0,7,50,50
1745785633376,ECE 197,001,957920,Mercier; Patrick Philip,9992,0,9999,7
1745785634405,ECON 178,A01,907814,Zhu; Ying,28,0,35,7
1745785635430,EDS 115,A00,895312,Staff,41,0,45,4
1745785636457,EDS 117,A01,895337,Staff,30,0,30,0
1745785637484,EDS 125,A00,895341,Jones; Gabrielle Anastasia,43,0,45,2
1745785638509,EDS 128A,A01,895459,Fargason; Sharon Gayle,44,0,45,1
1745785639535,EDS 128B,A01,895543,Pappas; Elizabeth,44,0,45,1
1745785640560,EDS 139,A00,897203,Pappas; Elizabeth,44,0,45,1
1745785640560,EDS 139,B00,897209,Fargason; Sharon Gayle,44,0,45,1
1745785641587,EDS 201,A00,895545,Staff,43,0,45,2
1745785642615,EDS 203,A01,895581,Halter; Christopher P.,43,0,45,2
1745785643641,EDS 204R,A01,895625,Heinzman; Erica M.,44,0,45,1
1745785643641,EDS 204R,B01,895693,Halter; Christopher P.,18,0,45,27
1745785644670,EDS 206R,A00,895694,Fargason; Sharon Gayle,9,0,30,21
1745785644670,EDS 206R,B00,895695,Choi; Bailey Miyeon,20,0,30,10
1745785645752,EDS 250,A00,895697,Hemans; Patricia Ann Benitez,43,0,45,2
1745785646780,EDS 281,A00,895701,Meyerott; Theresa Ann,15,0,15,0
1745785647808,EDS 284,A00,895736,Meyerott; Theresa Ann,15,0,15,0
1745785648834,EDS 286,A00,897210,Fine; Sarah,15,0,15,0
1745785649861,EDS 289C,A01,895770,Daly; Alan J.,15,0,15,0
1745785650887,EDS 290,A00,897211,Hofstetter; Carolyn,15,0,15,0
1745785651915,LIGM 5A,A00,896162,Fischer-Grunski; Eva K,15,0,20,5
1745785652945,LIGM 5B,A00,896260,Fischer-Grunski; Eva K,17,0,20,3
1745785653973,LIGM 5C,A00,896308,Fischer-Grunski; Eva K,18,0,20,2
1745785655000,LIIT 5AS,A00,896313,Carnelos; Chiara,18,0,20,2
1745785656026,LIIT 5BS,A00,896416,Carnelos; Chiara,20,0,20,0
1745785657052,LIIT 5CS,A00,896564,Carnelos; Chiara,20,0,20,0
1745785658081,LISP 5A,A00,896588,Munoz Sanchez; Alicia,4,0,20,16
1745785659106,LISP 5B,A00,896653,Munoz Sanchez; Alicia,10,0,20,10
1745785660136,LISP 5C,A00,896655,Munoz Sanchez; Alicia,4,0,20,16
1745785661164,MAE 197,001,957918,Kleissl; Jan,9998,0,9999,1
1745785662191,MATH 2,A01,957937,Staff,34,0,35,1
1745785663216,MATH 197,001,957876,Kedlaya; Kiran S.,9993,0,9999,6
1745785664242,MCWP 40,A00,892729,Duru; Nur,13,0,20,7
1745785664242,MCWP 40,B00,893304,Montejo; Carolina,20,0,20,0
1745785665271,MCWP 40R,A00,893757,Redela; Pamela Morgan,0,6,20,20
1745785666299,MCWP 50,A00,893758,Morshed; Michael James,2,0,20,18
1745785666299,MCWP 50,B00,893761,Bartulis; Jason Michael,17,0,20,3
1745785667328,MCWP 50R,A00,893766,Compas; Sean Matthew,0,1,20,20
1745785667328,MCWP 50R,B00,893769,Carter; Jennifer A,0,0,20,20
1745785667328,MCWP 50R,C00,893771,Krone; Jarret,0,3,20,20
1745785667328,MCWP 50R,D00,893772,Miller; Elizabeth Deen,3,0,20,17
1745785667328,MCWP 50R,E00,893775,Carter; Andrea L,0,0,20,20
1745785668358,MMW 11R,A01,892721,Herbst; Matthew,11,0,27,16
1745785668358,MMW 11R,A02,892722,Herbst; Matthew,0,0,0,3
1745785669383,MMW 12R,A01,892724,Herbst; Matthew,0,9,16,16
1745785669383,MMW 12R,A02,892725,Herbst; Matthew,0,9,16,16
1745785670411,MMW 13R,A01,892727,Staff,0,3,16,16
1745785670411,MMW 13R,A02,892728,Staff,0,4,16,16
1745785670411,MMW 13R,A03,958032,Staff,0,3,16,16
1745785670411,MMW 13R,A04,958033,Staff,0,2,16,16
1745785670411,MMW 13R,A05,958034,Staff,0,3,16,16
1745785671440,SIO 295LS,A00,894015,Staff,7,0,25,18
1745785672468,SIO 295S,A00,894020,Staff,7,0,25,18
1745785673495,SIOC 290S,B01,958918,Staff,0,0,0,0
1745785674523,SIOC 291S,B01,958922,Staff,0,0,0,0
1745785675550,SOCI 117,A01,895339,Staff,4,0,5,1
1745785676581,WES 237B,A00,894149,Staff,11,0,20,9
1745785678646,AESE 279B,A00,891859,Staff,13,0,35,22
1745785679674,AIP 197,001,891854,Staff,70,0,70,0
1745785680698,ANTH 289S,A00,891856,Gagneux; Pascal,12,0,12,0
1745785681724,BENG 196,001,957946,Engler; Adam J.,9996,0,9999,3
1745785682748,CAT 124RS,A01,956906,Staff,8,0,25,17
1745785683774,CAT 125RS,A01,922013,Staff,8,0,25,17
1745785684799,CLRE 250,A00,891860,Morris; Sheldon,9995,0,9999,4
1745785686851,CLRE 251R,A00,907817,Mehta; Ravindra L.,9994,0,9999,5
1745785687880,CLRE 252,A00,891864,Cuomo; Raphael Eduardo,9993,0,9999,6
1745785688906,CLRE 253,A00,891867,Vaida; Florin,9994,0,9999,5
1745785688906,CLRE 253,B00,907819,Staff,9999,0,9999,0
1745785689933,CLRE 259,A00,891868,Patel; Hemal,9998,0,9999,1
1745785690960,CLRE 260,A00,891872,Cuomo; Raphael Eduardo,9999,0,9999,0
1745785691986,CLRE 297,001,891888,Cuomo; Raphael Eduardo,9999,0,9999,0
1745785693016,CSE 191,A00,958773,Minnes Kemp; Mor Mia,9999,0,9999,0
1745785694041,CSS 201S,A01,892054,Mignozzetti; Umberto,30,0,30,0
1745785695069,CSS 202S,A01,892056,Mignozzetti; Umberto,30,0,30,0
1745785696098,DSC 197,001,956898,Eldridge; Justin Matthew,9998,0,9999,1
1745785697123,DSC 297,001,958000,Mazumdar; Arya,9998,0,9999,1
1745785698152,EAP 100,A00,905686,Staff,9776,0,9999,223
1745785699181,ECE 45,A01,892618,Staff,0,12,50,50
1745785700211,ECE 109,A01,892620,Staff,0,43,0,0
1745785701237,ECE 111,A01,892719,Staff,0,7,50,50
1745785702265,ECE 197,001,957920,Mercier; Patrick Philip,9992,0,9999,7
1745785703292,ECON 178,A01,907814,Zhu; Ying,28,0,35,7
1745785704319,EDS 115,A00,895312,Staff,41,0,45,4
1745785705349,EDS 117,A01,895337,Staff,30,0,30,0
1745785706375,EDS 125,A00,895341,Jones; Gabrielle Anastasia,43,0,45,2
1745785707403,EDS 128A,A01,895459,Fargason; Sharon Gayle,44,0,45,1
1745785708432,EDS 128B,A01,895543,Pappas; Elizabeth,44,0,45,1
1745785709458,EDS 139,A00,897203,Pappas; Elizabeth,44,0,45,1
1745785709458,EDS 139,B00,897209,Fargason; Sharon Gayle,44,0,45,1
1745785710484,EDS 201,A00,895545,Staff,43,0,45,2
1745785711538,EDS 203,A01,895581,Halter; Christopher P.,43,0,45,2
1745785712565,EDS 204R,A01,895625,Heinzman; Erica M.,44,0,45,1
1745785712565,EDS 204R,B01,895693,Halter; Christopher P.,18,0,45,27
1745785713591,EDS 206R,A00,895694,Fargason; Sharon Gayle,9,0,30,21
1745785713591,EDS 206R,B00,895695,Choi; Bailey Miyeon,20,0,30,10
1745785714616,EDS 250,A00,895697,Hemans; Patricia Ann Benitez,43,0,45,2
1745785715643,EDS 281,A00,895701,Meyerott; Theresa Ann,15,0,15,0
1745785716668,EDS 284,A00,895736,Meyerott; Theresa Ann,15,0,15,0
1745785717704,EDS 286,A00,897210,Fine; Sarah,15,0,15,0
1745785718728,EDS 289C,A01,895770,Daly; Alan J.,15,0,15,0
1745785719751,EDS 290,A00,897211,Hofstetter; Carolyn,15,0,15,0
1745785720777,LIGM 5A,A00,896162,Fischer-Grunski; Eva K,15,0,20,5
1745785721802,LIGM 5B,A00,896260,Fischer-Grunski; Eva K,17,0,20,3
1745785722832,LIGM 5C,A00,896308,Fischer-Grunski; Eva K,18,0,20,2
1745785723857,LIIT 5AS,A00,896313,Carnelos; Chiara,18,0,20,2
1745785724883,LIIT 5BS,A00,896416,Carnelos; Chiara,20,0,20,0
1745785725907,LIIT 5CS,A00,896564,Carnelos; Chiara,20,0,20,0
1745785726937,LISP 5A,A00,896588,Munoz Sanchez; Alicia,4,0,20,16
1745785727965,LISP 5B,A00,896653,Munoz Sanchez; Alicia,10,0,20,10
1745785728994,LISP 5C,A00,896655,Munoz Sanchez; Alicia,4,0,20,16
1745785730018,MAE 197,001,957918,Kleissl; Jan,9998,0,9999,1
1745785731044,MATH 2,A01,957937,Staff,34,0,35,1
1745785732068,MATH 197,001,957876,Kedlaya; Kiran S.,9993,0,9999,6
1745785733096,MCWP 40,A00,892729,Duru; Nur,13,0,20,7
1745785733096,MCWP 40,B00,893304,Montejo; Carolina,20,0,20,0
1745785734121,MCWP 40R,A00,893757,Redela; Pamela Morgan,0,6,20,20
1745785735145,MCWP 50,A00,893758,Morshed; Michael James,2,0,20,18
1745785735145,MCWP 50,B00,893761,Bartulis; Jason Michael,17,0,20,3
1745785736171,MCWP 50R,A00,893766,Compas; Sean Matthew,0,1,20,20
1745785736171,MCWP 50R,B00,893769,Carter; Jennifer A,0,0,20,20
1745785736171,MCWP 50R,C00,893771,Krone; Jarret,0,3,20,20
1745785736171,MCWP 50R,D00,893772,Miller; Elizabeth Deen,3,0,20,17
1745785736171,MCWP 50R,E00,893775,Carter; Andrea L,0,0,20,20
1745785737199,MMW 11R,A01,892721,Herbst; Matthew,11,0,27,16
1745785737199,MMW 11R,A02,892722,Herbst; Matthew,0,0,0,3
1745785738227,MMW 12R,A01,892724,Herbst; Matthew,0,9,16,16
1745785738227,MMW 12R,A02,892725,Herbst; Matthew,0,9,16,16
1745785739257,MMW 13R,A01,892727,Staff,0,3,16,16
1745785739257,MMW 13R,A02,892728,Staff,0,4,16,16
1745785739257,MMW 13R,A03,958032,Staff,0,3,16,16
1745785739257,MMW 13R,A04,958033,Staff,0,2,16,16
1745785739257,MMW 13R,A05,958034,Staff,0,3,16,16
1745785740283,SIO 295LS,A00,894015,Staff,7,0,25,18
1745785741308,SIO 295S,A00,894020,Staff,7,0,25,18
1745785742335,SIOC 290S,B01,958918,Staff,0,0,0,0
1745785743361,SIOC 291S,B01,958922,Staff,0,0,0,0
1745785744387,SOCI 117,A01,895339,Staff,4,0,5,1
1745785745415,WES 237B,A00,894149,Staff,11,0,20,9
1745785747483,AESE 279B,A00,891859,Staff,13,0,35,22
1745785748509,AIP 197,001,891854,Staff,70,0,70,0
1745785749535,ANTH 289S,A00,891856,Gagneux; Pascal,12,0,12,0
1745785750560,BENG 196,001,957946,Engler; Adam J.,9996,0,9999,3
1745785751585,CAT 124RS,A01,956906,Staff,8,0,25,17
1745785752610,CAT 125RS,A01,922013,Staff,8,0,25,17
1745785753636,CLRE 250,A00,891860,Morris; Sheldon,9995,0,9999,4
1745785755689,CLRE 251R,A00,907817,Mehta; Ravindra L.,9994,0,9999,5
1745785756716,CLRE 252,A00,891864,Cuomo; Raphael Eduardo,9993,0,9999,6
1745785757741,CLRE 253,A00,891867,Vaida; Florin,9994,0,9999,5
1745785757741,CLRE 253,B00,907819,Staff,9999,0,9999,0
1745785758769,CLRE 259,A00,891868,Patel; Hemal,9998,0,9999,1
1745785759794,CLRE 260,A00,891872,Cuomo; Raphael Eduardo,9999,0,9999,0
1745785760822,CLRE 297,001,891888,Cuomo; Raphael Eduardo,9999,0,9999,0
1745785761848,CSE 191,A00,958773,Minnes Kemp; Mor Mia,9999,0,9999,0
1745785762873,CSS 201S,A01,892054,Mignozzetti; Umberto,30,0,30,0
1745785763901,CSS 202S,A01,892056,Mignozzetti; Umberto,30,0,30,0
1745785764928,DSC 197,001,956898,Eldridge; Justin Matthew,9998,0,9999,1
1745785765953,DSC 297,001,958000,Mazumdar; Arya,9998,0,9999,1
1745785766979,EAP 100,A00,905686,Staff,9776,0,9999,223
1745785768004,ECE 45,A01,892618,Staff,0,12,50,50
1745785769033,ECE 109,A01,892620,Staff,0,43,0,0
1745785770058,ECE 111,A01,892719,Staff,0,7,50,50
1745785771083,ECE 197,001,957920,Mercier; Patrick Philip,9992,0,9999,7
1745785772112,ECON 178,A01,907814,Zhu; Ying,28,0,35,7
1745785773138,EDS 115,A00,895312,Staff,41,0,45,4
1745785774167,EDS 117,A01,895337,Staff,30,0,30,0
1745785775197,EDS 125,A00,895341,Jones; Gabrielle Anastasia,43,0,45,2
1745785776226,EDS 128A,A01,895459,Fargason; Sharon Gayle,44,0,45,1
1745785777251,EDS 128B,A01,895543,Pappas; Elizabeth,44,0,45,1
1745785778302,EDS 139,A00,897203,Pappas; Elizabeth,44,0,45,1
1745785778302,EDS 139,B00,897209,Fargason; Sharon Gayle,44,0,45,1
1745785779327,EDS 201,A00,895545,Staff,43,0,45,2
1745785780353,EDS 203,A01,895581,Halter; Christopher P.,43,0,45,2
1745785781381,EDS 204R,A01,895625,Heinzman; Erica M.,44,0,45,1
1745785781381,EDS 204R,B01,895693,Halter; Christopher P.,18,0,45,27
1745785782405,EDS 206R,A00,895694,Fargason; Sharon Gayle,9,0,30,21
1745785782405,EDS 206R,B00,895695,Choi; Bailey Miyeon,20,0,30,10
1745785783435,EDS 250,A00,895697,Hemans; Patricia Ann Benitez,43,0,45,2
1745785784462,EDS 281,A00,895701,Meyerott; Theresa Ann,15,0,15,0
1745785785487,EDS 284,A00,895736,Meyerott; Theresa Ann,15,0,15,0
1745785786512,EDS 286,A00,897210,Fine; Sarah,15,0,15,0
1745785787539,EDS 289C,A01,895770,Daly; Alan J.,15,0,15,0
1745785788564,EDS 290,A00,897211,Hofstetter; Carolyn,15,0,15,0
1745785789587,LIGM 5A,A00,896162,Fischer-Grunski; Eva K,15,0,20,5
1745785790618,LIGM 5B,A00,896260,Fischer-Grunski; Eva K,17,0,20,3
1745785791644,LIGM 5C,A00,896308,Fischer-Grunski; Eva K,18,0,20,2
1745785792670,LIIT 5AS,A00,896313,Carnelos; Chiara,18,0,20,2
1745785793700,LIIT 5BS,A00,896416,Carnelos; Chiara,20,0,20,0
1745785794725,LIIT 5CS,A00,896564,Carnelos; Chiara,20,0,20,0
1745785795752,LISP 5A,A00,896588,Munoz Sanchez; Alicia,4,0,20,16
1745785796780,LISP 5B,A00,896653,Munoz Sanchez; Alicia,10,0,20,10
1745785797810,LISP 5C,A00,896655,Munoz Sanchez; Alicia,4,0,20,16
1745785798837,MAE 197,001,957918,Kleissl; Jan,9998,0,9999,1
1745785799863,MATH 2,A01,957937,Staff,34,0,35,1
1745785800889,MATH 197,001,957876,Kedlaya; Kiran S.,9993,0,9999,6
1745785801919,MCWP 40,A00,892729,Duru; Nur,13,0,20,7
1745785801919,MCWP 40,B00,893304,Montejo; Carolina,20,0,20,0
1745785802949,MCWP 40R,A00,893757,Redela; Pamela Morgan,0,6,20,20
1745785803974,MCWP 50,A00,893758,Morshed; Michael James,2,0,20,18
1745785803974,MCWP 50,B00,893761,Bartulis; Jason Michael,17,0,20,3
1745785805002,MCWP 50R,A00,893766,Compas; Sean Matthew,0,1,20,20
1745785805002,MCWP 50R,B00,893769,Carter; Jennifer A,0,0,20,20
1745785805002,MCWP 50R,C00,893771,Krone; Jarret,0,3,20,20
1745785805002,MCWP 50R,D00,893772,Miller; Elizabeth Deen,3,0,20,17
1745785805002,MCWP 50R,E00,893775,Carter; Andrea L,0,0,20,20
1745785806028,MMW 11R,A01,892721,Herbst; Matthew,11,0,27,16
1745785806028,MMW 11R,A02,892722,Herbst; Matthew,0,0,0,3
1745785807056,MMW 12R,A01,892724,Herbst; Matthew,0,9,16,16
1745785807056,MMW 12R,A02,892725,Herbst; Matthew,0,9,16,16
1745785808083,MMW 13R,A01,892727,Staff,0,3,16,16
1745785808083,MMW 13R,A02,892728,Staff,0,4,16,16
1745785808083,MMW 13R,A03,958032,Staff,0,3,16,16
1745785808083,MMW 13R,A04,958033,Staff,0,2,16,16
1745785808083,MMW 13R,A05,958034,Staff,0,3,16,16
1745785809110,SIO 295LS,A00,894015,Staff,7,0,25,18
1745785810139,SIO 295S,A00,894020,Staff,7,0,25,18
1745785811172,SIOC 290S,B01,958918,Staff,0,0,0,0
1745785812198,SIOC 291S,B01,958922,Staff,0,0,0,0
1745785813225,SOCI 117,A01,895339,Staff,4,0,5,1
1745785814251,WES 237B,A00,894149,Staff,11,0,20,9
1745785816315,AESE 279B,A00,891859,Staff,13,0,35,22
1745785817341,AIP 197,001,891854,Staff,70,0,70,0
1745785818369,ANTH 289S,A00,891856,Gagneux; Pascal,12,0,12,0
1745785819395,BENG 196,001,957946,Engler; Adam J.,9996,0,9999,3
1745785820423,CAT 124RS,A01,956906,Staff,8,0,25,17
1745785821449,CAT 125RS,A01,922013,Staff,8,0,25,17
1745785822475,CLRE 250,A00,891860,Morris; Sheldon,9995,0,9999,4
1745785824525,CLRE 251R,A00,907817,Mehta; Ravindra L.,9994,0,9999,5
1745785825552,CLRE 252,A00,891864,Cuomo; Raphael Eduardo,9993,0,9999,6
1745785826581,CLRE 253,A00,891867,Vaida; Florin,9994,0,9999,5
1745785826581,CLRE 253,B00,907819,Staff,9999,0,9999,0
1745785827606,CLRE 259,A00,891868,Patel; Hemal,9998,0,9999,1
1745785828631,CLRE 260,A00,891872,Cuomo; Raphael Eduardo,9999,0,9999,0
1745785829656,CLRE 297,001,891888,Cuomo; Raphael Eduardo,9999,0,9999,0
1745785830681,CSE 191,A00,958773,Minnes Kemp; Mor Mia,9999,0,9999,0
1745785831711,CSS 201S,A01,892054,Mignozzetti; Umberto,30,0,30,0
1745785832736,CSS 202S,A01,892056,Mignozzetti; Umberto,30,0,30,0
1745785833762,DSC 197,001,956898,Eldridge; Justin Matthew,9998,0,9999,1
1745785834786,DSC 297,001,958000,Mazumdar; Arya,9998,0,9999,1
1745785835811,EAP 100,A00,905686,Staff,9776,0,9999,223
1745785836836,ECE 45,A01,892618,Staff,0,12,50,50
1745785837860,ECE 109,A01,892620,Staff,0,43,0,0
1745785838886,ECE 111,A01,892719,Staff,0,7,50,50
1745785839913,ECE 197,001,957920,Mercier; Patrick Philip,9992,0,9999,7
1745785840938,ECON 178,A01,907814,Zhu; Ying,28,0,35,7
1745785841964,EDS 115,A00,895312,Staff,41,0,45,4
1745785842995,EDS 117,A01,895337,Staff,30,0,30,0
1745785844020,EDS 125,A00,895341,Jones; Gabrielle Anastasia,43,0,45,2
1745785845047,EDS 128A,A01,895459,Fargason; Sharon Gayle,44,0,45,1
1745785846074,EDS 128B,A01,895543,Pappas; Elizabeth,44,0,45,1
1745785847101,EDS 139,A00,897203,Pappas; Elizabeth,44,0,45,1
1745785847101,EDS 139,B00,897209,Fargason; Sharon Gayle,44,0,45,1
1745785848127,EDS 201,A00,895545,Staff,43,0,45,2
1745785849154,EDS 203,A01,895581,Halter; Christopher P.,43,0,45,2
1745785850183,EDS 204R,A01,895625,Heinzman; Erica M.,44,0,45,1
1745785850183,EDS 204R,B01,895693,Halter; Christopher P.,18,0,45,27
1745785851212,EDS 206R,A00,895694,Fargason; Sharon Gayle,9,0,30,21
1745785851212,EDS 206R,B00,895695,Choi; Bailey Miyeon,20,0,30,10
1745785852237,EDS 250,A00,895697,Hemans; Patricia Ann Benitez,43,0,45,2
1745785853319,EDS 281,A00,895701,Meyerott; Theresa Ann,15,0,15,0
1745785854346,EDS 284,A00,895736,Meyerott; Theresa Ann,15,0,15,0
1745785855374,EDS 286,A00,897210,Fine; Sarah,15,0,15,0
1745785856401,EDS 289C,A01,895770,Daly; Alan J.,15,0,15,0
1745785857428,EDS 290,A00,897211,Hofstetter; Carolyn,15,0,15,0
1745785858456,LIGM 5A,A00,896162,Fischer-Grunski; Eva K,15,0,20,5
1745785859483,LIGM 5B,A00,896260,Fischer-Grunski; Eva K,17,0,20,3
1745785860513,LIGM 5C,A00,896308,Fischer-Grunski; Eva K,18,0,20,2
1745785861572,LIIT 5AS,A00,896313,Carnelos; Chiara,18,0,20,2
1745785862599,LIIT 5BS,A00,896416,Carnelos; Chiara,20,0,20,0
1745785863625,LIIT 5CS,A00,896564,Carnelos; Chiara,20,0,20,0
1745785864651,LISP 5A,A00,896588,Munoz Sanchez; Alicia,4,0,20,16
1745785865676,LISP 5B,A00,896653,Munoz Sanchez; Alicia,10,0,20,10
1745785866703,LISP 5C,A00,896655,Munoz Sanchez; Alicia,4,0,20,16
1745785867730,MAE 197,001,957918,Kleissl; Jan,9998,0,9999,1
1745785868757,MATH 2,A01,957937,Staff,34,0,35,1
1745785869783,MATH 197,001,957876,Kedlaya; Kiran S.,9993,0,9999,6
1745785870810,MCWP 40,A00,892729,Duru; Nur,13,0,20,7
1745785870810,MCWP 40,B00,893304,Montejo; Carolina,20,0,20,0
1745785871839,MCWP 40R,A00,893757,Redela; Pamela Morgan,0,6,20,20
1745785872870,MCWP 50,A00,893758,Morshed; Michael James,2,0,20,18
1745785872870,MCWP 50,B00,893761,Bartulis; Jason Michael,17,0,20,3
1745785873897,MCWP 50R,A00,893766,Compas; Sean Matthew,0,1,20,20
1745785873897,MCWP 50R,B00,893769,Carter; Jennifer A,0,0,20,20
1745785873897,MCWP 50R,C00,893771,Krone; Jarret,0,3,20,20
1745785873897,MCWP 50R,D00,893772,Miller; Elizabeth Deen,3,0,20,17
1745785873897,MCWP 50R,E00,893775,Carter; Andrea L,0,0,20,20
1745785874926,MMW 11R,A01,892721,Herbst; Matthew,11,0,27,16
1745785874926,MMW 11R,A02,892722,Herbst; Matthew,0,0,0,3
1745785875953,MMW 12R,A01,892724,Herbst; Matthew,0,9,16,16
1745785875953,MMW 12R,A02,892725,Herbst; Matthew,0,9,16,16
1745785876980,MMW 13R,A01,892727,Staff,0,3,16,16
1745785876980,MMW 13R,A02,892728,Staff,0,4,16,16
1745785876980,MMW 13R,A03,958032,Staff,0,3,16,16
1745785876980,MMW 13R,A04,958033,Staff,0,2,16,16
1745785876980,MMW 13R,A05,958034,Staff,0,3,16,16
1745785878008,SIO 295LS,A00,894015,Staff,7,0,25,18
1745785879037,SIO 295S,A00,894020,Staff,7,0,25,18
1745785880064,SIOC 290S,B01,958918,Staff,0,0,0,0
1745785881094,SIOC 291S,B01,958922,Staff,0,0,0,0
1745785882122,SOCI 117,A01,895339,Staff,4,0,5,1
1745785883150,WES 237B,A00,894149,Staff,11,0,20,9
1745785885207,AESE 279B,A00,891859,Staff,13,0,35,22
1745785886235,AIP 197,001,891854,Staff,70,0,70,0
1745785887260,ANTH 289S,A00,891856,Gagneux; Pascal,12,0,12,0
1745785888288,BENG 196,001,957946,Engler; Adam J.,9996,0,9999,3
1745785889316,CAT 124RS,A01,956906,Staff,8,0,25,17
1745785890342,CAT 125RS,A01,922013,Staff,8,0,25,17
1745785891372,CLRE 250,A00,891860,Morris; Sheldon,9995,0,9999,4
1745785893427,CLRE 251R,A00,907817,Mehta; Ravindra L.,9994,0,9999,5
1745785894454,CLRE 252,A00,891864,Cuomo; Raphael Eduardo,9993,0,9999,6
1745785895481,CLRE 253,A00,891867,Vaida; Florin,9994,0,9999,5
1745785895481,CLRE 253,B00,907819,Staff,9999,0,9999,0
1745785896510,CLRE 259,A00,891868,Patel; Hemal,9998,0,9999,1
1745785897537,CLRE 260,A00,891872,Cuomo; Raphael Eduardo,9999,0,9999,0
1745785898564,CLRE 297,001,891888,Cuomo; Raphael Eduardo,9999,0,9999,0
1745785899591,CSE 191,A00,958773,Minnes Kemp; Mor Mia,9999,0,9999,0
1745785900617,CSS 201S,A01,892054,Mignozzetti; Umberto,30,0,30,0
1745785901648,CSS 202S,A01,892056,Mignozzetti; Umberto,30,0,30,0
1745785902676,DSC 197,001,956898,Eldridge; Justin Matthew,9998,0,9999,1
1745785903702,DSC 297,001,958000,Mazumdar; Arya,9998,0,9999,1
1745785904729,EAP 100,A00,905686,Staff,9776,0,9999,223
1745785905758,ECE 45,A01,892618,Staff,0,12,50,50
1745785906786,ECE 109,A01,892620,Staff,0,43,0,0
1745785907811,ECE 111,A01,892719,Staff,0,7,50,50
1745785908837,ECE 197,001,957920,Mercier; Patrick Philip,9992,0,9999,7
1745785909867,ECON 178,A01,907814,Zhu; Ying,28,0,35,7
1745785910895,EDS 115,A00,895312,Staff,41,0,45,4
1745785911922,EDS 117,A01,895337,Staff,30,0,30,0
1745785912948,EDS 125,A00,895341,Jones; Gabrielle Anastasia,43,0,45,2
1745785913973,EDS 128A,A01,895459,Fargason; Sharon Gayle,44,0,45,1
1745785914999,EDS 128B,A01,895543,Pappas; Elizabeth,44,0,45,1
1745785916024,EDS 139,A00,897203,Pappas; Elizabeth,44,0,45,1
1745785916024,EDS 139,B00,897209,Fargason; Sharon Gayle,44,0,45,1
1745785917052,EDS 201,A00,895545,Staff,43,0,45,2
1745785918077,EDS 203,A01,895581,Halter; Christopher P.,43,0,45,2
1745785919105,EDS 204R,A01,895625,Heinzman; Erica M.,44,0,45,1
1745785919105,EDS 204R,B01,895693,Halter; Christopher P.,18,0,45,27
1745785920134,EDS 206R,A00,895694,Fargason; Sharon Gayle,9,0,30,21
1745785920134,EDS 206R,B00,895695,Choi; Bailey Miyeon,20,0,30,10
1745785921161,EDS 250,A00,895697,Hemans; Patricia Ann Benitez,43,0,45,2
1745785922188,EDS 281,A00,895701,Meyerott; Theresa Ann,15,0,15,0
1745785923217,EDS 284,A00,895736,Meyerott; Theresa Ann,15,0,15,0
1745785924244,EDS 286,A00,897210,Fine; Sarah,15,0,15,0
1745785925274,EDS 289C,A01,895770,Daly; Alan J.,15,0,15,0
1745785926299,EDS 290,A00,897211,Hofstetter; Carolyn,15,0,15,0
1745785927328,LIGM 5A,A00,896162,Fischer-Grunski; Eva K,15,0,20,5
1745785928353,LIGM 5B,A00,896260,Fischer-Grunski; Eva K,17,0,20,3
1745785929382,LIGM 5C,A00,896308,Fischer-Grunski; Eva K,18,0,20,2
1745785930411,LIIT 5AS,A00,896313,Carnelos; Chiara,18,0,20,2
1745785931437,LIIT 5BS,A00,896416,Carnelos; Chiara,20,0,20,0
1745785932475,LIIT 5CS,A00,896564,Carnelos; Chiara,20,0,20,0
1745785933504,LISP 5A,A00,896588,Munoz Sanchez; Alicia,4,0,20,16
1745785934528,LISP 5B,A00,896653,Munoz Sanchez; Alicia,10,0,20,10
1745785935554,LISP 5C,A00,896655,Munoz Sanchez; Alicia,4,0,20,16
1745785936578,MAE 197,001,957918,Kleissl; Jan,9998,0,9999,1
1745785937606,MATH 2,A01,957937,Staff,34,0,35,1
1745785938633,MATH 197,001,957876,Kedlaya; Kiran S.,9993,0,9999,6
1745785939657,MCWP 40,A00,892729,Duru; Nur,13,0,20,7
1745785939657,MCWP 40,B00,893304,Montejo; Carolina,20,0,20,0
1745785940686,MCWP 40R,A00,893757,Redela; Pamela Morgan,0,6,20,20
1745785941712,MCWP 50,A00,893758,Morshed; Michael James,2,0,20,18
1745785941712,MCWP 50,B00,893761,Bartulis; Jason Michael,17,0,20,3
1745785942737,MCWP 50R,A00,893766,Compas; Sean Matthew,0,1,20,20
1745785942737,MCWP 50R,B00,893769,Carter; Jennifer A,0,0,20,20
1745785942737,MCWP 50R,C00,893771,Krone; Jarret,0,3,20,20
1745785942737,MCWP 50R,D00,893772,Miller; Elizabeth Deen,3,0,20,17
1745785942737,MCWP 50R,E00,893775,Carter; Andrea L,0,0,20,20
1745785943764,MMW 11R,A01,892721,Herbst; Matthew,11,0,27,16
1745785943764,MMW 11R,A02,892722,Herbst; Matthew,0,0,0,3
1745785944792,MMW 12R,A01,892724,Herbst; Matthew,0,9,16,16
1745785944792,MMW 12R,A02,892725,Herbst; Matthew,0,9,16,16
1745785945819,MMW 13R,A01,892727,Staff,0,3,16,16
1745785945819,MMW 13R,A02,892728,Staff,0,4,16,16
1745785945819,MMW 13R,A03,958032,Staff,0,3,16,16
1745785945819,MMW 13R,A04,958033,Staff,0,2,16,16
1745785945819,MMW 13R,A05,958034,Staff,0,3,16,16
1745785946848,SIO 295LS,A00,894015,Staff,7,0,25,18
1745785947874,SIO 295S,A00,894020,Staff,7,0,25,18
1745785948900,SIOC 290S,B01,958918,Staff,0,0,0,0
1745785949930,SIOC 291S,B01,958922,Staff,0,0,0,0
1745785950955,SOCI 117,A01,895339,Staff,4,0,5,1
1745785951979,WES 237B,A00,894149,Staff,11,0,20,9
1745785954039,AESE 279B,A00,891859,Staff,13,0,35,22
1745785955065,AIP 197,001,891854,Staff,70,0,70,0
1745785956090,ANTH 289S,A00,891856,Gagneux; Pascal,12,0,12,0
1745785957154,BENG 196,001,957946,Engler; Adam J.,9996,0,9999,3
1745785958179,CAT 124RS,A01,956906,Staff,8,0,25,17
1745785959209,CAT 125RS,A01,922013,Staff,8,0,25,17
1745785960236,CLRE 250,A00,891860,Morris; Sheldon,9995,0,9999,4
1745785962289,CLRE 251R,A00,907817,Mehta; Ravindra L.,9994,0,9999,5
1745785963316,CLRE 252,A00,891864,Cuomo; Raphael Eduardo,9993,0,9999,6
1745785964343,CLRE 253,A00,891867,Vaida; Florin,9994,0,9999,5
1745785964343,CLRE 253,B00,907819,Staff,9999,0,9999,0
1745785965368,CLRE 259,A00,891868,Patel; Hemal,9998,0,9999,1
1745785966394,CLRE 260,A00,891872,Cuomo; Raphael Eduardo,9999,0,9999,0
1745785967429,CLRE 297,001,891888,Cuomo; Raphael Eduardo,9999,0,9999,0
1745785968459,CSE 191,A00,958773,Minnes Kemp; Mor Mia,9999,0,9999,0
1745785969484,CSS 201S,A01,892054,Mignozzetti; Umberto,30,0,30,0
1745785970514,CSS 202S,A01,892056,Mignozzetti; Umberto,30,0,30,0
1745785971540,DSC 197,001,956898,Eldridge; Justin Matthew,9998,0,9999,1
1745785972569,DSC 297,001,958000,Mazumdar; Arya,9998,0,9999,1
1745785973594,EAP 100,A00,905686,Staff,9776,0,9999,223
1745785974622,ECE 45,A01,892618,Staff,0,12,50,50
1745785975649,ECE 109,A01,892620,Staff,0,43,0,0
1745785976677,ECE 111,A01,892719,Staff,0,7,50,50
1745785977704,ECE 197,001,957920,Mercier; Patrick Philip,9992,0,9999,7
1745785978730,ECON 178,A01,907814,Zhu; Ying,28,0,35,7
1745785979756,EDS 115,A00,895312,Staff,41,0,45,4
1745785980783,EDS 117,A01,895337,Staff,30,0,30,0
1745785981812,EDS 125,A00,895341,Jones; Gabrielle Anastasia,43,0,45,2
1745785982841,EDS 128A,A01,895459,Fargason; Sharon Gayle,44,0,45,1
1745785983872,EDS 128B,A01,895543,Pappas; Elizabeth,44,0,45,1
1745785984898,EDS 139,A00,897203,Pappas; Elizabeth,44,0,45,1
1745785984898,EDS 139,B00,897209,Fargason; Sharon Gayle,44,0,45,1
1745785985924,EDS 201,A00,895545,Staff,43,0,45,2
1745785986951,EDS 203,A01,895581,Halter; Christopher P.,43,0,45,2
1745785987981,EDS 204R,A01,895625,Heinzman; Erica M.,44,0,45,1
1745785987981,EDS 204R,B01,895693,Halter; Christopher P.,18,0,45,27
1745785989010,EDS 206R,A00,895694,Fargason; Sharon Gayle,9,0,30,21
1745785989010,EDS 206R,B00,895695,Choi; Bailey Miyeon,20,0,30,10
1745785990039,EDS 250,A00,895697,Hemans; Patricia Ann Benitez,43,0,45,2
1745785991065,EDS 281,A00,895701,Meyerott; Theresa Ann,15,0,15,0
1745785992094,EDS 284,A00,895736,Meyerott; Theresa Ann,15,0,15,0
1745785993119,EDS 286,A00,897210,Fine; Sarah,15,0,15,0
1745785994145,EDS 289C,A01,895770,Daly; Alan J.,15,0,15,0
1745785995170,EDS 290,A00,897211,Hofstetter; Carolyn,15,0,15,0
1745785996199,LIGM 5A,A00,896162,Fischer-Grunski; Eva K,15,0,20,5
1745785997224,LIGM 5B,A00,896260,Fischer-Grunski; Eva K,17,0,20,3
1745785998251,LIGM 5C,A00,896308,Fischer-Grunski; Eva K,18,0,20,2
1745785999278,LIIT 5AS,A00,896313,Carnelos; Chiara,18,0,20,2
1745786000309,LIIT 5BS,A00,896416,Carnelos; Chiara,20,0,20,0
1745786001336,LIIT 5CS,A00,896564,Carnelos; Chiara,20,0,20,0
1745786002365,LISP 5A,A00,896588,Munoz Sanchez; Alicia,4,0,20,16
1745786003392,LISP 5B,A00,896653,Munoz Sanchez; Alicia,10,0,20,10
1745786004418,LISP 5C,A00,896655,Munoz Sanchez; Alicia,4,0,20,16
1745786005447,MAE 197,001,957918,Kleissl; Jan,9998,0,9999,1
1745786006475,MATH 2,A01,957937,Staff,34,0,35,1
1745786007501,MATH 197,001,957876,Kedlaya; Kiran S.,9993,0,9999,6
1745786008530,MCWP 40,A00,892729,Duru; Nur,13,0,20,7
1745786008530,MCWP 40,B00,893304,Montejo; Carolina,20,0,20,0
1745786009555,MCWP 40R,A00,893757,Redela; Pamela Morgan,0,6,20,20
1745786010582,MCWP 50,A00,893758,Morshed; Michael James,2,0,20,18
1745786010582,MCWP 50,B00,893761,Bartulis; Jason Michael,17,0,20,3
1745786011608,MCWP 50R,A00,893766,Compas; Sean Matthew,0,1,20,20
1745786011608,MCWP 50R,B00,893769,Carter; Jennifer A,0,0,20,20
1745786011608,MCWP 50R,C00,893771,Krone; Jarret,0,3,20,20
1745786011608,MCWP 50R,D00,893772,Miller; Elizabeth Deen,3,0,20,17
1745786011608,MCWP 50R,E00,893775,Carter; Andrea L,0,0,20,20
1745786012635,MMW 11R,A01,892721,Herbst; Matthew,11,0,27,16
1745786012635,MMW 11R,A02,892722,Herbst; Matthew,0,0,0,3
1745786013663,MMW 12R,A01,892724,Herbst; Matthew,0,9,16,16
1745786013663,MMW 12R,A02,892725,Herbst; Matthew,0,9,16,16
1745786014689,MMW 13R,A01,892727,Staff,0,3,16,16
1745786014689,MMW 13R,A02,892728,Staff,0,4,16,16
1745786014689,MMW 13R,A03,958032,Staff,0,3,16,16
1745786014689,MMW 13R,A04,958033,Staff,0,2,16,16
1745786014689,MMW 13R,A05,958034,Staff,0,3,16,16
1745786015717,SIO 295LS,A00,894015,Staff,7,0,25,18
1745786016747,SIO 295S,A00,894020,Staff,7,0,25,18
1745786017777,SIOC 290S,B01,958918,Staff,0,0,0,0
1745786018807,SIOC 291S,B01,958922,Staff,0,0,0,0
1745786019832,SOCI 117,A01,895339,Staff,4,0,5,1
1745786020857,WES 237B,A00,894149,Staff,11,0,20,9
1745786022920,AESE 279B,A00,891859,Staff,13,0,35,22
1745786023949,AIP 197,001,891854,Staff,70,0,70,0
1745786024973,ANTH 289S,A00,891856,Gagneux; Pascal,12,0,12,0
1745786026003,BENG 196,001,957946,Engler; Adam J.,9996,0,9999,3
1745786027030,CAT 124RS,A01,956906,Staff,8,0,25,17
1745786028060,CAT 125RS,A01,922013,Staff,8,0,25,17
1745786029085,CLRE 250,A00,891860,Morris; Sheldon,9995,0,9999,4
1745786031140,CLRE 251R,A00,907817,Mehta; Ravindra L.,9994,0,9999,5
1745786032166,CLRE 252,A00,891864,Cuomo; Raphael Eduardo,9993,0,9999,6
1745786033196,CLRE 253,A00,891867,Vaida; Florin,9994,0,9999,5
1745786033196,CLRE 253,B00,907819,Staff,9999,0,9999,0
1745786034223,CLRE 259,A00,891868,Patel; Hemal,9998,0,9999,1
1745786035252,CLRE 260,A00,891872,Cuomo; Raphael Eduardo,9999,0,9999,0
1745786036277,CLRE 297,001,891888,Cuomo; Raphael Eduardo,9999,0,9999,0
1745786037308,CSE 191,A00,958773,Minnes Kemp; Mor Mia,9999,0,9999,0
1745786038334,CSS 201S,A01,892054,Mignozzetti; Umberto,30,0,30,0
1745786039359,CSS 202S,A01,892056,Mignozzetti; Umberto,30,0,30,0
1745786040384,DSC 197,001,956898,Eldridge; Justin Matthew,9998,0,9999,1
1745786041412,DSC 297,001,958000,Mazumdar; Arya,9998,0,9999,1
1745786042438,EAP 100,A00,905686,Staff,9776,0,9999,223
1745786043467,ECE 45,A01,892618,Staff,0,12,50,50
1745786044493,ECE 109,A01,892620,Staff,0,43,0,0
1745786045519,ECE 111,A01,892719,Staff,0,7,50,50
1745786046547,ECE 197,001,957920,Mercier; Patrick Philip,9992,0,9999,7
1745786047574,ECON 178,A01,907814,Zhu; Ying,28,0,35,7
1745786048611,EDS 115,A00,895312,Staff,41,0,45,4
1745786049637,EDS 117,A01,895337,Staff,30,0,30,0
1745786050663,EDS 125,A00,895341,Jones; Gabrielle Anastasia,43,0,45,2
1745786051692,EDS 128A,A01,895459,Fargason; Sharon Gayle,44,0,45,1
1745786052720,EDS 128B,A01,895543,Pappas; Elizabeth,44,0,45,1
1745786053748,EDS 139,A00,897203,Pappas; Elizabeth,44,0,45,1
1745786053748,EDS 139,B00,897209,Fargason; Sharon Gayle,44,0,45,1
1745786054776,EDS 201,A00,895545,Staff,43,0,45,2
1745786055806,EDS 203,A01,895581,Halter; Christopher P.,43,0,45,2
1745786056836,EDS 204R,A01,895625,Heinzman; Erica M.,44,0,45,1
1745786056836,EDS 204R,B01,895693,Halter; Christopher P.,18,0,45,27
1745786057863,EDS 206R,A00,895694,Fargason; Sharon Gayle,9,0,30,21
1745786057863,EDS 206R,B00,895695,Choi; Bailey Miyeon,20,0,30,10
1745786058893,EDS 250,A00,895697,Hemans; Patricia Ann Benitez,43,0,45,2
1745786059919,EDS 281,A00,895701,Meyerott; Theresa Ann,15,0,15,0
1745786060986,EDS 284,A00,895736,Meyerott; Theresa Ann,15,0,15,0
1745786062011,EDS 286,A00,897210,Fine; Sarah,15,0,15,0
1745786063035,EDS 289C,A01,895770,Daly; Alan J.,15,0,15,0
1745786064060,EDS 290,A00,897211,Hofstetter; Carolyn,15,0,15,0
1745786065087,LIGM 5A,A00,896162,Fischer-Grunski; Eva K,15,0,20,5
1745786066113,LIGM 5B,A00,896260,Fischer-Grunski; Eva K,17,0,20,3
1745786067140,LIGM 5C,A00,896308,Fischer-Grunski; Eva K,18,0,20,2
1745786068167,LIIT 5AS,A00,896313,Carnelos; Chiara,18,0,20,2
1745786069192,LIIT 5BS,A00,896416,Carnelos; Chiara,20,0,20,0
1745786070221,LIIT 5CS,A00,896564,Carnelos; Chiara,20,0,20,0
1745786071249,LISP 5A,A00,896588,Munoz Sanchez; Alicia,4,0,20,16
1745786072276,LISP 5B,A00,896653,Munoz Sanchez; Alicia,10,0,20,10
1745786073303,LISP 5C,A00,896655,Munoz Sanchez; Alicia,4,0,20,16
1745786074330,MAE 197,001,957918,Kleissl; Jan,9998,0,9999,1
1745786075357,MATH 2,A01,957937,Staff,34,0,35,1
1745786076381,MATH 197,001,957876,Kedlaya; Kiran S.,9993,0,9999,6
1745786077412,MCWP 40,A00,892729,Duru; Nur,13,0,20,7
1745786077412,MCWP 40,B00,893304,Montejo; Carolina,20,0,20,0
1745786078439,MCWP 40R,A00,893757,Redela; Pamela Morgan,0,6,20,20
1745786079465,MCWP 50,A00,893758,Morshed; Michael James,2,0,20,18
1745786079465,MCWP 50,B00,893761,Bartulis; Jason Michael,17,0,20,3
1745786080496,MCWP 50R,A00,893766,Compas; Sean Matthew,0,1,20,20
1745786080496,MCWP 50R,B00,893769,Carter; Jennifer A,0,0,20,20
1745786080496,MCWP 50R,C00,893771,Krone; Jarret,0,3,20,20
1745786080496,MCWP 50R,D00,893772,Miller; Elizabeth Deen,3,0,20,17
1745786080496,MCWP 50R,E00,893775,Carter; Andrea L,0,0,20,20
1745786081526,MMW 11R,A01,892721,Herbst; Matthew,11,0,27,16
1745786081526,MMW 11R,A02,892722,Herbst; Matthew,0,0,0,3
1745786082553,MMW 12R,A01,892724,Herbst; Matthew,0,9,16,16
1745786082553,MMW 12R,A02,892725,Herbst; Matthew,0,9,16,16
1745786083583,MMW 13R,A01,892727,Staff,0,3,16,16
1745786083583,MMW 13R,A02,892728,Staff,0,4,16,16
1745786083583,MMW 13R,A03,958032,Staff,0,3,16,16
1745786083583,MMW 13R,A04,958033,Staff,0,2,16,16
1745786083583,MMW 13R,A05,958034,Staff,0,3,16,16
1745786084612,SIO 295LS,A00,894015,Staff,7,0,25,18
1745786085638,SIO 295S,A00,894020,Staff,7,0,25,18
1745786086668,SIOC 290S,B01,958918,Staff,0,0,0,0
1745786087697,SIOC 291S,B01,958922,Staff,0,0,0,0
1745786088722,SOCI 117,A01,895339,Staff,4,0,5,1
1745786089749,WES 237B,A00,894149,Staff,11,0,20,9
1745786091811,AESE 279B,A00,891859,Staff,13,0,35,22
1745786092837,AIP 197,001,891854,Staff,70,0,70,0
1745786093864,ANTH 289S,A00,891856,Gagneux; Pascal,12,0,12,0
1745786094890,BENG 196,001,957946,Engler; Adam J.,9996,0,9999,3
1745786095916,CAT 124RS,A01,956906,Staff,8,0,25,17
1745786096943,CAT 125RS,A01,922013,Staff,8,0,25,17
1745786097970,CLRE 250,A00,891860,Morris; Sheldon,9995,0,9999,4
1745786100025,CLRE 251R,A00,907817,Mehta; Ravindra L.,9994,0,9999,5
1745786101056,CLRE 252,A00,891864,Cuomo; Raphael Eduardo,9993,0,9999,6
1745786102082,CLRE 253,A00,891867,Vaida; Florin,9994,0,9999,5
1745786102082,CLRE 253,B00,907819,Staff,9999,0,9999,0
1745786103116,CLRE 259,A00,891868,Patel; Hemal,9998,0,9999,1
1745786104144,CLRE 260,A00,891872,Cuomo; Raphael Eduardo,9999,0,9999,0
1745786105173,CLRE 297,001,891888,Cuomo; Raphael Eduardo,9999,0,9999,0
1745786106198,CSE 191,A00,958773,Minnes Kemp; Mor Mia,9999,0,9999,0
1745786107224,CSS 201S,A01,892054,Mignozzetti; Umberto,30,0,30,0
1745786108249,CSS 202S,A01,892056,Mignozzetti; Umberto,30,0,30,0
1745786109275,DSC 197,001,956898,Eldridge; Justin Matthew,9998,0,9999,1
1745786110301,DSC 297,001,958000,Mazumdar; Arya,9998,0,9999,1
1745786111334,EAP 100,A00,905686,Staff,9776,0,9999,223
1745786112362,ECE 45,A01,892618,Staff,0,12,50,50
1745786113388,ECE 109,A01,892620,Staff,0,43,0,0
1745786114415,ECE 111,A01,892719,Staff,0,7,50,50
1745786115440,ECE 197,001,957920,Mercier; Patrick Philip,9992,0,9999,7
1745786116468,ECON 178,A01,907814,Zhu; Ying,28,0,35,7
1745786117494,EDS 115,A00,895312,Staff,41,0,45,4
1745786118521,EDS 117,A01,895337,Staff,30,0,30,0
1745786119548,EDS 125,A00,895341,Jones; Gabrielle Anastasia,43,0,45,2
1745786120574,EDS 128A,A01,895459,Fargason; Sharon Gayle,44,0,45,1
1745786121602,EDS 128B,A01,895543,Pappas; Elizabeth,44,0,45,1
1745786122630,EDS 139,A00,897203,Pappas; Elizabeth,44,0,45,1
1745786122630,EDS 139,B00,897209,Fargason; Sharon Gayle,44,0,45,1
1745786123657,EDS 201,A00,895545,Staff,43,0,45,2
1745786124684,EDS 203,A01,895581,Halter; Christopher P.,43,0,45,2
1745786125712,EDS 204R,A01,895625,Heinzman; Erica M.,44,0,45,1
1745786125712,EDS 204R,B01,895693,Halter; Christopher P.,18,0,45,27
1745786126738,EDS 206R,A00,895694,Fargason; Sharon Gayle,9,0,30,21
1745786126738,EDS 206R,B00,895695,Choi; Bailey Miyeon,20,0,30,10
1745786127764,EDS 250,A00,895697,Hemans; Patricia Ann Benitez,43,0,45,2
1745786128790,EDS 281,A00,895701,Meyerott; Theresa Ann,15,0,15,0
1745786129820,EDS 284,A00,895736,Meyerott; Theresa Ann,15,0,15,0
1745786130849,EDS 286,A00,897210,Fine; Sarah,15,0,15,0
1745786131876,EDS 289C,A01,895770,Daly; Alan J.,15,0,15,0
1745786132901,EDS 290,A00,897211,Hofstetter; Carolyn,15,0,15,0
1745786133927,LIGM 5A,A00,896162,Fischer-Grunski; Eva K,15,0,20,5
1745786134953,LIGM 5B,A00,896260,Fischer-Grunski; Eva K,17,0,20,3
1745786135996,LIGM 5C,A00,896308,Fischer-Grunski; Eva K,18,0,20,2
1745786137022,LIIT 5AS,A00,896313,Carnelos; Chiara,18,0,20,2
1745786138050,LIIT 5BS,A00,896416,Carnelos; Chiara,20,0,20,0
1745786139081,LIIT 5CS,A00,896564,Carnelos; Chiara,20,0,20,0
1745786140112,LISP 5A,A00,896588,Munoz Sanchez; Alicia,4,0,20,16
1745786141142,LISP 5B,A00,896653,Munoz Sanchez; Alicia,10,0,20,10
1745786142169,LISP 5C,A00,896655,Munoz Sanchez; Alicia,4,0,20,16
1745786143195,MAE 197,001,957918,Kleissl; Jan,9998,0,9999,1
1745786144222,MATH 2,A01,957937,Staff,34,0,35,1
1745786145250,MATH 197,001,957876,Kedlaya; Kiran S.,9993,0,9999,6
1745786146279,MCWP 40,A00,892729,Duru; Nur,13,0,20,7
1745786146279,MCWP 40,B00,893304,Montejo; Carolina,20,0,20,0
1745786147307,MCWP 40R,A00,893757,Redela; Pamela Morgan,0,6,20,20
1745786148333,MCWP 50,A00,893758,Morshed; Michael James,2,0,20,18
1745786148333,MCWP 50,B00,893761,Bartulis; Jason Michael,17,0,20,3
1745786149364,MCWP 50R,A00,893766,Compas; Sean Matthew,0,1,20,20
1745786149364,MCWP 50R,B00,893769,Carter; Jennifer A,0,0,20,20
1745786149364,MCWP 50R,C00,893771,Krone; Jarret,0,3,20,20
1745786149364,MCWP 50R,D00,893772,Miller; Elizabeth Deen,3,0,20,17
1745786149364,MCWP 50R,E00,893775,Carter; Andrea L,0,0,20,20
1745786150392,MMW 11R,A01,892721,Herbst; Matthew,11,0,27,16
1745786150392,MMW 11R,A02,892722,Herbst; Matthew,0,0,0,3
1745786151422,MMW 12R,A01,892724,Herbst; Matthew,0,9,16,16
1745786151422,MMW 12R,A02,892725,Herbst; Matthew,0,9,16,16
1745786152448,MMW 13R,A01,892727,Staff,0,3,16,16
1745786152448,MMW 13R,A02,892728,Staff,0,4,16,16
1745786152448,MMW 13R,A03,958032,Staff,0,3,16,16
1745786152448,MMW 13R,A04,958033,Staff,0,2,16,16
1745786152448,MMW 13R,A05,958034,Staff,0,3,16,16
1745786153475,SIO 295LS,A00,894015,Staff,7,0,25,18
1745786154501,SIO 295S,A00,894020,Staff,7,0,25,18
1745786155531,SIOC 290S,B01,958918,Staff,0,0,0,0
1745786156560,SIOC 291S,B01,958922,Staff,0,0,0,0
1745786157584,SOCI 117,A01,895339,Staff,4,0,5,1
1745786158611,WES 237B,A00,894149,Staff,11,0,20,9
1745786160677,AESE 279B,A00,891859,Staff,13,0,35,22
1745786161705,AIP 197,001,891854,Staff,70,0,70,0
1745786162731,ANTH 289S,A00,891856,Gagneux; Pascal,12,0,12,0
1745786163758,BENG 196,001,957946,Engler; Adam J.,9996,0,9999,3
1745786164841,CAT 124RS,A01,956906,Staff,8,0,25,17
1745786165867,CAT 125RS,A01,922013,Staff,8,0,25,17
1745786166894,CLRE 250,A00,891860,Morris; Sheldon,9995,0,9999,4
1745786168949,CLRE 251R,A00,907817,Mehta; Ravindra L.,9994,0,9999,5
1745786169976,CLRE 252,A00,891864,Cuomo; Raphael Eduardo,9993,0,9999,6
1745786171003,CLRE 253,A00,891867,Vaida; Florin,9994,0,9999,5
1745786171003,CLRE 253,B00,907819,Staff,9999,0,9999,0
1745786172032,CLRE 259,A00,891868,Patel; Hemal,9998,0,9999,1
1745786173060,CLRE 260,A00,891872,Cuomo; Raphael Eduardo,9999,0,9999,0
1745786174090,CLRE 297,001,891888,Cuomo; Raphael Eduardo,9999,0,9999,0
1745786175119,CSE 191,A00,958773,Minnes Kemp; Mor Mia,9999,0,9999,0
1745786176146,CSS 201S,A01,892054,Mignozzetti; Umberto,30,0,30,0
1745786177172,CSS 202S,A01,892056,Mignozzetti; Umberto,30,0,30,0
1745786178200,DSC 197,001,956898,Eldridge; Justin Matthew,9998,0,9999,1
1745786179223,DSC 297,001,958000,Mazumdar; Arya,9998,0,9999,1
1745786180249,EAP 100,A00,905686,Staff,9776,0,9999,223
1745786181275,ECE 45,A01,892618,Staff,0,12,50,50
1745786182303,ECE 109,A01,892620,Staff,0,43,0,0
1745786183329,ECE 111,A01,892719,Staff,0,7,50,50
1745786184354,ECE 197,001,957920,Mercier; Patrick Philip,9992,0,9999,7
1745786185380,ECON 178,A01,907814,Zhu; Ying,28,0,35,7
1745786186409,EDS 115,A00,895312,Staff,41,0,45,4
1745786187435,EDS 117,A01,895337,Staff,30,0,30,0
1745786188464,EDS 125,A00,895341,Jones; Gabrielle Anastasia,43,0,45,2
1745786189494,EDS 128A,A01,895459,Fargason; Sharon Gayle,44,0,45,1
1745786190518,EDS 128B,A01,895543,Pappas; Elizabeth,44,0,45,1
1745786191542,EDS 139,A00,897203,Pappas; Elizabeth,44,0,45,1
1745786191542,EDS 139,B00,897209,Fargason; Sharon Gayle,44,0,45,1
1745786192569,EDS 201,A00,895545,Staff,43,0,45,2
1745786193597,EDS 203,A01,895581,Halter; Christopher P.,43,0,45,2
1745786194625,EDS 204R,A01,895625,Heinzman; Erica M.,44,0,45,1
1745786194625,EDS 204R,B01,895693,Halter; Christopher P.,18,0,45,27
1745786195652,EDS 206R,A00,895694,Fargason; Sharon Gayle,9,0,30,21
1745786195652,EDS 206R,B00,895695,Choi; Bailey Miyeon,20,0,30,10
1745786196677,EDS 250,A00,895697,Hemans; Patricia Ann Benitez,43,0,45,2
1745786197708,EDS 281,A00,895701,Meyerott; Theresa Ann,15,0,15,0
1745786198733,EDS 284,A00,895736,Meyerott; Theresa Ann,15,0,15,0
1745786199757,EDS 286,A00,897210,Fine; Sarah,15,0,15,0
1745786200785,EDS 289C,A01,895770,Daly; Alan J.,15,0,15,0
1745786201813,EDS 290,A00,897211,Hofstetter; Carolyn,15,0,15,0
1745786202839,LIGM 5A,A00,896162,Fischer-Grunski; Eva K,15,0,20,5
1745786203866,LIGM 5B,A00,896260,Fischer-Grunski; Eva K,17,0,20,3
1745786204891,LIGM 5C,A00,896308,Fischer-Grunski; Eva K,18,0,20,2
1745786205920,LIIT 5AS,A00,896313,Carnelos; Chiara,18,0,20,2
1745786206946,LIIT 5BS,A00,896416,Carnelos; Chiara,20,0,20,0
1745786207976,LIIT 5CS,A00,896564,Carnelos; Chiara,20,0,20,0
1745786209005,LISP 5A,A00,896588,Munoz Sanchez; Alicia,4,0,20,16
1745786210030,LISP 5B,A00,896653,Munoz Sanchez; Alicia,10,0,20,10
1745786211057,LISP 5C,A00,896655,Munoz Sanchez; Alicia,4,0,20,16
1745786212087,MAE 197,001,957918,Kleissl; Jan,9998,0,9999,1
1745786213114,MATH 2,A01,957937,Staff,34,0,35,1
1745786214143,MATH 197,001,957876,Kedlaya; Kiran S.,9993,0,9999,6
1745786215169,MCWP 40,A00,892729,Duru; Nur,13,0,20,7
1745786215169,MCWP 40,B00,893304,Montejo; Carolina,20,0,20,0
1745786216196,MCWP 40R,A00,893757,Redela; Pamela Morgan,0,6,20,20
1745786217224,MCWP 50,A00,893758,Morshed; Michael James,2,0,20,18
1745786217224,MCWP 50,B00,893761,Bartulis; Jason Michael,17,0,20,3
1745786218252,MCWP 50R,A00,893766,Compas; Sean Matthew,0,1,20,20
1745786218252,MCWP 50R,B00,893769,Carter; Jennifer A,0,0,20,20
1745786218252,MCWP 50R,C00,893771,Krone; Jarret,0,3,20,20
1745786218252,MCWP 50R,D00,893772,Miller; Elizabeth Deen,3,0,20,17
1745786218252,MCWP 50R,E00,893775,Carter; Andrea L,0,0,20,20
1745786219281,MMW 11R,A01,892721,Herbst; Matthew,11,0,27,16
1745786219281,MMW 11R,A02,892722,Herbst; Matthew,0,0,0,3
1745786220307,MMW 12R,A01,892724,Herbst; Matthew,0,9,16,16
1745786220307,MMW 12R,A02,892725,Herbst; Matthew,0,9,16,16
1745786221345,MMW 13R,A01,892727,Staff,0,3,16,16
1745786221345,MMW 13R,A02,892728,Staff,0,4,16,16
1745786221345,MMW 13R,A03,958032,Staff,0,3,16,16
1745786221345,MMW 13R,A04,958033,Staff,0,2,16,16
1745786221345,MMW 13R,A05,958034,Staff,0,3,16,16
1745786222377,SIO 295LS,A00,894015,Staff,7,0,25,18
1745786223408,SIO 295S,A00,894020,Staff,7,0,25,18
1745786224438,SIOC 290S,B01,958918,Staff,0,0,0,0
1745786225469,SIOC 291S,B01,958922,Staff,0,0,0,0
1745786226496,SOCI 117,A01,895339,Staff,4,0,5,1
1745786227525,WES 237B,A00,894149,Staff,11,0,20,9
1745786229581,AESE 279B,A00,891859,Staff,13,0,35,22
1745786230610,AIP 197,001,891854,Staff,70,0,70,0
1745786231637,ANTH 289S,A00,891856,Gagneux; Pascal,12,0,12,0
1745786232662,BENG 196,001,957946,Engler; Adam J.,9996,0,9999,3
1745786233687,CAT 124RS,A01,956906,Staff,8,0,25,17
1745786234714,CAT 125RS,A01,922013,Staff,8,0,25,17
1745786235742,CLRE 250,A00,891860,Morris; Sheldon,9995,0,9999,4
1745786237792,CLRE 251R,A00,907817,Mehta; Ravindra L.,9994,0,9999,5
1745786238818,CLRE 252,A00,891864,Cuomo; Raphael Eduardo,9993,0,9999,6
1745786239847,CLRE 253,A00,891867,Vaida; Florin,9994,0,9999,5
1745786239847,CLRE 253,B00,907819,Staff,9999,0,9999,0
1745786240873,CLRE 259,A00,891868,Patel; Hemal,9998,0,9999,1
1745786241902,CLRE 260,A00,891872,Cuomo; Raphael Eduardo,9999,0,9999,0
1745786242927,CLRE 297,001,891888,Cuomo; Raphael Eduardo,9999,0,9999,0
1745786243953,CSE 191,A00,958773,Minnes Kemp; Mor Mia,9999,0,9999,0
1745786244978,CSS 201S,A01,892054,Mignozzetti; Umberto,30,0,30,0
1745786246004,CSS 202S,A01,892056,Mignozzetti; Umberto,30,0,30,0
1745786247032,DSC 197,001,956898,Eldridge; Justin Matthew,9998,0,9999,1
1745786248060,DSC 297,001,958000,Mazumdar; Arya,9998,0,9999,1
1745786249085,EAP 100,A00,905686,Staff,9776,0,9999,223
1745786250114,ECE 45,A01,892618,Staff,0,12,50,50
1745786251140,ECE 109,A01,892620,Staff,0,43,0,0
1745786252168,ECE 111,A01,892719,Staff,0,7,50,50
1745786253193,ECE 197,001,957920,Mercier; Patrick Philip,9992,0,9999,7
1745786254221,ECON 178,A01,907814,Zhu; Ying,28,0,35,7
1745786255246,EDS 115,A00,895312,Staff,41,0,45,4
1745786256273,EDS 117,A01,895337,Staff,30,0,30,0
1745786257300,EDS 125,A00,895341,Jones; Gabrielle Anastasia,43,0,45,2
1745786258330,EDS 128A,A01,895459,Fargason; Sharon Gayle,44,0,45,1
1745786259358,EDS 128B,A01,895543,Pappas; Elizabeth,44,0,45,1
1745786260385,EDS 139,A00,897203,Pappas; Elizabeth,44,0,45,1
1745786260385,EDS 139,B00,897209,Fargason; Sharon Gayle,44,0,45,1
1745786261410,EDS 201,A00,895545,Staff,43,0,45,2
1745786262437,EDS 203,A01,895581,Halter; Christopher P.,43,0,45,2
1745786263463,EDS 204R,A01,895625,Heinzman; Erica M.,44,0,45,1
1745786263463,EDS 204R,B01,895693,Halter; Christopher P.,18,0,45,27
1745786264488,EDS 206R,A00,895694,Fargason; Sharon Gayle,9,0,30,21
1745786264488,EDS 206R,B00,895695,Choi; Bailey Miyeon,20,0,30,10
1745786265513,EDS 250,A00,895697,Hemans; Patricia Ann Benitez,43,0,45,2
1745786266540,EDS 281,A00,895701,Meyerott; Theresa Ann,15,0,15,0
1745786267565,EDS 284,A00,895736,Meyerott; Theresa Ann,15,0,15,0
1745786268632,EDS 286,A00,897210,Fine; Sarah,15,0,15,0
1745786269658,EDS 289C,A01,895770,Daly; Alan J.,15,0,15,0
1745786270683,EDS 290,A00,897211,Hofstetter; Carolyn,15,0,15,0
1745786271707,LIGM 5A,A00,896162,Fischer-Grunski; Eva K,15,0,20,5
1745786272736,LIGM 5B,A00,896260,Fischer-Grunski; Eva K,17,0,20,3
1745786273762,LIGM 5C,A00,896308,Fischer-Grunski; Eva K,18,0,20,2
1745786274789,LIIT 5AS,A00,896313,Carnelos; Chiara,18,0,20,2
1745786275819,LIIT 5BS,A00,896416,Carnelos; Chiara,20,0,20,0
1745786276844,LIIT 5CS,A00,896564,Carnelos; Chiara,20,0,20,0
1745786277871,LISP 5A,A00,896588,Munoz Sanchez; Alicia,4,0,20,16
1745786278899,LISP 5B,A00,896653,Munoz Sanchez; Alicia,10,0,20,10
1745786279928,LISP 5C,A00,896655,Munoz Sanchez; Alicia,4,0,20,16
1745786280954,MAE 197,001,957918,Kleissl; Jan,9998,0,9999,1
1745786281979,MATH 2,A01,957937,Staff,34,0,35,1
1745786283006,MATH 197,001,957876,Kedlaya; Kiran S.,9993,0,9999,6
1745786284032,MCWP 40,A00,892729,Duru; Nur,13,0,20,7
1745786284032,MCWP 40,B00,893304,Montejo; Carolina,20,0,20,0
1745786285058,MCWP 40R,A00,893757,Redela; Pamela Morgan,0,6,20,20
1745786286084,MCWP 50,A00,893758,Morshed; Michael James,2,0,20,18
1745786286084,MCWP 50,B00,893761,Bartulis; Jason Michael,17,0,20,3
1745786287115,MCWP 50R,A00,893766,Compas; Sean Matthew,0,1,20,20
1745786287115,MCWP 50R,B00,893769,Carter; Jennifer A,0,0,20,20
1745786287115,MCWP 50R,C00,893771,Krone; Jarret,0,3,20,20
1745786287115,MCWP 50R,D00,893772,Miller; Elizabeth Deen,3,0,20,17
1745786287115,MCWP 50R,E00,893775,Carter; Andrea L,0,0,20,20
1745786288141,MMW 11R,A01,892721,Herbst; Matthew,11,0,27,16
1745786288141,MMW 11R,A02,892722,Herbst; Matthew,0,0,0,3
1745786289170,MMW 12R,A01,892724,Herbst; Matthew,0,9,16,16
1745786289170,MMW 12R,A02,892725,Herbst; Matthew,0,9,16,16
1745786290197,MMW 13R,A01,892727,Staff,0,3,16,16
1745786290197,MMW 13R,A02,892728,Staff,0,4,16,16
1745786290197,MMW 13R,A03,958032,Staff,0,3,16,16
1745786290197,MMW 13R,A04,958033,Staff,0,2,16,16
1745786290197,MMW 13R,A05,958034,Staff,0,3,16,16
1745786291224,SIO 295LS,A00,894015,Staff,7,0,25,18
1745786292253,SIO 295S,A00,894020,Staff,7,0,25,18
1745786293279,SIOC 290S,B01,958918,Staff,0,0,0,0
1745786294310,SIOC 291S,B01,958922,Staff,0,0,0,0
1745786295339,SOCI 117,A01,895339,Staff,4,0,5,1
1745786296366,WES 237B,A00,894149,Staff,11,0,20,9
1745786298433,AESE 279B,A00,891859,Staff,13,0,35,22
1745786299456,AIP 197,001,891854,Staff,70,0,70,0
1745786300484,ANTH 289S,A00,891856,Gagneux; Pascal,12,0,12,0
1745786301513,BENG 196,001,957946,Engler; Adam J.,9996,0,9999,3
1745786302541,CAT 124RS,A01,956906,Staff,8,0,25,17
1745786303568,CAT 125RS,A01,922013,Staff,8,0,25,17
1745786304594,CLRE 250,A00,891860,Morris; Sheldon,9995,0,9999,4
1745786306649,CLRE 251R,A00,907817,Mehta; Ravindra L.,9994,0,9999,5
1745786307678,CLRE 252,A00,891864,Cuomo; Raphael Eduardo,9993,0,9999,6
1745786308706,CLRE 253,A00,891867,Vaida; Florin,9994,0,9999,5
1745786308706,CLRE 253,B00,907819,Staff,9999,0,9999,0
1745786309734,CLRE 259,A00,891868,Patel; Hemal,9998,0,9999,1
1745786310760,CLRE 260,A00,891872,Cuomo; Raphael Eduardo,9999,0,9999,0
1745786311786,CLRE 297,001,891888,Cuomo; Raphael Eduardo,9999,0,9999,0
1745786312812,CSE 191,A00,958773,Minnes Kemp; Mor Mia,9999,0,9999,0
1745786313838,CSS 201S,A01,892054,Mignozzetti; Umberto,30,0,30,0
1745786314864,CSS 202S,A01,892056,Mignozzetti; Umberto,30,0,30,0
1745786315892,DSC 197,001,956898,Eldridge; Justin Matthew,9998,0,9999,1
1745786316920,DSC 297,001,958000,Mazumdar; Arya,9998,0,9999,1
1745786317946,EAP 100,A00,905686,Staff,9776,0,9999,223
1745786318976,ECE 45,A01,892618,Staff,0,12,50,50
1745786320001,ECE 109,A01,892620,Staff,0,43,0,0
1745786321026,ECE 111,A01,892719,Staff,0,7,50,50
1745786322054,ECE 197,001,957920,Mercier; Patrick Philip,9992,0,9999,7
1745786323080,ECON 178,A01,907814,Zhu; Ying,28,0,35,7
1745786324105,EDS 115,A00,895312,Staff,41,0,45,4
1745786325131,EDS 117,A01,895337,Staff,30,0,30,0
1745786326158,EDS 125,A00,895341,Jones; Gabrielle Anastasia,43,0,45,2
1745786327183,EDS 128A,A01,895459,Fargason; Sharon Gayle,44,0,45,1
1745786328208,EDS 128B,A01,895543,Pappas; Elizabeth,44,0,45,1
1745786329236,EDS 139,A00,897203,Pappas; Elizabeth,44,0,45,1
1745786329236,EDS 139,B00,897209,Fargason; Sharon Gayle,44,0,45,1
1745786330262,EDS 201,A00,895545,Staff,43,0,45,2
1745786331291,EDS 203,A01,895581,Halter; Christopher P.,43,0,45,2
1745786332317,EDS 204R,A01,895625,Heinzman; Erica M.,44,0,45,1
1745786332317,EDS 204R,B01,895693,Halter; Christopher P.,18,0,45,27
1745786333344,EDS 206R,A00,895694,Fargason; Sharon Gayle,9,0,30,21
1745786333344,EDS 206R,B00,895695,Choi; Bailey Miyeon,20,0,30,10
1745786334373,EDS 250,A00,895697,Hemans; Patricia Ann Benitez,43,0,45,2
1745786335399,EDS 281,A00,895701,Meyerott; Theresa Ann,15,0,15,0
1745786336424,EDS 284,A00,895736,Meyerott; Theresa Ann,15,0,15,0
1745786337454,EDS 286,A00,897210,Fine; Sarah,15,0,15,0
1745786338479,EDS 289C,A01,895770,Daly; Alan J.,15,0,15,0
1745786339505,EDS 290,A00,897211,Hofstetter; Carolyn,15,0,15,0
1745786340534,LIGM 5A,A00,896162,Fischer-Grunski; Eva K,15,0,20,5
1745786341564,LIGM 5B,A00,896260,Fischer-Grunski; Eva K,17,0,20,3
1745786342590,LIGM 5C,A00,896308,Fischer-Grunski; Eva K,18,0,20,2
1745786343623,LIIT 5AS,A00,896313,Carnelos; Chiara,18,0,20,2
1745786344652,LIIT 5BS,A00,896416,Carnelos; Chiara,20,0,20,0
1745786345690,LIIT 5CS,A00,896564,Carnelos; Chiara,20,0,20,0
1745786346715,LISP 5A,A00,896588,Munoz Sanchez; Alicia,4,0,20,16
1745786347741,LISP 5B,A00,896653,Munoz Sanchez; Alicia,10,0,20,10
1745786348812,LISP 5C,A00,896655,Munoz Sanchez; Alicia,4,0,20,16
1745786349838,MAE 197,001,957918,Kleissl; Jan,9998,0,9999,1
1745786350867,MATH 2,A01,957937,Staff,34,0,35,1
1745786351893,MATH 197,001,957876,Kedlaya; Kiran S.,9993,0,9999,6
1745786352919,MCWP 40,A00,892729,Duru; Nur,13,0,20,7
1745786352919,MCWP 40,B00,893304,Montejo; Carolina,20,0,20,0
1745786353947,MCWP 40R,A00,893757,Redela; Pamela Morgan,0,6,20,20
1745786354974,MCWP 50,A00,893758,Morshed; Michael James,2,0,20,18
1745786354974,MCWP 50,B00,893761,Bartulis; Jason Michael,17,0,20,3
1745786356002,MCWP 50R,A00,893766,Compas; Sean Matthew,0,1,20,20
1745786356002,MCWP 50R,B00,893769,Carter; Jennifer A,0,0,20,20
1745786356002,MCWP 50R,C00,893771,Krone; Jarret,0,3,20,20
1745786356002,MCWP 50R,D00,893772,Miller; Elizabeth Deen,3,0,20,17
1745786356002,MCWP 50R,E00,893775,Carter; Andrea L,0,0,20,20
1745786357029,MMW 11R,A01,892721,Herbst; Matthew,11,0,27,16
1745786357029,MMW 11R,A02,892722,Herbst; Matthew,0,0,0,3
1745786358055,MMW 12R,A01,892724,Herbst; Matthew,0,9,16,16
1745786358055,MMW 12R,A02,892725,Herbst; Matthew,0,9,16,16
1745786359081,MMW 13R,A01,892727,Staff,0,3,16,16
1745786359081,MMW 13R,A02,892728,Staff,0,4,16,16
1745786359081,MMW 13R,A03,958032,Staff,0,3,16,16
1745786359081,MMW 13R,A04,958033,Staff,0,2,16,16
1745786359081,MMW 13R,A05,958034,Staff,0,3,16,16
1745786360109,SIO 295LS,A00,894015,Staff,7,0,25,18
1745786361136,SIO 295S,A00,894020,Staff,7,0,25,18
1745786362166,SIOC 290S,B01,958918,Staff,0,0,0,0
1745786363194,SIOC 291S,B01,958922,Staff,0,0,0,0
1745786364223,SOCI 117,A01,895339,Staff,4,0,5,1
1745786365248,WES 237B,A00,894149,Staff,11,0,20,9
1745786367305,AESE 279B,A00,891859,Staff,13,0,35,22
1745786368334,AIP 197,001,891854,Staff,70,0,70,0
1745786369359,ANTH 289S,A00,891856,Gagneux; Pascal,12,0,12,0
1745786370388,BENG 196,001,957946,Engler; Adam J.,9996,0,9999,3
1745786371414,CAT 124RS,A01,956906,Staff,8,0,25,17
1745786372477,CAT 125RS,A01,922013,Staff,8,0,25,17
1745786373504,CLRE 250,A00,891860,Morris; Sheldon,9995,0,9999,4
1745786375557,CLRE 251R,A00,907817,Mehta; Ravindra L.,9994,0,9999,5
1745786376587,CLRE 252,A00,891864,Cuomo; Raphael Eduardo,9993,0,9999,6
1745786377611,CLRE 253,A00,891867,Vaida; Florin,9994,0,9999,5
1745786377611,CLRE 253,B00,907819,Staff,9999,0,9999,0
1745786378640,CLRE 259,A00,891868,Patel; Hemal,9998,0,9999,1
1745786379665,CLRE 260,A00,891872,Cuomo; Raphael Eduardo,9999,0,9999,0
1745786380692,CLRE 297,001,891888,Cuomo; Raphael Eduardo,9999,0,9999,0
1745786381720,CSE 191,A00,958773,Minnes Kemp; Mor Mia,9999,0,9999,0
1745786382748,CSS 201S,A01,892054,Mignozzetti; Umberto,30,0,30,0
1745786383773,CSS 202S,A01,892056,Mignozzetti; Umberto,30,0,30,0
1745786384799,DSC 197,001,956898,Eldridge; Justin Matthew,9998,0,9999,1
1745786385825,DSC 297,001,958000,Mazumdar; Arya,9998,0,9999,1
1745786386853,EAP 100,A00,905686,Staff,9776,0,9999,223
1745786387881,ECE 45,A01,892618,Staff,0,12,50,50
1745786388910,ECE 109,A01,892620,Staff,0,43,0,0
1745786389937,ECE 111,A01,892719,Staff,0,7,50,50
1745786390964,ECE 197,001,957920,Mercier; Patrick Philip,9992,0,9999,7
1745786391994,ECON 178,A01,907814,Zhu; Ying,28,0,35,7
1745786393023,EDS 115,A00,895312,Staff,41,0,45,4
1745786394052,EDS 117,A01,895337,Staff,30,0,30,0
1745786395079,EDS 125,A00,895341,Jones; Gabrielle Anastasia,43,0,45,2
1745786396103,EDS 128A,A01,895459,Fargason; Sharon Gayle,44,0,45,1
1745786397134,EDS 128B,A01,895543,Pappas; Elizabeth,44,0,45,1
1745786398160,EDS 139,A00,897203,Pappas; Elizabeth,44,0,45,1
1745786398160,EDS 139,B00,897209,Fargason; Sharon Gayle,44,0,45,1
1745786399187,EDS 201,A00,895545,Staff,43,0,45,2
1745786400217,EDS 203,A01,895581,Halter; Christopher P.,43,0,45,2
1745786401242,EDS 204R,A01,895625,Heinzman; Erica M.,44,0,45,1
1745786401242,EDS 204R,B01,895693,Halter; Christopher P.,18,0,45,27
1745786402274,EDS 206R,A00,895694,Fargason; Sharon Gayle,9,0,30,21
1745786402274,EDS 206R,B00,895695,Choi; Bailey Miyeon,20,0,30,10
1745786403300,EDS 250,A00,895697,Hemans; Patricia Ann Benitez,43,0,45,2
1745786404329,EDS 281,A00,895701,Meyerott; Theresa Ann,15,0,15,0
1745786405358,EDS 284,A00,895736,Meyerott; Theresa Ann,15,0,15,0
1745786406386,EDS 286,A00,897210,Fine; Sarah,15,0,15,0
1745786407412,EDS 289C,A01,895770,Daly; Alan J.,15,0,15,0
1745786408441,EDS 290,A00,897211,Hofstetter; Carolyn,15,0,15,0
1745786409470,LIGM 5A,A00,896162,Fischer-Grunski; Eva K,15,0,20,5
1745786410496,LIGM 5B,A00,896260,Fischer-Grunski; Eva K,17,0,20,3
1745786411522,LIGM 5C,A00,896308,Fischer-Grunski; Eva K,18,0,20,2
1745786412549,LIIT 5AS,A00,896313,Carnelos; Chiara,18,0,20,2
1745786413576,LIIT 5BS,A00,896416,Carnelos; Chiara,20,0,20,0
1745786414608,LIIT 5CS,A00,896564,Carnelos; Chiara,20,0,20,0
1745786415637,LISP 5A,A00,896588,Munoz Sanchez; Alicia,4,0,20,16
1745786416663,LISP 5B,A00,896653,Munoz Sanchez; Alicia,10,0,20,10
1745786417690,LISP 5C,A00,896655,Munoz Sanchez; Alicia,4,0,20,16
1745786418715,MAE 197,001,957918,Kleissl; Jan,9998,0,9999,1
1745786419741,MATH 2,A01,957937,Staff,34,0,35,1
1745786420771,MATH 197,001,957876,Kedlaya; Kiran S.,9993,0,9999,6
1745786421795,MCWP 40,A00,892729,Duru; Nur,13,0,20,7
1745786421795,MCWP 40,B00,893304,Montejo; Carolina,20,0,20,0
1745786422820,MCWP 40R,A00,893757,Redela; Pamela Morgan,0,6,20,20
1745786423848,MCWP 50,A00,893758,Morshed; Michael James,2,0,20,18
1745786423848,MCWP 50,B00,893761,Bartulis; Jason Michael,17,0,20,3
1745786424875,MCWP 50R,A00,893766,Compas; Sean Matthew,0,1,20,20
1745786424875,MCWP 50R,B00,893769,Carter; Jennifer A,0,0,20,20
1745786424875,MCWP 50R,C00,893771,Krone; Jarret,0,3,20,20
1745786424875,MCWP 50R,D00,893772,Miller; Elizabeth Deen,3,0,20,17
1745786424875,MCWP 50R,E00,893775,Carter; Andrea L,0,0,20,20
1745786425901,MMW 11R,A01,892721,Herbst; Matthew,11,0,27,16
1745786425901,MMW 11R,A02,892722,Herbst; Matthew,0,0,0,3
1745786426930,MMW 12R,A01,892724,Herbst; Matthew,0,9,16,16
1745786426930,MMW 12R,A02,892725,Herbst; Matthew,0,9,16,16
1745786427954,MMW 13R,A01,892727,Staff,0,3,16,16
1745786427954,MMW 13R,A02,892728,Staff,0,4,16,16
1745786427954,MMW 13R,A03,958032,Staff,0,3,16,16
1745786427954,MMW 13R,A04,958033,Staff,0,2,16,16
1745786427954,MMW 13R,A05,958034,Staff,0,3,16,16
1745786428980,SIO 295LS,A00,894015,Staff,7,0,25,18
1745786430005,SIO 295S,A00,894020,Staff,7,0,25,18
1745786431035,SIOC 290S,B01,958918,Staff,0,0,0,0
1745786432060,SIOC 291S,B01,958922,Staff,0,0,0,0
1745786433085,SOCI 117,A01,895339,Staff,4,0,5,1
1745786434113,WES 237B,A00,894149,Staff,11,0,20,9
1745786436170,AESE 279B,A00,891859,Staff,13,0,35,22
1745786437199,AIP 197,001,891854,Staff,70,0,70,0
1745786438229,ANTH 289S,A00,891856,Gagneux; Pascal,12,0,12,0
1745786439256,BENG 196,001,957946,Engler; Adam J.,9996,0,9999,3
1745786440282,CAT 124RS,A01,956906,Staff,8,0,25,17
1745786441310,CAT 125RS,A01,922013,Staff,8,0,25,17
1745786442336,CLRE 250,A00,891860,Morris; Sheldon,9995,0,9999,4
1745786444388,CLRE 251R,A00,907817,Mehta; Ravindra L.,9994,0,9999,5
1745786445414,CLRE 252,A00,891864,Cuomo; Raphael Eduardo,9993,0,9999,6
1745786446439,CLRE 253,A00,891867,Vaida; Florin,9994,0,9999,5
1745786446439,CLRE 253,B00,907819,Staff,9999,0,9999,0
1745786447469,CLRE 259,A00,891868,Patel; Hemal,9998,0,9999,1
1745786448494,CLRE 260,A00,891872,Cuomo; Raphael Eduardo,9999,0,9999,0
1745786449521,CLRE 297,001,891888,Cuomo; Raphael Eduardo,9999,0,9999,0
1745786450546,CSE 191,A00,958773,Minnes Kemp; Mor Mia,9999,0,9999,0
1745786451574,CSS 201S,A01,892054,Mignozzetti; Umberto,30,0,30,0
1745786452599,CSS 202S,A01,892056,Mignozzetti; Umberto,30,0,30,0
1745786453626,DSC 197,001,956898,Eldridge; Justin Matthew,9998,0,9999,1
1745786454653,DSC 297,001,958000,Mazumdar; Arya,9998,0,9999,1
1745786455682,EAP 100,A00,905686,Staff,9776,0,9999,223
1745786456708,ECE 45,A01,892618,Staff,0,12,50,50
1745786457736,ECE 109,A01,892620,Staff,0,43,0,0
1745786458761,ECE 111,A01,892719,Staff,0,7,50,50
1745786459787,ECE 197,001,957920,Mercier; Patrick Philip,9992,0,9999,7
1745786460812,ECON 178,A01,907814,Zhu; Ying,28,0,35,7
1745786461842,EDS 115,A00,895312,Staff,41,0,45,4
1745786462871,EDS 117,A01,895337,Staff,30,0,30,0
1745786463897,EDS 125,A00,895341,Jones; Gabrielle Anastasia,43,0,45,2
1745786464926,EDS 128A,A01,895459,Fargason; Sharon Gayle,44,0,45,1
1745786465950,EDS 128B,A01,895543,Pappas; Elizabeth,44,0,45,1
1745786466980,EDS 139,A00,897203,Pappas; Elizabeth,44,0,45,1
1745786466980,EDS 139,B00,897209,Fargason; Sharon Gayle,44,0,45,1
1745786468008,EDS 201,A00,895545,Staff,43,0,45,2
1745786469034,EDS 203,A01,895581,Halter; Christopher P.,43,0,45,2
1745786470060,EDS 204R,A01,895625,Heinzman; Erica M.,44,0,45,1
1745786470060,EDS 204R,B01,895693,Halter; Christopher P.,18,0,45,27
1745786471086,EDS 206R,A00,895694,Fargason; Sharon Gayle,9,0,30,21
1745786471086,EDS 206R,B00,895695,Choi; Bailey Miyeon,20,0,30,10
1745786472113,EDS 250,A00,895697,Hemans; Patricia Ann Benitez,43,0,45,2
1745786473138,EDS 281,A00,895701,Meyerott; Theresa Ann,15,0,15,0
1745786474166,EDS 284,A00,895736,Meyerott; Theresa Ann,15,0,15,0
1745786475195,EDS 286,A00,897210,Fine; Sarah,15,0,15,0
1745786476262,EDS 289C,A01,895770,Daly; Alan J.,15,0,15,0
1745786477288,EDS 290,A00,897211,Hofstetter; Carolyn,15,0,15,0
1745786478312,LIGM 5A,A00,896162,Fischer-Grunski; Eva K,15,0,20,5
1745786479339,LIGM 5B,A00,896260,Fischer-Grunski; Eva K,17,0,20,3
1745786480366,LIGM 5C,A00,896308,Fischer-Grunski; Eva K,18,0,20,2
1745786481397,LIIT 5AS,A00,896313,Carnelos; Chiara,18,0,20,2
1745786482424,LIIT 5BS,A00,896416,Carnelos; Chiara,20,0,20,0
1745786483451,LIIT 5CS,A00,896564,Carnelos; Chiara,20,0,20,0
1745786484481,LISP 5A,A00,896588,Munoz Sanchez; Alicia,4,0,20,16
1745786485507,LISP 5B,A00,896653,Munoz Sanchez; Alicia,10,0,20,10
1745786486536,LISP 5C,A00,896655,Munoz Sanchez; Alicia,4,0,20,16
1745786487562,MAE 197,001,957918,Kleissl; Jan,9998,0,9999,1
1745786488587,MATH 2,A01,957937,Staff,34,0,35,1
1745786489615,MATH 197,001,957876,Kedlaya; Kiran S.,9993,0,9999,6
1745786490642,MCWP 40,A00,892729,Duru; Nur,13,0,20,7
1745786490642,MCWP 40,B00,893304,Montejo; Carolina,20,0,20,0
1745786491670,MCWP 40R,A00,893757,Redela; Pamela Morgan,0,6,20,20
1745786492696,MCWP 50,A00,893758,Morshed; Michael James,2,0,20,18
1745786492696,MCWP 50,B00,893761,Bartulis; Jason Michael,17,0,20,3
1745786493723,MCWP 50R,A00,893766,Compas; Sean Matthew,0,1,20,20
1745786493723,MCWP 50R,B00,893769,Carter; Jennifer A,0,0,20,20
1745786493723,MCWP 50R,C00,893771,Krone; Jarret,0,3,20,20
1745786493723,MCWP 50R,D00,893772,Miller; Elizabeth Deen,3,0,20,17
1745786493723,MCWP 50R,E00,893775,Carter; Andrea L,0,0,20,20
1745786494750,MMW 11R,A01,892721,Herbst; Matthew,11,0,27,16
1745786494750,MMW 11R,A02,892722,Herbst; Matthew,0,0,0,3
1745786495779,MMW 12R,A01,892724,Herbst; Matthew,0,9,16,16
1745786495779,MMW 12R,A02,892725,Herbst; Matthew,0,9,16,16
1745786496805,MMW 13R,A01,892727,Staff,0,3,16,16
1745786496805,MMW 13R,A02,892728,Staff,0,4,16,16
1745786496805,MMW 13R,A03,958032,Staff,0,3,16,16
1745786496805,MMW 13R,A04,958033,Staff,0,2,16,16
1745786496805,MMW 13R,A05,958034,Staff,0,3,16,16
1745786497833,SIO 295LS,A00,894015,Staff,7,0,25,18
1745786498860,SIO 295S,A00,894020,Staff,7,0,25,18
1745786499885,SIOC 290S,B01,958918,Staff,0,0,0,0
1745786500912,SIOC 291S,B01,958922,Staff,0,0,0,0
1745786501938,SOCI 117,A01,895339,Staff,4,0,5,1
1745786502967,WES 237B,A00,894149,Staff,11,0,20,9
1745786505030,AESE 279B,A00,891859,Staff,13,0,35,22
1745786506057,AIP 197,001,891854,Staff,70,0,70,0
1745786507084,ANTH 289S,A00,891856,Gagneux; Pascal,12,0,12,0
1745786508112,BENG 196,001,957946,Engler; Adam J.,9996,0,9999,3
1745786509140,CAT 124RS,A01,956906,Staff,8,0,25,17
1745786510166,CAT 125RS,A01,922013,Staff,8,0,25,17
1745786511192,CLRE 250,A00,891860,Morris; Sheldon,9995,0,9999,4
1745786513246,CLRE 251R,A00,907817,Mehta; Ravindra L.,9994,0,9999,5
1745786514276,CLRE 252,A00,891864,Cuomo; Raphael Eduardo,9993,0,9999,6
1745786515304,CLRE 253,A00,891867,Vaida; Florin,9994,0,9999,5
1745786515304,CLRE 253,B00,907819,Staff,9999,0,9999,0
1745786516331,CLRE 259,A00,891868,Patel; Hemal,9998,0,9999,1
1745786517357,CLRE 260,A00,891872,Cuomo; Raphael Eduardo,9999,0,9999,0
1745786518382,CLRE 297,001,891888,Cuomo; Raphael Eduardo,9999,0,9999,0
1745786519408,CSE 191,A00,958773,Minnes Kemp; Mor Mia,9999,0,9999,0
1745786520437,CSS 201S,A01,892054,Mignozzetti; Umberto,30,0,30,0
1745786521461,CSS 202S,A01,892056,Mignozzetti; Umberto,30,0,30,0
1745786522488,DSC 197,001,956898,Eldridge; Justin Matthew,9998,0,9999,1
1745786523513,DSC 297,001,958000,Mazumdar; Arya,9998,0,9999,1
1745786524539,EAP 100,A00,905686,Staff,9776,0,9999,223
1745786525564,ECE 45,A01,892618,Staff,0,12,50,50
1745786526589,ECE 109,A01,892620,Staff,0,43,0,0
1745786527615,ECE 111,A01,892719,Staff,0,7,50,50
1745786528643,ECE 197,001,957920,Mercier; Patrick Philip,9992,0,9999,7
1745786529673,ECON 178,A01,907814,Zhu; Ying,28,0,35,7
1745786530701,EDS 115,A00,895312,Staff,41,0,45,4
1745786531727,EDS 117,A01,895337,Staff,30,0,30,0
1745786532756,EDS 125,A00,895341,Jones; Gabrielle Anastasia,43,0,45,2
1745786533785,EDS 128A,A01,895459,Fargason; Sharon Gayle,44,0,45,1
1745786534811,EDS 128B,A01,895543,Pappas; Elizabeth,44,0,45,1
1745786535837,EDS 139,A00,897203,Pappas; Elizabeth,44,0,45,1
1745786535837,EDS 139,B00,897209,Fargason; Sharon Gayle,44,0,45,1
1745786536864,EDS 201,A00,895545,Staff,43,0,45,2
1745786537890,EDS 203,A01,895581,Halter; Christopher P.,43,0,45,2
1745786538919,EDS 204R,A01,895625,Heinzman; Erica M.,44,0,45,1
1745786538919,EDS 204R,B01,895693,Halter; Christopher P.,18,0,45,27
1745786539949,EDS 206R,A00,895694,Fargason; Sharon Gayle,9,0,30,21
1745786539949,EDS 206R,B00,895695,Choi; Bailey Miyeon,20,0,30,10
1745786540974,EDS 250,A00,895697,Hemans; Patricia Ann Benitez,43,0,45,2
1745786542002,EDS 281,A00,895701,Meyerott; Theresa Ann,15,0,15,0
1745786543028,EDS 284,A00,895736,Meyerott; Theresa Ann,15,0,15,0
1745786544054,EDS 286,A00,897210,Fine; Sarah,15,0,15,0
1745786545082,EDS 289C,A01,895770,Daly; Alan J.,15,0,15,0
1745786546110,EDS 290,A00,897211,Hofstetter; Carolyn,15,0,15,0
1745786547137,LIGM 5A,A00,896162,Fischer-Grunski; Eva K,15,0,20,5
1745786548164,LIGM 5B,A00,896260,Fischer-Grunski; Eva K,17,0,20,3
1745786549193,LIGM 5C,A00,896308,Fischer-Grunski; Eva K,18,0,20,2
1745786550218,LIIT 5AS,A00,896313,Carnelos; Chiara,18,0,20,2
1745786551244,LIIT 5BS,A00,896416,Carnelos; Chiara,20,0,20,0
1745786552270,LIIT 5CS,A00,896564,Carnelos; Chiara,20,0,20,0
1745786553298,LISP 5A,A00,896588,Munoz Sanchez; Alicia,4,0,20,16
1745786554324,LISP 5B,A00,896653,Munoz Sanchez; Alicia,10,0,20,10
1745786555351,LISP 5C,A00,896655,Munoz Sanchez; Alicia,4,0,20,16
1745786556375,MAE 197,001,957918,Kleissl; Jan,9998,0,9999,1
1745786557401,MATH 2,A01,957937,Staff,34,0,35,1
1745786558426,MATH 197,001,957876,Kedlaya; Kiran S.,9993,0,9999,6
1745786559452,MCWP 40,A00,892729,Duru; Nur,13,0,20,7
1745786559452,MCWP 40,B00,893304,Montejo; Carolina,20,0,20,0
1745786560478,MCWP 40R,A00,893757,Redela; Pamela Morgan,0,6,20,20
1745786561506,MCWP 50,A00,893758,Morshed; Michael James,2,0,20,18
1745786561506,MCWP 50,B00,893761,Bartulis; Jason Michael,17,0,20,3
1745786562531,MCWP 50R,A00,893766,Compas; Sean Matthew,0,1,20,20
1745786562531,MCWP 50R,B00,893769,Carter; Jennifer A,0,0,20,20
1745786562531,MCWP 50R,C00,893771,Krone; Jarret,0,3,20,20
1745786562531,MCWP 50R,D00,893772,Miller; Elizabeth Deen,3,0,20,17
1745786562531,MCWP 50R,E00,893775,Carter; Andrea L,0,0,20,20
1745786563557,MMW 11R,A01,892721,Herbst; Matthew,11,0,27,16
1745786563557,MMW 11R,A02,892722,Herbst; Matthew,0,0,0,3
1745786564585,MMW 12R,A01,892724,Herbst; Matthew,0,9,16,16
1745786564585,MMW 12R,A02,892725,Herbst; Matthew,0,9,16,16
1745786565610,MMW 13R,A01,892727,Staff,0,3,16,16
1745786565610,MMW 13R,A02,892728,Staff,0,4,16,16
1745786565610,MMW 13R,A03,958032,Staff,0,3,16,16
1745786565610,MMW 13R,A04,958033,Staff,0,2,16,16
1745786565610,MMW 13R,A05,958034,Staff,0,3,16,16
1745786566639,SIO 295LS,A00,894015,Staff,7,0,25,18
1745786567669,SIO 295S,A00,894020,Staff,7,0,25,18
1745786568694,SIOC 290S,B01,958918,Staff,0,0,0,0
1745786569719,SIOC 291S,B01,958922,Staff,0,0,0,0
1745786570744,SOCI 117,A01,895339,Staff,4,0,5,1
1745786571769,WES 237B,A00,894149,Staff,11,0,20,9
1745786573836,AESE 279B,A00,891859,Staff,13,0,35,22
1745786574860,AIP 197,001,891854,Staff,70,0,70,0
1745786575885,ANTH 289S,A00,891856,Gagneux; Pascal,12,0,12,0
1745786576911,BENG 196,001,957946,Engler; Adam J.,9996,0,9999,3
1745786577940,CAT 124RS,A01,956906,Staff,8,0,25,17
1745786578967,CAT 125RS,A01,922013,Staff,8,0,25,17
1745786580036,CLRE 250,A00,891860,Morris; Sheldon,9995,0,9999,4
1745786582089,CLRE 251R,A00,907817,Mehta; Ravindra L.,9994,0,9999,5
1745786583115,CLRE 252,A00,891864,Cuomo; Raphael Eduardo,9993,0,9999,6
1745786584144,CLRE 253,A00,891867,Vaida; Florin,9994,0,9999,5
1745786584144,CLRE 253,B00,907819,Staff,9999,0,9999,0
1745786585173,CLRE 259,A00,891868,Patel; Hemal,9998,0,9999,1
1745786586200,CLRE 260,A00,891872,Cuomo; Raphael Eduardo,9999,0,9999,0
1745786587227,CLRE 297,001,891888,Cuomo; Raphael Eduardo,9999,0,9999,0
1745786588253,CSE 191,A00,958773,Minnes Kemp; Mor Mia,9999,0,9999,0
1745786589282,CSS 201S,A01,892054,Mignozzetti; Umberto,30,0,30,0
1745786590312,CSS 202S,A01,892056,Mignozzetti; Umberto,30,0,30,0
1745786591342,DSC 197,001,956898,Eldridge; Justin Matthew,9998,0,9999,1
1745786592369,DSC 297,001,958000,Mazumdar; Arya,9998,0,9999,1
1745786593398,EAP 100,A00,905686,Staff,9776,0,9999,223
1745786594425,ECE 45,A01,892618,Staff,0,12,50,50
1745786595450,ECE 109,A01,892620,Staff,0,43,0,0
1745786596477,ECE 111,A01,892719,Staff,0,7,50,50
1745786597504,ECE 197,001,957920,Mercier; Patrick Philip,9992,0,9999,7
1745786598534,ECON 178,A01,907814,Zhu; Ying,28,0,35,7
1745786599561,EDS 115,A00,895312,Staff,41,0,45,4
1745786600588,EDS 117,A01,895337,Staff,30,0,30,0
1745786601618,EDS 125,A00,895341,Jones; Gabrielle Anastasia,43,0,45,2
1745786602645,EDS 128A,A01,895459,Fargason; Sharon Gayle,44,0,45,1
1745786603673,EDS 128B,A01,895543,Pappas; Elizabeth,44,0,45,1
1745786604698,EDS 139,A00,897203,Pappas; Elizabeth,44,0,45,1
1745786604698,EDS 139,B00,897209,Fargason; Sharon Gayle,44,0,45,1
1745786605725,EDS 201,A00,895545,Staff,43,0,45,2
1745786606754,EDS 203,A01,895581,Halter; Christopher P.,43,0,45,2
1745786607782,EDS 204R,A01,895625,Heinzman; Erica M.,44,0,45,1
1745786607782,EDS 204R,B01,895693,Halter; Christopher P.,18,0,45,27
1745786608809,EDS 206R,A00,895694,Fargason; Sharon Gayle,9,0,30,21
1745786608809,EDS 206R,B00,895695,Choi; Bailey Miyeon,20,0,30,10
1745786609835,EDS 250,A00,895697,Hemans; Patricia Ann Benitez,43,0,45,2
1745786610864,EDS 281,A00,895701,Meyerott; Theresa Ann,15,0,15,0
1745786611893,EDS 284,A00,895736,Meyerott; Theresa Ann,15,0,15,0
1745786612919,EDS 286,A00,897210,Fine; Sarah,15,0,15,0
1745786613947,EDS 289C,A01,895770,Daly; Alan J.,15,0,15,0
1745786614973,EDS 290,A00,897211,Hofstetter; Carolyn,15,0,15,0
1745786616000,LIGM 5A,A00,896162,Fischer-Grunski; Eva K,15,0,20,5
1745786617027,LIGM 5B,A00,896260,Fischer-Grunski; Eva K,17,0,20,3
1745786618052,LIGM 5C,A00,896308,Fischer-Grunski; Eva K,18,0,20,2
1745786619078,LIIT 5AS,A00,896313,Carnelos; Chiara,18,0,20,2
1745786620107,LIIT 5BS,A00,896416,Carnelos; Chiara,20,0,20,0
1745786621133,LIIT 5CS,A00,896564,Carnelos; Chiara,20,0,20,0
1745786622158,LISP 5A,A00,896588,Munoz Sanchez; Alicia,4,0,20,16
1745786623187,LISP 5B,A00,896653,Munoz Sanchez; Alicia,10,0,20,10
1745786624215,LISP 5C,A00,896655,Munoz Sanchez; Alicia,4,0,20,16
1745786625239,MAE 197,001,957918,Kleissl; Jan,9998,0,9999,1
1745786626264,MATH 2,A01,957937,Staff,34,0,35,1
1745786627290,MATH 197,001,957876,Kedlaya; Kiran S.,9993,0,9999,6
1745786628316,MCWP 40,A00,892729,Duru; Nur,13,0,20,7
1745786628316,MCWP 40,B00,893304,Montejo; Carolina,20,0,20,0
1745786629345,MCWP 40R,A00,893757,Redela; Pamela Morgan,0,6,20,20
1745786630373,MCWP 50,A00,893758,Morshed; Michael James,2,0,20,18
1745786630373,MCWP 50,B00,893761,Bartulis; Jason Michael,17,0,20,3
1745786631403,MCWP 50R,A00,893766,Compas; Sean Matthew,0,1,20,20
1745786631403,MCWP 50R,B00,893769,Carter; Jennifer A,0,0,20,20
1745786631403,MCWP 50R,C00,893771,Krone; Jarret,0,3,20,20
1745786631403,MCWP 50R,D00,893772,Miller; Elizabeth Deen,3,0,20,17
1745786631403,MCWP 50R,E00,893775,Carter; Andrea L,0,0,20,20
1745786632432,MMW 11R,A01,892721,Herbst; Matthew,11,0,27,16
1745786632432,MMW 11R,A02,892722,Herbst; Matthew,0,0,0,3
1745786633461,MMW 12R,A01,892724,Herbst; Matthew,0,9,16,16
1745786633461,MMW 12R,A02,892725,Herbst; Matthew,0,9,16,16
1745786634487,MMW 13R,A01,892727,Staff,0,3,16,16
1745786634487,MMW 13R,A02,892728,Staff,0,4,16,16
1745786634487,MMW 13R,A03,958032,Staff,0,3,16,16
1745786634487,MMW 13R,A04,958033,Staff,0,2,16,16
1745786634487,MMW 13R,A05,958034,Staff,0,3,16,16
1745786635514,SIO 295LS,A00,894015,Staff,7,0,25,18
1745786636543,SIO 295S,A00,894020,Staff,7,0,25,18
1745786637570,SIOC 290S,B01,958918,Staff,0,0,0,0
1745786638599,SIOC 291S,B01,958922,Staff,0,0,0,0
1745786639625,SOCI 117,A01,895339,Staff,4,0,5,1
1745786640650,WES 237B,A00,894149,Staff,11,0,20,9
1745786642713,AESE 279B,A00,891859,Staff,13,0,35,22
1745786643742,AIP 197,001,891854,Staff,70,0,70,0
1745786644768,ANTH 289S,A00,891856,Gagneux; Pascal,12,0,12,0
1745786645795,BENG 196,001,957946,Engler; Adam J.,9996,0,9999,3
1745786646821,CAT 124RS,A01,956906,Staff,8,0,25,17
1745786647847,CAT 125RS,A01,922013,Staff,8,0,25,17
1745786648876,CLRE 250,A00,891860,Morris; Sheldon,9995,0,9999,4
1745786650937,CLRE 251R,A00,907817,Mehta; Ravindra L.,9994,0,9999,5
1745786651964,CLRE 252,A00,891864,Cuomo; Raphael Eduardo,9993,0,9999,6
1745786652994,CLRE 253,A00,891867,Vaida; Florin,9994,0,9999,5
1745786652994,CLRE 253,B00,907819,Staff,9999,0,9999,0
1745786654021,CLRE 259,A00,891868,Patel; Hemal,9998,0,9999,1
1745786655051,CLRE 260,A00,891872,Cuomo; Raphael Eduardo,9999,0,9999,0
1745786656077,CLRE 297,001,891888,Cuomo; Raphael Eduardo,9999,0,9999,0
1745786657102,CSE 191,A00,958773,Minnes Kemp; Mor Mia,9999,0,9999,0
1745786658128,CSS 201S,A01,892054,Mignozzetti; Umberto,30,0,30,0
1745786659158,CSS 202S,A01,892056,Mignozzetti; Umberto,30,0,30,0
1745786660184,DSC 197,001,956898,Eldridge; Justin Matthew,9998,0,9999,1
1745786661210,DSC 297,001,958000,Mazumdar; Arya,9998,0,9999,1
1745786662235,EAP 100,A00,905686,Staff,9776,0,9999,223
1745786663262,ECE 45,A01,892618,Staff,0,12,50,50
1745786664292,ECE 109,A01,892620,Staff,0,43,0,0
1745786665318,ECE 111,A01,892719,Staff,0,7,50,50
1745786666346,ECE 197,001,957920,Mercier; Patrick Philip,9992,0,9999,7
1745786667371,ECON 178,A01,907814,Zhu; Ying,28,0,35,7
1745786668397,EDS 115,A00,895312,Staff,41,0,45,4
1745786669426,EDS 117,A01,895337,Staff,30,0,30,0
1745786670453,EDS 125,A00,895341,Jones; Gabrielle Anastasia,43,0,45,2
1745786671483,EDS 128A,A01,895459,Fargason; Sharon Gayle,44,0,45,1
1745786672510,EDS 128B,A01,895543,Pappas; Elizabeth,44,0,45,1
1745786673540,EDS 139,A00,897203,Pappas; Elizabeth,44,0,45,1
1745786673540,EDS 139,B00,897209,Fargason; Sharon Gayle,44,0,45,1
1745786674568,EDS 201,A00,895545,Staff,43,0,45,2
1745786675594,EDS 203,A01,895581,Halter; Christopher P.,43,0,45,2
1745786676620,EDS 204R,A01,895625,Heinzman; Erica M.,44,0,45,1
1745786676620,EDS 204R,B01,895693,Halter; Christopher P.,18,0,45,27
1745786677645,EDS 206R,A00,895694,Fargason; Sharon Gayle,9,0,30,21
1745786677645,EDS 206R,B00,895695,Choi; Bailey Miyeon,20,0,30,10
1745786678671,EDS 250,A00,895697,Hemans; Patricia Ann Benitez,43,0,45,2
1745786679699,EDS 281,A00,895701,Meyerott; Theresa Ann,15,0,15,0
1745786680724,EDS 284,A00,895736,Meyerott; Theresa Ann,15,0,15,0
1745786681753,EDS 286,A00,897210,Fine; Sarah,15,0,15,0
1745786682779,EDS 289C,A01,895770,Daly; Alan J.,15,0,15,0
1745786683845,EDS 290,A00,897211,Hofstetter; Carolyn,15,0,15,0
1745786684871,LIGM 5A,A00,896162,Fischer-Grunski; Eva K,15,0,20,5
1745786685898,LIGM 5B,A00,896260,Fischer-Grunski; Eva K,17,0,20,3
1745786686926,LIGM 5C,A00,896308,Fischer-Grunski; Eva K,18,0,20,2
1745786687951,LIIT 5AS,A00,896313,Carnelos; Chiara,18,0,20,2
1745786688981,LIIT 5BS,A00,896416,Carnelos; Chiara,20,0,20,0
1745786690007,LIIT 5CS,A00,896564,Carnelos; Chiara,20,0,20,0
1745786691033,LISP 5A,A00,896588,Munoz Sanchez; Alicia,4,0,20,16
1745786692063,LISP 5B,A00,896653,Munoz Sanchez; Alicia,10,0,20,10
1745786693089,LISP 5C,A00,896655,Munoz Sanchez; Alicia,4,0,20,16
1745786694120,MAE 197,001,957918,Kleissl; Jan,9998,0,9999,1
1745786695150,MATH 2,A01,957937,Staff,34,0,35,1
1745786696177,MATH 197,001,957876,Kedlaya; Kiran S.,9993,0,9999,6
1745786697207,MCWP 40,A00,892729,Duru; Nur,13,0,20,7
1745786697207,MCWP 40,B00,893304,Montejo; Carolina,20,0,20,0
1745786698235,MCWP 40R,A00,893757,Redela; Pamela Morgan,0,6,20,20
1745786699263,MCWP 50,A00,893758,Morshed; Michael James,2,0,20,18
1745786699263,MCWP 50,B00,893761,Bartulis; Jason Michael,17,0,20,3
1745786700289,MCWP 50R,A00,893766,Compas; Sean Matthew,0,1,20,20
1745786700289,MCWP 50R,B00,893769,Carter; Jennifer A,0,0,20,20
1745786700289,MCWP 50R,C00,893771,Krone; Jarret,0,3,20,20
1745786700289,MCWP 50R,D00,893772,Miller; Elizabeth Deen,3,0,20,17
1745786700289,MCWP 50R,E00,893775,Carter; Andrea L,0,0,20,20
1745786701320,MMW 11R,A01,892721,Herbst; Matthew,11,0,27,16
1745786701320,MMW 11R,A02,892722,Herbst; Matthew,0,0,0,3
1745786702349,MMW 12R,A01,892724,Herbst; Matthew,0,9,16,16
1745786702349,MMW 12R,A02,892725,Herbst; Matthew,0,9,16,16
1745786703379,MMW 13R,A01,892727,Staff,0,3,16,16
1745786703379,MMW 13R,A02,892728,Staff,0,4,16,16
1745786703379,MMW 13R,A03,958032,Staff,0,3,16,16
1745786703379,MMW 13R,A04,958033,Staff,0,2,16,16
1745786703379,MMW 13R,A05,958034,Staff,0,3,16,16
1745786704406,SIO 295LS,A00,894015,Staff,7,0,25,18
1745786705432,SIO 295S,A00,894020,Staff,7,0,25,18
1745786706461,SIOC 290S,B01,958918,Staff,0,0,0,0
1745786707489,SIOC 291S,B01,958922,Staff,0,0,0,0
1745786708514,SOCI 117,A01,895339,Staff,4,0,5,1
1745786709541,WES 237B,A00,894149,Staff,11,0,20,9
1745786711600,AESE 279B,A00,891859,Staff,13,0,35,22
1745786712628,AIP 197,001,891854,Staff,70,0,70,0
1745786713656,ANTH 289S,A00,891856,Gagneux; Pascal,12,0,12,0
1745786714682,BENG 196,001,957946,Engler; Adam J.,9996,0,9999,3
1745786715709,CAT 124RS,A01,956906,Staff,8,0,25,17
1745786716736,CAT 125RS,A01,922013,Staff,8,0,25,17
1745786717762,CLRE 250,A00,891860,Morris; Sheldon,9995,0,9999,4
1745786719821,CLRE 251R,A00,907817,Mehta; Ravindra L.,9994,0,9999,5
1745786720849,CLRE 252,A00,891864,Cuomo; Raphael Eduardo,9993,0,9999,6
1745786721879,CLRE 253,A00,891867,Vaida; Florin,9994,0,9999,5
1745786721879,CLRE 253,B00,907819,Staff,9999,0,9999,0
1745786722908,CLRE 259,A00,891868,Patel; Hemal,9998,0,9999,1
1745786723938,CLRE 260,A00,891872,Cuomo; Raphael Eduardo,9999,0,9999,0
1745786724965,CLRE 297,001,891888,Cuomo; Raphael Eduardo,9999,0,9999,0
1745786725994,CSE 191,A00,958773,Minnes Kemp; Mor Mia,9999,0,9999,0
1745786727020,CSS 201S,A01,892054,Mignozzetti; Umberto,30,0,30,0
1745786728046,CSS 202S,A01,892056,Mignozzetti; Umberto,30,0,30,0
1745786729072,DSC 197,001,956898,Eldridge; Justin Matthew,9998,0,9999,1
1745786730097,DSC 297,001,958000,Mazumdar; Arya,9998,0,9999,1
1745786731122,EAP 100,A00,905686,Staff,9776,0,9999,223
1745786732147,ECE 45,A01,892618,Staff,0,12,50,50
1745786733173,ECE 109,A01,892620,Staff,0,43,0,0
1745786734200,ECE 111,A01,892719,Staff,0,7,50,50
1745786735226,ECE 197,001,957920,Mercier; Patrick Philip,9992,0,9999,7
1745786736252,ECON 178,A01,907814,Zhu; Ying,28,0,35,7
1745786737277,EDS 115,A00,895312,Staff,41,0,45,4
1745786738303,EDS 117,A01,895337,Staff,30,0,30,0
1745786739331,EDS 125,A00,895341,Jones; Gabrielle Anastasia,43,0,45,2
1745786740358,EDS 128A,A01,895459,Fargason; Sharon Gayle,44,0,45,1
1745786741386,EDS 128B,A01,895543,Pappas; Elizabeth,44,0,45,1
1745786742412,EDS 139,A00,897203,Pappas; Elizabeth,44,0,45,1
1745786742412,EDS 139,B00,897209,Fargason; Sharon Gayle,44,0,45,1
1745786743439,EDS 201,A00,895545,Staff,43,0,45,2
1745786744467,EDS 203,A01,895581,Halter; Christopher P.,43,0,45,2
1745786745492,EDS 204R,A01,895625,Heinzman; Erica M.,44,0,45,1
1745786745492,EDS 204R,B01,895693,Halter; Christopher P.,18,0,45,27
1745786746517,EDS 206R,A00,895694,Fargason; Sharon Gayle,9,0,30,21
1745786746517,EDS 206R,B00,895695,Choi; Bailey Miyeon,20,0,30,10
1745786747542,EDS 250,A00,895697,Hemans; Patricia Ann Benitez,43,0,45,2
1745786748570,EDS 281,A00,895701,Meyerott; Theresa Ann,15,0,15,0
1745786749594,EDS 284,A00,895736,Meyerott; Theresa Ann,15,0,15,0
1745786750622,EDS 286,A00,897210,Fine; Sarah,15,0,15,0
1745786751648,EDS 289C,A01,895770,Daly; Alan J.,15,0,15,0
1745786752674,EDS 290,A00,897211,Hofstetter; Carolyn,15,0,15,0
1745786753701,LIGM 5A,A00,896162,Fischer-Grunski; Eva K,15,0,20,5
1745786754731,LIGM 5B,A00,896260,Fischer-Grunski; Eva K,17,0,20,3
1745786755755,LIGM 5C,A00,896308,Fischer-Grunski; Eva K,18,0,20,2
1745786756783,LIIT 5AS,A00,896313,Carnelos; Chiara,18,0,20,2
1745786757810,LIIT 5BS,A00,896416,Carnelos; Chiara,20,0,20,0
1745786758839,LIIT 5CS,A00,896564,Carnelos; Chiara,20,0,20,0
1745786759865,LISP 5A,A00,896588,Munoz Sanchez; Alicia,4,0,20,16
1745786760895,LISP 5B,A00,896653,Munoz Sanchez; Alicia,10,0,20,10
1745786761927,LISP 5C,A00,896655,Munoz Sanchez; Alicia,4,0,20,16
1745786762952,MAE 197,001,957918,Kleissl; Jan,9998,0,9999,1
1745786763979,MATH 2,A01,957937,Staff,34,0,35,1
1745786765006,MATH 197,001,957876,Kedlaya; Kiran S.,9993,0,9999,6
1745786766034,MCWP 40,A00,892729,Duru; Nur,13,0,20,7
1745786766034,MCWP 40,B00,893304,Montejo; Carolina,20,0,20,0
1745786767062,MCWP 40R,A00,893757,Redela; Pamela Morgan,0,6,20,20
1745786768087,MCWP 50,A00,893758,Morshed; Michael James,2,0,20,18
1745786768087,MCWP 50,B00,893761,Bartulis; Jason Michael,17,0,20,3
1745786769113,MCWP 50R,A00,893766,Compas; Sean Matthew,0,1,20,20
1745786769113,MCWP 50R,B00,893769,Carter; Jennifer A,0,0,20,20
1745786769113,MCWP 50R,C00,893771,Krone; Jarret,0,3,20,20
1745786769113,MCWP 50R,D00,893772,Miller; Elizabeth Deen,3,0,20,17
1745786769113,MCWP 50R,E00,893775,Carter; Andrea L,0,0,20,20
1745786770138,MMW 11R,A01,892721,Herbst; Matthew,11,0,27,16
1745786770138,MMW 11R,A02,892722,Herbst; Matthew,0,0,0,3
1745786771162,MMW 12R,A01,892724,Herbst; Matthew,0,9,16,16
1745786771162,MMW 12R,A02,892725,Herbst; Matthew,0,9,16,16
1745786772189,MMW 13R,A01,892727,Staff,0,3,16,16
1745786772189,MMW 13R,A02,892728,Staff,0,4,16,16
1745786772189,MMW 13R,A03,958032,Staff,0,3,16,16
1745786772189,MMW 13R,A04,958033,Staff,0,2,16,16
1745786772189,MMW 13R,A05,958034,Staff,0,3,16,16
1745786773214,SIO 295LS,A00,894015,Staff,7,0,25,18
1745786774240,SIO 295S,A00,894020,Staff,7,0,25,18
1745786775269,SIOC 290S,B01,958918,Staff,0,0,0,0
1745786776296,SIOC 291S,B01,958922,Staff,0,0,0,0
1745786777325,SOCI 117,A01,895339,Staff,4,0,5,1
1745786778353,WES 237B,A00,894149,Staff,11,0,20,9
1745786780411,AESE 279B,A00,891859,Staff,13,0,35,22
1745786781437,AIP 197,001,891854,Staff,70,0,70,0
1745786782463,ANTH 289S,A00,891856,Gagneux; Pascal,12,0,12,0
1745786783490,BENG 196,001,957946,Engler; Adam J.,9996,0,9999,3
1745786784517,CAT 124RS,A01,956906,Staff,8,0,25,17
1745786785542,CAT 125RS,A01,922013,Staff,8,0,25,17
1745786786571,CLRE 250,A00,891860,Morris; Sheldon,9995,0,9999,4
1745786788661,CLRE 251R,A00,907817,Mehta; Ravindra L.,9994,0,9999,5
1745786789689,CLRE 252,A00,891864,Cuomo; Raphael Eduardo,9993,0,9999,6
1745786790716,CLRE 253,A00,891867,Vaida; Florin,9994,0,9999,5
1745786790716,CLRE 253,B00,907819,Staff,9999,0,9999,0
1745786791743,CLRE 259,A00,891868,Patel; Hemal,9998,0,9999,1
1745786792770,CLRE 260,A00,891872,Cuomo; Raphael Eduardo,9999,0,9999,0
1745786793795,CLRE 297,001,891888,Cuomo; Raphael Eduardo,9999,0,9999,0
1745786794821,CSE 191,A00,958773,Minnes Kemp; Mor Mia,9999,0,9999,0
1745786795850,CSS 201S,A01,892054,Mignozzetti; Umberto,30,0,30,0
1745786796880,CSS 202S,A01,892056,Mignozzetti; Umberto,30,0,30,0
1745786797909,DSC 197,001,956898,Eldridge; Justin Matthew,9998,0,9999,1
1745786798934,DSC 297,001,958000,Mazumdar; Arya,9998,0,9999,1
1745786799960,EAP 100,A00,905686,Staff,9776,0,9999,223
1745786800994,ECE 45,A01,892618,Staff,0,12,50,50
1745786802022,ECE 109,A01,892620,Staff,0,43,0,0
1745786803050,ECE 111,A01,892719,Staff,0,7,50,50
1745786804075,ECE 197,001,957920,Mercier; Patrick Philip,9992,0,9999,7
1745786805100,ECON 178,A01,907814,Zhu; Ying,28,0,35,7
1745786806125,EDS 115,A00,895312,Staff,41,0,45,4
1745786807153,EDS 117,A01,895337,Staff,30,0,30,0
1745786808179,EDS 125,A00,895341,Jones; Gabrielle Anastasia,43,0,45,2
1745786809205,EDS 128A,A01,895459,Fargason; Sharon Gayle,44,0,45,1
1745786810234,EDS 128B,A01,895543,Pappas; Elizabeth,44,0,45,1
1745786811264,EDS 139,A00,897203,Pappas; Elizabeth,44,0,45,1
1745786811264,EDS 139,B00,897209,Fargason; Sharon Gayle,44,0,45,1
1745786812290,EDS 201,A00,895545,Staff,43,0,45,2
1745786813316,EDS 203,A01,895581,Halter; Christopher P.,43,0,45,2
1745786814345,EDS 204R,A01,895625,Heinzman; Erica M.,44,0,45,1
1745786814345,EDS 204R,B01,895693,Halter; Christopher P.,18,0,45,27
1745786815375,EDS 206R,A00,895694,Fargason; Sharon Gayle,9,0,30,21
1745786815375,EDS 206R,B00,895695,Choi; Bailey Miyeon,20,0,30,10
1745786816400,EDS 250,A00,895697,Hemans; Patricia Ann Benitez,43,0,45,2
1745786817425,EDS 281,A00,895701,Meyerott; Theresa Ann,15,0,15,0
1745786818451,EDS 284,A00,895736,Meyerott; Theresa Ann,15,0,15,0
1745786819478,EDS 286,A00,897210,Fine; Sarah,15,0,15,0
1745786820504,EDS 289C,A01,895770,Daly; Alan J.,15,0,15,0
1745786821531,EDS 290,A00,897211,Hofstetter; Carolyn,15,0,15,0
1745786822561,LIGM 5A,A00,896162,Fischer-Grunski; Eva K,15,0,20,5
1745786823590,LIGM 5B,A00,896260,Fischer-Grunski; Eva K,17,0,20,3
1745786824620,LIGM 5C,A00,896308,Fischer-Grunski; Eva K,18,0,20,2
1745786825647,LIIT 5AS,A00,896313,Carnelos; Chiara,18,0,20,2
1745786826676,LIIT 5BS,A00,896416,Carnelos; Chiara,20,0,20,0
1745786827703,LIIT 5CS,A00,896564,Carnelos; Chiara,20,0,20,0
1745786828731,LISP 5A,A00,896588,Munoz Sanchez; Alicia,4,0,20,16
1745786829756,LISP 5B,A00,896653,Munoz Sanchez; Alicia,10,0,20,10
1745786830782,LISP 5C,A00,896655,Munoz Sanchez; Alicia,4,0,20,16
1745786831808,MAE 197,001,957918,Kleissl; Jan,9998,0,9999,1
1745786832834,MATH 2,A01,957937,Staff,34,0,35,1
1745786833859,MATH 197,001,957876,Kedlaya; Kiran S.,9993,0,9999,6
1745786834883,MCWP 40,A00,892729,Duru; Nur,13,0,20,7
1745786834883,MCWP 40,B00,893304,Montejo; Carolina,20,0,20,0
1745786835910,MCWP 40R,A00,893757,Redela; Pamela Morgan,0,6,20,20
1745786836937,MCWP 50,A00,893758,Morshed; Michael James,2,0,20,18
1745786836937,MCWP 50,B00,893761,Bartulis; Jason Michael,17,0,20,3
1745786837967,MCWP 50R,A00,893766,Compas; Sean Matthew,0,1,20,20
1745786837967,MCWP 50R,B00,893769,Carter; Jennifer A,0,0,20,20
1745786837967,MCWP 50R,C00,893771,Krone; Jarret,0,3,20,20
1745786837967,MCWP 50R,D00,893772,Miller; Elizabeth Deen,3,0,20,17
1745786837967,MCWP 50R,E00,893775,Carter; Andrea L,0,0,20,20
1745786838993,MMW 11R,A01,892721,Herbst; Matthew,11,0,27,16
1745786838993,MMW 11R,A02,892722,Herbst; Matthew,0,0,0,3
1745786840020,MMW 12R,A01,892724,Herbst; Matthew,0,9,16,16
1745786840020,MMW 12R,A02,892725,Herbst; Matthew,0,9,16,16
1745786841049,MMW 13R,A01,892727,Staff,0,3,16,16
1745786841049,MMW 13R,A02,892728,Staff,0,4,16,16
1745786841049,MMW 13R,A03,958032,Staff,0,3,16,16
1745786841049,MMW 13R,A04,958033,Staff,0,2,16,16
1745786841049,MMW 13R,A05,958034,Staff,0,3,16,16
1745786842075,SIO 295LS,A00,894015,Staff,7,0,25,18
1745786843105,SIO 295S,A00,894020,Staff,7,0,25,18
1745786844133,SIOC 290S,B01,958918,Staff,0,0,0,0
1745786845158,SIOC 291S,B01,958922,Staff,0,0,0,0
1745786846187,SOCI 117,A01,895339,Staff,4,0,5,1
1745786847214,WES 237B,A00,894149,Staff,11,0,20,9
1745786849280,AESE 279B,A00,891859,Staff,13,0,35,22
1745786850306,AIP 197,001,891854,Staff,70,0,70,0
1745786851336,ANTH 289S,A00,891856,Gagneux; Pascal,12,0,12,0
1745786852362,BENG 196,001,957946,Engler; Adam J.,9996,0,9999,3
1745786853388,CAT 124RS,A01,956906,Staff,8,0,25,17
1745786854417,CAT 125RS,A01,922013,Staff,8,0,25,17
1745786855443,CLRE 250,A00,891860,Morris; Sheldon,9995,0,9999,4
1745786857494,CLRE 251R,A00,907817,Mehta; Ravindra L.,9994,0,9999,5
1745786858523,CLRE 252,A00,891864,Cuomo; Raphael Eduardo,9993,0,9999,6
1745786859547,CLRE 253,A00,891867,Vaida; Florin,9994,0,9999,5
1745786859547,CLRE 253,B00,907819,Staff,9999,0,9999,0
1745786860572,CLRE 259,A00,891868,Patel; Hemal,9998,0,9999,1
1745786861599,CLRE 260,A00,891872,Cuomo; Raphael Eduardo,9999,0,9999,0
1745786862627,CLRE 297,001,891888,Cuomo; Raphael Eduardo,9999,0,9999,0
1745786863653,CSE 191,A00,958773,Minnes Kemp; Mor Mia,9999,0,9999,0
1745786864681,CSS 201S,A01,892054,Mignozzetti; Umberto,30,0,30,0
1745786865708,CSS 202S,A01,892056,Mignozzetti; Umberto,30,0,30,0
1745786866733,DSC 197,001,956898,Eldridge; Justin Matthew,9998,0,9999,1
1745786867758,DSC 297,001,958000,Mazumdar; Arya,9998,0,9999,1
1745786868785,EAP 100,A00,905686,Staff,9776,0,9999,223
1745786869811,ECE 45,A01,892618,Staff,0,12,50,50
1745786870838,ECE 109,A01,892620,Staff,0,43,0,0
1745786871865,ECE 111,A01,892719,Staff,0,7,50,50
1745786872891,ECE 197,001,957920,Mercier; Patrick Philip,9992,0,9999,7
1745786873918,ECON 178,A01,907814,Zhu; Ying,28,0,35,7
1745786874943,EDS 115,A00,895312,Staff,41,0,45,4
1745786875969,EDS 117,A01,895337,Staff,30,0,30,0
1745786876998,EDS 125,A00,895341,Jones; Gabrielle Anastasia,43,0,45,2
1745786878024,EDS 128A,A01,895459,Fargason; Sharon Gayle,44,0,45,1
1745786879053,EDS 128B,A01,895543,Pappas; Elizabeth,44,0,45,1
1745786880081,EDS 139,A00,897203,Pappas; Elizabeth,44,0,45,1
1745786880081,EDS 139,B00,897209,Fargason; Sharon Gayle,44,0,45,1
1745786881109,EDS 201,A00,895545,Staff,43,0,45,2
1745786882137,EDS 203,A01,895581,Halter; Christopher P.,43,0,45,2
1745786883163,EDS 204R,A01,895625,Heinzman; Erica M.,44,0,45,1
1745786883163,EDS 204R,B01,895693,Halter; Christopher P.,18,0,45,27
1745786884193,EDS 206R,A00,895694,Fargason; Sharon Gayle,9,0,30,21
1745786884193,EDS 206R,B00,895695,Choi; Bailey Miyeon,20,0,30,10
1745786885224,EDS 250,A00,895697,Hemans; Patricia Ann Benitez,43,0,45,2
1745786886250,EDS 281,A00,895701,Meyerott; Theresa Ann,15,0,15,0
1745786887279,EDS 284,A00,895736,Meyerott; Theresa Ann,15,0,15,0
1745786888303,EDS 286,A00,897210,Fine; Sarah,15,0,15,0
1745786889329,EDS 289C,A01,895770,Daly; Alan J.,15,0,15,0
1745786890355,EDS 290,A00,897211,Hofstetter; Carolyn,15,0,15,0
1745786891420,LIGM 5A,A00,896162,Fischer-Grunski; Eva K,15,0,20,5
1745786892448,LIGM 5B,A00,896260,Fischer-Grunski; Eva K,17,0,20,3
1745786893472,LIGM 5C,A00,896308,Fischer-Grunski; Eva K,18,0,20,2
1745786894499,LIIT 5AS,A00,896313,Carnelos; Chiara,18,0,20,2
1745786895525,LIIT 5BS,A00,896416,Carnelos; Chiara,20,0,20,0
1745786896554,LIIT 5CS,A00,896564,Carnelos; Chiara,20,0,20,0
1745786897582,LISP 5A,A00,896588,Munoz Sanchez; Alicia,4,0,20,16
1745786898607,LISP 5B,A00,896653,Munoz Sanchez; Alicia,10,0,20,10
1745786899632,LISP 5C,A00,896655,Munoz Sanchez; Alicia,4,0,20,16
1745786900659,MAE 197,001,957918,Kleissl; Jan,9998,0,9999,1
1745786901688,MATH 2,A01,957937,Staff,34,0,35,1
1745786902713,MATH 197,001,957876,Kedlaya; Kiran S.,9993,0,9999,6
1745786903740,MCWP 40,A00,892729,Duru; Nur,13,0,20,7
1745786903740,MCWP 40,B00,893304,Montejo; Carolina,20,0,20,0
1745786904768,MCWP 40R,A00,893757,Redela; Pamela Morgan,0,6,20,20
1745786905796,MCWP 50,A00,893758,Morshed; Michael James,2,0,20,18
1745786905796,MCWP 50,B00,893761,Bartulis; Jason Michael,17,0,20,3
1745786906821,MCWP 50R,A00,893766,Compas; Sean Matthew,0,1,20,20
1745786906821,MCWP 50R,B00,893769,Carter; Jennifer A,0,0,20,20
1745786906821,MCWP 50R,C00,893771,Krone; Jarret,0,3,20,20
1745786906821,MCWP 50R,D00,893772,Miller; Elizabeth Deen,3,0,20,17
1745786906821,MCWP 50R,E00,893775,Carter; Andrea L,0,0,20,20
1745786907849,MMW 11R,A01,892721,Herbst; Matthew,11,0,27,16
1745786907849,MMW 11R,A02,892722,Herbst; Matthew,0,0,0,3
1745786908874,MMW 12R,A01,892724,Herbst; Matthew,0,9,16,16
1745786908874,MMW 12R,A02,892725,Herbst; Matthew,0,9,16,16
1745786909902,MMW 13R,A01,892727,Staff,0,3,16,16
1745786909902,MMW 13R,A02,892728,Staff,0,4,16,16
1745786909902,MMW 13R,A03,958032,Staff,0,3,16,16
1745786909902,MMW 13R,A04,958033,Staff,0,2,16,16
1745786909902,MMW 13R,A05,958034,Staff,0,3,16,16
1745786910930,SIO 295LS,A00,894015,Staff,7,0,25,18
1745786911959,SIO 295S,A00,894020,Staff,7,0,25,18
1745786912989,SIOC 290S,B01,958918,Staff,0,0,0,0
1745786914021,SIOC 291S,B01,958922,Staff,0,0,0,0
1745786915048,SOCI 117,A01,895339,Staff,4,0,5,1
1745786916073,WES 237B,A00,894149,Staff,11,0,20,9
1745786918130,AESE 279B,A00,891859,Staff,13,0,35,22
1745786919156,AIP 197,001,891854,Staff,70,0,70,0
1745786920186,ANTH 289S,A00,891856,Gagneux; Pascal,12,0,12,0
1745786921212,BENG 196,001,957946,Engler; Adam J.,9996,0,9999,3
1745786922239,CAT 124RS,A01,956906,Staff,8,0,25,17
1745786923267,CAT 125RS,A01,922013,Staff,8,0,25,17
1745786924293,CLRE 250,A00,891860,Morris; Sheldon,9995,0,9999,4
1745786926349,CLRE 251R,A00,907817,Mehta; Ravindra L.,9994,0,9999,5
1745786927377,CLRE 252,A00,891864,Cuomo; Raphael Eduardo,9993,0,9999,6
1745786928404,CLRE 253,A00,891867,Vaida; Florin,9994,0,9999,5
1745786928404,CLRE 253,B00,907819,Staff,9999,0,9999,0
1745786929432,CLRE 259,A00,891868,Patel; Hemal,9998,0,9999,1
1745786930472,CLRE 260,A00,891872,Cuomo; Raphael Eduardo,9999,0,9999,0
1745786931498,CLRE 297,001,891888,Cuomo; Raphael Eduardo,9999,0,9999,0
1745786932526,CSE 191,A00,958773,Minnes Kemp; Mor Mia,9999,0,9999,0
1745786933553,CSS 201S,A01,892054,Mignozzetti; Umberto,30,0,30,0
1745786934580,CSS 202S,A01,892056,Mignozzetti; Umberto,30,0,30,0
1745786935607,DSC 197,001,956898,Eldridge; Justin Matthew,9998,0,9999,1
1745786936632,DSC 297,001,958000,Mazumdar; Arya,9998,0,9999,1
1745786937659,EAP 100,A00,905686,Staff,9776,0,9999,223
1745786938686,ECE 45,A01,892618,Staff,0,12,50,50
1745786939713,ECE 109,A01,892620,Staff,0,43,0,0
1745786940740,ECE 111,A01,892719,Staff,0,7,50,50
1745786941765,ECE 197,001,957920,Mercier; Patrick Philip,9992,0,9999,7
1745786942793,ECON 178,A01,907814,Zhu; Ying,28,0,35,7
1745786943818,EDS 115,A00,895312,Staff,41,0,45,4
1745786944847,EDS 117,A01,895337,Staff,30,0,30,0
1745786945873,EDS 125,A00,895341,Jones; Gabrielle Anastasia,43,0,45,2
1745786946903,EDS 128A,A01,895459,Fargason; Sharon Gayle,44,0,45,1
1745786947928,EDS 128B,A01,895543,Pappas; Elizabeth,44,0,45,1
1745786948955,EDS 139,A00,897203,Pappas; Elizabeth,44,0,45,1
1745786948955,EDS 139,B00,897209,Fargason; Sharon Gayle,44,0,45,1
1745786949983,EDS 201,A00,895545,Staff,43,0,45,2
1745786951012,EDS 203,A01,895581,Halter; Christopher P.,43,0,45,2
1745786952038,EDS 204R,A01,895625,Heinzman; Erica M.,44,0,45,1
1745786952038,EDS 204R,B01,895693,Halter; Christopher P.,18,0,45,27
1745786953065,EDS 206R,A00,895694,Fargason; Sharon Gayle,9,0,30,21
1745786953065,EDS 206R,B00,895695,Choi; Bailey Miyeon,20,0,30,10
1745786954093,EDS 250,A00,895697,Hemans; Patricia Ann Benitez,43,0,45,2
1745786955123,EDS 281,A00,895701,Meyerott; Theresa Ann,15,0,15,0
1745786956152,EDS 284,A00,895736,Meyerott; Theresa Ann,15,0,15,0
1745786957180,EDS 286,A00,897210,Fine; Sarah,15,0,15,0
1745786958206,EDS 289C,A01,895770,Daly; Alan J.,15,0,15,0
1745786959242,EDS 290,A00,897211,Hofstetter; Carolyn,15,0,15,0
1745786960269,LIGM 5A,A00,896162,Fischer-Grunski; Eva K,15,0,20,5
1745786961293,LIGM 5B,A00,896260,Fischer-Grunski; Eva K,17,0,20,3
1745786962317,LIGM 5C,A00,896308,Fischer-Grunski; Eva K,18,0,20,2
1745786963346,LIIT 5AS,A00,896313,Carnelos; Chiara,18,0,20,2
1745786964373,LIIT 5BS,A00,896416,Carnelos; Chiara,20,0,20,0
1745786965403,LIIT 5CS,A00,896564,Carnelos; Chiara,20,0,20,0
1745786966430,LISP 5A,A00,896588,Munoz Sanchez; Alicia,4,0,20,16
1745786967460,LISP 5B,A00,896653,Munoz Sanchez; Alicia,10,0,20,10
1745786968485,LISP 5C,A00,896655,Munoz Sanchez; Alicia,4,0,20,16
1745786969514,MAE 197,001,957918,Kleissl; Jan,9998,0,9999,1
1745786970540,MATH 2,A01,957937,Staff,34,0,35,1
1745786971564,MATH 197,001,957876,Kedlaya; Kiran S.,9993,0,9999,6
1745786972593,MCWP 40,A00,892729,Duru; Nur,13,0,20,7
1745786972593,MCWP 40,B00,893304,Montejo; Carolina,20,0,20,0
1745786973622,MCWP 40R,A00,893757,Redela; Pamela Morgan,0,6,20,20
1745786974650,MCWP 50,A00,893758,Morshed; Michael James,2,0,20,18
1745786974650,MCWP 50,B00,893761,Bartulis; Jason Michael,17,0,20,3
1745786975681,MCWP 50R,A00,893766,Compas; Sean Matthew,0,1,20,20
1745786975681,MCWP 50R,B00,893769,Carter; Jennifer A,0,0,20,20
1745786975681,MCWP 50R,C00,893771,Krone; Jarret,0,3,20,20
1745786975681,MCWP 50R,D00,893772,Miller; Elizabeth Deen,3,0,20,17
1745786975681,MCWP 50R,E00,893775,Carter; Andrea L,0,0,20,20
1745786976709,MMW 11R,A01,892721,Herbst; Matthew,11,0,27,16
1745786976709,MMW 11R,A02,892722,Herbst; Matthew,0,0,0,3
1745786977737,MMW 12R,A01,892724,Herbst; Matthew,0,9,16,16
1745786977737,MMW 12R,A02,892725,Herbst; Matthew,0,9,16,16
1745786978765,MMW 13R,A01,892727,Staff,0,3,16,16
1745786978765,MMW 13R,A02,892728,Staff,0,4,16,16
1745786978765,MMW 13R,A03,958032,Staff,0,3,16,16
1745786978765,MMW 13R,A04,958033,Staff,0,2,16,16
1745786978765,MMW 13R,A05,958034,Staff,0,3,16,16
1745786979791,SIO 295LS,A00,894015,Staff,7,0,25,18
1745786980815,SIO 295S,A00,894020,Staff,7,0,25,18
1745786981841,SIOC 290S,B01,958918,Staff,0,0,0,0
1745786982874,SIOC 291S,B01,958922,Staff,0,0,0,0
1745786983904,SOCI 117,A01,895339,Staff,4,0,5,1
1745786984931,WES 237B,A00,894149,Staff,11,0,20,9
1745786986998,AESE 279B,A00,891859,Staff,13,0,35,22
1745786988024,AIP 197,001,891854,Staff,70,0,70,0
1745786989050,ANTH 289S,A00,891856,Gagneux; Pascal,12,0,12,0
1745786990076,BENG 196,001,957946,Engler; Adam J.,9996,0,9999,3
1745786991102,CAT 124RS,A01,956906,Staff,8,0,25,17
1745786992130,CAT 125RS,A01,922013,Staff,8,0,25,17
1745786993157,CLRE 250,A00,891860,Morris; Sheldon,9995,0,9999,4
1745786995213,CLRE 251R,A00,907817,Mehta; Ravindra L.,9994,0,9999,5
1745786996242,CLRE 252,A00,891864,Cuomo; Raphael Eduardo,9993,0,9999,6
1745786997267,CLRE 253,A00,891867,Vaida; Florin,9994,0,9999,5
1745786997267,CLRE 253,B00,907819,Staff,9999,0,9999,0
1745786998296,CLRE 259,A00,891868,Patel; Hemal,9998,0,9999,1
1745786999324,CLRE 260,A00,891872,Cuomo; Raphael Eduardo,9999,0,9999,0
1745787000352,CLRE 297,001,891888,Cuomo; Raphael Eduardo,9999,0,9999,0
1745787001381,CSE 191,A00,958773,Minnes Kemp; Mor Mia,9999,0,9999,0
1745787002412,CSS 201S,A01,892054,Mignozzetti; Umberto,30,0,30,0
1745787003438,CSS 202S,A01,892056,Mignozzetti; Umberto,30,0,30,0
1745787004463,DSC 197,001,956898,Eldridge; Justin Matthew,9998,0,9999,1
1745787005493,DSC 297,001,958000,Mazumdar; Arya,9998,0,9999,1
1745787006519,EAP 100,A00,905686,Staff,9776,0,9999,223
1745787007546,ECE 45,A01,892618,Staff,0,12,50,50
1745787008572,ECE 109,A01,892620,Staff,0,43,0,0
1745787009599,ECE 111,A01,892719,Staff,0,7,50,50
1745787010625,ECE 197,001,957920,Mercier; Patrick Philip,9992,0,9999,7
1745787011651,ECON 178,A01,907814,Zhu; Ying,28,0,35,7
1745787012677,EDS 115,A00,895312,Staff,41,0,45,4
1745787013703,EDS 117,A01,895337,Staff,30,0,30,0
1745787014734,EDS 125,A00,895341,Jones; Gabrielle Anastasia,43,0,45,2
1745787015759,EDS 128A,A01,895459,Fargason; Sharon Gayle,44,0,45,1
1745787016788,EDS 128B,A01,895543,Pappas; Elizabeth,44,0,45,1
1745787017816,EDS 139,A00,897203,Pappas; Elizabeth,44,0,45,1
1745787017816,EDS 139,B00,897209,Fargason; Sharon Gayle,44,0,45,1
1745787018844,EDS 201,A00,895545,Staff,43,0,45,2
1745787019869,EDS 203,A01,895581,Halter; Christopher P.,43,0,45,2
1745787020897,EDS 204R,A01,895625,Heinzman; Erica M.,44,0,45,1
1745787020897,EDS 204R,B01,895693,Halter; Christopher P.,18,0,45,27
1745787021926,EDS 206R,A00,895694,Fargason; Sharon Gayle,9,0,30,21
1745787021926,EDS 206R,B00,895695,Choi; Bailey Miyeon,20,0,30,10
1745787022953,EDS 250,A00,895697,Hemans; Patricia Ann Benitez,43,0,45,2
1745787023980,EDS 281,A00,895701,Meyerott; Theresa Ann,15,0,15,0
1745787025009,EDS 284,A00,895736,Meyerott; Theresa Ann,15,0,15,0
1745787026035,EDS 286,A00,897210,Fine; Sarah,15,0,15,0
1745787027063,EDS 289C,A01,895770,Daly; Alan J.,15,0,15,0
1745787028090,EDS 290,A00,897211,Hofstetter; Carolyn,15,0,15,0
1745787029118,LIGM 5A,A00,896162,Fischer-Grunski; Eva K,15,0,20,5
1745787030148,LIGM 5B,A00,896260,Fischer-Grunski; Eva K,17,0,20,3
1745787031177,LIGM 5C,A00,896308,Fischer-Grunski; Eva K,18,0,20,2
1745787032203,LIIT 5AS,A00,896313,Carnelos; Chiara,18,0,20,2
1745787033230,LIIT 5BS,A00,896416,Carnelos; Chiara,20,0,20,0
1745787034259,LIIT 5CS,A00,896564,Carnelos; Chiara,20,0,20,0
1745787035287,LISP 5A,A00,896588,Munoz Sanchez; Alicia,4,0,20,16
1745787036313,LISP 5B,A00,896653,Munoz Sanchez; Alicia,10,0,20,10
1745787037339,LISP 5C,A00,896655,Munoz Sanchez; Alicia,4,0,20,16
1745787038370,MAE 197,001,957918,Kleissl; Jan,9998,0,9999,1
1745787039397,MATH 2,A01,957937,Staff,34,0,35,1
1745787040421,MATH 197,001,957876,Kedlaya; Kiran S.,9993,0,9999,6
1745787041447,MCWP 40,A00,892729,Duru; Nur,13,0,20,7
1745787041447,MCWP 40,B00,893304,Montejo; Carolina,20,0,20,0
1745787042472,MCWP 40R,A00,893757,Redela; Pamela Morgan,0,6,20,20
1745787043499,MCWP 50,A00,893758,Morshed; Michael James,2,0,20,18
1745787043499,MCWP 50,B00,893761,Bartulis; Jason Michael,17,0,20,3
1745787044529,MCWP 50R,A00,893766,Compas; Sean Matthew,0,1,20,20
1745787044529,MCWP 50R,B00,893769,Carter; Jennifer A,0,0,20,20
1745787044529,MCWP 50R,C00,893771,Krone; Jarret,0,3,20,20
1745787044529,MCWP 50R,D00,893772,Miller; Elizabeth Deen,3,0,20,17
1745787044529,MCWP 50R,E00,893775,Carter; Andrea L,0,0,20,20
1745787045556,MMW 11R,A01,892721,Herbst; Matthew,11,0,27,16
1745787045556,MMW 11R,A02,892722,Herbst; Matthew,0,0,0,3
1745787046584,MMW 12R,A01,892724,Herbst; Matthew,0,9,16,16
1745787046584,MMW 12R,A02,892725,Herbst; Matthew,0,9,16,16
1745787047612,MMW 13R,A01,892727,Staff,0,3,16,16
1745787047612,MMW 13R,A02,892728,Staff,0,4,16,16
1745787047612,MMW 13R,A03,958032,Staff,0,3,16,16
1745787047612,MMW 13R,A04,958033,Staff,0,2,16,16
1745787047612,MMW 13R,A05,958034,Staff,0,3,16,16
1745787048640,SIO 295LS,A00,894015,Staff,7,0,25,18
1745787049667,SIO 295S,A00,894020,Staff,7,0,25,18
1745787050693,SIOC 290S,B01,958918,Staff,0,0,0,0
1745787051723,SIOC 291S,B01,958922,Staff,0,0,0,0
1745787052748,SOCI 117,A01,895339,Staff,4,0,5,1
1745787053774,WES 237B,A00,894149,Staff,11,0,20,9
1745787055841,AESE 279B,A00,891859,Staff,13,0,35,22
1745787056868,AIP 197,001,891854,Staff,70,0,70,0
1745787057895,ANTH 289S,A00,891856,Gagneux; Pascal,12,0,12,0
1745787058923,BENG 196,001,957946,Engler; Adam J.,9996,0,9999,3
1745787059948,CAT 124RS,A01,956906,Staff,8,0,25,17
1745787060974,CAT 125RS,A01,922013,Staff,8,0,25,17
1745787062000,CLRE 250,A00,891860,Morris; Sheldon,9995,0,9999,4
1745787064057,CLRE 251R,A00,907817,Mehta; Ravindra L.,9994,0,9999,5
1745787065083,CLRE 252,A00,891864,Cuomo; Raphael Eduardo,9993,0,9999,6
1745787066111,CLRE 253,A00,891867,Vaida; Florin,9994,0,9999,5
1745787066111,CLRE 253,B00,907819,Staff,9999,0,9999,0
1745787067136,CLRE 259,A00,891868,Patel; Hemal,9998,0,9999,1
1745787068162,CLRE 260,A00,891872,Cuomo; Raphael Eduardo,9999,0,9999,0
1745787069188,CLRE 297,001,891888,Cuomo; Raphael Eduardo,9999,0,9999,0
1745787070213,CSE 191,A00,958773,Minnes Kemp; Mor Mia,9999,0,9999,0
1745787071239,CSS 201S,A01,892054,Mignozzetti; Umberto,30,0,30,0
1745787072266,CSS 202S,A01,892056,Mignozzetti; Umberto,30,0,30,0
1745787073291,DSC 197,001,956898,Eldridge; Justin Matthew,9998,0,9999,1
1745787074319,DSC 297,001,958000,Mazumdar; Arya,9998,0,9999,1
1745787075346,EAP 100,A00,905686,Staff,9776,0,9999,223
1745787076373,ECE 45,A01,892618,Staff,0,12,50,50
1745787077399,ECE 109,A01,892620,Staff,0,43,0,0
1745787078428,ECE 111,A01,892719,Staff,0,7,50,50
1745787079454,ECE 197,001,957920,Mercier; Patrick Philip,9992,0,9999,7
1745787080481,ECON 178,A01,907814,Zhu; Ying,28,0,35,7
1745787081509,EDS 115,A00,895312,Staff,41,0,45,4
1745787082536,EDS 117,A01,895337,Staff,30,0,30,0
1745787083564,EDS 125,A00,895341,Jones; Gabrielle Anastasia,43,0,45,2
1745787084590,EDS 128A,A01,895459,Fargason; Sharon Gayle,44,0,45,1
1745787085618,EDS 128B,A01,895543,Pappas; Elizabeth,44,0,45,1
1745787086646,EDS 139,A00,897203,Pappas; Elizabeth,44,0,45,1
1745787086646,EDS 139,B00,897209,Fargason; Sharon Gayle,44,0,45,1
1745787087672,EDS 201,A00,895545,Staff,43,0,45,2
1745787088696,EDS 203,A01,895581,Halter; Christopher P.,43,0,45,2
1745787089726,EDS 204R,A01,895625,Heinzman; Erica M.,44,0,45,1
1745787089726,EDS 204R,B01,895693,Halter; Christopher P.,18,0,45,27
1745787090753,EDS 206R,A00,895694,Fargason; Sharon Gayle,9,0,30,21
1745787090753,EDS 206R,B00,895695,Choi; Bailey Miyeon,20,0,30,10
1745787091779,EDS 250,A00,895697,Hemans; Patricia Ann Benitez,43,0,45,2
1745787092802,EDS 281,A00,895701,Meyerott; Theresa Ann,15,0,15,0
1745787093831,EDS 284,A00,895736,Meyerott; Theresa Ann,15,0,15,0
1745787094856,EDS 286,A00,897210,Fine; Sarah,15,0,15,0
1745787095882,EDS 289C,A01,895770,Daly; Alan J.,15,0,15,0
1745787096907,EDS 290,A00,897211,Hofstetter; Carolyn,15,0,15,0
1745787097935,LIGM 5A,A00,896162,Fischer-Grunski; Eva K,15,0,20,5
1745787098962,LIGM 5B,A00,896260,Fischer-Grunski; Eva K,17,0,20,3
1745787099989,LIGM 5C,A00,896308,Fischer-Grunski; Eva K,18,0,20,2
1745787101017,LIIT 5AS,A00,896313,Carnelos; Chiara,18,0,20,2
1745787102043,LIIT 5BS,A00,896416,Carnelos; Chiara,20,0,20,0
1745787103073,LIIT 5CS,A00,896564,Carnelos; Chiara,20,0,20,0
1745787104099,LISP 5A,A00,896588,Munoz Sanchez; Alicia,4,0,20,16
1745787105123,LISP 5B,A00,896653,Munoz Sanchez; Alicia,10,0,20,10
1745787106154,LISP 5C,A00,896655,Munoz Sanchez; Alicia,4,0,20,16
1745787107180,MAE 197,001,957918,Kleissl; Jan,9998,0,9999,1
1745787108208,MATH 2,A01,957937,Staff,34,0,35,1
1745787109233,MATH 197,001,957876,Kedlaya; Kiran S.,9993,0,9999,6
1745787110258,MCWP 40,A00,892729,Duru; Nur,13,0,20,7
1745787110258,MCWP 40,B00,893304,Montejo; Carolina,20,0,20,0
1745787111288,MCWP 40R,A00,893757,Redela; Pamela Morgan,0,6,20,20
1745787112313,MCWP 50,A00,893758,Morshed; Michael James,2,0,20,18
1745787112313,MCWP 50,B00,893761,Bartulis; Jason Michael,17,0,20,3
1745787113341,MCWP 50R,A00,893766,Compas; Sean Matthew,0,1,20,20
1745787113341,MCWP 50R,B00,893769,Carter; Jennifer A,0,0,20,20
1745787113341,MCWP 50R,C00,893771,Krone; Jarret,0,3,20,20
1745787113341,MCWP 50R,D00,893772,Miller; Elizabeth Deen,3,0,20,17
1745787113341,MCWP 50R,E00,893775,Carter; Andrea L,0,0,20,20
1745787114370,MMW 11R,A01,892721,Herbst; Matthew,11,0,27,16
1745787114370,MMW 11R,A02,892722,Herbst; Matthew,0,0,0,3
1745787115395,MMW 12R,A01,892724,Herbst; Matthew,0,9,16,16
1745787115395,MMW 12R,A02,892725,Herbst; Matthew,0,9,16,16
1745787116425,MMW 13R,A01,892727,Staff,0,3,16,16
1745787116425,MMW 13R,A02,892728,Staff,0,4,16,16
1745787116425,MMW 13R,A03,958032,Staff,0,3,16,16
1745787116425,MMW 13R,A04,958033,Staff,0,2,16,16
1745787116425,MMW 13R,A05,958034,Staff,0,3,16,16
1745787117453,SIO 295LS,A00,894015,Staff,7,0,25,18
1745787118477,SIO 295S,A00,894020,Staff,7,0,25,18
1745787119508,SIOC 290S,B01,958918,Staff,0,0,0,0
1745787120534,SIOC 291S,B01,958922,Staff,0,0,0,0
1745787121564,SOCI 117,A01,895339,Staff,4,0,5,1
1745787122593,WES 237B,A00,894149,Staff,11,0,20,9
1745787124649,AESE 279B,A00,891859,Staff,13,0,35,22
1745787125676,AIP 197,001,891854,Staff,70,0,70,0
1745787126701,ANTH 289S,A00,891856,Gagneux; Pascal,12,0,12,0
1745787127727,BENG 196,001,957946,Engler; Adam J.,9996,0,9999,3
1745787128752,CAT 124RS,A01,956906,Staff,8,0,25,17
1745787129777,CAT 125RS,A01,922013,Staff,8,0,25,17
1745787130800,CLRE 250,A00,891860,Morris; Sheldon,9995,0,9999,4
1745787132858,CLRE 251R,A00,907817,Mehta; Ravindra L.,9994,0,9999,5
1745787133884,CLRE 252,A00,891864,Cuomo; Raphael Eduardo,9993,0,9999,6
1745787134910,CLRE 253,A00,891867,Vaida; Florin,9994,0,9999,5
1745787134910,CLRE 253,B00,907819,Staff,9999,0,9999,0
1745787135938,CLRE 259,A00,891868,Patel; Hemal,9998,0,9999,1
1745787136963,CLRE 260,A00,891872,Cuomo; Raphael Eduardo,9999,0,9999,0
1745787137992,CLRE 297,001,891888,Cuomo; Raphael Eduardo,9999,0,9999,0
1745787139018,CSE 191,A00,958773,Minnes Kemp; Mor Mia,9999,0,9999,0
1745787140046,CSS 201S,A01,892054,Mignozzetti; Umberto,30,0,30,0
1745787141073,CSS 202S,A01,892056,Mignozzetti; Umberto,30,0,30,0
1745787142099,DSC 197,001,956898,Eldridge; Justin Matthew,9998,0,9999,1
1745787143124,DSC 297,001,958000,Mazumdar; Arya,9998,0,9999,1
1745787144154,EAP 100,A00,905686,Staff,9776,0,9999,223
1745787145184,ECE 45,A01,892618,Staff,0,12,50,50
1745787146212,ECE 109,A01,892620,Staff,0,43,0,0
1745787147237,ECE 111,A01,892719,Staff,0,7,50,50
1745787148264,ECE 197,001,957920,Mercier; Patrick Philip,9992,0,9999,7
1745787149292,ECON 178,A01,907814,Zhu; Ying,28,0,35,7
1745787150319,EDS 115,A00,895312,Staff,41,0,45,4
1745787151347,EDS 117,A01,895337,Staff,30,0,30,0
1745787152381,EDS 125,A00,895341,Jones; Gabrielle Anastasia,43,0,45,2
1745787153407,EDS 128A,A01,895459,Fargason; Sharon Gayle,44,0,45,1
1745787154435,EDS 128B,A01,895543,Pappas; Elizabeth,44,0,45,1
1745787155460,EDS 139,A00,897203,Pappas; Elizabeth,44,0,45,1
1745787155460,EDS 139,B00,897209,Fargason; Sharon Gayle,44,0,45,1
1745787156489,EDS 201,A00,895545,Staff,43,0,45,2
1745787157515,EDS 203,A01,895581,Halter; Christopher P.,43,0,45,2
1745787158540,EDS 204R,A01,895625,Heinzman; Erica M.,44,0,45,1
1745787158540,EDS 204R,B01,895693,Halter; Christopher P.,18,0,45,27
1745787159569,EDS 206R,A00,895694,Fargason; Sharon Gayle,9,0,30,21
1745787159569,EDS 206R,B00,895695,Choi; Bailey Miyeon,20,0,30,10
1745787160594,EDS 250,A00,895697,Hemans; Patricia Ann Benitez,43,0,45,2
1745787161621,EDS 281,A00,895701,Meyerott; Theresa Ann,15,0,15,0
1745787162651,EDS 284,A00,895736,Meyerott; Theresa Ann,15,0,15,0
1745787163675,EDS 286,A00,897210,Fine; Sarah,15,0,15,0
1745787164700,EDS 289C,A01,895770,Daly; Alan J.,15,0,15,0
1745787165727,EDS 290,A00,897211,Hofstetter; Carolyn,15,0,15,0
1745787166752,LIGM 5A,A00,896162,Fischer-Grunski; Eva K,15,0,20,5
1745787167776,LIGM 5B,A00,896260,Fischer-Grunski; Eva K,17,0,20,3
1745787168802,LIGM 5C,A00,896308,Fischer-Grunski; Eva K,18,0,20,2
1745787169831,LIIT 5AS,A00,896313,Carnelos; Chiara,18,0,20,2
1745787170857,LIIT 5BS,A00,896416,Carnelos; Chiara,20,0,20,0
1745787171884,LIIT 5CS,A00,896564,Carnelos; Chiara,20,0,20,0
1745787172911,LISP 5A,A00,896588,Munoz Sanchez; Alicia,4,0,20,16
1745787173937,LISP 5B,A00,896653,Munoz Sanchez; Alicia,10,0,20,10
1745787174965,LISP 5C,A00,896655,Munoz Sanchez; Alicia,4,0,20,16
1745787175989,MAE 197,001,957918,Kleissl; Jan,9998,0,9999,1
1745787177017,MATH 2,A01,957937,Staff,34,0,35,1
1745787178045,MATH 197,001,957876,Kedlaya; Kiran S.,9993,0,9999,6
1745787179074,MCWP 40,A00,892729,Duru; Nur,13,0,20,7
1745787179074,MCWP 40,B00,893304,Montejo; Carolina,20,0,20,0
1745787180100,MCWP 40R,A00,893757,Redela; Pamela Morgan,0,6,20,20
1745787181128,MCWP 50,A00,893758,Morshed; Michael James,2,0,20,18
1745787181128,MCWP 50,B00,893761,Bartulis; Jason Michael,17,0,20,3
1745787182156,MCWP 50R,A00,893766,Compas; Sean Matthew,0,1,20,20
1745787182156,MCWP 50R,B00,893769,Carter; Jennifer A,0,0,20,20
1745787182156,MCWP 50R,C00,893771,Krone; Jarret,0,3,20,20
1745787182156,MCWP 50R,D00,893772,Miller; Elizabeth Deen,3,0,20,17
1745787182156,MCWP 50R,E00,893775,Carter; Andrea L,0,0,20,20
1745787183181,MMW 11R,A01,892721,Herbst; Matthew,11,0,27,16
1745787183181,MMW 11R,A02,892722,Herbst; Matthew,0,0,0,3
1745787184210,MMW 12R,A01,892724,Herbst; Matthew,0,9,16,16
1745787184210,MMW 12R,A02,892725,Herbst; Matthew,0,9,16,16
1745787185239,MMW 13R,A01,892727,Staff,0,3,16,16
1745787185239,MMW 13R,A02,892728,Staff,0,4,16,16
1745787185239,MMW 13R,A03,958032,Staff,0,3,16,16
1745787185239,MMW 13R,A04,958033,Staff,0,2,16,16
1745787185239,MMW 13R,A05,958034,Staff,0,3,16,16
1745787186269,SIO 295LS,A00,894015,Staff,7,0,25,18
1745787187295,SIO 295S,A00,894020,Staff,7,0,25,18
1745787188324,SIOC 290S,B01,958918,Staff,0,0,0,0
1745787189350,SIOC 291S,B01,958922,Staff,0,0,0,0
1745787190377,SOCI 117,A01,895339,Staff,4,0,5,1
1745787191405,WES 237B,A00,894149,Staff,11,0,20,9
1745787193473,AESE 279B,A00,891859,Staff,13,0,35,22
1745787194498,AIP 197,001,891854,Staff,70,0,70,0
1745787195527,ANTH 289S,A00,891856,Gagneux; Pascal,12,0,12,0
1745787196552,BENG 196,001,957946,Engler; Adam J.,9996,0,9999,3
1745787197580,CAT 124RS,A01,956906,Staff,8,0,25,17
1745787198606,CAT 125RS,A01,922013,Staff,8,0,25,17
1745787199630,CLRE 250,A00,891860,Morris; Sheldon,9995,0,9999,4
1745787201683,CLRE 251R,A00,907817,Mehta; Ravindra L.,9994,0,9999,5
1745787202710,CLRE 252,A00,891864,Cuomo; Raphael Eduardo,9993,0,9999,6
1745787203737,CLRE 253,A00,891867,Vaida; Florin,9994,0,9999,5
1745787203737,CLRE 253,B00,907819,Staff,9999,0,9999,0
1745787204766,CLRE 259,A00,891868,Patel; Hemal,9998,0,9999,1
1745787205790,CLRE 260,A00,891872,Cuomo; Raphael Eduardo,9999,0,9999,0
1745787206818,CLRE 297,001,891888,Cuomo; Raphael Eduardo,9999,0,9999,0
1745787207844,CSE 191,A00,958773,Minnes Kemp; Mor Mia,9999,0,9999,0
1745787208872,CSS 201S,A01,892054,Mignozzetti; Umberto,30,0,30,0
1745787209902,CSS 202S,A01,892056,Mignozzetti; Umberto,30,0,30,0
1745787210928,DSC 197,001,956898,Eldridge; Justin Matthew,9998,0,9999,1
1745787211954,DSC 297,001,958000,Mazumdar; Arya,9998,0,9999,1
1745787212980,EAP 100,A00,905686,Staff,9776,0,9999,223
1745787214007,ECE 45,A01,892618,Staff,0,12,50,50
1745787215036,ECE 109,A01,892620,Staff,0,43,0,0
1745787216062,ECE 111,A01,892719,Staff,0,7,50,50
1745787217088,ECE 197,001,957920,Mercier; Patrick Philip,9992,0,9999,7
1745787218118,ECON 178,A01,907814,Zhu; Ying,28,0,35,7
1745787219143,EDS 115,A00,895312,Staff,41,0,45,4
1745787220173,EDS 117,A01,895337,Staff,30,0,30,0
1745787221201,EDS 125,A00,895341,Jones; Gabrielle Anastasia,43,0,45,2
1745787222227,EDS 128A,A01,895459,Fargason; Sharon Gayle,44,0,45,1
1745787223252,EDS 128B,A01,895543,Pappas; Elizabeth,44,0,45,1
1745787224276,EDS 139,A00,897203,Pappas; Elizabeth,44,0,45,1
1745787224276,EDS 139,B00,897209,Fargason; Sharon Gayle,44,0,45,1
1745787225302,EDS 201,A00,895545,Staff,43,0,45,2
1745787226328,EDS 203,A01,895581,Halter; Christopher P.,43,0,45,2
1745787227356,EDS 204R,A01,895625,Heinzman; Erica M.,44,0,45,1
1745787227356,EDS 204R,B01,895693,Halter; Christopher P.,18,0,45,27
1745787228384,EDS 206R,A00,895694,Fargason; Sharon Gayle,9,0,30,21
1745787228384,EDS 206R,B00,895695,Choi; Bailey Miyeon,20,0,30,10
1745787229410,EDS 250,A00,895697,Hemans; Patricia Ann Benitez,43,0,45,2
1745787230440,EDS 281,A00,895701,Meyerott; Theresa Ann,15,0,15,0
1745787231468,EDS 284,A00,895736,Meyerott; Theresa Ann,15,0,15,0
1745787232496,EDS 286,A00,897210,Fine; Sarah,15,0,15,0
1745787233522,EDS 289C,A01,895770,Daly; Alan J.,15,0,15,0
1745787234549,EDS 290,A00,897211,Hofstetter; Carolyn,15,0,15,0
1745787235573,LIGM 5A,A00,896162,Fischer-Grunski; Eva K,15,0,20,5
1745787236600,LIGM 5B,A00,896260,Fischer-Grunski; Eva K,17,0,20,3
1745787237625,LIGM 5C,A00,896308,Fischer-Grunski; Eva K,18,0,20,2
1745787238655,LIIT 5AS,A00,896313,Carnelos; Chiara,18,0,20,2
1745787239681,LIIT 5BS,A00,896416,Carnelos; Chiara,20,0,20,0
1745787240712,LIIT 5CS,A00,896564,Carnelos; Chiara,20,0,20,0
1745787241742,LISP 5A,A00,896588,Munoz Sanchez; Alicia,4,0,20,16
1745787242768,LISP 5B,A00,896653,Munoz Sanchez; Alicia,10,0,20,10
1745787243796,LISP 5C,A00,896655,Munoz Sanchez; Alicia,4,0,20,16
1745787244821,MAE 197,001,957918,Kleissl; Jan,9998,0,9999,1
1745787245850,MATH 2,A01,957937,Staff,34,0,35,1
1745787246879,MATH 197,001,957876,Kedlaya; Kiran S.,9993,0,9999,6
1745787247907,MCWP 40,A00,892729,Duru; Nur,13,0,20,7
1745787247907,MCWP 40,B00,893304,Montejo; Carolina,20,0,20,0
1745787248933,MCWP 40R,A00,893757,Redela; Pamela Morgan,0,6,20,20
1745787249963,MCWP 50,A00,893758,Morshed; Michael James,2,0,20,18
1745787249963,MCWP 50,B00,893761,Bartulis; Jason Michael,17,0,20,3
1745787250990,MCWP 50R,A00,893766,Compas; Sean Matthew,0,1,20,20
1745787250990,MCWP 50R,B00,893769,Carter; Jennifer A,0,0,20,20
1745787250990,MCWP 50R,C00,893771,Krone; Jarret,0,3,20,20
1745787250990,MCWP 50R,D00,893772,Miller; Elizabeth Deen,3,0,20,17
1745787250990,MCWP 50R,E00,893775,Carter; Andrea L,0,0,20,20
1745787252016,MMW 11R,A01,892721,Herbst; Matthew,11,0,27,16
1745787252016,MMW 11R,A02,892722,Herbst; Matthew,0,0,0,3
1745787253044,MMW 12R,A01,892724,Herbst; Matthew,0,9,16,16
1745787253044,MMW 12R,A02,892725,Herbst; Matthew,0,9,16,16
1745787254070,MMW 13R,A01,892727,Staff,0,3,16,16
1745787254070,MMW 13R,A02,892728,Staff,0,4,16,16
1745787254070,MMW 13R,A03,958032,Staff,0,3,16,16
1745787254070,MMW 13R,A04,958033,Staff,0,2,16,16
1745787254070,MMW 13R,A05,958034,Staff,0,3,16,16
1745787255099,SIO 295LS,A00,894015,Staff,7,0,25,18
1745787256127,SIO 295S,A00,894020,Staff,7,0,25,18
1745787257158,SIOC 290S,B01,958918,Staff,0,0,0,0
1745787258184,SIOC 291S,B01,958922,Staff,0,0,0,0
1745787259209,SOCI 117,A01,895339,Staff,4,0,5,1
1745787260234,WES 237B,A00,894149,Staff,11,0,20,9
1745787262295,AESE 279B,A00,891859,Staff,13,0,35,22
1745787263321,AIP 197,001,891854,Staff,70,0,70,0
1745787264349,ANTH 289S,A00,891856,Gagneux; Pascal,12,0,12,0
1745787265374,BENG 196,001,957946,Engler; Adam J.,9996,0,9999,3
1745787266401,CAT 124RS,A01,956906,Staff,8,0,25,17
1745787267426,CAT 125RS,A01,922013,Staff,8,0,25,17
1745787268469,CLRE 250,A00,891860,Morris; Sheldon,9995,0,9999,4
1745787270525,CLRE 251R,A00,907817,Mehta; Ravindra L.,9994,0,9999,5
1745787271554,CLRE 252,A00,891864,Cuomo; Raphael Eduardo,9993,0,9999,6
1745787272581,CLRE 253,A00,891867,Vaida; Florin,9994,0,9999,5
1745787272581,CLRE 253,B00,907819,Staff,9999,0,9999,0
1745787273607,CLRE 259,A00,891868,Patel; Hemal,9998,0,9999,1
1745787274631,CLRE 260,A00,891872,Cuomo; Raphael Eduardo,9999,0,9999,0
1745787275657,CLRE 297,001,891888,Cuomo; Raphael Eduardo,9999,0,9999,0
1745787276684,CSE 191,A00,958773,Minnes Kemp; Mor Mia,9999,0,9999,0
1745787277713,CSS 201S,A01,892054,Mignozzetti; Umberto,30,0,30,0
1745787278743,CSS 202S,A01,892056,Mignozzetti; Umberto,30,0,30,0
1745787279770,DSC 197,001,956898,Eldridge; Justin Matthew,9998,0,9999,1
1745787280798,DSC 297,001,958000,Mazumdar; Arya,9998,0,9999,1
1745787281823,EAP 100,A00,905686,Staff,9776,0,9999,223
1745787282848,ECE 45,A01,892618,Staff,0,12,50,50
1745787283874,ECE 109,A01,892620,Staff,0,43,0,0
1745787284900,ECE 111,A01,892719,Staff,0,7,50,50
1745787285927,ECE 197,001,957920,Mercier; Patrick Philip,9992,0,9999,7
1745787286953,ECON 178,A01,907814,Zhu; Ying,28,0,35,7
1745787287981,EDS 115,A00,895312,Staff,41,0,45,4
1745787289007,EDS 117,A01,895337,Staff,30,0,30,0
1745787290032,EDS 125,A00,895341,Jones; Gabrielle Anastasia,43,0,45,2
1745787291058,EDS 128A,A01,895459,Fargason; Sharon Gayle,44,0,45,1
1745787292088,EDS 128B,A01,895543,Pappas; Elizabeth,44,0,45,1
1745787293113,EDS 139,A00,897203,Pappas; Elizabeth,44,0,45,1
1745787293113,EDS 139,B00,897209,Fargason; Sharon Gayle,44,0,45,1
1745787294142,EDS 201,A00,895545,Staff,43,0,45,2
1745787295171,EDS 203,A01,895581,Halter; Christopher P.,43,0,45,2
1745787296197,EDS 204R,A01,895625,Heinzman; Erica M.,44,0,45,1
1745787296197,EDS 204R,B01,895693,Halter; Christopher P.,18,0,45,27
1745787297224,EDS 206R,A00,895694,Fargason; Sharon Gayle,9,0,30,21
1745787297224,EDS 206R,B00,895695,Choi; Bailey Miyeon,20,0,30,10
1745787298250,EDS 250,A00,895697,Hemans; Patricia Ann Benitez,43,0,45,2
1745787299275,EDS 281,A00,895701,Meyerott; Theresa Ann,15,0,15,0
1745787300301,EDS 284,A00,895736,Meyerott; Theresa Ann,15,0,15,0
1745787301328,EDS 286,A00,897210,Fine; Sarah,15,0,15,0
1745787302354,EDS 289C,A01,895770,Daly; Alan J.,15,0,15,0
1745787303381,EDS 290,A00,897211,Hofstetter; Carolyn,15,0,15,0
1745787304413,LIGM 5A,A00,896162,Fischer-Grunski; Eva K,15,0,20,5
1745787305440,LIGM 5B,A00,896260,Fischer-Grunski; Eva K,17,0,20,3
1745787306467,LIGM 5C,A00,896308,Fischer-Grunski; Eva K,18,0,20,2
1745787307495,LIIT 5AS,A00,896313,Carnelos; Chiara,18,0,20,2
1745787308537,LIIT 5BS,A00,896416,Carnelos; Chiara,20,0,20,0
1745787309565,LIIT 5CS,A00,896564,Carnelos; Chiara,20,0,20,0
1745787310593,LISP 5A,A00,896588,Munoz Sanchez; Alicia,4,0,20,16
1745787311618,LISP 5B,A00,896653,Munoz Sanchez; Alicia,10,0,20,10
1745787312645,LISP 5C,A00,896655,Munoz Sanchez; Alicia,4,0,20,16
1745787313673,MAE 197,001,957918,Kleissl; Jan,9998,0,9999,1
1745787314698,MATH 2,A01,957937,Staff,34,0,35,1
1745787315723,MATH 197,001,957876,Kedlaya; Kiran S.,9993,0,9999,6
1745787316752,MCWP 40,A00,892729,Duru; Nur,13,0,20,7
1745787316752,MCWP 40,B00,893304,Montejo; Carolina,20,0,20,0
1745787317780,MCWP 40R,A00,893757,Redela; Pamela Morgan,0,6,20,20
1745787318809,MCWP 50,A00,893758,Morshed; Michael James,2,0,20,18
1745787318809,MCWP 50,B00,893761,Bartulis; Jason Michael,17,0,20,3
1745787319837,MCWP 50R,A00,893766,Compas; Sean Matthew,0,1,20,20
1745787319837,MCWP 50R,B00,893769,Carter; Jennifer A,0,0,20,20
1745787319837,MCWP 50R,C00,893771,Krone; Jarret,0,3,20,20
1745787319837,MCWP 50R,D00,893772,Miller; Elizabeth Deen,3,0,20,17
1745787319837,MCWP 50R,E00,893775,Carter; Andrea L,0,0,20,20
1745787320863,MMW 11R,A01,892721,Herbst; Matthew,11,0,27,16
1745787320863,MMW 11R,A02,892722,Herbst; Matthew,0,0,0,3
1745787321891,MMW 12R,A01,892724,Herbst; Matthew,0,9,16,16
1745787321891,MMW 12R,A02,892725,Herbst; Matthew,0,9,16,16
1745787322922,MMW 13R,A01,892727,Staff,0,3,16,16
1745787322922,MMW 13R,A02,892728,Staff,0,4,16,16
1745787322922,MMW 13R,A03,958032,Staff,0,3,16,16
1745787322922,MMW 13R,A04,958033,Staff,0,2,16,16
1745787322922,MMW 13R,A05,958034,Staff,0,3,16,16
1745787323948,SIO 295LS,A00,894015,Staff,7,0,25,18
1745787324977,SIO 295S,A00,894020,Staff,7,0,25,18
1745787326007,SIOC 290S,B01,958918,Staff,0,0,0,0
1745787327033,SIOC 291S,B01,958922,Staff,0,0,0,0
1745787328061,SOCI 117,A01,895339,Staff,4,0,5,1
1745787329087,WES 237B,A00,894149,Staff,11,0,20,9
1745787331142,AESE 279B,A00,891859,Staff,13,0,35,22
1745787332169,AIP 197,001,891854,Staff,70,0,70,0
1745787333196,ANTH 289S,A00,891856,Gagneux; Pascal,12,0,12,0
1745787334221,BENG 196,001,957946,Engler; Adam J.,9996,0,9999,3
1745787335251,CAT 124RS,A01,956906,Staff,8,0,25,17
1745787336277,CAT 125RS,A01,922013,Staff,8,0,25,17
1745787337303,CLRE 250,A00,891860,Morris; Sheldon,9995,0,9999,4
1745787339353,CLRE 251R,A00,907817,Mehta; Ravindra L.,9994,0,9999,5
1745787340383,CLRE 252,A00,891864,Cuomo; Raphael Eduardo,9993,0,9999,6
1745787341409,CLRE 253,A00,891867,Vaida; Florin,9994,0,9999,5
1745787341409,CLRE 253,B00,907819,Staff,9999,0,9999,0
1745787342438,CLRE 259,A00,891868,Patel; Hemal,9998,0,9999,1
1745787343461,CLRE 260,A00,891872,Cuomo; Raphael Eduardo,9999,0,9999,0
1745787344489,CLRE 297,001,891888,Cuomo; Raphael Eduardo,9999,0,9999,0
1745787345517,CSE 191,A00,958773,Minnes Kemp; Mor Mia,9999,0,9999,0
1745787346545,CSS 201S,A01,892054,Mignozzetti; Umberto,30,0,30,0
1745787347576,CSS 202S,A01,892056,Mignozzetti; Umberto,30,0,30,0
1745787348603,DSC 197,001,956898,Eldridge; Justin Matthew,9998,0,9999,1
1745787349627,DSC 297,001,958000,Mazumdar; Arya,9998,0,9999,1
1745787350652,EAP 100,A00,905686,Staff,9776,0,9999,223
1745787351678,ECE 45,A01,892618,Staff,0,12,50,50
1745787352709,ECE 109,A01,892620,Staff,0,43,0,0
1745787353734,ECE 111,A01,892719,Staff,0,7,50,50
1745787354761,ECE 197,001,957920,Mercier; Patrick Philip,9992,0,9999,7
1745787355789,ECON 178,A01,907814,Zhu; Ying,28,0,35,7
1745787356812,EDS 115,A00,895312,Staff,41,0,45,4
1745787357841,EDS 117,A01,895337,Staff,30,0,30,0
1745787358866,EDS 125,A00,895341,Jones; Gabrielle Anastasia,43,0,45,2
1745787359892,EDS 128A,A01,895459,Fargason; Sharon Gayle,44,0,45,1
1745787360917,EDS 128B,A01,895543,Pappas; Elizabeth,44,0,45,1
1745787361946,EDS 139,A00,897203,Pappas; Elizabeth,44,0,45,1
1745787361946,EDS 139,B00,897209,Fargason; Sharon Gayle,44,0,45,1
1745787362972,EDS 201,A00,895545,Staff,43,0,45,2
1745787363999,EDS 203,A01,895581,Halter; Christopher P.,43,0,45,2
1745787365026,EDS 204R,A01,895625,Heinzman; Erica M.,44,0,45,1
1745787365026,EDS 204R,B01,895693,Halter; Christopher P.,18,0,45,27
1745787366050,EDS 206R,A00,895694,Fargason; Sharon Gayle,9,0,30,21
1745787366050,EDS 206R,B00,895695,Choi; Bailey Miyeon,20,0,30,10
1745787367079,EDS 250,A00,895697,Hemans; Patricia Ann Benitez,43,0,45,2
1745787368108,EDS 281,A00,895701,Meyerott; Theresa Ann,15,0,15,0
1745787369132,EDS 284,A00,895736,Meyerott; Theresa Ann,15,0,15,0
1745787370159,EDS 286,A00,897210,Fine; Sarah,15,0,15,0
1745787371188,EDS 289C,A01,895770,Daly; Alan J.,15,0,15,0
1745787372216,EDS 290,A00,897211,Hofstetter; Carolyn,15,0,15,0
1745787373246,LIGM 5A,A00,896162,Fischer-Grunski; Eva K,15,0,20,5
1745787374275,LIGM 5B,A00,896260,Fischer-Grunski; Eva K,17,0,20,3
1745787375303,LIGM 5C,A00,896308,Fischer-Grunski; Eva K,18,0,20,2
1745787376330,LIIT 5AS,A00,896313,Carnelos; Chiara,18,0,20,2
1745787377357,LIIT 5BS,A00,896416,Carnelos; Chiara,20,0,20,0
1745787378385,LIIT 5CS,A00,896564,Carnelos; Chiara,20,0,20,0
1745787379411,LISP 5A,A00,896588,Munoz Sanchez; Alicia,4,0,20,16
1745787380440,LISP 5B,A00,896653,Munoz Sanchez; Alicia,10,0,20,10
1745787381470,LISP 5C,A00,896655,Munoz Sanchez; Alicia,4,0,20,16
1745787382498,MAE 197,001,957918,Kleissl; Jan,9998,0,9999,1
1745787383525,MATH 2,A01,957937,Staff,34,0,35,1
1745787384553,MATH 197,001,957876,Kedlaya; Kiran S.,9993,0,9999,6
1745787385579,MCWP 40,A00,892729,Duru; Nur,13,0,20,7
1745787385579,MCWP 40,B00,893304,Montejo; Carolina,20,0,20,0
1745787386608,MCWP 40R,A00,893757,Redela; Pamela Morgan,0,6,20,20
1745787387632,MCWP 50,A00,893758,Morshed; Michael James,2,0,20,18
1745787387632,MCWP 50,B00,893761,Bartulis; Jason Michael,17,0,20,3
1745787388658,MCWP 50R,A00,893766,Compas; Sean Matthew,0,1,20,20
1745787388658,MCWP 50R,B00,893769,Carter; Jennifer A,0,0,20,20
1745787388658,MCWP 50R,C00,893771,Krone; Jarret,0,3,20,20
1745787388658,MCWP 50R,D00,893772,Miller; Elizabeth Deen,3,0,20,17
1745787388658,MCWP 50R,E00,893775,Carter; Andrea L,0,0,20,20
1745787389684,MMW 11R,A01,892721,Herbst; Matthew,11,0,27,16
1745787389684,MMW 11R,A02,892722,Herbst; Matthew,0,0,0,3
1745787390710,MMW 12R,A01,892724,Herbst; Matthew,0,9,16,16
1745787390710,MMW 12R,A02,892725,Herbst; Matthew,0,9,16,16
1745787391736,MMW 13R,A01,892727,Staff,0,3,16,16
1745787391736,MMW 13R,A02,892728,Staff,0,4,16,16
1745787391736,MMW 13R,A03,958032,Staff,0,3,16,16
1745787391736,MMW 13R,A04,958033,Staff,0,2,16,16
1745787391736,MMW 13R,A05,958034,Staff,0,3,16,16
1745787392765,SIO 295LS,A00,894015,Staff,7,0,25,18
1745787393792,SIO 295S,A00,894020,Staff,7,0,25,18
1745787394818,SIOC 290S,B01,958918,Staff,0,0,0,0
1745787395846,SIOC 291S,B01,958922,Staff,0,0,0,0
1745787396872,SOCI 117,A01,895339,Staff,4,0,5,1
1745787397897,WES 237B,A00,894149,Staff,11,0,20,9
1745787399964,AESE 279B,A00,891859,Staff,13,0,35,22
1745787400990,AIP 197,001,891854,Staff,70,0,70,0
1745787402022,ANTH 289S,A00,891856,Gagneux; Pascal,12,0,12,0
1745787403049,BENG 196,001,957946,Engler; Adam J.,9996,0,9999,3
1745787404076,CAT 124RS,A01,956906,Staff,8,0,25,17
1745787405101,CAT 125RS,A01,922013,Staff,8,0,25,17
1745787406127,CLRE 250,A00,891860,Morris; Sheldon,9995,0,9999,4
1745787408182,CLRE 251R,A00,907817,Mehta; Ravindra L.,9994,0,9999,5
1745787409211,CLRE 252,A00,891864,Cuomo; Raphael Eduardo,9993,0,9999,6
1745787410241,CLRE 253,A00,891867,Vaida; Florin,9994,0,9999,5
1745787410241,CLRE 253,B00,907819,Staff,9999,0,9999,0
1745787411268,CLRE 259,A00,891868,Patel; Hemal,9998,0,9999,1
1745787412296,CLRE 260,A00,891872,Cuomo; Raphael Eduardo,9999,0,9999,0
1745787413324,CLRE 297,001,891888,Cuomo; Raphael Eduardo,9999,0,9999,0
1745787414350,CSE 191,A00,958773,Minnes Kemp; Mor Mia,9999,0,9999,0
1745787415380,CSS 201S,A01,892054,Mignozzetti; Umberto,30,0,30,0
1745787416406,CSS 202S,A01,892056,Mignozzetti; Umberto,30,0,30,0
1745787417439,DSC 197,001,956898,Eldridge; Justin Matthew,9998,0,9999,1
1745787418464,DSC 297,001,958000,Mazumdar; Arya,9998,0,9999,1
1745787419491,EAP 100,A00,905686,Staff,9776,0,9999,223
1745787420517,ECE 45,A01,892618,Staff,0,12,50,50
1745787421546,ECE 109,A01,892620,Staff,0,43,0,0
1745787422573,ECE 111,A01,892719,Staff,0,7,50,50
1745787423601,ECE 197,001,957920,Mercier; Patrick Philip,9992,0,9999,7
1745787424629,ECON 178,A01,907814,Zhu; Ying,28,0,35,7
1745787425657,EDS 115,A00,895312,Staff,41,0,45,4
1745787426684,EDS 117,A01,895337,Staff,30,0,30,0
1745787427711,EDS 125,A00,895341,Jones; Gabrielle Anastasia,43,0,45,2
1745787428759,EDS 128A,A01,895459,Fargason; Sharon Gayle,44,0,45,1
1745787429787,EDS 128B,A01,895543,Pappas; Elizabeth,44,0,45,1
1745787430816,EDS 139,A00,897203,Pappas; Elizabeth,44,0,45,1
1745787430816,EDS 139,B00,897209,Fargason; Sharon Gayle,44,0,45,1
1745787431844,EDS 201,A00,895545,Staff,43,0,45,2
1745787432870,EDS 203,A01,895581,Halter; Christopher P.,43,0,45,2
1745787433897,EDS 204R,A01,895625,Heinzman; Erica M.,44,0,45,1
1745787433897,EDS 204R,B01,895693,Halter; Christopher P.,18,0,45,27
1745787434924,EDS 206R,A00,895694,Fargason; Sharon Gayle,9,0,30,21
1745787434924,EDS 206R,B00,895695,Choi; Bailey Miyeon,20,0,30,10
1745787435949,EDS 250,A00,895697,Hemans; Patricia Ann Benitez,43,0,45,2
1745787436975,EDS 281,A00,895701,Meyerott; Theresa Ann,15,0,15,0
1745787437998,EDS 284,A00,895736,Meyerott; Theresa Ann,15,0,15,0
1745787439026,EDS 286,A00,897210,Fine; Sarah,15,0,15,0
1745787440051,EDS 289C,A01,895770,Daly; Alan J.,15,0,15,0
1745787441077,EDS 290,A00,897211,Hofstetter; Carolyn,15,0,15,0
1745787442104,LIGM 5A,A00,896162,Fischer-Grunski; Eva K,15,0,20,5
1745787443134,LIGM 5B,A00,896260,Fischer-Grunski; Eva K,17,0,20,3
1745787444163,LIGM 5C,A00,896308,Fischer-Grunski; Eva K,18,0,20,2
1745787445192,LIIT 5AS,A00,896313,Carnelos; Chiara,18,0,20,2
1745787446223,LIIT 5BS,A00,896416,Carnelos; Chiara,20,0,20,0
1745787447249,LIIT 5CS,A00,896564,Carnelos; Chiara,20,0,20,0
1745787448277,LISP 5A,A00,896588,Munoz Sanchez; Alicia,4,0,20,16
1745787449305,LISP 5B,A00,896653,Munoz Sanchez; Alicia,10,0,20,10
1745787450330,LISP 5C,A00,896655,Munoz Sanchez; Alicia,4,0,20,16
1745787451360,MAE 197,001,957918,Kleissl; Jan,9998,0,9999,1
1745787452389,MATH 2,A01,957937,Staff,34,0,35,1
1745787453415,MATH 197,001,957876,Kedlaya; Kiran S.,9993,0,9999,6
1745787454441,MCWP 40,A00,892729,Duru; Nur,13,0,20,7
1745787454441,MCWP 40,B00,893304,Montejo; Carolina,20,0,20,0
1745787455470,MCWP 40R,A00,893757,Redela; Pamela Morgan,0,6,20,20
1745787456499,MCWP 50,A00,893758,Morshed; Michael James,2,0,20,18
1745787456499,MCWP 50,B00,893761,Bartulis; Jason Michael,17,0,20,3
1745787457526,MCWP 50R,A00,893766,Compas; Sean Matthew,0,1,20,20
1745787457526,MCWP 50R,B00,893769,Carter; Jennifer A,0,0,20,20
1745787457526,MCWP 50R,C00,893771,Krone; Jarret,0,3,20,20
1745787457526,MCWP 50R,D00,893772,Miller; Elizabeth Deen,3,0,20,17
1745787457526,MCWP 50R,E00,893775,Carter; Andrea L,0,0,20,20
1745787458555,MMW 11R,A01,892721,Herbst; Matthew,11,0,27,16
1745787458555,MMW 11R,A02,892722,Herbst; Matthew,0,0,0,3
1745787459581,MMW 12R,A01,892724,Herbst; Matthew,0,9,16,16
1745787459581,MMW 12R,A02,892725,Herbst; Matthew,0,9,16,16
1745787460607,MMW 13R,A01,892727,Staff,0,3,16,16
1745787460607,MMW 13R,A02,892728,Staff,0,4,16,16
1745787460607,MMW 13R,A03,958032,Staff,0,3,16,16
1745787460607,MMW 13R,A04,958033,Staff,0,2,16,16
1745787460607,MMW 13R,A05,958034,Staff,0,3,16,16
1745787461635,SIO 295LS,A00,894015,Staff,7,0,25,18
1745787462666,SIO 295S,A00,894020,Staff,7,0,25,18
1745787463691,SIOC 290S,B01,958918,Staff,0,0,0,0
1745787464720,SIOC 291S,B01,958922,Staff,0,0,0,0
1745787465745,SOCI 117,A01,895339,Staff,4,0,5,1
1745787466770,WES 237B,A00,894149,Staff,11,0,20,9
1745787468829,AESE 279B,A00,891859,Staff,13,0,35,22
1745787469858,AIP 197,001,891854,Staff,70,0,70,0
1745787470886,ANTH 289S,A00,891856,Gagneux; Pascal,12,0,12,0
1745787471913,BENG 196,001,957946,Engler; Adam J.,9996,0,9999,3
1745787472940,CAT 124RS,A01,956906,Staff,8,0,25,17
1745787473968,CAT 125RS,A01,922013,Staff,8,0,25,17
1745787474998,CLRE 250,A00,891860,Morris; Sheldon,9995,0,9999,4
1745787477048,CLRE 251R,A00,907817,Mehta; Ravindra L.,9994,0,9999,5
1745787478074,CLRE 252,A00,891864,Cuomo; Raphael Eduardo,9993,0,9999,6
1745787479101,CLRE 253,A00,891867,Vaida; Florin,9994,0,9999,5
1745787479101,CLRE 253,B00,907819,Staff,9999,0,9999,0
1745787480129,CLRE 259,A00,891868,Patel; Hemal,9998,0,9999,1
1745787481155,CLRE 260,A00,891872,Cuomo; Raphael Eduardo,9999,0,9999,0
1745787482185,CLRE 297,001,891888,Cuomo; Raphael Eduardo,9999,0,9999,0
1745787483213,CSE 191,A00,958773,Minnes Kemp; Mor Mia,9999,0,9999,0
1745787484241,CSS 201S,A01,892054,Mignozzetti; Umberto,30,0,30,0
1745787485271,CSS 202S,A01,892056,Mignozzetti; Umberto,30,0,30,0
1745787486300,DSC 197,001,956898,Eldridge; Justin Matthew,9998,0,9999,1
1745787487327,DSC 297,001,958000,Mazumdar; Arya,9998,0,9999,1
1745787488355,EAP 100,A00,905686,Staff,9776,0,9999,223
1745787489381,ECE 45,A01,892618,Staff,0,12,50,50
1745787490409,ECE 109,A01,892620,Staff,0,43,0,0
1745787491438,ECE 111,A01,892719,Staff,0,7,50,50
1745787492465,ECE 197,001,957920,Mercier; Patrick Philip,9992,0,9999,7
1745787493494,ECON 178,A01,907814,Zhu; Ying,28,0,35,7
1745787494523,EDS 115,A00,895312,Staff,41,0,45,4
1745787495547,EDS 117,A01,895337,Staff,30,0,30,0
1745787496576,EDS 125,A00,895341,Jones; Gabrielle Anastasia,43,0,45,2
1745787497601,EDS 128A,A01,895459,Fargason; Sharon Gayle,44,0,45,1
1745787498629,EDS 128B,A01,895543,Pappas; Elizabeth,44,0,45,1
1745787499658,EDS 139,A00,897203,Pappas; Elizabeth,44,0,45,1
1745787499658,EDS 139,B00,897209,Fargason; Sharon Gayle,44,0,45,1
1745787500685,EDS 201,A00,895545,Staff,43,0,45,2
1745787501713,EDS 203,A01,895581,Halter; Christopher P.,43,0,45,2
1745787502741,EDS 204R,A01,895625,Heinzman; Erica M.,44,0,45,1
1745787502741,EDS 204R,B01,895693,Halter; Christopher P.,18,0,45,27
1745787503770,EDS 206R,A00,895694,Fargason; Sharon Gayle,9,0,30,21
1745787503770,EDS 206R,B00,895695,Choi; Bailey Miyeon,20,0,30,10
1745787504796,EDS 250,A00,895697,Hemans; Patricia Ann Benitez,43,0,45,2
1745787505822,EDS 281,A00,895701,Meyerott; Theresa Ann,15,0,15,0
1745787506849,EDS 284,A00,895736,Meyerott; Theresa Ann,15,0,15,0
1745787507876,EDS 286,A00,897210,Fine; Sarah,15,0,15,0
1745787508903,EDS 289C,A01,895770,Daly; Alan J.,15,0,15,0
1745787509931,EDS 290,A00,897211,Hofstetter; Carolyn,15,0,15,0
1745787510957,LIGM 5A,A00,896162,Fischer-Grunski; Eva K,15,0,20,5
1745787511984,LIGM 5B,A00,896260,Fischer-Grunski; Eva K,17,0,20,3
1745787513018,LIGM 5C,A00,896308,Fischer-Grunski; Eva K,18,0,20,2
1745787514043,LIIT 5AS,A00,896313,Carnelos; Chiara,18,0,20,2
1745787515072,LIIT 5BS,A00,896416,Carnelos; Chiara,20,0,20,0
1745787516098,LIIT 5CS,A00,896564,Carnelos; Chiara,20,0,20,0
1745787517130,LISP 5A,A00,896588,Munoz Sanchez; Alicia,4,0,20,16
1745787518154,LISP 5B,A00,896653,Munoz Sanchez; Alicia,10,0,20,10
1745787519181,LISP 5C,A00,896655,Munoz Sanchez; Alicia,4,0,20,16
1745787520212,MAE 197,001,957918,Kleissl; Jan,9998,0,9999,1
1745787521239,MATH 2,A01,957937,Staff,34,0,35,1
1745787522266,MATH 197,001,957876,Kedlaya; Kiran S.,9993,0,9999,6
1745787523293,MCWP 40,A00,892729,Duru; Nur,13,0,20,7
1745787523293,MCWP 40,B00,893304,Montejo; Carolina,20,0,20,0
1745787524318,MCWP 40R,A00,893757,Redela; Pamela Morgan,0,6,20,20
1745787525345,MCWP 50,A00,893758,Morshed; Michael James,2,0,20,18
1745787525345,MCWP 50,B00,893761,Bartulis; Jason Michael,17,0,20,3
1745787526378,MCWP 50R,A00,893766,Compas; Sean Matthew,0,1,20,20
1745787526378,MCWP 50R,B00,893769,Carter; Jennifer A,0,0,20,20
1745787526378,MCWP 50R,C00,893771,Krone; Jarret,0,3,20,20
1745787526378,MCWP 50R,D00,893772,Miller; Elizabeth Deen,3,0,20,17
1745787526378,MCWP 50R,E00,893775,Carter; Andrea L,0,0,20,20
1745787527405,MMW 11R,A01,892721,Herbst; Matthew,11,0,27,16
1745787527405,MMW 11R,A02,892722,Herbst; Matthew,0,0,0,3
1745787528431,MMW 12R,A01,892724,Herbst; Matthew,0,9,16,16
1745787528431,MMW 12R,A02,892725,Herbst; Matthew,0,9,16,16
1745787529460,MMW 13R,A01,892727,Staff,0,3,16,16
1745787529460,MMW 13R,A02,892728,Staff,0,4,16,16
1745787529460,MMW 13R,A03,958032,Staff,0,3,16,16
1745787529460,MMW 13R,A04,958033,Staff,0,2,16,16
1745787529460,MMW 13R,A05,958034,Staff,0,3,16,16
1745787530488,SIO 295LS,A00,894015,Staff,7,0,25,18
1745787531514,SIO 295S,A00,894020,Staff,7,0,25,18
1745787532541,SIOC 290S,B01,958918,Staff,0,0,0,0
1745787533568,SIOC 291S,B01,958922,Staff,0,0,0,0
1745787534595,SOCI 117,A01,895339,Staff,4,0,5,1
1745787535620,WES 237B,A00,894149,Staff,11,0,20,9
1745787537687,AESE 279B,A00,891859,Staff,13,0,35,22
1745787538713,AIP 197,001,891854,Staff,70,0,70,0
1745787539742,ANTH 289S,A00,891856,Gagneux; Pascal,12,0,12,0
1745787540768,BENG 196,001,957946,Engler; Adam J.,9996,0,9999,3
1745787541812,CAT 124RS,A01,956906,Staff,8,0,25,17
1745787542838,CAT 125RS,A01,922013,Staff,8,0,25,17
1745787543867,CLRE 250,A00,891860,Morris; Sheldon,9995,0,9999,4
1745787545922,CLRE 251R,A00,907817,Mehta; Ravindra L.,9994,0,9999,5
1745787546955,CLRE 252,A00,891864,Cuomo; Raphael Eduardo,9993,0,9999,6
1745787547982,CLRE 253,A00,891867,Vaida; Florin,9994,0,9999,5
1745787547982,CLRE 253,B00,907819,Staff,9999,0,9999,0
1745787549007,CLRE 259,A00,891868,Patel; Hemal,9998,0,9999,1
1745787550037,CLRE 260,A00,891872,Cuomo; Raphael Eduardo,9999,0,9999,0
1745787551063,CLRE 297,001,891888,Cuomo; Raphael Eduardo,9999,0,9999,0
1745787552091,CSE 191,A00,958773,Minnes Kemp; Mor Mia,9999,0,9999,0
1745787553119,CSS 201S,A01,892054,Mignozzetti; Umberto,30,0,30,0
1745787554146,CSS 202S,A01,892056,Mignozzetti; Umberto,30,0,30,0
1745787555174,DSC 197,001,956898,Eldridge; Justin Matthew,9998,0,9999,1
1745787556202,DSC 297,001,958000,Mazumdar; Arya,9998,0,9999,1
1745787557231,EAP 100,A00,905686,Staff,9776,0,9999,223
1745787558256,ECE 45,A01,892618,Staff,0,12,50,50
1745787559286,ECE 109,A01,892620,Staff,0,43,0,0
1745787560312,ECE 111,A01,892719,Staff,0,7,50,50
1745787561339,ECE 197,001,957920,Mercier; Patrick Philip,9992,0,9999,7
1745787562382,ECON 178,A01,907814,Zhu; Ying,28,0,35,7
1745787563407,EDS 115,A00,895312,Staff,41,0,45,4
1745787564432,EDS 117,A01,895337,Staff,30,0,30,0
1745787565458,EDS 125,A00,895341,Jones; Gabrielle Anastasia,43,0,45,2
1745787566483,EDS 128A,A01,895459,Fargason; Sharon Gayle,44,0,45,1
1745787567510,EDS 128B,A01,895543,Pappas; Elizabeth,44,0,45,1
1745787568537,EDS 139,A00,897203,Pappas; Elizabeth,44,0,45,1
1745787568537,EDS 139,B00,897209,Fargason; Sharon Gayle,44,0,45,1
1745787569565,EDS 201,A00,895545,Staff,43,0,45,2
1745787570591,EDS 203,A01,895581,Halter; Christopher P.,43,0,45,2
1745787571617,EDS 204R,A01,895625,Heinzman; Erica M.,44,0,45,1
1745787571617,EDS 204R,B01,895693,Halter; Christopher P.,18,0,45,27
1745787572644,EDS 206R,A00,895694,Fargason; Sharon Gayle,9,0,30,21
1745787572644,EDS 206R,B00,895695,Choi; Bailey Miyeon,20,0,30,10
1745787573669,EDS 250,A00,895697,Hemans; Patricia Ann Benitez,43,0,45,2
1745787574698,EDS 281,A00,895701,Meyerott; Theresa Ann,15,0,15,0
1745787575726,EDS 284,A00,895736,Meyerott; Theresa Ann,15,0,15,0
1745787576752,EDS 286,A00,897210,Fine; Sarah,15,0,15,0
1745787577779,EDS 289C,A01,895770,Daly; Alan J.,15,0,15,0
1745787578807,EDS 290,A00,897211,Hofstetter; Carolyn,15,0,15,0
1745787579836,LIGM 5A,A00,896162,Fischer-Grunski; Eva K,15,0,20,5
1745787580866,LIGM 5B,A00,896260,Fischer-Grunski; Eva K,17,0,20,3
1745787581894,LIGM 5C,A00,896308,Fischer-Grunski; Eva K,18,0,20,2
1745787582919,LIIT 5AS,A00,896313,Carnelos; Chiara,18,0,20,2
1745787583946,LIIT 5BS,A00,896416,Carnelos; Chiara,20,0,20,0
1745787584970,LIIT 5CS,A00,896564,Carnelos; Chiara,20,0,20,0
1745787585996,LISP 5A,A00,896588,Munoz Sanchez; Alicia,4,0,20,16
1745787587025,LISP 5B,A00,896653,Munoz Sanchez; Alicia,10,0,20,10
1745787588051,LISP 5C,A00,896655,Munoz Sanchez; Alicia,4,0,20,16
1745787589078,MAE 197,001,957918,Kleissl; Jan,9998,0,9999,1
1745787590106,MATH 2,A01,957937,Staff,34,0,35,1
1745787591132,MATH 197,001,957876,Kedlaya; Kiran S.,9993,0,9999,6
1745787592157,MCWP 40,A00,892729,Duru; Nur,13,0,20,7
1745787592157,MCWP 40,B00,893304,Montejo; Carolina,20,0,20,0
1745787593185,MCWP 40R,A00,893757,Redela; Pamela Morgan,0,6,20,20
1745787594213,MCWP 50,A00,893758,Morshed; Michael James,2,0,20,18
1745787594213,MCWP 50,B00,893761,Bartulis; Jason Michael,17,0,20,3
1745787595242,MCWP 50R,A00,893766,Compas; Sean Matthew,0,1,20,20
1745787595242,MCWP 50R,B00,893769,Carter; Jennifer A,0,0,20,20
1745787595242,MCWP 50R,C00,893771,Krone; Jarret,0,3,20,20
1745787595242,MCWP 50R,D00,893772,Miller; Elizabeth Deen,3,0,20,17
1745787595242,MCWP 50R,E00,893775,Carter; Andrea L,0,0,20,20
1745787596270,MMW 11R,A01,892721,Herbst; Matthew,11,0,27,16
1745787596270,MMW 11R,A02,892722,Herbst; Matthew,0,0,0,3
1745787597297,MMW 12R,A01,892724,Herbst; Matthew,0,9,16,16
1745787597297,MMW 12R,A02,892725,Herbst; Matthew,0,9,16,16
1745787598324,MMW 13R,A01,892727,Staff,0,3,16,16
1745787598324,MMW 13R,A02,892728,Staff,0,4,16,16
1745787598324,MMW 13R,A03,958032,Staff,0,3,16,16
1745787598324,MMW 13R,A04,958033,Staff,0,2,16,16
1745787598324,MMW 13R,A05,958034,Staff,0,3,16,16
1745787599351,SIO 295LS,A00,894015,Staff,7,0,25,18
1745787600378,SIO 295S,A00,894020,Staff,7,0,25,18
1745787601409,SIOC 290S,B01,958918,Staff,0,0,0,0
1745787602439,SIOC 291S,B01,958922,Staff,0,0,0,0
1745787603466,SOCI 117,A01,895339,Staff,4,0,5,1
1745787604495,WES 237B,A00,894149,Staff,11,0,20,9
1745787606560,AESE 279B,A00,891859,Staff,13,0,35,22
1745787607587,AIP 197,001,891854,Staff,70,0,70,0
1745787608618,ANTH 289S,A00,891856,Gagneux; Pascal,12,0,12,0
1745787609648,BENG 196,001,957946,Engler; Adam J.,9996,0,9999,3
1745787610674,CAT 124RS,A01,956906,Staff,8,0,25,17
1745787611701,CAT 125RS,A01,922013,Staff,8,0,25,17
1745787612725,CLRE 250,A00,891860,Morris; Sheldon,9995,0,9999,4
1745787614776,CLRE 251R,A00,907817,Mehta; Ravindra L.,9994,0,9999,5
1745787615804,CLRE 252,A00,891864,Cuomo; Raphael Eduardo,9993,0,9999,6
1745787616830,CLRE 253,A00,891867,Vaida; Florin,9994,0,9999,5
1745787616830,CLRE 253,B00,907819,Staff,9999,0,9999,0
1745787617856,CLRE 259,A00,891868,Patel; Hemal,9998,0,9999,1
1745787618885,CLRE 260,A00,891872,Cuomo; Raphael Eduardo,9999,0,9999,0
1745787619911,CLRE 297,001,891888,Cuomo; Raphael Eduardo,9999,0,9999,0
1745787620937,CSE 191,A00,958773,Minnes Kemp; Mor Mia,9999,0,9999,0
1745787621964,CSS 201S,A01,892054,Mignozzetti; Umberto,30,0,30,0
1745787623000,CSS 202S,A01,892056,Mignozzetti; Umberto,30,0,30,0
1745787624027,DSC 197,001,956898,Eldridge; Justin Matthew,9998,0,9999,1
1745787625056,DSC 297,001,958000,Mazumdar; Arya,9998,0,9999,1
1745787626084,EAP 100,A00,905686,Staff,9776,0,9999,223
1745787627115,ECE 45,A01,892618,Staff,0,12,50,50
1745787628142,ECE 109,A01,892620,Staff,0,43,0,0
1745787629169,ECE 111,A01,892719,Staff,0,7,50,50
1745787630196,ECE 197,001,957920,Mercier; Patrick Philip,9992,0,9999,7
1745787631222,ECON 178,A01,907814,Zhu; Ying,28,0,35,7
1745787632247,EDS 115,A00,895312,Staff,41,0,45,4
1745787633274,EDS 117,A01,895337,Staff,30,0,30,0
1745787634304,EDS 125,A00,895341,Jones; Gabrielle Anastasia,43,0,45,2
1745787635333,EDS 128A,A01,895459,Fargason; Sharon Gayle,44,0,45,1
1745787636360,EDS 128B,A01,895543,Pappas; Elizabeth,44,0,45,1
1745787637389,EDS 139,A00,897203,Pappas; Elizabeth,44,0,45,1
1745787637389,EDS 139,B00,897209,Fargason; Sharon Gayle,44,0,45,1
1745787638417,EDS 201,A00,895545,Staff,43,0,45,2
1745787639446,EDS 203,A01,895581,Halter; Christopher P.,43,0,45,2
1745787640470,EDS 204R,A01,895625,Heinzman; Erica M.,44,0,45,1
1745787640470,EDS 204R,B01,895693,Halter; Christopher P.,18,0,45,27
1745787641499,EDS 206R,A00,895694,Fargason; Sharon Gayle,9,0,30,21
1745787641499,EDS 206R,B00,895695,Choi; Bailey Miyeon,20,0,30,10
1745787642525,EDS 250,A00,895697,Hemans; Patricia Ann Benitez,43,0,45,2
1745787643590,EDS 281,A00,895701,Meyerott; Theresa Ann,15,0,15,0
1745787644616,EDS 284,A00,895736,Meyerott; Theresa Ann,15,0,15,0
1745787645643,EDS 286,A00,897210,Fine; Sarah,15,0,15,0
1745787646667,EDS 289C,A01,895770,Daly; Alan J.,15,0,15,0
1745787647695,EDS 290,A00,897211,Hofstetter; Carolyn,15,0,15,0
1745787648721,LIGM 5A,A00,896162,Fischer-Grunski; Eva K,15,0,20,5
1745787649751,LIGM 5B,A00,896260,Fischer-Grunski; Eva K,17,0,20,3
1745787650780,LIGM 5C,A00,896308,Fischer-Grunski; Eva K,18,0,20,2
1745787651807,LIIT 5AS,A00,896313,Carnelos; Chiara,18,0,20,2
1745787652834,LIIT 5BS,A00,896416,Carnelos; Chiara,20,0,20,0
1745787653863,LIIT 5CS,A00,896564,Carnelos; Chiara,20,0,20,0
1745787654889,LISP 5A,A00,896588,Munoz Sanchez; Alicia,4,0,20,16
1745787655915,LISP 5B,A00,896653,Munoz Sanchez; Alicia,10,0,20,10
1745787656940,LISP 5C,A00,896655,Munoz Sanchez; Alicia,4,0,20,16
1745787657967,MAE 197,001,957918,Kleissl; Jan,9998,0,9999,1
1745787658992,MATH 2,A01,957937,Staff,34,0,35,1
1745787660023,MATH 197,001,957876,Kedlaya; Kiran S.,9993,0,9999,6
1745787661051,MCWP 40,A00,892729,Duru; Nur,13,0,20,7
1745787661051,MCWP 40,B00,893304,Montejo; Carolina,20,0,20,0
1745787662077,MCWP 40R,A00,893757,Redela; Pamela Morgan,0,6,20,20
1745787663107,MCWP 50,A00,893758,Morshed; Michael James,2,0,20,18
1745787663107,MCWP 50,B00,893761,Bartulis; Jason Michael,17,0,20,3
1745787664134,MCWP 50R,A00,893766,Compas; Sean Matthew,0,1,20,20
1745787664134,MCWP 50R,B00,893769,Carter; Jennifer A,0,0,20,20
1745787664134,MCWP 50R,C00,893771,Krone; Jarret,0,3,20,20
1745787664134,MCWP 50R,D00,893772,Miller; Elizabeth Deen,3,0,20,17
1745787664134,MCWP 50R,E00,893775,Carter; Andrea L,0,0,20,20
1745787665159,MMW 11R,A01,892721,Herbst; Matthew,11,0,27,16
1745787665159,MMW 11R,A02,892722,Herbst; Matthew,0,0,0,3
1745787666188,MMW 12R,A01,892724,Herbst; Matthew,0,9,16,16
1745787666188,MMW 12R,A02,892725,Herbst; Matthew,0,9,16,16
1745787667218,MMW 13R,A01,892727,Staff,0,3,16,16
1745787667218,MMW 13R,A02,892728,Staff,0,4,16,16
1745787667218,MMW 13R,A03,958032,Staff,0,3,16,16
1745787667218,MMW 13R,A04,958033,Staff,0,2,16,16
1745787667218,MMW 13R,A05,958034,Staff,0,3,16,16
1745787668244,SIO 295LS,A00,894015,Staff,7,0,25,18
1745787669273,SIO 295S,A00,894020,Staff,7,0,25,18
1745787670300,SIOC 290S,B01,958918,Staff,0,0,0,0
1745787671328,SIOC 291S,B01,958922,Staff,0,0,0,0
1745787672356,SOCI 117,A01,895339,Staff,4,0,5,1
1745787673382,WES 237B,A00,894149,Staff,11,0,20,9
1745787675445,AESE 279B,A00,891859,Staff,13,0,35,22
1745787676470,AIP 197,001,891854,Staff,70,0,70,0
1745787677496,ANTH 289S,A00,891856,Gagneux; Pascal,12,0,12,0
1745787678523,BENG 196,001,957946,Engler; Adam J.,9996,0,9999,3
1745787679547,CAT 124RS,A01,956906,Staff,8,0,25,17
1745787680576,CAT 125RS,A01,922013,Staff,8,0,25,17
1745787681604,CLRE 250,A00,891860,Morris; Sheldon,9995,0,9999,4
1745787683658,CLRE 251R,A00,907817,Mehta; Ravindra L.,9994,0,9999,5
1745787684686,CLRE 252,A00,891864,Cuomo; Raphael Eduardo,9993,0,9999,6
1745787685716,CLRE 253,A00,891867,Vaida; Florin,9994,0,9999,5
1745787685716,CLRE 253,B00,907819,Staff,9999,0,9999,0
1745787686744,CLRE 259,A00,891868,Patel; Hemal,9998,0,9999,1
1745787687773,CLRE 260,A00,891872,Cuomo; Raphael Eduardo,9999,0,9999,0
1745787688800,CLRE 297,001,891888,Cuomo; Raphael Eduardo,9999,0,9999,0
1745787689829,CSE 191,A00,958773,Minnes Kemp; Mor Mia,9999,0,9999,0
1745787690860,CSS 201S,A01,892054,Mignozzetti; Umberto,30,0,30,0
1745787691889,CSS 202S,A01,892056,Mignozzetti; Umberto,30,0,30,0
1745787692918,DSC 197,001,956898,Eldridge; Justin Matthew,9998,0,9999,1
1745787693947,DSC 297,001,958000,Mazumdar; Arya,9998,0,9999,1
1745787694975,EAP 100,A00,905686,Staff,9776,0,9999,223
1745787696002,ECE 45,A01,892618,Staff,0,12,50,50
1745787697031,ECE 109,A01,892620,Staff,0,43,0,0
1745787698056,ECE 111,A01,892719,Staff,0,7,50,50
1745787699081,ECE 197,001,957920,Mercier; Patrick Philip,9992,0,9999,7
1745787700107,ECON 178,A01,907814,Zhu; Ying,28,0,35,7
1745787701134,EDS 115,A00,895312,Staff,41,0,45,4
1745787702158,EDS 117,A01,895337,Staff,30,0,30,0
1745787703181,EDS 125,A00,895341,Jones; Gabrielle Anastasia,43,0,45,2
1745787704205,EDS 128A,A01,895459,Fargason; Sharon Gayle,44,0,45,1
1745787705230,EDS 128B,A01,895543,Pappas; Elizabeth,44,0,45,1
1745787706255,EDS 139,A00,897203,Pappas; Elizabeth,44,0,45,1
1745787706255,EDS 139,B00,897209,Fargason; Sharon Gayle,44,0,45,1
1745787707279,EDS 201,A00,895545,Staff,43,0,45,2
1745787708306,EDS 203,A01,895581,Halter; Christopher P.,43,0,45,2
1745787709333,EDS 204R,A01,895625,Heinzman; Erica M.,44,0,45,1
1745787709333,EDS 204R,B01,895693,Halter; Christopher P.,18,0,45,27
1745787710359,EDS 206R,A00,895694,Fargason; Sharon Gayle,9,0,30,21
1745787710359,EDS 206R,B00,895695,Choi; Bailey Miyeon,20,0,30,10
1745787711388,EDS 250,A00,895697,Hemans; Patricia Ann Benitez,43,0,45,2
1745787712417,EDS 281,A00,895701,Meyerott; Theresa Ann,15,0,15,0
1745787713445,EDS 284,A00,895736,Meyerott; Theresa Ann,15,0,15,0
1745787714474,EDS 286,A00,897210,Fine; Sarah,15,0,15,0
1745787715502,EDS 289C,A01,895770,Daly; Alan J.,15,0,15,0
1745787716528,EDS 290,A00,897211,Hofstetter; Carolyn,15,0,15,0
1745787717558,LIGM 5A,A00,896162,Fischer-Grunski; Eva K,15,0,20,5
1745787718582,LIGM 5B,A00,896260,Fischer-Grunski; Eva K,17,0,20,3
1745787719609,LIGM 5C,A00,896308,Fischer-Grunski; Eva K,18,0,20,2
1745787720640,LIIT 5AS,A00,896313,Carnelos; Chiara,18,0,20,2
1745787721666,LIIT 5BS,A00,896416,Carnelos; Chiara,20,0,20,0
1745787722698,LIIT 5CS,A00,896564,Carnelos; Chiara,20,0,20,0
1745787723724,LISP 5A,A00,896588,Munoz Sanchez; Alicia,4,0,20,16
1745787724750,LISP 5B,A00,896653,Munoz Sanchez; Alicia,10,0,20,10
1745787725775,LISP 5C,A00,896655,Munoz Sanchez; Alicia,4,0,20,16
1745787726802,MAE 197,001,957918,Kleissl; Jan,9998,0,9999,1
1745787727833,MATH 2,A01,957937,Staff,34,0,35,1
1745787728859,MATH 197,001,957876,Kedlaya; Kiran S.,9993,0,9999,6
1745787729887,MCWP 40,A00,892729,Duru; Nur,13,0,20,7
1745787729887,MCWP 40,B00,893304,Montejo; Carolina,20,0,20,0
1745787730912,MCWP 40R,A00,893757,Redela; Pamela Morgan,0,6,20,20
1745787731940,MCWP 50,A00,893758,Morshed; Michael James,2,0,20,18
1745787731940,MCWP 50,B00,893761,Bartulis; Jason Michael,17,0,20,3
1745787732971,MCWP 50R,A00,893766,Compas; Sean Matthew,0,1,20,20
1745787732971,MCWP 50R,B00,893769,Carter; Jennifer A,0,0,20,20
1745787732971,MCWP 50R,C00,893771,Krone; Jarret,0,3,20,20
1745787732971,MCWP 50R,D00,893772,Miller; Elizabeth Deen,3,0,20,17
1745787732971,MCWP 50R,E00,893775,Carter; Andrea L,0,0,20,20
1745787733996,MMW 11R,A01,892721,Herbst; Matthew,11,0,27,16
1745787733996,MMW 11R,A02,892722,Herbst; Matthew,0,0,0,3
1745787735025,MMW 12R,A01,892724,Herbst; Matthew,0,9,16,16
1745787735025,MMW 12R,A02,892725,Herbst; Matthew,0,9,16,16
1745787736052,MMW 13R,A01,892727,Staff,0,3,16,16
1745787736052,MMW 13R,A02,892728,Staff,0,4,16,16
1745787736052,MMW 13R,A03,958032,Staff,0,3,16,16
1745787736052,MMW 13R,A04,958033,Staff,0,2,16,16
1745787736052,MMW 13R,A05,958034,Staff,0,3,16,16
1745787737080,SIO 295LS,A00,894015,Staff,7,0,25,18
1745787738105,SIO 295S,A00,894020,Staff,7,0,25,18
1745787739134,SIOC 290S,B01,958918,Staff,0,0,0,0
1745787740166,SIOC 291S,B01,958922,Staff,0,0,0,0
1745787741193,SOCI 117,A01,895339,Staff,4,0,5,1
1745787742220,WES 237B,A00,894149,Staff,11,0,20,9
1745787744284,AESE 279B,A00,891859,Staff,13,0,35,22
1745787745309,AIP 197,001,891854,Staff,70,0,70,0
1745787746339,ANTH 289S,A00,891856,Gagneux; Pascal,12,0,12,0
1745787747365,BENG 196,001,957946,Engler; Adam J.,9996,0,9999,3
1745787748390,CAT 124RS,A01,956906,Staff,8,0,25,17
1745787749416,CAT 125RS,A01,922013,Staff,8,0,25,17
1745787750442,CLRE 250,A00,891860,Morris; Sheldon,9995,0,9999,4
1745787752494,CLRE 251R,A00,907817,Mehta; Ravindra L.,9994,0,9999,5
1745787753518,CLRE 252,A00,891864,Cuomo; Raphael Eduardo,9993,0,9999,6
1745787754546,CLRE 253,A00,891867,Vaida; Florin,9994,0,9999,5
1745787754546,CLRE 253,B00,907819,Staff,9999,0,9999,0
1745787755572,CLRE 259,A00,891868,Patel; Hemal,9998,0,9999,1
1745787756597,CLRE 260,A00,891872,Cuomo; Raphael Eduardo,9999,0,9999,0
1745787757622,CLRE 297,001,891888,Cuomo; Raphael Eduardo,9999,0,9999,0
1745787758649,CSE 191,A00,958773,Minnes Kemp; Mor Mia,9999,0,9999,0
1745787759676,CSS 201S,A01,892054,Mignozzetti; Umberto,30,0,30,0
1745787760702,CSS 202S,A01,892056,Mignozzetti; Umberto,30,0,30,0
1745787761730,DSC 197,001,956898,Eldridge; Justin Matthew,9998,0,9999,1
1745787762757,DSC 297,001,958000,Mazumdar; Arya,9998,0,9999,1
1745787763782,EAP 100,A00,905686,Staff,9776,0,9999,223
1745787764808,ECE 45,A01,892618,Staff,0,12,50,50
1745787765831,ECE 109,A01,892620,Staff,0,43,0,0
1745787766859,ECE 111,A01,892719,Staff,0,7,50,50
1745787767887,ECE 197,001,957920,Mercier; Patrick Philip,9992,0,9999,7
1745787768912,ECON 178,A01,907814,Zhu; Ying,28,0,35,7
1745787769940,EDS 115,A00,895312,Staff,41,0,45,4
1745787770968,EDS 117,A01,895337,Staff,30,0,30,0
1745787771995,EDS 125,A00,895341,Jones; Gabrielle Anastasia,43,0,45,2
1745787773021,EDS 128A,A01,895459,Fargason; Sharon Gayle,44,0,45,1
1745787774049,EDS 128B,A01,895543,Pappas; Elizabeth,44,0,45,1
1745787775074,EDS 139,A00,897203,Pappas; Elizabeth,44,0,45,1
1745787775074,EDS 139,B00,897209,Fargason; Sharon Gayle,44,0,45,1
1745787776098,EDS 201,A00,895545,Staff,43,0,45,2
1745787777124,EDS 203,A01,895581,Halter; Christopher P.,43,0,45,2
1745787778152,EDS 204R,A01,895625,Heinzman; Erica M.,44,0,45,1
1745787778152,EDS 204R,B01,895693,Halter; Christopher P.,18,0,45,27
1745787779177,EDS 206R,A00,895694,Fargason; Sharon Gayle,9,0,30,21
1745787779177,EDS 206R,B00,895695,Choi; Bailey Miyeon,20,0,30,10
1745787780203,EDS 250,A00,895697,Hemans; Patricia Ann Benitez,43,0,45,2
1745787781230,EDS 281,A00,895701,Meyerott; Theresa Ann,15,0,15,0
1745787782257,EDS 284,A00,895736,Meyerott; Theresa Ann,15,0,15,0
1745787783280,EDS 286,A00,897210,Fine; Sarah,15,0,15,0
1745787784307,EDS 289C,A01,895770,Daly; Alan J.,15,0,15,0
1745787785333,EDS 290,A00,897211,Hofstetter; Carolyn,15,0,15,0
1745787786363,LIGM 5A,A00,896162,Fischer-Grunski; Eva K,15,0,20,5
1745787787392,LIGM 5B,A00,896260,Fischer-Grunski; Eva K,17,0,20,3
1745787788424,LIGM 5C,A00,896308,Fischer-Grunski; Eva K,18,0,20,2
1745787789452,LIIT 5AS,A00,896313,Carnelos; Chiara,18,0,20,2
1745787790479,LIIT 5BS,A00,896416,Carnelos; Chiara,20,0,20,0
1745787791508,LIIT 5CS,A00,896564,Carnelos; Chiara,20,0,20,0
1745787792541,LISP 5A,A00,896588,Munoz Sanchez; Alicia,4,0,20,16
1745787793566,LISP 5B,A00,896653,Munoz Sanchez; Alicia,10,0,20,10
1745787794594,LISP 5C,A00,896655,Munoz Sanchez; Alicia,4,0,20,16
1745787795622,MAE 197,001,957918,Kleissl; Jan,9998,0,9999,1
1745787796650,MATH 2,A01,957937,Staff,34,0,35,1
1745787797675,MATH 197,001,957876,Kedlaya; Kiran S.,9993,0,9999,6
1745787798703,MCWP 40,A00,892729,Duru; Nur,13,0,20,7
1745787798703,MCWP 40,B00,893304,Montejo; Carolina,20,0,20,0
1745787799732,MCWP 40R,A00,893757,Redela; Pamela Morgan,0,6,20,20
1745787800761,MCWP 50,A00,893758,Morshed; Michael James,2,0,20,18
1745787800761,MCWP 50,B00,893761,Bartulis; Jason Michael,17,0,20,3
1745787801791,MCWP 50R,A00,893766,Compas; Sean Matthew,0,1,20,20
1745787801791,MCWP 50R,B00,893769,Carter; Jennifer A,0,0,20,20
1745787801791,MCWP 50R,C00,893771,Krone; Jarret,0,3,20,20
1745787801791,MCWP 50R,D00,893772,Miller; Elizabeth Deen,3,0,20,17
1745787801791,MCWP 50R,E00,893775,Carter; Andrea L,0,0,20,20
1745787802820,MMW 11R,A01,892721,Herbst; Matthew,11,0,27,16
1745787802820,MMW 11R,A02,892722,Herbst; Matthew,0,0,0,3
1745787803849,MMW 12R,A01,892724,Herbst; Matthew,0,9,16,16
1745787803849,MMW 12R,A02,892725,Herbst; Matthew,0,9,16,16
1745787804880,MMW 13R,A01,892727,Staff,0,3,16,16
1745787804880,MMW 13R,A02,892728,Staff,0,4,16,16
1745787804880,MMW 13R,A03,958032,Staff,0,3,16,16
1745787804880,MMW 13R,A04,958033,Staff,0,2,16,16
1745787804880,MMW 13R,A05,958034,Staff,0,3,16,16
1745787805948,SIO 295LS,A00,894015,Staff,7,0,25,18
1745787806974,SIO 295S,A00,894020,Staff,7,0,25,18
1745787808001,SIOC 290S,B01,958918,Staff,0,0,0,0
1745787809030,SIOC 291S,B01,958922,Staff,0,0,0,0
1745787810057,SOCI 117,A01,895339,Staff,4,0,5,1
1745787811081,WES 237B,A00,894149,Staff,11,0,20,9
1745787813139,AESE 279B,A00,891859,Staff,13,0,35,22
1745787814165,AIP 197,001,891854,Staff,70,0,70,0
1745787815191,ANTH 289S,A00,891856,Gagneux; Pascal,12,0,12,0
1745787816217,BENG 196,001,957946,Engler; Adam J.,9996,0,9999,3
1745787817244,CAT 124RS,A01,956906,Staff,8,0,25,17
1745787818269,CAT 125RS,A01,922013,Staff,8,0,25,17
1745787819294,CLRE 250,A00,891860,Morris; Sheldon,9995,0,9999,4
1745787821350,CLRE 251R,A00,907817,Mehta; Ravindra L.,9994,0,9999,5
1745787822391,CLRE 252,A00,891864,Cuomo; Raphael Eduardo,9993,0,9999,6
1745787823421,CLRE 253,A00,891867,Vaida; Florin,9994,0,9999,5
1745787823421,CLRE 253,B00,907819,Staff,9999,0,9999,0
1745787824447,CLRE 259,A00,891868,Patel; Hemal,9998,0,9999,1
1745787825475,CLRE 260,A00,891872,Cuomo; Raphael Eduardo,9999,0,9999,0
1745787826501,CLRE 297,001,891888,Cuomo; Raphael Eduardo,9999,0,9999,0
1745787827527,CSE 191,A00,958773,Minnes Kemp; Mor Mia,9999,0,9999,0
1745787828558,CSS 201S,A01,892054,Mignozzetti; Umberto,30,0,30,0
1745787829585,CSS 202S,A01,892056,Mignozzetti; Umberto,30,0,30,0
1745787830615,DSC 197,001,956898,Eldridge; Justin Matthew,9998,0,9999,1
1745787831640,DSC 297,001,958000,Mazumdar; Arya,9998,0,9999,1
1745787832665,EAP 100,A00,905686,Staff,9776,0,9999,223
1745787833692,ECE 45,A01,892618,Staff,0,12,50,50
1745787834717,ECE 109,A01,892620,Staff,0,43,0,0
1745787835746,ECE 111,A01,892719,Staff,0,7,50,50
1745787836773,ECE 197,001,957920,Mercier; Patrick Philip,9992,0,9999,7
1745787837799,ECON 178,A01,907814,Zhu; Ying,28,0,35,7
1745787838825,EDS 115,A00,895312,Staff,41,0,45,4
1745787839851,EDS 117,A01,895337,Staff,30,0,30,0
1745787840879,EDS 125,A00,895341,Jones; Gabrielle Anastasia,43,0,45,2
1745787841905,EDS 128A,A01,895459,Fargason; Sharon Gayle,44,0,45,1
1745787842932,EDS 128B,A01,895543,Pappas; Elizabeth,44,0,45,1
1745787843958,EDS 139,A00,897203,Pappas; Elizabeth,44,0,45,1
1745787843958,EDS 139,B00,897209,Fargason; Sharon Gayle,44,0,45,1
1745787844987,EDS 201,A00,895545,Staff,43,0,45,2
1745787846013,EDS 203,A01,895581,Halter; Christopher P.,43,0,45,2
1745787847044,EDS 204R,A01,895625,Heinzman; Erica M.,44,0,45,1
1745787847044,EDS 204R,B01,895693,Halter; Christopher P.,18,0,45,27
1745787848068,EDS 206R,A00,895694,Fargason; Sharon Gayle,9,0,30,21
1745787848068,EDS 206R,B00,895695,Choi; Bailey Miyeon,20,0,30,10
1745787849095,EDS 250,A00,895697,Hemans; Patricia Ann Benitez,43,0,45,2
1745787850121,EDS 281,A00,895701,Meyerott; Theresa Ann,15,0,15,0
1745787851147,EDS 284,A00,895736,Meyerott; Theresa Ann,15,0,15,0
1745787852174,EDS 286,A00,897210,Fine; Sarah,15,0,15,0
1745787853202,EDS 289C,A01,895770,Daly; Alan J.,15,0,15,0
1745787854228,EDS 290,A00,897211,Hofstetter; Carolyn,15,0,15,0
1745787855257,LIGM 5A,A00,896162,Fischer-Grunski; Eva K,15,0,20,5
1745787856283,LIGM 5B,A00,896260,Fischer-Grunski; Eva K,17,0,20,3
1745787857310,LIGM 5C,A00,896308,Fischer-Grunski; Eva K,18,0,20,2
1745787858338,LIIT 5AS,A00,896313,Carnelos; Chiara,18,0,20,2
1745787859368,LIIT 5BS,A00,896416,Carnelos; Chiara,20,0,20,0
1745787860394,LIIT 5CS,A00,896564,Carnelos; Chiara,20,0,20,0
1745787861425,LISP 5A,A00,896588,Munoz Sanchez; Alicia,4,0,20,16
1745787862454,LISP 5B,A00,896653,Munoz Sanchez; Alicia,10,0,20,10
1745787863482,LISP 5C,A00,896655,Munoz Sanchez; Alicia,4,0,20,16
1745787864507,MAE 197,001,957918,Kleissl; Jan,9998,0,9999,1
1745787865535,MATH 2,A01,957937,Staff,34,0,35,1
1745787866562,MATH 197,001,957876,Kedlaya; Kiran S.,9993,0,9999,6
1745787867589,MCWP 40,A00,892729,Duru; Nur,13,0,20,7
1745787867589,MCWP 40,B00,893304,Montejo; Carolina,20,0,20,0
1745787868615,MCWP 40R,A00,893757,Redela; Pamela Morgan,0,6,20,20
1745787869640,MCWP 50,A00,893758,Morshed; Michael James,2,0,20,18
1745787869640,MCWP 50,B00,893761,Bartulis; Jason Michael,17,0,20,3
1745787870671,MCWP 50R,A00,893766,Compas; Sean Matthew,0,1,20,20
1745787870671,MCWP 50R,B00,893769,Carter; Jennifer A,0,0,20,20
1745787870671,MCWP 50R,C00,893771,Krone; Jarret,0,3,20,20
1745787870671,MCWP 50R,D00,893772,Miller; Elizabeth Deen,3,0,20,17
1745787870671,MCWP 50R,E00,893775,Carter; Andrea L,0,0,20,20
1745787871699,MMW 11R,A01,892721,Herbst; Matthew,11,0,27,16
1745787871699,MMW 11R,A02,892722,Herbst; Matthew,0,0,0,3
1745787872729,MMW 12R,A01,892724,Herbst; Matthew,0,9,16,16
1745787872729,MMW 12R,A02,892725,Herbst; Matthew,0,9,16,16
1745787873755,MMW 13R,A01,892727,Staff,0,3,16,16
1745787873755,MMW 13R,A02,892728,Staff,0,4,16,16
1745787873755,MMW 13R,A03,958032,Staff,0,3,16,16
1745787873755,MMW 13R,A04,958033,Staff,0,2,16,16
1745787873755,MMW 13R,A05,958034,Staff,0,3,16,16
1745787874781,SIO 295LS,A00,894015,Staff,7,0,25,18
1745787875807,SIO 295S,A00,894020,Staff,7,0,25,18
1745787876838,SIOC 290S,B01,958918,Staff,0,0,0,0
1745787877864,SIOC 291S,B01,958922,Staff,0,0,0,0
1745787878890,SOCI 117,A01,895339,Staff,4,0,5,1
1745787879917,WES 237B,A00,894149,Staff,11,0,20,9
1745787881976,AESE 279B,A00,891859,Staff,13,0,35,22
1745787883002,AIP 197,001,891854,Staff,70,0,70,0
1745787884030,ANTH 289S,A00,891856,Gagneux; Pascal,12,0,12,0
1745787885056,BENG 196,001,957946,Engler; Adam J.,9996,0,9999,3
1745787886081,CAT 124RS,A01,956906,Staff,8,0,25,17
1745787887108,CAT 125RS,A01,922013,Staff,8,0,25,17
1745787888134,CLRE 250,A00,891860,Morris; Sheldon,9995,0,9999,4
1745787890191,CLRE 251R,A00,907817,Mehta; Ravindra L.,9994,0,9999,5
1745787891224,CLRE 252,A00,891864,Cuomo; Raphael Eduardo,9993,0,9999,6
1745787892250,CLRE 253,A00,891867,Vaida; Florin,9994,0,9999,5
1745787892250,CLRE 253,B00,907819,Staff,9999,0,9999,0
1745787893277,CLRE 259,A00,891868,Patel; Hemal,9998,0,9999,1
1745787894301,CLRE 260,A00,891872,Cuomo; Raphael Eduardo,9999,0,9999,0
1745787895328,CLRE 297,001,891888,Cuomo; Raphael Eduardo,9999,0,9999,0
1745787896357,CSE 191,A00,958773,Minnes Kemp; Mor Mia,9999,0,9999,0
1745787897386,CSS 201S,A01,892054,Mignozzetti; Umberto,30,0,30,0
1745787898411,CSS 202S,A01,892056,Mignozzetti; Umberto,30,0,30,0
1745787899437,DSC 197,001,956898,Eldridge; Justin Matthew,9998,0,9999,1
1745787900466,DSC 297,001,958000,Mazumdar; Arya,9998,0,9999,1
1745787901492,EAP 100,A00,905686,Staff,9776,0,9999,223
1745787902520,ECE 45,A01,892618,Staff,0,12,50,50
1745787903547,ECE 109,A01,892620,Staff,0,43,0,0
1745787904575,ECE 111,A01,892719,Staff,0,7,50,50
1745787905602,ECE 197,001,957920,Mercier; Patrick Philip,9992,0,9999,7
1745787906632,ECON 178,A01,907814,Zhu; Ying,28,0,35,7
1745787907664,EDS 115,A00,895312,Staff,41,0,45,4
1745787908690,EDS 117,A01,895337,Staff,30,0,30,0
1745787909762,EDS 125,A00,895341,Jones; Gabrielle Anastasia,43,0,45,2
1745787910788,EDS 128A,A01,895459,Fargason; Sharon Gayle,44,0,45,1
1745787911816,EDS 128B,A01,895543,Pappas; Elizabeth,44,0,45,1
1745787912842,EDS 139,A00,897203,Pappas; Elizabeth,44,0,45,1
1745787912842,EDS 139,B00,897209,Fargason; Sharon Gayle,44,0,45,1
1745787913874,EDS 201,A00,895545,Staff,43,0,45,2
1745787914900,EDS 203,A01,895581,Halter; Christopher P.,43,0,45,2
1745787915926,EDS 204R,A01,895625,Heinzman; Erica M.,44,0,45,1
1745787915926,EDS 204R,B01,895693,Halter; Christopher P.,18,0,45,27
1745787916952,EDS 206R,A00,895694,Fargason; Sharon Gayle,9,0,30,21
1745787916952,EDS 206R,B00,895695,Choi; Bailey Miyeon,20,0,30,10
1745787917978,EDS 250,A00,895697,Hemans; Patricia Ann Benitez,43,0,45,2
1745787919006,EDS 281,A00,895701,Meyerott; Theresa Ann,15,0,15,0
1745787920031,EDS 284,A00,895736,Meyerott; Theresa Ann,15,0,15,0
1745787921056,EDS 286,A00,897210,Fine; Sarah,15,0,15,0
1745787922081,EDS 289C,A01,895770,Daly; Alan J.,15,0,15,0
1745787923108,EDS 290,A00,897211,Hofstetter; Carolyn,15,0,15,0
1745787924137,LIGM 5A,A00,896162,Fischer-Grunski; Eva K,15,0,20,5
1745787925166,LIGM 5B,A00,896260,Fischer-Grunski; Eva K,17,0,20,3
1745787926193,LIGM 5C,A00,896308,Fischer-Grunski; Eva K,18,0,20,2
1745787927222,LIIT 5AS,A00,896313,Carnelos; Chiara,18,0,20,2
1745787928251,LIIT 5BS,A00,896416,Carnelos; Chiara,20,0,20,0
1745787929280,LIIT 5CS,A00,896564,Carnelos; Chiara,20,0,20,0
1745787930309,LISP 5A,A00,896588,Munoz Sanchez; Alicia,4,0,20,16
1745787931337,LISP 5B,A00,896653,Munoz Sanchez; Alicia,10,0,20,10
1745787932366,LISP 5C,A00,896655,Munoz Sanchez; Alicia,4,0,20,16
1745787933392,MAE 197,001,957918,Kleissl; Jan,9998,0,9999,1
1745787934417,MATH 2,A01,957937,Staff,34,0,35,1
1745787935445,MATH 197,001,957876,Kedlaya; Kiran S.,9993,0,9999,6
1745787936471,MCWP 40,A00,892729,Duru; Nur,13,0,20,7
1745787936471,MCWP 40,B00,893304,Montejo; Carolina,20,0,20,0
1745787937496,MCWP 40R,A00,893757,Redela; Pamela Morgan,0,6,20,20
1745787938525,MCWP 50,A00,893758,Morshed; Michael James,2,0,20,18
1745787938525,MCWP 50,B00,893761,Bartulis; Jason Michael,17,0,20,3
1745787939553,MCWP 50R,A00,893766,Compas; Sean Matthew,0,1,20,20
1745787939553,MCWP 50R,B00,893769,Carter; Jennifer A,0,0,20,20
1745787939553,MCWP 50R,C00,893771,Krone; Jarret,0,3,20,20
1745787939553,MCWP 50R,D00,893772,Miller; Elizabeth Deen,3,0,20,17
1745787939553,MCWP 50R,E00,893775,Carter; Andrea L,0,0,20,20
1745787940579,MMW 11R,A01,892721,Herbst; Matthew,11,0,27,16
1745787940579,MMW 11R,A02,892722,Herbst; Matthew,0,0,0,3
1745787941608,MMW 12R,A01,892724,Herbst; Matthew,0,9,16,16
1745787941608,MMW 12R,A02,892725,Herbst; Matthew,0,9,16,16
1745787942636,MMW 13R,A01,892727,Staff,0,3,16,16
1745787942636,MMW 13R,A02,892728,Staff,0,4,16,16
1745787942636,MMW 13R,A03,958032,Staff,0,3,16,16
1745787942636,MMW 13R,A04,958033,Staff,0,2,16,16
1745787942636,MMW 13R,A05,958034,Staff,0,3,16,16
1745787943660,SIO 295LS,A00,894015,Staff,7,0,25,18
1745787944686,SIO 295S,A00,894020,Staff,7,0,25,18
1745787945713,SIOC 290S,B01,958918,Staff,0,0,0,0
1745787946741,SIOC 291S,B01,958922,Staff,0,0,0,0
1745787947766,SOCI 117,A01,895339,Staff,4,0,5,1
1745787948791,WES 237B,A00,894149,Staff,11,0,20,9
1745787950865,AESE 279B,A00,891859,Staff,13,0,35,22
1745787951891,AIP 197,001,891854,Staff,70,0,70,0
1745787952919,ANTH 289S,A00,891856,Gagneux; Pascal,12,0,12,0
1745787953951,BENG 196,001,957946,Engler; Adam J.,9996,0,9999,3
1745787954977,CAT 124RS,A01,956906,Staff,8,0,25,17
1745787956001,CAT 125RS,A01,922013,Staff,8,0,25,17
1745787957025,CLRE 250,A00,891860,Morris; Sheldon,9995,0,9999,4
1745787959080,CLRE 251R,A00,907817,Mehta; Ravindra L.,9994,0,9999,5
1745787960106,CLRE 252,A00,891864,Cuomo; Raphael Eduardo,9993,0,9999,6
1745787961134,CLRE 253,A00,891867,Vaida; Florin,9994,0,9999,5
1745787961134,CLRE 253,B00,907819,Staff,9999,0,9999,0
1745787962162,CLRE 259,A00,891868,Patel; Hemal,9998,0,9999,1
1745787963191,CLRE 260,A00,891872,Cuomo; Raphael Eduardo,9999,0,9999,0
1745787964216,CLRE 297,001,891888,Cuomo; Raphael Eduardo,9999,0,9999,0
1745787965244,CSE 191,A00,958773,Minnes Kemp; Mor Mia,9999,0,9999,0
1745787966270,CSS 201S,A01,892054,Mignozzetti; Umberto,30,0,30,0
1745787967298,CSS 202S,A01,892056,Mignozzetti; Umberto,30,0,30,0
1745787968325,DSC 197,001,956898,Eldridge; Justin Matthew,9998,0,9999,1
1745787969351,DSC 297,001,958000,Mazumdar; Arya,9998,0,9999,1
1745787970377,EAP 100,A00,905686,Staff,9776,0,9999,223
1745787971402,ECE 45,A01,892618,Staff,0,12,50,50
1745787972431,ECE 109,A01,892620,Staff,0,43,0,0
1745787973455,ECE 111,A01,892719,Staff,0,7,50,50
1745787974481,ECE 197,001,957920,Mercier; Patrick Philip,9992,0,9999,7
1745787975507,ECON 178,A01,907814,Zhu; Ying,28,0,35,7
1745787976532,EDS 115,A00,895312,Staff,41,0,45,4
1745787977556,EDS 117,A01,895337,Staff,30,0,30,0
1745787978582,EDS 125,A00,895341,Jones; Gabrielle Anastasia,43,0,45,2
1745787979608,EDS 128A,A01,895459,Fargason; Sharon Gayle,44,0,45,1
1745787980634,EDS 128B,A01,895543,Pappas; Elizabeth,44,0,45,1
1745787981660,EDS 139,A00,897203,Pappas; Elizabeth,44,0,45,1
1745787981660,EDS 139,B00,897209,Fargason; Sharon Gayle,44,0,45,1
1745787982685,EDS 201,A00,895545,Staff,43,0,45,2
1745787983714,EDS 203,A01,895581,Halter; Christopher P.,43,0,45,2
1745787984741,EDS 204R,A01,895625,Heinzman; Erica M.,44,0,45,1
1745787984741,EDS 204R,B01,895693,Halter; Christopher P.,18,0,45,27
1745787985769,EDS 206R,A00,895694,Fargason; Sharon Gayle,9,0,30,21
1745787985769,EDS 206R,B00,895695,Choi; Bailey Miyeon,20,0,30,10
1745787986796,EDS 250,A00,895697,Hemans; Patricia Ann Benitez,43,0,45,2
1745787987825,EDS 281,A00,895701,Meyerott; Theresa Ann,15,0,15,0
1745787988853,EDS 284,A00,895736,Meyerott; Theresa Ann,15,0,15,0
1745787989880,EDS 286,A00,897210,Fine; Sarah,15,0,15,0
1745787990905,EDS 289C,A01,895770,Daly; Alan J.,15,0,15,0
1745787991929,EDS 290,A00,897211,Hofstetter; Carolyn,15,0,15,0
1745787992955,LIGM 5A,A00,896162,Fischer-Grunski; Eva K,15,0,20,5
1745787993986,LIGM 5B,A00,896260,Fischer-Grunski; Eva K,17,0,20,3
1745787995040,LIGM 5C,A00,896308,Fischer-Grunski; Eva K,18,0,20,2
1745787996071,LIIT 5AS,A00,896313,Carnelos; Chiara,18,0,20,2
1745787997102,LIIT 5BS,A00,896416,Carnelos; Chiara,20,0,20,0
1745787998129,LIIT 5CS,A00,896564,Carnelos; Chiara,20,0,20,0
1745787999159,LISP 5A,A00,896588,Munoz Sanchez; Alicia,4,0,20,16
1745788000185,LISP 5B,A00,896653,Munoz Sanchez; Alicia,10,0,20,10
1745788001214,LISP 5C,A00,896655,Munoz Sanchez; Alicia,4,0,20,16
1745788002242,MAE 197,001,957918,Kleissl; Jan,9998,0,9999,1
1745788003267,MATH 2,A01,957937,Staff,34,0,35,1
1745788004294,MATH 197,001,957876,Kedlaya; Kiran S.,9993,0,9999,6
1745788005322,MCWP 40,A00,892729,Duru; Nur,13,0,20,7
1745788005322,MCWP 40,B00,893304,Montejo; Carolina,20,0,20,0
1745788006349,MCWP 40R,A00,893757,Redela; Pamela Morgan,0,6,20,20
1745788007378,MCWP 50,A00,893758,Morshed; Michael James,2,0,20,18
1745788007378,MCWP 50,B00,893761,Bartulis; Jason Michael,17,0,20,3
1745788008408,MCWP 50R,A00,893766,Compas; Sean Matthew,0,1,20,20
1745788008408,MCWP 50R,B00,893769,Carter; Jennifer A,0,0,20,20
1745788008408,MCWP 50R,C00,893771,Krone; Jarret,0,3,20,20
1745788008408,MCWP 50R,D00,893772,Miller; Elizabeth Deen,3,0,20,17
1745788008408,MCWP 50R,E00,893775,Carter; Andrea L,0,0,20,20
1745788009433,MMW 11R,A01,892721,Herbst; Matthew,11,0,27,16
1745788009433,MMW 11R,A02,892722,Herbst; Matthew,0,0,0,3
1745788010458,MMW 12R,A01,892724,Herbst; Matthew,0,9,16,16
1745788010458,MMW 12R,A02,892725,Herbst; Matthew,0,9,16,16
1745788011483,MMW 13R,A01,892727,Staff,0,3,16,16
1745788011483,MMW 13R,A02,892728,Staff,0,4,16,16
1745788011483,MMW 13R,A03,958032,Staff,0,3,16,16
1745788011483,MMW 13R,A04,958033,Staff,0,2,16,16
1745788011483,MMW 13R,A05,958034,Staff,0,3,16,16
1745788012512,SIO 295LS,A00,894015,Staff,7,0,25,18
1745788013538,SIO 295S,A00,894020,Staff,7,0,25,18
1745788014565,SIOC 290S,B01,958918,Staff,0,0,0,0
1745788015591,SIOC 291S,B01,958922,Staff,0,0,0,0
1745788016620,SOCI 117,A01,895339,Staff,4,0,5,1
1745788017647,WES 237B,A00,894149,Staff,11,0,20,9
1745788019713,AESE 279B,A00,891859,Staff,13,0,35,22
1745788020741,AIP 197,001,891854,Staff,70,0,70,0
1745788021770,ANTH 289S,A00,891856,Gagneux; Pascal,12,0,12,0
1745788022798,BENG 196,001,957946,Engler; Adam J.,9996,0,9999,3
1745788023824,CAT 124RS,A01,956906,Staff,8,0,25,17
1745788024850,CAT 125RS,A01,922013,Staff,8,0,25,17
1745788025878,CLRE 250,A00,891860,Morris; Sheldon,9995,0,9999,4
1745788027933,CLRE 251R,A00,907817,Mehta; Ravindra L.,9994,0,9999,5
1745788028962,CLRE 252,A00,891864,Cuomo; Raphael Eduardo,9993,0,9999,6
1745788029987,CLRE 253,A00,891867,Vaida; Florin,9994,0,9999,5
1745788029987,CLRE 253,B00,907819,Staff,9999,0,9999,0
1745788031013,CLRE 259,A00,891868,Patel; Hemal,9998,0,9999,1
1745788032038,CLRE 260,A00,891872,Cuomo; Raphael Eduardo,9999,0,9999,0
1745788033065,CLRE 297,001,891888,Cuomo; Raphael Eduardo,9999,0,9999,0
1745788034089,CSE 191,A00,958773,Minnes Kemp; Mor Mia,9999,0,9999,0
1745788035116,CSS 201S,A01,892054,Mignozzetti; Umberto,30,0,30,0
1745788036147,CSS 202S,A01,892056,Mignozzetti; Umberto,30,0,30,0
1745788037174,DSC 197,001,956898,Eldridge; Justin Matthew,9998,0,9999,1
1745788038199,DSC 297,001,958000,Mazumdar; Arya,9998,0,9999,1
1745788039224,EAP 100,A00,905686,Staff,9776,0,9999,223
1745788040255,ECE 45,A01,892618,Staff,0,12,50,50
1745788041282,ECE 109,A01,892620,Staff,0,43,0,0
1745788042313,ECE 111,A01,892719,Staff,0,7,50,50
1745788043341,ECE 197,001,957920,Mercier; Patrick Philip,9992,0,9999,7
1745788044370,ECON 178,A01,907814,Zhu; Ying,28,0,35,7
1745788045397,EDS 115,A00,895312,Staff,41,0,45,4
1745788046426,EDS 117,A01,895337,Staff,30,0,30,0
1745788047455,EDS 125,A00,895341,Jones; Gabrielle Anastasia,43,0,45,2
1745788048481,EDS 128A,A01,895459,Fargason; Sharon Gayle,44,0,45,1
1745788049508,EDS 128B,A01,895543,Pappas; Elizabeth,44,0,45,1
1745788050536,EDS 139,A00,897203,Pappas; Elizabeth,44,0,45,1
1745788050536,EDS 139,B00,897209,Fargason; Sharon Gayle,44,0,45,1
1745788051562,EDS 201,A00,895545,Staff,43,0,45,2
1745788052587,EDS 203,A01,895581,Halter; Christopher P.,43,0,45,2
1745788053617,EDS 204R,A01,895625,Heinzman; Erica M.,43,0,45,2
1745788053617,EDS 204R,B01,895693,Halter; Christopher P.,18,0,45,27
1745788054644,EDS 206R,A00,895694,Fargason; Sharon Gayle,9,0,30,21
1745788054644,EDS 206R,B00,895695,Choi; Bailey Miyeon,20,0,30,10
1745788055671,EDS 250,A00,895697,Hemans; Patricia Ann Benitez,43,0,45,2
1745788056700,EDS 281,A00,895701,Meyerott; Theresa Ann,15,0,15,0
1745788057724,EDS 284,A00,895736,Meyerott; Theresa Ann,15,0,15,0
1745788058753,EDS 286,A00,897210,Fine; Sarah,15,0,15,0
1745788059778,EDS 289C,A01,895770,Daly; Alan J.,15,0,15,0
1745788060804,EDS 290,A00,897211,Hofstetter; Carolyn,15,0,15,0
1745788061829,LIGM 5A,A00,896162,Fischer-Grunski; Eva K,15,0,20,5
1745788062858,LIGM 5B,A00,896260,Fischer-Grunski; Eva K,17,0,20,3
1745788063884,LIGM 5C,A00,896308,Fischer-Grunski; Eva K,18,0,20,2
1745788064911,LIIT 5AS,A00,896313,Carnelos; Chiara,18,0,20,2
1745788065941,LIIT 5BS,A00,896416,Carnelos; Chiara,20,0,20,0
1745788066970,LIIT 5CS,A00,896564,Carnelos; Chiara,20,0,20,0
1745788067998,LISP 5A,A00,896588,Munoz Sanchez; Alicia,4,0,20,16
1745788069028,LISP 5B,A00,896653,Munoz Sanchez; Alicia,10,0,20,10
1745788070053,LISP 5C,A00,896655,Munoz Sanchez; Alicia,4,0,20,16
1745788071081,MAE 197,001,957918,Kleissl; Jan,9998,0,9999,1
1745788072110,MATH 2,A01,957937,Staff,34,0,35,1
1745788073136,MATH 197,001,957876,Kedlaya; Kiran S.,9993,0,9999,6
1745788074163,MCWP 40,A00,892729,Duru; Nur,13,0,20,7
1745788074163,MCWP 40,B00,893304,Montejo; Carolina,20,0,20,0
1745788075191,MCWP 40R,A00,893757,Redela; Pamela Morgan,0,6,20,20
1745788076219,MCWP 50,A00,893758,Morshed; Michael James,2,0,20,18
1745788076219,MCWP 50,B00,893761,Bartulis; Jason Michael,17,0,20,3
1745788077249,MCWP 50R,A00,893766,Compas; Sean Matthew,0,1,20,20
1745788077249,MCWP 50R,B00,893769,Carter; Jennifer A,0,0,20,20
1745788077249,MCWP 50R,C00,893771,Krone; Jarret,0,3,20,20
1745788077249,MCWP 50R,D00,893772,Miller; Elizabeth Deen,3,0,20,17
1745788077249,MCWP 50R,E00,893775,Carter; Andrea L,0,0,20,20
1745788078277,MMW 11R,A01,892721,Herbst; Matthew,11,0,27,16
1745788078277,MMW 11R,A02,892722,Herbst; Matthew,0,0,0,3
1745788079304,MMW 12R,A01,892724,Herbst; Matthew,0,9,16,16
1745788079304,MMW 12R,A02,892725,Herbst; Matthew,0,9,16,16
1745788080331,MMW 13R,A01,892727,Staff,0,3,16,16
1745788080331,MMW 13R,A02,892728,Staff,0,4,16,16
1745788080331,MMW 13R,A03,958032,Staff,0,3,16,16
1745788080331,MMW 13R,A04,958033,Staff,0,2,16,16
1745788080331,MMW 13R,A05,958034,Staff,0,3,16,16
1745788081360,SIO 295LS,A00,894015,Staff,7,0,25,18
1745788082389,SIO 295S,A00,894020,Staff,7,0,25,18
1745788083416,SIOC 290S,B01,958918,Staff,0,0,0,0
1745788084444,SIOC 291S,B01,958922,Staff,0,0,0,0
1745788085472,SOCI 117,A01,895339,Staff,4,0,5,1
1745788086497,WES 237B,A00,894149,Staff,11,0,20,9
1745788088567,AESE 279B,A00,891859,Staff,13,0,35,22
1745788089593,AIP 197,001,891854,Staff,70,0,70,0
1745788090623,ANTH 289S,A00,891856,Gagneux; Pascal,12,0,12,0
1745788091648,BENG 196,001,957946,Engler; Adam J.,9996,0,9999,3
1745788092673,CAT 124RS,A01,956906,Staff,8,0,25,17
1745788093697,CAT 125RS,A01,922013,Staff,8,0,25,17
1745788094726,CLRE 250,A00,891860,Morris; Sheldon,9995,0,9999,4
1745788096777,CLRE 251R,A00,907817,Mehta; Ravindra L.,9994,0,9999,5
1745788097805,CLRE 252,A00,891864,Cuomo; Raphael Eduardo,9993,0,9999,6
1745788098835,CLRE 253,A00,891867,Vaida; Florin,9994,0,9999,5
1745788098835,CLRE 253,B00,907819,Staff,9999,0,9999,0
1745788099864,CLRE 259,A00,891868,Patel; Hemal,9998,0,9999,1
1745788100892,CLRE 260,A00,891872,Cuomo; Raphael Eduardo,9999,0,9999,0
1745788101920,CLRE 297,001,891888,Cuomo; Raphael Eduardo,9999,0,9999,0
1745788102949,CSE 191,A00,958773,Minnes Kemp; Mor Mia,9999,0,9999,0
1745788103980,CSS 201S,A01,892054,Mignozzetti; Umberto,30,0,30,0
1745788105005,CSS 202S,A01,892056,Mignozzetti; Umberto,30,0,30,0
1745788106033,DSC 197,001,956898,Eldridge; Justin Matthew,9998,0,9999,1
1745788107059,DSC 297,001,958000,Mazumdar; Arya,9998,0,9999,1
1745788108086,EAP 100,A00,905686,Staff,9776,0,9999,223
1745788109115,ECE 45,A01,892618,Staff,0,12,50,50
1745788110144,ECE 109,A01,892620,Staff,0,43,0,0
1745788111171,ECE 111,A01,892719,Staff,0,7,50,50
1745788112196,ECE 197,001,957920,Mercier; Patrick Philip,9992,0,9999,7
1745788113226,ECON 178,A01,907814,Zhu; Ying,28,0,35,7
1745788114252,EDS 115,A00,895312,Staff,41,0,45,4
1745788115284,EDS 117,A01,895337,Staff,30,0,30,0
1745788116310,EDS 125,A00,895341,Jones; Gabrielle Anastasia,43,0,45,2
1745788117338,EDS 128A,A01,895459,Fargason; Sharon Gayle,44,0,45,1
1745788118365,EDS 128B,A01,895543,Pappas; Elizabeth,44,0,45,1
1745788119395,EDS 139,A00,897203,Pappas; Elizabeth,44,0,45,1
1745788119395,EDS 139,B00,897209,Fargason; Sharon Gayle,44,0,45,1
1745788120425,EDS 201,A00,895545,Staff,43,0,45,2
1745788121452,EDS 203,A01,895581,Halter; Christopher P.,43,0,45,2
1745788122480,EDS 204R,A01,895625,Heinzman; Erica M.,43,0,45,2
1745788122480,EDS 204R,B01,895693,Halter; Christopher P.,18,0,45,27
1745788123510,EDS 206R,A00,895694,Fargason; Sharon Gayle,9,0,30,21
1745788123510,EDS 206R,B00,895695,Choi; Bailey Miyeon,20,0,30,10
1745788124537,EDS 250,A00,895697,Hemans; Patricia Ann Benitez,43,0,45,2
1745788125564,EDS 281,A00,895701,Meyerott; Theresa Ann,15,0,15,0
1745788126590,EDS 284,A00,895736,Meyerott; Theresa Ann,15,0,15,0
1745788127617,EDS 286,A00,897210,Fine; Sarah,15,0,15,0
1745788128646,EDS 289C,A01,895770,Daly; Alan J.,15,0,15,0
1745788129671,EDS 290,A00,897211,Hofstetter; Carolyn,15,0,15,0
1745788130698,LIGM 5A,A00,896162,Fischer-Grunski; Eva K,15,0,20,5
1745788131729,LIGM 5B,A00,896260,Fischer-Grunski; Eva K,17,0,20,3
1745788132755,LIGM 5C,A00,896308,Fischer-Grunski; Eva K,18,0,20,2
1745788133782,LIIT 5AS,A00,896313,Carnelos; Chiara,18,0,20,2
1745788134812,LIIT 5BS,A00,896416,Carnelos; Chiara,20,0,20,0
1745788135839,LIIT 5CS,A00,896564,Carnelos; Chiara,20,0,20,0
1745788136870,LISP 5A,A00,896588,Munoz Sanchez; Alicia,4,0,20,16
1745788137896,LISP 5B,A00,896653,Munoz Sanchez; Alicia,10,0,20,10
1745788138924,LISP 5C,A00,896655,Munoz Sanchez; Alicia,4,0,20,16
1745788139954,MAE 197,001,957918,Kleissl; Jan,9998,0,9999,1
1745788140981,MATH 2,A01,957937,Staff,34,0,35,1
1745788142011,MATH 197,001,957876,Kedlaya; Kiran S.,9993,0,9999,6
1745788143043,MCWP 40,A00,892729,Duru; Nur,13,0,20,7
1745788143043,MCWP 40,B00,893304,Montejo; Carolina,20,0,20,0
1745788144076,MCWP 40R,A00,893757,Redela; Pamela Morgan,0,6,20,20
1745788145101,MCWP 50,A00,893758,Morshed; Michael James,2,0,20,18
1745788145101,MCWP 50,B00,893761,Bartulis; Jason Michael,17,0,20,3
1745788146132,MCWP 50R,A00,893766,Compas; Sean Matthew,0,1,20,20
1745788146132,MCWP 50R,B00,893769,Carter; Jennifer A,0,0,20,20
1745788146132,MCWP 50R,C00,893771,Krone; Jarret,0,3,20,20
1745788146132,MCWP 50R,D00,893772,Miller; Elizabeth Deen,3,0,20,17
1745788146132,MCWP 50R,E00,893775,Carter; Andrea L,0,0,20,20
1745788147160,MMW 11R,A01,892721,Herbst; Matthew,11,0,27,16
1745788147160,MMW 11R,A02,892722,Herbst; Matthew,0,0,0,3
1745788148187,MMW 12R,A01,892724,Herbst; Matthew,0,9,16,16
1745788148187,MMW 12R,A02,892725,Herbst; Matthew,0,9,16,16
1745788149215,MMW 13R,A01,892727,Staff,0,3,16,16
1745788149215,MMW 13R,A02,892728,Staff,0,4,16,16
1745788149215,MMW 13R,A03,958032,Staff,0,3,16,16
1745788149215,MMW 13R,A04,958033,Staff,0,2,16,16
1745788149215,MMW 13R,A05,958034,Staff,0,3,16,16
1745788150244,SIO 295LS,A00,894015,Staff,7,0,25,18
1745788151271,SIO 295S,A00,894020,Staff,7,0,25,18
1745788152302,SIOC 290S,B01,958918,Staff,0,0,0,0
1745788153331,SIOC 291S,B01,958922,Staff,0,0,0,0
1745788154360,SOCI 117,A01,895339,Staff,4,0,5,1
1745788155385,WES 237B,A00,894149,Staff,11,0,20,9
1745788157442,AESE 279B,A00,891859,Staff,13,0,35,22
1745788158468,AIP 197,001,891854,Staff,70,0,70,0
1745788159495,ANTH 289S,A00,891856,Gagneux; Pascal,12,0,12,0
1745788160521,BENG 196,001,957946,Engler; Adam J.,9996,0,9999,3
1745788161550,CAT 124RS,A01,956906,Staff,8,0,25,17
1745788162577,CAT 125RS,A01,922013,Staff,8,0,25,17
1745788163604,CLRE 250,A00,891860,Morris; Sheldon,9995,0,9999,4
1745788165655,CLRE 251R,A00,907817,Mehta; Ravindra L.,9994,0,9999,5
1745788166683,CLRE 252,A00,891864,Cuomo; Raphael Eduardo,9993,0,9999,6
1745788167713,CLRE 253,A00,891867,Vaida; Florin,9994,0,9999,5
1745788167713,CLRE 253,B00,907819,Staff,9999,0,9999,0
1745788168738,CLRE 259,A00,891868,Patel; Hemal,9998,0,9999,1
1745788169766,CLRE 260,A00,891872,Cuomo; Raphael Eduardo,9999,0,9999,0
1745788170793,CLRE 297,001,891888,Cuomo; Raphael Eduardo,9999,0,9999,0
1745788171821,CSE 191,A00,958773,Minnes Kemp; Mor Mia,9999,0,9999,0
1745788172850,CSS 201S,A01,892054,Mignozzetti; Umberto,30,0,30,0
1745788173881,CSS 202S,A01,892056,Mignozzetti; Umberto,30,0,30,0
1745788174910,DSC 197,001,956898,Eldridge; Justin Matthew,9998,0,9999,1
1745788175936,DSC 297,001,958000,Mazumdar; Arya,9998,0,9999,1
1745788176962,EAP 100,A00,905686,Staff,9776,0,9999,223
1745788177991,ECE 45,A01,892618,Staff,0,12,50,50
1745788179016,ECE 109,A01,892620,Staff,0,43,0,0
1745788180046,ECE 111,A01,892719,Staff,0,7,50,50
1745788181070,ECE 197,001,957920,Mercier; Patrick Philip,9992,0,9999,7
1745788182102,ECON 178,A01,907814,Zhu; Ying,28,0,35,7
1745788183132,EDS 115,A00,895312,Staff,41,0,45,4
1745788184158,EDS 117,A01,895337,Staff,30,0,30,0
1745788185183,EDS 125,A00,895341,Jones; Gabrielle Anastasia,43,0,45,2
1745788186212,EDS 128A,A01,895459,Fargason; Sharon Gayle,44,0,45,1
1745788187239,EDS 128B,A01,895543,Pappas; Elizabeth,44,0,45,1
1745788188266,EDS 139,A00,897203,Pappas; Elizabeth,44,0,45,1
1745788188266,EDS 139,B00,897209,Fargason; Sharon Gayle,44,0,45,1
1745788189291,EDS 201,A00,895545,Staff,43,0,45,2
1745788190319,EDS 203,A01,895581,Halter; Christopher P.,43,0,45,2
1745788191345,EDS 204R,A01,895625,Heinzman; Erica M.,43,0,45,2
1745788191345,EDS 204R,B01,895693,Halter; Christopher P.,18,0,45,27
1745788192374,EDS 206R,A00,895694,Fargason; Sharon Gayle,9,0,30,21
1745788192374,EDS 206R,B00,895695,Choi; Bailey Miyeon,20,0,30,10
1745788193403,EDS 250,A00,895697,Hemans; Patricia Ann Benitez,43,0,45,2
1745788194428,EDS 281,A00,895701,Meyerott; Theresa Ann,15,0,15,0
1745788195457,EDS 284,A00,895736,Meyerott; Theresa Ann,15,0,15,0
1745788196483,EDS 286,A00,897210,Fine; Sarah,15,0,15,0
1745788197510,EDS 289C,A01,895770,Daly; Alan J.,15,0,15,0
1745788198537,EDS 290,A00,897211,Hofstetter; Carolyn,15,0,15,0
1745788199563,LIGM 5A,A00,896162,Fischer-Grunski; Eva K,15,0,20,5
1745788200592,LIGM 5B,A00,896260,Fischer-Grunski; Eva K,17,0,20,3
1745788201620,LIGM 5C,A00,896308,Fischer-Grunski; Eva K,18,0,20,2
1745788202658,LIIT 5AS,A00,896313,Carnelos; Chiara,18,0,20,2
1745788203688,LIIT 5BS,A00,896416,Carnelos; Chiara,20,0,20,0
1745788204716,LIIT 5CS,A00,896564,Carnelos; Chiara,20,0,20,0
1745788205744,LISP 5A,A00,896588,Munoz Sanchez; Alicia,4,0,20,16
1745788206771,LISP 5B,A00,896653,Munoz Sanchez; Alicia,10,0,20,10
1745788207801,LISP 5C,A00,896655,Munoz Sanchez; Alicia,4,0,20,16
1745788208828,MAE 197,001,957918,Kleissl; Jan,9998,0,9999,1
1745788209854,MATH 2,A01,957937,Staff,34,0,35,1
1745788210880,MATH 197,001,957876,Kedlaya; Kiran S.,9993,0,9999,6
1745788211905,MCWP 40,A00,892729,Duru; Nur,13,0,20,7
1745788211905,MCWP 40,B00,893304,Montejo; Carolina,20,0,20,0
1745788212933,MCWP 40R,A00,893757,Redela; Pamela Morgan,0,6,20,20
1745788213963,MCWP 50,A00,893758,Morshed; Michael James,2,0,20,18
1745788213963,MCWP 50,B00,893761,Bartulis; Jason Michael,17,0,20,3
1745788214997,MCWP 50R,A00,893766,Compas; Sean Matthew,0,1,20,20
1745788214997,MCWP 50R,B00,893769,Carter; Jennifer A,0,0,20,20
1745788214997,MCWP 50R,C00,893771,Krone; Jarret,0,3,20,20
1745788214997,MCWP 50R,D00,893772,Miller; Elizabeth Deen,3,0,20,17
1745788214997,MCWP 50R,E00,893775,Carter; Andrea L,0,0,20,20
1745788216025,MMW 11R,A01,892721,Herbst; Matthew,11,0,27,16
1745788216025,MMW 11R,A02,892722,Herbst; Matthew,0,0,0,3
1745788217055,MMW 12R,A01,892724,Herbst; Matthew,0,9,16,16
1745788217055,MMW 12R,A02,892725,Herbst; Matthew,0,9,16,16
1745788218081,MMW 13R,A01,892727,Staff,0,3,16,16
1745788218081,MMW 13R,A02,892728,Staff,0,4,16,16
1745788218081,MMW 13R,A03,958032,Staff,0,3,16,16
1745788218081,MMW 13R,A04,958033,Staff,0,2,16,16
1745788218081,MMW 13R,A05,958034,Staff,0,3,16,16
1745788219109,SIO 295LS,A00,894015,Staff,7,0,25,18
1745788220135,SIO 295S,A00,894020,Staff,7,0,25,18
1745788221165,SIOC 290S,B01,958918,Staff,0,0,0,0
1745788222191,SIOC 291S,B01,958922,Staff,0,0,0,0
1745788223218,SOCI 117,A01,895339,Staff,4,0,5,1
1745788224245,WES 237B,A00,894149,Staff,11,0,20,9
1745788226303,AESE 279B,A00,891859,Staff,13,0,35,22
1745788227330,AIP 197,001,891854,Staff,70,0,70,0
1745788228360,ANTH 289S,A00,891856,Gagneux; Pascal,12,0,12,0
1745788229387,BENG 196,001,957946,Engler; Adam J.,9996,0,9999,3
1745788230415,CAT 124RS,A01,956906,Staff,8,0,25,17
1745788231444,CAT 125RS,A01,922013,Staff,8,0,25,17
1745788232468,CLRE 250,A00,891860,Morris; Sheldon,9995,0,9999,4
1745788234522,CLRE 251R,A00,907817,Mehta; Ravindra L.,9994,0,9999,5
1745788235548,CLRE 252,A00,891864,Cuomo; Raphael Eduardo,9993,0,9999,6
1745788236574,CLRE 253,A00,891867,Vaida; Florin,9994,0,9999,5
1745788236574,CLRE 253,B00,907819,Staff,9999,0,9999,0
1745788237599,CLRE 259,A00,891868,Patel; Hemal,9998,0,9999,1
1745788238623,CLRE 260,A00,891872,Cuomo; Raphael Eduardo,9999,0,9999,0
1745788239651,CLRE 297,001,891888,Cuomo; Raphael Eduardo,9999,0,9999,0
1745788240674,CSE 191,A00,958773,Minnes Kemp; Mor Mia,9999,0,9999,0
1745788241701,CSS 201S,A01,892054,Mignozzetti; Umberto,30,0,30,0
1745788242729,CSS 202S,A01,892056,Mignozzetti; Umberto,30,0,30,0
1745788243754,DSC 197,001,956898,Eldridge; Justin Matthew,9998,0,9999,1
1745788244778,DSC 297,001,958000,Mazumdar; Arya,9998,0,9999,1
1745788245804,EAP 100,A00,905686,Staff,9776,0,9999,223
1745788246832,ECE 45,A01,892618,Staff,0,12,50,50
1745788247857,ECE 109,A01,892620,Staff,0,43,0,0
1745788248884,ECE 111,A01,892719,Staff,0,7,50,50
1745788249912,ECE 197,001,957920,Mercier; Patrick Philip,9992,0,9999,7
1745788250941,ECON 178,A01,907814,Zhu; Ying,28,0,35,7
1745788251966,EDS 115,A00,895312,Staff,41,0,45,4
1745788252991,EDS 117,A01,895337,Staff,30,0,30,0
1745788254020,EDS 125,A00,895341,Jones; Gabrielle Anastasia,43,0,45,2
1745788255048,EDS 128A,A01,895459,Fargason; Sharon Gayle,44,0,45,1
1745788256077,EDS 128B,A01,895543,Pappas; Elizabeth,44,0,45,1
1745788257106,EDS 139,A00,897203,Pappas; Elizabeth,44,0,45,1
1745788257106,EDS 139,B00,897209,Fargason; Sharon Gayle,44,0,45,1
1745788258131,EDS 201,A00,895545,Staff,43,0,45,2
1745788259158,EDS 203,A01,895581,Halter; Christopher P.,43,0,45,2
1745788260185,EDS 204R,A01,895625,Heinzman; Erica M.,43,0,45,2
1745788260185,EDS 204R,B01,895693,Halter; Christopher P.,18,0,45,27
1745788261215,EDS 206R,A00,895694,Fargason; Sharon Gayle,9,0,30,21
1745788261215,EDS 206R,B00,895695,Choi; Bailey Miyeon,20,0,30,10
1745788262244,EDS 250,A00,895697,Hemans; Patricia Ann Benitez,43,0,45,2
1745788263269,EDS 281,A00,895701,Meyerott; Theresa Ann,15,0,15,0
1745788264295,EDS 284,A00,895736,Meyerott; Theresa Ann,15,0,15,0
1745788265321,EDS 286,A00,897210,Fine; Sarah,15,0,15,0
1745788266347,EDS 289C,A01,895770,Daly; Alan J.,15,0,15,0
1745788267376,EDS 290,A00,897211,Hofstetter; Carolyn,15,0,15,0
1745788268404,LIGM 5A,A00,896162,Fischer-Grunski; Eva K,15,0,20,5
1745788269432,LIGM 5B,A00,896260,Fischer-Grunski; Eva K,17,0,20,3
1745788270457,LIGM 5C,A00,896308,Fischer-Grunski; Eva K,18,0,20,2
1745788271486,LIIT 5AS,A00,896313,Carnelos; Chiara,18,0,20,2
1745788272516,LIIT 5BS,A00,896416,Carnelos; Chiara,20,0,20,0
1745788273541,LIIT 5CS,A00,896564,Carnelos; Chiara,20,0,20,0
1745788274566,LISP 5A,A00,896588,Munoz Sanchez; Alicia,4,0,20,16
1745788275594,LISP 5B,A00,896653,Munoz Sanchez; Alicia,10,0,20,10
1745788276623,LISP 5C,A00,896655,Munoz Sanchez; Alicia,4,0,20,16
1745788277651,MAE 197,001,957918,Kleissl; Jan,9998,0,9999,1
1745788278678,MATH 2,A01,957937,Staff,34,0,35,1
1745788279702,MATH 197,001,957876,Kedlaya; Kiran S.,9993,0,9999,6
1745788280729,MCWP 40,A00,892729,Duru; Nur,13,0,20,7
1745788280729,MCWP 40,B00,893304,Montejo; Carolina,20,0,20,0
1745788281756,MCWP 40R,A00,893757,Redela; Pamela Morgan,0,6,20,20
1745788282781,MCWP 50,A00,893758,Morshed; Michael James,2,0,20,18
1745788282781,MCWP 50,B00,893761,Bartulis; Jason Michael,17,0,20,3
1745788283808,MCWP 50R,A00,893766,Compas; Sean Matthew,0,1,20,20
1745788283808,MCWP 50R,B00,893769,Carter; Jennifer A,0,0,20,20
1745788283808,MCWP 50R,C00,893771,Krone; Jarret,0,3,20,20
1745788283808,MCWP 50R,D00,893772,Miller; Elizabeth Deen,3,0,20,17
1745788283808,MCWP 50R,E00,893775,Carter; Andrea L,0,0,20,20
1745788284837,MMW 11R,A01,892721,Herbst; Matthew,11,0,27,16
1745788284837,MMW 11R,A02,892722,Herbst; Matthew,0,0,0,3
1745788285863,MMW 12R,A01,892724,Herbst; Matthew,0,9,16,16
1745788285863,MMW 12R,A02,892725,Herbst; Matthew,0,9,16,16
1745788286891,MMW 13R,A01,892727,Staff,0,3,16,16
1745788286891,MMW 13R,A02,892728,Staff,0,4,16,16
1745788286891,MMW 13R,A03,958032,Staff,0,3,16,16
1745788286891,MMW 13R,A04,958033,Staff,0,2,16,16
1745788286891,MMW 13R,A05,958034,Staff,0,3,16,16
1745788287920,SIO 295LS,A00,894015,Staff,7,0,25,18
1745788288948,SIO 295S,A00,894020,Staff,7,0,25,18
1745788289975,SIOC 290S,B01,958918,Staff,0,0,0,0
1745788291004,SIOC 291S,B01,958922,Staff,0,0,0,0
1745788292031,SOCI 117,A01,895339,Staff,4,0,5,1
1745788293057,WES 237B,A00,894149,Staff,11,0,20,9
1745788295126,AESE 279B,A00,891859,Staff,13,0,35,22
1745788296154,AIP 197,001,891854,Staff,70,0,70,0
1745788297181,ANTH 289S,A00,891856,Gagneux; Pascal,12,0,12,0
1745788298209,BENG 196,001,957946,Engler; Adam J.,9996,0,9999,3
1745788299238,CAT 124RS,A01,956906,Staff,8,0,25,17
1745788300265,CAT 125RS,A01,922013,Staff,8,0,25,17
1745788301291,CLRE 250,A00,891860,Morris; Sheldon,9995,0,9999,4
1745788303346,CLRE 251R,A00,907817,Mehta; Ravindra L.,9994,0,9999,5
1745788304371,CLRE 252,A00,891864,Cuomo; Raphael Eduardo,9993,0,9999,6
1745788305403,CLRE 253,A00,891867,Vaida; Florin,9994,0,9999,5
1745788305403,CLRE 253,B00,907819,Staff,9999,0,9999,0
1745788306429,CLRE 259,A00,891868,Patel; Hemal,9998,0,9999,1
1745788307455,CLRE 260,A00,891872,Cuomo; Raphael Eduardo,9999,0,9999,0
1745788308483,CLRE 297,001,891888,Cuomo; Raphael Eduardo,9999,0,9999,0
1745788309511,CSE 191,A00,958773,Minnes Kemp; Mor Mia,9999,0,9999,0
1745788310541,CSS 201S,A01,892054,Mignozzetti; Umberto,30,0,30,0
1745788311572,CSS 202S,A01,892056,Mignozzetti; Umberto,30,0,30,0
1745788312598,DSC 197,001,956898,Eldridge; Justin Matthew,9998,0,9999,1
1745788313629,DSC 297,001,958000,Mazumdar; Arya,9998,0,9999,1
1745788314657,EAP 100,A00,905686,Staff,9776,0,9999,223
1745788315683,ECE 45,A01,892618,Staff,0,12,50,50
1745788316709,ECE 109,A01,892620,Staff,0,43,0,0
1745788317734,ECE 111,A01,892719,Staff,0,7,50,50
1745788318763,ECE 197,001,957920,Mercier; Patrick Philip,9992,0,9999,7
1745788319791,ECON 178,A01,907814,Zhu; Ying,28,0,35,7
1745788320816,EDS 115,A00,895312,Staff,41,0,45,4
1745788321850,EDS 117,A01,895337,Staff,30,0,30,0
1745788322880,EDS 125,A00,895341,Jones; Gabrielle Anastasia,43,0,45,2
1745788323907,EDS 128A,A01,895459,Fargason; Sharon Gayle,44,0,45,1
1745788324937,EDS 128B,A01,895543,Pappas; Elizabeth,44,0,45,1
1745788325965,EDS 139,A00,897203,Pappas; Elizabeth,44,0,45,1
1745788325965,EDS 139,B00,897209,Fargason; Sharon Gayle,44,0,45,1
1745788326993,EDS 201,A00,895545,Staff,43,0,45,2
1745788328020,EDS 203,A01,895581,Halter; Christopher P.,43,0,45,2
1745788329046,EDS 204R,A01,895625,Heinzman; Erica M.,43,0,45,2
1745788329046,EDS 204R,B01,895693,Halter; Christopher P.,18,0,45,27
1745788330072,EDS 206R,A00,895694,Fargason; Sharon Gayle,9,0,30,21
1745788330072,EDS 206R,B00,895695,Choi; Bailey Miyeon,20,0,30,10
1745788331098,EDS 250,A00,895697,Hemans; Patricia Ann Benitez,43,0,45,2
1745788332124,EDS 281,A00,895701,Meyerott; Theresa Ann,15,0,15,0
1745788333151,EDS 284,A00,895736,Meyerott; Theresa Ann,15,0,15,0
1745788334177,EDS 286,A00,897210,Fine; Sarah,15,0,15,0
1745788335204,EDS 289C,A01,895770,Daly; Alan J.,15,0,15,0
1745788336233,EDS 290,A00,897211,Hofstetter; Carolyn,15,0,15,0
1745788337259,LIGM 5A,A00,896162,Fischer-Grunski; Eva K,15,0,20,5
1745788338287,LIGM 5B,A00,896260,Fischer-Grunski; Eva K,17,0,20,3
1745788339317,LIGM 5C,A00,896308,Fischer-Grunski; Eva K,18,0,20,2
1745788340348,LIIT 5AS,A00,896313,Carnelos; Chiara,18,0,20,2
1745788341374,LIIT 5BS,A00,896416,Carnelos; Chiara,20,0,20,0
1745788342401,LIIT 5CS,A00,896564,Carnelos; Chiara,20,0,20,0
1745788343426,LISP 5A,A00,896588,Munoz Sanchez; Alicia,4,0,20,16
1745788344452,LISP 5B,A00,896653,Munoz Sanchez; Alicia,10,0,20,10
1745788345477,LISP 5C,A00,896655,Munoz Sanchez; Alicia,4,0,20,16
1745788346511,MAE 197,001,957918,Kleissl; Jan,9998,0,9999,1
1745788347541,MATH 2,A01,957937,Staff,34,0,35,1
1745788348566,MATH 197,001,957876,Kedlaya; Kiran S.,9993,0,9999,6
1745788349592,MCWP 40,A00,892729,Duru; Nur,13,0,20,7
1745788349592,MCWP 40,B00,893304,Montejo; Carolina,20,0,20,0
1745788350620,MCWP 40R,A00,893757,Redela; Pamela Morgan,0,6,20,20
1745788351647,MCWP 50,A00,893758,Morshed; Michael James,2,0,20,18
1745788351647,MCWP 50,B00,893761,Bartulis; Jason Michael,17,0,20,3
1745788352673,MCWP 50R,A00,893766,Compas; Sean Matthew,0,1,20,20
1745788352673,MCWP 50R,B00,893769,Carter; Jennifer A,0,0,20,20
1745788352673,MCWP 50R,C00,893771,Krone; Jarret,0,3,20,20
1745788352673,MCWP 50R,D00,893772,Miller; Elizabeth Deen,3,0,20,17
1745788352673,MCWP 50R,E00,893775,Carter; Andrea L,0,0,20,20
1745788353699,MMW 11R,A01,892721,Herbst; Matthew,11,0,27,16
1745788353699,MMW 11R,A02,892722,Herbst; Matthew,0,0,0,3
1745788354725,MMW 12R,A01,892724,Herbst; Matthew,0,9,16,16
1745788354725,MMW 12R,A02,892725,Herbst; Matthew,0,9,16,16
1745788355755,MMW 13R,A01,892727,Staff,0,3,16,16
1745788355755,MMW 13R,A02,892728,Staff,0,4,16,16
1745788355755,MMW 13R,A03,958032,Staff,0,3,16,16
1745788355755,MMW 13R,A04,958033,Staff,0,2,16,16
1745788355755,MMW 13R,A05,958034,Staff,0,3,16,16
1745788356781,SIO 295LS,A00,894015,Staff,7,0,25,18
1745788357806,SIO 295S,A00,894020,Staff,7,0,25,18
1745788358832,SIOC 290S,B01,958918,Staff,0,0,0,0
1745788359861,SIOC 291S,B01,958922,Staff,0,0,0,0
1745788360885,SOCI 117,A01,895339,Staff,4,0,5,1
1745788361912,WES 237B,A00,894149,Staff,11,0,20,9
1745788364009,AESE 279B,A00,891859,Staff,13,0,35,22
1745788365039,AIP 197,001,891854,Staff,70,0,70,0
1745788366066,ANTH 289S,A00,891856,Gagneux; Pascal,12,0,12,0
1745788367092,BENG 196,001,957946,Engler; Adam J.,9996,0,9999,3
1745788368121,CAT 124RS,A01,956906,Staff,8,0,25,17
1745788369149,CAT 125RS,A01,922013,Staff,8,0,25,17
1745788370173,CLRE 250,A00,891860,Morris; Sheldon,9995,0,9999,4
1745788372227,CLRE 251R,A00,907817,Mehta; Ravindra L.,9994,0,9999,5
1745788373251,CLRE 252,A00,891864,Cuomo; Raphael Eduardo,9993,0,9999,6
1745788374279,CLRE 253,A00,891867,Vaida; Florin,9994,0,9999,5
1745788374279,CLRE 253,B00,907819,Staff,9999,0,9999,0
1745788375308,CLRE 259,A00,891868,Patel; Hemal,9998,0,9999,1
1745788376334,CLRE 260,A00,891872,Cuomo; Raphael Eduardo,9999,0,9999,0
1745788377359,CLRE 297,001,891888,Cuomo; Raphael Eduardo,9999,0,9999,0
1745788378387,CSE 191,A00,958773,Minnes Kemp; Mor Mia,9999,0,9999,0
1745788379413,CSS 201S,A01,892054,Mignozzetti; Umberto,30,0,30,0
1745788380442,CSS 202S,A01,892056,Mignozzetti; Umberto,30,0,30,0
1745788381466,DSC 197,001,956898,Eldridge; Justin Matthew,9998,0,9999,1
1745788382493,DSC 297,001,958000,Mazumdar; Arya,9998,0,9999,1
1745788383520,EAP 100,A00,905686,Staff,9776,0,9999,223
1745788384549,ECE 45,A01,892618,Staff,0,12,50,50
1745788385577,ECE 109,A01,892620,Staff,0,43,0,0
1745788386604,ECE 111,A01,892719,Staff,0,7,50,50
1745788387632,ECE 197,001,957920,Mercier; Patrick Philip,9992,0,9999,7
1745788388660,ECON 178,A01,907814,Zhu; Ying,28,0,35,7
1745788389685,EDS 115,A00,895312,Staff,41,0,45,4
1745788390711,EDS 117,A01,895337,Staff,30,0,30,0
1745788391736,EDS 125,A00,895341,Jones; Gabrielle Anastasia,43,0,45,2
1745788392763,EDS 128A,A01,895459,Fargason; Sharon Gayle,44,0,45,1
1745788393793,EDS 128B,A01,895543,Pappas; Elizabeth,44,0,45,1
1745788394819,EDS 139,A00,897203,Pappas; Elizabeth,44,0,45,1
1745788394819,EDS 139,B00,897209,Fargason; Sharon Gayle,44,0,45,1
1745788395848,EDS 201,A00,895545,Staff,43,0,45,2
1745788396874,EDS 203,A01,895581,Halter; Christopher P.,43,0,45,2
1745788397900,EDS 204R,A01,895625,Heinzman; Erica M.,43,0,45,2
1745788397900,EDS 204R,B01,895693,Halter; Christopher P.,18,0,45,27
1745788398929,EDS 206R,A00,895694,Fargason; Sharon Gayle,9,0,30,21
1745788398929,EDS 206R,B00,895695,Choi; Bailey Miyeon,20,0,30,10
1745788399957,EDS 250,A00,895697,Hemans; Patricia Ann Benitez,43,0,45,2
1745788400984,EDS 281,A00,895701,Meyerott; Theresa Ann,15,0,15,0
1745788402012,EDS 284,A00,895736,Meyerott; Theresa Ann,15,0,15,0
1745788403041,EDS 286,A00,897210,Fine; Sarah,15,0,15,0
1745788404071,EDS 289C,A01,895770,Daly; Alan J.,15,0,15,0
1745788405096,EDS 290,A00,897211,Hofstetter; Carolyn,15,0,15,0
1745788406125,LIGM 5A,A00,896162,Fischer-Grunski; Eva K,15,0,20,5
1745788407151,LIGM 5B,A00,896260,Fischer-Grunski; Eva K,17,0,20,3
1745788408178,LIGM 5C,A00,896308,Fischer-Grunski; Eva K,18,0,20,2
1745788409204,LIIT 5AS,A00,896313,Carnelos; Chiara,18,0,20,2
1745788410234,LIIT 5BS,A00,896416,Carnelos; Chiara,20,0,20,0
1745788411262,LIIT 5CS,A00,896564,Carnelos; Chiara,20,0,20,0
1745788412288,LISP 5A,A00,896588,Munoz Sanchez; Alicia,4,0,20,16
1745788413314,LISP 5B,A00,896653,Munoz Sanchez; Alicia,10,0,20,10
1745788414341,LISP 5C,A00,896655,Munoz Sanchez; Alicia,4,0,20,16
1745788415369,MAE 197,001,957918,Kleissl; Jan,9998,0,9999,1
1745788416395,MATH 2,A01,957937,Staff,34,0,35,1
1745788417424,MATH 197,001,957876,Kedlaya; Kiran S.,9993,0,9999,6
1745788418451,MCWP 40,A00,892729,Duru; Nur,13,0,20,7
1745788418451,MCWP 40,B00,893304,Montejo; Carolina,20,0,20,0
1745788419482,MCWP 40R,A00,893757,Redela; Pamela Morgan,0,6,20,20
1745788420511,MCWP 50,A00,893758,Morshed; Michael James,2,0,20,18
1745788420511,MCWP 50,B00,893761,Bartulis; Jason Michael,17,0,20,3
1745788421540,MCWP 50R,A00,893766,Compas; Sean Matthew,0,1,20,20
1745788421540,MCWP 50R,B00,893769,Carter; Jennifer A,0,0,20,20
1745788421540,MCWP 50R,C00,893771,Krone; Jarret,0,3,20,20
1745788421540,MCWP 50R,D00,893772,Miller; Elizabeth Deen,3,0,20,17
1745788421540,MCWP 50R,E00,893775,Carter; Andrea L,0,0,20,20
1745788422567,MMW 11R,A01,892721,Herbst; Matthew,11,0,27,16
1745788422567,MMW 11R,A02,892722,Herbst; Matthew,0,0,0,3
1745788423591,MMW 12R,A01,892724,Herbst; Matthew,0,9,16,16
1745788423591,MMW 12R,A02,892725,Herbst; Matthew,0,9,16,16
1745788424617,MMW 13R,A01,892727,Staff,0,3,16,16
1745788424617,MMW 13R,A02,892728,Staff,0,4,16,16
1745788424617,MMW 13R,A03,958032,Staff,0,3,16,16
1745788424617,MMW 13R,A04,958033,Staff,0,2,16,16
1745788424617,MMW 13R,A05,958034,Staff,0,3,16,16
1745788425643,SIO 295LS,A00,894015,Staff,7,0,25,18
1745788426670,SIO 295S,A00,894020,Staff,7,0,25,18
1745788427697,SIOC 290S,B01,958918,Staff,0,0,0,0
1745788428729,SIOC 291S,B01,958922,Staff,0,0,0,0
1745788429756,SOCI 117,A01,895339,Staff,4,0,5,1
1745788430782,WES 237B,A00,894149,Staff,11,0,20,9
1745788432843,AESE 279B,A00,891859,Staff,13,0,35,22
1745788433870,AIP 197,001,891854,Staff,70,0,70,0
1745788434895,ANTH 289S,A00,891856,Gagneux; Pascal,12,0,12,0
1745788435922,BENG 196,001,957946,Engler; Adam J.,9996,0,9999,3
1745788436951,CAT 124RS,A01,956906,Staff,8,0,25,17
1745788437981,CAT 125RS,A01,922013,Staff,8,0,25,17
1745788439008,CLRE 250,A00,891860,Morris; Sheldon,9995,0,9999,4
1745788441059,CLRE 251R,A00,907817,Mehta; Ravindra L.,9994,0,9999,5
1745788442088,CLRE 252,A00,891864,Cuomo; Raphael Eduardo,9993,0,9999,6
1745788443118,CLRE 253,A00,891867,Vaida; Florin,9994,0,9999,5
1745788443118,CLRE 253,B00,907819,Staff,9999,0,9999,0
1745788444143,CLRE 259,A00,891868,Patel; Hemal,9998,0,9999,1
1745788445173,CLRE 260,A00,891872,Cuomo; Raphael Eduardo,9999,0,9999,0
1745788446200,CLRE 297,001,891888,Cuomo; Raphael Eduardo,9999,0,9999,0
1745788447227,CSE 191,A00,958773,Minnes Kemp; Mor Mia,9999,0,9999,0
1745788448259,CSS 201S,A01,892054,Mignozzetti; Umberto,30,0,30,0
1745788449288,CSS 202S,A01,892056,Mignozzetti; Umberto,30,0,30,0
1745788450314,DSC 197,001,956898,Eldridge; Justin Matthew,9998,0,9999,1
1745788451342,DSC 297,001,958000,Mazumdar; Arya,9998,0,9999,1
1745788452381,EAP 100,A00,905686,Staff,9776,0,9999,223
1745788453406,ECE 45,A01,892618,Staff,0,12,50,50
1745788454432,ECE 109,A01,892620,Staff,0,43,0,0
1745788455461,ECE 111,A01,892719,Staff,0,7,50,50
1745788456487,ECE 197,001,957920,Mercier; Patrick Philip,9992,0,9999,7
1745788457517,ECON 178,A01,907814,Zhu; Ying,28,0,35,7
1745788458544,EDS 115,A00,895312,Staff,41,0,45,4
1745788459568,EDS 117,A01,895337,Staff,30,0,30,0
1745788460597,EDS 125,A00,895341,Jones; Gabrielle Anastasia,43,0,45,2
1745788461625,EDS 128A,A01,895459,Fargason; Sharon Gayle,44,0,45,1
1745788462650,EDS 128B,A01,895543,Pappas; Elizabeth,44,0,45,1
1745788463679,EDS 139,A00,897203,Pappas; Elizabeth,44,0,45,1
1745788463679,EDS 139,B00,897209,Fargason; Sharon Gayle,44,0,45,1
1745788464706,EDS 201,A00,895545,Staff,43,0,45,2
1745788465733,EDS 203,A01,895581,Halter; Christopher P.,43,0,45,2
1745788466761,EDS 204R,A01,895625,Heinzman; Erica M.,43,0,45,2
1745788466761,EDS 204R,B01,895693,Halter; Christopher P.,18,0,45,27
1745788467786,EDS 206R,A00,895694,Fargason; Sharon Gayle,9,0,30,21
1745788467786,EDS 206R,B00,895695,Choi; Bailey Miyeon,20,0,30,10
1745788468812,EDS 250,A00,895697,Hemans; Patricia Ann Benitez,43,0,45,2
1745788469841,EDS 281,A00,895701,Meyerott; Theresa Ann,15,0,15,0
1745788470869,EDS 284,A00,895736,Meyerott; Theresa Ann,15,0,15,0
1745788471897,EDS 286,A00,897210,Fine; Sarah,15,0,15,0
1745788472923,EDS 289C,A01,895770,Daly; Alan J.,15,0,15,0
1745788473952,EDS 290,A00,897211,Hofstetter; Carolyn,15,0,15,0
1745788474978,LIGM 5A,A00,896162,Fischer-Grunski; Eva K,15,0,20,5
1745788476004,LIGM 5B,A00,896260,Fischer-Grunski; Eva K,17,0,20,3
1745788477029,LIGM 5C,A00,896308,Fischer-Grunski; Eva K,18,0,20,2
1745788478059,LIIT 5AS,A00,896313,Carnelos; Chiara,18,0,20,2
1745788479085,LIIT 5BS,A00,896416,Carnelos; Chiara,20,0,20,0
1745788480113,LIIT 5CS,A00,896564,Carnelos; Chiara,20,0,20,0
1745788481143,LISP 5A,A00,896588,Munoz Sanchez; Alicia,4,0,20,16
1745788482173,LISP 5B,A00,896653,Munoz Sanchez; Alicia,10,0,20,10
1745788483203,LISP 5C,A00,896655,Munoz Sanchez; Alicia,4,0,20,16
1745788484232,MAE 197,001,957918,Kleissl; Jan,9998,0,9999,1
1745788485260,MATH 2,A01,957937,Staff,34,0,35,1
1745788486288,MATH 197,001,957876,Kedlaya; Kiran S.,9993,0,9999,6
1745788487316,MCWP 40,A00,892729,Duru; Nur,13,0,20,7
1745788487316,MCWP 40,B00,893304,Montejo; Carolina,20,0,20,0
1745788488343,MCWP 40R,A00,893757,Redela; Pamela Morgan,0,6,20,20
1745788489368,MCWP 50,A00,893758,Morshed; Michael James,2,0,20,18
1745788489368,MCWP 50,B00,893761,Bartulis; Jason Michael,17,0,20,3
1745788490395,MCWP 50R,A00,893766,Compas; Sean Matthew,0,1,20,20
1745788490395,MCWP 50R,B00,893769,Carter; Jennifer A,0,0,20,20
1745788490395,MCWP 50R,C00,893771,Krone; Jarret,0,3,20,20
1745788490395,MCWP 50R,D00,893772,Miller; Elizabeth Deen,3,0,20,17
1745788490395,MCWP 50R,E00,893775,Carter; Andrea L,0,0,20,20
1745788491423,MMW 11R,A01,892721,Herbst; Matthew,11,0,27,16
1745788491423,MMW 11R,A02,892722,Herbst; Matthew,0,0,0,3
1745788492452,MMW 12R,A01,892724,Herbst; Matthew,0,9,16,16
1745788492452,MMW 12R,A02,892725,Herbst; Matthew,0,9,16,16
1745788493480,MMW 13R,A01,892727,Staff,0,3,16,16
1745788493480,MMW 13R,A02,892728,Staff,0,4,16,16
1745788493480,MMW 13R,A03,958032,Staff,0,3,16,16
1745788493480,MMW 13R,A04,958033,Staff,0,2,16,16
1745788493480,MMW 13R,A05,958034,Staff,0,3,16,16
1745788494508,SIO 295LS,A00,894015,Staff,7,0,25,18
1745788495538,SIO 295S,A00,894020,Staff,7,0,25,18
1745788496567,SIOC 290S,B01,958918,Staff,0,0,0,0
1745788497594,SIOC 291S,B01,958922,Staff,0,0,0,0
1745788498621,SOCI 117,A01,895339,Staff,4,0,5,1
1745788499649,WES 237B,A00,894149,Staff,11,0,20,9
1745788501713,AESE 279B,A00,891859,Staff,13,0,35,22
1745788502740,AIP 197,001,891854,Staff,70,0,70,0
1745788503765,ANTH 289S,A00,891856,Gagneux; Pascal,12,0,12,0
1745788504791,BENG 196,001,957946,Engler; Adam J.,9996,0,9999,3
1745788505817,CAT 124RS,A01,956906,Staff,8,0,25,17
1745788506842,CAT 125RS,A01,922013,Staff,8,0,25,17
1745788507867,CLRE 250,A00,891860,Morris; Sheldon,9995,0,9999,4
1745788509923,CLRE 251R,A00,907817,Mehta; Ravindra L.,9994,0,9999,5
1745788510951,CLRE 252,A00,891864,Cuomo; Raphael Eduardo,9993,0,9999,6
1745788511982,CLRE 253,A00,891867,Vaida; Florin,9994,0,9999,5
1745788511982,CLRE 253,B00,907819,Staff,9999,0,9999,0
1745788513010,CLRE 259,A00,891868,Patel; Hemal,9998,0,9999,1
1745788514037,CLRE 260,A00,891872,Cuomo; Raphael Eduardo,9999,0,9999,0
1745788515062,CLRE 297,001,891888,Cuomo; Raphael Eduardo,9999,0,9999,0
1745788516088,CSE 191,A00,958773,Minnes Kemp; Mor Mia,9999,0,9999,0
1745788517115,CSS 201S,A01,892054,Mignozzetti; Umberto,30,0,30,0
1745788518143,CSS 202S,A01,892056,Mignozzetti; Umberto,30,0,30,0
1745788519169,DSC 197,001,956898,Eldridge; Justin Matthew,9998,0,9999,1
1745788520195,DSC 297,001,958000,Mazumdar; Arya,9998,0,9999,1
1745788521222,EAP 100,A00,905686,Staff,9776,0,9999,223
1745788522251,ECE 45,A01,892618,Staff,0,12,50,50
1745788523278,ECE 109,A01,892620,Staff,0,43,0,0
1745788524304,ECE 111,A01,892719,Staff,0,7,50,50
1745788525332,ECE 197,001,957920,Mercier; Patrick Philip,9992,0,9999,7
1745788526358,ECON 178,A01,907814,Zhu; Ying,28,0,35,7
1745788527385,EDS 115,A00,895312,Staff,41,0,45,4
1745788528413,EDS 117,A01,895337,Staff,30,0,30,0
1745788529439,EDS 125,A00,895341,Jones; Gabrielle Anastasia,43,0,45,2
1745788530465,EDS 128A,A01,895459,Fargason; Sharon Gayle,44,0,45,1
1745788531492,EDS 128B,A01,895543,Pappas; Elizabeth,44,0,45,1
1745788532522,EDS 139,A00,897203,Pappas; Elizabeth,44,0,45,1
1745788532522,EDS 139,B00,897209,Fargason; Sharon Gayle,44,0,45,1
1745788533552,EDS 201,A00,895545,Staff,43,0,45,2
1745788534578,EDS 203,A01,895581,Halter; Christopher P.,43,0,45,2
1745788535608,EDS 204R,A01,895625,Heinzman; Erica M.,43,0,45,2
1745788535608,EDS 204R,B01,895693,Halter; Christopher P.,18,0,45,27
1745788536633,EDS 206R,A00,895694,Fargason; Sharon Gayle,9,0,30,21
1745788536633,EDS 206R,B00,895695,Choi; Bailey Miyeon,20,0,30,10
1745788537660,EDS 250,A00,895697,Hemans; Patricia Ann Benitez,43,0,45,2
1745788538687,EDS 281,A00,895701,Meyerott; Theresa Ann,15,0,15,0
1745788539713,EDS 284,A00,895736,Meyerott; Theresa Ann,15,0,15,0
1745788540741,EDS 286,A00,897210,Fine; Sarah,15,0,15,0
1745788541769,EDS 289C,A01,895770,Daly; Alan J.,15,0,15,0
1745788542797,EDS 290,A00,897211,Hofstetter; Carolyn,15,0,15,0
1745788543823,LIGM 5A,A00,896162,Fischer-Grunski; Eva K,15,0,20,5
1745788544849,LIGM 5B,A00,896260,Fischer-Grunski; Eva K,17,0,20,3
1745788545876,LIGM 5C,A00,896308,Fischer-Grunski; Eva K,18,0,20,2
1745788546901,LIIT 5AS,A00,896313,Carnelos; Chiara,18,0,20,2
1745788547931,LIIT 5BS,A00,896416,Carnelos; Chiara,20,0,20,0
1745788548958,LIIT 5CS,A00,896564,Carnelos; Chiara,20,0,20,0
1745788549984,LISP 5A,A00,896588,Munoz Sanchez; Alicia,4,0,20,16
1745788551014,LISP 5B,A00,896653,Munoz Sanchez; Alicia,10,0,20,10
1745788552041,LISP 5C,A00,896655,Munoz Sanchez; Alicia,4,0,20,16
1745788553073,MAE 197,001,957918,Kleissl; Jan,9998,0,9999,1
1745788554101,MATH 2,A01,957937,Staff,34,0,35,1
1745788555130,MATH 197,001,957876,Kedlaya; Kiran S.,9993,0,9999,6
1745788556158,MCWP 40,A00,892729,Duru; Nur,13,0,20,7
1745788556158,MCWP 40,B00,893304,Montejo; Carolina,20,0,20,0
1745788557185,MCWP 40R,A00,893757,Redela; Pamela Morgan,0,6,20,20
1745788558214,MCWP 50,A00,893758,Morshed; Michael James,2,0,20,18
1745788558214,MCWP 50,B00,893761,Bartulis; Jason Michael,17,0,20,3
1745788559245,MCWP 50R,A00,893766,Compas; Sean Matthew,0,1,20,20
1745788559245,MCWP 50R,B00,893769,Carter; Jennifer A,0,0,20,20
1745788559245,MCWP 50R,C00,893771,Krone; Jarret,0,3,20,20
1745788559245,MCWP 50R,D00,893772,Miller; Elizabeth Deen,3,0,20,17
1745788559245,MCWP 50R,E00,893775,Carter; Andrea L,0,0,20,20
1745788560273,MMW 11R,A01,892721,Herbst; Matthew,11,0,27,16
1745788560273,MMW 11R,A02,892722,Herbst; Matthew,0,0,0,3
1745788561304,MMW 12R,A01,892724,Herbst; Matthew,0,9,16,16
1745788561304,MMW 12R,A02,892725,Herbst; Matthew,0,9,16,16
1745788562333,MMW 13R,A01,892727,Staff,0,3,16,16
1745788562333,MMW 13R,A02,892728,Staff,0,4,16,16
1745788562333,MMW 13R,A03,958032,Staff,0,3,16,16
1745788562333,MMW 13R,A04,958033,Staff,0,2,16,16
1745788562333,MMW 13R,A05,958034,Staff,0,3,16,16
1745788563358,SIO 295LS,A00,894015,Staff,7,0,25,18
1745788564388,SIO 295S,A00,894020,Staff,7,0,25,18
1745788565416,SIOC 290S,B01,958918,Staff,0,0,0,0
1745788566443,SIOC 291S,B01,958922,Staff,0,0,0,0
1745788567470,SOCI 117,A01,895339,Staff,4,0,5,1
1745788568498,WES 237B,A00,894149,Staff,11,0,20,9
1745788570564,AESE 279B,A00,891859,Staff,13,0,35,22
1745788571590,AIP 197,001,891854,Staff,70,0,70,0
1745788572617,ANTH 289S,A00,891856,Gagneux; Pascal,12,0,12,0
1745788573645,BENG 196,001,957946,Engler; Adam J.,9996,0,9999,3
1745788574671,CAT 124RS,A01,956906,Staff,8,0,25,17
1745788575699,CAT 125RS,A01,922013,Staff,8,0,25,17
1745788576728,CLRE 250,A00,891860,Morris; Sheldon,9995,0,9999,4
1745788578780,CLRE 251R,A00,907817,Mehta; Ravindra L.,9994,0,9999,5
1745788579808,CLRE 252,A00,891864,Cuomo; Raphael Eduardo,9993,0,9999,6
1745788580834,CLRE 253,A00,891867,Vaida; Florin,9994,0,9999,5
1745788580834,CLRE 253,B00,907819,Staff,9999,0,9999,0
1745788581863,CLRE 259,A00,891868,Patel; Hemal,9998,0,9999,1
1745788582892,CLRE 260,A00,891872,Cuomo; Raphael Eduardo,9999,0,9999,0
1745788583921,CLRE 297,001,891888,Cuomo; Raphael Eduardo,9999,0,9999,0
1745788584948,CSE 191,A00,958773,Minnes Kemp; Mor Mia,9999,0,9999,0
1745788585974,CSS 201S,A01,892054,Mignozzetti; Umberto,30,0,30,0
1745788587001,CSS 202S,A01,892056,Mignozzetti; Umberto,30,0,30,0
1745788588031,DSC 197,001,956898,Eldridge; Justin Matthew,9998,0,9999,1
1745788589057,DSC 297,001,958000,Mazumdar; Arya,9998,0,9999,1
1745788590088,EAP 100,A00,905686,Staff,9776,0,9999,223
1745788591113,ECE 45,A01,892618,Staff,0,12,50,50
1745788592142,ECE 109,A01,892620,Staff,0,43,0,0
1745788593171,ECE 111,A01,892719,Staff,0,7,50,50
1745788594196,ECE 197,001,957920,Mercier; Patrick Philip,9992,0,9999,7
1745788595223,ECON 178,A01,907814,Zhu; Ying,28,0,35,7
1745788596249,EDS 115,A00,895312,Staff,41,0,45,4
1745788597276,EDS 117,A01,895337,Staff,30,0,30,0
1745788598306,EDS 125,A00,895341,Jones; Gabrielle Anastasia,43,0,45,2
1745788599332,EDS 128A,A01,895459,Fargason; Sharon Gayle,44,0,45,1
1745788600361,EDS 128B,A01,895543,Pappas; Elizabeth,44,0,45,1
1745788601387,EDS 139,A00,897203,Pappas; Elizabeth,44,0,45,1
1745788601387,EDS 139,B00,897209,Fargason; Sharon Gayle,44,0,45,1
1745788602416,EDS 201,A00,895545,Staff,43,0,45,2
1745788603442,EDS 203,A01,895581,Halter; Christopher P.,43,0,45,2
1745788604468,EDS 204R,A01,895625,Heinzman; Erica M.,43,0,45,2
1745788604468,EDS 204R,B01,895693,Halter; Christopher P.,18,0,45,27
1745788605495,EDS 206R,A00,895694,Fargason; Sharon Gayle,9,0,30,21
1745788605495,EDS 206R,B00,895695,Choi; Bailey Miyeon,20,0,30,10
1745788606525,EDS 250,A00,895697,Hemans; Patricia Ann Benitez,43,0,45,2
1745788607551,EDS 281,A00,895701,Meyerott; Theresa Ann,15,0,15,0
1745788608577,EDS 284,A00,895736,Meyerott; Theresa Ann,15,0,15,0
1745788609604,EDS 286,A00,897210,Fine; Sarah,15,0,15,0
1745788610633,EDS 289C,A01,895770,Daly; Alan J.,15,0,15,0
1745788611660,EDS 290,A00,897211,Hofstetter; Carolyn,15,0,15,0
1745788612685,LIGM 5A,A00,896162,Fischer-Grunski; Eva K,15,0,20,5
1745788613714,LIGM 5B,A00,896260,Fischer-Grunski; Eva K,17,0,20,3
1745788614740,LIGM 5C,A00,896308,Fischer-Grunski; Eva K,18,0,20,2
1745788615765,LIIT 5AS,A00,896313,Carnelos; Chiara,18,0,20,2
1745788616794,LIIT 5BS,A00,896416,Carnelos; Chiara,20,0,20,0
1745788617824,LIIT 5CS,A00,896564,Carnelos; Chiara,20,0,20,0
1745788618849,LISP 5A,A00,896588,Munoz Sanchez; Alicia,4,0,20,16
1745788619875,LISP 5B,A00,896653,Munoz Sanchez; Alicia,10,0,20,10
1745788620903,LISP 5C,A00,896655,Munoz Sanchez; Alicia,4,0,20,16
1745788621929,MAE 197,001,957918,Kleissl; Jan,9998,0,9999,1
1745788622958,MATH 2,A01,957937,Staff,34,0,35,1
1745788623986,MATH 197,001,957876,Kedlaya; Kiran S.,9993,0,9999,6
1745788625018,MCWP 40,A00,892729,Duru; Nur,13,0,20,7
1745788625018,MCWP 40,B00,893304,Montejo; Carolina,20,0,20,0
1745788626045,MCWP 40R,A00,893757,Redela; Pamela Morgan,0,6,20,20
1745788627073,MCWP 50,A00,893758,Morshed; Michael James,2,0,20,18
1745788627073,MCWP 50,B00,893761,Bartulis; Jason Michael,17,0,20,3
1745788628099,MCWP 50R,A00,893766,Compas; Sean Matthew,0,1,20,20
1745788628099,MCWP 50R,B00,893769,Carter; Jennifer A,0,0,20,20
1745788628099,MCWP 50R,C00,893771,Krone; Jarret,0,3,20,20
1745788628099,MCWP 50R,D00,893772,Miller; Elizabeth Deen,3,0,20,17
1745788628099,MCWP 50R,E00,893775,Carter; Andrea L,0,0,20,20
1745788629129,MMW 11R,A01,892721,Herbst; Matthew,11,0,27,16
1745788629129,MMW 11R,A02,892722,Herbst; Matthew,0,0,0,3
1745788630155,MMW 12R,A01,892724,Herbst; Matthew,0,9,16,16
1745788630155,MMW 12R,A02,892725,Herbst; Matthew,0,9,16,16
1745788631185,MMW 13R,A01,892727,Staff,0,3,16,16
1745788631185,MMW 13R,A02,892728,Staff,0,4,16,16
1745788631185,MMW 13R,A03,958032,Staff,0,3,16,16
1745788631185,MMW 13R,A04,958033,Staff,0,2,16,16
1745788631185,MMW 13R,A05,958034,Staff,0,3,16,16
1745788632214,SIO 295LS,A00,894015,Staff,7,0,25,18
1745788633240,SIO 295S,A00,894020,Staff,7,0,25,18
1745788634269,SIOC 290S,B01,958918,Staff,0,0,0,0
1745788635300,SIOC 291S,B01,958922,Staff,0,0,0,0
1745788636330,SOCI 117,A01,895339,Staff,4,0,5,1
1745788637355,WES 237B,A00,894149,Staff,11,0,20,9
1745788639418,AESE 279B,A00,891859,Staff,13,0,35,22
1745788640444,AIP 197,001,891854,Staff,70,0,70,0
1745788641471,ANTH 289S,A00,891856,Gagneux; Pascal,12,0,12,0
1745788642496,BENG 196,001,957946,Engler; Adam J.,9996,0,9999,3
1745788643522,CAT 124RS,A01,956906,Staff,8,0,25,17
1745788644547,CAT 125RS,A01,922013,Staff,8,0,25,17
1745788645574,CLRE 250,A00,891860,Morris; Sheldon,9995,0,9999,4
1745788647627,CLRE 251R,A00,907817,Mehta; Ravindra L.,9994,0,9999,5
1745788648650,CLRE 252,A00,891864,Cuomo; Raphael Eduardo,9993,0,9999,6
1745788649676,CLRE 253,A00,891867,Vaida; Florin,9994,0,9999,5
1745788649676,CLRE 253,B00,907819,Staff,9999,0,9999,0
1745788650703,CLRE 259,A00,891868,Patel; Hemal,9998,0,9999,1
1745788651729,CLRE 260,A00,891872,Cuomo; Raphael Eduardo,9999,0,9999,0
1745788652758,CLRE 297,001,891888,Cuomo; Raphael Eduardo,9999,0,9999,0
1745788653784,CSE 191,A00,958773,Minnes Kemp; Mor Mia,9999,0,9999,0
1745788654811,CSS 201S,A01,892054,Mignozzetti; Umberto,30,0,30,0
1745788655840,CSS 202S,A01,892056,Mignozzetti; Umberto,30,0,30,0
1745788656869,DSC 197,001,956898,Eldridge; Justin Matthew,9998,0,9999,1
1745788657895,DSC 297,001,958000,Mazumdar; Arya,9998,0,9999,1
1745788658923,EAP 100,A00,905686,Staff,9776,0,9999,223
1745788659949,ECE 45,A01,892618,Staff,0,12,50,50
1745788660975,ECE 109,A01,892620,Staff,0,43,0,0
1745788662005,ECE 111,A01,892719,Staff,0,7,50,50
1745788663030,ECE 197,001,957920,Mercier; Patrick Philip,9992,0,9999,7
1745788664056,ECON 178,A01,907814,Zhu; Ying,28,0,35,7
1745788665084,EDS 115,A00,895312,Staff,41,0,45,4
1745788666110,EDS 117,A01,895337,Staff,30,0,30,0
1745788667136,EDS 125,A00,895341,Jones; Gabrielle Anastasia,43,0,45,2
1745788668165,EDS 128A,A01,895459,Fargason; Sharon Gayle,44,0,45,1
1745788669194,EDS 128B,A01,895543,Pappas; Elizabeth,44,0,45,1
1745788670220,EDS 139,A00,897203,Pappas; Elizabeth,44,0,45,1
1745788670220,EDS 139,B00,897209,Fargason; Sharon Gayle,44,0,45,1
1745788671249,EDS 201,A00,895545,Staff,43,0,45,2
1745788672277,EDS 203,A01,895581,Halter; Christopher P.,43,0,45,2
1745788673303,EDS 204R,A01,895625,Heinzman; Erica M.,43,0,45,2
1745788673303,EDS 204R,B01,895693,Halter; Christopher P.,18,0,45,27
1745788674328,EDS 206R,A00,895694,Fargason; Sharon Gayle,9,0,30,21
1745788674328,EDS 206R,B00,895695,Choi; Bailey Miyeon,20,0,30,10
1745788675356,EDS 250,A00,895697,Hemans; Patricia Ann Benitez,43,0,45,2
1745788676381,EDS 281,A00,895701,Meyerott; Theresa Ann,15,0,15,0
1745788677409,EDS 284,A00,895736,Meyerott; Theresa Ann,15,0,15,0
1745788678436,EDS 286,A00,897210,Fine; Sarah,15,0,15,0
1745788679465,EDS 289C,A01,895770,Daly; Alan J.,15,0,15,0
1745788680490,EDS 290,A00,897211,Hofstetter; Carolyn,15,0,15,0
1745788681515,LIGM 5A,A00,896162,Fischer-Grunski; Eva K,15,0,20,5
1745788682542,LIGM 5B,A00,896260,Fischer-Grunski; Eva K,17,0,20,3
1745788683572,LIGM 5C,A00,896308,Fischer-Grunski; Eva K,18,0,20,2
1745788684600,LIIT 5AS,A00,896313,Carnelos; Chiara,18,0,20,2
1745788685626,LIIT 5BS,A00,896416,Carnelos; Chiara,20,0,20,0
1745788686653,LIIT 5CS,A00,896564,Carnelos; Chiara,20,0,20,0
1745788687681,LISP 5A,A00,896588,Munoz Sanchez; Alicia,4,0,20,16
1745788688707,LISP 5B,A00,896653,Munoz Sanchez; Alicia,10,0,20,10
1745788689732,LISP 5C,A00,896655,Munoz Sanchez; Alicia,4,0,20,16
1745788690761,MAE 197,001,957918,Kleissl; Jan,9998,0,9999,1
1745788691787,MATH 2,A01,957937,Staff,34,0,35,1
1745788692815,MATH 197,001,957876,Kedlaya; Kiran S.,9993,0,9999,6
1745788693842,MCWP 40,A00,892729,Duru; Nur,13,0,20,7
1745788693842,MCWP 40,B00,893304,Montejo; Carolina,20,0,20,0
1745788694870,MCWP 40R,A00,893757,Redela; Pamela Morgan,0,6,20,20
1745788695895,MCWP 50,A00,893758,Morshed; Michael James,2,0,20,18
1745788695895,MCWP 50,B00,893761,Bartulis; Jason Michael,17,0,20,3
1745788696925,MCWP 50R,A00,893766,Compas; Sean Matthew,0,1,20,20
1745788696925,MCWP 50R,B00,893769,Carter; Jennifer A,0,0,20,20
1745788696925,MCWP 50R,C00,893771,Krone; Jarret,0,3,20,20
1745788696925,MCWP 50R,D00,893772,Miller; Elizabeth Deen,3,0,20,17
1745788696925,MCWP 50R,E00,893775,Carter; Andrea L,0,0,20,20
1745788697953,MMW 11R,A01,892721,Herbst; Matthew,11,0,27,16
1745788697953,MMW 11R,A02,892722,Herbst; Matthew,0,0,0,3
1745788698979,MMW 12R,A01,892724,Herbst; Matthew,0,9,16,16
1745788698979,MMW 12R,A02,892725,Herbst; Matthew,0,9,16,16
1745788700008,MMW 13R,A01,892727,Staff,0,3,16,16
1745788700008,MMW 13R,A02,892728,Staff,0,4,16,16
1745788700008,MMW 13R,A03,958032,Staff,0,3,16,16
1745788700008,MMW 13R,A04,958033,Staff,0,2,16,16
1745788700008,MMW 13R,A05,958034,Staff,0,3,16,16
1745788701034,SIO 295LS,A00,894015,Staff,7,0,25,18
1745788702062,SIO 295S,A00,894020,Staff,7,0,25,18
1745788703092,SIOC 290S,B01,958918,Staff,0,0,0,0
1745788704117,SIOC 291S,B01,958922,Staff,0,0,0,0
1745788705145,SOCI 117,A01,895339,Staff,4,0,5,1
1745788706171,WES 237B,A00,894149,Staff,11,0,20,9
1745788708227,AESE 279B,A00,891859,Staff,13,0,35,22
1745788709254,AIP 197,001,891854,Staff,70,0,70,0
1745788710281,ANTH 289S,A00,891856,Gagneux; Pascal,12,0,12,0
1745788711307,BENG 196,001,957946,Engler; Adam J.,9996,0,9999,3
1745788712337,CAT 124RS,A01,956906,Staff,8,0,25,17
1745788713363,CAT 125RS,A01,922013,Staff,8,0,25,17
1745788714390,CLRE 250,A00,891860,Morris; Sheldon,9995,0,9999,4
1745788716443,CLRE 251R,A00,907817,Mehta; Ravindra L.,9994,0,9999,5
1745788717470,CLRE 252,A00,891864,Cuomo; Raphael Eduardo,9993,0,9999,6
1745788718499,CLRE 253,A00,891867,Vaida; Florin,9994,0,9999,5
1745788718499,CLRE 253,B00,907819,Staff,9999,0,9999,0
1745788719527,CLRE 259,A00,891868,Patel; Hemal,9998,0,9999,1
1745788720556,CLRE 260,A00,891872,Cuomo; Raphael Eduardo,9999,0,9999,0
1745788721581,CLRE 297,001,891888,Cuomo; Raphael Eduardo,9999,0,9999,0
1745788722606,CSE 191,A00,958773,Minnes Kemp; Mor Mia,9999,0,9999,0
1745788723633,CSS 201S,A01,892054,Mignozzetti; Umberto,30,0,30,0
1745788724663,CSS 202S,A01,892056,Mignozzetti; Umberto,30,0,30,0
1745788725690,DSC 197,001,956898,Eldridge; Justin Matthew,9998,0,9999,1
1745788726715,DSC 297,001,958000,Mazumdar; Arya,9998,0,9999,1
1745788727741,EAP 100,A00,905686,Staff,9776,0,9999,223
1745788728768,ECE 45,A01,892618,Staff,0,12,50,50
1745788729797,ECE 109,A01,892620,Staff,0,43,0,0
1745788730826,ECE 111,A01,892719,Staff,0,7,50,50
1745788731853,ECE 197,001,957920,Mercier; Patrick Philip,9992,0,9999,7
1745788732882,ECON 178,A01,907814,Zhu; Ying,28,0,35,7
1745788733907,EDS 115,A00,895312,Staff,41,0,45,4
1745788734937,EDS 117,A01,895337,Staff,30,0,30,0
1745788735963,EDS 125,A00,895341,Jones; Gabrielle Anastasia,43,0,45,2
1745788736989,EDS 128A,A01,895459,Fargason; Sharon Gayle,44,0,45,1
1745788738015,EDS 128B,A01,895543,Pappas; Elizabeth,44,0,45,1
1745788739042,EDS 139,A00,897203,Pappas; Elizabeth,44,0,45,1
1745788739042,EDS 139,B00,897209,Fargason; Sharon Gayle,44,0,45,1
1745788740070,EDS 201,A00,895545,Staff,43,0,45,2
1745788741100,EDS 203,A01,895581,Halter; Christopher P.,43,0,45,2
1745788742129,EDS 204R,A01,895625,Heinzman; Erica M.,43,0,45,2
1745788742129,EDS 204R,B01,895693,Halter; Christopher P.,18,0,45,27
1745788743160,EDS 206R,A00,895694,Fargason; Sharon Gayle,9,0,30,21
1745788743160,EDS 206R,B00,895695,Choi; Bailey Miyeon,20,0,30,10
1745788744185,EDS 250,A00,895697,Hemans; Patricia Ann Benitez,43,0,45,2
1745788745212,EDS 281,A00,895701,Meyerott; Theresa Ann,15,0,15,0
1745788746238,EDS 284,A00,895736,Meyerott; Theresa Ann,15,0,15,0
1745788747263,EDS 286,A00,897210,Fine; Sarah,15,0,15,0
1745788748289,EDS 289C,A01,895770,Daly; Alan J.,15,0,15,0
1745788749314,EDS 290,A00,897211,Hofstetter; Carolyn,15,0,15,0
1745788750340,LIGM 5A,A00,896162,Fischer-Grunski; Eva K,15,0,20,5
1745788751367,LIGM 5B,A00,896260,Fischer-Grunski; Eva K,17,0,20,3
1745788752394,LIGM 5C,A00,896308,Fischer-Grunski; Eva K,18,0,20,2
1745788753420,LIIT 5AS,A00,896313,Carnelos; Chiara,18,0,20,2
1745788754449,LIIT 5BS,A00,896416,Carnelos; Chiara,20,0,20,0
1745788755475,LIIT 5CS,A00,896564,Carnelos; Chiara,20,0,20,0
1745788756503,LISP 5A,A00,896588,Munoz Sanchez; Alicia,4,0,20,16
1745788757531,LISP 5B,A00,896653,Munoz Sanchez; Alicia,10,0,20,10
1745788758559,LISP 5C,A00,896655,Munoz Sanchez; Alicia,4,0,20,16
1745788759587,MAE 197,001,957918,Kleissl; Jan,9998,0,9999,1
1745788760615,MATH 2,A01,957937,Staff,34,0,35,1
1745788761643,MATH 197,001,957876,Kedlaya; Kiran S.,9993,0,9999,6
1745788762672,MCWP 40,A00,892729,Duru; Nur,13,0,20,7
1745788762672,MCWP 40,B00,893304,Montejo; Carolina,20,0,20,0
1745788763698,MCWP 40R,A00,893757,Redela; Pamela Morgan,0,6,20,20
1745788764729,MCWP 50,A00,893758,Morshed; Michael James,2,0,20,18
1745788764729,MCWP 50,B00,893761,Bartulis; Jason Michael,17,0,20,3
1745788765760,MCWP 50R,A00,893766,Compas; Sean Matthew,0,1,20,20
1745788765760,MCWP 50R,B00,893769,Carter; Jennifer A,0,0,20,20
1745788765760,MCWP 50R,C00,893771,Krone; Jarret,0,3,20,20
1745788765760,MCWP 50R,D00,893772,Miller; Elizabeth Deen,3,0,20,17
1745788765760,MCWP 50R,E00,893775,Carter; Andrea L,0,0,20,20
1745788766786,MMW 11R,A01,892721,Herbst; Matthew,11,0,27,16
1745788766786,MMW 11R,A02,892722,Herbst; Matthew,0,0,0,3
1745788767815,MMW 12R,A01,892724,Herbst; Matthew,0,9,16,16
1745788767815,MMW 12R,A02,892725,Herbst; Matthew,0,9,16,16
1745788768846,MMW 13R,A01,892727,Staff,0,3,16,16
1745788768846,MMW 13R,A02,892728,Staff,0,4,16,16
1745788768846,MMW 13R,A03,958032,Staff,0,3,16,16
1745788768846,MMW 13R,A04,958033,Staff,0,2,16,16
1745788768846,MMW 13R,A05,958034,Staff,0,3,16,16
1745788769873,SIO 295LS,A00,894015,Staff,7,0,25,18
1745788770901,SIO 295S,A00,894020,Staff,7,0,25,18
1745788771929,SIOC 290S,B01,958918,Staff,0,0,0,0
1745788772959,SIOC 291S,B01,958922,Staff,0,0,0,0
1745788773988,SOCI 117,A01,895339,Staff,4,0,5,1
1745788775014,WES 237B,A00,894149,Staff,11,0,20,9
1745788777075,AESE 279B,A00,891859,Staff,13,0,35,22
1745788778098,AIP 197,001,891854,Staff,70,0,70,0
1745788779124,ANTH 289S,A00,891856,Gagneux; Pascal,12,0,12,0
1745788780151,BENG 196,001,957946,Engler; Adam J.,9996,0,9999,3
1745788781180,CAT 124RS,A01,956906,Staff,8,0,25,17
1745788782208,CAT 125RS,A01,922013,Staff,8,0,25,17
1745788783237,CLRE 250,A00,891860,Morris; Sheldon,9995,0,9999,4
1745788785290,CLRE 251R,A00,907817,Mehta; Ravindra L.,9994,0,9999,5
1745788786317,CLRE 252,A00,891864,Cuomo; Raphael Eduardo,9993,0,9999,6
1745788787346,CLRE 253,A00,891867,Vaida; Florin,9994,0,9999,5
1745788787346,CLRE 253,B00,907819,Staff,9999,0,9999,0
1745788788374,CLRE 259,A00,891868,Patel; Hemal,9998,0,9999,1
1745788789404,CLRE 260,A00,891872,Cuomo; Raphael Eduardo,9999,0,9999,0
1745788790431,CLRE 297,001,891888,Cuomo; Raphael Eduardo,9999,0,9999,0
1745788791457,CSE 191,A00,958773,Minnes Kemp; Mor Mia,9999,0,9999,0
1745788792487,CSS 201S,A01,892054,Mignozzetti; Umberto,30,0,30,0
1745788793518,CSS 202S,A01,892056,Mignozzetti; Umberto,30,0,30,0
1745788794545,DSC 197,001,956898,Eldridge; Justin Matthew,9998,0,9999,1
1745788795571,DSC 297,001,958000,Mazumdar; Arya,9998,0,9999,1
1745788796597,EAP 100,A00,905686,Staff,9776,0,9999,223
1745788797623,ECE 45,A01,892618,Staff,0,12,50,50
1745788798648,ECE 109,A01,892620,Staff,0,43,0,0
1745788799674,ECE 111,A01,892719,Staff,0,7,50,50
1745788800702,ECE 197,001,957920,Mercier; Patrick Philip,9992,0,9999,7
1745788801731,ECON 178,A01,907814,Zhu; Ying,28,0,35,7
1745788802761,EDS 115,A00,895312,Staff,41,0,45,4
1745788803787,EDS 117,A01,895337,Staff,30,0,30,0
1745788804817,EDS 125,A00,895341,Jones; Gabrielle Anastasia,43,0,45,2
1745788805847,EDS 128A,A01,895459,Fargason; Sharon Gayle,44,0,45,1
1745788806874,EDS 128B,A01,895543,Pappas; Elizabeth,44,0,45,1
1745788807901,EDS 139,A00,897203,Pappas; Elizabeth,44,0,45,1
1745788807901,EDS 139,B00,897209,Fargason; Sharon Gayle,44,0,45,1
1745788808927,EDS 201,A00,895545,Staff,43,0,45,2
1745788809957,EDS 203,A01,895581,Halter; Christopher P.,43,0,45,2
1745788810985,EDS 204R,A01,895625,Heinzman; Erica M.,43,0,45,2
1745788810985,EDS 204R,B01,895693,Halter; Christopher P.,18,0,45,27
1745788812012,EDS 206R,A00,895694,Fargason; Sharon Gayle,9,0,30,21
1745788812012,EDS 206R,B00,895695,Choi; Bailey Miyeon,20,0,30,10
1745788813037,EDS 250,A00,895697,Hemans; Patricia Ann Benitez,43,0,45,2
1745788814065,EDS 281,A00,895701,Meyerott; Theresa Ann,15,0,15,0
1745788815092,EDS 284,A00,895736,Meyerott; Theresa Ann,15,0,15,0
1745788816120,EDS 286,A00,897210,Fine; Sarah,15,0,15,0
1745788817147,EDS 289C,A01,895770,Daly; Alan J.,15,0,15,0
1745788818174,EDS 290,A00,897211,Hofstetter; Carolyn,15,0,15,0
1745788819199,LIGM 5A,A00,896162,Fischer-Grunski; Eva K,15,0,20,5
1745788820229,LIGM 5B,A00,896260,Fischer-Grunski; Eva K,17,0,20,3
1745788821259,LIGM 5C,A00,896308,Fischer-Grunski; Eva K,18,0,20,2
1745788822287,LIIT 5AS,A00,896313,Carnelos; Chiara,18,0,20,2
1745788823313,LIIT 5BS,A00,896416,Carnelos; Chiara,20,0,20,0
1745788824342,LIIT 5CS,A00,896564,Carnelos; Chiara,20,0,20,0
1745788825373,LISP 5A,A00,896588,Munoz Sanchez; Alicia,4,0,20,16
1745788826398,LISP 5B,A00,896653,Munoz Sanchez; Alicia,10,0,20,10
1745788827423,LISP 5C,A00,896655,Munoz Sanchez; Alicia,4,0,20,16
1745788828450,MAE 197,001,957918,Kleissl; Jan,9998,0,9999,1
1745788829475,MATH 2,A01,957937,Staff,34,0,35,1
1745788830504,MATH 197,001,957876,Kedlaya; Kiran S.,9993,0,9999,6
1745788831533,MCWP 40,A00,892729,Duru; Nur,13,0,20,7
1745788831533,MCWP 40,B00,893304,Montejo; Carolina,20,0,20,0
1745788832562,MCWP 40R,A00,893757,Redela; Pamela Morgan,0,6,20,20
1745788833592,MCWP 50,A00,893758,Morshed; Michael James,2,0,20,18
1745788833592,MCWP 50,B00,893761,Bartulis; Jason Michael,17,0,20,3
1745788834622,MCWP 50R,A00,893766,Compas; Sean Matthew,0,1,20,20
1745788834622,MCWP 50R,B00,893769,Carter; Jennifer A,0,0,20,20
1745788834622,MCWP 50R,C00,893771,Krone; Jarret,0,3,20,20
1745788834622,MCWP 50R,D00,893772,Miller; Elizabeth Deen,3,0,20,17
1745788834622,MCWP 50R,E00,893775,Carter; Andrea L,0,0,20,20
1745788835649,MMW 11R,A01,892721,Herbst; Matthew,11,0,27,16
1745788835649,MMW 11R,A02,892722,Herbst; Matthew,0,0,0,3
1745788836678,MMW 12R,A01,892724,Herbst; Matthew,0,9,16,16
1745788836678,MMW 12R,A02,892725,Herbst; Matthew,0,9,16,16
1745788837705,MMW 13R,A01,892727,Staff,0,3,16,16
1745788837705,MMW 13R,A02,892728,Staff,0,4,16,16
1745788837705,MMW 13R,A03,958032,Staff,0,3,16,16
1745788837705,MMW 13R,A04,958033,Staff,0,2,16,16
1745788837705,MMW 13R,A05,958034,Staff,0,3,16,16
1745788838731,SIO 295LS,A00,894015,Staff,7,0,25,18
1745788839756,SIO 295S,A00,894020,Staff,7,0,25,18
1745788840786,SIOC 290S,B01,958918,Staff,0,0,0,0
1745788841816,SIOC 291S,B01,958922,Staff,0,0,0,0
1745788842842,SOCI 117,A01,895339,Staff,4,0,5,1
1745788843871,WES 237B,A00,894149,Staff,11,0,20,9
1745788845939,AESE 279B,A00,891859,Staff,13,0,35,22
1745788846965,AIP 197,001,891854,Staff,70,0,70,0
1745788847991,ANTH 289S,A00,891856,Gagneux; Pascal,12,0,12,0
1745788849020,BENG 196,001,957946,Engler; Adam J.,9996,0,9999,3
1745788850045,CAT 124RS,A01,956906,Staff,8,0,25,17
1745788851071,CAT 125RS,A01,922013,Staff,8,0,25,17
1745788852096,CLRE 250,A00,891860,Morris; Sheldon,9995,0,9999,4
1745788854150,CLRE 251R,A00,907817,Mehta; Ravindra L.,9994,0,9999,5
1745788855179,CLRE 252,A00,891864,Cuomo; Raphael Eduardo,9993,0,9999,6
1745788856204,CLRE 253,A00,891867,Vaida; Florin,9994,0,9999,5
1745788856204,CLRE 253,B00,907819,Staff,9999,0,9999,0
1745788857232,CLRE 259,A00,891868,Patel; Hemal,9998,0,9999,1
1745788858256,CLRE 260,A00,891872,Cuomo; Raphael Eduardo,9999,0,9999,0
1745788859284,CLRE 297,001,891888,Cuomo; Raphael Eduardo,9999,0,9999,0
1745788860312,CSE 191,A00,958773,Minnes Kemp; Mor Mia,9999,0,9999,0
1745788861342,CSS 201S,A01,892054,Mignozzetti; Umberto,30,0,30,0
1745788862372,CSS 202S,A01,892056,Mignozzetti; Umberto,30,0,30,0
1745788863399,DSC 197,001,956898,Eldridge; Justin Matthew,9998,0,9999,1
1745788864425,DSC 297,001,958000,Mazumdar; Arya,9998,0,9999,1
1745788865451,EAP 100,A00,905686,Staff,9776,0,9999,223
1745788866476,ECE 45,A01,892618,Staff,0,12,50,50
1745788867504,ECE 109,A01,892620,Staff,0,43,0,0
1745788868530,ECE 111,A01,892719,Staff,0,7,50,50
1745788869556,ECE 197,001,957920,Mercier; Patrick Philip,9992,0,9999,7
1745788870587,ECON 178,A01,907814,Zhu; Ying,28,0,35,7
1745788871616,EDS 115,A00,895312,Staff,41,0,45,4
1745788872644,EDS 117,A01,895337,Staff,30,0,30,0
1745788873671,EDS 125,A00,895341,Jones; Gabrielle Anastasia,43,0,45,2
1745788874701,EDS 128A,A01,895459,Fargason; Sharon Gayle,44,0,45,1
1745788875726,EDS 128B,A01,895543,Pappas; Elizabeth,44,0,45,1
1745788876754,EDS 139,A00,897203,Pappas; Elizabeth,44,0,45,1
1745788876754,EDS 139,B00,897209,Fargason; Sharon Gayle,44,0,45,1
1745788877782,EDS 201,A00,895545,Staff,43,0,45,2
1745788878809,EDS 203,A01,895581,Halter; Christopher P.,43,0,45,2
1745788879835,EDS 204R,A01,895625,Heinzman; Erica M.,43,0,45,2
1745788879835,EDS 204R,B01,895693,Halter; Christopher P.,18,0,45,27
1745788880864,EDS 206R,A00,895694,Fargason; Sharon Gayle,9,0,30,21
1745788880864,EDS 206R,B00,895695,Choi; Bailey Miyeon,20,0,30,10
1745788881892,EDS 250,A00,895697,Hemans; Patricia Ann Benitez,43,0,45,2
1745788882921,EDS 281,A00,895701,Meyerott; Theresa Ann,15,0,15,0
1745788883948,EDS 284,A00,895736,Meyerott; Theresa Ann,15,0,15,0
1745788884976,EDS 286,A00,897210,Fine; Sarah,15,0,15,0
1745788886004,EDS 289C,A01,895770,Daly; Alan J.,15,0,15,0
1745788887033,EDS 290,A00,897211,Hofstetter; Carolyn,15,0,15,0
1745788888059,LIGM 5A,A00,896162,Fischer-Grunski; Eva K,15,0,20,5
1745788889085,LIGM 5B,A00,896260,Fischer-Grunski; Eva K,17,0,20,3
1745788890113,LIGM 5C,A00,896308,Fischer-Grunski; Eva K,18,0,20,2
1745788891141,LIIT 5AS,A00,896313,Carnelos; Chiara,18,0,20,2
1745788892170,LIIT 5BS,A00,896416,Carnelos; Chiara,20,0,20,0
1745788893195,LIIT 5CS,A00,896564,Carnelos; Chiara,20,0,20,0
1745788894223,LISP 5A,A00,896588,Munoz Sanchez; Alicia,4,0,20,16
1745788895247,LISP 5B,A00,896653,Munoz Sanchez; Alicia,10,0,20,10
1745788896292,LISP 5C,A00,896655,Munoz Sanchez; Alicia,4,0,20,16
1745788897317,MAE 197,001,957918,Kleissl; Jan,9998,0,9999,1
1745788898342,MATH 2,A01,957937,Staff,34,0,35,1
1745788899369,MATH 197,001,957876,Kedlaya; Kiran S.,9993,0,9999,6
1745788900395,MCWP 40,A00,892729,Duru; Nur,13,0,20,7
1745788900395,MCWP 40,B00,893304,Montejo; Carolina,20,0,20,0
1745788901421,MCWP 40R,A00,893757,Redela; Pamela Morgan,0,6,20,20
1745788902450,MCWP 50,A00,893758,Morshed; Michael James,2,0,20,18
1745788902450,MCWP 50,B00,893761,Bartulis; Jason Michael,17,0,20,3
1745788903479,MCWP 50R,A00,893766,Compas; Sean Matthew,0,1,20,20
1745788903479,MCWP 50R,B00,893769,Carter; Jennifer A,0,0,20,20
1745788903479,MCWP 50R,C00,893771,Krone; Jarret,0,3,20,20
1745788903479,MCWP 50R,D00,893772,Miller; Elizabeth Deen,3,0,20,17
1745788903479,MCWP 50R,E00,893775,Carter; Andrea L,0,0,20,20
1745788904505,MMW 11R,A01,892721,Herbst; Matthew,11,0,27,16
1745788904505,MMW 11R,A02,892722,Herbst; Matthew,0,0,0,3
1745788905530,MMW 12R,A01,892724,Herbst; Matthew,0,9,16,16
1745788905530,MMW 12R,A02,892725,Herbst; Matthew,0,9,16,16
1745788906560,MMW 13R,A01,892727,Staff,0,3,16,16
1745788906560,MMW 13R,A02,892728,Staff,0,4,16,16
1745788906560,MMW 13R,A03,958032,Staff,0,3,16,16
1745788906560,MMW 13R,A04,958033,Staff,0,2,16,16
1745788906560,MMW 13R,A05,958034,Staff,0,3,16,16
1745788907585,SIO 295LS,A00,894015,Staff,7,0,25,18
1745788908614,SIO 295S,A00,894020,Staff,7,0,25,18
1745788909639,SIOC 290S,B01,958918,Staff,0,0,0,0
1745788910666,SIOC 291S,B01,958922,Staff,0,0,0,0
1745788911693,SOCI 117,A01,895339,Staff,4,0,5,1
1745788912722,WES 237B,A00,894149,Staff,11,0,20,9
1745788914778,AESE 279B,A00,891859,Staff,13,0,35,22
1745788915804,AIP 197,001,891854,Staff,70,0,70,0
1745788916831,ANTH 289S,A00,891856,Gagneux; Pascal,12,0,12,0
1745788917857,BENG 196,001,957946,Engler; Adam J.,9996,0,9999,3
1745788918882,CAT 124RS,A01,956906,Staff,8,0,25,17
1745788919909,CAT 125RS,A01,922013,Staff,8,0,25,17
1745788920935,CLRE 250,A00,891860,Morris; Sheldon,9995,0,9999,4
1745788922991,CLRE 251R,A00,907817,Mehta; Ravindra L.,9994,0,9999,5
1745788924018,CLRE 252,A00,891864,Cuomo; Raphael Eduardo,9993,0,9999,6
1745788925046,CLRE 253,A00,891867,Vaida; Florin,9994,0,9999,5
1745788925046,CLRE 253,B00,907819,Staff,9999,0,9999,0
1745788926074,CLRE 259,A00,891868,Patel; Hemal,9998,0,9999,1
1745788927099,CLRE 260,A00,891872,Cuomo; Raphael Eduardo,9999,0,9999,0
1745788928127,CLRE 297,001,891888,Cuomo; Raphael Eduardo,9999,0,9999,0
1745788929153,CSE 191,A00,958773,Minnes Kemp; Mor Mia,9999,0,9999,0
1745788930182,CSS 201S,A01,892054,Mignozzetti; Umberto,30,0,30,0
1745788931207,CSS 202S,A01,892056,Mignozzetti; Umberto,30,0,30,0
1745788932233,DSC 197,001,956898,Eldridge; Justin Matthew,9998,0,9999,1
1745788933261,DSC 297,001,958000,Mazumdar; Arya,9998,0,9999,1
1745788934288,EAP 100,A00,905686,Staff,9776,0,9999,223
1745788935316,ECE 45,A01,892618,Staff,0,12,50,50
1745788936380,ECE 109,A01,892620,Staff,0,43,0,0
1745788937405,ECE 111,A01,892719,Staff,0,7,50,50
1745788938429,ECE 197,001,957920,Mercier; Patrick Philip,9992,0,9999,7
1745788939459,ECON 178,A01,907814,Zhu; Ying,28,0,35,7
1745788940486,EDS 115,A00,895312,Staff,41,0,45,4
1745788941512,EDS 117,A01,895337,Staff,30,0,30,0
1745788942537,EDS 125,A00,895341,Jones; Gabrielle Anastasia,43,0,45,2
1745788943566,EDS 128A,A01,895459,Fargason; Sharon Gayle,44,0,45,1
1745788944595,EDS 128B,A01,895543,Pappas; Elizabeth,44,0,45,1
1745788945621,EDS 139,A00,897203,Pappas; Elizabeth,44,0,45,1
1745788945621,EDS 139,B00,897209,Fargason; Sharon Gayle,44,0,45,1
1745788946649,EDS 201,A00,895545,Staff,43,0,45,2
1745788947675,EDS 203,A01,895581,Halter; Christopher P.,43,0,45,2
1745788948699,EDS 204R,A01,895625,Heinzman; Erica M.,43,0,45,2
1745788948699,EDS 204R,B01,895693,Halter; Christopher P.,18,0,45,27
1745788949729,EDS 206R,A00,895694,Fargason; Sharon Gayle,9,0,30,21
1745788949729,EDS 206R,B00,895695,Choi; Bailey Miyeon,20,0,30,10
1745788950758,EDS 250,A00,895697,Hemans; Patricia Ann Benitez,43,0,45,2
1745788951786,EDS 281,A00,895701,Meyerott; Theresa Ann,15,0,15,0
1745788952814,EDS 284,A00,895736,Meyerott; Theresa Ann,15,0,15,0
1745788953840,EDS 286,A00,897210,Fine; Sarah,15,0,15,0
1745788954867,EDS 289C,A01,895770,Daly; Alan J.,15,0,15,0
1745788955893,EDS 290,A00,897211,Hofstetter; Carolyn,15,0,15,0
1745788956919,LIGM 5A,A00,896162,Fischer-Grunski; Eva K,15,0,20,5
1745788957945,LIGM 5B,A00,896260,Fischer-Grunski; Eva K,17,0,20,3
1745788958971,LIGM 5C,A00,896308,Fischer-Grunski; Eva K,18,0,20,2
1745788959999,LIIT 5AS,A00,896313,Carnelos; Chiara,18,0,20,2
1745788961026,LIIT 5BS,A00,896416,Carnelos; Chiara,20,0,20,0
1745788962051,LIIT 5CS,A00,896564,Carnelos; Chiara,20,0,20,0
1745788963080,LISP 5A,A00,896588,Munoz Sanchez; Alicia,4,0,20,16
1745788964107,LISP 5B,A00,896653,Munoz Sanchez; Alicia,10,0,20,10
1745788965131,LISP 5C,A00,896655,Munoz Sanchez; Alicia,4,0,20,16
1745788966156,MAE 197,001,957918,Kleissl; Jan,9998,0,9999,1
1745788967182,MATH 2,A01,957937,Staff,34,0,35,1
1745788968207,MATH 197,001,957876,Kedlaya; Kiran S.,9993,0,9999,6
1745788969235,MCWP 40,A00,892729,Duru; Nur,13,0,20,7
1745788969235,MCWP 40,B00,893304,Montejo; Carolina,20,0,20,0
1745788970262,MCWP 40R,A00,893757,Redela; Pamela Morgan,0,6,20,20
1745788971288,MCWP 50,A00,893758,Morshed; Michael James,2,0,20,18
1745788971288,MCWP 50,B00,893761,Bartulis; Jason Michael,17,0,20,3
1745788972317,MCWP 50R,A00,893766,Compas; Sean Matthew,0,1,20,20
1745788972317,MCWP 50R,B00,893769,Carter; Jennifer A,0,0,20,20
1745788972317,MCWP 50R,C00,893771,Krone; Jarret,0,3,20,20
1745788972317,MCWP 50R,D00,893772,Miller; Elizabeth Deen,3,0,20,17
1745788972317,MCWP 50R,E00,893775,Carter; Andrea L,0,0,20,20
1745788973344,MMW 11R,A01,892721,Herbst; Matthew,11,0,27,16
1745788973344,MMW 11R,A02,892722,Herbst; Matthew,0,0,0,3
1745788974374,MMW 12R,A01,892724,Herbst; Matthew,0,9,16,16
1745788974374,MMW 12R,A02,892725,Herbst; Matthew,0,9,16,16
1745788975403,MMW 13R,A01,892727,Staff,0,3,16,16
1745788975403,MMW 13R,A02,892728,Staff,0,4,16,16
1745788975403,MMW 13R,A03,958032,Staff,0,3,16,16
1745788975403,MMW 13R,A04,958033,Staff,0,2,16,16
1745788975403,MMW 13R,A05,958034,Staff,0,3,16,16
1745788976433,SIO 295LS,A00,894015,Staff,7,0,25,18
1745788977459,SIO 295S,A00,894020,Staff,7,0,25,18
1745788978487,SIOC 290S,B01,958918,Staff,0,0,0,0
1745788979514,SIOC 291S,B01,958922,Staff,0,0,0,0
1745788980539,SOCI 117,A01,895339,Staff,4,0,5,1
1745788981566,WES 237B,A00,894149,Staff,11,0,20,9
1745788983630,AESE 279B,A00,891859,Staff,13,0,35,22
1745788984655,AIP 197,001,891854,Staff,70,0,70,0
1745788985684,ANTH 289S,A00,891856,Gagneux; Pascal,12,0,12,0
1745788986709,BENG 196,001,957946,Engler; Adam J.,9996,0,9999,3
1745788987736,CAT 124RS,A01,956906,Staff,8,0,25,17
1745788988763,CAT 125RS,A01,922013,Staff,8,0,25,17
1745788989791,CLRE 250,A00,891860,Morris; Sheldon,9995,0,9999,4
1745788991856,CLRE 251R,A00,907817,Mehta; Ravindra L.,9994,0,9999,5
1745788992883,CLRE 252,A00,891864,Cuomo; Raphael Eduardo,9993,0,9999,6
1745788993912,CLRE 253,A00,891867,Vaida; Florin,9994,0,9999,5
1745788993912,CLRE 253,B00,907819,Staff,9999,0,9999,0
1745788994941,CLRE 259,A00,891868,Patel; Hemal,9998,0,9999,1
1745788995967,CLRE 260,A00,891872,Cuomo; Raphael Eduardo,9999,0,9999,0
1745788996991,CLRE 297,001,891888,Cuomo; Raphael Eduardo,9999,0,9999,0
1745788998015,CSE 191,A00,958773,Minnes Kemp; Mor Mia,9999,0,9999,0
1745788999039,CSS 201S,A01,892054,Mignozzetti; Umberto,30,0,30,0
1745789000066,CSS 202S,A01,892056,Mignozzetti; Umberto,30,0,30,0
1745789001092,DSC 197,001,956898,Eldridge; Justin Matthew,9998,0,9999,1
1745789002118,DSC 297,001,958000,Mazumdar; Arya,9998,0,9999,1
1745789003146,EAP 100,A00,905686,Staff,9776,0,9999,223
1745789004175,ECE 45,A01,892618,Staff,0,12,50,50
1745789005203,ECE 109,A01,892620,Staff,0,43,0,0
1745789006232,ECE 111,A01,892719,Staff,0,7,50,50
1745789007258,ECE 197,001,957920,Mercier; Patrick Philip,9992,0,9999,7
1745789008288,ECON 178,A01,907814,Zhu; Ying,28,0,35,7
1745789009315,EDS 115,A00,895312,Staff,41,0,45,4
1745789010342,EDS 117,A01,895337,Staff,30,0,30,0
1745789011376,EDS 125,A00,895341,Jones; Gabrielle Anastasia,43,0,45,2
1745789012402,EDS 128A,A01,895459,Fargason; Sharon Gayle,44,0,45,1
1745789013433,EDS 128B,A01,895543,Pappas; Elizabeth,44,0,45,1
1745789014459,EDS 139,A00,897203,Pappas; Elizabeth,44,0,45,1
1745789014459,EDS 139,B00,897209,Fargason; Sharon Gayle,44,0,45,1
1745789015486,EDS 201,A00,895545,Staff,43,0,45,2
1745789016511,EDS 203,A01,895581,Halter; Christopher P.,43,0,45,2
1745789017538,EDS 204R,A01,895625,Heinzman; Erica M.,43,0,45,2
1745789017538,EDS 204R,B01,895693,Halter; Christopher P.,18,0,45,27
1745789018567,EDS 206R,A00,895694,Fargason; Sharon Gayle,9,0,30,21
1745789018567,EDS 206R,B00,895695,Choi; Bailey Miyeon,20,0,30,10
1745789019597,EDS 250,A00,895697,Hemans; Patricia Ann Benitez,43,0,45,2
1745789020623,EDS 281,A00,895701,Meyerott; Theresa Ann,15,0,15,0
1745789021652,EDS 284,A00,895736,Meyerott; Theresa Ann,15,0,15,0
1745789022680,EDS 286,A00,897210,Fine; Sarah,15,0,15,0
1745789023711,EDS 289C,A01,895770,Daly; Alan J.,15,0,15,0
1745789024739,EDS 290,A00,897211,Hofstetter; Carolyn,15,0,15,0
1745789025766,LIGM 5A,A00,896162,Fischer-Grunski; Eva K,15,0,20,5
1745789026793,LIGM 5B,A00,896260,Fischer-Grunski; Eva K,17,0,20,3
1745789027820,LIGM 5C,A00,896308,Fischer-Grunski; Eva K,18,0,20,2
1745789028849,LIIT 5AS,A00,896313,Carnelos; Chiara,18,0,20,2
1745789029875,LIIT 5BS,A00,896416,Carnelos; Chiara,20,0,20,0
1745789030903,LIIT 5CS,A00,896564,Carnelos; Chiara,20,0,20,0
1745789031928,LISP 5A,A00,896588,Munoz Sanchez; Alicia,4,0,20,16
1745789032957,LISP 5B,A00,896653,Munoz Sanchez; Alicia,10,0,20,10
1745789033984,LISP 5C,A00,896655,Munoz Sanchez; Alicia,4,0,20,16
1745789035010,MAE 197,001,957918,Kleissl; Jan,9998,0,9999,1
1745789036041,MATH 2,A01,957937,Staff,34,0,35,1
1745789037067,MATH 197,001,957876,Kedlaya; Kiran S.,9993,0,9999,6
1745789038094,MCWP 40,A00,892729,Duru; Nur,13,0,20,7
1745789038094,MCWP 40,B00,893304,Montejo; Carolina,20,0,20,0
1745789039121,MCWP 40R,A00,893757,Redela; Pamela Morgan,0,6,20,20
1745789040150,MCWP 50,A00,893758,Morshed; Michael James,2,0,20,18
1745789040150,MCWP 50,B00,893761,Bartulis; Jason Michael,17,0,20,3
1745789041180,MCWP 50R,A00,893766,Compas; Sean Matthew,0,1,20,20
1745789041180,MCWP 50R,B00,893769,Carter; Jennifer A,0,0,20,20
1745789041180,MCWP 50R,C00,893771,Krone; Jarret,0,3,20,20
1745789041180,MCWP 50R,D00,893772,Miller; Elizabeth Deen,3,0,20,17
1745789041180,MCWP 50R,E00,893775,Carter; Andrea L,0,0,20,20
1745789042210,MMW 11R,A01,892721,Herbst; Matthew,11,0,27,16
1745789042210,MMW 11R,A02,892722,Herbst; Matthew,0,0,0,3
1745789043236,MMW 12R,A01,892724,Herbst; Matthew,0,9,16,16
1745789043236,MMW 12R,A02,892725,Herbst; Matthew,0,9,16,16
1745789044266,MMW 13R,A01,892727,Staff,0,3,16,16
1745789044266,MMW 13R,A02,892728,Staff,0,4,16,16
1745789044266,MMW 13R,A03,958032,Staff,0,3,16,16
1745789044266,MMW 13R,A04,958033,Staff,0,2,16,16
1745789044266,MMW 13R,A05,958034,Staff,0,3,16,16
1745789045293,SIO 295LS,A00,894015,Staff,7,0,25,18
1745789046319,SIO 295S,A00,894020,Staff,7,0,25,18
1745789047345,SIOC 290S,B01,958918,Staff,0,0,0,0
1745789048375,SIOC 291S,B01,958922,Staff,0,0,0,0
1745789049404,SOCI 117,A01,895339,Staff,4,0,5,1
1745789050432,WES 237B,A00,894149,Staff,11,0,20,9
1745789052491,AESE 279B,A00,891859,Staff,13,0,35,22
1745789053518,AIP 197,001,891854,Staff,70,0,70,0
1745789054543,ANTH 289S,A00,891856,Gagneux; Pascal,12,0,12,0
1745789055568,BENG 196,001,957946,Engler; Adam J.,9996,0,9999,3
1745789056594,CAT 124RS,A01,956906,Staff,8,0,25,17
1745789057621,CAT 125RS,A01,922013,Staff,8,0,25,17
1745789058646,CLRE 250,A00,891860,Morris; Sheldon,9995,0,9999,4
1745789060701,CLRE 251R,A00,907817,Mehta; Ravindra L.,9994,0,9999,5
1745789061725,CLRE 252,A00,891864,Cuomo; Raphael Eduardo,9993,0,9999,6
1745789062754,CLRE 253,A00,891867,Vaida; Florin,9994,0,9999,5
1745789062754,CLRE 253,B00,907819,Staff,9999,0,9999,0
1745789063782,CLRE 259,A00,891868,Patel; Hemal,9998,0,9999,1
1745789064808,CLRE 260,A00,891872,Cuomo; Raphael Eduardo,9999,0,9999,0
1745789065835,CLRE 297,001,891888,Cuomo; Raphael Eduardo,9999,0,9999,0
1745789066863,CSE 191,A00,958773,Minnes Kemp; Mor Mia,9999,0,9999,0
1745789067893,CSS 201S,A01,892054,Mignozzetti; Umberto,30,0,30,0
1745789068918,CSS 202S,A01,892056,Mignozzetti; Umberto,30,0,30,0
1745789069944,DSC 197,001,956898,Eldridge; Justin Matthew,9998,0,9999,1
1745789070971,DSC 297,001,958000,Mazumdar; Arya,9998,0,9999,1
1745789071997,EAP 100,A00,905686,Staff,9776,0,9999,223
1745789073023,ECE 45,A01,892618,Staff,0,12,50,50
1745789074049,ECE 109,A01,892620,Staff,0,43,0,0
1745789075076,ECE 111,A01,892719,Staff,0,7,50,50
1745789076101,ECE 197,001,957920,Mercier; Patrick Philip,9992,0,9999,7
1745789077130,ECON 178,A01,907814,Zhu; Ying,28,0,35,7
1745789078160,EDS 115,A00,895312,Staff,41,0,45,4
1745789079190,EDS 117,A01,895337,Staff,30,0,30,0
1745789080221,EDS 125,A00,895341,Jones; Gabrielle Anastasia,43,0,45,2
1745789081247,EDS 128A,A01,895459,Fargason; Sharon Gayle,44,0,45,1
1745789082275,EDS 128B,A01,895543,Pappas; Elizabeth,44,0,45,1
1745789083303,EDS 139,A00,897203,Pappas; Elizabeth,44,0,45,1
1745789083303,EDS 139,B00,897209,Fargason; Sharon Gayle,44,0,45,1
1745789084329,EDS 201,A00,895545,Staff,43,0,45,2
1745789085354,EDS 203,A01,895581,Halter; Christopher P.,43,0,45,2
1745789086381,EDS 204R,A01,895625,Heinzman; Erica M.,43,0,45,2
1745789086381,EDS 204R,B01,895693,Halter; Christopher P.,18,0,45,27
1745789087408,EDS 206R,A00,895694,Fargason; Sharon Gayle,9,0,30,21
1745789087408,EDS 206R,B00,895695,Choi; Bailey Miyeon,20,0,30,10
1745789088434,EDS 250,A00,895697,Hemans; Patricia Ann Benitez,43,0,45,2
1745789089461,EDS 281,A00,895701,Meyerott; Theresa Ann,15,0,15,0
1745789090488,EDS 284,A00,895736,Meyerott; Theresa Ann,15,0,15,0
1745789091516,EDS 286,A00,897210,Fine; Sarah,15,0,15,0
1745789092545,EDS 289C,A01,895770,Daly; Alan J.,15,0,15,0
1745789093570,EDS 290,A00,897211,Hofstetter; Carolyn,15,0,15,0
1745789094597,LIGM 5A,A00,896162,Fischer-Grunski; Eva K,15,0,20,5
1745789095624,LIGM 5B,A00,896260,Fischer-Grunski; Eva K,17,0,20,3
1745789096650,LIGM 5C,A00,896308,Fischer-Grunski; Eva K,18,0,20,2
1745789097676,LIIT 5AS,A00,896313,Carnelos; Chiara,18,0,20,2
1745789098701,LIIT 5BS,A00,896416,Carnelos; Chiara,20,0,20,0
1745789099731,LIIT 5CS,A00,896564,Carnelos; Chiara,20,0,20,0
1745789100758,LISP 5A,A00,896588,Munoz Sanchez; Alicia,4,0,20,16
1745789101782,LISP 5B,A00,896653,Munoz Sanchez; Alicia,10,0,20,10
1745789102808,LISP 5C,A00,896655,Munoz Sanchez; Alicia,4,0,20,16
1745789103834,MAE 197,001,957918,Kleissl; Jan,9998,0,9999,1
1745789104867,MATH 2,A01,957937,Staff,34,0,35,1
1745789105896,MATH 197,001,957876,Kedlaya; Kiran S.,9993,0,9999,6
1745789106924,MCWP 40,A00,892729,Duru; Nur,13,0,20,7
1745789106924,MCWP 40,B00,893304,Montejo; Carolina,20,0,20,0
1745789107950,MCWP 40R,A00,893757,Redela; Pamela Morgan,0,6,20,20
1745789108976,MCWP 50,A00,893758,Morshed; Michael James,2,0,20,18
1745789108976,MCWP 50,B00,893761,Bartulis; Jason Michael,17,0,20,3
1745789110007,MCWP 50R,A00,893766,Compas; Sean Matthew,0,1,20,20
1745789110007,MCWP 50R,B00,893769,Carter; Jennifer A,0,0,20,20
1745789110007,MCWP 50R,C00,893771,Krone; Jarret,0,3,20,20
1745789110007,MCWP 50R,D00,893772,Miller; Elizabeth Deen,3,0,20,17
1745789110007,MCWP 50R,E00,893775,Carter; Andrea L,0,0,20,20
1745789111034,MMW 11R,A01,892721,Herbst; Matthew,11,0,27,16
1745789111034,MMW 11R,A02,892722,Herbst; Matthew,0,0,0,3
1745789112060,MMW 12R,A01,892724,Herbst; Matthew,0,9,16,16
1745789112060,MMW 12R,A02,892725,Herbst; Matthew,0,9,16,16
1745789113089,MMW 13R,A01,892727,Staff,0,3,16,16
1745789113089,MMW 13R,A02,892728,Staff,0,4,16,16
1745789113089,MMW 13R,A03,958032,Staff,0,3,16,16
1745789113089,MMW 13R,A04,958033,Staff,0,2,16,16
1745789113089,MMW 13R,A05,958034,Staff,0,3,16,16
1745789114115,SIO 295LS,A00,894015,Staff,7,0,25,18
1745789115143,SIO 295S,A00,894020,Staff,7,0,25,18
1745789116172,SIOC 290S,B01,958918,Staff,0,0,0,0
1745789117200,SIOC 291S,B01,958922,Staff,0,0,0,0
1745789118226,SOCI 117,A01,895339,Staff,4,0,5,1
1745789119252,WES 237B,A00,894149,Staff,11,0,20,9
1745789121315,AESE 279B,A00,891859,Staff,13,0,35,22
1745789122342,AIP 197,001,891854,Staff,70,0,70,0
1745789123369,ANTH 289S,A00,891856,Gagneux; Pascal,12,0,12,0
1745789124398,BENG 196,001,957946,Engler; Adam J.,9996,0,9999,3
1745789125423,CAT 124RS,A01,956906,Staff,8,0,25,17
1745789126448,CAT 125RS,A01,922013,Staff,8,0,25,17
1745789127475,CLRE 250,A00,891860,Morris; Sheldon,9995,0,9999,4
1745789129530,CLRE 251R,A00,907817,Mehta; Ravindra L.,9994,0,9999,5
1745789130557,CLRE 252,A00,891864,Cuomo; Raphael Eduardo,9993,0,9999,6
1745789131581,CLRE 253,A00,891867,Vaida; Florin,9994,0,9999,5
1745789131581,CLRE 253,B00,907819,Staff,9999,0,9999,0
1745789132608,CLRE 259,A00,891868,Patel; Hemal,9998,0,9999,1
1745789133632,CLRE 260,A00,891872,Cuomo; Raphael Eduardo,9999,0,9999,0
1745789134658,CLRE 297,001,891888,Cuomo; Raphael Eduardo,9999,0,9999,0
1745789135685,CSE 191,A00,958773,Minnes Kemp; Mor Mia,9999,0,9999,0
1745789136715,CSS 201S,A01,892054,Mignozzetti; Umberto,30,0,30,0
1745789137745,CSS 202S,A01,892056,Mignozzetti; Umberto,30,0,30,0
1745789138773,DSC 197,001,956898,Eldridge; Justin Matthew,9998,0,9999,1
1745789139801,DSC 297,001,958000,Mazumdar; Arya,9998,0,9999,1
1745789140828,EAP 100,A00,905686,Staff,9776,0,9999,223
1745789141856,ECE 45,A01,892618,Staff,0,12,50,50
1745789142883,ECE 109,A01,892620,Staff,0,43,0,0
1745789143950,ECE 111,A01,892719,Staff,0,7,50,50
1745789144977,ECE 197,001,957920,Mercier; Patrick Philip,9992,0,9999,7
1745789146003,ECON 178,A01,907814,Zhu; Ying,28,0,35,7
1745789147028,EDS 115,A00,895312,Staff,41,0,45,4
1745789148054,EDS 117,A01,895337,Staff,30,0,30,0
1745789149083,EDS 125,A00,895341,Jones; Gabrielle Anastasia,43,0,45,2
1745789150107,EDS 128A,A01,895459,Fargason; Sharon Gayle,44,0,45,1
1745789151136,EDS 128B,A01,895543,Pappas; Elizabeth,44,0,45,1
1745789152161,EDS 139,A00,897203,Pappas; Elizabeth,44,0,45,1
1745789152161,EDS 139,B00,897209,Fargason; Sharon Gayle,44,0,45,1
1745789153186,EDS 201,A00,895545,Staff,43,0,45,2
1745789154211,EDS 203,A01,895581,Halter; Christopher P.,43,0,45,2
1745789155241,EDS 204R,A01,895625,Heinzman; Erica M.,43,0,45,2
1745789155241,EDS 204R,B01,895693,Halter; Christopher P.,18,0,45,27
1745789156268,EDS 206R,A00,895694,Fargason; Sharon Gayle,9,0,30,21
1745789156268,EDS 206R,B00,895695,Choi; Bailey Miyeon,20,0,30,10
1745789157295,EDS 250,A00,895697,Hemans; Patricia Ann Benitez,43,0,45,2
1745789158321,EDS 281,A00,895701,Meyerott; Theresa Ann,15,0,15,0
1745789159350,EDS 284,A00,895736,Meyerott; Theresa Ann,15,0,15,0
1745789160376,EDS 286,A00,897210,Fine; Sarah,15,0,15,0
1745789161403,EDS 289C,A01,895770,Daly; Alan J.,15,0,15,0
1745789162429,EDS 290,A00,897211,Hofstetter; Carolyn,15,0,15,0
1745789163460,LIGM 5A,A00,896162,Fischer-Grunski; Eva K,15,0,20,5
1745789164485,LIGM 5B,A00,896260,Fischer-Grunski; Eva K,17,0,20,3
1745789165512,LIGM 5C,A00,896308,Fischer-Grunski; Eva K,18,0,20,2
1745789166537,LIIT 5AS,A00,896313,Carnelos; Chiara,18,0,20,2
1745789167564,LIIT 5BS,A00,896416,Carnelos; Chiara,20,0,20,0
1745789168591,LIIT 5CS,A00,896564,Carnelos; Chiara,20,0,20,0
1745789169617,LISP 5A,A00,896588,Munoz Sanchez; Alicia,4,0,20,16
1745789170643,LISP 5B,A00,896653,Munoz Sanchez; Alicia,10,0,20,10
1745789171670,LISP 5C,A00,896655,Munoz Sanchez; Alicia,4,0,20,16
1745789172695,MAE 197,001,957918,Kleissl; Jan,9998,0,9999,1
1745789173720,MATH 2,A01,957937,Staff,34,0,35,1
1745789174751,MATH 197,001,957876,Kedlaya; Kiran S.,9993,0,9999,6
1745789175778,MCWP 40,A00,892729,Duru; Nur,13,0,20,7
1745789175778,MCWP 40,B00,893304,Montejo; Carolina,20,0,20,0
1745789176804,MCWP 40R,A00,893757,Redela; Pamela Morgan,0,6,20,20
1745789177831,MCWP 50,A00,893758,Morshed; Michael James,2,0,20,18
1745789177831,MCWP 50,B00,893761,Bartulis; Jason Michael,17,0,20,3
1745789178858,MCWP 50R,A00,893766,Compas; Sean Matthew,0,1,20,20
1745789178858,MCWP 50R,B00,893769,Carter; Jennifer A,0,0,20,20
1745789178858,MCWP 50R,C00,893771,Krone; Jarret,0,3,20,20
1745789178858,MCWP 50R,D00,893772,Miller; Elizabeth Deen,3,0,20,17
1745789178858,MCWP 50R,E00,893775,Carter; Andrea L,0,0,20,20
1745789179883,MMW 11R,A01,892721,Herbst; Matthew,11,0,27,16
1745789179883,MMW 11R,A02,892722,Herbst; Matthew,0,0,0,3
1745789180908,MMW 12R,A01,892724,Herbst; Matthew,0,9,16,16
1745789180908,MMW 12R,A02,892725,Herbst; Matthew,0,9,16,16
1745789181939,MMW 13R,A01,892727,Staff,0,3,16,16
1745789181939,MMW 13R,A02,892728,Staff,0,4,16,16
1745789181939,MMW 13R,A03,958032,Staff,0,3,16,16
1745789181939,MMW 13R,A04,958033,Staff,0,2,16,16
1745789181939,MMW 13R,A05,958034,Staff,0,3,16,16
1745789182965,SIO 295LS,A00,894015,Staff,7,0,25,18
1745789183990,SIO 295S,A00,894020,Staff,7,0,25,18
1745789185019,SIOC 290S,B01,958918,Staff,0,0,0,0
1745789186045,SIOC 291S,B01,958922,Staff,0,0,0,0
1745789187074,SOCI 117,A01,895339,Staff,4,0,5,1
1745789188104,WES 237B,A00,894149,Staff,11,0,20,9
1745789190158,AESE 279B,A00,891859,Staff,13,0,35,22
1745789191184,AIP 197,001,891854,Staff,70,0,70,0
1745789192212,ANTH 289S,A00,891856,Gagneux; Pascal,12,0,12,0
1745789193241,BENG 196,001,957946,Engler; Adam J.,9996,0,9999,3
1745789194266,CAT 124RS,A01,956906,Staff,8,0,25,17
1745789195294,CAT 125RS,A01,922013,Staff,8,0,25,17
1745789196323,CLRE 250,A00,891860,Morris; Sheldon,9995,0,9999,4
1745789198374,CLRE 251R,A00,907817,Mehta; Ravindra L.,9994,0,9999,5
1745789199401,CLRE 252,A00,891864,Cuomo; Raphael Eduardo,9993,0,9999,6
1745789200429,CLRE 253,A00,891867,Vaida; Florin,9994,0,9999,5
1745789200429,CLRE 253,B00,907819,Staff,9999,0,9999,0
1745789201455,CLRE 259,A00,891868,Patel; Hemal,9998,0,9999,1
1745789202481,CLRE 260,A00,891872,Cuomo; Raphael Eduardo,9999,0,9999,0
1745789203507,CLRE 297,001,891888,Cuomo; Raphael Eduardo,9999,0,9999,0
1745789204537,CSE 191,A00,958773,Minnes Kemp; Mor Mia,9999,0,9999,0
1745789205566,CSS 201S,A01,892054,Mignozzetti; Umberto,30,0,30,0
1745789206591,CSS 202S,A01,892056,Mignozzetti; Umberto,30,0,30,0
1745789207618,DSC 197,001,956898,Eldridge; Justin Matthew,9998,0,9999,1
1745789208645,DSC 297,001,958000,Mazumdar; Arya,9998,0,9999,1
1745789209671,EAP 100,A00,905686,Staff,9776,0,9999,223
1745789210697,ECE 45,A01,892618,Staff,0,12,50,50
1745789211725,ECE 109,A01,892620,Staff,0,43,0,0
1745789212754,ECE 111,A01,892719,Staff,0,7,50,50
1745789213783,ECE 197,001,957920,Mercier; Patrick Philip,9992,0,9999,7
1745789214811,ECON 178,A01,907814,Zhu; Ying,28,0,35,7
1745789215836,EDS 115,A00,895312,Staff,41,0,45,4
1745789216862,EDS 117,A01,895337,Staff,30,0,30,0
1745789217889,EDS 125,A00,895341,Jones; Gabrielle Anastasia,43,0,45,2
1745789218914,EDS 128A,A01,895459,Fargason; Sharon Gayle,44,0,45,1
1745789219941,EDS 128B,A01,895543,Pappas; Elizabeth,44,0,45,1
1745789220966,EDS 139,A00,897203,Pappas; Elizabeth,44,0,45,1
1745789220966,EDS 139,B00,897209,Fargason; Sharon Gayle,44,0,45,1
1745789221994,EDS 201,A00,895545,Staff,43,0,45,2
1745789223022,EDS 203,A01,895581,Halter; Christopher P.,43,0,45,2
1745789224051,EDS 204R,A01,895625,Heinzman; Erica M.,43,0,45,2
1745789224051,EDS 204R,B01,895693,Halter; Christopher P.,18,0,45,27
1745789225077,EDS 206R,A00,895694,Fargason; Sharon Gayle,9,0,30,21
1745789225077,EDS 206R,B00,895695,Choi; Bailey Miyeon,20,0,30,10
1745789226104,EDS 250,A00,895697,Hemans; Patricia Ann Benitez,43,0,45,2
1745789227132,EDS 281,A00,895701,Meyerott; Theresa Ann,15,0,15,0
1745789228160,EDS 284,A00,895736,Meyerott; Theresa Ann,15,0,15,0
1745789229185,EDS 286,A00,897210,Fine; Sarah,15,0,15,0
1745789230214,EDS 289C,A01,895770,Daly; Alan J.,15,0,15,0
1745789231239,EDS 290,A00,897211,Hofstetter; Carolyn,15,0,15,0
1745789232267,LIGM 5A,A00,896162,Fischer-Grunski; Eva K,15,0,20,5
1745789233294,LIGM 5B,A00,896260,Fischer-Grunski; Eva K,17,0,20,3
1745789234320,LIGM 5C,A00,896308,Fischer-Grunski; Eva K,18,0,20,2
1745789235347,LIIT 5AS,A00,896313,Carnelos; Chiara,18,0,20,2
1745789236377,LIIT 5BS,A00,896416,Carnelos; Chiara,20,0,20,0
1745789237404,LIIT 5CS,A00,896564,Carnelos; Chiara,20,0,20,0
1745789238428,LISP 5A,A00,896588,Munoz Sanchez; Alicia,4,0,20,16
1745789239453,LISP 5B,A00,896653,Munoz Sanchez; Alicia,10,0,20,10
1745789240483,LISP 5C,A00,896655,Munoz Sanchez; Alicia,4,0,20,16
1745789241510,MAE 197,001,957918,Kleissl; Jan,9998,0,9999,1
1745789242535,MATH 2,A01,957937,Staff,34,0,35,1
1745789243564,MATH 197,001,957876,Kedlaya; Kiran S.,9993,0,9999,6
1745789244592,MCWP 40,A00,892729,Duru; Nur,13,0,20,7
1745789244592,MCWP 40,B00,893304,Montejo; Carolina,20,0,20,0
1745789245616,MCWP 40R,A00,893757,Redela; Pamela Morgan,0,6,20,20
1745789246643,MCWP 50,A00,893758,Morshed; Michael James,2,0,20,18
1745789246643,MCWP 50,B00,893761,Bartulis; Jason Michael,17,0,20,3
1745789247668,MCWP 50R,A00,893766,Compas; Sean Matthew,0,1,20,20
1745789247668,MCWP 50R,B00,893769,Carter; Jennifer A,0,0,20,20
1745789247668,MCWP 50R,C00,893771,Krone; Jarret,0,3,20,20
1745789247668,MCWP 50R,D00,893772,Miller; Elizabeth Deen,3,0,20,17
1745789247668,MCWP 50R,E00,893775,Carter; Andrea L,0,0,20,20
1745789248693,MMW 11R,A01,892721,Herbst; Matthew,11,0,27,16
1745789248693,MMW 11R,A02,892722,Herbst; Matthew,0,0,0,3
1745789249720,MMW 12R,A01,892724,Herbst; Matthew,0,9,16,16
1745789249720,MMW 12R,A02,892725,Herbst; Matthew,0,9,16,16
1745789250746,MMW 13R,A01,892727,Staff,0,3,16,16
1745789250746,MMW 13R,A02,892728,Staff,0,4,16,16
1745789250746,MMW 13R,A03,958032,Staff,0,3,16,16
1745789250746,MMW 13R,A04,958033,Staff,0,2,16,16
1745789250746,MMW 13R,A05,958034,Staff,0,3,16,16
1745789251772,SIO 295LS,A00,894015,Staff,7,0,25,18
1745789252802,SIO 295S,A00,894020,Staff,7,0,25,18
1745789253828,SIOC 290S,B01,958918,Staff,0,0,0,0
1745789254854,SIOC 291S,B01,958922,Staff,0,0,0,0
1745789255881,SOCI 117,A01,895339,Staff,4,0,5,1
1745789256908,WES 237B,A00,894149,Staff,11,0,20,9
1745789258969,AESE 279B,A00,891859,Staff,13,0,35,22
1745789259995,AIP 197,001,891854,Staff,70,0,70,0
1745789261024,ANTH 289S,A00,891856,Gagneux; Pascal,12,0,12,0
1745789262052,BENG 196,001,957946,Engler; Adam J.,9996,0,9999,3
1745789263079,CAT 124RS,A01,956906,Staff,8,0,25,17
1745789264105,CAT 125RS,A01,922013,Staff,8,0,25,17
1745789265134,CLRE 250,A00,891860,Morris; Sheldon,9995,0,9999,4
1745789267186,CLRE 251R,A00,907817,Mehta; Ravindra L.,9994,0,9999,5
1745789268213,CLRE 252,A00,891864,Cuomo; Raphael Eduardo,9993,0,9999,6
1745789269240,CLRE 253,A00,891867,Vaida; Florin,9994,0,9999,5
1745789269240,CLRE 253,B00,907819,Staff,9999,0,9999,0
1745789270267,CLRE 259,A00,891868,Patel; Hemal,9998,0,9999,1
1745789271294,CLRE 260,A00,891872,Cuomo; Raphael Eduardo,9999,0,9999,0
1745789272322,CLRE 297,001,891888,Cuomo; Raphael Eduardo,9999,0,9999,0
1745789273346,CSE 191,A00,958773,Minnes Kemp; Mor Mia,9999,0,9999,0
1745789274372,CSS 201S,A01,892054,Mignozzetti; Umberto,30,0,30,0
1745789275399,CSS 202S,A01,892056,Mignozzetti; Umberto,30,0,30,0
1745789276424,DSC 197,001,956898,Eldridge; Justin Matthew,9998,0,9999,1
1745789277450,DSC 297,001,958000,Mazumdar; Arya,9998,0,9999,1
1745789278477,EAP 100,A00,905686,Staff,9776,0,9999,223
1745789279505,ECE 45,A01,892618,Staff,0,12,50,50
1745789280531,ECE 109,A01,892620,Staff,0,43,0,0
1745789281556,ECE 111,A01,892719,Staff,0,7,50,50
1745789282581,ECE 197,001,957920,Mercier; Patrick Philip,9992,0,9999,7
1745789283607,ECON 178,A01,907814,Zhu; Ying,28,0,35,7
1745789284632,EDS 115,A00,895312,Staff,41,0,45,4
1745789285657,EDS 117,A01,895337,Staff,30,0,30,0
1745789286685,EDS 125,A00,895341,Jones; Gabrielle Anastasia,43,0,45,2
1745789287708,EDS 128A,A01,895459,Fargason; Sharon Gayle,44,0,45,1
1745789288734,EDS 128B,A01,895543,Pappas; Elizabeth,44,0,45,1
1745789289759,EDS 139,A00,897203,Pappas; Elizabeth,44,0,45,1
1745789289759,EDS 139,B00,897209,Fargason; Sharon Gayle,44,0,45,1
1745789290787,EDS 201,A00,895545,Staff,43,0,45,2
1745789291814,EDS 203,A01,895581,Halter; Christopher P.,43,0,45,2
1745789292843,EDS 204R,A01,895625,Heinzman; Erica M.,43,0,45,2
1745789292843,EDS 204R,B01,895693,Halter; Christopher P.,18,0,45,27
1745789293875,EDS 206R,A00,895694,Fargason; Sharon Gayle,9,0,30,21
1745789293875,EDS 206R,B00,895695,Choi; Bailey Miyeon,20,0,30,10
1745789294901,EDS 250,A00,895697,Hemans; Patricia Ann Benitez,43,0,45,2
1745789295926,EDS 281,A00,895701,Meyerott; Theresa Ann,15,0,15,0
1745789296951,EDS 284,A00,895736,Meyerott; Theresa Ann,15,0,15,0
1745789297979,EDS 286,A00,897210,Fine; Sarah,15,0,15,0
1745789299005,EDS 289C,A01,895770,Daly; Alan J.,15,0,15,0
1745789300030,EDS 290,A00,897211,Hofstetter; Carolyn,15,0,15,0
1745789301056,LIGM 5A,A00,896162,Fischer-Grunski; Eva K,15,0,20,5
1745789302084,LIGM 5B,A00,896260,Fischer-Grunski; Eva K,17,0,20,3
1745789303112,LIGM 5C,A00,896308,Fischer-Grunski; Eva K,18,0,20,2
1745789304142,LIIT 5AS,A00,896313,Carnelos; Chiara,18,0,20,2
1745789305167,LIIT 5BS,A00,896416,Carnelos; Chiara,20,0,20,0
1745789306194,LIIT 5CS,A00,896564,Carnelos; Chiara,20,0,20,0
1745789307219,LISP 5A,A00,896588,Munoz Sanchez; Alicia,4,0,20,16
1745789308245,LISP 5B,A00,896653,Munoz Sanchez; Alicia,10,0,20,10
1745789309276,LISP 5C,A00,896655,Munoz Sanchez; Alicia,4,0,20,16
1745789310300,MAE 197,001,957918,Kleissl; Jan,9998,0,9999,1
1745789311325,MATH 2,A01,957937,Staff,34,0,35,1
1745789312355,MATH 197,001,957876,Kedlaya; Kiran S.,9993,0,9999,6
1745789313381,MCWP 40,A00,892729,Duru; Nur,13,0,20,7
1745789313381,MCWP 40,B00,893304,Montejo; Carolina,20,0,20,0
1745789314406,MCWP 40R,A00,893757,Redela; Pamela Morgan,0,6,20,20
1745789315436,MCWP 50,A00,893758,Morshed; Michael James,2,0,20,18
1745789315436,MCWP 50,B00,893761,Bartulis; Jason Michael,17,0,20,3
1745789316467,MCWP 50R,A00,893766,Compas; Sean Matthew,0,1,20,20
1745789316467,MCWP 50R,B00,893769,Carter; Jennifer A,0,0,20,20
1745789316467,MCWP 50R,C00,893771,Krone; Jarret,0,3,20,20
1745789316467,MCWP 50R,D00,893772,Miller; Elizabeth Deen,3,0,20,17
1745789316467,MCWP 50R,E00,893775,Carter; Andrea L,0,0,20,20
1745789317492,MMW 11R,A01,892721,Herbst; Matthew,11,0,27,16
1745789317492,MMW 11R,A02,892722,Herbst; Matthew,0,0,0,3
1745789318521,MMW 12R,A01,892724,Herbst; Matthew,0,9,16,16
1745789318521,MMW 12R,A02,892725,Herbst; Matthew,0,9,16,16
1745789319553,MMW 13R,A01,892727,Staff,0,3,16,16
1745789319553,MMW 13R,A02,892728,Staff,0,4,16,16
1745789319553,MMW 13R,A03,958032,Staff,0,3,16,16
1745789319553,MMW 13R,A04,958033,Staff,0,2,16,16
1745789319553,MMW 13R,A05,958034,Staff,0,3,16,16
1745789320579,SIO 295LS,A00,894015,Staff,7,0,25,18
1745789321604,SIO 295S,A00,894020,Staff,7,0,25,18
1745789322635,SIOC 290S,B01,958918,Staff,0,0,0,0
1745789323661,SIOC 291S,B01,958922,Staff,0,0,0,0
1745789324687,SOCI 117,A01,895339,Staff,4,0,5,1
1745789325712,WES 237B,A00,894149,Staff,11,0,20,9
1745789327775,AESE 279B,A00,891859,Staff,13,0,35,22
1745789328801,AIP 197,001,891854,Staff,70,0,70,0
1745789329831,ANTH 289S,A00,891856,Gagneux; Pascal,12,0,12,0
1745789330858,BENG 196,001,957946,Engler; Adam J.,9996,0,9999,3
1745789331884,CAT 124RS,A01,956906,Staff,8,0,25,17
1745789332911,CAT 125RS,A01,922013,Staff,8,0,25,17
1745789333936,CLRE 250,A00,891860,Morris; Sheldon,9995,0,9999,4
1745789335991,CLRE 251R,A00,907817,Mehta; Ravindra L.,9994,0,9999,5
1745789337019,CLRE 252,A00,891864,Cuomo; Raphael Eduardo,9993,0,9999,6
1745789338051,CLRE 253,A00,891867,Vaida; Florin,9994,0,9999,5
1745789338051,CLRE 253,B00,907819,Staff,9999,0,9999,0
1745789339075,CLRE 259,A00,891868,Patel; Hemal,9998,0,9999,1
1745789340101,CLRE 260,A00,891872,Cuomo; Raphael Eduardo,9999,0,9999,0
1745789341125,CLRE 297,001,891888,Cuomo; Raphael Eduardo,9999,0,9999,0
1745789342151,CSE 191,A00,958773,Minnes Kemp; Mor Mia,9999,0,9999,0
1745789343176,CSS 201S,A01,892054,Mignozzetti; Umberto,30,0,30,0
1745789344206,CSS 202S,A01,892056,Mignozzetti; Umberto,30,0,30,0
1745789345230,DSC 197,001,956898,Eldridge; Justin Matthew,9998,0,9999,1
1745789346257,DSC 297,001,958000,Mazumdar; Arya,9998,0,9999,1
1745789347282,EAP 100,A00,905686,Staff,9776,0,9999,223
1745789348306,ECE 45,A01,892618,Staff,0,12,50,50
1745789349335,ECE 109,A01,892620,Staff,0,43,0,0
1745789350363,ECE 111,A01,892719,Staff,0,7,50,50
1745789351443,ECE 197,001,957920,Mercier; Patrick Philip,9992,0,9999,7
1745789352471,ECON 178,A01,907814,Zhu; Ying,28,0,35,7
1745789353497,EDS 115,A00,895312,Staff,41,0,45,4
1745789354526,EDS 117,A01,895337,Staff,30,0,30,0
1745789355554,EDS 125,A00,895341,Jones; Gabrielle Anastasia,43,0,45,2
1745789356579,EDS 128A,A01,895459,Fargason; Sharon Gayle,44,0,45,1
1745789357605,EDS 128B,A01,895543,Pappas; Elizabeth,44,0,45,1
1745789358629,EDS 139,A00,897203,Pappas; Elizabeth,44,0,45,1
1745789358629,EDS 139,B00,897209,Fargason; Sharon Gayle,44,0,45,1
1745789359654,EDS 201,A00,895545,Staff,43,0,45,2
1745789360684,EDS 203,A01,895581,Halter; Christopher P.,43,0,45,2
1745789361709,EDS 204R,A01,895625,Heinzman; Erica M.,43,0,45,2
1745789361709,EDS 204R,B01,895693,Halter; Christopher P.,18,0,45,27
1745789362738,EDS 206R,A00,895694,Fargason; Sharon Gayle,9,0,30,21
1745789362738,EDS 206R,B00,895695,Choi; Bailey Miyeon,20,0,30,10
1745789363766,EDS 250,A00,895697,Hemans; Patricia Ann Benitez,43,0,45,2
1745789364792,EDS 281,A00,895701,Meyerott; Theresa Ann,15,0,15,0
1745789365818,EDS 284,A00,895736,Meyerott; Theresa Ann,15,0,15,0
1745789366845,EDS 286,A00,897210,Fine; Sarah,15,0,15,0
1745789367870,EDS 289C,A01,895770,Daly; Alan J.,15,0,15,0
1745789368896,EDS 290,A00,897211,Hofstetter; Carolyn,15,0,15,0
1745789369921,LIGM 5A,A00,896162,Fischer-Grunski; Eva K,15,0,20,5
1745789370946,LIGM 5B,A00,896260,Fischer-Grunski; Eva K,17,0,20,3
1745789371974,LIGM 5C,A00,896308,Fischer-Grunski; Eva K,18,0,20,2
1745789373001,LIIT 5AS,A00,896313,Carnelos; Chiara,18,0,20,2
1745789374027,LIIT 5BS,A00,896416,Carnelos; Chiara,20,0,20,0
1745789375054,LIIT 5CS,A00,896564,Carnelos; Chiara,20,0,20,0
1745789376084,LISP 5A,A00,896588,Munoz Sanchez; Alicia,4,0,20,16
1745789377109,LISP 5B,A00,896653,Munoz Sanchez; Alicia,10,0,20,10
1745789378137,LISP 5C,A00,896655,Munoz Sanchez; Alicia,4,0,20,16
1745789379167,MAE 197,001,957918,Kleissl; Jan,9998,0,9999,1
1745789380192,MATH 2,A01,957937,Staff,34,0,35,1
1745789381250,MATH 197,001,957876,Kedlaya; Kiran S.,9993,0,9999,6
1745789382281,MCWP 40,A00,892729,Duru; Nur,13,0,20,7
1745789382281,MCWP 40,B00,893304,Montejo; Carolina,20,0,20,0
1745789383307,MCWP 40R,A00,893757,Redela; Pamela Morgan,0,6,20,20
1745789384331,MCWP 50,A00,893758,Morshed; Michael James,2,0,20,18
1745789384331,MCWP 50,B00,893761,Bartulis; Jason Michael,17,0,20,3
1745789385354,MCWP 50R,A00,893766,Compas; Sean Matthew,0,1,20,20
1745789385354,MCWP 50R,B00,893769,Carter; Jennifer A,0,0,20,20
1745789385354,MCWP 50R,C00,893771,Krone; Jarret,0,3,20,20
1745789385354,MCWP 50R,D00,893772,Miller; Elizabeth Deen,3,0,20,17
1745789385354,MCWP 50R,E00,893775,Carter; Andrea L,0,0,20,20
1745789386380,MMW 11R,A01,892721,Herbst; Matthew,11,0,27,16
1745789386380,MMW 11R,A02,892722,Herbst; Matthew,0,0,0,3
1745789387407,MMW 12R,A01,892724,Herbst; Matthew,0,9,16,16
1745789387407,MMW 12R,A02,892725,Herbst; Matthew,0,9,16,16
1745789388435,MMW 13R,A01,892727,Staff,0,3,16,16
1745789388435,MMW 13R,A02,892728,Staff,0,4,16,16
1745789388435,MMW 13R,A03,958032,Staff,0,3,16,16
1745789388435,MMW 13R,A04,958033,Staff,0,2,16,16
1745789388435,MMW 13R,A05,958034,Staff,0,3,16,16
1745789389462,SIO 295LS,A00,894015,Staff,7,0,25,18
1745789390488,SIO 295S,A00,894020,Staff,7,0,25,18
1745789391513,SIOC 290S,B01,958918,Staff,0,0,0,0
1745789392542,SIOC 291S,B01,958922,Staff,0,0,0,0
1745789393570,SOCI 117,A01,895339,Staff,4,0,5,1
1745789394595,WES 237B,A00,894149,Staff,11,0,20,9
1745789396651,AESE 279B,A00,891859,Staff,13,0,35,22
1745789397679,AIP 197,001,891854,Staff,70,0,70,0
1745789398707,ANTH 289S,A00,891856,Gagneux; Pascal,12,0,12,0
1745789399733,BENG 196,001,957946,Engler; Adam J.,9996,0,9999,3
1745789400759,CAT 124RS,A01,956906,Staff,8,0,25,17
1745789401790,CAT 125RS,A01,922013,Staff,8,0,25,17
1745789402820,CLRE 250,A00,891860,Morris; Sheldon,9995,0,9999,4
1745789404876,CLRE 251R,A00,907817,Mehta; Ravindra L.,9994,0,9999,5
1745789405901,CLRE 252,A00,891864,Cuomo; Raphael Eduardo,9993,0,9999,6
1745789406929,CLRE 253,A00,891867,Vaida; Florin,9994,0,9999,5
1745789406929,CLRE 253,B00,907819,Staff,9999,0,9999,0
1745789407954,CLRE 259,A00,891868,Patel; Hemal,9998,0,9999,1
1745789408979,CLRE 260,A00,891872,Cuomo; Raphael Eduardo,9999,0,9999,0
1745789410009,CLRE 297,001,891888,Cuomo; Raphael Eduardo,9999,0,9999,0
1745789411038,CSE 191,A00,958773,Minnes Kemp; Mor Mia,9999,0,9999,0
1745789412065,CSS 201S,A01,892054,Mignozzetti; Umberto,30,0,30,0
1745789413090,CSS 202S,A01,892056,Mignozzetti; Umberto,30,0,30,0
1745789414115,DSC 197,001,956898,Eldridge; Justin Matthew,9998,0,9999,1
1745789415141,DSC 297,001,958000,Mazumdar; Arya,9998,0,9999,1
1745789416167,EAP 100,A00,905686,Staff,9776,0,9999,223
1745789417195,ECE 45,A01,892618,Staff,0,12,50,50
1745789418221,ECE 109,A01,892620,Staff,0,43,0,0
1745789419246,ECE 111,A01,892719,Staff,0,7,50,50
1745789420274,ECE 197,001,957920,Mercier; Patrick Philip,9992,0,9999,7
1745789421301,ECON 178,A01,907814,Zhu; Ying,28,0,35,7
1745789422326,EDS 115,A00,895312,Staff,41,0,45,4
1745789423352,EDS 117,A01,895337,Staff,30,0,30,0
1745789424379,EDS 125,A00,895341,Jones; Gabrielle Anastasia,43,0,45,2
1745789425404,EDS 128A,A01,895459,Fargason; Sharon Gayle,44,0,45,1
1745789426434,EDS 128B,A01,895543,Pappas; Elizabeth,44,0,45,1
1745789427459,EDS 139,A00,897203,Pappas; Elizabeth,44,0,45,1
1745789427459,EDS 139,B00,897209,Fargason; Sharon Gayle,44,0,45,1
1745789428482,EDS 201,A00,895545,Staff,43,0,45,2
1745789429508,EDS 203,A01,895581,Halter; Christopher P.,43,0,45,2
1745789430535,EDS 204R,A01,895625,Heinzman; Erica M.,43,0,45,2
1745789430535,EDS 204R,B01,895693,Halter; Christopher P.,18,0,45,27
1745789431558,EDS 206R,A00,895694,Fargason; Sharon Gayle,9,0,30,21
1745789431558,EDS 206R,B00,895695,Choi; Bailey Miyeon,20,0,30,10
1745789432585,EDS 250,A00,895697,Hemans; Patricia Ann Benitez,43,0,45,2
1745789433611,EDS 281,A00,895701,Meyerott; Theresa Ann,15,0,15,0
1745789434638,EDS 284,A00,895736,Meyerott; Theresa Ann,15,0,15,0
1745789435665,EDS 286,A00,897210,Fine; Sarah,15,0,15,0
1745789436690,EDS 289C,A01,895770,Daly; Alan J.,15,0,15,0
1745789437718,EDS 290,A00,897211,Hofstetter; Carolyn,15,0,15,0
1745789438747,LIGM 5A,A00,896162,Fischer-Grunski; Eva K,15,0,20,5
1745789439773,LIGM 5B,A00,896260,Fischer-Grunski; Eva K,17,0,20,3
1745789440800,LIGM 5C,A00,896308,Fischer-Grunski; Eva K,18,0,20,2
1745789441826,LIIT 5AS,A00,896313,Carnelos; Chiara,18,0,20,2
1745789442853,LIIT 5BS,A00,896416,Carnelos; Chiara,20,0,20,0
1745789443879,LIIT 5CS,A00,896564,Carnelos; Chiara,20,0,20,0
1745789444904,LISP 5A,A00,896588,Munoz Sanchez; Alicia,4,0,20,16
1745789445931,LISP 5B,A00,896653,Munoz Sanchez; Alicia,10,0,20,10
1745789446961,LISP 5C,A00,896655,Munoz Sanchez; Alicia,4,0,20,16
1745789448004,MAE 197,001,957918,Kleissl; Jan,9998,0,9999,1
1745789449029,MATH 2,A01,957937,Staff,34,0,35,1
1745789450058,MATH 197,001,957876,Kedlaya; Kiran S.,9993,0,9999,6
1745789451087,MCWP 40,A00,892729,Duru; Nur,13,0,20,7
1745789451087,MCWP 40,B00,893304,Montejo; Carolina,20,0,20,0
1745789452114,MCWP 40R,A00,893757,Redela; Pamela Morgan,0,6,20,20
1745789453139,MCWP 50,A00,893758,Morshed; Michael James,2,0,20,18
1745789453139,MCWP 50,B00,893761,Bartulis; Jason Michael,17,0,20,3
1745789454165,MCWP 50R,A00,893766,Compas; Sean Matthew,0,1,20,20
1745789454165,MCWP 50R,B00,893769,Carter; Jennifer A,0,0,20,20
1745789454165,MCWP 50R,C00,893771,Krone; Jarret,0,3,20,20
1745789454165,MCWP 50R,D00,893772,Miller; Elizabeth Deen,3,0,20,17
1745789454165,MCWP 50R,E00,893775,Carter; Andrea L,0,0,20,20
1745789455249,MMW 11R,A01,892721,Herbst; Matthew,11,0,27,16
1745789455249,MMW 11R,A02,892722,Herbst; Matthew,0,0,0,3
1745789456275,MMW 12R,A01,892724,Herbst; Matthew,0,9,16,16
1745789456275,MMW 12R,A02,892725,Herbst; Matthew,0,9,16,16
1745789457304,MMW 13R,A01,892727,Staff,0,3,16,16
1745789457304,MMW 13R,A02,892728,Staff,0,4,16,16
1745789457304,MMW 13R,A03,958032,Staff,0,3,16,16
1745789457304,MMW 13R,A04,958033,Staff,0,2,16,16
1745789457304,MMW 13R,A05,958034,Staff,0,3,16,16
1745789458329,SIO 295LS,A00,894015,Staff,7,0,25,18
1745789459357,SIO 295S,A00,894020,Staff,7,0,25,18
1745789460387,SIOC 290S,B01,958918,Staff,0,0,0,0
1745789461415,SIOC 291S,B01,958922,Staff,0,0,0,0
1745789462441,SOCI 117,A01,895339,Staff,4,0,5,1
1745789463468,WES 237B,A00,894149,Staff,11,0,20,9
1745789465522,AESE 279B,A00,891859,Staff,13,0,35,22
1745789466549,AIP 197,001,891854,Staff,70,0,70,0
1745789467574,ANTH 289S,A00,891856,Gagneux; Pascal,12,0,12,0
1745789468599,BENG 196,001,957946,Engler; Adam J.,9996,0,9999,3
1745789469627,CAT 124RS,A01,956906,Staff,8,0,25,17
1745789470655,CAT 125RS,A01,922013,Staff,8,0,25,17
1745789471685,CLRE 250,A00,891860,Morris; Sheldon,9995,0,9999,4
1745789473740,CLRE 251R,A00,907817,Mehta; Ravindra L.,9994,0,9999,5
1745789474766,CLRE 252,A00,891864,Cuomo; Raphael Eduardo,9993,0,9999,6
1745789475796,CLRE 253,A00,891867,Vaida; Florin,9994,0,9999,5
1745789475796,CLRE 253,B00,907819,Staff,9999,0,9999,0
1745789476822,CLRE 259,A00,891868,Patel; Hemal,9998,0,9999,1
1745789477850,CLRE 260,A00,891872,Cuomo; Raphael Eduardo,9999,0,9999,0
1745789478875,CLRE 297,001,891888,Cuomo; Raphael Eduardo,9999,0,9999,0
1745789479901,CSE 191,A00,958773,Minnes Kemp; Mor Mia,9999,0,9999,0
1745789480926,CSS 201S,A01,892054,Mignozzetti; Umberto,30,0,30,0
1745789481953,CSS 202S,A01,892056,Mignozzetti; Umberto,30,0,30,0
1745789482980,DSC 197,001,956898,Eldridge; Justin Matthew,9998,0,9999,1
1745789484006,DSC 297,001,958000,Mazumdar; Arya,9998,0,9999,1
1745789485035,EAP 100,A00,905686,Staff,9776,0,9999,223
1745789486066,ECE 45,A01,892618,Staff,0,12,50,50
1745789487094,ECE 109,A01,892620,Staff,0,43,0,0
1745789488122,ECE 111,A01,892719,Staff,0,7,50,50
1745789489148,ECE 197,001,957920,Mercier; Patrick Philip,9992,0,9999,7
1745789490176,ECON 178,A01,907814,Zhu; Ying,28,0,35,7
1745789491202,EDS 115,A00,895312,Staff,41,0,45,4
1745789492228,EDS 117,A01,895337,Staff,30,0,30,0
1745789493253,EDS 125,A00,895341,Jones; Gabrielle Anastasia,43,0,45,2
1745789494283,EDS 128A,A01,895459,Fargason; Sharon Gayle,44,0,45,1
1745789495310,EDS 128B,A01,895543,Pappas; Elizabeth,44,0,45,1
1745789496335,EDS 139,A00,897203,Pappas; Elizabeth,44,0,45,1
1745789496335,EDS 139,B00,897209,Fargason; Sharon Gayle,44,0,45,1
1745789497361,EDS 201,A00,895545,Staff,43,0,45,2
1745789498389,EDS 203,A01,895581,Halter; Christopher P.,43,0,45,2
1745789499416,EDS 204R,A01,895625,Heinzman; Erica M.,43,0,45,2
1745789499416,EDS 204R,B01,895693,Halter; Christopher P.,18,0,45,27
1745789500443,EDS 206R,A00,895694,Fargason; Sharon Gayle,9,0,30,21
1745789500443,EDS 206R,B00,895695,Choi; Bailey Miyeon,20,0,30,10
1745789501468,EDS 250,A00,895697,Hemans; Patricia Ann Benitez,43,0,45,2
1745789502496,EDS 281,A00,895701,Meyerott; Theresa Ann,15,0,15,0
1745789503523,EDS 284,A00,895736,Meyerott; Theresa Ann,15,0,15,0
1745789504550,EDS 286,A00,897210,Fine; Sarah,15,0,15,0
1745789505577,EDS 289C,A01,895770,Daly; Alan J.,15,0,15,0
1745789506601,EDS 290,A00,897211,Hofstetter; Carolyn,15,0,15,0
1745789507630,LIGM 5A,A00,896162,Fischer-Grunski; Eva K,15,0,20,5
1745789508660,LIGM 5B,A00,896260,Fischer-Grunski; Eva K,17,0,20,3
1745789509686,LIGM 5C,A00,896308,Fischer-Grunski; Eva K,18,0,20,2
1745789510716,LIIT 5AS,A00,896313,Carnelos; Chiara,18,0,20,2
1745789511746,LIIT 5BS,A00,896416,Carnelos; Chiara,20,0,20,0
1745789512775,LIIT 5CS,A00,896564,Carnelos; Chiara,20,0,20,0
1745789513804,LISP 5A,A00,896588,Munoz Sanchez; Alicia,4,0,20,16
1745789514830,LISP 5B,A00,896653,Munoz Sanchez; Alicia,10,0,20,10
1745789515856,LISP 5C,A00,896655,Munoz Sanchez; Alicia,4,0,20,16
1745789516886,MAE 197,001,957918,Kleissl; Jan,9998,0,9999,1
1745789517914,MATH 2,A01,957937,Staff,34,0,35,1
1745789518940,MATH 197,001,957876,Kedlaya; Kiran S.,9993,0,9999,6
1745789519967,MCWP 40,A00,892729,Duru; Nur,13,0,20,7
1745789519967,MCWP 40,B00,893304,Montejo; Carolina,20,0,20,0
1745789520995,MCWP 40R,A00,893757,Redela; Pamela Morgan,0,6,20,20
1745789522023,MCWP 50,A00,893758,Morshed; Michael James,2,0,20,18
1745789522023,MCWP 50,B00,893761,Bartulis; Jason Michael,17,0,20,3
1745789523051,MCWP 50R,A00,893766,Compas; Sean Matthew,0,1,20,20
1745789523051,MCWP 50R,B00,893769,Carter; Jennifer A,0,0,20,20
1745789523051,MCWP 50R,C00,893771,Krone; Jarret,0,3,20,20
1745789523051,MCWP 50R,D00,893772,Miller; Elizabeth Deen,3,0,20,17
1745789523051,MCWP 50R,E00,893775,Carter; Andrea L,0,0,20,20
1745789524077,MMW 11R,A01,892721,Herbst; Matthew,11,0,27,16
1745789524077,MMW 11R,A02,892722,Herbst; Matthew,0,0,0,3
1745789525107,MMW 12R,A01,892724,Herbst; Matthew,0,9,16,16
1745789525107,MMW 12R,A02,892725,Herbst; Matthew,0,9,16,16
1745789526133,MMW 13R,A01,892727,Staff,0,3,16,16
1745789526133,MMW 13R,A02,892728,Staff,0,4,16,16
1745789526133,MMW 13R,A03,958032,Staff,0,3,16,16
1745789526133,MMW 13R,A04,958033,Staff,0,2,16,16
1745789526133,MMW 13R,A05,958034,Staff,0,3,16,16
1745789527160,SIO 295LS,A00,894015,Staff,7,0,25,18
1745789528186,SIO 295S,A00,894020,Staff,7,0,25,18
1745789529211,SIOC 290S,B01,958918,Staff,0,0,0,0
1745789530237,SIOC 291S,B01,958922,Staff,0,0,0,0
1745789531264,SOCI 117,A01,895339,Staff,4,0,5,1
1745789532289,WES 237B,A00,894149,Staff,11,0,20,9
1745789534355,AESE 279B,A00,891859,Staff,13,0,35,22
1745789535381,AIP 197,001,891854,Staff,70,0,70,0
1745789536406,ANTH 289S,A00,891856,Gagneux; Pascal,12,0,12,0
1745789537432,BENG 196,001,957946,Engler; Adam J.,9996,0,9999,3
1745789538459,CAT 124RS,A01,956906,Staff,8,0,25,17
1745789539483,CAT 125RS,A01,922013,Staff,8,0,25,17
1745789540513,CLRE 250,A00,891860,Morris; Sheldon,9995,0,9999,4
1745789542567,CLRE 251R,A00,907817,Mehta; Ravindra L.,9994,0,9999,5
1745789543595,CLRE 252,A00,891864,Cuomo; Raphael Eduardo,9993,0,9999,6
1745789544623,CLRE 253,A00,891867,Vaida; Florin,9994,0,9999,5
1745789544623,CLRE 253,B00,907819,Staff,9999,0,9999,0
1745789545648,CLRE 259,A00,891868,Patel; Hemal,9998,0,9999,1
1745789546677,CLRE 260,A00,891872,Cuomo; Raphael Eduardo,9999,0,9999,0
1745789547704,CLRE 297,001,891888,Cuomo; Raphael Eduardo,9999,0,9999,0
1745789548730,CSE 191,A00,958773,Minnes Kemp; Mor Mia,9999,0,9999,0
1745789549774,CSS 201S,A01,892054,Mignozzetti; Umberto,30,0,30,0
1745789550800,CSS 202S,A01,892056,Mignozzetti; Umberto,30,0,30,0
1745789551828,DSC 197,001,956898,Eldridge; Justin Matthew,9998,0,9999,1
1745789552856,DSC 297,001,958000,Mazumdar; Arya,9998,0,9999,1
1745789553881,EAP 100,A00,905686,Staff,9776,0,9999,223
1745789554909,ECE 45,A01,892618,Staff,0,12,50,50
1745789555937,ECE 109,A01,892620,Staff,0,43,0,0
1745789556964,ECE 111,A01,892719,Staff,0,7,50,50
1745789557989,ECE 197,001,957920,Mercier; Patrick Philip,9992,0,9999,7
1745789559073,ECON 178,A01,907814,Zhu; Ying,28,0,35,7
1745789560098,EDS 115,A00,895312,Staff,41,0,45,4
1745789561124,EDS 117,A01,895337,Staff,30,0,30,0
1745789562151,EDS 125,A00,895341,Jones; Gabrielle Anastasia,43,0,45,2
1745789563179,EDS 128A,A01,895459,Fargason; Sharon Gayle,44,0,45,1
1745789564209,EDS 128B,A01,895543,Pappas; Elizabeth,44,0,45,1
1745789565233,EDS 139,A00,897203,Pappas; Elizabeth,44,0,45,1
1745789565233,EDS 139,B00,897209,Fargason; Sharon Gayle,44,0,45,1
1745789566261,EDS 201,A00,895545,Staff,43,0,45,2
1745789567291,EDS 203,A01,895581,Halter; Christopher P.,43,0,45,2
1745789568319,EDS 204R,A01,895625,Heinzman; Erica M.,43,0,45,2
1745789568319,EDS 204R,B01,895693,Halter; Christopher P.,18,0,45,27
1745789569345,EDS 206R,A00,895694,Fargason; Sharon Gayle,9,0,30,21
1745789569345,EDS 206R,B00,895695,Choi; Bailey Miyeon,20,0,30,10
1745789570371,EDS 250,A00,895697,Hemans; Patricia Ann Benitez,43,0,45,2
1745789571398,EDS 281,A00,895701,Meyerott; Theresa Ann,15,0,15,0
1745789572427,EDS 284,A00,895736,Meyerott; Theresa Ann,15,0,15,0
1745789573454,EDS 286,A00,897210,Fine; Sarah,15,0,15,0
1745789574483,EDS 289C,A01,895770,Daly; Alan J.,15,0,15,0
1745789575510,EDS 290,A00,897211,Hofstetter; Carolyn,15,0,15,0
1745789576536,LIGM 5A,A00,896162,Fischer-Grunski; Eva K,15,0,20,5
1745789577566,LIGM 5B,A00,896260,Fischer-Grunski; Eva K,17,0,20,3
1745789578594,LIGM 5C,A00,896308,Fischer-Grunski; Eva K,18,0,20,2
1745789579624,LIIT 5AS,A00,896313,Carnelos; Chiara,18,0,20,2
1745789580654,LIIT 5BS,A00,896416,Carnelos; Chiara,20,0,20,0
1745789581682,LIIT 5CS,A00,896564,Carnelos; Chiara,20,0,20,0
1745789582711,LISP 5A,A00,896588,Munoz Sanchez; Alicia,4,0,20,16
1745789583737,LISP 5B,A00,896653,Munoz Sanchez; Alicia,10,0,20,10
1745789584763,LISP 5C,A00,896655,Munoz Sanchez; Alicia,4,0,20,16
1745789585791,MAE 197,001,957918,Kleissl; Jan,9998,0,9999,1
1745789586819,MATH 2,A01,957937,Staff,34,0,35,1
1745789587847,MATH 197,001,957876,Kedlaya; Kiran S.,9993,0,9999,6
1745789588877,MCWP 40,A00,892729,Duru; Nur,13,0,20,7
1745789588877,MCWP 40,B00,893304,Montejo; Carolina,20,0,20,0
1745789589905,MCWP 40R,A00,893757,Redela; Pamela Morgan,0,6,20,20
1745789590934,MCWP 50,A00,893758,Morshed; Michael James,2,0,20,18
1745789590934,MCWP 50,B00,893761,Bartulis; Jason Michael,17,0,20,3
1745789591960,MCWP 50R,A00,893766,Compas; Sean Matthew,0,1,20,20
1745789591960,MCWP 50R,B00,893769,Carter; Jennifer A,0,0,20,20
1745789591960,MCWP 50R,C00,893771,Krone; Jarret,0,3,20,20
1745789591960,MCWP 50R,D00,893772,Miller; Elizabeth Deen,3,0,20,17
1745789591960,MCWP 50R,E00,893775,Carter; Andrea L,0,0,20,20
1745789592988,MMW 11R,A01,892721,Herbst; Matthew,11,0,27,16
1745789592988,MMW 11R,A02,892722,Herbst; Matthew,0,0,0,3
1745789594014,MMW 12R,A01,892724,Herbst; Matthew,0,9,16,16
1745789594014,MMW 12R,A02,892725,Herbst; Matthew,0,9,16,16
1745789595041,MMW 13R,A01,892727,Staff,0,3,16,16
1745789595041,MMW 13R,A02,892728,Staff,0,4,16,16
1745789595041,MMW 13R,A03,958032,Staff,0,3,16,16
1745789595041,MMW 13R,A04,958033,Staff,0,2,16,16
1745789595041,MMW 13R,A05,958034,Staff,0,3,16,16
1745789596070,SIO 295LS,A00,894015,Staff,7,0,25,18
1745789597100,SIO 295S,A00,894020,Staff,7,0,25,18
1745789598128,SIOC 290S,B01,958918,Staff,0,0,0,0
1745789599159,SIOC 291S,B01,958922,Staff,0,0,0,0
1745789600185,SOCI 117,A01,895339,Staff,4,0,5,1
1745789601213,WES 237B,A00,894149,Staff,11,0,20,9
1745789603270,AESE 279B,A00,891859,Staff,13,0,35,22
1745789604299,AIP 197,001,891854,Staff,70,0,70,0
1745789605324,ANTH 289S,A00,891856,Gagneux; Pascal,12,0,12,0
1745789606351,BENG 196,001,957946,Engler; Adam J.,9996,0,9999,3
1745789607378,CAT 124RS,A01,956906,Staff,8,0,25,17
1745789608404,CAT 125RS,A01,922013,Staff,8,0,25,17
1745789609431,CLRE 250,A00,891860,Morris; Sheldon,9995,0,9999,4
1745789611487,CLRE 251R,A00,907817,Mehta; Ravindra L.,9994,0,9999,5
1745789612513,CLRE 252,A00,891864,Cuomo; Raphael Eduardo,9993,0,9999,6
1745789613541,CLRE 253,A00,891867,Vaida; Florin,9994,0,9999,5
1745789613541,CLRE 253,B00,907819,Staff,9999,0,9999,0
1745789614567,CLRE 259,A00,891868,Patel; Hemal,9998,0,9999,1
1745789615596,CLRE 260,A00,891872,Cuomo; Raphael Eduardo,9999,0,9999,0
1745789616624,CLRE 297,001,891888,Cuomo; Raphael Eduardo,9999,0,9999,0
1745789617649,CSE 191,A00,958773,Minnes Kemp; Mor Mia,9999,0,9999,0
1745789618675,CSS 201S,A01,892054,Mignozzetti; Umberto,30,0,30,0
1745789619701,CSS 202S,A01,892056,Mignozzetti; Umberto,30,0,30,0
1745789620727,DSC 197,001,956898,Eldridge; Justin Matthew,9998,0,9999,1
1745789621752,DSC 297,001,958000,Mazumdar; Arya,9998,0,9999,1
1745789622776,EAP 100,A00,905686,Staff,9776,0,9999,223
1745789623801,ECE 45,A01,892618,Staff,0,12,50,50
1745789624827,ECE 109,A01,892620,Staff,0,43,0,0
1745789625854,ECE 111,A01,892719,Staff,0,7,50,50
1745789626879,ECE 197,001,957920,Mercier; Patrick Philip,9992,0,9999,7
1745789627907,ECON 178,A01,907814,Zhu; Ying,28,0,35,7
1745789628934,EDS 115,A00,895312,Staff,41,0,45,4
1745789629963,EDS 117,A01,895337,Staff,30,0,30,0
1745789630988,EDS 125,A00,895341,Jones; Gabrielle Anastasia,43,0,45,2
1745789632018,EDS 128A,A01,895459,Fargason; Sharon Gayle,44,0,45,1
1745789633043,EDS 128B,A01,895543,Pappas; Elizabeth,44,0,45,1
1745789634072,EDS 139,A00,897203,Pappas; Elizabeth,44,0,45,1
1745789634072,EDS 139,B00,897209,Fargason; Sharon Gayle,44,0,45,1
1745789635098,EDS 201,A00,895545,Staff,43,0,45,2
1745789636123,EDS 203,A01,895581,Halter; Christopher P.,43,0,45,2
1745789637152,EDS 204R,A01,895625,Heinzman; Erica M.,43,0,45,2
1745789637152,EDS 204R,B01,895693,Halter; Christopher P.,18,0,45,27
1745789638182,EDS 206R,A00,895694,Fargason; Sharon Gayle,9,0,30,21
1745789638182,EDS 206R,B00,895695,Choi; Bailey Miyeon,20,0,30,10
1745789639209,EDS 250,A00,895697,Hemans; Patricia Ann Benitez,43,0,45,2
1745789640238,EDS 281,A00,895701,Meyerott; Theresa Ann,15,0,15,0
1745789641263,EDS 284,A00,895736,Meyerott; Theresa Ann,15,0,15,0
1745789642292,EDS 286,A00,897210,Fine; Sarah,15,0,15,0
1745789643320,EDS 289C,A01,895770,Daly; Alan J.,15,0,15,0
1745789644347,EDS 290,A00,897211,Hofstetter; Carolyn,15,0,15,0
1745789645374,LIGM 5A,A00,896162,Fischer-Grunski; Eva K,15,0,20,5
1745789646401,LIGM 5B,A00,896260,Fischer-Grunski; Eva K,17,0,20,3
1745789647430,LIGM 5C,A00,896308,Fischer-Grunski; Eva K,18,0,20,2
1745789648456,LIIT 5AS,A00,896313,Carnelos; Chiara,18,0,20,2
1745789649482,LIIT 5BS,A00,896416,Carnelos; Chiara,20,0,20,0
1745789650512,LIIT 5CS,A00,896564,Carnelos; Chiara,20,0,20,0
1745789651539,LISP 5A,A00,896588,Munoz Sanchez; Alicia,4,0,20,16
1745789652569,LISP 5B,A00,896653,Munoz Sanchez; Alicia,10,0,20,10
1745789653594,LISP 5C,A00,896655,Munoz Sanchez; Alicia,4,0,20,16
1745789654619,MAE 197,001,957918,Kleissl; Jan,9998,0,9999,1
1745789655647,MATH 2,A01,957937,Staff,34,0,35,1
1745789656672,MATH 197,001,957876,Kedlaya; Kiran S.,9993,0,9999,6
1745789657701,MCWP 40,A00,892729,Duru; Nur,13,0,20,7
1745789657701,MCWP 40,B00,893304,Montejo; Carolina,20,0,20,0
1745789658727,MCWP 40R,A00,893757,Redela; Pamela Morgan,0,6,20,20
1745789659753,MCWP 50,A00,893758,Morshed; Michael James,2,0,20,18
1745789659753,MCWP 50,B00,893761,Bartulis; Jason Michael,17,0,20,3
1745789660787,MCWP 50R,A00,893766,Compas; Sean Matthew,0,1,20,20
1745789660787,MCWP 50R,B00,893769,Carter; Jennifer A,0,0,20,20
1745789660787,MCWP 50R,C00,893771,Krone; Jarret,0,3,20,20
1745789660787,MCWP 50R,D00,893772,Miller; Elizabeth Deen,3,0,20,17
1745789660787,MCWP 50R,E00,893775,Carter; Andrea L,0,0,20,20
1745789661814,MMW 11R,A01,892721,Herbst; Matthew,11,0,27,16
1745789661814,MMW 11R,A02,892722,Herbst; Matthew,0,0,0,3
1745789662878,MMW 12R,A01,892724,Herbst; Matthew,0,9,16,16
1745789662878,MMW 12R,A02,892725,Herbst; Matthew,0,9,16,16
1745789663909,MMW 13R,A01,892727,Staff,0,3,16,16
1745789663909,MMW 13R,A02,892728,Staff,0,4,16,16
1745789663909,MMW 13R,A03,958032,Staff,0,3,16,16
1745789663909,MMW 13R,A04,958033,Staff,0,2,16,16
1745789663909,MMW 13R,A05,958034,Staff,0,3,16,16
1745789664937,SIO 295LS,A00,894015,Staff,7,0,25,18
1745789665963,SIO 295S,A00,894020,Staff,7,0,25,18
1745789666991,SIOC 290S,B01,958918,Staff,0,0,0,0
1745789668019,SIOC 291S,B01,958922,Staff,0,0,0,0
1745789669047,SOCI 117,A01,895339,Staff,4,0,5,1
1745789670078,WES 237B,A00,894149,Staff,11,0,20,9
1745789672143,AESE 279B,A00,891859,Staff,13,0,35,22
1745789673167,AIP 197,001,891854,Staff,70,0,70,0
1745789674193,ANTH 289S,A00,891856,Gagneux; Pascal,12,0,12,0
1745789675219,BENG 196,001,957946,Engler; Adam J.,9996,0,9999,3
1745789676247,CAT 124RS,A01,956906,Staff,8,0,25,17
1745789677274,CAT 125RS,A01,922013,Staff,8,0,25,17
1745789678298,CLRE 250,A00,891860,Morris; Sheldon,9995,0,9999,4
1745789680354,CLRE 251R,A00,907817,Mehta; Ravindra L.,9994,0,9999,5
1745789681379,CLRE 252,A00,891864,Cuomo; Raphael Eduardo,9993,0,9999,6
1745789682408,CLRE 253,A00,891867,Vaida; Florin,9994,0,9999,5
1745789682408,CLRE 253,B00,907819,Staff,9999,0,9999,0
1745789683435,CLRE 259,A00,891868,Patel; Hemal,9998,0,9999,1
1745789684461,CLRE 260,A00,891872,Cuomo; Raphael Eduardo,9999,0,9999,0
1745789685489,CLRE 297,001,891888,Cuomo; Raphael Eduardo,9999,0,9999,0
1745789686514,CSE 191,A00,958773,Minnes Kemp; Mor Mia,9999,0,9999,0
1745789687540,CSS 201S,A01,892054,Mignozzetti; Umberto,30,0,30,0
1745789688567,CSS 202S,A01,892056,Mignozzetti; Umberto,30,0,30,0
1745789689589,DSC 197,001,956898,Eldridge; Justin Matthew,9998,0,9999,1
1745789690617,DSC 297,001,958000,Mazumdar; Arya,9998,0,9999,1
1745789691642,EAP 100,A00,905686,Staff,9776,0,9999,223
1745789692669,ECE 45,A01,892618,Staff,0,12,50,50
1745789693698,ECE 109,A01,892620,Staff,0,43,0,0
1745789694724,ECE 111,A01,892719,Staff,0,7,50,50
1745789695754,ECE 197,001,957920,Mercier; Patrick Philip,9992,0,9999,7
1745789696783,ECON 178,A01,907814,Zhu; Ying,28,0,35,7
1745789697810,EDS 115,A00,895312,Staff,41,0,45,4
1745789698835,EDS 117,A01,895337,Staff,30,0,30,0
1745789699861,EDS 125,A00,895341,Jones; Gabrielle Anastasia,43,0,45,2
1745789700887,EDS 128A,A01,895459,Fargason; Sharon Gayle,44,0,45,1
1745789701917,EDS 128B,A01,895543,Pappas; Elizabeth,44,0,45,1
1745789702951,EDS 139,A00,897203,Pappas; Elizabeth,44,0,45,1
1745789702951,EDS 139,B00,897209,Fargason; Sharon Gayle,44,0,45,1
1745789703980,EDS 201,A00,895545,Staff,43,0,45,2
1745789705019,EDS 203,A01,895581,Halter; Christopher P.,43,0,45,2
1745789706046,EDS 204R,A01,895625,Heinzman; Erica M.,43,0,45,2
1745789706046,EDS 204R,B01,895693,Halter; Christopher P.,18,0,45,27
1745789707075,EDS 206R,A00,895694,Fargason; Sharon Gayle,9,0,30,21
1745789707075,EDS 206R,B00,895695,Choi; Bailey Miyeon,20,0,30,10
1745789708103,EDS 250,A00,895697,Hemans; Patricia Ann Benitez,43,0,45,2
1745789709132,EDS 281,A00,895701,Meyerott; Theresa Ann,15,0,15,0
1745789710157,EDS 284,A00,895736,Meyerott; Theresa Ann,15,0,15,0
1745789711183,EDS 286,A00,897210,Fine; Sarah,15,0,15,0
1745789712210,EDS 289C,A01,895770,Daly; Alan J.,15,0,15,0
1745789713237,EDS 290,A00,897211,Hofstetter; Carolyn,15,0,15,0
1745789714268,LIGM 5A,A00,896162,Fischer-Grunski; Eva K,15,0,20,5
1745789715295,LIGM 5B,A00,896260,Fischer-Grunski; Eva K,17,0,20,3
1745789716319,LIGM 5C,A00,896308,Fischer-Grunski; Eva K,18,0,20,2
1745789717349,LIIT 5AS,A00,896313,Carnelos; Chiara,18,0,20,2
1745789718376,LIIT 5BS,A00,896416,Carnelos; Chiara,20,0,20,0
1745789719406,LIIT 5CS,A00,896564,Carnelos; Chiara,20,0,20,0
1745789720436,LISP 5A,A00,896588,Munoz Sanchez; Alicia,4,0,20,16
1745789721487,LISP 5B,A00,896653,Munoz Sanchez; Alicia,10,0,20,10
1745789722515,LISP 5C,A00,896655,Munoz Sanchez; Alicia,4,0,20,16
1745789723542,MAE 197,001,957918,Kleissl; Jan,9998,0,9999,1
1745789724570,MATH 2,A01,957937,Staff,34,0,35,1
1745789725597,MATH 197,001,957876,Kedlaya; Kiran S.,9993,0,9999,6
1745789726623,MCWP 40,A00,892729,Duru; Nur,13,0,20,7
1745789726623,MCWP 40,B00,893304,Montejo; Carolina,20,0,20,0
1745789727669,MCWP 40R,A00,893757,Redela; Pamela Morgan,0,6,20,20
1745789728693,MCWP 50,A00,893758,Morshed; Michael James,2,0,20,18
1745789728693,MCWP 50,B00,893761,Bartulis; Jason Michael,17,0,20,3
1745789729719,MCWP 50R,A00,893766,Compas; Sean Matthew,0,1,20,20
1745789729719,MCWP 50R,B00,893769,Carter; Jennifer A,0,0,20,20
1745789729719,MCWP 50R,C00,893771,Krone; Jarret,0,3,20,20
1745789729719,MCWP 50R,D00,893772,Miller; Elizabeth Deen,3,0,20,17
1745789729719,MCWP 50R,E00,893775,Carter; Andrea L,0,0,20,20
1745789730745,MMW 11R,A01,892721,Herbst; Matthew,11,0,27,16
1745789730745,MMW 11R,A02,892722,Herbst; Matthew,0,0,0,3
1745789731770,MMW 12R,A01,892724,Herbst; Matthew,0,9,16,16
1745789731770,MMW 12R,A02,892725,Herbst; Matthew,0,9,16,16
1745789732798,MMW 13R,A01,892727,Staff,0,3,16,16
1745789732798,MMW 13R,A02,892728,Staff,0,4,16,16
1745789732798,MMW 13R,A03,958032,Staff,0,3,16,16
1745789732798,MMW 13R,A04,958033,Staff,0,2,16,16
1745789732798,MMW 13R,A05,958034,Staff,0,3,16,16
1745789733823,SIO 295LS,A00,894015,Staff,7,0,25,18
1745789734848,SIO 295S,A00,894020,Staff,7,0,25,18
1745789735875,SIOC 290S,B01,958918,Staff,0,0,0,0
1745789736902,SIOC 291S,B01,958922,Staff,0,0,0,0
1745789737929,SOCI 117,A01,895339,Staff,4,0,5,1
1745789738955,WES 237B,A00,894149,Staff,11,0,20,9
1745789741012,AESE 279B,A00,891859,Staff,13,0,35,22
1745789742037,AIP 197,001,891854,Staff,70,0,70,0
1745789743063,ANTH 289S,A00,891856,Gagneux; Pascal,12,0,12,0
1745789744089,BENG 196,001,957946,Engler; Adam J.,9996,0,9999,3
1745789745116,CAT 124RS,A01,956906,Staff,8,0,25,17
1745789746144,CAT 125RS,A01,922013,Staff,8,0,25,17
1745789747172,CLRE 250,A00,891860,Morris; Sheldon,9995,0,9999,4
1745789749226,CLRE 251R,A00,907817,Mehta; Ravindra L.,9994,0,9999,5
1745789750254,CLRE 252,A00,891864,Cuomo; Raphael Eduardo,9993,0,9999,6
1745789751279,CLRE 253,A00,891867,Vaida; Florin,9994,0,9999,5
1745789751279,CLRE 253,B00,907819,Staff,9999,0,9999,0
1745789752308,CLRE 259,A00,891868,Patel; Hemal,9998,0,9999,1
1745789753336,CLRE 260,A00,891872,Cuomo; Raphael Eduardo,9999,0,9999,0
1745789754363,CLRE 297,001,891888,Cuomo; Raphael Eduardo,9999,0,9999,0
1745789755390,CSE 191,A00,958773,Minnes Kemp; Mor Mia,9999,0,9999,0
1745789756420,CSS 201S,A01,892054,Mignozzetti; Umberto,30,0,30,0
1745789757446,CSS 202S,A01,892056,Mignozzetti; Umberto,30,0,30,0
1745789758470,DSC 197,001,956898,Eldridge; Justin Matthew,9998,0,9999,1
1745789759496,DSC 297,001,958000,Mazumdar; Arya,9998,0,9999,1
1745789760521,EAP 100,A00,905686,Staff,9776,0,9999,223
1745789761548,ECE 45,A01,892618,Staff,0,12,50,50
1745789762576,ECE 109,A01,892620,Staff,0,43,0,0
1745789763605,ECE 111,A01,892719,Staff,0,7,50,50
1745789764629,ECE 197,001,957920,Mercier; Patrick Philip,9992,0,9999,7
1745789765654,ECON 178,A01,907814,Zhu; Ying,28,0,35,7
1745789766682,EDS 115,A00,895312,Staff,41,0,45,4
1745789767709,EDS 117,A01,895337,Staff,30,0,30,0
1745789768734,EDS 125,A00,895341,Jones; Gabrielle Anastasia,43,0,45,2
1745789769758,EDS 128A,A01,895459,Fargason; Sharon Gayle,44,0,45,1
1745789770783,EDS 128B,A01,895543,Pappas; Elizabeth,44,0,45,1
1745789771807,EDS 139,A00,897203,Pappas; Elizabeth,44,0,45,1
1745789771807,EDS 139,B00,897209,Fargason; Sharon Gayle,44,0,45,1
1745789772835,EDS 201,A00,895545,Staff,43,0,45,2
1745789773859,EDS 203,A01,895581,Halter; Christopher P.,43,0,45,2
1745789774885,EDS 204R,A01,895625,Heinzman; Erica M.,43,0,45,2
1745789774885,EDS 204R,B01,895693,Halter; Christopher P.,18,0,45,27
1745789775912,EDS 206R,A00,895694,Fargason; Sharon Gayle,9,0,30,21
1745789775912,EDS 206R,B00,895695,Choi; Bailey Miyeon,20,0,30,10
1745789776938,EDS 250,A00,895697,Hemans; Patricia Ann Benitez,43,0,45,2
1745789777965,EDS 281,A00,895701,Meyerott; Theresa Ann,15,0,15,0
1745789778989,EDS 284,A00,895736,Meyerott; Theresa Ann,15,0,15,0
1745789780016,EDS 286,A00,897210,Fine; Sarah,15,0,15,0
1745789781043,EDS 289C,A01,895770,Daly; Alan J.,15,0,15,0
1745789782068,EDS 290,A00,897211,Hofstetter; Carolyn,15,0,15,0
1745789783095,LIGM 5A,A00,896162,Fischer-Grunski; Eva K,15,0,20,5
1745789784124,LIGM 5B,A00,896260,Fischer-Grunski; Eva K,17,0,20,3
1745789785149,LIGM 5C,A00,896308,Fischer-Grunski; Eva K,18,0,20,2
1745789786175,LIIT 5AS,A00,896313,Carnelos; Chiara,18,0,20,2
1745789787204,LIIT 5BS,A00,896416,Carnelos; Chiara,20,0,20,0
1745789788232,LIIT 5CS,A00,896564,Carnelos; Chiara,20,0,20,0
1745789789256,LISP 5A,A00,896588,Munoz Sanchez; Alicia,4,0,20,16
1745789790282,LISP 5B,A00,896653,Munoz Sanchez; Alicia,10,0,20,10
1745789791308,LISP 5C,A00,896655,Munoz Sanchez; Alicia,4,0,20,16
1745789792332,MAE 197,001,957918,Kleissl; Jan,9998,0,9999,1
1745789793357,MATH 2,A01,957937,Staff,34,0,35,1
1745789794381,MATH 197,001,957876,Kedlaya; Kiran S.,9993,0,9999,6
1745789795409,MCWP 40,A00,892729,Duru; Nur,13,0,20,7
1745789795409,MCWP 40,B00,893304,Montejo; Carolina,20,0,20,0
1745789796436,MCWP 40R,A00,893757,Redela; Pamela Morgan,0,6,20,20
1745789797463,MCWP 50,A00,893758,Morshed; Michael James,2,0,20,18
1745789797463,MCWP 50,B00,893761,Bartulis; Jason Michael,17,0,20,3
1745789798490,MCWP 50R,A00,893766,Compas; Sean Matthew,0,1,20,20
1745789798490,MCWP 50R,B00,893769,Carter; Jennifer A,0,0,20,20
1745789798490,MCWP 50R,C00,893771,Krone; Jarret,0,3,20,20
1745789798490,MCWP 50R,D00,893772,Miller; Elizabeth Deen,3,0,20,17
1745789798490,MCWP 50R,E00,893775,Carter; Andrea L,0,0,20,20
1745789799518,MMW 11R,A01,892721,Herbst; Matthew,11,0,27,16
1745789799518,MMW 11R,A02,892722,Herbst; Matthew,0,0,0,3
1745789800547,MMW 12R,A01,892724,Herbst; Matthew,0,9,16,16
1745789800547,MMW 12R,A02,892725,Herbst; Matthew,0,9,16,16
1745789801571,MMW 13R,A01,892727,Staff,0,4,16,16
1745789801571,MMW 13R,A02,892728,Staff,0,4,16,16
1745789801571,MMW 13R,A03,958032,Staff,0,3,16,16
1745789801571,MMW 13R,A04,958033,Staff,0,2,16,16
1745789801571,MMW 13R,A05,958034,Staff,0,3,16,16
1745789802597,SIO 295LS,A00,894015,Staff,7,0,25,18
1745789803623,SIO 295S,A00,894020,Staff,7,0,25,18
1745789804653,SIOC 290S,B01,958918,Staff,0,0,0,0
1745789805678,SIOC 291S,B01,958922,Staff,0,0,0,0
1745789806703,SOCI 117,A01,895339,Staff,4,0,5,1
1745789807727,WES 237B,A00,894149,Staff,11,0,20,9
1745789809796,AESE 279B,A00,891859,Staff,13,0,35,22
1745789810819,AIP 197,001,891854,Staff,70,0,70,0
1745789811847,ANTH 289S,A00,891856,Gagneux; Pascal,12,0,12,0
1745789812874,BENG 196,001,957946,Engler; Adam J.,9996,0,9999,3
1745789813899,CAT 124RS,A01,956906,Staff,8,0,25,17
1745789814924,CAT 125RS,A01,922013,Staff,8,0,25,17
1745789816007,CLRE 250,A00,891860,Morris; Sheldon,9995,0,9999,4
1745789818057,CLRE 251R,A00,907817,Mehta; Ravindra L.,9994,0,9999,5
1745789819087,CLRE 252,A00,891864,Cuomo; Raphael Eduardo,9993,0,9999,6
1745789820115,CLRE 253,A00,891867,Vaida; Florin,9994,0,9999,5
1745789820115,CLRE 253,B00,907819,Staff,9999,0,9999,0
1745789821143,CLRE 259,A00,891868,Patel; Hemal,9998,0,9999,1
1745789822169,CLRE 260,A00,891872,Cuomo; Raphael Eduardo,9999,0,9999,0
1745789823194,CLRE 297,001,891888,Cuomo; Raphael Eduardo,9999,0,9999,0
1745789824222,CSE 191,A00,958773,Minnes Kemp; Mor Mia,9999,0,9999,0
1745789825251,CSS 201S,A01,892054,Mignozzetti; Umberto,30,0,30,0
1745789826280,CSS 202S,A01,892056,Mignozzetti; Umberto,30,0,30,0
1745789827313,DSC 197,001,956898,Eldridge; Justin Matthew,9998,0,9999,1
1745789828344,DSC 297,001,958000,Mazumdar; Arya,9998,0,9999,1
1745789829372,EAP 100,A00,905686,Staff,9776,0,9999,223
1745789830398,ECE 45,A01,892618,Staff,0,12,50,50
1745789831427,ECE 109,A01,892620,Staff,0,43,0,0
1745789832456,ECE 111,A01,892719,Staff,0,7,50,50
1745789833482,ECE 197,001,957920,Mercier; Patrick Philip,9992,0,9999,7
1745789834507,ECON 178,A01,907814,Zhu; Ying,28,0,35,7
1745789835535,EDS 115,A00,895312,Staff,41,0,45,4
1745789836560,EDS 117,A01,895337,Staff,30,0,30,0
1745789837584,EDS 125,A00,895341,Jones; Gabrielle Anastasia,43,0,45,2
1745789838611,EDS 128A,A01,895459,Fargason; Sharon Gayle,44,0,45,1
1745789839639,EDS 128B,A01,895543,Pappas; Elizabeth,44,0,45,1
1745789840665,EDS 139,A00,897203,Pappas; Elizabeth,44,0,45,1
1745789840665,EDS 139,B00,897209,Fargason; Sharon Gayle,44,0,45,1
1745789841694,EDS 201,A00,895545,Staff,43,0,45,2
1745789842719,EDS 203,A01,895581,Halter; Christopher P.,43,0,45,2
1745789843746,EDS 204R,A01,895625,Heinzman; Erica M.,43,0,45,2
1745789843746,EDS 204R,B01,895693,Halter; Christopher P.,18,0,45,27
1745789844774,EDS 206R,A00,895694,Fargason; Sharon Gayle,9,0,30,21
1745789844774,EDS 206R,B00,895695,Choi; Bailey Miyeon,20,0,30,10
1745789845800,EDS 250,A00,895697,Hemans; Patricia Ann Benitez,43,0,45,2
1745789846828,EDS 281,A00,895701,Meyerott; Theresa Ann,15,0,15,0
1745789847857,EDS 284,A00,895736,Meyerott; Theresa Ann,15,0,15,0
1745789848883,EDS 286,A00,897210,Fine; Sarah,15,0,15,0
1745789849912,EDS 289C,A01,895770,Daly; Alan J.,15,0,15,0
1745789850941,EDS 290,A00,897211,Hofstetter; Carolyn,15,0,15,0
1745789851971,LIGM 5A,A00,896162,Fischer-Grunski; Eva K,15,0,20,5
1745789853001,LIGM 5B,A00,896260,Fischer-Grunski; Eva K,17,0,20,3
1745789854027,LIGM 5C,A00,896308,Fischer-Grunski; Eva K,18,0,20,2
1745789855056,LIIT 5AS,A00,896313,Carnelos; Chiara,18,0,20,2
1745789856086,LIIT 5BS,A00,896416,Carnelos; Chiara,20,0,20,0
1745789857113,LIIT 5CS,A00,896564,Carnelos; Chiara,20,0,20,0
1745789858139,LISP 5A,A00,896588,Munoz Sanchez; Alicia,4,0,20,16
1745789859166,LISP 5B,A00,896653,Munoz Sanchez; Alicia,10,0,20,10
1745789860191,LISP 5C,A00,896655,Munoz Sanchez; Alicia,4,0,20,16
1745789861220,MAE 197,001,957918,Kleissl; Jan,9998,0,9999,1
1745789862245,MATH 2,A01,957937,Staff,34,0,35,1
1745789863276,MATH 197,001,957876,Kedlaya; Kiran S.,9993,0,9999,6
1745789864301,MCWP 40,A00,892729,Duru; Nur,13,0,20,7
1745789864301,MCWP 40,B00,893304,Montejo; Carolina,20,0,20,0
1745789865328,MCWP 40R,A00,893757,Redela; Pamela Morgan,0,6,20,20
1745789866355,MCWP 50,A00,893758,Morshed; Michael James,2,0,20,18
1745789866355,MCWP 50,B00,893761,Bartulis; Jason Michael,17,0,20,3
1745789867382,MCWP 50R,A00,893766,Compas; Sean Matthew,0,1,20,20
1745789867382,MCWP 50R,B00,893769,Carter; Jennifer A,0,0,20,20
1745789867382,MCWP 50R,C00,893771,Krone; Jarret,0,3,20,20
1745789867382,MCWP 50R,D00,893772,Miller; Elizabeth Deen,3,0,20,17
1745789867382,MCWP 50R,E00,893775,Carter; Andrea L,0,0,20,20
1745789868412,MMW 11R,A01,892721,Herbst; Matthew,11,0,27,16
1745789868412,MMW 11R,A02,892722,Herbst; Matthew,0,0,0,3
1745789869441,MMW 12R,A01,892724,Herbst; Matthew,0,9,16,16
1745789869441,MMW 12R,A02,892725,Herbst; Matthew,0,9,16,16
1745789870465,MMW 13R,A01,892727,Staff,0,4,16,16
1745789870465,MMW 13R,A02,892728,Staff,0,4,16,16
1745789870465,MMW 13R,A03,958032,Staff,0,3,16,16
1745789870465,MMW 13R,A04,958033,Staff,0,2,16,16
1745789870465,MMW 13R,A05,958034,Staff,0,3,16,16
1745789871496,SIO 295LS,A00,894015,Staff,7,0,25,18
1745789872522,SIO 295S,A00,894020,Staff,7,0,25,18
1745789873547,SIOC 290S,B01,958918,Staff,0,0,0,0
1745789874574,SIOC 291S,B01,958922,Staff,0,0,0,0
1745789875600,SOCI 117,A01,895339,Staff,4,0,5,1
1745789876627,WES 237B,A00,894149,Staff,11,0,20,9
1745789878680,AESE 279B,A00,891859,Staff,13,0,35,22
1745789879707,AIP 197,001,891854,Staff,70,0,70,0
1745789880736,ANTH 289S,A00,891856,Gagneux; Pascal,12,0,12,0
1745789881761,BENG 196,001,957946,Engler; Adam J.,9996,0,9999,3
1745789882786,CAT 124RS,A01,956906,Staff,8,0,25,17
1745789883810,CAT 125RS,A01,922013,Staff,8,0,25,17
1745789884836,CLRE 250,A00,891860,Morris; Sheldon,9995,0,9999,4
1745789886887,CLRE 251R,A00,907817,Mehta; Ravindra L.,9994,0,9999,5
1745789887918,CLRE 252,A00,891864,Cuomo; Raphael Eduardo,9993,0,9999,6
1745789888943,CLRE 253,A00,891867,Vaida; Florin,9994,0,9999,5
1745789888943,CLRE 253,B00,907819,Staff,9999,0,9999,0
1745789889971,CLRE 259,A00,891868,Patel; Hemal,9998,0,9999,1
1745789890997,CLRE 260,A00,891872,Cuomo; Raphael Eduardo,9999,0,9999,0
1745789892024,CLRE 297,001,891888,Cuomo; Raphael Eduardo,9999,0,9999,0
1745789893050,CSE 191,A00,958773,Minnes Kemp; Mor Mia,9999,0,9999,0
1745789894076,CSS 201S,A01,892054,Mignozzetti; Umberto,30,0,30,0
1745789895101,CSS 202S,A01,892056,Mignozzetti; Umberto,30,0,30,0
1745789896127,DSC 197,001,956898,Eldridge; Justin Matthew,9998,0,9999,1
1745789897154,DSC 297,001,958000,Mazumdar; Arya,9998,0,9999,1
1745789898180,EAP 100,A00,905686,Staff,9776,0,9999,223
1745789899208,ECE 45,A01,892618,Staff,0,12,50,50
1745789900234,ECE 109,A01,892620,Staff,0,43,0,0
1745789901263,ECE 111,A01,892719,Staff,0,7,50,50
1745789902290,ECE 197,001,957920,Mercier; Patrick Philip,9992,0,9999,7
1745789903317,ECON 178,A01,907814,Zhu; Ying,28,0,35,7
1745789904346,EDS 115,A00,895312,Staff,41,0,45,4
1745789905375,EDS 117,A01,895337,Staff,30,0,30,0
1745789906404,EDS 125,A00,895341,Jones; Gabrielle Anastasia,43,0,45,2
1745789907431,EDS 128A,A01,895459,Fargason; Sharon Gayle,44,0,45,1
1745789908456,EDS 128B,A01,895543,Pappas; Elizabeth,44,0,45,1
1745789909486,EDS 139,A00,897203,Pappas; Elizabeth,44,0,45,1
1745789909486,EDS 139,B00,897209,Fargason; Sharon Gayle,44,0,45,1
1745789910513,EDS 201,A00,895545,Staff,43,0,45,2
1745789911539,EDS 203,A01,895581,Halter; Christopher P.,43,0,45,2
1745789912568,EDS 204R,A01,895625,Heinzman; Erica M.,43,0,45,2
1745789912568,EDS 204R,B01,895693,Halter; Christopher P.,18,0,45,27
1745789913595,EDS 206R,A00,895694,Fargason; Sharon Gayle,9,0,30,21
1745789913595,EDS 206R,B00,895695,Choi; Bailey Miyeon,20,0,30,10
1745789914619,EDS 250,A00,895697,Hemans; Patricia Ann Benitez,43,0,45,2
1745789915644,EDS 281,A00,895701,Meyerott; Theresa Ann,15,0,15,0
1745789916672,EDS 284,A00,895736,Meyerott; Theresa Ann,15,0,15,0
1745789917695,EDS 286,A00,897210,Fine; Sarah,15,0,15,0
1745789918724,EDS 289C,A01,895770,Daly; Alan J.,15,0,15,0
1745789919752,EDS 290,A00,897211,Hofstetter; Carolyn,15,0,15,0
1745789920778,LIGM 5A,A00,896162,Fischer-Grunski; Eva K,15,0,20,5
1745789921802,LIGM 5B,A00,896260,Fischer-Grunski; Eva K,17,0,20,3
1745789922828,LIGM 5C,A00,896308,Fischer-Grunski; Eva K,18,0,20,2
1745789923856,LIIT 5AS,A00,896313,Carnelos; Chiara,18,0,20,2
1745789924880,LIIT 5BS,A00,896416,Carnelos; Chiara,20,0,20,0
1745789925906,LIIT 5CS,A00,896564,Carnelos; Chiara,20,0,20,0
1745789926936,LISP 5A,A00,896588,Munoz Sanchez; Alicia,4,0,20,16
1745789927964,LISP 5B,A00,896653,Munoz Sanchez; Alicia,10,0,20,10
1745789928989,LISP 5C,A00,896655,Munoz Sanchez; Alicia,4,0,20,16
1745789930016,MAE 197,001,957918,Kleissl; Jan,9998,0,9999,1
1745789931044,MATH 2,A01,957937,Staff,34,0,35,1
1745789932072,MATH 197,001,957876,Kedlaya; Kiran S.,9993,0,9999,6
1745789933099,MCWP 40,A00,892729,Duru; Nur,13,0,20,7
1745789933099,MCWP 40,B00,893304,Montejo; Carolina,20,0,20,0
1745789934124,MCWP 40R,A00,893757,Redela; Pamela Morgan,0,6,20,20
1745789935149,MCWP 50,A00,893758,Morshed; Michael James,2,0,20,18
1745789935149,MCWP 50,B00,893761,Bartulis; Jason Michael,17,0,20,3
1745789936179,MCWP 50R,A00,893766,Compas; Sean Matthew,0,1,20,20
1745789936179,MCWP 50R,B00,893769,Carter; Jennifer A,0,0,20,20
1745789936179,MCWP 50R,C00,893771,Krone; Jarret,0,3,20,20
1745789936179,MCWP 50R,D00,893772,Miller; Elizabeth Deen,3,0,20,17
1745789936179,MCWP 50R,E00,893775,Carter; Andrea L,0,0,20,20
1745789937203,MMW 11R,A01,892721,Herbst; Matthew,11,0,27,16
1745789937203,MMW 11R,A02,892722,Herbst; Matthew,0,0,0,3
1745789938229,MMW 12R,A01,892724,Herbst; Matthew,0,9,16,16
1745789938229,MMW 12R,A02,892725,Herbst; Matthew,0,9,16,16
1745789939256,MMW 13R,A01,892727,Staff,0,4,16,16
1745789939256,MMW 13R,A02,892728,Staff,0,4,16,16
1745789939256,MMW 13R,A03,958032,Staff,0,3,16,16
1745789939256,MMW 13R,A04,958033,Staff,0,2,16,16
1745789939256,MMW 13R,A05,958034,Staff,0,3,16,16
1745789940281,SIO 295LS,A00,894015,Staff,7,0,25,18
1745789941309,SIO 295S,A00,894020,Staff,7,0,25,18
1745789942337,SIOC 290S,B01,958918,Staff,0,0,0,0
1745789943368,SIOC 291S,B01,958922,Staff,0,0,0,0
1745789944396,SOCI 117,A01,895339,Staff,4,0,5,1
1745789945423,WES 237B,A00,894149,Staff,11,0,20,9
1745789947482,AESE 279B,A00,891859,Staff,13,0,35,22
1745789948509,AIP 197,001,891854,Staff,70,0,70,0
1745789949536,ANTH 289S,A00,891856,Gagneux; Pascal,12,0,12,0
1745789950564,BENG 196,001,957946,Engler; Adam J.,9996,0,9999,3
1745789951590,CAT 124RS,A01,956906,Staff,8,0,25,17
1745789952618,CAT 125RS,A01,922013,Staff,8,0,25,17
1745789953642,CLRE 250,A00,891860,Morris; Sheldon,9995,0,9999,4
1745789955697,CLRE 251R,A00,907817,Mehta; Ravindra L.,9994,0,9999,5
1745789956723,CLRE 252,A00,891864,Cuomo; Raphael Eduardo,9993,0,9999,6
1745789957750,CLRE 253,A00,891867,Vaida; Florin,9994,0,9999,5
1745789957750,CLRE 253,B00,907819,Staff,9999,0,9999,0
1745789958777,CLRE 259,A00,891868,Patel; Hemal,9998,0,9999,1
1745789959806,CLRE 260,A00,891872,Cuomo; Raphael Eduardo,9999,0,9999,0
1745789960833,CLRE 297,001,891888,Cuomo; Raphael Eduardo,9999,0,9999,0
1745789961859,CSE 191,A00,958773,Minnes Kemp; Mor Mia,9999,0,9999,0
1745789962893,CSS 201S,A01,892054,Mignozzetti; Umberto,30,0,30,0
1745789963923,CSS 202S,A01,892056,Mignozzetti; Umberto,30,0,30,0
1745789964958,DSC 197,001,956898,Eldridge; Justin Matthew,9998,0,9999,1
1745789965987,DSC 297,001,958000,Mazumdar; Arya,9998,0,9999,1
1745789967012,EAP 100,A00,905686,Staff,9776,0,9999,223
1745789968037,ECE 45,A01,892618,Staff,0,12,50,50
1745789969067,ECE 109,A01,892620,Staff,0,43,0,0
1745789970093,ECE 111,A01,892719,Staff,0,7,50,50
1745789971121,ECE 197,001,957920,Mercier; Patrick Philip,9992,0,9999,7
1745789972148,ECON 178,A01,907814,Zhu; Ying,28,0,35,7
1745789973174,EDS 115,A00,895312,Staff,41,0,45,4
1745789974204,EDS 117,A01,895337,Staff,30,0,30,0
1745789975229,EDS 125,A00,895341,Jones; Gabrielle Anastasia,43,0,45,2
1745789976255,EDS 128A,A01,895459,Fargason; Sharon Gayle,44,0,45,1
1745789977281,EDS 128B,A01,895543,Pappas; Elizabeth,44,0,45,1
1745789978310,EDS 139,A00,897203,Pappas; Elizabeth,44,0,45,1
1745789978310,EDS 139,B00,897209,Fargason; Sharon Gayle,44,0,45,1
1745789979339,EDS 201,A00,895545,Staff,43,0,45,2
1745789980366,EDS 203,A01,895581,Halter; Christopher P.,43,0,45,2
1745789981392,EDS 204R,A01,895625,Heinzman; Erica M.,43,0,45,2
1745789981392,EDS 204R,B01,895693,Halter; Christopher P.,18,0,45,27
1745789982418,EDS 206R,A00,895694,Fargason; Sharon Gayle,9,0,30,21
1745789982418,EDS 206R,B00,895695,Choi; Bailey Miyeon,20,0,30,10
1745789983446,EDS 250,A00,895697,Hemans; Patricia Ann Benitez,43,0,45,2
1745789984473,EDS 281,A00,895701,Meyerott; Theresa Ann,15,0,15,0
1745789985501,EDS 284,A00,895736,Meyerott; Theresa Ann,15,0,15,0
1745789986528,EDS 286,A00,897210,Fine; Sarah,15,0,15,0
1745789987558,EDS 289C,A01,895770,Daly; Alan J.,15,0,15,0
1745789988585,EDS 290,A00,897211,Hofstetter; Carolyn,15,0,15,0
1745789989614,LIGM 5A,A00,896162,Fischer-Grunski; Eva K,15,0,20,5
1745789990642,LIGM 5B,A00,896260,Fischer-Grunski; Eva K,17,0,20,3
1745789991671,LIGM 5C,A00,896308,Fischer-Grunski; Eva K,18,0,20,2
1745789992701,LIIT 5AS,A00,896313,Carnelos; Chiara,18,0,20,2
1745789993727,LIIT 5BS,A00,896416,Carnelos; Chiara,20,0,20,0
1745789994755,LIIT 5CS,A00,896564,Carnelos; Chiara,20,0,20,0
1745789995780,LISP 5A,A00,896588,Munoz Sanchez; Alicia,4,0,20,16
1745789996808,LISP 5B,A00,896653,Munoz Sanchez; Alicia,10,0,20,10
1745789997838,LISP 5C,A00,896655,Munoz Sanchez; Alicia,4,0,20,16
1745789998866,MAE 197,001,957918,Kleissl; Jan,9998,0,9999,1
1745789999891,MATH 2,A01,957937,Staff,34,0,35,1
1745790000918,MATH 197,001,957876,Kedlaya; Kiran S.,9993,0,9999,6
1745790001945,MCWP 40,A00,892729,Duru; Nur,13,0,20,7
1745790001945,MCWP 40,B00,893304,Montejo; Carolina,20,0,20,0
1745790002976,MCWP 40R,A00,893757,Redela; Pamela Morgan,0,6,20,20
1745790004004,MCWP 50,A00,893758,Morshed; Michael James,2,0,20,18
1745790004004,MCWP 50,B00,893761,Bartulis; Jason Michael,17,0,20,3
1745790005032,MCWP 50R,A00,893766,Compas; Sean Matthew,0,1,20,20
1745790005032,MCWP 50R,B00,893769,Carter; Jennifer A,0,0,20,20
1745790005032,MCWP 50R,C00,893771,Krone; Jarret,0,3,20,20
1745790005032,MCWP 50R,D00,893772,Miller; Elizabeth Deen,3,0,20,17
1745790005032,MCWP 50R,E00,893775,Carter; Andrea L,0,0,20,20
1745790006060,MMW 11R,A01,892721,Herbst; Matthew,11,0,27,16
1745790006060,MMW 11R,A02,892722,Herbst; Matthew,0,0,0,3
1745790007090,MMW 12R,A01,892724,Herbst; Matthew,0,9,16,16
1745790007090,MMW 12R,A02,892725,Herbst; Matthew,0,9,16,16
1745790008117,MMW 13R,A01,892727,Staff,0,4,16,16
1745790008117,MMW 13R,A02,892728,Staff,0,4,16,16
1745790008117,MMW 13R,A03,958032,Staff,0,3,16,16
1745790008117,MMW 13R,A04,958033,Staff,0,2,16,16
1745790008117,MMW 13R,A05,958034,Staff,0,3,16,16
1745790009144,SIO 295LS,A00,894015,Staff,7,0,25,18
1745790010174,SIO 295S,A00,894020,Staff,7,0,25,18
1745790011203,SIOC 290S,B01,958918,Staff,0,0,0,0
1745790012228,SIOC 291S,B01,958922,Staff,0,0,0,0
1745790013254,SOCI 117,A01,895339,Staff,4,0,5,1
1745790014281,WES 237B,A00,894149,Staff,11,0,20,9
1745790016338,AESE 279B,A00,891859,Staff,13,0,35,22
1745790017363,AIP 197,001,891854,Staff,70,0,70,0
1745790018392,ANTH 289S,A00,891856,Gagneux; Pascal,12,0,12,0
1745790019417,BENG 196,001,957946,Engler; Adam J.,9996,0,9999,3
1745790020444,CAT 124RS,A01,956906,Staff,8,0,25,17
1745790021469,CAT 125RS,A01,922013,Staff,8,0,25,17
1745790022495,CLRE 250,A00,891860,Morris; Sheldon,9995,0,9999,4
1745790024550,CLRE 251R,A00,907817,Mehta; Ravindra L.,9994,0,9999,5
1745790025576,CLRE 252,A00,891864,Cuomo; Raphael Eduardo,9993,0,9999,6
1745790026603,CLRE 253,A00,891867,Vaida; Florin,9994,0,9999,5
1745790026603,CLRE 253,B00,907819,Staff,9999,0,9999,0
1745790027630,CLRE 259,A00,891868,Patel; Hemal,9998,0,9999,1
1745790028655,CLRE 260,A00,891872,Cuomo; Raphael Eduardo,9999,0,9999,0
1745790029681,CLRE 297,001,891888,Cuomo; Raphael Eduardo,9999,0,9999,0
1745790030708,CSE 191,A00,958773,Minnes Kemp; Mor Mia,9999,0,9999,0
1745790031735,CSS 201S,A01,892054,Mignozzetti; Umberto,30,0,30,0
1745790032763,CSS 202S,A01,892056,Mignozzetti; Umberto,30,0,30,0
1745790033790,DSC 197,001,956898,Eldridge; Justin Matthew,9998,0,9999,1
1745790034815,DSC 297,001,958000,Mazumdar; Arya,9998,0,9999,1
1745790035843,EAP 100,A00,905686,Staff,9776,0,9999,223
1745790036869,ECE 45,A01,892618,Staff,0,12,50,50
1745790037901,ECE 109,A01,892620,Staff,0,43,0,0
1745790038930,ECE 111,A01,892719,Staff,0,7,50,50
1745790039956,ECE 197,001,957920,Mercier; Patrick Philip,9992,0,9999,7
1745790040993,ECON 178,A01,907814,Zhu; Ying,28,0,35,7
1745790042019,EDS 115,A00,895312,Staff,41,0,45,4
1745790043046,EDS 117,A01,895337,Staff,30,0,30,0
1745790044072,EDS 125,A00,895341,Jones; Gabrielle Anastasia,43,0,45,2
1745790045098,EDS 128A,A01,895459,Fargason; Sharon Gayle,44,0,45,1
1745790046123,EDS 128B,A01,895543,Pappas; Elizabeth,44,0,45,1
1745790047152,EDS 139,A00,897203,Pappas; Elizabeth,44,0,45,1
1745790047152,EDS 139,B00,897209,Fargason; Sharon Gayle,44,0,45,1
1745790048181,EDS 201,A00,895545,Staff,43,0,45,2
1745790049207,EDS 203,A01,895581,Halter; Christopher P.,43,0,45,2
1745790050237,EDS 204R,A01,895625,Heinzman; Erica M.,43,0,45,2
1745790050237,EDS 204R,B01,895693,Halter; Christopher P.,18,0,45,27
1745790051263,EDS 206R,A00,895694,Fargason; Sharon Gayle,9,0,30,21
1745790051263,EDS 206R,B00,895695,Choi; Bailey Miyeon,20,0,30,10
1745790052289,EDS 250,A00,895697,Hemans; Patricia Ann Benitez,43,0,45,2
1745790053316,EDS 281,A00,895701,Meyerott; Theresa Ann,15,0,15,0
1745790054342,EDS 284,A00,895736,Meyerott; Theresa Ann,15,0,15,0
1745790055369,EDS 286,A00,897210,Fine; Sarah,15,0,15,0
1745790056394,EDS 289C,A01,895770,Daly; Alan J.,15,0,15,0
1745790057420,EDS 290,A00,897211,Hofstetter; Carolyn,15,0,15,0
1745790058447,LIGM 5A,A00,896162,Fischer-Grunski; Eva K,15,0,20,5
1745790059473,LIGM 5B,A00,896260,Fischer-Grunski; Eva K,17,0,20,3
1745790060499,LIGM 5C,A00,896308,Fischer-Grunski; Eva K,18,0,20,2
1745790061526,LIIT 5AS,A00,896313,Carnelos; Chiara,18,0,20,2
1745790062552,LIIT 5BS,A00,896416,Carnelos; Chiara,20,0,20,0
1745790063589,LIIT 5CS,A00,896564,Carnelos; Chiara,20,0,20,0
1745790064615,LISP 5A,A00,896588,Munoz Sanchez; Alicia,4,0,20,16
1745790065641,LISP 5B,A00,896653,Munoz Sanchez; Alicia,10,0,20,10
1745790066671,LISP 5C,A00,896655,Munoz Sanchez; Alicia,4,0,20,16
1745790067697,MAE 197,001,957918,Kleissl; Jan,9998,0,9999,1
1745790068722,MATH 2,A01,957937,Staff,34,0,35,1
1745790069749,MATH 197,001,957876,Kedlaya; Kiran S.,9993,0,9999,6
1745790070774,MCWP 40,A00,892729,Duru; Nur,13,0,20,7
1745790070774,MCWP 40,B00,893304,Montejo; Carolina,20,0,20,0
1745790071801,MCWP 40R,A00,893757,Redela; Pamela Morgan,0,6,20,20
1745790072827,MCWP 50,A00,893758,Morshed; Michael James,2,0,20,18
1745790072827,MCWP 50,B00,893761,Bartulis; Jason Michael,17,0,20,3
1745790073853,MCWP 50R,A00,893766,Compas; Sean Matthew,0,1,20,20
1745790073853,MCWP 50R,B00,893769,Carter; Jennifer A,0,0,20,20
1745790073853,MCWP 50R,C00,893771,Krone; Jarret,0,3,20,20
1745790073853,MCWP 50R,D00,893772,Miller; Elizabeth Deen,3,0,20,17
1745790073853,MCWP 50R,E00,893775,Carter; Andrea L,0,0,20,20
1745790074879,MMW 11R,A01,892721,Herbst; Matthew,11,0,27,16
1745790074879,MMW 11R,A02,892722,Herbst; Matthew,0,0,0,3
1745790075904,MMW 12R,A01,892724,Herbst; Matthew,0,9,16,16
1745790075904,MMW 12R,A02,892725,Herbst; Matthew,0,9,16,16
1745790076931,MMW 13R,A01,892727,Staff,0,4,16,16
1745790076931,MMW 13R,A02,892728,Staff,0,4,16,16
1745790076931,MMW 13R,A03,958032,Staff,0,3,16,16
1745790076931,MMW 13R,A04,958033,Staff,0,2,16,16
1745790076931,MMW 13R,A05,958034,Staff,0,3,16,16
1745790078012,SIO 295LS,A00,894015,Staff,7,0,25,18
1745790079039,SIO 295S,A00,894020,Staff,7,0,25,18
1745790080070,SIOC 290S,B01,958918,Staff,0,0,0,0
1745790081100,SIOC 291S,B01,958922,Staff,0,0,0,0
1745790082127,SOCI 117,A01,895339,Staff,4,0,5,1
1745790083152,WES 237B,A00,894149,Staff,11,0,20,9
1745790085214,AESE 279B,A00,891859,Staff,13,0,35,22
1745790086241,AIP 197,001,891854,Staff,70,0,70,0
1745790087271,ANTH 289S,A00,891856,Gagneux; Pascal,12,0,12,0
1745790088294,BENG 196,001,957946,Engler; Adam J.,9996,0,9999,3
1745790089321,CAT 124RS,A01,956906,Staff,8,0,25,17
1745790090350,CAT 125RS,A01,922013,Staff,8,0,25,17
1745790091376,CLRE 250,A00,891860,Morris; Sheldon,9995,0,9999,4
1745790093428,CLRE 251R,A00,907817,Mehta; Ravindra L.,9994,0,9999,5
1745790094452,CLRE 252,A00,891864,Cuomo; Raphael Eduardo,9993,0,9999,6
1745790095477,CLRE 253,A00,891867,Vaida; Florin,9994,0,9999,5
1745790095477,CLRE 253,B00,907819,Staff,9999,0,9999,0
1745790096502,CLRE 259,A00,891868,Patel; Hemal,9998,0,9999,1
1745790097530,CLRE 260,A00,891872,Cuomo; Raphael Eduardo,9999,0,9999,0
1745790098555,CLRE 297,001,891888,Cuomo; Raphael Eduardo,9999,0,9999,0
1745790099581,CSE 191,A00,958773,Minnes Kemp; Mor Mia,9999,0,9999,0
1745790100610,CSS 201S,A01,892054,Mignozzetti; Umberto,30,0,30,0
1745790101640,CSS 202S,A01,892056,Mignozzetti; Umberto,30,0,30,0
1745790102667,DSC 197,001,956898,Eldridge; Justin Matthew,9998,0,9999,1
1745790103691,DSC 297,001,958000,Mazumdar; Arya,9998,0,9999,1
1745790104718,EAP 100,A00,905686,Staff,9776,0,9999,223
1745790105744,ECE 45,A01,892618,Staff,0,12,50,50
1745790106771,ECE 109,A01,892620,Staff,0,43,0,0
1745790107800,ECE 111,A01,892719,Staff,0,7,50,50
1745790108830,ECE 197,001,957920,Mercier; Patrick Philip,9992,0,9999,7
1745790109856,ECON 178,A01,907814,Zhu; Ying,28,0,35,7
1745790110884,EDS 115,A00,895312,Staff,41,0,45,4
1745790111909,EDS 117,A01,895337,Staff,30,0,30,0
1745790112936,EDS 125,A00,895341,Jones; Gabrielle Anastasia,43,0,45,2
1745790113989,EDS 128A,A01,895459,Fargason; Sharon Gayle,44,0,45,1
1745790115018,EDS 128B,A01,895543,Pappas; Elizabeth,44,0,45,1
1745790116046,EDS 139,A00,897203,Pappas; Elizabeth,44,0,45,1
1745790116046,EDS 139,B00,897209,Fargason; Sharon Gayle,44,0,45,1
1745790117072,EDS 201,A00,895545,Staff,43,0,45,2
1745790118100,EDS 203,A01,895581,Halter; Christopher P.,43,0,45,2
1745790119126,EDS 204R,A01,895625,Heinzman; Erica M.,43,0,45,2
1745790119126,EDS 204R,B01,895693,Halter; Christopher P.,18,0,45,27
1745790120155,EDS 206R,A00,895694,Fargason; Sharon Gayle,9,0,30,21
1745790120155,EDS 206R,B00,895695,Choi; Bailey Miyeon,20,0,30,10
1745790121180,EDS 250,A00,895697,Hemans; Patricia Ann Benitez,43,0,45,2
1745790122208,EDS 281,A00,895701,Meyerott; Theresa Ann,15,0,15,0
1745790123234,EDS 284,A00,895736,Meyerott; Theresa Ann,15,0,15,0
1745790124260,EDS 286,A00,897210,Fine; Sarah,15,0,15,0
1745790125286,EDS 289C,A01,895770,Daly; Alan J.,15,0,15,0
1745790126312,EDS 290,A00,897211,Hofstetter; Carolyn,15,0,15,0
1745790127355,LIGM 5A,A00,896162,Fischer-Grunski; Eva K,15,0,20,5
1745790128384,LIGM 5B,A00,896260,Fischer-Grunski; Eva K,17,0,20,3
1745790129409,LIGM 5C,A00,896308,Fischer-Grunski; Eva K,18,0,20,2
1745790130434,LIIT 5AS,A00,896313,Carnelos; Chiara,18,0,20,2
1745790131461,LIIT 5BS,A00,896416,Carnelos; Chiara,20,0,20,0
1745790132486,LIIT 5CS,A00,896564,Carnelos; Chiara,20,0,20,0
1745790133512,LISP 5A,A00,896588,Munoz Sanchez; Alicia,4,0,20,16
1745790134541,LISP 5B,A00,896653,Munoz Sanchez; Alicia,10,0,20,10
1745790135570,LISP 5C,A00,896655,Munoz Sanchez; Alicia,4,0,20,16
1745790136596,MAE 197,001,957918,Kleissl; Jan,9998,0,9999,1
1745790137621,MATH 2,A01,957937,Staff,34,0,35,1
1745790138646,MATH 197,001,957876,Kedlaya; Kiran S.,9993,0,9999,6
1745790139673,MCWP 40,A00,892729,Duru; Nur,13,0,20,7
1745790139673,MCWP 40,B00,893304,Montejo; Carolina,20,0,20,0
1745790140701,MCWP 40R,A00,893757,Redela; Pamela Morgan,0,6,20,20
1745790141730,MCWP 50,A00,893758,Morshed; Michael James,2,0,20,18
1745790141730,MCWP 50,B00,893761,Bartulis; Jason Michael,17,0,20,3
1745790142754,MCWP 50R,A00,893766,Compas; Sean Matthew,0,1,20,20
1745790142754,MCWP 50R,B00,893769,Carter; Jennifer A,0,0,20,20
1745790142754,MCWP 50R,C00,893771,Krone; Jarret,0,3,20,20
1745790142754,MCWP 50R,D00,893772,Miller; Elizabeth Deen,3,0,20,17
1745790142754,MCWP 50R,E00,893775,Carter; Andrea L,0,0,20,20
1745790143783,MMW 11R,A01,892721,Herbst; Matthew,11,0,27,16
1745790143783,MMW 11R,A02,892722,Herbst; Matthew,0,0,0,3
1745790144808,MMW 12R,A01,892724,Herbst; Matthew,0,9,16,16
1745790144808,MMW 12R,A02,892725,Herbst; Matthew,0,9,16,16
1745790145834,MMW 13R,A01,892727,Staff,0,4,16,16
1745790145834,MMW 13R,A02,892728,Staff,0,4,16,16
1745790145834,MMW 13R,A03,958032,Staff,0,3,16,16
1745790145834,MMW 13R,A04,958033,Staff,0,2,16,16
1745790145834,MMW 13R,A05,958034,Staff,0,3,16,16
1745790146865,SIO 295LS,A00,894015,Staff,7,0,25,18
1745790147890,SIO 295S,A00,894020,Staff,7,0,25,18
1745790148915,SIOC 290S,B01,958918,Staff,0,0,0,0
1745790149943,SIOC 291S,B01,958922,Staff,0,0,0,0
1745790150968,SOCI 117,A01,895339,Staff,4,0,5,1
1745790151992,WES 237B,A00,894149,Staff,11,0,20,9
1745790154049,AESE 279B,A00,891859,Staff,13,0,35,22
1745790155075,AIP 197,001,891854,Staff,70,0,70,0
1745790156101,ANTH 289S,A00,891856,Gagneux; Pascal,12,0,12,0
1745790157128,BENG 196,001,957946,Engler; Adam J.,9996,0,9999,3
1745790158153,CAT 124RS,A01,956906,Staff,8,0,25,17
1745790159179,CAT 125RS,A01,922013,Staff,8,0,25,17
1745790160208,CLRE 250,A00,891860,Morris; Sheldon,9995,0,9999,4
1745790162263,CLRE 251R,A00,907817,Mehta; Ravindra L.,9994,0,9999,5
1745790163290,CLRE 252,A00,891864,Cuomo; Raphael Eduardo,9993,0,9999,6
1745790164320,CLRE 253,A00,891867,Vaida; Florin,9994,0,9999,5
1745790164320,CLRE 253,B00,907819,Staff,9999,0,9999,0
1745790165346,CLRE 259,A00,891868,Patel; Hemal,9998,0,9999,1
1745790166372,CLRE 260,A00,891872,Cuomo; Raphael Eduardo,9999,0,9999,0
1745790167398,CLRE 297,001,891888,Cuomo; Raphael Eduardo,9999,0,9999,0
1745790168425,CSE 191,A00,958773,Minnes Kemp; Mor Mia,9999,0,9999,0
1745790169452,CSS 201S,A01,892054,Mignozzetti; Umberto,30,0,30,0
1745790170478,CSS 202S,A01,892056,Mignozzetti; Umberto,30,0,30,0
1745790171506,DSC 197,001,956898,Eldridge; Justin Matthew,9998,0,9999,1
1745790172534,DSC 297,001,958000,Mazumdar; Arya,9998,0,9999,1
1745790173561,EAP 100,A00,905686,Staff,9776,0,9999,223
1745790174585,ECE 45,A01,892618,Staff,0,12,50,50
1745790175613,ECE 109,A01,892620,Staff,0,43,0,0
1745790176642,ECE 111,A01,892719,Staff,0,7,50,50
1745790177670,ECE 197,001,957920,Mercier; Patrick Philip,9992,0,9999,7
1745790178697,ECON 178,A01,907814,Zhu; Ying,28,0,35,7
1745790179723,EDS 115,A00,895312,Staff,41,0,45,4
1745790180749,EDS 117,A01,895337,Staff,30,0,30,0
1745790181775,EDS 125,A00,895341,Jones; Gabrielle Anastasia,43,0,45,2
1745790182803,EDS 128A,A01,895459,Fargason; Sharon Gayle,44,0,45,1
1745790183832,EDS 128B,A01,895543,Pappas; Elizabeth,44,0,45,1
1745790184859,EDS 139,A00,897203,Pappas; Elizabeth,44,0,45,1
1745790184859,EDS 139,B00,897209,Fargason; Sharon Gayle,44,0,45,1
1745790185883,EDS 201,A00,895545,Staff,43,0,45,2
1745790186912,EDS 203,A01,895581,Halter; Christopher P.,43,0,45,2
1745790187941,EDS 204R,A01,895625,Heinzman; Erica M.,43,0,45,2
1745790187941,EDS 204R,B01,895693,Halter; Christopher P.,18,0,45,27
1745790188967,EDS 206R,A00,895694,Fargason; Sharon Gayle,9,0,30,21
1745790188967,EDS 206R,B00,895695,Choi; Bailey Miyeon,20,0,30,10
1745790189993,EDS 250,A00,895697,Hemans; Patricia Ann Benitez,43,0,45,2
1745790191022,EDS 281,A00,895701,Meyerott; Theresa Ann,15,0,15,0
1745790192047,EDS 284,A00,895736,Meyerott; Theresa Ann,15,0,15,0
1745790193074,EDS 286,A00,897210,Fine; Sarah,15,0,15,0
1745790194098,EDS 289C,A01,895770,Daly; Alan J.,15,0,15,0
1745790195126,EDS 290,A00,897211,Hofstetter; Carolyn,15,0,15,0
1745790196153,LIGM 5A,A00,896162,Fischer-Grunski; Eva K,15,0,20,5
1745790197179,LIGM 5B,A00,896260,Fischer-Grunski; Eva K,17,0,20,3
1745790198208,LIGM 5C,A00,896308,Fischer-Grunski; Eva K,18,0,20,2
1745790199238,LIIT 5AS,A00,896313,Carnelos; Chiara,18,0,20,2
1745790200264,LIIT 5BS,A00,896416,Carnelos; Chiara,20,0,20,0
1745790201292,LIIT 5CS,A00,896564,Carnelos; Chiara,20,0,20,0
1745790202321,LISP 5A,A00,896588,Munoz Sanchez; Alicia,4,0,20,16
1745790203348,LISP 5B,A00,896653,Munoz Sanchez; Alicia,10,0,20,10
1745790204377,LISP 5C,A00,896655,Munoz Sanchez; Alicia,4,0,20,16
1745790205406,MAE 197,001,957918,Kleissl; Jan,9998,0,9999,1
1745790206436,MATH 2,A01,957937,Staff,34,0,35,1
1745790207464,MATH 197,001,957876,Kedlaya; Kiran S.,9993,0,9999,6
1745790208488,MCWP 40,A00,892729,Duru; Nur,13,0,20,7
1745790208488,MCWP 40,B00,893304,Montejo; Carolina,20,0,20,0
1745790209518,MCWP 40R,A00,893757,Redela; Pamela Morgan,0,6,20,20
1745790210543,MCWP 50,A00,893758,Morshed; Michael James,2,0,20,18
1745790210543,MCWP 50,B00,893761,Bartulis; Jason Michael,17,0,20,3
1745790211570,MCWP 50R,A00,893766,Compas; Sean Matthew,0,1,20,20
1745790211570,MCWP 50R,B00,893769,Carter; Jennifer A,0,0,20,20
1745790211570,MCWP 50R,C00,893771,Krone; Jarret,0,3,20,20
1745790211570,MCWP 50R,D00,893772,Miller; Elizabeth Deen,3,0,20,17
1745790211570,MCWP 50R,E00,893775,Carter; Andrea L,0,0,20,20
1745790212596,MMW 11R,A01,892721,Herbst; Matthew,11,0,27,16
1745790212596,MMW 11R,A02,892722,Herbst; Matthew,0,0,0,3
1745790213624,MMW 12R,A01,892724,Herbst; Matthew,0,9,16,16
1745790213624,MMW 12R,A02,892725,Herbst; Matthew,0,9,16,16
1745790214650,MMW 13R,A01,892727,Staff,0,4,16,16
1745790214650,MMW 13R,A02,892728,Staff,0,4,16,16
1745790214650,MMW 13R,A03,958032,Staff,0,3,16,16
1745790214650,MMW 13R,A04,958033,Staff,0,2,16,16
1745790214650,MMW 13R,A05,958034,Staff,0,3,16,16
1745790215680,SIO 295LS,A00,894015,Staff,7,0,25,18
1745790216705,SIO 295S,A00,894020,Staff,7,0,25,18
1745790217732,SIOC 290S,B01,958918,Staff,0,0,0,0
1745790218759,SIOC 291S,B01,958922,Staff,0,0,0,0
1745790219784,SOCI 117,A01,895339,Staff,4,0,5,1
1745790220812,WES 237B,A00,894149,Staff,11,0,20,9
1745790222880,AESE 279B,A00,891859,Staff,13,0,35,22
1745790223907,AIP 197,001,891854,Staff,70,0,70,0
1745790224933,ANTH 289S,A00,891856,Gagneux; Pascal,12,0,12,0
1745790225959,BENG 196,001,957946,Engler; Adam J.,9996,0,9999,3
1745790226987,CAT 124RS,A01,956906,Staff,8,0,25,17
1745790228014,CAT 125RS,A01,922013,Staff,8,0,25,17
1745790229043,CLRE 250,A00,891860,Morris; Sheldon,9995,0,9999,4
1745790231098,CLRE 251R,A00,907817,Mehta; Ravindra L.,9994,0,9999,5
1745790232129,CLRE 252,A00,891864,Cuomo; Raphael Eduardo,9993,0,9999,6
1745790233155,CLRE 253,A00,891867,Vaida; Florin,9994,0,9999,5
1745790233155,CLRE 253,B00,907819,Staff,9999,0,9999,0
1745790234183,CLRE 259,A00,891868,Patel; Hemal,9998,0,9999,1
1745790235209,CLRE 260,A00,891872,Cuomo; Raphael Eduardo,9999,0,9999,0
1745790236238,CLRE 297,001,891888,Cuomo; Raphael Eduardo,9999,0,9999,0
1745790237262,CSE 191,A00,958773,Minnes Kemp; Mor Mia,9999,0,9999,0
1745790238289,CSS 201S,A01,892054,Mignozzetti; Umberto,30,0,30,0
1745790239319,CSS 202S,A01,892056,Mignozzetti; Umberto,30,0,30,0
1745790240345,DSC 197,001,956898,Eldridge; Justin Matthew,9998,0,9999,1
1745790241372,DSC 297,001,958000,Mazumdar; Arya,9998,0,9999,1
1745790242399,EAP 100,A00,905686,Staff,9776,0,9999,223
1745790243428,ECE 45,A01,892618,Staff,0,12,50,50
1745790244455,ECE 109,A01,892620,Staff,0,43,0,0
1745790245482,ECE 111,A01,892719,Staff,0,7,50,50
1745790246507,ECE 197,001,957920,Mercier; Patrick Philip,9992,0,9999,7
1745790247535,ECON 178,A01,907814,Zhu; Ying,28,0,35,7
1745790248561,EDS 115,A00,895312,Staff,41,0,45,4
1745790249587,EDS 117,A01,895337,Staff,30,0,30,0
1745790250613,EDS 125,A00,895341,Jones; Gabrielle Anastasia,43,0,45,2
1745790251640,EDS 128A,A01,895459,Fargason; Sharon Gayle,44,0,45,1
1745790252669,EDS 128B,A01,895543,Pappas; Elizabeth,44,0,45,1
1745790253694,EDS 139,A00,897203,Pappas; Elizabeth,44,0,45,1
1745790253694,EDS 139,B00,897209,Fargason; Sharon Gayle,44,0,45,1
1745790254720,EDS 201,A00,895545,Staff,43,0,45,2
1745790255746,EDS 203,A01,895581,Halter; Christopher P.,43,0,45,2
1745790256790,EDS 204R,A01,895625,Heinzman; Erica M.,43,0,45,2
1745790256790,EDS 204R,B01,895693,Halter; Christopher P.,18,0,45,27
1745790257820,EDS 206R,A00,895694,Fargason; Sharon Gayle,9,0,30,21
1745790257820,EDS 206R,B00,895695,Choi; Bailey Miyeon,20,0,30,10
1745790258846,EDS 250,A00,895697,Hemans; Patricia Ann Benitez,43,0,45,2
1745790259871,EDS 281,A00,895701,Meyerott; Theresa Ann,15,0,15,0
1745790260899,EDS 284,A00,895736,Meyerott; Theresa Ann,15,0,15,0
1745790261939,EDS 286,A00,897210,Fine; Sarah,15,0,15,0
1745790262969,EDS 289C,A01,895770,Daly; Alan J.,15,0,15,0
1745790263995,EDS 290,A00,897211,Hofstetter; Carolyn,15,0,15,0
1745790265025,LIGM 5A,A00,896162,Fischer-Grunski; Eva K,15,0,20,5
1745790266053,LIGM 5B,A00,896260,Fischer-Grunski; Eva K,17,0,20,3
1745790267079,LIGM 5C,A00,896308,Fischer-Grunski; Eva K,18,0,20,2
1745790268106,LIIT 5AS,A00,896313,Carnelos; Chiara,18,0,20,2
1745790269134,LIIT 5BS,A00,896416,Carnelos; Chiara,20,0,20,0
1745790270160,LIIT 5CS,A00,896564,Carnelos; Chiara,20,0,20,0
1745790271188,LISP 5A,A00,896588,Munoz Sanchez; Alicia,4,0,20,16
1745790272217,LISP 5B,A00,896653,Munoz Sanchez; Alicia,10,0,20,10
1745790273246,LISP 5C,A00,896655,Munoz Sanchez; Alicia,4,0,20,16
1745790274272,MAE 197,001,957918,Kleissl; Jan,9998,0,9999,1
1745790275301,MATH 2,A01,957937,Staff,34,0,35,1
1745790276327,MATH 197,001,957876,Kedlaya; Kiran S.,9993,0,9999,6
1745790277353,MCWP 40,A00,892729,Duru; Nur,13,0,20,7
1745790277353,MCWP 40,B00,893304,Montejo; Carolina,20,0,20,0
1745790278379,MCWP 40R,A00,893757,Redela; Pamela Morgan,0,6,20,20
1745790279405,MCWP 50,A00,893758,Morshed; Michael James,2,0,20,18
1745790279405,MCWP 50,B00,893761,Bartulis; Jason Michael,17,0,20,3
1745790280431,MCWP 50R,A00,893766,Compas; Sean Matthew,0,1,20,20
1745790280431,MCWP 50R,B00,893769,Carter; Jennifer A,0,0,20,20
1745790280431,MCWP 50R,C00,893771,Krone; Jarret,0,3,20,20
1745790280431,MCWP 50R,D00,893772,Miller; Elizabeth Deen,3,0,20,17
1745790280431,MCWP 50R,E00,893775,Carter; Andrea L,0,0,20,20
1745790281459,MMW 11R,A01,892721,Herbst; Matthew,11,0,27,16
1745790281459,MMW 11R,A02,892722,Herbst; Matthew,0,0,0,3
1745790282485,MMW 12R,A01,892724,Herbst; Matthew,0,9,16,16
1745790282485,MMW 12R,A02,892725,Herbst; Matthew,0,9,16,16
1745790283510,MMW 13R,A01,892727,Staff,0,4,16,16
1745790283510,MMW 13R,A02,892728,Staff,0,4,16,16
1745790283510,MMW 13R,A03,958032,Staff,0,3,16,16
1745790283510,MMW 13R,A04,958033,Staff,0,2,16,16
1745790283510,MMW 13R,A05,958034,Staff,0,3,16,16
1745790284539,SIO 295LS,A00,894015,Staff,7,0,25,18
1745790285566,SIO 295S,A00,894020,Staff,7,0,25,18
1745790286595,SIOC 290S,B01,958918,Staff,0,0,0,0
1745790287621,SIOC 291S,B01,958922,Staff,0,0,0,0
1745790288649,SOCI 117,A01,895339,Staff,4,0,5,1
1745790289673,WES 237B,A00,894149,Staff,11,0,20,9
1745790291734,AESE 279B,A00,891859,Staff,13,0,35,22
1745790292758,AIP 197,001,891854,Staff,70,0,70,0
1745790293789,ANTH 289S,A00,891856,Gagneux; Pascal,12,0,12,0
1745790294817,BENG 196,001,957946,Engler; Adam J.,9996,0,9999,3
1745790295845,CAT 124RS,A01,956906,Staff,8,0,25,17
1745790296871,CAT 125RS,A01,922013,Staff,8,0,25,17
1745790297899,CLRE 250,A00,891860,Morris; Sheldon,9995,0,9999,4
1745790299954,CLRE 251R,A00,907817,Mehta; Ravindra L.,9994,0,9999,5
1745790300982,CLRE 252,A00,891864,Cuomo; Raphael Eduardo,9993,0,9999,6
1745790302011,CLRE 253,A00,891867,Vaida; Florin,9994,0,9999,5
1745790302011,CLRE 253,B00,907819,Staff,9999,0,9999,0
1745790303037,CLRE 259,A00,891868,Patel; Hemal,9998,0,9999,1
1745790304063,CLRE 260,A00,891872,Cuomo; Raphael Eduardo,9999,0,9999,0
1745790305091,CLRE 297,001,891888,Cuomo; Raphael Eduardo,9999,0,9999,0
1745790306117,CSE 191,A00,958773,Minnes Kemp; Mor Mia,9999,0,9999,0
1745790307147,CSS 201S,A01,892054,Mignozzetti; Umberto,30,0,30,0
1745790308176,CSS 202S,A01,892056,Mignozzetti; Umberto,30,0,30,0
1745790309203,DSC 197,001,956898,Eldridge; Justin Matthew,9998,0,9999,1
1745790310232,DSC 297,001,958000,Mazumdar; Arya,9998,0,9999,1
1745790311257,EAP 100,A00,905686,Staff,9776,0,9999,223
1745790312284,ECE 45,A01,892618,Staff,0,12,50,50
1745790313311,ECE 109,A01,892620,Staff,0,43,0,0
1745790314336,ECE 111,A01,892719,Staff,0,7,50,50
1745790315361,ECE 197,001,957920,Mercier; Patrick Philip,9992,0,9999,7
1745790316387,ECON 178,A01,907814,Zhu; Ying,28,0,35,7
1745790317416,EDS 115,A00,895312,Staff,41,0,45,4
1745790318446,EDS 117,A01,895337,Staff,30,0,30,0
1745790319474,EDS 125,A00,895341,Jones; Gabrielle Anastasia,43,0,45,2
1745790320499,EDS 128A,A01,895459,Fargason; Sharon Gayle,44,0,45,1
1745790321528,EDS 128B,A01,895543,Pappas; Elizabeth,44,0,45,1
1745790322556,EDS 139,A00,897203,Pappas; Elizabeth,44,0,45,1
1745790322556,EDS 139,B00,897209,Fargason; Sharon Gayle,44,0,45,1
1745790323584,EDS 201,A00,895545,Staff,43,0,45,2
1745790324609,EDS 203,A01,895581,Halter; Christopher P.,43,0,45,2
1745790325637,EDS 204R,A01,895625,Heinzman; Erica M.,43,0,45,2
1745790325637,EDS 204R,B01,895693,Halter; Christopher P.,18,0,45,27
1745790326664,EDS 206R,A00,895694,Fargason; Sharon Gayle,9,0,30,21
1745790326664,EDS 206R,B00,895695,Choi; Bailey Miyeon,20,0,30,10
1745790327689,EDS 250,A00,895697,Hemans; Patricia Ann Benitez,43,0,45,2
1745790328714,EDS 281,A00,895701,Meyerott; Theresa Ann,15,0,15,0
1745790329739,EDS 284,A00,895736,Meyerott; Theresa Ann,15,0,15,0
1745790330769,EDS 286,A00,897210,Fine; Sarah,15,0,15,0
1745790331797,EDS 289C,A01,895770,Daly; Alan J.,15,0,15,0
1745790332826,EDS 290,A00,897211,Hofstetter; Carolyn,15,0,15,0
1745790333852,LIGM 5A,A00,896162,Fischer-Grunski; Eva K,15,0,20,5
1745790334879,LIGM 5B,A00,896260,Fischer-Grunski; Eva K,17,0,20,3
1745790335907,LIGM 5C,A00,896308,Fischer-Grunski; Eva K,18,0,20,2
1745790336931,LIIT 5AS,A00,896313,Carnelos; Chiara,18,0,20,2
1745790337958,LIIT 5BS,A00,896416,Carnelos; Chiara,20,0,20,0
1745790338984,LIIT 5CS,A00,896564,Carnelos; Chiara,20,0,20,0
1745790340011,LISP 5A,A00,896588,Munoz Sanchez; Alicia,4,0,20,16
1745790341038,LISP 5B,A00,896653,Munoz Sanchez; Alicia,10,0,20,10
1745790342066,LISP 5C,A00,896655,Munoz Sanchez; Alicia,4,0,20,16
1745790343091,MAE 197,001,957918,Kleissl; Jan,9998,0,9999,1
1745790344118,MATH 2,A01,957937,Staff,34,0,35,1
1745790345144,MATH 197,001,957876,Kedlaya; Kiran S.,9993,0,9999,6
1745790346174,MCWP 40,A00,892729,Duru; Nur,13,0,20,7
1745790346174,MCWP 40,B00,893304,Montejo; Carolina,20,0,20,0
1745790347201,MCWP 40R,A00,893757,Redela; Pamela Morgan,0,6,20,20
1745790348228,MCWP 50,A00,893758,Morshed; Michael James,2,0,20,18
1745790348228,MCWP 50,B00,893761,Bartulis; Jason Michael,17,0,20,3
1745790349255,MCWP 50R,A00,893766,Compas; Sean Matthew,0,1,20,20
1745790349255,MCWP 50R,B00,893769,Carter; Jennifer A,0,0,20,20
1745790349255,MCWP 50R,C00,893771,Krone; Jarret,0,3,20,20
1745790349255,MCWP 50R,D00,893772,Miller; Elizabeth Deen,3,0,20,17
1745790349255,MCWP 50R,E00,893775,Carter; Andrea L,0,0,20,20
1745790350285,MMW 11R,A01,892721,Herbst; Matthew,11,0,27,16
1745790350285,MMW 11R,A02,892722,Herbst; Matthew,0,0,0,3
1745790351309,MMW 12R,A01,892724,Herbst; Matthew,0,9,16,16
1745790351309,MMW 12R,A02,892725,Herbst; Matthew,0,9,16,16
1745790352339,MMW 13R,A01,892727,Staff,0,4,16,16
1745790352339,MMW 13R,A02,892728,Staff,0,4,16,16
1745790352339,MMW 13R,A03,958032,Staff,0,3,16,16
1745790352339,MMW 13R,A04,958033,Staff,0,2,16,16
1745790352339,MMW 13R,A05,958034,Staff,0,3,16,16
1745790353367,SIO 295LS,A00,894015,Staff,7,0,25,18
1745790354391,SIO 295S,A00,894020,Staff,7,0,25,18
1745790355418,SIOC 290S,B01,958918,Staff,0,0,0,0
1745790356446,SIOC 291S,B01,958922,Staff,0,0,0,0
1745790357474,SOCI 117,A01,895339,Staff,4,0,5,1
1745790358500,WES 237B,A00,894149,Staff,11,0,20,9
1745790360556,AESE 279B,A00,891859,Staff,13,0,35,22
1745790361584,AIP 197,001,891854,Staff,70,0,70,0
1745790362609,ANTH 289S,A00,891856,Gagneux; Pascal,12,0,12,0
1745790363635,BENG 196,001,957946,Engler; Adam J.,9996,0,9999,3
1745790364664,CAT 124RS,A01,956906,Staff,8,0,25,17
1745790365689,CAT 125RS,A01,922013,Staff,8,0,25,17
1745790366715,CLRE 250,A00,891860,Morris; Sheldon,9995,0,9999,4
1745790368772,CLRE 251R,A00,907817,Mehta; Ravindra L.,9994,0,9999,5
1745790369799,CLRE 252,A00,891864,Cuomo; Raphael Eduardo,9993,0,9999,6
1745790370825,CLRE 253,A00,891867,Vaida; Florin,9994,0,9999,5
1745790370825,CLRE 253,B00,907819,Staff,9999,0,9999,0
1745790371851,CLRE 259,A00,891868,Patel; Hemal,9998,0,9999,1
1745790372878,CLRE 260,A00,891872,Cuomo; Raphael Eduardo,9999,0,9999,0
1745790373903,CLRE 297,001,891888,Cuomo; Raphael Eduardo,9999,0,9999,0
1745790374931,CSE 191,A00,958773,Minnes Kemp; Mor Mia,9999,0,9999,0
1745790375962,CSS 201S,A01,892054,Mignozzetti; Umberto,30,0,30,0
1745790376989,CSS 202S,A01,892056,Mignozzetti; Umberto,30,0,30,0
1745790378016,DSC 197,001,956898,Eldridge; Justin Matthew,9998,0,9999,1
1745790379042,DSC 297,001,958000,Mazumdar; Arya,9998,0,9999,1
1745790380067,EAP 100,A00,905686,Staff,9776,0,9999,223
1745790381093,ECE 45,A01,892618,Staff,0,12,50,50
1745790382121,ECE 109,A01,892620,Staff,0,43,0,0
1745790383148,ECE 111,A01,892719,Staff,0,7,50,50
1745790384177,ECE 197,001,957920,Mercier; Patrick Philip,9992,0,9999,7
1745790385207,ECON 178,A01,907814,Zhu; Ying,28,0,35,7
1745790386236,EDS 115,A00,895312,Staff,41,0,45,4
1745790387267,EDS 117,A01,895337,Staff,30,0,30,0
1745790388293,EDS 125,A00,895341,Jones; Gabrielle Anastasia,43,0,45,2
1745790389319,EDS 128A,A01,895459,Fargason; Sharon Gayle,44,0,45,1
1745790390349,EDS 128B,A01,895543,Pappas; Elizabeth,44,0,45,1
1745790391374,EDS 139,A00,897203,Pappas; Elizabeth,44,0,45,1
1745790391374,EDS 139,B00,897209,Fargason; Sharon Gayle,44,0,45,1
1745790392402,EDS 201,A00,895545,Staff,43,0,45,2
1745790393428,EDS 203,A01,895581,Halter; Christopher P.,43,0,45,2
1745790394453,EDS 204R,A01,895625,Heinzman; Erica M.,43,0,45,2
1745790394453,EDS 204R,B01,895693,Halter; Christopher P.,18,0,45,27
1745790395478,EDS 206R,A00,895694,Fargason; Sharon Gayle,9,0,30,21
1745790395478,EDS 206R,B00,895695,Choi; Bailey Miyeon,20,0,30,10
1745790396507,EDS 250,A00,895697,Hemans; Patricia Ann Benitez,43,0,45,2
1745790397536,EDS 281,A00,895701,Meyerott; Theresa Ann,15,0,15,0
1745790398564,EDS 284,A00,895736,Meyerott; Theresa Ann,15,0,15,0
1745790399590,EDS 286,A00,897210,Fine; Sarah,15,0,15,0
1745790400618,EDS 289C,A01,895770,Daly; Alan J.,15,0,15,0
1745790401643,EDS 290,A00,897211,Hofstetter; Carolyn,15,0,15,0
1745790402670,LIGM 5A,A00,896162,Fischer-Grunski; Eva K,15,0,20,5
1745790403695,LIGM 5B,A00,896260,Fischer-Grunski; Eva K,17,0,20,3
1745790404720,LIGM 5C,A00,896308,Fischer-Grunski; Eva K,18,0,20,2
1745790405746,LIIT 5AS,A00,896313,Carnelos; Chiara,18,0,20,2
1745790406776,LIIT 5BS,A00,896416,Carnelos; Chiara,20,0,20,0
1745790407803,LIIT 5CS,A00,896564,Carnelos; Chiara,20,0,20,0
1745790408827,LISP 5A,A00,896588,Munoz Sanchez; Alicia,4,0,20,16
1745790409856,LISP 5B,A00,896653,Munoz Sanchez; Alicia,10,0,20,10
1745790410884,LISP 5C,A00,896655,Munoz Sanchez; Alicia,4,0,20,16
1745790411911,MAE 197,001,957918,Kleissl; Jan,9998,0,9999,1
1745790412936,MATH 2,A01,957937,Staff,34,0,35,1
1745790413962,MATH 197,001,957876,Kedlaya; Kiran S.,9993,0,9999,6
1745790414994,MCWP 40,A00,892729,Duru; Nur,13,0,20,7
1745790414994,MCWP 40,B00,893304,Montejo; Carolina,20,0,20,0
1745790416021,MCWP 40R,A00,893757,Redela; Pamela Morgan,0,6,20,20
1745790417049,MCWP 50,A00,893758,Morshed; Michael James,2,0,20,18
1745790417049,MCWP 50,B00,893761,Bartulis; Jason Michael,17,0,20,3
1745790418076,MCWP 50R,A00,893766,Compas; Sean Matthew,0,1,20,20
1745790418076,MCWP 50R,B00,893769,Carter; Jennifer A,0,0,20,20
1745790418076,MCWP 50R,C00,893771,Krone; Jarret,0,3,20,20
1745790418076,MCWP 50R,D00,893772,Miller; Elizabeth Deen,3,0,20,17
1745790418076,MCWP 50R,E00,893775,Carter; Andrea L,0,0,20,20
1745790419106,MMW 11R,A01,892721,Herbst; Matthew,11,0,27,16
1745790419106,MMW 11R,A02,892722,Herbst; Matthew,0,0,0,3
1745790420135,MMW 12R,A01,892724,Herbst; Matthew,0,9,16,16
1745790420135,MMW 12R,A02,892725,Herbst; Matthew,0,9,16,16
1745790421161,MMW 13R,A01,892727,Staff,0,4,16,16
1745790421161,MMW 13R,A02,892728,Staff,0,4,16,16
1745790421161,MMW 13R,A03,958032,Staff,0,3,16,16
1745790421161,MMW 13R,A04,958033,Staff,0,2,16,16
1745790421161,MMW 13R,A05,958034,Staff,0,3,16,16
1745790422188,SIO 295LS,A00,894015,Staff,7,0,25,18
1745790423218,SIO 295S,A00,894020,Staff,7,0,25,18
1745790424245,SIOC 290S,B01,958918,Staff,0,0,0,0
1745790425277,SIOC 291S,B01,958922,Staff,0,0,0,0
1745790426303,SOCI 117,A01,895339,Staff,4,0,5,1
1745790427332,WES 237B,A00,894149,Staff,11,0,20,9
1745790429388,AESE 279B,A00,891859,Staff,13,0,35,22
1745790430414,AIP 197,001,891854,Staff,70,0,70,0
1745790431441,ANTH 289S,A00,891856,Gagneux; Pascal,12,0,12,0
1745790432468,BENG 196,001,957946,Engler; Adam J.,9996,0,9999,3
1745790433493,CAT 124RS,A01,956906,Staff,8,0,25,17
1745790434520,CAT 125RS,A01,922013,Staff,8,0,25,17
1745790435545,CLRE 250,A00,891860,Morris; Sheldon,9995,0,9999,4
1745790437597,CLRE 251R,A00,907817,Mehta; Ravindra L.,9994,0,9999,5
1745790438622,CLRE 252,A00,891864,Cuomo; Raphael Eduardo,9993,0,9999,6
1745790439645,CLRE 253,A00,891867,Vaida; Florin,9994,0,9999,5
1745790439645,CLRE 253,B00,907819,Staff,9999,0,9999,0
1745790440673,CLRE 259,A00,891868,Patel; Hemal,9998,0,9999,1
1745790441699,CLRE 260,A00,891872,Cuomo; Raphael Eduardo,9999,0,9999,0
1745790442727,CLRE 297,001,891888,Cuomo; Raphael Eduardo,9999,0,9999,0
1745790443752,CSE 191,A00,958773,Minnes Kemp; Mor Mia,9999,0,9999,0
1745790444778,CSS 201S,A01,892054,Mignozzetti; Umberto,30,0,30,0
1745790445803,CSS 202S,A01,892056,Mignozzetti; Umberto,30,0,30,0
1745790446828,DSC 197,001,956898,Eldridge; Justin Matthew,9998,0,9999,1
1745790447856,DSC 297,001,958000,Mazumdar; Arya,9998,0,9999,1
1745790448883,EAP 100,A00,905686,Staff,9776,0,9999,223
1745790449912,ECE 45,A01,892618,Staff,0,12,50,50
1745790450940,ECE 109,A01,892620,Staff,0,43,0,0
1745790451965,ECE 111,A01,892719,Staff,0,7,50,50
1745790452994,ECE 197,001,957920,Mercier; Patrick Philip,9992,0,9999,7
1745790454021,ECON 178,A01,907814,Zhu; Ying,28,0,35,7
1745790455050,EDS 115,A00,895312,Staff,41,0,45,4
1745790456075,EDS 117,A01,895337,Staff,30,0,30,0
1745790457099,EDS 125,A00,895341,Jones; Gabrielle Anastasia,43,0,45,2
1745790458126,EDS 128A,A01,895459,Fargason; Sharon Gayle,44,0,45,1
1745790459154,EDS 128B,A01,895543,Pappas; Elizabeth,44,0,45,1
1745790460180,EDS 139,A00,897203,Pappas; Elizabeth,44,0,45,1
1745790460180,EDS 139,B00,897209,Fargason; Sharon Gayle,44,0,45,1
1745790461208,EDS 201,A00,895545,Staff,43,0,45,2
1745790462235,EDS 203,A01,895581,Halter; Christopher P.,43,0,45,2
1745790463263,EDS 204R,A01,895625,Heinzman; Erica M.,43,0,45,2
1745790463263,EDS 204R,B01,895693,Halter; Christopher P.,18,0,45,27
1745790464292,EDS 206R,A00,895694,Fargason; Sharon Gayle,9,0,30,21
1745790464292,EDS 206R,B00,895695,Choi; Bailey Miyeon,20,0,30,10
1745790465318,EDS 250,A00,895697,Hemans; Patricia Ann Benitez,43,0,45,2
1745790466344,EDS 281,A00,895701,Meyerott; Theresa Ann,15,0,15,0
1745790467371,EDS 284,A00,895736,Meyerott; Theresa Ann,15,0,15,0
1745790468399,EDS 286,A00,897210,Fine; Sarah,15,0,15,0
1745790469423,EDS 289C,A01,895770,Daly; Alan J.,15,0,15,0
1745790470451,EDS 290,A00,897211,Hofstetter; Carolyn,15,0,15,0
1745790471478,LIGM 5A,A00,896162,Fischer-Grunski; Eva K,15,0,20,5
1745790472503,LIGM 5B,A00,896260,Fischer-Grunski; Eva K,17,0,20,3
1745790473530,LIGM 5C,A00,896308,Fischer-Grunski; Eva K,18,0,20,2
1745790474558,LIIT 5AS,A00,896313,Carnelos; Chiara,18,0,20,2
1745790475584,LIIT 5BS,A00,896416,Carnelos; Chiara,20,0,20,0
1745790476609,LIIT 5CS,A00,896564,Carnelos; Chiara,20,0,20,0
1745790477637,LISP 5A,A00,896588,Munoz Sanchez; Alicia,4,0,20,16
1745790478664,LISP 5B,A00,896653,Munoz Sanchez; Alicia,10,0,20,10
1745790479689,LISP 5C,A00,896655,Munoz Sanchez; Alicia,4,0,20,16
1745790480721,MAE 197,001,957918,Kleissl; Jan,9998,0,9999,1
1745790481750,MATH 2,A01,957937,Staff,34,0,35,1
1745790482775,MATH 197,001,957876,Kedlaya; Kiran S.,9993,0,9999,6
1745790483805,MCWP 40,A00,892729,Duru; Nur,13,0,20,7
1745790483805,MCWP 40,B00,893304,Montejo; Carolina,20,0,20,0
1745790484831,MCWP 40R,A00,893757,Redela; Pamela Morgan,0,6,20,20
1745790485857,MCWP 50,A00,893758,Morshed; Michael James,2,0,20,18
1745790485857,MCWP 50,B00,893761,Bartulis; Jason Michael,17,0,20,3
1745790486885,MCWP 50R,A00,893766,Compas; Sean Matthew,0,1,20,20
1745790486885,MCWP 50R,B00,893769,Carter; Jennifer A,0,0,20,20
1745790486885,MCWP 50R,C00,893771,Krone; Jarret,0,3,20,20
1745790486885,MCWP 50R,D00,893772,Miller; Elizabeth Deen,3,0,20,17
1745790486885,MCWP 50R,E00,893775,Carter; Andrea L,0,0,20,20
1745790487910,MMW 11R,A01,892721,Herbst; Matthew,11,0,27,16
1745790487910,MMW 11R,A02,892722,Herbst; Matthew,0,0,0,3
1745790488939,MMW 12R,A01,892724,Herbst; Matthew,0,9,16,16
1745790488939,MMW 12R,A02,892725,Herbst; Matthew,0,9,16,16
1745790489966,MMW 13R,A01,892727,Staff,0,4,16,16
1745790489966,MMW 13R,A02,892728,Staff,0,4,16,16
1745790489966,MMW 13R,A03,958032,Staff,0,3,16,16
1745790489966,MMW 13R,A04,958033,Staff,0,2,16,16
1745790489966,MMW 13R,A05,958034,Staff,0,3,16,16
1745790490995,SIO 295LS,A00,894015,Staff,7,0,25,18
1745790492019,SIO 295S,A00,894020,Staff,7,0,25,18
1745790493049,SIOC 290S,B01,958918,Staff,0,0,0,0
1745790494076,SIOC 291S,B01,958922,Staff,0,0,0,0
1745790495102,SOCI 117,A01,895339,Staff,4,0,5,1
1745790496129,WES 237B,A00,894149,Staff,11,0,20,9
1745790498200,AESE 279B,A00,891859,Staff,13,0,35,22
1745790499225,AIP 197,001,891854,Staff,70,0,70,0
1745790500254,ANTH 289S,A00,891856,Gagneux; Pascal,12,0,12,0
1745790501284,BENG 196,001,957946,Engler; Adam J.,9996,0,9999,3
1745790502311,CAT 124RS,A01,956906,Staff,8,0,25,17
1745790503340,CAT 125RS,A01,922013,Staff,8,0,25,17
1745790504367,CLRE 250,A00,891860,Morris; Sheldon,9995,0,9999,4
1745790506419,CLRE 251R,A00,907817,Mehta; Ravindra L.,9994,0,9999,5
1745790507446,CLRE 252,A00,891864,Cuomo; Raphael Eduardo,9993,0,9999,6
1745790508475,CLRE 253,A00,891867,Vaida; Florin,9994,0,9999,5
1745790508475,CLRE 253,B00,907819,Staff,9999,0,9999,0
1745790509503,CLRE 259,A00,891868,Patel; Hemal,9998,0,9999,1
1745790510531,CLRE 260,A00,891872,Cuomo; Raphael Eduardo,9999,0,9999,0
1745790511557,CLRE 297,001,891888,Cuomo; Raphael Eduardo,9999,0,9999,0
1745790512587,CSE 191,A00,958773,Minnes Kemp; Mor Mia,9999,0,9999,0
1745790513613,CSS 201S,A01,892054,Mignozzetti; Umberto,30,0,30,0
1745790514642,CSS 202S,A01,892056,Mignozzetti; Umberto,30,0,30,0
1745790515667,DSC 197,001,956898,Eldridge; Justin Matthew,9998,0,9999,1
1745790516693,DSC 297,001,958000,Mazumdar; Arya,9998,0,9999,1
1745790517719,EAP 100,A00,905686,Staff,9776,0,9999,223
1745790518744,ECE 45,A01,892618,Staff,0,12,50,50
1745790519769,ECE 109,A01,892620,Staff,0,43,0,0
1745790520795,ECE 111,A01,892719,Staff,0,7,50,50
1745790521822,ECE 197,001,957920,Mercier; Patrick Philip,9992,0,9999,7
1745790522850,ECON 178,A01,907814,Zhu; Ying,28,0,35,7
1745790523876,EDS 115,A00,895312,Staff,41,0,45,4
1745790524903,EDS 117,A01,895337,Staff,30,0,30,0
1745790525928,EDS 125,A00,895341,Jones; Gabrielle Anastasia,43,0,45,2
1745790526955,EDS 128A,A01,895459,Fargason; Sharon Gayle,44,0,45,1
1745790527981,EDS 128B,A01,895543,Pappas; Elizabeth,44,0,45,1
1745790529008,EDS 139,A00,897203,Pappas; Elizabeth,44,0,45,1
1745790529008,EDS 139,B00,897209,Fargason; Sharon Gayle,44,0,45,1
1745790530035,EDS 201,A00,895545,Staff,43,0,45,2
1745790531061,EDS 203,A01,895581,Halter; Christopher P.,43,0,45,2
1745790532092,EDS 204R,A01,895625,Heinzman; Erica M.,43,0,45,2
1745790532092,EDS 204R,B01,895693,Halter; Christopher P.,18,0,45,27
1745790533119,EDS 206R,A00,895694,Fargason; Sharon Gayle,9,0,30,21
1745790533119,EDS 206R,B00,895695,Choi; Bailey Miyeon,20,0,30,10
1745790534149,EDS 250,A00,895697,Hemans; Patricia Ann Benitez,43,0,45,2
1745790535175,EDS 281,A00,895701,Meyerott; Theresa Ann,15,0,15,0
1745790536203,EDS 284,A00,895736,Meyerott; Theresa Ann,15,0,15,0
1745790537232,EDS 286,A00,897210,Fine; Sarah,15,0,15,0
1745790538261,EDS 289C,A01,895770,Daly; Alan J.,15,0,15,0
1745790539288,EDS 290,A00,897211,Hofstetter; Carolyn,15,0,15,0
1745790540315,LIGM 5A,A00,896162,Fischer-Grunski; Eva K,15,0,20,5
1745790541341,LIGM 5B,A00,896260,Fischer-Grunski; Eva K,17,0,20,3
1745790542372,LIGM 5C,A00,896308,Fischer-Grunski; Eva K,18,0,20,2
1745790543402,LIIT 5AS,A00,896313,Carnelos; Chiara,18,0,20,2
1745790544434,LIIT 5BS,A00,896416,Carnelos; Chiara,20,0,20,0
1745790545460,LIIT 5CS,A00,896564,Carnelos; Chiara,20,0,20,0
1745790546490,LISP 5A,A00,896588,Munoz Sanchez; Alicia,4,0,20,16
1745790547515,LISP 5B,A00,896653,Munoz Sanchez; Alicia,10,0,20,10
1745790548545,LISP 5C,A00,896655,Munoz Sanchez; Alicia,4,0,20,16
1745790549572,MAE 197,001,957918,Kleissl; Jan,9998,0,9999,1
1745790550598,MATH 2,A01,957937,Staff,34,0,35,1
1745790551624,MATH 197,001,957876,Kedlaya; Kiran S.,9993,0,9999,6
1745790552649,MCWP 40,A00,892729,Duru; Nur,13,0,20,7
1745790552649,MCWP 40,B00,893304,Montejo; Carolina,20,0,20,0
1745790553672,MCWP 40R,A00,893757,Redela; Pamela Morgan,0,6,20,20
1745790554702,MCWP 50,A00,893758,Morshed; Michael James,2,0,20,18
1745790554702,MCWP 50,B00,893761,Bartulis; Jason Michael,17,0,20,3
1745790555728,MCWP 50R,A00,893766,Compas; Sean Matthew,0,1,20,20
1745790555728,MCWP 50R,B00,893769,Carter; Jennifer A,0,0,20,20
1745790555728,MCWP 50R,C00,893771,Krone; Jarret,0,3,20,20
1745790555728,MCWP 50R,D00,893772,Miller; Elizabeth Deen,3,0,20,17
1745790555728,MCWP 50R,E00,893775,Carter; Andrea L,0,0,20,20
1745790556755,MMW 11R,A01,892721,Herbst; Matthew,11,0,27,16
1745790556755,MMW 11R,A02,892722,Herbst; Matthew,0,0,0,3
1745790557782,MMW 12R,A01,892724,Herbst; Matthew,0,9,16,16
1745790557782,MMW 12R,A02,892725,Herbst; Matthew,0,9,16,16
1745790558809,MMW 13R,A01,892727,Staff,0,4,16,16
1745790558809,MMW 13R,A02,892728,Staff,0,4,16,16
1745790558809,MMW 13R,A03,958032,Staff,0,3,16,16
1745790558809,MMW 13R,A04,958033,Staff,0,2,16,16
1745790558809,MMW 13R,A05,958034,Staff,0,3,16,16
1745790559838,SIO 295LS,A00,894015,Staff,7,0,25,18
1745790560867,SIO 295S,A00,894020,Staff,7,0,25,18
1745790561895,SIOC 290S,B01,958918,Staff,0,0,0,0
1745790562921,SIOC 291S,B01,958922,Staff,0,0,0,0
1745790563946,SOCI 117,A01,895339,Staff,4,0,5,1
1745790564971,WES 237B,A00,894149,Staff,11,0,20,9
1745790567039,AESE 279B,A00,891859,Staff,13,0,35,22
1745790568063,AIP 197,001,891854,Staff,70,0,70,0
1745790569092,ANTH 289S,A00,891856,Gagneux; Pascal,12,0,12,0
1745790570121,BENG 196,001,957946,Engler; Adam J.,9996,0,9999,3
1745790571149,CAT 124RS,A01,956906,Staff,8,0,25,17
1745790572175,CAT 125RS,A01,922013,Staff,8,0,25,17
1745790573201,CLRE 250,A00,891860,Morris; Sheldon,9995,0,9999,4
1745790575252,CLRE 251R,A00,907817,Mehta; Ravindra L.,9994,0,9999,5
1745790576279,CLRE 252,A00,891864,Cuomo; Raphael Eduardo,9993,0,9999,6
1745790577304,CLRE 253,A00,891867,Vaida; Florin,9994,0,9999,5
1745790577304,CLRE 253,B00,907819,Staff,9999,0,9999,0
1745790578331,CLRE 259,A00,891868,Patel; Hemal,9998,0,9999,1
1745790579361,CLRE 260,A00,891872,Cuomo; Raphael Eduardo,9999,0,9999,0
1745790580389,CLRE 297,001,891888,Cuomo; Raphael Eduardo,9999,0,9999,0
1745790581414,CSE 191,A00,958773,Minnes Kemp; Mor Mia,9999,0,9999,0
1745790582445,CSS 201S,A01,892054,Mignozzetti; Umberto,30,0,30,0
1745790583475,CSS 202S,A01,892056,Mignozzetti; Umberto,30,0,30,0
1745790584501,DSC 197,001,956898,Eldridge; Justin Matthew,9998,0,9999,1
1745790585530,DSC 297,001,958000,Mazumdar; Arya,9998,0,9999,1
1745790586555,EAP 100,A00,905686,Staff,9776,0,9999,223
1745790587581,ECE 45,A01,892618,Staff,0,12,50,50
1745790588607,ECE 109,A01,892620,Staff,0,43,0,0
1745790589634,ECE 111,A01,892719,Staff,0,7,50,50
1745790590659,ECE 197,001,957920,Mercier; Patrick Philip,9992,0,9999,7
1745790591689,ECON 178,A01,907814,Zhu; Ying,28,0,35,7
1745790592713,EDS 115,A00,895312,Staff,41,0,45,4
1745790593739,EDS 117,A01,895337,Staff,30,0,30,0
1745790594766,EDS 125,A00,895341,Jones; Gabrielle Anastasia,43,0,45,2
1745790595792,EDS 128A,A01,895459,Fargason; Sharon Gayle,44,0,45,1
1745790596819,EDS 128B,A01,895543,Pappas; Elizabeth,44,0,45,1
1745790597847,EDS 139,A00,897203,Pappas; Elizabeth,44,0,45,1
1745790597847,EDS 139,B00,897209,Fargason; Sharon Gayle,44,0,45,1
1745790598879,EDS 201,A00,895545,Staff,43,0,45,2
1745790599905,EDS 203,A01,895581,Halter; Christopher P.,43,0,45,2
1745790600935,EDS 204R,A01,895625,Heinzman; Erica M.,43,0,45,2
1745790600935,EDS 204R,B01,895693,Halter; Christopher P.,18,0,45,27
1745790601964,EDS 206R,A00,895694,Fargason; Sharon Gayle,9,0,30,21
1745790601964,EDS 206R,B00,895695,Choi; Bailey Miyeon,20,0,30,10
1745790602992,EDS 250,A00,895697,Hemans; Patricia Ann Benitez,43,0,45,2
1745790604018,EDS 281,A00,895701,Meyerott; Theresa Ann,15,0,15,0
1745790605046,EDS 284,A00,895736,Meyerott; Theresa Ann,15,0,15,0
1745790606074,EDS 286,A00,897210,Fine; Sarah,15,0,15,0
1745790607102,EDS 289C,A01,895770,Daly; Alan J.,15,0,15,0
1745790608128,EDS 290,A00,897211,Hofstetter; Carolyn,15,0,15,0
1745790609156,LIGM 5A,A00,896162,Fischer-Grunski; Eva K,15,0,20,5
1745790610185,LIGM 5B,A00,896260,Fischer-Grunski; Eva K,17,0,20,3
1745790611215,LIGM 5C,A00,896308,Fischer-Grunski; Eva K,18,0,20,2
1745790612244,LIIT 5AS,A00,896313,Carnelos; Chiara,18,0,20,2
1745790613272,LIIT 5BS,A00,896416,Carnelos; Chiara,20,0,20,0
1745790614298,LIIT 5CS,A00,896564,Carnelos; Chiara,20,0,20,0
1745790615328,LISP 5A,A00,896588,Munoz Sanchez; Alicia,4,0,20,16
1745790616352,LISP 5B,A00,896653,Munoz Sanchez; Alicia,10,0,20,10
1745790617383,LISP 5C,A00,896655,Munoz Sanchez; Alicia,4,0,20,16
1745790618409,MAE 197,001,957918,Kleissl; Jan,9998,0,9999,1
1745790619436,MATH 2,A01,957937,Staff,34,0,35,1
1745790620462,MATH 197,001,957876,Kedlaya; Kiran S.,9993,0,9999,6
1745790621491,MCWP 40,A00,892729,Duru; Nur,13,0,20,7
1745790621491,MCWP 40,B00,893304,Montejo; Carolina,20,0,20,0
1745790622520,MCWP 40R,A00,893757,Redela; Pamela Morgan,0,6,20,20
1745790623550,MCWP 50,A00,893758,Morshed; Michael James,2,0,20,18
1745790623550,MCWP 50,B00,893761,Bartulis; Jason Michael,17,0,20,3
1745790624580,MCWP 50R,A00,893766,Compas; Sean Matthew,0,1,20,20
1745790624580,MCWP 50R,B00,893769,Carter; Jennifer A,0,0,20,20
1745790624580,MCWP 50R,C00,893771,Krone; Jarret,0,3,20,20
1745790624580,MCWP 50R,D00,893772,Miller; Elizabeth Deen,3,0,20,17
1745790624580,MCWP 50R,E00,893775,Carter; Andrea L,0,0,20,20
1745790625605,MMW 11R,A01,892721,Herbst; Matthew,11,0,27,16
1745790625605,MMW 11R,A02,892722,Herbst; Matthew,0,0,0,3
1745790626632,MMW 12R,A01,892724,Herbst; Matthew,0,9,16,16
1745790626632,MMW 12R,A02,892725,Herbst; Matthew,0,9,16,16
1745790627661,MMW 13R,A01,892727,Staff,0,4,16,16
1745790627661,MMW 13R,A02,892728,Staff,0,4,16,16
1745790627661,MMW 13R,A03,958032,Staff,0,3,16,16
1745790627661,MMW 13R,A04,958033,Staff,0,2,16,16
1745790627661,MMW 13R,A05,958034,Staff,0,3,16,16
1745790628687,SIO 295LS,A00,894015,Staff,7,0,25,18
1745790629713,SIO 295S,A00,894020,Staff,7,0,25,18
1745790630740,SIOC 290S,B01,958918,Staff,0,0,0,0
1745790631765,SIOC 291S,B01,958922,Staff,0,0,0,0
1745790632789,SOCI 117,A01,895339,Staff,4,0,5,1
1745790633814,WES 237B,A00,894149,Staff,11,0,20,9
1745790635877,AESE 279B,A00,891859,Staff,13,0,35,22
1745790636906,AIP 197,001,891854,Staff,70,0,70,0
1745790637931,ANTH 289S,A00,891856,Gagneux; Pascal,12,0,12,0
1745790638955,BENG 196,001,957946,Engler; Adam J.,9996,0,9999,3
1745790639981,CAT 124RS,A01,956906,Staff,8,0,25,17
1745790641008,CAT 125RS,A01,922013,Staff,8,0,25,17
1745790642034,CLRE 250,A00,891860,Morris; Sheldon,9995,0,9999,4
1745790644088,CLRE 251R,A00,907817,Mehta; Ravindra L.,9994,0,9999,5
1745790645117,CLRE 252,A00,891864,Cuomo; Raphael Eduardo,9993,0,9999,6
1745790646143,CLRE 253,A00,891867,Vaida; Florin,9994,0,9999,5
1745790646143,CLRE 253,B00,907819,Staff,9999,0,9999,0
1745790647169,CLRE 259,A00,891868,Patel; Hemal,9998,0,9999,1
1745790648194,CLRE 260,A00,891872,Cuomo; Raphael Eduardo,9999,0,9999,0
1745790649220,CLRE 297,001,891888,Cuomo; Raphael Eduardo,9999,0,9999,0
1745790650247,CSE 191,A00,958773,Minnes Kemp; Mor Mia,9999,0,9999,0
1745790651273,CSS 201S,A01,892054,Mignozzetti; Umberto,30,0,30,0
1745790652300,CSS 202S,A01,892056,Mignozzetti; Umberto,30,0,30,0
1745790653328,DSC 197,001,956898,Eldridge; Justin Matthew,9998,0,9999,1
1745790654355,DSC 297,001,958000,Mazumdar; Arya,9998,0,9999,1
1745790655382,EAP 100,A00,905686,Staff,9776,0,9999,223
1745790656410,ECE 45,A01,892618,Staff,0,12,50,50
1745790657437,ECE 109,A01,892620,Staff,0,43,0,0
1745790658463,ECE 111,A01,892719,Staff,0,7,50,50
1745790659488,ECE 197,001,957920,Mercier; Patrick Philip,9992,0,9999,7
1745790660515,ECON 178,A01,907814,Zhu; Ying,28,0,35,7
1745790661543,EDS 115,A00,895312,Staff,41,0,45,4
1745790662569,EDS 117,A01,895337,Staff,30,0,30,0
1745790663596,EDS 125,A00,895341,Jones; Gabrielle Anastasia,43,0,45,2
1745790664623,EDS 128A,A01,895459,Fargason; Sharon Gayle,44,0,45,1
1745790665649,EDS 128B,A01,895543,Pappas; Elizabeth,44,0,45,1
1745790666676,EDS 139,A00,897203,Pappas; Elizabeth,44,0,45,1
1745790666676,EDS 139,B00,897209,Fargason; Sharon Gayle,44,0,45,1
1745790667701,EDS 201,A00,895545,Staff,43,0,45,2
1745790668727,EDS 203,A01,895581,Halter; Christopher P.,43,0,45,2
1745790669757,EDS 204R,A01,895625,Heinzman; Erica M.,43,0,45,2
1745790669757,EDS 204R,B01,895693,Halter; Christopher P.,18,0,45,27
1745790670783,EDS 206R,A00,895694,Fargason; Sharon Gayle,9,0,30,21
1745790670783,EDS 206R,B00,895695,Choi; Bailey Miyeon,20,0,30,10
1745790671810,EDS 250,A00,895697,Hemans; Patricia Ann Benitez,43,0,45,2
1745790672838,EDS 281,A00,895701,Meyerott; Theresa Ann,15,0,15,0
1745790673864,EDS 284,A00,895736,Meyerott; Theresa Ann,15,0,15,0
1745790674890,EDS 286,A00,897210,Fine; Sarah,15,0,15,0
1745790675916,EDS 289C,A01,895770,Daly; Alan J.,15,0,15,0
1745790676940,EDS 290,A00,897211,Hofstetter; Carolyn,15,0,15,0
1745790677966,LIGM 5A,A00,896162,Fischer-Grunski; Eva K,15,0,20,5
1745790678994,LIGM 5B,A00,896260,Fischer-Grunski; Eva K,17,0,20,3
1745790680021,LIGM 5C,A00,896308,Fischer-Grunski; Eva K,18,0,20,2
1745790681050,LIIT 5AS,A00,896313,Carnelos; Chiara,18,0,20,2
1745790682077,LIIT 5BS,A00,896416,Carnelos; Chiara,20,0,20,0
1745790683107,LIIT 5CS,A00,896564,Carnelos; Chiara,20,0,20,0
1745790684138,LISP 5A,A00,896588,Munoz Sanchez; Alicia,4,0,20,16
1745790685167,LISP 5B,A00,896653,Munoz Sanchez; Alicia,10,0,20,10
1745790686194,LISP 5C,A00,896655,Munoz Sanchez; Alicia,4,0,20,16
1745790687221,MAE 197,001,957918,Kleissl; Jan,9998,0,9999,1
1745790688248,MATH 2,A01,957937,Staff,34,0,35,1
1745790689279,MATH 197,001,957876,Kedlaya; Kiran S.,9993,0,9999,6
1745790690305,MCWP 40,A00,892729,Duru; Nur,13,0,20,7
1745790690305,MCWP 40,B00,893304,Montejo; Carolina,20,0,20,0
1745790691332,MCWP 40R,A00,893757,Redela; Pamela Morgan,0,6,20,20
1745790692357,MCWP 50,A00,893758,Morshed; Michael James,2,0,20,18
1745790692357,MCWP 50,B00,893761,Bartulis; Jason Michael,17,0,20,3
1745790693383,MCWP 50R,A00,893766,Compas; Sean Matthew,0,1,20,20
1745790693383,MCWP 50R,B00,893769,Carter; Jennifer A,0,0,20,20
1745790693383,MCWP 50R,C00,893771,Krone; Jarret,0,3,20,20
1745790693383,MCWP 50R,D00,893772,Miller; Elizabeth Deen,3,0,20,17
1745790693383,MCWP 50R,E00,893775,Carter; Andrea L,0,0,20,20
1745790694411,MMW 11R,A01,892721,Herbst; Matthew,11,0,27,16
1745790694411,MMW 11R,A02,892722,Herbst; Matthew,0,0,0,3
1745790695439,MMW 12R,A01,892724,Herbst; Matthew,0,9,16,16
1745790695439,MMW 12R,A02,892725,Herbst; Matthew,0,9,16,16
1745790696464,MMW 13R,A01,892727,Staff,0,4,16,16
1745790696464,MMW 13R,A02,892728,Staff,0,4,16,16
1745790696464,MMW 13R,A03,958032,Staff,0,3,16,16
1745790696464,MMW 13R,A04,958033,Staff,0,2,16,16
1745790696464,MMW 13R,A05,958034,Staff,0,3,16,16
1745790697492,SIO 295LS,A00,894015,Staff,7,0,25,18
1745790698517,SIO 295S,A00,894020,Staff,7,0,25,18
1745790699542,SIOC 290S,B01,958918,Staff,0,0,0,0
1745790700569,SIOC 291S,B01,958922,Staff,0,0,0,0
1745790701593,SOCI 117,A01,895339,Staff,4,0,5,1
1745790702657,WES 237B,A00,894149,Staff,11,0,20,9
1745790704720,AESE 279B,A00,891859,Staff,13,0,35,22
1745790705746,AIP 197,001,891854,Staff,70,0,70,0
1745790706773,ANTH 289S,A00,891856,Gagneux; Pascal,12,0,12,0
1745790707797,BENG 196,001,957946,Engler; Adam J.,9996,0,9999,3
1745790708824,CAT 124RS,A01,956906,Staff,8,0,25,17
1745790709852,CAT 125RS,A01,922013,Staff,8,0,25,17
1745790710880,CLRE 250,A00,891860,Morris; Sheldon,9995,0,9999,4
1745790712933,CLRE 251R,A00,907817,Mehta; Ravindra L.,9994,0,9999,5
1745790713960,CLRE 252,A00,891864,Cuomo; Raphael Eduardo,9993,0,9999,6
1745790714987,CLRE 253,A00,891867,Vaida; Florin,9994,0,9999,5
1745790714987,CLRE 253,B00,907819,Staff,9999,0,9999,0
1745790716012,CLRE 259,A00,891868,Patel; Hemal,9998,0,9999,1
1745790717036,CLRE 260,A00,891872,Cuomo; Raphael Eduardo,9999,0,9999,0
1745790718061,CLRE 297,001,891888,Cuomo; Raphael Eduardo,9999,0,9999,0
1745790719090,CSE 191,A00,958773,Minnes Kemp; Mor Mia,9999,0,9999,0
1745790720117,CSS 201S,A01,892054,Mignozzetti; Umberto,30,0,30,0
1745790721143,CSS 202S,A01,892056,Mignozzetti; Umberto,30,0,30,0
1745790722172,DSC 197,001,956898,Eldridge; Justin Matthew,9998,0,9999,1
1745790723198,DSC 297,001,958000,Mazumdar; Arya,9998,0,9999,1
1745790724225,EAP 100,A00,905686,Staff,9776,0,9999,223
1745790725252,ECE 45,A01,892618,Staff,0,12,50,50
1745790726277,ECE 109,A01,892620,Staff,0,43,0,0
1745790727303,ECE 111,A01,892719,Staff,0,7,50,50
1745790728330,ECE 197,001,957920,Mercier; Patrick Philip,9992,0,9999,7
1745790729356,ECON 178,A01,907814,Zhu; Ying,28,0,35,7
1745790730381,EDS 115,A00,895312,Staff,41,0,45,4
1745790731406,EDS 117,A01,895337,Staff,30,0,30,0
1745790732433,EDS 125,A00,895341,Jones; Gabrielle Anastasia,43,0,45,2
1745790733459,EDS 128A,A01,895459,Fargason; Sharon Gayle,44,0,45,1
1745790734484,EDS 128B,A01,895543,Pappas; Elizabeth,44,0,45,1
1745790735509,EDS 139,A00,897203,Pappas; Elizabeth,44,0,45,1
1745790735509,EDS 139,B00,897209,Fargason; Sharon Gayle,44,0,45,1
1745790736539,EDS 201,A00,895545,Staff,43,0,45,2
1745790737566,EDS 203,A01,895581,Halter; Christopher P.,43,0,45,2
1745790738593,EDS 204R,A01,895625,Heinzman; Erica M.,43,0,45,2
1745790738593,EDS 204R,B01,895693,Halter; Christopher P.,18,0,45,27
1745790739619,EDS 206R,A00,895694,Fargason; Sharon Gayle,9,0,30,21
1745790739619,EDS 206R,B00,895695,Choi; Bailey Miyeon,20,0,30,10
1745790740646,EDS 250,A00,895697,Hemans; Patricia Ann Benitez,43,0,45,2
1745790741672,EDS 281,A00,895701,Meyerott; Theresa Ann,15,0,15,0
1745790742702,EDS 284,A00,895736,Meyerott; Theresa Ann,15,0,15,0
1745790743727,EDS 286,A00,897210,Fine; Sarah,15,0,15,0
1745790744753,EDS 289C,A01,895770,Daly; Alan J.,15,0,15,0
1745790745782,EDS 290,A00,897211,Hofstetter; Carolyn,15,0,15,0
1745790746809,LIGM 5A,A00,896162,Fischer-Grunski; Eva K,15,0,20,5
1745790747837,LIGM 5B,A00,896260,Fischer-Grunski; Eva K,17,0,20,3
1745790748863,LIGM 5C,A00,896308,Fischer-Grunski; Eva K,18,0,20,2
1745790749890,LIIT 5AS,A00,896313,Carnelos; Chiara,18,0,20,2
1745790750918,LIIT 5BS,A00,896416,Carnelos; Chiara,20,0,20,0
1745790751947,LIIT 5CS,A00,896564,Carnelos; Chiara,20,0,20,0
1745790752972,LISP 5A,A00,896588,Munoz Sanchez; Alicia,4,0,20,16
1745790754001,LISP 5B,A00,896653,Munoz Sanchez; Alicia,10,0,20,10
1745790755027,LISP 5C,A00,896655,Munoz Sanchez; Alicia,4,0,20,16
1745790756053,MAE 197,001,957918,Kleissl; Jan,9998,0,9999,1
1745790757080,MATH 2,A01,957937,Staff,34,0,35,1
1745790758105,MATH 197,001,957876,Kedlaya; Kiran S.,9993,0,9999,6
1745790759130,MCWP 40,A00,892729,Duru; Nur,13,0,20,7
1745790759130,MCWP 40,B00,893304,Montejo; Carolina,20,0,20,0
1745790760156,MCWP 40R,A00,893757,Redela; Pamela Morgan,0,6,20,20
1745790761184,MCWP 50,A00,893758,Morshed; Michael James,2,0,20,18
1745790761184,MCWP 50,B00,893761,Bartulis; Jason Michael,17,0,20,3
1745790762211,MCWP 50R,A00,893766,Compas; Sean Matthew,0,1,20,20
1745790762211,MCWP 50R,B00,893769,Carter; Jennifer A,0,0,20,20
1745790762211,MCWP 50R,C00,893771,Krone; Jarret,0,3,20,20
1745790762211,MCWP 50R,D00,893772,Miller; Elizabeth Deen,3,0,20,17
1745790762211,MCWP 50R,E00,893775,Carter; Andrea L,0,0,20,20
1745790763235,MMW 11R,A01,892721,Herbst; Matthew,11,0,27,16
1745790763235,MMW 11R,A02,892722,Herbst; Matthew,0,0,0,3
1745790764263,MMW 12R,A01,892724,Herbst; Matthew,0,9,16,16
1745790764263,MMW 12R,A02,892725,Herbst; Matthew,0,9,16,16
1745790765291,MMW 13R,A01,892727,Staff,0,4,16,16
1745790765291,MMW 13R,A02,892728,Staff,0,4,16,16
1745790765291,MMW 13R,A03,958032,Staff,0,3,16,16
1745790765291,MMW 13R,A04,958033,Staff,0,2,16,16
1745790765291,MMW 13R,A05,958034,Staff,0,3,16,16
1745790766317,SIO 295LS,A00,894015,Staff,7,0,25,18
1745790767344,SIO 295S,A00,894020,Staff,7,0,25,18
1745790768373,SIOC 290S,B01,958918,Staff,0,0,0,0
1745790769400,SIOC 291S,B01,958922,Staff,0,0,0,0
1745790770426,SOCI 117,A01,895339,Staff,4,0,5,1
1745790771452,WES 237B,A00,894149,Staff,11,0,20,9
1745790773516,AESE 279B,A00,891859,Staff,13,0,35,22
1745790774545,AIP 197,001,891854,Staff,70,0,70,0
1745790775570,ANTH 289S,A00,891856,Gagneux; Pascal,12,0,12,0
1745790776595,BENG 196,001,957946,Engler; Adam J.,9996,0,9999,3
1745790777620,CAT 124RS,A01,956906,Staff,8,0,25,17
1745790778644,CAT 125RS,A01,922013,Staff,8,0,25,17
1745790779670,CLRE 250,A00,891860,Morris; Sheldon,9995,0,9999,4
1745790781721,CLRE 251R,A00,907817,Mehta; Ravindra L.,9994,0,9999,5
1745790782747,CLRE 252,A00,891864,Cuomo; Raphael Eduardo,9993,0,9999,6
1745790783772,CLRE 253,A00,891867,Vaida; Florin,9994,0,9999,5
1745790783772,CLRE 253,B00,907819,Staff,9999,0,9999,0
1745790784798,CLRE 259,A00,891868,Patel; Hemal,9998,0,9999,1
1745790785825,CLRE 260,A00,891872,Cuomo; Raphael Eduardo,9999,0,9999,0
1745790786851,CLRE 297,001,891888,Cuomo; Raphael Eduardo,9999,0,9999,0
1745790787879,CSE 191,A00,958773,Minnes Kemp; Mor Mia,9999,0,9999,0
1745790788905,CSS 201S,A01,892054,Mignozzetti; Umberto,30,0,30,0
1745790789930,CSS 202S,A01,892056,Mignozzetti; Umberto,30,0,30,0
1745790790957,DSC 197,001,956898,Eldridge; Justin Matthew,9998,0,9999,1
1745790791986,DSC 297,001,958000,Mazumdar; Arya,9998,0,9999,1
1745790793012,EAP 100,A00,905686,Staff,9776,0,9999,223
1745790794041,ECE 45,A01,892618,Staff,0,12,50,50
1745790795067,ECE 109,A01,892620,Staff,0,43,0,0
1745790796094,ECE 111,A01,892719,Staff,0,7,50,50
1745790797120,ECE 197,001,957920,Mercier; Patrick Philip,9992,0,9999,7
1745790798146,ECON 178,A01,907814,Zhu; Ying,28,0,35,7
1745790799172,EDS 115,A00,895312,Staff,41,0,45,4
1745790800198,EDS 117,A01,895337,Staff,30,0,30,0
1745790801224,EDS 125,A00,895341,Jones; Gabrielle Anastasia,43,0,45,2
1745790802253,EDS 128A,A01,895459,Fargason; Sharon Gayle,44,0,45,1
1745790803278,EDS 128B,A01,895543,Pappas; Elizabeth,44,0,45,1
1745790804305,EDS 139,A00,897203,Pappas; Elizabeth,44,0,45,1
1745790804305,EDS 139,B00,897209,Fargason; Sharon Gayle,44,0,45,1
1745790805333,EDS 201,A00,895545,Staff,43,0,45,2
1745790806361,EDS 203,A01,895581,Halter; Christopher P.,43,0,45,2
1745790807387,EDS 204R,A01,895625,Heinzman; Erica M.,43,0,45,2
1745790807387,EDS 204R,B01,895693,Halter; Christopher P.,18,0,45,27
1745790808413,EDS 206R,A00,895694,Fargason; Sharon Gayle,9,0,30,21
1745790808413,EDS 206R,B00,895695,Choi; Bailey Miyeon,20,0,30,10
1745790809442,EDS 250,A00,895697,Hemans; Patricia Ann Benitez,43,0,45,2
1745790810468,EDS 281,A00,895701,Meyerott; Theresa Ann,15,0,15,0
1745790811497,EDS 284,A00,895736,Meyerott; Theresa Ann,15,0,15,0
1745790812523,EDS 286,A00,897210,Fine; Sarah,15,0,15,0
1745790813550,EDS 289C,A01,895770,Daly; Alan J.,15,0,15,0
1745790814575,EDS 290,A00,897211,Hofstetter; Carolyn,15,0,15,0
1745790815605,LIGM 5A,A00,896162,Fischer-Grunski; Eva K,15,0,20,5
1745790816631,LIGM 5B,A00,896260,Fischer-Grunski; Eva K,17,0,20,3
1745790817658,LIGM 5C,A00,896308,Fischer-Grunski; Eva K,18,0,20,2
1745790818683,LIIT 5AS,A00,896313,Carnelos; Chiara,18,0,20,2
1745790819709,LIIT 5BS,A00,896416,Carnelos; Chiara,20,0,20,0
1745790820737,LIIT 5CS,A00,896564,Carnelos; Chiara,20,0,20,0
1745790821767,LISP 5A,A00,896588,Munoz Sanchez; Alicia,4,0,20,16
1745790822795,LISP 5B,A00,896653,Munoz Sanchez; Alicia,10,0,20,10
1745790823825,LISP 5C,A00,896655,Munoz Sanchez; Alicia,4,0,20,16
1745790824851,MAE 197,001,957918,Kleissl; Jan,9998,0,9999,1
1745790825880,MATH 2,A01,957937,Staff,34,0,35,1
1745790826908,MATH 197,001,957876,Kedlaya; Kiran S.,9993,0,9999,6
1745790827937,MCWP 40,A00,892729,Duru; Nur,13,0,20,7
1745790827937,MCWP 40,B00,893304,Montejo; Carolina,20,0,20,0
1745790828965,MCWP 40R,A00,893757,Redela; Pamela Morgan,0,6,20,20
1745790829990,MCWP 50,A00,893758,Morshed; Michael James,2,0,20,18
1745790829990,MCWP 50,B00,893761,Bartulis; Jason Michael,17,0,20,3
1745790831016,MCWP 50R,A00,893766,Compas; Sean Matthew,0,1,20,20
1745790831016,MCWP 50R,B00,893769,Carter; Jennifer A,0,0,20,20
1745790831016,MCWP 50R,C00,893771,Krone; Jarret,0,3,20,20
1745790831016,MCWP 50R,D00,893772,Miller; Elizabeth Deen,3,0,20,17
1745790831016,MCWP 50R,E00,893775,Carter; Andrea L,0,0,20,20
1745790832043,MMW 11R,A01,892721,Herbst; Matthew,11,0,27,16
1745790832043,MMW 11R,A02,892722,Herbst; Matthew,0,0,0,3
1745790833073,MMW 12R,A01,892724,Herbst; Matthew,0,9,16,16
1745790833073,MMW 12R,A02,892725,Herbst; Matthew,0,9,16,16
1745790834102,MMW 13R,A01,892727,Staff,0,4,16,16
1745790834102,MMW 13R,A02,892728,Staff,0,4,16,16
1745790834102,MMW 13R,A03,958032,Staff,0,3,16,16
1745790834102,MMW 13R,A04,958033,Staff,0,2,16,16
1745790834102,MMW 13R,A05,958034,Staff,0,3,16,16
1745790835127,SIO 295LS,A00,894015,Staff,7,0,25,18
1745790836152,SIO 295S,A00,894020,Staff,7,0,25,18
1745790837182,SIOC 290S,B01,958918,Staff,0,0,0,0
1745790838209,SIOC 291S,B01,958922,Staff,0,0,0,0
1745790839235,SOCI 117,A01,895339,Staff,4,0,5,1
1745790840261,WES 237B,A00,894149,Staff,11,0,20,9
1745790842329,AESE 279B,A00,891859,Staff,13,0,35,22
1745790843356,AIP 197,001,891854,Staff,70,0,70,0
1745790844384,ANTH 289S,A00,891856,Gagneux; Pascal,12,0,12,0
1745790845411,BENG 196,001,957946,Engler; Adam J.,9996,0,9999,3
1745790846435,CAT 124RS,A01,956906,Staff,8,0,25,17
1745790847460,CAT 125RS,A01,922013,Staff,8,0,25,17
1745790848485,CLRE 250,A00,891860,Morris; Sheldon,9995,0,9999,4
1745790850536,CLRE 251R,A00,907817,Mehta; Ravindra L.,9994,0,9999,5
1745790851565,CLRE 252,A00,891864,Cuomo; Raphael Eduardo,9993,0,9999,6
1745790852594,CLRE 253,A00,891867,Vaida; Florin,9994,0,9999,5
1745790852594,CLRE 253,B00,907819,Staff,9999,0,9999,0
1745790853624,CLRE 259,A00,891868,Patel; Hemal,9998,0,9999,1
1745790854649,CLRE 260,A00,891872,Cuomo; Raphael Eduardo,9999,0,9999,0
1745790855674,CLRE 297,001,891888,Cuomo; Raphael Eduardo,9999,0,9999,0
1745790856701,CSE 191,A00,958773,Minnes Kemp; Mor Mia,9999,0,9999,0
1745790857727,CSS 201S,A01,892054,Mignozzetti; Umberto,30,0,30,0
1745790858753,CSS 202S,A01,892056,Mignozzetti; Umberto,30,0,30,0
1745790859781,DSC 197,001,956898,Eldridge; Justin Matthew,9998,0,9999,1
1745790860810,DSC 297,001,958000,Mazumdar; Arya,9998,0,9999,1
1745790861835,EAP 100,A00,905686,Staff,9776,0,9999,223
1745790862865,ECE 45,A01,892618,Staff,0,12,50,50
1745790863891,ECE 109,A01,892620,Staff,0,43,0,0
1745790864916,ECE 111,A01,892719,Staff,0,7,50,50
1745790865943,ECE 197,001,957920,Mercier; Patrick Philip,9992,0,9999,7
1745790866967,ECON 178,A01,907814,Zhu; Ying,28,0,35,7
1745790867993,EDS 115,A00,895312,Staff,41,0,45,4
1745790869019,EDS 117,A01,895337,Staff,30,0,30,0
1745790870048,EDS 125,A00,895341,Jones; Gabrielle Anastasia,43,0,45,2
1745790871077,EDS 128A,A01,895459,Fargason; Sharon Gayle,44,0,45,1
1745790872104,EDS 128B,A01,895543,Pappas; Elizabeth,44,0,45,1
1745790873132,EDS 139,A00,897203,Pappas; Elizabeth,44,0,45,1
1745790873132,EDS 139,B00,897209,Fargason; Sharon Gayle,44,0,45,1
1745790874156,EDS 201,A00,895545,Staff,43,0,45,2
1745790875183,EDS 203,A01,895581,Halter; Christopher P.,43,0,45,2
1745790876211,EDS 204R,A01,895625,Heinzman; Erica M.,43,0,45,2
1745790876211,EDS 204R,B01,895693,Halter; Christopher P.,18,0,45,27
1745790877235,EDS 206R,A00,895694,Fargason; Sharon Gayle,9,0,30,21
1745790877235,EDS 206R,B00,895695,Choi; Bailey Miyeon,20,0,30,10
1745790878261,EDS 250,A00,895697,Hemans; Patricia Ann Benitez,43,0,45,2
1745790879286,EDS 281,A00,895701,Meyerott; Theresa Ann,15,0,15,0
1745790880312,EDS 284,A00,895736,Meyerott; Theresa Ann,15,0,15,0
1745790881340,EDS 286,A00,897210,Fine; Sarah,15,0,15,0
1745790882369,EDS 289C,A01,895770,Daly; Alan J.,15,0,15,0
1745790883393,EDS 290,A00,897211,Hofstetter; Carolyn,15,0,15,0
1745790884423,LIGM 5A,A00,896162,Fischer-Grunski; Eva K,15,0,20,5
1745790885448,LIGM 5B,A00,896260,Fischer-Grunski; Eva K,17,0,20,3
1745790886475,LIGM 5C,A00,896308,Fischer-Grunski; Eva K,18,0,20,2
1745790887500,LIIT 5AS,A00,896313,Carnelos; Chiara,18,0,20,2
1745790888525,LIIT 5BS,A00,896416,Carnelos; Chiara,20,0,20,0
1745790889549,LIIT 5CS,A00,896564,Carnelos; Chiara,20,0,20,0
1745790890578,LISP 5A,A00,896588,Munoz Sanchez; Alicia,4,0,20,16
1745790891605,LISP 5B,A00,896653,Munoz Sanchez; Alicia,10,0,20,10
1745790892631,LISP 5C,A00,896655,Munoz Sanchez; Alicia,4,0,20,16
1745790893660,MAE 197,001,957918,Kleissl; Jan,9998,0,9999,1
1745790894686,MATH 2,A01,957937,Staff,34,0,35,1
1745790895712,MATH 197,001,957876,Kedlaya; Kiran S.,9993,0,9999,6
1745790896739,MCWP 40,A00,892729,Duru; Nur,13,0,20,7
1745790896739,MCWP 40,B00,893304,Montejo; Carolina,20,0,20,0
1745790897764,MCWP 40R,A00,893757,Redela; Pamela Morgan,0,6,20,20
1745790898791,MCWP 50,A00,893758,Morshed; Michael James,2,0,20,18
1745790898791,MCWP 50,B00,893761,Bartulis; Jason Michael,17,0,20,3
1745790899819,MCWP 50R,A00,893766,Compas; Sean Matthew,0,1,20,20
1745790899819,MCWP 50R,B00,893769,Carter; Jennifer A,0,0,20,20
1745790899819,MCWP 50R,C00,893771,Krone; Jarret,0,3,20,20
1745790899819,MCWP 50R,D00,893772,Miller; Elizabeth Deen,3,0,20,17
1745790899819,MCWP 50R,E00,893775,Carter; Andrea L,0,0,20,20
1745790900845,MMW 11R,A01,892721,Herbst; Matthew,11,0,27,16
1745790900845,MMW 11R,A02,892722,Herbst; Matthew,0,0,0,3
1745790901876,MMW 12R,A01,892724,Herbst; Matthew,0,9,16,16
1745790901876,MMW 12R,A02,892725,Herbst; Matthew,0,9,16,16
1745790902902,MMW 13R,A01,892727,Staff,0,4,16,16
1745790902902,MMW 13R,A02,892728,Staff,0,4,16,16
1745790902902,MMW 13R,A03,958032,Staff,0,3,16,16
1745790902902,MMW 13R,A04,958033,Staff,0,2,16,16
1745790902902,MMW 13R,A05,958034,Staff,0,3,16,16
1745790903931,SIO 295LS,A00,894015,Staff,7,0,25,18
1745790904961,SIO 295S,A00,894020,Staff,7,0,25,18
1745790905992,SIOC 290S,B01,958918,Staff,0,0,0,0
1745790907021,SIOC 291S,B01,958922,Staff,0,0,0,0
1745790908049,SOCI 117,A01,895339,Staff,4,0,5,1
1745790909076,WES 237B,A00,894149,Staff,11,0,20,9
1745790911141,AESE 279B,A00,891859,Staff,13,0,35,22
1745790912167,AIP 197,001,891854,Staff,70,0,70,0
1745790913195,ANTH 289S,A00,891856,Gagneux; Pascal,12,0,12,0
1745790914221,BENG 196,001,957946,Engler; Adam J.,9996,0,9999,3
1745790915246,CAT 124RS,A01,956906,Staff,8,0,25,17
1745790916272,CAT 125RS,A01,922013,Staff,8,0,25,17
1745790917299,CLRE 250,A00,891860,Morris; Sheldon,9995,0,9999,4
1745790919352,CLRE 251R,A00,907817,Mehta; Ravindra L.,9994,0,9999,5
1745790920377,CLRE 252,A00,891864,Cuomo; Raphael Eduardo,9993,0,9999,6
1745790921403,CLRE 253,A00,891867,Vaida; Florin,9994,0,9999,5
1745790921403,CLRE 253,B00,907819,Staff,9999,0,9999,0
1745790922447,CLRE 259,A00,891868,Patel; Hemal,9998,0,9999,1
1745790923473,CLRE 260,A00,891872,Cuomo; Raphael Eduardo,9999,0,9999,0
1745790924497,CLRE 297,001,891888,Cuomo; Raphael Eduardo,9999,0,9999,0
1745790925523,CSE 191,A00,958773,Minnes Kemp; Mor Mia,9999,0,9999,0
1745790926549,CSS 201S,A01,892054,Mignozzetti; Umberto,30,0,30,0
1745790927576,CSS 202S,A01,892056,Mignozzetti; Umberto,30,0,30,0
1745790928601,DSC 197,001,956898,Eldridge; Justin Matthew,9998,0,9999,1
1745790929628,DSC 297,001,958000,Mazumdar; Arya,9998,0,9999,1
1745790930652,EAP 100,A00,905686,Staff,9776,0,9999,223
1745790931679,ECE 45,A01,892618,Staff,0,12,50,50
1745790932702,ECE 109,A01,892620,Staff,0,43,0,0
1745790933730,ECE 111,A01,892719,Staff,0,7,50,50
1745790934757,ECE 197,001,957920,Mercier; Patrick Philip,9992,0,9999,7
1745790935784,ECON 178,A01,907814,Zhu; Ying,28,0,35,7
1745790936809,EDS 115,A00,895312,Staff,41,0,45,4
1745790937836,EDS 117,A01,895337,Staff,30,0,30,0
1745790938861,EDS 125,A00,895341,Jones; Gabrielle Anastasia,43,0,45,2
1745790939890,EDS 128A,A01,895459,Fargason; Sharon Gayle,44,0,45,1
1745790940915,EDS 128B,A01,895543,Pappas; Elizabeth,44,0,45,1
1745790941940,EDS 139,A00,897203,Pappas; Elizabeth,44,0,45,1
1745790941940,EDS 139,B00,897209,Fargason; Sharon Gayle,44,0,45,1
1745790942966,EDS 201,A00,895545,Staff,43,0,45,2
1745790943994,EDS 203,A01,895581,Halter; Christopher P.,43,0,45,2
1745790945023,EDS 204R,A01,895625,Heinzman; Erica M.,43,0,45,2
1745790945023,EDS 204R,B01,895693,Halter; Christopher P.,18,0,45,27
1745790946049,EDS 206R,A00,895694,Fargason; Sharon Gayle,9,0,30,21
1745790946049,EDS 206R,B00,895695,Choi; Bailey Miyeon,20,0,30,10
1745790947074,EDS 250,A00,895697,Hemans; Patricia Ann Benitez,43,0,45,2
1745790948102,EDS 281,A00,895701,Meyerott; Theresa Ann,15,0,15,0
1745790949127,EDS 284,A00,895736,Meyerott; Theresa Ann,15,0,15,0
1745790950152,EDS 286,A00,897210,Fine; Sarah,15,0,15,0
1745790951179,EDS 289C,A01,895770,Daly; Alan J.,15,0,15,0
1745790952207,EDS 290,A00,897211,Hofstetter; Carolyn,15,0,15,0
1745790953234,LIGM 5A,A00,896162,Fischer-Grunski; Eva K,15,0,20,5
1745790954259,LIGM 5B,A00,896260,Fischer-Grunski; Eva K,17,0,20,3
1745790955285,LIGM 5C,A00,896308,Fischer-Grunski; Eva K,18,0,20,2
1745790956314,LIIT 5AS,A00,896313,Carnelos; Chiara,18,0,20,2
1745790957342,LIIT 5BS,A00,896416,Carnelos; Chiara,20,0,20,0
1745790958372,LIIT 5CS,A00,896564,Carnelos; Chiara,20,0,20,0
1745790959402,LISP 5A,A00,896588,Munoz Sanchez; Alicia,4,0,20,16
1745790960428,LISP 5B,A00,896653,Munoz Sanchez; Alicia,10,0,20,10
1745790961457,LISP 5C,A00,896655,Munoz Sanchez; Alicia,4,0,20,16
1745790962486,MAE 197,001,957918,Kleissl; Jan,9998,0,9999,1
1745790963511,MATH 2,A01,957937,Staff,34,0,35,1
1745790964534,MATH 197,001,957876,Kedlaya; Kiran S.,9993,0,9999,6
1745790965564,MCWP 40,A00,892729,Duru; Nur,13,0,20,7
1745790965564,MCWP 40,B00,893304,Montejo; Carolina,20,0,20,0
1745790966589,MCWP 40R,A00,893757,Redela; Pamela Morgan,0,6,20,20
1745790967614,MCWP 50,A00,893758,Morshed; Michael James,2,0,20,18
1745790967614,MCWP 50,B00,893761,Bartulis; Jason Michael,17,0,20,3
1745790968641,MCWP 50R,A00,893766,Compas; Sean Matthew,0,1,20,20
1745790968641,MCWP 50R,B00,893769,Carter; Jennifer A,0,0,20,20
1745790968641,MCWP 50R,C00,893771,Krone; Jarret,0,3,20,20
1745790968641,MCWP 50R,D00,893772,Miller; Elizabeth Deen,3,0,20,17
1745790968641,MCWP 50R,E00,893775,Carter; Andrea L,0,0,20,20
1745790969667,MMW 11R,A01,892721,Herbst; Matthew,11,0,27,16
1745790969667,MMW 11R,A02,892722,Herbst; Matthew,0,0,0,3
1745790970691,MMW 12R,A01,892724,Herbst; Matthew,0,9,16,16
1745790970691,MMW 12R,A02,892725,Herbst; Matthew,0,9,16,16
1745790971716,MMW 13R,A01,892727,Staff,0,4,16,16
1745790971716,MMW 13R,A02,892728,Staff,0,4,16,16
1745790971716,MMW 13R,A03,958032,Staff,0,3,16,16
1745790971716,MMW 13R,A04,958033,Staff,0,2,16,16
1745790971716,MMW 13R,A05,958034,Staff,0,3,16,16
1745790972744,SIO 295LS,A00,894015,Staff,7,0,25,18
1745790973772,SIO 295S,A00,894020,Staff,7,0,25,18
1745790974798,SIOC 290S,B01,958918,Staff,0,0,0,0
1745790975824,SIOC 291S,B01,958922,Staff,0,0,0,0
1745790976850,SOCI 117,A01,895339,Staff,4,0,5,1
1745790977876,WES 237B,A00,894149,Staff,11,0,20,9
1745790979937,AESE 279B,A00,891859,Staff,13,0,35,22
1745790980963,AIP 197,001,891854,Staff,70,0,70,0
1745790981991,ANTH 289S,A00,891856,Gagneux; Pascal,12,0,12,0
1745790983020,BENG 196,001,957946,Engler; Adam J.,9996,0,9999,3
1745790984047,CAT 124RS,A01,956906,Staff,8,0,25,17
1745790985075,CAT 125RS,A01,922013,Staff,8,0,25,17
1745790986100,CLRE 250,A00,891860,Morris; Sheldon,9995,0,9999,4
1745790988154,CLRE 251R,A00,907817,Mehta; Ravindra L.,9994,0,9999,5
1745790989180,CLRE 252,A00,891864,Cuomo; Raphael Eduardo,9993,0,9999,6
1745790990206,CLRE 253,A00,891867,Vaida; Florin,9994,0,9999,5
1745790990206,CLRE 253,B00,907819,Staff,9999,0,9999,0
1745790991235,CLRE 259,A00,891868,Patel; Hemal,9998,0,9999,1
1745790992262,CLRE 260,A00,891872,Cuomo; Raphael Eduardo,9999,0,9999,0
1745790993287,CLRE 297,001,891888,Cuomo; Raphael Eduardo,9999,0,9999,0
1745790994314,CSE 191,A00,958773,Minnes Kemp; Mor Mia,9999,0,9999,0
1745790995346,CSS 201S,A01,892054,Mignozzetti; Umberto,30,0,30,0
1745790996375,CSS 202S,A01,892056,Mignozzetti; Umberto,30,0,30,0
1745790997402,DSC 197,001,956898,Eldridge; Justin Matthew,9998,0,9999,1
1745790998430,DSC 297,001,958000,Mazumdar; Arya,9998,0,9999,1
1745790999454,EAP 100,A00,905686,Staff,9776,0,9999,223
1745791000479,ECE 45,A01,892618,Staff,0,12,50,50
1745791001505,ECE 109,A01,892620,Staff,0,43,0,0
1745791002534,ECE 111,A01,892719,Staff,0,7,50,50
1745791003558,ECE 197,001,957920,Mercier; Patrick Philip,9992,0,9999,7
1745791004587,ECON 178,A01,907814,Zhu; Ying,28,0,35,7
1745791005614,EDS 115,A00,895312,Staff,41,0,45,4
1745791006637,EDS 117,A01,895337,Staff,30,0,30,0
1745791007666,EDS 125,A00,895341,Jones; Gabrielle Anastasia,43,0,45,2
1745791008692,EDS 128A,A01,895459,Fargason; Sharon Gayle,44,0,45,1
1745791009715,EDS 128B,A01,895543,Pappas; Elizabeth,44,0,45,1
1745791010740,EDS 139,A00,897203,Pappas; Elizabeth,44,0,45,1
1745791010740,EDS 139,B00,897209,Fargason; Sharon Gayle,44,0,45,1
1745791011766,EDS 201,A00,895545,Staff,43,0,45,2
1745791012792,EDS 203,A01,895581,Halter; Christopher P.,43,0,45,2
1745791013818,EDS 204R,A01,895625,Heinzman; Erica M.,43,0,45,2
1745791013818,EDS 204R,B01,895693,Halter; Christopher P.,18,0,45,27
1745791014843,EDS 206R,A00,895694,Fargason; Sharon Gayle,9,0,30,21
1745791014843,EDS 206R,B00,895695,Choi; Bailey Miyeon,20,0,30,10
1745791015870,EDS 250,A00,895697,Hemans; Patricia Ann Benitez,43,0,45,2
1745791016896,EDS 281,A00,895701,Meyerott; Theresa Ann,15,0,15,0
1745791017922,EDS 284,A00,895736,Meyerott; Theresa Ann,15,0,15,0
1745791018948,EDS 286,A00,897210,Fine; Sarah,15,0,15,0
1745791019974,EDS 289C,A01,895770,Daly; Alan J.,15,0,15,0
1745791021000,EDS 290,A00,897211,Hofstetter; Carolyn,15,0,15,0
1745791022027,LIGM 5A,A00,896162,Fischer-Grunski; Eva K,15,0,20,5
1745791023052,LIGM 5B,A00,896260,Fischer-Grunski; Eva K,17,0,20,3
1745791024079,LIGM 5C,A00,896308,Fischer-Grunski; Eva K,18,0,20,2
1745791025104,LIIT 5AS,A00,896313,Carnelos; Chiara,18,0,20,2
1745791026133,LIIT 5BS,A00,896416,Carnelos; Chiara,20,0,20,0
1745791027159,LIIT 5CS,A00,896564,Carnelos; Chiara,20,0,20,0
1745791028185,LISP 5A,A00,896588,Munoz Sanchez; Alicia,4,0,20,16
1745791029215,LISP 5B,A00,896653,Munoz Sanchez; Alicia,10,0,20,10
1745791030245,LISP 5C,A00,896655,Munoz Sanchez; Alicia,4,0,20,16
1745791031272,MAE 197,001,957918,Kleissl; Jan,9998,0,9999,1
1745791032298,MATH 2,A01,957937,Staff,34,0,35,1
1745791033326,MATH 197,001,957876,Kedlaya; Kiran S.,9993,0,9999,6
1745791034351,MCWP 40,A00,892729,Duru; Nur,13,0,20,7
1745791034351,MCWP 40,B00,893304,Montejo; Carolina,20,0,20,0
1745791035376,MCWP 40R,A00,893757,Redela; Pamela Morgan,0,6,20,20
1745791036400,MCWP 50,A00,893758,Morshed; Michael James,2,0,20,18
1745791036400,MCWP 50,B00,893761,Bartulis; Jason Michael,17,0,20,3
1745791037428,MCWP 50R,A00,893766,Compas; Sean Matthew,0,1,20,20
1745791037428,MCWP 50R,B00,893769,Carter; Jennifer A,0,0,20,20
1745791037428,MCWP 50R,C00,893771,Krone; Jarret,0,3,20,20
1745791037428,MCWP 50R,D00,893772,Miller; Elizabeth Deen,3,0,20,17
1745791037428,MCWP 50R,E00,893775,Carter; Andrea L,0,0,20,20
1745791038458,MMW 11R,A01,892721,Herbst; Matthew,11,0,27,16
1745791038458,MMW 11R,A02,892722,Herbst; Matthew,0,0,0,3
1745791039483,MMW 12R,A01,892724,Herbst; Matthew,0,9,16,16
1745791039483,MMW 12R,A02,892725,Herbst; Matthew,0,9,16,16
1745791040509,MMW 13R,A01,892727,Staff,0,4,16,16
1745791040509,MMW 13R,A02,892728,Staff,0,4,16,16
1745791040509,MMW 13R,A03,958032,Staff,0,3,16,16
1745791040509,MMW 13R,A04,958033,Staff,0,2,16,16
1745791040509,MMW 13R,A05,958034,Staff,0,3,16,16
1745791041535,SIO 295LS,A00,894015,Staff,7,0,25,18
1745791042563,SIO 295S,A00,894020,Staff,7,0,25,18
1745791043592,SIOC 290S,B01,958918,Staff,0,0,0,0
1745791044619,SIOC 291S,B01,958922,Staff,0,0,0,0
1745791045643,SOCI 117,A01,895339,Staff,4,0,5,1
1745791046669,WES 237B,A00,894149,Staff,11,0,20,9
1745791048728,AESE 279B,A00,891859,Staff,13,0,35,22
1745791049757,AIP 197,001,891854,Staff,70,0,70,0
1745791050784,ANTH 289S,A00,891856,Gagneux; Pascal,12,0,12,0
1745791051810,BENG 196,001,957946,Engler; Adam J.,9996,0,9999,3
1745791052835,CAT 124RS,A01,956906,Staff,8,0,25,17
1745791053861,CAT 125RS,A01,922013,Staff,8,0,25,17
1745791054887,CLRE 250,A00,891860,Morris; Sheldon,9995,0,9999,4
1745791056939,CLRE 251R,A00,907817,Mehta; Ravindra L.,9994,0,9999,5
1745791057967,CLRE 252,A00,891864,Cuomo; Raphael Eduardo,9993,0,9999,6
1745791058994,CLRE 253,A00,891867,Vaida; Florin,9994,0,9999,5
1745791058994,CLRE 253,B00,907819,Staff,9999,0,9999,0
1745791060020,CLRE 259,A00,891868,Patel; Hemal,9998,0,9999,1
1745791061045,CLRE 260,A00,891872,Cuomo; Raphael Eduardo,9999,0,9999,0
1745791062072,CLRE 297,001,891888,Cuomo; Raphael Eduardo,9999,0,9999,0
1745791063100,CSE 191,A00,958773,Minnes Kemp; Mor Mia,9999,0,9999,0
1745791064129,CSS 201S,A01,892054,Mignozzetti; Umberto,30,0,30,0
1745791065158,CSS 202S,A01,892056,Mignozzetti; Umberto,30,0,30,0
1745791066186,DSC 197,001,956898,Eldridge; Justin Matthew,9998,0,9999,1
1745791067213,DSC 297,001,958000,Mazumdar; Arya,9998,0,9999,1
1745791068239,EAP 100,A00,905686,Staff,9776,0,9999,223
1745791069268,ECE 45,A01,892618,Staff,0,12,50,50
1745791070295,ECE 109,A01,892620,Staff,0,43,0,0
1745791071325,ECE 111,A01,892719,Staff,0,7,50,50
1745791072352,ECE 197,001,957920,Mercier; Patrick Philip,9992,0,9999,7
1745791073378,ECON 178,A01,907814,Zhu; Ying,28,0,35,7
1745791074404,EDS 115,A00,895312,Staff,41,0,45,4
1745791075430,EDS 117,A01,895337,Staff,30,0,30,0
1745791076455,EDS 125,A00,895341,Jones; Gabrielle Anastasia,43,0,45,2
1745791077481,EDS 128A,A01,895459,Fargason; Sharon Gayle,44,0,45,1
1745791078509,EDS 128B,A01,895543,Pappas; Elizabeth,44,0,45,1
1745791079535,EDS 139,A00,897203,Pappas; Elizabeth,44,0,45,1
1745791079535,EDS 139,B00,897209,Fargason; Sharon Gayle,44,0,45,1
1745791080562,EDS 201,A00,895545,Staff,43,0,45,2
1745791081587,EDS 203,A01,895581,Halter; Christopher P.,43,0,45,2
1745791082619,EDS 204R,A01,895625,Heinzman; Erica M.,43,0,45,2
1745791082619,EDS 204R,B01,895693,Halter; Christopher P.,18,0,45,27
1745791083647,EDS 206R,A00,895694,Fargason; Sharon Gayle,9,0,30,21
1745791083647,EDS 206R,B00,895695,Choi; Bailey Miyeon,20,0,30,10
1745791084675,EDS 250,A00,895697,Hemans; Patricia Ann Benitez,43,0,45,2
1745791085704,EDS 281,A00,895701,Meyerott; Theresa Ann,15,0,15,0
1745791086731,EDS 284,A00,895736,Meyerott; Theresa Ann,15,0,15,0
1745791087756,EDS 286,A00,897210,Fine; Sarah,15,0,15,0
1745791088783,EDS 289C,A01,895770,Daly; Alan J.,15,0,15,0
1745791089809,EDS 290,A00,897211,Hofstetter; Carolyn,15,0,15,0
1745791090839,LIGM 5A,A00,896162,Fischer-Grunski; Eva K,15,0,20,5
1745791091865,LIGM 5B,A00,896260,Fischer-Grunski; Eva K,17,0,20,3
1745791092896,LIGM 5C,A00,896308,Fischer-Grunski; Eva K,18,0,20,2
1745791093922,LIIT 5AS,A00,896313,Carnelos; Chiara,18,0,20,2
1745791094948,LIIT 5BS,A00,896416,Carnelos; Chiara,20,0,20,0
1745791095974,LIIT 5CS,A00,896564,Carnelos; Chiara,20,0,20,0
1745791097027,LISP 5A,A00,896588,Munoz Sanchez; Alicia,4,0,20,16
1745791098056,LISP 5B,A00,896653,Munoz Sanchez; Alicia,10,0,20,10
1745791099085,LISP 5C,A00,896655,Munoz Sanchez; Alicia,4,0,20,16
1745791100110,MAE 197,001,957918,Kleissl; Jan,9998,0,9999,1
1745791101139,MATH 2,A01,957937,Staff,34,0,35,1
1745791102169,MATH 197,001,957876,Kedlaya; Kiran S.,9993,0,9999,6
1745791103195,MCWP 40,A00,892729,Duru; Nur,13,0,20,7
1745791103195,MCWP 40,B00,893304,Montejo; Carolina,20,0,20,0
1745791104222,MCWP 40R,A00,893757,Redela; Pamela Morgan,0,6,20,20
1745791105248,MCWP 50,A00,893758,Morshed; Michael James,2,0,20,18
1745791105248,MCWP 50,B00,893761,Bartulis; Jason Michael,17,0,20,3
1745791106277,MCWP 50R,A00,893766,Compas; Sean Matthew,0,1,20,20
1745791106277,MCWP 50R,B00,893769,Carter; Jennifer A,0,0,20,20
1745791106277,MCWP 50R,C00,893771,Krone; Jarret,0,3,20,20
1745791106277,MCWP 50R,D00,893772,Miller; Elizabeth Deen,3,0,20,17
1745791106277,MCWP 50R,E00,893775,Carter; Andrea L,0,0,20,20
1745791107303,MMW 11R,A01,892721,Herbst; Matthew,11,0,27,16
1745791107303,MMW 11R,A02,892722,Herbst; Matthew,0,0,0,3
1745791108328,MMW 12R,A01,892724,Herbst; Matthew,0,9,16,16
1745791108328,MMW 12R,A02,892725,Herbst; Matthew,0,9,16,16
1745791109356,MMW 13R,A01,892727,Staff,0,4,16,16
1745791109356,MMW 13R,A02,892728,Staff,0,4,16,16
1745791109356,MMW 13R,A03,958032,Staff,0,3,16,16
1745791109356,MMW 13R,A04,958033,Staff,0,2,16,16
1745791109356,MMW 13R,A05,958034,Staff,0,3,16,16
1745791110382,SIO 295LS,A00,894015,Staff,7,0,25,18
1745791111407,SIO 295S,A00,894020,Staff,7,0,25,18
1745791112434,SIOC 290S,B01,958918,Staff,0,0,0,0
1745791113464,SIOC 291S,B01,958922,Staff,0,0,0,0
1745791114491,SOCI 117,A01,895339,Staff,4,0,5,1
1745791115516,WES 237B,A00,894149,Staff,11,0,20,9
1745791117578,AESE 279B,A00,891859,Staff,13,0,35,22
1745791118603,AIP 197,001,891854,Staff,70,0,70,0
1745791119630,ANTH 289S,A00,891856,Gagneux; Pascal,12,0,12,0
1745791120655,BENG 196,001,957946,Engler; Adam J.,9996,0,9999,3
1745791121681,CAT 124RS,A01,956906,Staff,8,0,25,17
1745791122712,CAT 125RS,A01,922013,Staff,8,0,25,17
1745791123740,CLRE 250,A00,891860,Morris; Sheldon,9995,0,9999,4
1745791125798,CLRE 251R,A00,907817,Mehta; Ravindra L.,9994,0,9999,5
1745791126827,CLRE 252,A00,891864,Cuomo; Raphael Eduardo,9993,0,9999,6
1745791127853,CLRE 253,A00,891867,Vaida; Florin,9994,0,9999,5
1745791127853,CLRE 253,B00,907819,Staff,9999,0,9999,0
1745791128880,CLRE 259,A00,891868,Patel; Hemal,9998,0,9999,1
1745791129905,CLRE 260,A00,891872,Cuomo; Raphael Eduardo,9999,0,9999,0
1745791130929,CLRE 297,001,891888,Cuomo; Raphael Eduardo,9999,0,9999,0
1745791131955,CSE 191,A00,958773,Minnes Kemp; Mor Mia,9999,0,9999,0
1745791132985,CSS 201S,A01,892054,Mignozzetti; Umberto,30,0,30,0
1745791134013,CSS 202S,A01,892056,Mignozzetti; Umberto,30,0,30,0
1745791135041,DSC 197,001,956898,Eldridge; Justin Matthew,9998,0,9999,1
1745791136067,DSC 297,001,958000,Mazumdar; Arya,9998,0,9999,1
1745791137094,EAP 100,A00,905686,Staff,9776,0,9999,223
1745791138117,ECE 45,A01,892618,Staff,0,12,50,50
1745791139144,ECE 109,A01,892620,Staff,0,43,0,0
1745791140172,ECE 111,A01,892719,Staff,0,7,50,50
1745791141199,ECE 197,001,957920,Mercier; Patrick Philip,9992,0,9999,7
1745791142229,ECON 178,A01,907814,Zhu; Ying,28,0,35,7
1745791143255,EDS 115,A00,895312,Staff,41,0,45,4
1745791144282,EDS 117,A01,895337,Staff,30,0,30,0
1745791145307,EDS 125,A00,895341,Jones; Gabrielle Anastasia,43,0,45,2
1745791146336,EDS 128A,A01,895459,Fargason; Sharon Gayle,44,0,45,1
1745791147367,EDS 128B,A01,895543,Pappas; Elizabeth,44,0,45,1
1745791148393,EDS 139,A00,897203,Pappas; Elizabeth,44,0,45,1
1745791148393,EDS 139,B00,897209,Fargason; Sharon Gayle,44,0,45,1
1745791149420,EDS 201,A00,895545,Staff,43,0,45,2
1745791150445,EDS 203,A01,895581,Halter; Christopher P.,43,0,45,2
1745791151470,EDS 204R,A01,895625,Heinzman; Erica M.,43,0,45,2
1745791151470,EDS 204R,B01,895693,Halter; Christopher P.,18,0,45,27
1745791152497,EDS 206R,A00,895694,Fargason; Sharon Gayle,9,0,30,21
1745791152497,EDS 206R,B00,895695,Choi; Bailey Miyeon,20,0,30,10
1745791153526,EDS 250,A00,895697,Hemans; Patricia Ann Benitez,43,0,45,2
1745791154552,EDS 281,A00,895701,Meyerott; Theresa Ann,15,0,15,0
1745791155578,EDS 284,A00,895736,Meyerott; Theresa Ann,15,0,15,0
1745791156603,EDS 286,A00,897210,Fine; Sarah,15,0,15,0
1745791157629,EDS 289C,A01,895770,Daly; Alan J.,15,0,15,0
1745791158699,EDS 290,A00,897211,Hofstetter; Carolyn,15,0,15,0
1745791159723,LIGM 5A,A00,896162,Fischer-Grunski; Eva K,15,0,20,5
1745791160751,LIGM 5B,A00,896260,Fischer-Grunski; Eva K,17,0,20,3
1745791161777,LIGM 5C,A00,896308,Fischer-Grunski; Eva K,18,0,20,2
1745791162807,LIIT 5AS,A00,896313,Carnelos; Chiara,18,0,20,2
1745791163833,LIIT 5BS,A00,896416,Carnelos; Chiara,20,0,20,0
1745791164858,LIIT 5CS,A00,896564,Carnelos; Chiara,20,0,20,0
1745791165887,LISP 5A,A00,896588,Munoz Sanchez; Alicia,4,0,20,16
1745791166916,LISP 5B,A00,896653,Munoz Sanchez; Alicia,10,0,20,10
1745791167945,LISP 5C,A00,896655,Munoz Sanchez; Alicia,4,0,20,16
1745791168975,MAE 197,001,957918,Kleissl; Jan,9998,0,9999,1
1745791170004,MATH 2,A01,957937,Staff,34,0,35,1
1745791171030,MATH 197,001,957876,Kedlaya; Kiran S.,9993,0,9999,6
1745791172059,MCWP 40,A00,892729,Duru; Nur,13,0,20,7
1745791172059,MCWP 40,B00,893304,Montejo; Carolina,20,0,20,0
1745791173084,MCWP 40R,A00,893757,Redela; Pamela Morgan,0,6,20,20
1745791174116,MCWP 50,A00,893758,Morshed; Michael James,2,0,20,18
1745791174116,MCWP 50,B00,893761,Bartulis; Jason Michael,17,0,20,3
1745791175146,MCWP 50R,A00,893766,Compas; Sean Matthew,0,1,20,20
1745791175146,MCWP 50R,B00,893769,Carter; Jennifer A,0,0,20,20
1745791175146,MCWP 50R,C00,893771,Krone; Jarret,0,3,20,20
1745791175146,MCWP 50R,D00,893772,Miller; Elizabeth Deen,3,0,20,17
1745791175146,MCWP 50R,E00,893775,Carter; Andrea L,0,0,20,20
1745791176175,MMW 11R,A01,892721,Herbst; Matthew,11,0,27,16
1745791176175,MMW 11R,A02,892722,Herbst; Matthew,0,0,0,3
1745791177201,MMW 12R,A01,892724,Herbst; Matthew,0,9,16,16
1745791177201,MMW 12R,A02,892725,Herbst; Matthew,0,9,16,16
1745791178230,MMW 13R,A01,892727,Staff,0,4,16,16
1745791178230,MMW 13R,A02,892728,Staff,0,4,16,16
1745791178230,MMW 13R,A03,958032,Staff,0,3,16,16
1745791178230,MMW 13R,A04,958033,Staff,0,2,16,16
1745791178230,MMW 13R,A05,958034,Staff,0,3,16,16
1745791179257,SIO 295LS,A00,894015,Staff,7,0,25,18
1745791180285,SIO 295S,A00,894020,Staff,7,0,25,18
1745791181312,SIOC 290S,B01,958918,Staff,0,0,0,0
1745791182339,SIOC 291S,B01,958922,Staff,0,0,0,0
1745791183364,SOCI 117,A01,895339,Staff,4,0,5,1
1745791184393,WES 237B,A00,894149,Staff,11,0,20,9
1745791186454,AESE 279B,A00,891859,Staff,13,0,35,22
1745791187480,AIP 197,001,891854,Staff,70,0,70,0
1745791188509,ANTH 289S,A00,891856,Gagneux; Pascal,12,0,12,0
1745791189533,BENG 196,001,957946,Engler; Adam J.,9996,0,9999,3
1745791190560,CAT 124RS,A01,956906,Staff,8,0,25,17
1745791191585,CAT 125RS,A01,922013,Staff,8,0,25,17
1745791192609,CLRE 250,A00,891860,Morris; Sheldon,9995,0,9999,4
1745791194663,CLRE 251R,A00,907817,Mehta; Ravindra L.,9994,0,9999,5
1745791195691,CLRE 252,A00,891864,Cuomo; Raphael Eduardo,9993,0,9999,6
1745791196716,CLRE 253,A00,891867,Vaida; Florin,9994,0,9999,5
1745791196716,CLRE 253,B00,907819,Staff,9999,0,9999,0
1745791197744,CLRE 259,A00,891868,Patel; Hemal,9998,0,9999,1
1745791198773,CLRE 260,A00,891872,Cuomo; Raphael Eduardo,9999,0,9999,0
1745791199800,CLRE 297,001,891888,Cuomo; Raphael Eduardo,9999,0,9999,0
1745791200826,CSE 191,A00,958773,Minnes Kemp; Mor Mia,9999,0,9999,0
1745791201853,CSS 201S,A01,892054,Mignozzetti; Umberto,30,0,30,0
1745791202886,CSS 202S,A01,892056,Mignozzetti; Umberto,30,0,30,0
1745791203914,DSC 197,001,956898,Eldridge; Justin Matthew,9998,0,9999,1
1745791204942,DSC 297,001,958000,Mazumdar; Arya,9998,0,9999,1
1745791205968,EAP 100,A00,905686,Staff,9776,0,9999,223
1745791206995,ECE 45,A01,892618,Staff,0,12,50,50
1745791208021,ECE 109,A01,892620,Staff,0,43,0,0
1745791209051,ECE 111,A01,892719,Staff,0,7,50,50
1745791210077,ECE 197,001,957920,Mercier; Patrick Philip,9992,0,9999,7
1745791211103,ECON 178,A01,907814,Zhu; Ying,28,0,35,7
1745791212128,EDS 115,A00,895312,Staff,41,0,45,4
1745791213155,EDS 117,A01,895337,Staff,30,0,30,0
1745791214183,EDS 125,A00,895341,Jones; Gabrielle Anastasia,43,0,45,2
1745791215210,EDS 128A,A01,895459,Fargason; Sharon Gayle,44,0,45,1
1745791216237,EDS 128B,A01,895543,Pappas; Elizabeth,44,0,45,1
1745791217266,EDS 139,A00,897203,Pappas; Elizabeth,44,0,45,1
1745791217266,EDS 139,B00,897209,Fargason; Sharon Gayle,44,0,45,1
1745791218293,EDS 201,A00,895545,Staff,43,0,45,2
1745791219320,EDS 203,A01,895581,Halter; Christopher P.,43,0,45,2
1745791220350,EDS 204R,A01,895625,Heinzman; Erica M.,43,0,45,2
1745791220350,EDS 204R,B01,895693,Halter; Christopher P.,18,0,45,27
1745791221377,EDS 206R,A00,895694,Fargason; Sharon Gayle,9,0,30,21
1745791221377,EDS 206R,B00,895695,Choi; Bailey Miyeon,20,0,30,10
1745791222403,EDS 250,A00,895697,Hemans; Patricia Ann Benitez,43,0,45,2
1745791223431,EDS 281,A00,895701,Meyerott; Theresa Ann,15,0,15,0
1745791224457,EDS 284,A00,895736,Meyerott; Theresa Ann,15,0,15,0
1745791225484,EDS 286,A00,897210,Fine; Sarah,15,0,15,0
1745791226510,EDS 289C,A01,895770,Daly; Alan J.,15,0,15,0
1745791227537,EDS 290,A00,897211,Hofstetter; Carolyn,15,0,15,0
1745791228564,LIGM 5A,A00,896162,Fischer-Grunski; Eva K,15,0,20,5
1745791229590,LIGM 5B,A00,896260,Fischer-Grunski; Eva K,17,0,20,3
1745791230616,LIGM 5C,A00,896308,Fischer-Grunski; Eva K,18,0,20,2
1745791231645,LIIT 5AS,A00,896313,Carnelos; Chiara,18,0,20,2
1745791232669,LIIT 5BS,A00,896416,Carnelos; Chiara,20,0,20,0
1745791233694,LIIT 5CS,A00,896564,Carnelos; Chiara,20,0,20,0
1745791234724,LISP 5A,A00,896588,Munoz Sanchez; Alicia,4,0,20,16
1745791235752,LISP 5B,A00,896653,Munoz Sanchez; Alicia,10,0,20,10
1745791236778,LISP 5C,A00,896655,Munoz Sanchez; Alicia,4,0,20,16
1745791237804,MAE 197,001,957918,Kleissl; Jan,9998,0,9999,1
1745791238833,MATH 2,A01,957937,Staff,34,0,35,1
1745791239860,MATH 197,001,957876,Kedlaya; Kiran S.,9993,0,9999,6
1745791240887,MCWP 40,A00,892729,Duru; Nur,13,0,20,7
1745791240887,MCWP 40,B00,893304,Montejo; Carolina,20,0,20,0
1745791241914,MCWP 40R,A00,893757,Redela; Pamela Morgan,0,6,20,20
1745791242939,MCWP 50,A00,893758,Morshed; Michael James,2,0,20,18
1745791242939,MCWP 50,B00,893761,Bartulis; Jason Michael,17,0,20,3
1745791243964,MCWP 50R,A00,893766,Compas; Sean Matthew,0,1,20,20
1745791243964,MCWP 50R,B00,893769,Carter; Jennifer A,0,0,20,20
1745791243964,MCWP 50R,C00,893771,Krone; Jarret,0,3,20,20
1745791243964,MCWP 50R,D00,893772,Miller; Elizabeth Deen,3,0,20,17
1745791243964,MCWP 50R,E00,893775,Carter; Andrea L,0,0,20,20
1745791244994,MMW 11R,A01,892721,Herbst; Matthew,11,0,27,16
1745791244994,MMW 11R,A02,892722,Herbst; Matthew,0,0,0,3
1745791246019,MMW 12R,A01,892724,Herbst; Matthew,0,9,16,16
1745791246019,MMW 12R,A02,892725,Herbst; Matthew,0,9,16,16
1745791247045,MMW 13R,A01,892727,Staff,0,4,16,16
1745791247045,MMW 13R,A02,892728,Staff,0,4,16,16
1745791247045,MMW 13R,A03,958032,Staff,0,3,16,16
1745791247045,MMW 13R,A04,958033,Staff,0,2,16,16
1745791247045,MMW 13R,A05,958034,Staff,0,3,16,16
1745791248071,SIO 295LS,A00,894015,Staff,7,0,25,18
1745791249098,SIO 295S,A00,894020,Staff,7,0,25,18
1745791250130,SIOC 290S,B01,958918,Staff,0,0,0,0
1745791251157,SIOC 291S,B01,958922,Staff,0,0,0,0
1745791252183,SOCI 117,A01,895339,Staff,4,0,5,1
1745791253212,WES 237B,A00,894149,Staff,11,0,20,9
1745791255278,AESE 279B,A00,891859,Staff,13,0,35,22
1745791256307,AIP 197,001,891854,Staff,70,0,70,0
1745791257333,ANTH 289S,A00,891856,Gagneux; Pascal,12,0,12,0
1745791258360,BENG 196,001,957946,Engler; Adam J.,9996,0,9999,3
1745791259388,CAT 124RS,A01,956906,Staff,8,0,25,17
1745791260414,CAT 125RS,A01,922013,Staff,8,0,25,17
1745791261440,CLRE 250,A00,891860,Morris; Sheldon,9995,0,9999,4
1745791263495,CLRE 251R,A00,907817,Mehta; Ravindra L.,9994,0,9999,5
1745791264524,CLRE 252,A00,891864,Cuomo; Raphael Eduardo,9993,0,9999,6
1745791265551,CLRE 253,A00,891867,Vaida; Florin,9994,0,9999,5
1745791265551,CLRE 253,B00,907819,Staff,9999,0,9999,0
1745791266578,CLRE 259,A00,891868,Patel; Hemal,9998,0,9999,1
1745791267606,CLRE 260,A00,891872,Cuomo; Raphael Eduardo,9999,0,9999,0
1745791268634,CLRE 297,001,891888,Cuomo; Raphael Eduardo,9999,0,9999,0
1745791269659,CSE 191,A00,958773,Minnes Kemp; Mor Mia,9999,0,9999,0
1745791270689,CSS 201S,A01,892054,Mignozzetti; Umberto,30,0,30,0
1745791271716,CSS 202S,A01,892056,Mignozzetti; Umberto,30,0,30,0
1745791272742,DSC 197,001,956898,Eldridge; Justin Matthew,9998,0,9999,1
1745791273769,DSC 297,001,958000,Mazumdar; Arya,9998,0,9999,1
1745791274796,EAP 100,A00,905686,Staff,9776,0,9999,223
1745791275828,ECE 45,A01,892618,Staff,0,12,50,50
1745791276856,ECE 109,A01,892620,Staff,0,43,0,0
1745791277881,ECE 111,A01,892719,Staff,0,7,50,50
1745791278907,ECE 197,001,957920,Mercier; Patrick Philip,9992,0,9999,7
1745791279936,ECON 178,A01,907814,Zhu; Ying,28,0,35,7
1745791280964,EDS 115,A00,895312,Staff,41,0,45,4
1745791281992,EDS 117,A01,895337,Staff,30,0,30,0
1745791283021,EDS 125,A00,895341,Jones; Gabrielle Anastasia,43,0,45,2
1745791284046,EDS 128A,A01,895459,Fargason; Sharon Gayle,44,0,45,1
1745791285072,EDS 128B,A01,895543,Pappas; Elizabeth,44,0,45,1
1745791286098,EDS 139,A00,897203,Pappas; Elizabeth,44,0,45,1
1745791286098,EDS 139,B00,897209,Fargason; Sharon Gayle,44,0,45,1
1745791287122,EDS 201,A00,895545,Staff,43,0,45,2
1745791288151,EDS 203,A01,895581,Halter; Christopher P.,43,0,45,2
1745791289178,EDS 204R,A01,895625,Heinzman; Erica M.,43,0,45,2
1745791289178,EDS 204R,B01,895693,Halter; Christopher P.,18,0,45,27
1745791290205,EDS 206R,A00,895694,Fargason; Sharon Gayle,9,0,30,21
1745791290205,EDS 206R,B00,895695,Choi; Bailey Miyeon,20,0,30,10
1745791291237,EDS 250,A00,895697,Hemans; Patricia Ann Benitez,43,0,45,2
1745791292267,EDS 281,A00,895701,Meyerott; Theresa Ann,15,0,15,0
1745791293293,EDS 284,A00,895736,Meyerott; Theresa Ann,15,0,15,0
1745791294322,EDS 286,A00,897210,Fine; Sarah,15,0,15,0
1745791295350,EDS 289C,A01,895770,Daly; Alan J.,15,0,15,0
1745791296378,EDS 290,A00,897211,Hofstetter; Carolyn,15,0,15,0
1745791297407,LIGM 5A,A00,896162,Fischer-Grunski; Eva K,15,0,20,5
1745791298433,LIGM 5B,A00,896260,Fischer-Grunski; Eva K,17,0,20,3
1745791299464,LIGM 5C,A00,896308,Fischer-Grunski; Eva K,18,0,20,2
1745791300490,LIIT 5AS,A00,896313,Carnelos; Chiara,18,0,20,2
1745791301519,LIIT 5BS,A00,896416,Carnelos; Chiara,20,0,20,0
1745791302546,LIIT 5CS,A00,896564,Carnelos; Chiara,20,0,20,0
1745791303572,LISP 5A,A00,896588,Munoz Sanchez; Alicia,4,0,20,16
1745791304598,LISP 5B,A00,896653,Munoz Sanchez; Alicia,10,0,20,10
1745791305629,LISP 5C,A00,896655,Munoz Sanchez; Alicia,4,0,20,16
1745791306656,MAE 197,001,957918,Kleissl; Jan,9998,0,9999,1
1745791307681,MATH 2,A01,957937,Staff,34,0,35,1
1745791308706,MATH 197,001,957876,Kedlaya; Kiran S.,9993,0,9999,6
1745791309733,MCWP 40,A00,892729,Duru; Nur,13,0,20,7
1745791309733,MCWP 40,B00,893304,Montejo; Carolina,20,0,20,0
1745791310759,MCWP 40R,A00,893757,Redela; Pamela Morgan,0,6,20,20
1745791311789,MCWP 50,A00,893758,Morshed; Michael James,2,0,20,18
1745791311789,MCWP 50,B00,893761,Bartulis; Jason Michael,17,0,20,3
1745791312817,MCWP 50R,A00,893766,Compas; Sean Matthew,0,1,20,20
1745791312817,MCWP 50R,B00,893769,Carter; Jennifer A,0,0,20,20
1745791312817,MCWP 50R,C00,893771,Krone; Jarret,0,3,20,20
1745791312817,MCWP 50R,D00,893772,Miller; Elizabeth Deen,3,0,20,17
1745791312817,MCWP 50R,E00,893775,Carter; Andrea L,0,0,20,20
1745791313843,MMW 11R,A01,892721,Herbst; Matthew,11,0,27,16
1745791313843,MMW 11R,A02,892722,Herbst; Matthew,0,0,0,3
1745791314871,MMW 12R,A01,892724,Herbst; Matthew,0,9,16,16
1745791314871,MMW 12R,A02,892725,Herbst; Matthew,0,9,16,16
1745791315896,MMW 13R,A01,892727,Staff,0,4,16,16
1745791315896,MMW 13R,A02,892728,Staff,0,4,16,16
1745791315896,MMW 13R,A03,958032,Staff,0,3,16,16
1745791315896,MMW 13R,A04,958033,Staff,0,2,16,16
1745791315896,MMW 13R,A05,958034,Staff,0,3,16,16
1745791316922,SIO 295LS,A00,894015,Staff,7,0,25,18
1745791317948,SIO 295S,A00,894020,Staff,7,0,25,18
1745791318973,SIOC 290S,B01,958918,Staff,0,0,0,0
1745791320000,SIOC 291S,B01,958922,Staff,0,0,0,0
1745791321028,SOCI 117,A01,895339,Staff,4,0,5,1
1745791322054,WES 237B,A00,894149,Staff,11,0,20,9
1745791324119,AESE 279B,A00,891859,Staff,13,0,35,22
1745791325145,AIP 197,001,891854,Staff,70,0,70,0
1745791326172,ANTH 289S,A00,891856,Gagneux; Pascal,12,0,12,0
1745791327200,BENG 196,001,957946,Engler; Adam J.,9996,0,9999,3
1745791328230,CAT 124RS,A01,956906,Staff,8,0,25,17
1745791329304,CAT 125RS,A01,922013,Staff,8,0,25,17
1745791330331,CLRE 250,A00,891860,Morris; Sheldon,9995,0,9999,4
1745791332392,CLRE 251R,A00,907817,Mehta; Ravindra L.,9994,0,9999,5
1745791333419,CLRE 252,A00,891864,Cuomo; Raphael Eduardo,9993,0,9999,6
1745791334445,CLRE 253,A00,891867,Vaida; Florin,9994,0,9999,5
1745791334445,CLRE 253,B00,907819,Staff,9999,0,9999,0
1745791335470,CLRE 259,A00,891868,Patel; Hemal,9998,0,9999,1
1745791336497,CLRE 260,A00,891872,Cuomo; Raphael Eduardo,9999,0,9999,0
1745791337522,CLRE 297,001,891888,Cuomo; Raphael Eduardo,9999,0,9999,0
1745791338548,CSE 191,A00,958773,Minnes Kemp; Mor Mia,9999,0,9999,0
1745791339576,CSS 201S,A01,892054,Mignozzetti; Umberto,30,0,30,0
1745791340603,CSS 202S,A01,892056,Mignozzetti; Umberto,30,0,30,0
1745791341629,DSC 197,001,956898,Eldridge; Justin Matthew,9998,0,9999,1
1745791342655,DSC 297,001,958000,Mazumdar; Arya,9998,0,9999,1
1745791343681,EAP 100,A00,905686,Staff,9776,0,9999,223
1745791344707,ECE 45,A01,892618,Staff,0,12,50,50
1745791345734,ECE 109,A01,892620,Staff,0,43,0,0
1745791346759,ECE 111,A01,892719,Staff,0,7,50,50
1745791347787,ECE 197,001,957920,Mercier; Patrick Philip,9992,0,9999,7
1745791348812,ECON 178,A01,907814,Zhu; Ying,28,0,35,7
1745791349837,EDS 115,A00,895312,Staff,41,0,45,4
1745791350861,EDS 117,A01,895337,Staff,30,0,30,0
1745791351885,EDS 125,A00,895341,Jones; Gabrielle Anastasia,43,0,45,2
1745791352914,EDS 128A,A01,895459,Fargason; Sharon Gayle,44,0,45,1
1745791353939,EDS 128B,A01,895543,Pappas; Elizabeth,44,0,45,1
1745791354966,EDS 139,A00,897203,Pappas; Elizabeth,44,0,45,1
1745791354966,EDS 139,B00,897209,Fargason; Sharon Gayle,44,0,45,1
1745791355993,EDS 201,A00,895545,Staff,43,0,45,2
1745791357022,EDS 203,A01,895581,Halter; Christopher P.,43,0,45,2
1745791358047,EDS 204R,A01,895625,Heinzman; Erica M.,43,0,45,2
1745791358047,EDS 204R,B01,895693,Halter; Christopher P.,18,0,45,27
1745791359072,EDS 206R,A00,895694,Fargason; Sharon Gayle,9,0,30,21
1745791359072,EDS 206R,B00,895695,Choi; Bailey Miyeon,20,0,30,10
1745791360136,EDS 250,A00,895697,Hemans; Patricia Ann Benitez,43,0,45,2
1745791361162,EDS 281,A00,895701,Meyerott; Theresa Ann,15,0,15,0
1745791362188,EDS 284,A00,895736,Meyerott; Theresa Ann,15,0,15,0
1745791363214,EDS 286,A00,897210,Fine; Sarah,15,0,15,0
1745791364241,EDS 289C,A01,895770,Daly; Alan J.,15,0,15,0
1745791365267,EDS 290,A00,897211,Hofstetter; Carolyn,15,0,15,0
1745791366292,LIGM 5A,A00,896162,Fischer-Grunski; Eva K,15,0,20,5
1745791367320,LIGM 5B,A00,896260,Fischer-Grunski; Eva K,17,0,20,3
1745791368350,LIGM 5C,A00,896308,Fischer-Grunski; Eva K,18,0,20,2
1745791369375,LIIT 5AS,A00,896313,Carnelos; Chiara,18,0,20,2
1745791370401,LIIT 5BS,A00,896416,Carnelos; Chiara,20,0,20,0
1745791371432,LIIT 5CS,A00,896564,Carnelos; Chiara,20,0,20,0
1745791372457,LISP 5A,A00,896588,Munoz Sanchez; Alicia,4,0,20,16
1745791373483,LISP 5B,A00,896653,Munoz Sanchez; Alicia,10,0,20,10
1745791374513,LISP 5C,A00,896655,Munoz Sanchez; Alicia,4,0,20,16
1745791375540,MAE 197,001,957918,Kleissl; Jan,9998,0,9999,1
1745791376567,MATH 2,A01,957937,Staff,34,0,35,1
1745791377592,MATH 197,001,957876,Kedlaya; Kiran S.,9993,0,9999,6
1745791378618,MCWP 40,A00,892729,Duru; Nur,13,0,20,7
1745791378618,MCWP 40,B00,893304,Montejo; Carolina,20,0,20,0
1745791379647,MCWP 40R,A00,893757,Redela; Pamela Morgan,0,6,20,20
1745791380673,MCWP 50,A00,893758,Morshed; Michael James,2,0,20,18
1745791380673,MCWP 50,B00,893761,Bartulis; Jason Michael,17,0,20,3
1745791381703,MCWP 50R,A00,893766,Compas; Sean Matthew,0,1,20,20
1745791381703,MCWP 50R,B00,893769,Carter; Jennifer A,0,0,20,20
1745791381703,MCWP 50R,C00,893771,Krone; Jarret,0,3,20,20
1745791381703,MCWP 50R,D00,893772,Miller; Elizabeth Deen,3,0,20,17
1745791381703,MCWP 50R,E00,893775,Carter; Andrea L,0,0,20,20
1745791382728,MMW 11R,A01,892721,Herbst; Matthew,11,0,27,16
1745791382728,MMW 11R,A02,892722,Herbst; Matthew,0,0,0,3
1745791383754,MMW 12R,A01,892724,Herbst; Matthew,0,9,16,16
1745791383754,MMW 12R,A02,892725,Herbst; Matthew,0,9,16,16
1745791384779,MMW 13R,A01,892727,Staff,0,4,16,16
1745791384779,MMW 13R,A02,892728,Staff,0,4,16,16
1745791384779,MMW 13R,A03,958032,Staff,0,3,16,16
1745791384779,MMW 13R,A04,958033,Staff,0,2,16,16
1745791384779,MMW 13R,A05,958034,Staff,0,3,16,16
1745791385805,SIO 295LS,A00,894015,Staff,7,0,25,18
1745791386831,SIO 295S,A00,894020,Staff,7,0,25,18
1745791387856,SIOC 290S,B01,958918,Staff,0,0,0,0
1745791388881,SIOC 291S,B01,958922,Staff,0,0,0,0
1745791389909,SOCI 117,A01,895339,Staff,4,0,5,1
1745791390935,WES 237B,A00,894149,Staff,11,0,20,9
1745791392997,AESE 279B,A00,891859,Staff,13,0,35,22
1745791394023,AIP 197,001,891854,Staff,70,0,70,0
1745791395051,ANTH 289S,A00,891856,Gagneux; Pascal,12,0,12,0
1745791396080,BENG 196,001,957946,Engler; Adam J.,9996,0,9999,3
1745791397104,CAT 124RS,A01,956906,Staff,8,0,25,17
1745791398132,CAT 125RS,A01,922013,Staff,8,0,25,17
1745791399161,CLRE 250,A00,891860,Morris; Sheldon,9995,0,9999,4
1745791401213,CLRE 251R,A00,907817,Mehta; Ravindra L.,9994,0,9999,5
1745791402240,CLRE 252,A00,891864,Cuomo; Raphael Eduardo,9993,0,9999,6
1745791403270,CLRE 253,A00,891867,Vaida; Florin,9994,0,9999,5
1745791403270,CLRE 253,B00,907819,Staff,9999,0,9999,0
1745791404299,CLRE 259,A00,891868,Patel; Hemal,9998,0,9999,1
1745791405326,CLRE 260,A00,891872,Cuomo; Raphael Eduardo,9999,0,9999,0
1745791406355,CLRE 297,001,891888,Cuomo; Raphael Eduardo,9999,0,9999,0
1745791407380,CSE 191,A00,958773,Minnes Kemp; Mor Mia,9999,0,9999,0
1745791408407,CSS 201S,A01,892054,Mignozzetti; Umberto,30,0,30,0
1745791409432,CSS 202S,A01,892056,Mignozzetti; Umberto,30,0,30,0
1745791410458,DSC 197,001,956898,Eldridge; Justin Matthew,9998,0,9999,1
1745791411483,DSC 297,001,958000,Mazumdar; Arya,9998,0,9999,1
1745791412510,EAP 100,A00,905686,Staff,9776,0,9999,223
1745791413536,ECE 45,A01,892618,Staff,0,12,50,50
1745791414560,ECE 109,A01,892620,Staff,0,43,0,0
1745791415585,ECE 111,A01,892719,Staff,0,7,50,50
1745791416611,ECE 197,001,957920,Mercier; Patrick Philip,9992,0,9999,7
1745791417637,ECON 178,A01,907814,Zhu; Ying,28,0,35,7
1745791418666,EDS 115,A00,895312,Staff,41,0,45,4
1745791419694,EDS 117,A01,895337,Staff,30,0,30,0
1745791420719,EDS 125,A00,895341,Jones; Gabrielle Anastasia,43,0,45,2
1745791421746,EDS 128A,A01,895459,Fargason; Sharon Gayle,44,0,45,1
1745791422771,EDS 128B,A01,895543,Pappas; Elizabeth,44,0,45,1
1745791423795,EDS 139,A00,897203,Pappas; Elizabeth,44,0,45,1
1745791423795,EDS 139,B00,897209,Fargason; Sharon Gayle,44,0,45,1
1745791424820,EDS 201,A00,895545,Staff,43,0,45,2
1745791425849,EDS 203,A01,895581,Halter; Christopher P.,43,0,45,2
1745791426875,EDS 204R,A01,895625,Heinzman; Erica M.,43,0,45,2
1745791426875,EDS 204R,B01,895693,Halter; Christopher P.,18,0,45,27
1745791427904,EDS 206R,A00,895694,Fargason; Sharon Gayle,9,0,30,21
1745791427904,EDS 206R,B00,895695,Choi; Bailey Miyeon,20,0,30,10
1745791428933,EDS 250,A00,895697,Hemans; Patricia Ann Benitez,43,0,45,2
1745791429959,EDS 281,A00,895701,Meyerott; Theresa Ann,15,0,15,0
1745791430987,EDS 284,A00,895736,Meyerott; Theresa Ann,15,0,15,0
1745791432014,EDS 286,A00,897210,Fine; Sarah,15,0,15,0
1745791433040,EDS 289C,A01,895770,Daly; Alan J.,15,0,15,0
1745791434066,EDS 290,A00,897211,Hofstetter; Carolyn,15,0,15,0
1745791435095,LIGM 5A,A00,896162,Fischer-Grunski; Eva K,15,0,20,5
1745791436126,LIGM 5B,A00,896260,Fischer-Grunski; Eva K,17,0,20,3
1745791437153,LIGM 5C,A00,896308,Fischer-Grunski; Eva K,18,0,20,2
1745791438181,LIIT 5AS,A00,896313,Carnelos; Chiara,18,0,20,2
1745791439207,LIIT 5BS,A00,896416,Carnelos; Chiara,20,0,20,0
1745791440235,LIIT 5CS,A00,896564,Carnelos; Chiara,20,0,20,0
1745791441261,LISP 5A,A00,896588,Munoz Sanchez; Alicia,4,0,20,16
1745791442288,LISP 5B,A00,896653,Munoz Sanchez; Alicia,10,0,20,10
1745791443318,LISP 5C,A00,896655,Munoz Sanchez; Alicia,4,0,20,16
1745791444344,MAE 197,001,957918,Kleissl; Jan,9998,0,9999,1
1745791445372,MATH 2,A01,957937,Staff,34,0,35,1
1745791446400,MATH 197,001,957876,Kedlaya; Kiran S.,9993,0,9999,6
1745791447426,MCWP 40,A00,892729,Duru; Nur,13,0,20,7
1745791447426,MCWP 40,B00,893304,Montejo; Carolina,20,0,20,0
1745791448453,MCWP 40R,A00,893757,Redela; Pamela Morgan,0,6,20,20
1745791449481,MCWP 50,A00,893758,Morshed; Michael James,2,0,20,18
1745791449481,MCWP 50,B00,893761,Bartulis; Jason Michael,17,0,20,3
1745791450507,MCWP 50R,A00,893766,Compas; Sean Matthew,0,1,20,20
1745791450507,MCWP 50R,B00,893769,Carter; Jennifer A,0,0,20,20
1745791450507,MCWP 50R,C00,893771,Krone; Jarret,0,3,20,20
1745791450507,MCWP 50R,D00,893772,Miller; Elizabeth Deen,3,0,20,17
1745791450507,MCWP 50R,E00,893775,Carter; Andrea L,0,0,20,20
1745791451533,MMW 11R,A01,892721,Herbst; Matthew,11,0,27,16
1745791451533,MMW 11R,A02,892722,Herbst; Matthew,0,0,0,3
1745791452562,MMW 12R,A01,892724,Herbst; Matthew,0,9,16,16
1745791452562,MMW 12R,A02,892725,Herbst; Matthew,0,9,16,16
1745791453588,MMW 13R,A01,892727,Staff,0,4,16,16
1745791453588,MMW 13R,A02,892728,Staff,0,4,16,16
1745791453588,MMW 13R,A03,958032,Staff,0,3,16,16
1745791453588,MMW 13R,A04,958033,Staff,0,2,16,16
1745791453588,MMW 13R,A05,958034,Staff,0,3,16,16
1745791454614,SIO 295LS,A00,894015,Staff,7,0,25,18
1745791455641,SIO 295S,A00,894020,Staff,7,0,25,18
1745791456669,SIOC 290S,B01,958918,Staff,0,0,0,0
1745791457696,SIOC 291S,B01,958922,Staff,0,0,0,0
1745791458722,SOCI 117,A01,895339,Staff,4,0,5,1
1745791459746,WES 237B,A00,894149,Staff,11,0,20,9
1745791461808,AESE 279B,A00,891859,Staff,13,0,35,22
1745791462833,AIP 197,001,891854,Staff,70,0,70,0
1745791463899,ANTH 289S,A00,891856,Gagneux; Pascal,12,0,12,0
1745791464930,BENG 196,001,957946,Engler; Adam J.,9996,0,9999,3
1745791465958,CAT 124RS,A01,956906,Staff,8,0,25,17
1745791466984,CAT 125RS,A01,922013,Staff,8,0,25,17
1745791468012,CLRE 250,A00,891860,Morris; Sheldon,9995,0,9999,4
1745791470066,CLRE 251R,A00,907817,Mehta; Ravindra L.,9994,0,9999,5
1745791471095,CLRE 252,A00,891864,Cuomo; Raphael Eduardo,9993,0,9999,6
1745791472121,CLRE 253,A00,891867,Vaida; Florin,9994,0,9999,5
1745791472121,CLRE 253,B00,907819,Staff,9999,0,9999,0
1745791473148,CLRE 259,A00,891868,Patel; Hemal,9998,0,9999,1
1745791474176,CLRE 260,A00,891872,Cuomo; Raphael Eduardo,9999,0,9999,0
1745791475206,CLRE 297,001,891888,Cuomo; Raphael Eduardo,9999,0,9999,0
1745791476232,CSE 191,A00,958773,Minnes Kemp; Mor Mia,9999,0,9999,0
1745791477263,CSS 201S,A01,892054,Mignozzetti; Umberto,30,0,30,0
1745791478291,CSS 202S,A01,892056,Mignozzetti; Umberto,30,0,30,0
1745791479319,DSC 197,001,956898,Eldridge; Justin Matthew,9998,0,9999,1
1745791480348,DSC 297,001,958000,Mazumdar; Arya,9998,0,9999,1
1745791481375,EAP 100,A00,905686,Staff,9776,0,9999,223
1745791482407,ECE 45,A01,892618,Staff,0,12,50,50
1745791483433,ECE 109,A01,892620,Staff,0,43,0,0
1745791484459,ECE 111,A01,892719,Staff,0,7,50,50
1745791485485,ECE 197,001,957920,Mercier; Patrick Philip,9992,0,9999,7
1745791486510,ECON 178,A01,907814,Zhu; Ying,28,0,35,7
1745791487539,EDS 115,A00,895312,Staff,41,0,45,4
1745791488566,EDS 117,A01,895337,Staff,30,0,30,0
1745791489593,EDS 125,A00,895341,Jones; Gabrielle Anastasia,43,0,45,2
1745791490621,EDS 128A,A01,895459,Fargason; Sharon Gayle,44,0,45,1
1745791491650,EDS 128B,A01,895543,Pappas; Elizabeth,44,0,45,1
1745791492678,EDS 139,A00,897203,Pappas; Elizabeth,44,0,45,1
1745791492678,EDS 139,B00,897209,Fargason; Sharon Gayle,44,0,45,1
1745791493706,EDS 201,A00,895545,Staff,43,0,45,2
1745791494731,EDS 203,A01,895581,Halter; Christopher P.,43,0,45,2
1745791495758,EDS 204R,A01,895625,Heinzman; Erica M.,43,0,45,2
1745791495758,EDS 204R,B01,895693,Halter; Christopher P.,18,0,45,27
1745791496785,EDS 206R,A00,895694,Fargason; Sharon Gayle,9,0,30,21
1745791496785,EDS 206R,B00,895695,Choi; Bailey Miyeon,20,0,30,10
1745791497812,EDS 250,A00,895697,Hemans; Patricia Ann Benitez,43,0,45,2
1745791498845,EDS 281,A00,895701,Meyerott; Theresa Ann,15,0,15,0
1745791499874,EDS 284,A00,895736,Meyerott; Theresa Ann,15,0,15,0
1745791500902,EDS 286,A00,897210,Fine; Sarah,15,0,15,0
1745791501930,EDS 289C,A01,895770,Daly; Alan J.,15,0,15,0
1745791502963,EDS 290,A00,897211,Hofstetter; Carolyn,15,0,15,0
1745791503996,LIGM 5A,A00,896162,Fischer-Grunski; Eva K,15,0,20,5
1745791505024,LIGM 5B,A00,896260,Fischer-Grunski; Eva K,17,0,20,3
1745791506051,LIGM 5C,A00,896308,Fischer-Grunski; Eva K,18,0,20,2
1745791507079,LIIT 5AS,A00,896313,Carnelos; Chiara,18,0,20,2
1745791508133,LIIT 5BS,A00,896416,Carnelos; Chiara,20,0,20,0
1745791509159,LIIT 5CS,A00,896564,Carnelos; Chiara,20,0,20,0
1745791510186,LISP 5A,A00,896588,Munoz Sanchez; Alicia,4,0,20,16
1745791511213,LISP 5B,A00,896653,Munoz Sanchez; Alicia,10,0,20,10
1745791512242,LISP 5C,A00,896655,Munoz Sanchez; Alicia,4,0,20,16
1745791513271,MAE 197,001,957918,Kleissl; Jan,9998,0,9999,1
1745791514295,MATH 2,A01,957937,Staff,34,0,35,1
1745791515323,MATH 197,001,957876,Kedlaya; Kiran S.,9993,0,9999,6
1745791516349,MCWP 40,A00,892729,Duru; Nur,13,0,20,7
1745791516349,MCWP 40,B00,893304,Montejo; Carolina,20,0,20,0
1745791517376,MCWP 40R,A00,893757,Redela; Pamela Morgan,0,6,20,20
1745791518403,MCWP 50,A00,893758,Morshed; Michael James,2,0,20,18
1745791518403,MCWP 50,B00,893761,Bartulis; Jason Michael,17,0,20,3
1745791519430,MCWP 50R,A00,893766,Compas; Sean Matthew,0,1,20,20
1745791519430,MCWP 50R,B00,893769,Carter; Jennifer A,0,0,20,20
1745791519430,MCWP 50R,C00,893771,Krone; Jarret,0,3,20,20
1745791519430,MCWP 50R,D00,893772,Miller; Elizabeth Deen,3,0,20,17
1745791519430,MCWP 50R,E00,893775,Carter; Andrea L,0,0,20,20
1745791520456,MMW 11R,A01,892721,Herbst; Matthew,11,0,27,16
1745791520456,MMW 11R,A02,892722,Herbst; Matthew,0,0,0,3
1745791521484,MMW 12R,A01,892724,Herbst; Matthew,0,9,16,16
1745791521484,MMW 12R,A02,892725,Herbst; Matthew,0,9,16,16
1745791522513,MMW 13R,A01,892727,Staff,0,4,16,16
1745791522513,MMW 13R,A02,892728,Staff,0,4,16,16
1745791522513,MMW 13R,A03,958032,Staff,0,3,16,16
1745791522513,MMW 13R,A04,958033,Staff,0,2,16,16
1745791522513,MMW 13R,A05,958034,Staff,0,3,16,16
1745791523538,SIO 295LS,A00,894015,Staff,7,0,25,18
1745791524565,SIO 295S,A00,894020,Staff,7,0,25,18
1745791525589,SIOC 290S,B01,958918,Staff,0,0,0,0
1745791526615,SIOC 291S,B01,958922,Staff,0,0,0,0
1745791527642,SOCI 117,A01,895339,Staff,4,0,5,1
1745791528668,WES 237B,A00,894149,Staff,11,0,20,9
1745791530725,AESE 279B,A00,891859,Staff,13,0,35,22
1745791531751,AIP 197,001,891854,Staff,70,0,70,0
1745791532778,ANTH 289S,A00,891856,Gagneux; Pascal,12,0,12,0
1745791533805,BENG 196,001,957946,Engler; Adam J.,9996,0,9999,3
1745791534832,CAT 124RS,A01,956906,Staff,8,0,25,17
1745791535861,CAT 125RS,A01,922013,Staff,8,0,25,17
1745791536889,CLRE 250,A00,891860,Morris; Sheldon,9995,0,9999,4
1745791538945,CLRE 251R,A00,907817,Mehta; Ravindra L.,9994,0,9999,5
1745791539972,CLRE 252,A00,891864,Cuomo; Raphael Eduardo,9993,0,9999,6
1745791541001,CLRE 253,A00,891867,Vaida; Florin,9994,0,9999,5
1745791541001,CLRE 253,B00,907819,Staff,9999,0,9999,0
1745791542028,CLRE 259,A00,891868,Patel; Hemal,9998,0,9999,1
1745791543055,CLRE 260,A00,891872,Cuomo; Raphael Eduardo,9999,0,9999,0
1745791544082,CLRE 297,001,891888,Cuomo; Raphael Eduardo,9999,0,9999,0
1745791545111,CSE 191,A00,958773,Minnes Kemp; Mor Mia,9999,0,9999,0
1745791546142,CSS 201S,A01,892054,Mignozzetti; Umberto,30,0,30,0
1745791547168,CSS 202S,A01,892056,Mignozzetti; Umberto,30,0,30,0
1745791548195,DSC 197,001,956898,Eldridge; Justin Matthew,9998,0,9999,1
1745791549223,DSC 297,001,958000,Mazumdar; Arya,9998,0,9999,1
1745791550252,EAP 100,A00,905686,Staff,9776,0,9999,223
1745791551278,ECE 45,A01,892618,Staff,0,12,50,50
1745791552303,ECE 109,A01,892620,Staff,0,43,0,0
1745791553331,ECE 111,A01,892719,Staff,0,7,50,50
1745791554357,ECE 197,001,957920,Mercier; Patrick Philip,9992,0,9999,7
1745791555387,ECON 178,A01,907814,Zhu; Ying,28,0,35,7
1745791556415,EDS 115,A00,895312,Staff,41,0,45,4
1745791557441,EDS 117,A01,895337,Staff,30,0,30,0
1745791558468,EDS 125,A00,895341,Jones; Gabrielle Anastasia,43,0,45,2
1745791559498,EDS 128A,A01,895459,Fargason; Sharon Gayle,44,0,45,1
1745791560524,EDS 128B,A01,895543,Pappas; Elizabeth,44,0,45,1
1745791561552,EDS 139,A00,897203,Pappas; Elizabeth,44,0,45,1
1745791561552,EDS 139,B00,897209,Fargason; Sharon Gayle,44,0,45,1
1745791562581,EDS 201,A00,895545,Staff,43,0,45,2
1745791563611,EDS 203,A01,895581,Halter; Christopher P.,43,0,45,2
1745791564636,EDS 204R,A01,895625,Heinzman; Erica M.,43,0,45,2
1745791564636,EDS 204R,B01,895693,Halter; Christopher P.,18,0,45,27
1745791565665,EDS 206R,A00,895694,Fargason; Sharon Gayle,9,0,30,21
1745791565665,EDS 206R,B00,895695,Choi; Bailey Miyeon,20,0,30,10
1745791566691,EDS 250,A00,895697,Hemans; Patricia Ann Benitez,43,0,45,2
1745791567718,EDS 281,A00,895701,Meyerott; Theresa Ann,15,0,15,0
1745791568747,EDS 284,A00,895736,Meyerott; Theresa Ann,15,0,15,0
1745791569775,EDS 286,A00,897210,Fine; Sarah,15,0,15,0
1745791570802,EDS 289C,A01,895770,Daly; Alan J.,15,0,15,0
1745791571831,EDS 290,A00,897211,Hofstetter; Carolyn,15,0,15,0
1745791572859,LIGM 5A,A00,896162,Fischer-Grunski; Eva K,15,0,20,5
1745791573888,LIGM 5B,A00,896260,Fischer-Grunski; Eva K,17,0,20,3
1745791574914,LIGM 5C,A00,896308,Fischer-Grunski; Eva K,18,0,20,2
1745791575943,LIIT 5AS,A00,896313,Carnelos; Chiara,18,0,20,2
1745791576974,LIIT 5BS,A00,896416,Carnelos; Chiara,20,0,20,0
1745791578000,LIIT 5CS,A00,896564,Carnelos; Chiara,20,0,20,0
1745791579029,LISP 5A,A00,896588,Munoz Sanchez; Alicia,4,0,20,16
1745791580056,LISP 5B,A00,896653,Munoz Sanchez; Alicia,10,0,20,10
1745791581082,LISP 5C,A00,896655,Munoz Sanchez; Alicia,4,0,20,16
1745791582108,MAE 197,001,957918,Kleissl; Jan,9998,0,9999,1
1745791583137,MATH 2,A01,957937,Staff,34,0,35,1
1745791584165,MATH 197,001,957876,Kedlaya; Kiran S.,9993,0,9999,6
1745791585193,MCWP 40,A00,892729,Duru; Nur,13,0,20,7
1745791585193,MCWP 40,B00,893304,Montejo; Carolina,20,0,20,0
1745791586220,MCWP 40R,A00,893757,Redela; Pamela Morgan,0,6,20,20
1745791587249,MCWP 50,A00,893758,Morshed; Michael James,2,0,20,18
1745791587249,MCWP 50,B00,893761,Bartulis; Jason Michael,17,0,20,3
1745791588274,MCWP 50R,A00,893766,Compas; Sean Matthew,0,1,20,20
1745791588274,MCWP 50R,B00,893769,Carter; Jennifer A,0,0,20,20
1745791588274,MCWP 50R,C00,893771,Krone; Jarret,0,3,20,20
1745791588274,MCWP 50R,D00,893772,Miller; Elizabeth Deen,3,0,20,17
1745791588274,MCWP 50R,E00,893775,Carter; Andrea L,0,0,20,20
1745791589302,MMW 11R,A01,892721,Herbst; Matthew,11,0,27,16
1745791589302,MMW 11R,A02,892722,Herbst; Matthew,0,0,0,3
1745791590331,MMW 12R,A01,892724,Herbst; Matthew,0,9,16,16
1745791590331,MMW 12R,A02,892725,Herbst; Matthew,0,9,16,16
1745791591361,MMW 13R,A01,892727,Staff,0,4,16,16
1745791591361,MMW 13R,A02,892728,Staff,0,4,16,16
1745791591361,MMW 13R,A03,958032,Staff,0,3,16,16
1745791591361,MMW 13R,A04,958033,Staff,0,2,16,16
1745791591361,MMW 13R,A05,958034,Staff,0,3,16,16
1745791592392,SIO 295LS,A00,894015,Staff,7,0,25,18
1745791593418,SIO 295S,A00,894020,Staff,7,0,25,18
1745791594448,SIOC 290S,B01,958918,Staff,0,0,0,0
1745791595473,SIOC 291S,B01,958922,Staff,0,0,0,0
1745791596500,SOCI 117,A01,895339,Staff,4,0,5,1
1745791597529,WES 237B,A00,894149,Staff,11,0,20,9
1745791599595,AESE 279B,A00,891859,Staff,13,0,35,22
1745791600620,AIP 197,001,891854,Staff,70,0,70,0
1745791601650,ANTH 289S,A00,891856,Gagneux; Pascal,12,0,12,0
1745791602676,BENG 196,001,957946,Engler; Adam J.,9996,0,9999,3
1745791603702,CAT 124RS,A01,956906,Staff,8,0,25,17
1745791604731,CAT 125RS,A01,922013,Staff,8,0,25,17
1745791605756,CLRE 250,A00,891860,Morris; Sheldon,9995,0,9999,4
1745791607811,CLRE 251R,A00,907817,Mehta; Ravindra L.,9994,0,9999,5
1745791608838,CLRE 252,A00,891864,Cuomo; Raphael Eduardo,9993,0,9999,6
1745791609864,CLRE 253,A00,891867,Vaida; Florin,9994,0,9999,5
1745791609864,CLRE 253,B00,907819,Staff,9999,0,9999,0
1745791610892,CLRE 259,A00,891868,Patel; Hemal,9998,0,9999,1
1745791611920,CLRE 260,A00,891872,Cuomo; Raphael Eduardo,9999,0,9999,0
1745791612946,CLRE 297,001,891888,Cuomo; Raphael Eduardo,9999,0,9999,0
1745791613974,CSE 191,A00,958773,Minnes Kemp; Mor Mia,9999,0,9999,0
1745791614999,CSS 201S,A01,892054,Mignozzetti; Umberto,30,0,30,0
1745791616025,CSS 202S,A01,892056,Mignozzetti; Umberto,30,0,30,0
1745791617051,DSC 197,001,956898,Eldridge; Justin Matthew,9998,0,9999,1
1745791618079,DSC 297,001,958000,Mazumdar; Arya,9998,0,9999,1
1745791619105,EAP 100,A00,905686,Staff,9776,0,9999,223
1745791620136,ECE 45,A01,892618,Staff,0,12,50,50
1745791621162,ECE 109,A01,892620,Staff,0,43,0,0
1745791622188,ECE 111,A01,892719,Staff,0,7,50,50
1745791623217,ECE 197,001,957920,Mercier; Patrick Philip,9992,0,9999,7
1745791624248,ECON 178,A01,907814,Zhu; Ying,28,0,35,7
1745791625274,EDS 115,A00,895312,Staff,41,0,45,4
1745791626300,EDS 117,A01,895337,Staff,30,0,30,0
1745791627327,EDS 125,A00,895341,Jones; Gabrielle Anastasia,43,0,45,2
1745791628354,EDS 128A,A01,895459,Fargason; Sharon Gayle,44,0,45,1
1745791629381,EDS 128B,A01,895543,Pappas; Elizabeth,44,0,45,1
1745791630409,EDS 139,A00,897203,Pappas; Elizabeth,44,0,45,1
1745791630409,EDS 139,B00,897209,Fargason; Sharon Gayle,44,0,45,1
1745791631437,EDS 201,A00,895545,Staff,43,0,45,2
1745791632463,EDS 203,A01,895581,Halter; Christopher P.,43,0,45,2
1745791633488,EDS 204R,A01,895625,Heinzman; Erica M.,43,0,45,2
1745791633488,EDS 204R,B01,895693,Halter; Christopher P.,18,0,45,27
1745791634514,EDS 206R,A00,895694,Fargason; Sharon Gayle,9,0,30,21
1745791634514,EDS 206R,B00,895695,Choi; Bailey Miyeon,20,0,30,10
1745791635544,EDS 250,A00,895697,Hemans; Patricia Ann Benitez,43,0,45,2
1745791636568,EDS 281,A00,895701,Meyerott; Theresa Ann,15,0,15,0
1745791637596,EDS 284,A00,895736,Meyerott; Theresa Ann,15,0,15,0
1745791638627,EDS 286,A00,897210,Fine; Sarah,15,0,15,0
1745791639652,EDS 289C,A01,895770,Daly; Alan J.,15,0,15,0
1745791640680,EDS 290,A00,897211,Hofstetter; Carolyn,15,0,15,0
1745791641709,LIGM 5A,A00,896162,Fischer-Grunski; Eva K,15,0,20,5
1745791642734,LIGM 5B,A00,896260,Fischer-Grunski; Eva K,17,0,20,3
1745791643762,LIGM 5C,A00,896308,Fischer-Grunski; Eva K,18,0,20,2
1745791644793,LIIT 5AS,A00,896313,Carnelos; Chiara,18,0,20,2
1745791645822,LIIT 5BS,A00,896416,Carnelos; Chiara,20,0,20,0
1745791646847,LIIT 5CS,A00,896564,Carnelos; Chiara,20,0,20,0
1745791647873,LISP 5A,A00,896588,Munoz Sanchez; Alicia,4,0,20,16
1745791648898,LISP 5B,A00,896653,Munoz Sanchez; Alicia,10,0,20,10
1745791649925,LISP 5C,A00,896655,Munoz Sanchez; Alicia,4,0,20,16
1745791650951,MAE 197,001,957918,Kleissl; Jan,9998,0,9999,1
1745791651978,MATH 2,A01,957937,Staff,34,0,35,1
1745791653007,MATH 197,001,957876,Kedlaya; Kiran S.,9993,0,9999,6
1745791654033,MCWP 40,A00,892729,Duru; Nur,13,0,20,7
1745791654033,MCWP 40,B00,893304,Montejo; Carolina,20,0,20,0
1745791655059,MCWP 40R,A00,893757,Redela; Pamela Morgan,0,6,20,20
1745791656084,MCWP 50,A00,893758,Morshed; Michael James,2,0,20,18
1745791656084,MCWP 50,B00,893761,Bartulis; Jason Michael,17,0,20,3
1745791657115,MCWP 50R,A00,893766,Compas; Sean Matthew,0,1,20,20
1745791657115,MCWP 50R,B00,893769,Carter; Jennifer A,0,0,20,20
1745791657115,MCWP 50R,C00,893771,Krone; Jarret,0,3,20,20
1745791657115,MCWP 50R,D00,893772,Miller; Elizabeth Deen,3,0,20,17
1745791657115,MCWP 50R,E00,893775,Carter; Andrea L,0,0,20,20
1745791658141,MMW 11R,A01,892721,Herbst; Matthew,11,0,27,16
1745791658141,MMW 11R,A02,892722,Herbst; Matthew,0,0,0,3
1745791659168,MMW 12R,A01,892724,Herbst; Matthew,0,9,16,16
1745791659168,MMW 12R,A02,892725,Herbst; Matthew,0,9,16,16
1745791660197,MMW 13R,A01,892727,Staff,0,4,16,16
1745791660197,MMW 13R,A02,892728,Staff,0,4,16,16
1745791660197,MMW 13R,A03,958032,Staff,0,3,16,16
1745791660197,MMW 13R,A04,958033,Staff,0,2,16,16
1745791660197,MMW 13R,A05,958034,Staff,0,3,16,16
1745791661224,SIO 295LS,A00,894015,Staff,7,0,25,18
1745791662254,SIO 295S,A00,894020,Staff,7,0,25,18
1745791663282,SIOC 290S,B01,958918,Staff,0,0,0,0
1745791664313,SIOC 291S,B01,958922,Staff,0,0,0,0
1745791665342,SOCI 117,A01,895339,Staff,4,0,5,1
1745791666373,WES 237B,A00,894149,Staff,11,0,20,9
1745791668438,AESE 279B,A00,891859,Staff,13,0,35,22
1745791669463,AIP 197,001,891854,Staff,70,0,70,0
1745791670491,ANTH 289S,A00,891856,Gagneux; Pascal,12,0,12,0
1745791671517,BENG 196,001,957946,Engler; Adam J.,9996,0,9999,3
1745791672542,CAT 124RS,A01,956906,Staff,8,0,25,17
1745791673568,CAT 125RS,A01,922013,Staff,8,0,25,17
1745791674594,CLRE 250,A00,891860,Morris; Sheldon,9995,0,9999,4
1745791676646,CLRE 251R,A00,907817,Mehta; Ravindra L.,9994,0,9999,5
1745791677674,CLRE 252,A00,891864,Cuomo; Raphael Eduardo,9993,0,9999,6
1745791678701,CLRE 253,A00,891867,Vaida; Florin,9994,0,9999,5
1745791678701,CLRE 253,B00,907819,Staff,9999,0,9999,0
1745791679729,CLRE 259,A00,891868,Patel; Hemal,9998,0,9999,1
1745791680756,CLRE 260,A00,891872,Cuomo; Raphael Eduardo,9999,0,9999,0
1745791681784,CLRE 297,001,891888,Cuomo; Raphael Eduardo,9999,0,9999,0
1745791682811,CSE 191,A00,958773,Minnes Kemp; Mor Mia,9999,0,9999,0
1745791683842,CSS 201S,A01,892054,Mignozzetti; Umberto,30,0,30,0
1745791684870,CSS 202S,A01,892056,Mignozzetti; Umberto,30,0,30,0
1745791685895,DSC 197,001,956898,Eldridge; Justin Matthew,9998,0,9999,1
1745791686924,DSC 297,001,958000,Mazumdar; Arya,9998,0,9999,1
1745791687950,EAP 100,A00,905686,Staff,9776,0,9999,223
1745791688978,ECE 45,A01,892618,Staff,0,12,50,50
1745791690003,ECE 109,A01,892620,Staff,0,43,0,0
1745791691029,ECE 111,A01,892719,Staff,0,7,50,50
1745791692053,ECE 197,001,957920,Mercier; Patrick Philip,9992,0,9999,7
1745791693080,ECON 178,A01,907814,Zhu; Ying,28,0,35,7
1745791694105,EDS 115,A00,895312,Staff,41,0,45,4
1745791695134,EDS 117,A01,895337,Staff,30,0,30,0
1745791696202,EDS 125,A00,895341,Jones; Gabrielle Anastasia,43,0,45,2
1745791697228,EDS 128A,A01,895459,Fargason; Sharon Gayle,44,0,45,1
1745791698257,EDS 128B,A01,895543,Pappas; Elizabeth,44,0,45,1
1745791699284,EDS 139,A00,897203,Pappas; Elizabeth,44,0,45,1
1745791699284,EDS 139,B00,897209,Fargason; Sharon Gayle,44,0,45,1
1745791700313,EDS 201,A00,895545,Staff,43,0,45,2
1745791701339,EDS 203,A01,895581,Halter; Christopher P.,43,0,45,2
1745791702369,EDS 204R,A01,895625,Heinzman; Erica M.,43,0,45,2
1745791702369,EDS 204R,B01,895693,Halter; Christopher P.,18,0,45,27
1745791703394,EDS 206R,A00,895694,Fargason; Sharon Gayle,9,0,30,21
1745791703394,EDS 206R,B00,895695,Choi; Bailey Miyeon,20,0,30,10
1745791704424,EDS 250,A00,895697,Hemans; Patricia Ann Benitez,43,0,45,2
1745791705449,EDS 281,A00,895701,Meyerott; Theresa Ann,15,0,15,0
1745791706474,EDS 284,A00,895736,Meyerott; Theresa Ann,15,0,15,0
1745791707501,EDS 286,A00,897210,Fine; Sarah,15,0,15,0
1745791708525,EDS 289C,A01,895770,Daly; Alan J.,15,0,15,0
1745791709555,EDS 290,A00,897211,Hofstetter; Carolyn,15,0,15,0
1745791710581,LIGM 5A,A00,896162,Fischer-Grunski; Eva K,15,0,20,5
1745791711610,LIGM 5B,A00,896260,Fischer-Grunski; Eva K,17,0,20,3
1745791712639,LIGM 5C,A00,896308,Fischer-Grunski; Eva K,18,0,20,2
1745791713666,LIIT 5AS,A00,896313,Carnelos; Chiara,18,0,20,2
1745791714695,LIIT 5BS,A00,896416,Carnelos; Chiara,20,0,20,0
1745791715726,LIIT 5CS,A00,896564,Carnelos; Chiara,20,0,20,0
1745791716752,LISP 5A,A00,896588,Munoz Sanchez; Alicia,4,0,20,16
1745791717781,LISP 5B,A00,896653,Munoz Sanchez; Alicia,10,0,20,10
1745791718881,LISP 5C,A00,896655,Munoz Sanchez; Alicia,4,0,20,16
1745791719910,MAE 197,001,957918,Kleissl; Jan,9998,0,9999,1
1745791720936,MATH 2,A01,957937,Staff,34,0,35,1
1745791721967,MATH 197,001,957876,Kedlaya; Kiran S.,9993,0,9999,6
1745791722998,MCWP 40,A00,892729,Duru; Nur,13,0,20,7
1745791722998,MCWP 40,B00,893304,Montejo; Carolina,20,0,20,0
1745791724025,MCWP 40R,A00,893757,Redela; Pamela Morgan,0,6,20,20
1745791725055,MCWP 50,A00,893758,Morshed; Michael James,2,0,20,18
1745791725055,MCWP 50,B00,893761,Bartulis; Jason Michael,17,0,20,3
1745791726081,MCWP 50R,A00,893766,Compas; Sean Matthew,0,1,20,20
1745791726081,MCWP 50R,B00,893769,Carter; Jennifer A,0,0,20,20
1745791726081,MCWP 50R,C00,893771,Krone; Jarret,0,3,20,20
1745791726081,MCWP 50R,D00,893772,Miller; Elizabeth Deen,3,0,20,17
1745791726081,MCWP 50R,E00,893775,Carter; Andrea L,0,0,20,20
1745791727108,MMW 11R,A01,892721,Herbst; Matthew,11,0,27,16
1745791727108,MMW 11R,A02,892722,Herbst; Matthew,0,0,0,3
1745791728135,MMW 12R,A01,892724,Herbst; Matthew,0,9,16,16
1745791728135,MMW 12R,A02,892725,Herbst; Matthew,0,9,16,16
1745791729164,MMW 13R,A01,892727,Staff,0,4,16,16
1745791729164,MMW 13R,A02,892728,Staff,0,4,16,16
1745791729164,MMW 13R,A03,958032,Staff,0,3,16,16
1745791729164,MMW 13R,A04,958033,Staff,0,2,16,16
1745791729164,MMW 13R,A05,958034,Staff,0,3,16,16
1745791730189,SIO 295LS,A00,894015,Staff,7,0,25,18
1745791731215,SIO 295S,A00,894020,Staff,7,0,25,18
1745791732242,SIOC 290S,B01,958918,Staff,0,0,0,0
1745791733270,SIOC 291S,B01,958922,Staff,0,0,0,0
1745791734300,SOCI 117,A01,895339,Staff,4,0,5,1
1745791735326,WES 237B,A00,894149,Staff,11,0,20,9
1745791737389,AESE 279B,A00,891859,Staff,13,0,35,22
1745791738417,AIP 197,001,891854,Staff,70,0,70,0
1745791739444,ANTH 289S,A00,891856,Gagneux; Pascal,12,0,12,0
1745791740469,BENG 196,001,957946,Engler; Adam J.,9996,0,9999,3
1745791741497,CAT 124RS,A01,956906,Staff,8,0,25,17
1745791742529,CAT 125RS,A01,922013,Staff,8,0,25,17
1745791743563,CLRE 250,A00,891860,Morris; Sheldon,9995,0,9999,4
1745791745615,CLRE 251R,A00,907817,Mehta; Ravindra L.,9994,0,9999,5
1745791746641,CLRE 252,A00,891864,Cuomo; Raphael Eduardo,9993,0,9999,6
1745791747666,CLRE 253,A00,891867,Vaida; Florin,9994,0,9999,5
1745791747666,CLRE 253,B00,907819,Staff,9999,0,9999,0
1745791748693,CLRE 259,A00,891868,Patel; Hemal,9998,0,9999,1
1745791749719,CLRE 260,A00,891872,Cuomo; Raphael Eduardo,9999,0,9999,0
1745791750745,CLRE 297,001,891888,Cuomo; Raphael Eduardo,9999,0,9999,0
1745791751772,CSE 191,A00,958773,Minnes Kemp; Mor Mia,9999,0,9999,0
1745791752799,CSS 201S,A01,892054,Mignozzetti; Umberto,30,0,30,0
1745791753829,CSS 202S,A01,892056,Mignozzetti; Umberto,30,0,30,0
1745791754859,DSC 197,001,956898,Eldridge; Justin Matthew,9998,0,9999,1
1745791755886,DSC 297,001,958000,Mazumdar; Arya,9998,0,9999,1
1745791756910,EAP 100,A00,905686,Staff,9776,0,9999,223
1745791757938,ECE 45,A01,892618,Staff,0,12,50,50
1745791758964,ECE 109,A01,892620,Staff,0,43,0,0
1745791759992,ECE 111,A01,892719,Staff,0,7,50,50
1745791761018,ECE 197,001,957920,Mercier; Patrick Philip,9992,0,9999,7
1745791762043,ECON 178,A01,907814,Zhu; Ying,28,0,35,7
1745791763072,EDS 115,A00,895312,Staff,41,0,45,4
1745791764098,EDS 117,A01,895337,Staff,30,0,30,0
1745791765129,EDS 125,A00,895341,Jones; Gabrielle Anastasia,43,0,45,2
1745791766155,EDS 128A,A01,895459,Fargason; Sharon Gayle,44,0,45,1
1745791767185,EDS 128B,A01,895543,Pappas; Elizabeth,44,0,45,1
1745791768213,EDS 139,A00,897203,Pappas; Elizabeth,44,0,45,1
1745791768213,EDS 139,B00,897209,Fargason; Sharon Gayle,44,0,45,1
1745791769242,EDS 201,A00,895545,Staff,43,0,45,2
1745791770271,EDS 203,A01,895581,Halter; Christopher P.,43,0,45,2
1745791771300,EDS 204R,A01,895625,Heinzman; Erica M.,43,0,45,2
1745791771300,EDS 204R,B01,895693,Halter; Christopher P.,18,0,45,27
1745791772330,EDS 206R,A00,895694,Fargason; Sharon Gayle,9,0,30,21
1745791772330,EDS 206R,B00,895695,Choi; Bailey Miyeon,20,0,30,10
1745791773357,EDS 250,A00,895697,Hemans; Patricia Ann Benitez,43,0,45,2
1745791774386,EDS 281,A00,895701,Meyerott; Theresa Ann,15,0,15,0
1745791775412,EDS 284,A00,895736,Meyerott; Theresa Ann,15,0,15,0
1745791776438,EDS 286,A00,897210,Fine; Sarah,15,0,15,0
1745791777465,EDS 289C,A01,895770,Daly; Alan J.,15,0,15,0
1745791778492,EDS 290,A00,897211,Hofstetter; Carolyn,15,0,15,0
1745791779519,LIGM 5A,A00,896162,Fischer-Grunski; Eva K,15,0,20,5
1745791780546,LIGM 5B,A00,896260,Fischer-Grunski; Eva K,17,0,20,3
1745791781573,LIGM 5C,A00,896308,Fischer-Grunski; Eva K,18,0,20,2
1745791782602,LIIT 5AS,A00,896313,Carnelos; Chiara,18,0,20,2
1745791783627,LIIT 5BS,A00,896416,Carnelos; Chiara,20,0,20,0
1745791784656,LIIT 5CS,A00,896564,Carnelos; Chiara,20,0,20,0
1745791785685,LISP 5A,A00,896588,Munoz Sanchez; Alicia,4,0,20,16
1745791786711,LISP 5B,A00,896653,Munoz Sanchez; Alicia,10,0,20,10
1745791787739,LISP 5C,A00,896655,Munoz Sanchez; Alicia,4,0,20,16
1745791788767,MAE 197,001,957918,Kleissl; Jan,9998,0,9999,1
1745791789792,MATH 2,A01,957937,Staff,34,0,35,1
1745791790821,MATH 197,001,957876,Kedlaya; Kiran S.,9993,0,9999,6
1745791791847,MCWP 40,A00,892729,Duru; Nur,13,0,20,7
1745791791847,MCWP 40,B00,893304,Montejo; Carolina,20,0,20,0
1745791792875,MCWP 40R,A00,893757,Redela; Pamela Morgan,0,6,20,20
1745791793902,MCWP 50,A00,893758,Morshed; Michael James,2,0,20,18
1745791793902,MCWP 50,B00,893761,Bartulis; Jason Michael,17,0,20,3
1745791794928,MCWP 50R,A00,893766,Compas; Sean Matthew,0,1,20,20
1745791794928,MCWP 50R,B00,893769,Carter; Jennifer A,0,0,20,20
1745791794928,MCWP 50R,C00,893771,Krone; Jarret,0,3,20,20
1745791794928,MCWP 50R,D00,893772,Miller; Elizabeth Deen,3,0,20,17
1745791794928,MCWP 50R,E00,893775,Carter; Andrea L,0,0,20,20
1745791795958,MMW 11R,A01,892721,Herbst; Matthew,11,0,27,16
1745791795958,MMW 11R,A02,892722,Herbst; Matthew,0,0,0,3
1745791796987,MMW 12R,A01,892724,Herbst; Matthew,0,9,16,16
1745791796987,MMW 12R,A02,892725,Herbst; Matthew,0,9,16,16
1745791798014,MMW 13R,A01,892727,Staff,0,4,16,16
1745791798014,MMW 13R,A02,892728,Staff,0,4,16,16
1745791798014,MMW 13R,A03,958032,Staff,0,3,16,16
1745791798014,MMW 13R,A04,958033,Staff,0,2,16,16
1745791798014,MMW 13R,A05,958034,Staff,0,3,16,16
1745791799040,SIO 295LS,A00,894015,Staff,7,0,25,18
1745791800070,SIO 295S,A00,894020,Staff,7,0,25,18
1745791801096,SIOC 290S,B01,958918,Staff,0,0,0,0
1745791802129,SIOC 291S,B01,958922,Staff,0,0,0,0
1745791803158,SOCI 117,A01,895339,Staff,4,0,5,1
1745791804186,WES 237B,A00,894149,Staff,11,0,20,9
1745791806248,AESE 279B,A00,891859,Staff,13,0,35,22
1745791807274,AIP 197,001,891854,Staff,70,0,70,0
1745791808305,ANTH 289S,A00,891856,Gagneux; Pascal,12,0,12,0
1745791809331,BENG 196,001,957946,Engler; Adam J.,9996,0,9999,3
1745791810361,CAT 124RS,A01,956906,Staff,8,0,25,17
1745791811387,CAT 125RS,A01,922013,Staff,8,0,25,17
1745791812413,CLRE 250,A00,891860,Morris; Sheldon,9995,0,9999,4
1745791814466,CLRE 251R,A00,907817,Mehta; Ravindra L.,9994,0,9999,5
1745791815491,CLRE 252,A00,891864,Cuomo; Raphael Eduardo,9993,0,9999,6
1745791816517,CLRE 253,A00,891867,Vaida; Florin,9994,0,9999,5
1745791816517,CLRE 253,B00,907819,Staff,9999,0,9999,0
1745791817544,CLRE 259,A00,891868,Patel; Hemal,9998,0,9999,1
1745791818573,CLRE 260,A00,891872,Cuomo; Raphael Eduardo,9999,0,9999,0
1745791819599,CLRE 297,001,891888,Cuomo; Raphael Eduardo,9999,0,9999,0
1745791820625,CSE 191,A00,958773,Minnes Kemp; Mor Mia,9999,0,9999,0
1745791821655,CSS 201S,A01,892054,Mignozzetti; Umberto,30,0,30,0
1745791822719,CSS 202S,A01,892056,Mignozzetti; Umberto,30,0,30,0
1745791823745,DSC 197,001,956898,Eldridge; Justin Matthew,9998,0,9999,1
1745791824775,DSC 297,001,958000,Mazumdar; Arya,9998,0,9999,1
1745791825801,EAP 100,A00,905686,Staff,9776,0,9999,223
1745791826826,ECE 45,A01,892618,Staff,0,12,50,50
1745791827854,ECE 109,A01,892620,Staff,0,43,0,0
1745791828880,ECE 111,A01,892719,Staff,0,7,50,50
1745791829907,ECE 197,001,957920,Mercier; Patrick Philip,9992,0,9999,7
1745791830935,ECON 178,A01,907814,Zhu; Ying,28,0,35,7
1745791831960,EDS 115,A00,895312,Staff,41,0,45,4
1745791832985,EDS 117,A01,895337,Staff,30,0,30,0
1745791834010,EDS 125,A00,895341,Jones; Gabrielle Anastasia,43,0,45,2
1745791835036,EDS 128A,A01,895459,Fargason; Sharon Gayle,44,0,45,1
1745791836066,EDS 128B,A01,895543,Pappas; Elizabeth,44,0,45,1
1745791837093,EDS 139,A00,897203,Pappas; Elizabeth,44,0,45,1
1745791837093,EDS 139,B00,897209,Fargason; Sharon Gayle,44,0,45,1
1745791838122,EDS 201,A00,895545,Staff,43,0,45,2
1745791839147,EDS 203,A01,895581,Halter; Christopher P.,43,0,45,2
1745791840178,EDS 204R,A01,895625,Heinzman; Erica M.,43,0,45,2
1745791840178,EDS 204R,B01,895693,Halter; Christopher P.,18,0,45,27
1745791841205,EDS 206R,A00,895694,Fargason; Sharon Gayle,9,0,30,21
1745791841205,EDS 206R,B00,895695,Choi; Bailey Miyeon,20,0,30,10
1745791842230,EDS 250,A00,895697,Hemans; Patricia Ann Benitez,43,0,45,2
1745791843260,EDS 281,A00,895701,Meyerott; Theresa Ann,15,0,15,0
1745791844288,EDS 284,A00,895736,Meyerott; Theresa Ann,15,0,15,0
1745791845317,EDS 286,A00,897210,Fine; Sarah,15,0,15,0
1745791846346,EDS 289C,A01,895770,Daly; Alan J.,15,0,15,0
1745791847374,EDS 290,A00,897211,Hofstetter; Carolyn,15,0,15,0
1745791848402,LIGM 5A,A00,896162,Fischer-Grunski; Eva K,15,0,20,5
1745791849432,LIGM 5B,A00,896260,Fischer-Grunski; Eva K,17,0,20,3
1745791850462,LIGM 5C,A00,896308,Fischer-Grunski; Eva K,18,0,20,2
1745791851490,LIIT 5AS,A00,896313,Carnelos; Chiara,18,0,20,2
1745791852515,LIIT 5BS,A00,896416,Carnelos; Chiara,20,0,20,0
1745791853544,LIIT 5CS,A00,896564,Carnelos; Chiara,20,0,20,0
1745791854571,LISP 5A,A00,896588,Munoz Sanchez; Alicia,4,0,20,16
1745791855598,LISP 5B,A00,896653,Munoz Sanchez; Alicia,10,0,20,10
1745791856628,LISP 5C,A00,896655,Munoz Sanchez; Alicia,4,0,20,16
1745791857656,MAE 197,001,957918,Kleissl; Jan,9998,0,9999,1
1745791858683,MATH 2,A01,957937,Staff,34,0,35,1
1745791859712,MATH 197,001,957876,Kedlaya; Kiran S.,9993,0,9999,6
1745791860740,MCWP 40,A00,892729,Duru; Nur,13,0,20,7
1745791860740,MCWP 40,B00,893304,Montejo; Carolina,20,0,20,0
1745791861770,MCWP 40R,A00,893757,Redela; Pamela Morgan,0,6,20,20
1745791862795,MCWP 50,A00,893758,Morshed; Michael James,2,0,20,18
1745791862795,MCWP 50,B00,893761,Bartulis; Jason Michael,17,0,20,3
1745791863820,MCWP 50R,A00,893766,Compas; Sean Matthew,0,1,20,20
1745791863820,MCWP 50R,B00,893769,Carter; Jennifer A,0,0,20,20
1745791863820,MCWP 50R,C00,893771,Krone; Jarret,0,3,20,20
1745791863820,MCWP 50R,D00,893772,Miller; Elizabeth Deen,3,0,20,17
1745791863820,MCWP 50R,E00,893775,Carter; Andrea L,0,0,20,20
1745791864849,MMW 11R,A01,892721,Herbst; Matthew,11,0,27,16
1745791864849,MMW 11R,A02,892722,Herbst; Matthew,0,0,0,3
1745791865877,MMW 12R,A01,892724,Herbst; Matthew,0,9,16,16
1745791865877,MMW 12R,A02,892725,Herbst; Matthew,0,9,16,16
1745791866904,MMW 13R,A01,892727,Staff,0,4,16,16
1745791866904,MMW 13R,A02,892728,Staff,0,4,16,16
1745791866904,MMW 13R,A03,958032,Staff,0,3,16,16
1745791866904,MMW 13R,A04,958033,Staff,0,2,16,16
1745791866904,MMW 13R,A05,958034,Staff,0,3,16,16
1745791867932,SIO 295LS,A00,894015,Staff,7,0,25,18
1745791868962,SIO 295S,A00,894020,Staff,7,0,25,18
1745791869993,SIOC 290S,B01,958918,Staff,0,0,0,0
1745791871023,SIOC 291S,B01,958922,Staff,0,0,0,0
1745791872048,SOCI 117,A01,895339,Staff,4,0,5,1
1745791873075,WES 237B,A00,894149,Staff,11,0,20,9
1745791875138,AESE 279B,A00,891859,Staff,13,0,35,22
1745791876164,AIP 197,001,891854,Staff,70,0,70,0
1745791877189,ANTH 289S,A00,891856,Gagneux; Pascal,12,0,12,0
1745791878215,BENG 196,001,957946,Engler; Adam J.,9996,0,9999,3
1745791879240,CAT 124RS,A01,956906,Staff,8,0,25,17
1745791880267,CAT 125RS,A01,922013,Staff,8,0,25,17
1745791881292,CLRE 250,A00,891860,Morris; Sheldon,9995,0,9999,4
1745791883347,CLRE 251R,A00,907817,Mehta; Ravindra L.,9994,0,9999,5
1745791884376,CLRE 252,A00,891864,Cuomo; Raphael Eduardo,9993,0,9999,6
1745791885404,CLRE 253,A00,891867,Vaida; Florin,9994,0,9999,5
1745791885404,CLRE 253,B00,907819,Staff,9999,0,9999,0
1745791886431,CLRE 259,A00,891868,Patel; Hemal,9998,0,9999,1
1745791887458,CLRE 260,A00,891872,Cuomo; Raphael Eduardo,9999,0,9999,0
1745791888488,CLRE 297,001,891888,Cuomo; Raphael Eduardo,9999,0,9999,0
1745791889515,CSE 191,A00,958773,Minnes Kemp; Mor Mia,9999,0,9999,0
1745791890545,CSS 201S,A01,892054,Mignozzetti; Umberto,30,0,30,0
1745791891573,CSS 202S,A01,892056,Mignozzetti; Umberto,30,0,30,0
1745791892599,DSC 197,001,956898,Eldridge; Justin Matthew,9998,0,9999,1
1745791893627,DSC 297,001,958000,Mazumdar; Arya,9998,0,9999,1
1745791894656,EAP 100,A00,905686,Staff,9776,0,9999,223
1745791895681,ECE 45,A01,892618,Staff,0,12,50,50
1745791896709,ECE 109,A01,892620,Staff,0,43,0,0
1745791897763,ECE 111,A01,892719,Staff,0,7,50,50
1745791898792,ECE 197,001,957920,Mercier; Patrick Philip,9992,0,9999,7
1745791899818,ECON 178,A01,907814,Zhu; Ying,28,0,35,7
1745791900843,EDS 115,A00,895312,Staff,41,0,45,4
1745791901871,EDS 117,A01,895337,Staff,30,0,30,0
1745791902899,EDS 125,A00,895341,Jones; Gabrielle Anastasia,43,0,45,2
1745791903925,EDS 128A,A01,895459,Fargason; Sharon Gayle,44,0,45,1
1745791904954,EDS 128B,A01,895543,Pappas; Elizabeth,44,0,45,1
1745791905981,EDS 139,A00,897203,Pappas; Elizabeth,44,0,45,1
1745791905981,EDS 139,B00,897209,Fargason; Sharon Gayle,44,0,45,1
1745791907007,EDS 201,A00,895545,Staff,43,0,45,2
1745791908033,EDS 203,A01,895581,Halter; Christopher P.,43,0,45,2
1745791909062,EDS 204R,A01,895625,Heinzman; Erica M.,43,0,45,2
1745791909062,EDS 204R,B01,895693,Halter; Christopher P.,18,0,45,27
1745791910089,EDS 206R,A00,895694,Fargason; Sharon Gayle,9,0,30,21
1745791910089,EDS 206R,B00,895695,Choi; Bailey Miyeon,20,0,30,10
1745791911115,EDS 250,A00,895697,Hemans; Patricia Ann Benitez,43,0,45,2
1745791912144,EDS 281,A00,895701,Meyerott; Theresa Ann,15,0,15,0
1745791913173,EDS 284,A00,895736,Meyerott; Theresa Ann,15,0,15,0
1745791914198,EDS 286,A00,897210,Fine; Sarah,15,0,15,0
1745791915226,EDS 289C,A01,895770,Daly; Alan J.,15,0,15,0
1745791916253,EDS 290,A00,897211,Hofstetter; Carolyn,15,0,15,0
1745791917282,LIGM 5A,A00,896162,Fischer-Grunski; Eva K,15,0,20,5
1745791918313,LIGM 5B,A00,896260,Fischer-Grunski; Eva K,17,0,20,3
1745791919339,LIGM 5C,A00,896308,Fischer-Grunski; Eva K,18,0,20,2
1745791920364,LIIT 5AS,A00,896313,Carnelos; Chiara,18,0,20,2
1745791921395,LIIT 5BS,A00,896416,Carnelos; Chiara,20,0,20,0
1745791922426,LIIT 5CS,A00,896564,Carnelos; Chiara,20,0,20,0
1745791923452,LISP 5A,A00,896588,Munoz Sanchez; Alicia,4,0,20,16
1745791924477,LISP 5B,A00,896653,Munoz Sanchez; Alicia,10,0,20,10
1745791925504,LISP 5C,A00,896655,Munoz Sanchez; Alicia,4,0,20,16
1745791926531,MAE 197,001,957918,Kleissl; Jan,9998,0,9999,1
1745791927557,MATH 2,A01,957937,Staff,34,0,35,1
1745791928584,MATH 197,001,957876,Kedlaya; Kiran S.,9993,0,9999,6
1745791929614,MCWP 40,A00,892729,Duru; Nur,13,0,20,7
1745791929614,MCWP 40,B00,893304,Montejo; Carolina,20,0,20,0
1745791930639,MCWP 40R,A00,893757,Redela; Pamela Morgan,0,6,20,20
1745791931668,MCWP 50,A00,893758,Morshed; Michael James,2,0,20,18
1745791931668,MCWP 50,B00,893761,Bartulis; Jason Michael,17,0,20,3
1745791932694,MCWP 50R,A00,893766,Compas; Sean Matthew,0,1,20,20
1745791932694,MCWP 50R,B00,893769,Carter; Jennifer A,0,0,20,20
1745791932694,MCWP 50R,C00,893771,Krone; Jarret,0,3,20,20
1745791932694,MCWP 50R,D00,893772,Miller; Elizabeth Deen,3,0,20,17
1745791932694,MCWP 50R,E00,893775,Carter; Andrea L,0,0,20,20
1745791933723,MMW 11R,A01,892721,Herbst; Matthew,11,0,27,16
1745791933723,MMW 11R,A02,892722,Herbst; Matthew,0,0,0,3
1745791934751,MMW 12R,A01,892724,Herbst; Matthew,0,9,16,16
1745791934751,MMW 12R,A02,892725,Herbst; Matthew,0,9,16,16
1745791935778,MMW 13R,A01,892727,Staff,0,4,16,16
1745791935778,MMW 13R,A02,892728,Staff,0,4,16,16
1745791935778,MMW 13R,A03,958032,Staff,0,3,16,16
1745791935778,MMW 13R,A04,958033,Staff,0,2,16,16
1745791935778,MMW 13R,A05,958034,Staff,0,3,16,16
1745791936803,SIO 295LS,A00,894015,Staff,7,0,25,18
1745791937831,SIO 295S,A00,894020,Staff,7,0,25,18
1745791938861,SIOC 290S,B01,958918,Staff,0,0,0,0
1745791939891,SIOC 291S,B01,958922,Staff,0,0,0,0
1745791940917,SOCI 117,A01,895339,Staff,4,0,5,1
1745791941943,WES 237B,A00,894149,Staff,11,0,20,9
1745791944000,AESE 279B,A00,891859,Staff,13,0,35,22
1745791945025,AIP 197,001,891854,Staff,70,0,70,0
1745791946053,ANTH 289S,A00,891856,Gagneux; Pascal,12,0,12,0
1745791947081,BENG 196,001,957946,Engler; Adam J.,9996,0,9999,3
1745791948106,CAT 124RS,A01,956906,Staff,8,0,25,17
1745791949131,CAT 125RS,A01,922013,Staff,8,0,25,17
1745791950157,CLRE 250,A00,891860,Morris; Sheldon,9995,0,9999,4
1745791952211,CLRE 251R,A00,907817,Mehta; Ravindra L.,9994,0,9999,5
1745791953238,CLRE 252,A00,891864,Cuomo; Raphael Eduardo,9993,0,9999,6
1745791954267,CLRE 253,A00,891867,Vaida; Florin,9994,0,9999,5
1745791954267,CLRE 253,B00,907819,Staff,9999,0,9999,0
1745791955293,CLRE 259,A00,891868,Patel; Hemal,9998,0,9999,1
1745791956319,CLRE 260,A00,891872,Cuomo; Raphael Eduardo,9999,0,9999,0
1745791957345,CLRE 297,001,891888,Cuomo; Raphael Eduardo,9999,0,9999,0
1745791958373,CSE 191,A00,958773,Minnes Kemp; Mor Mia,9999,0,9999,0
1745791959398,CSS 201S,A01,892054,Mignozzetti; Umberto,30,0,30,0
1745791960427,CSS 202S,A01,892056,Mignozzetti; Umberto,30,0,30,0
1745791961456,DSC 197,001,956898,Eldridge; Justin Matthew,9998,0,9999,1
1745791962485,DSC 297,001,958000,Mazumdar; Arya,9998,0,9999,1
1745791963513,EAP 100,A00,905686,Staff,9776,0,9999,223
1745791964538,ECE 45,A01,892618,Staff,0,12,50,50
1745791965563,ECE 109,A01,892620,Staff,0,43,0,0
1745791966586,ECE 111,A01,892719,Staff,0,7,50,50
1745791967612,ECE 197,001,957920,Mercier; Patrick Philip,9992,0,9999,7
1745791968641,ECON 178,A01,907814,Zhu; Ying,28,0,35,7
1745791969667,EDS 115,A00,895312,Staff,41,0,45,4
1745791970697,EDS 117,A01,895337,Staff,30,0,30,0
1745791971723,EDS 125,A00,895341,Jones; Gabrielle Anastasia,43,0,45,2
1745791972749,EDS 128A,A01,895459,Fargason; Sharon Gayle,44,0,45,1
1745791973774,EDS 128B,A01,895543,Pappas; Elizabeth,44,0,45,1
1745791974802,EDS 139,A00,897203,Pappas; Elizabeth,44,0,45,1
1745791974802,EDS 139,B00,897209,Fargason; Sharon Gayle,44,0,45,1
1745791975828,EDS 201,A00,895545,Staff,43,0,45,2
1745791976856,EDS 203,A01,895581,Halter; Christopher P.,43,0,45,2
1745791977882,EDS 204R,A01,895625,Heinzman; Erica M.,43,0,45,2
1745791977882,EDS 204R,B01,895693,Halter; Christopher P.,18,0,45,27
1745791978908,EDS 206R,A00,895694,Fargason; Sharon Gayle,9,0,30,21
1745791978908,EDS 206R,B00,895695,Choi; Bailey Miyeon,20,0,30,10
1745791979936,EDS 250,A00,895697,Hemans; Patricia Ann Benitez,43,0,45,2
1745791980962,EDS 281,A00,895701,Meyerott; Theresa Ann,15,0,15,0
1745791981991,EDS 284,A00,895736,Meyerott; Theresa Ann,15,0,15,0
1745791983018,EDS 286,A00,897210,Fine; Sarah,15,0,15,0
1745791984044,EDS 289C,A01,895770,Daly; Alan J.,15,0,15,0
1745791985071,EDS 290,A00,897211,Hofstetter; Carolyn,15,0,15,0
1745791986097,LIGM 5A,A00,896162,Fischer-Grunski; Eva K,15,0,20,5
1745791987122,LIGM 5B,A00,896260,Fischer-Grunski; Eva K,17,0,20,3
1745791988147,LIGM 5C,A00,896308,Fischer-Grunski; Eva K,18,0,20,2
1745791989177,LIIT 5AS,A00,896313,Carnelos; Chiara,18,0,20,2
1745791990206,LIIT 5BS,A00,896416,Carnelos; Chiara,20,0,20,0
1745791991236,LIIT 5CS,A00,896564,Carnelos; Chiara,20,0,20,0
1745791992262,LISP 5A,A00,896588,Munoz Sanchez; Alicia,4,0,20,16
1745791993289,LISP 5B,A00,896653,Munoz Sanchez; Alicia,10,0,20,10
1745791994320,LISP 5C,A00,896655,Munoz Sanchez; Alicia,4,0,20,16
1745791995346,MAE 197,001,957918,Kleissl; Jan,9998,0,9999,1
1745791996375,MATH 2,A01,957937,Staff,34,0,35,1
1745791997400,MATH 197,001,957876,Kedlaya; Kiran S.,9993,0,9999,6
1745791998434,MCWP 40,A00,892729,Duru; Nur,13,0,20,7
1745791998434,MCWP 40,B00,893304,Montejo; Carolina,20,0,20,0
1745791999462,MCWP 40R,A00,893757,Redela; Pamela Morgan,0,6,20,20
1745792000491,MCWP 50,A00,893758,Morshed; Michael James,2,0,20,18
1745792000491,MCWP 50,B00,893761,Bartulis; Jason Michael,17,0,20,3
1745792001517,MCWP 50R,A00,893766,Compas; Sean Matthew,0,1,20,20
1745792001517,MCWP 50R,B00,893769,Carter; Jennifer A,0,0,20,20
1745792001517,MCWP 50R,C00,893771,Krone; Jarret,0,3,20,20
1745792001517,MCWP 50R,D00,893772,Miller; Elizabeth Deen,3,0,20,17
1745792001517,MCWP 50R,E00,893775,Carter; Andrea L,0,0,20,20
1745792002546,MMW 11R,A01,892721,Herbst; Matthew,11,0,27,16
1745792002546,MMW 11R,A02,892722,Herbst; Matthew,0,0,0,3
1745792003574,MMW 12R,A01,892724,Herbst; Matthew,0,9,16,16
1745792003574,MMW 12R,A02,892725,Herbst; Matthew,0,9,16,16
1745792004604,MMW 13R,A01,892727,Staff,0,4,16,16
1745792004604,MMW 13R,A02,892728,Staff,0,4,16,16
1745792004604,MMW 13R,A03,958032,Staff,0,3,16,16
1745792004604,MMW 13R,A04,958033,Staff,0,2,16,16
1745792004604,MMW 13R,A05,958034,Staff,0,3,16,16
1745792005633,SIO 295LS,A00,894015,Staff,7,0,25,18
1745792006659,SIO 295S,A00,894020,Staff,7,0,25,18
1745792007684,SIOC 290S,B01,958918,Staff,0,0,0,0
1745792008709,SIOC 291S,B01,958922,Staff,0,0,0,0
1745792009735,SOCI 117,A01,895339,Staff,4,0,5,1
1745792010762,WES 237B,A00,894149,Staff,11,0,20,9
1745792012835,AESE 279B,A00,891859,Staff,13,0,35,22
1745792013862,AIP 197,001,891854,Staff,70,0,70,0
1745792014888,ANTH 289S,A00,891856,Gagneux; Pascal,12,0,12,0
1745792015915,BENG 196,001,957946,Engler; Adam J.,9996,0,9999,3
1745792016944,CAT 124RS,A01,956906,Staff,8,0,25,17
1745792017970,CAT 125RS,A01,922013,Staff,8,0,25,17
1745792018998,CLRE 250,A00,891860,Morris; Sheldon,9995,0,9999,4
1745792021050,CLRE 251R,A00,907817,Mehta; Ravindra L.,9994,0,9999,5
1745792022078,CLRE 252,A00,891864,Cuomo; Raphael Eduardo,9993,0,9999,6
1745792023105,CLRE 253,A00,891867,Vaida; Florin,9994,0,9999,5
1745792023105,CLRE 253,B00,907819,Staff,9999,0,9999,0
1745792024134,CLRE 259,A00,891868,Patel; Hemal,9998,0,9999,1
1745792025160,CLRE 260,A00,891872,Cuomo; Raphael Eduardo,9999,0,9999,0
1745792026187,CLRE 297,001,891888,Cuomo; Raphael Eduardo,9999,0,9999,0
1745792027210,CSE 191,A00,958773,Minnes Kemp; Mor Mia,9999,0,9999,0
1745792028237,CSS 201S,A01,892054,Mignozzetti; Umberto,30,0,30,0
1745792029264,CSS 202S,A01,892056,Mignozzetti; Umberto,30,0,30,0
1745792030290,DSC 197,001,956898,Eldridge; Justin Matthew,9998,0,9999,1
1745792031320,DSC 297,001,958000,Mazumdar; Arya,9998,0,9999,1
1745792032346,EAP 100,A00,905686,Staff,9776,0,9999,223
1745792033377,ECE 45,A01,892618,Staff,0,12,50,50
1745792034404,ECE 109,A01,892620,Staff,0,43,0,0
1745792035428,ECE 111,A01,892719,Staff,0,7,50,50
1745792036453,ECE 197,001,957920,Mercier; Patrick Philip,9992,0,9999,7
1745792037479,ECON 178,A01,907814,Zhu; Ying,28,0,35,7
1745792038503,EDS 115,A00,895312,Staff,41,0,45,4
1745792039532,EDS 117,A01,895337,Staff,30,0,30,0
1745792040562,EDS 125,A00,895341,Jones; Gabrielle Anastasia,43,0,45,2
1745792041591,EDS 128A,A01,895459,Fargason; Sharon Gayle,44,0,45,1
1745792042620,EDS 128B,A01,895543,Pappas; Elizabeth,44,0,45,1
1745792043650,EDS 139,A00,897203,Pappas; Elizabeth,44,0,45,1
1745792043650,EDS 139,B00,897209,Fargason; Sharon Gayle,44,0,45,1
1745792044676,EDS 201,A00,895545,Staff,43,0,45,2
1745792045702,EDS 203,A01,895581,Halter; Christopher P.,43,0,45,2
1745792046729,EDS 204R,A01,895625,Heinzman; Erica M.,43,0,45,2
1745792046729,EDS 204R,B01,895693,Halter; Christopher P.,18,0,45,27
1745792047756,EDS 206R,A00,895694,Fargason; Sharon Gayle,9,0,30,21
1745792047756,EDS 206R,B00,895695,Choi; Bailey Miyeon,20,0,30,10
1745792048786,EDS 250,A00,895697,Hemans; Patricia Ann Benitez,43,0,45,2
1745792049814,EDS 281,A00,895701,Meyerott; Theresa Ann,15,0,15,0
1745792050843,EDS 284,A00,895736,Meyerott; Theresa Ann,15,0,15,0
1745792051871,EDS 286,A00,897210,Fine; Sarah,15,0,15,0
1745792052897,EDS 289C,A01,895770,Daly; Alan J.,15,0,15,0
1745792053923,EDS 290,A00,897211,Hofstetter; Carolyn,15,0,15,0
1745792054953,LIGM 5A,A00,896162,Fischer-Grunski; Eva K,15,0,20,5
1745792055980,LIGM 5B,A00,896260,Fischer-Grunski; Eva K,17,0,20,3
1745792057007,LIGM 5C,A00,896308,Fischer-Grunski; Eva K,18,0,20,2
1745792058035,LIIT 5AS,A00,896313,Carnelos; Chiara,18,0,20,2
1745792059062,LIIT 5BS,A00,896416,Carnelos; Chiara,20,0,20,0
1745792060092,LIIT 5CS,A00,896564,Carnelos; Chiara,20,0,20,0
1745792061118,LISP 5A,A00,896588,Munoz Sanchez; Alicia,4,0,20,16
1745792062142,LISP 5B,A00,896653,Munoz Sanchez; Alicia,10,0,20,10
1745792063167,LISP 5C,A00,896655,Munoz Sanchez; Alicia,4,0,20,16
1745792064198,MAE 197,001,957918,Kleissl; Jan,9998,0,9999,1
1745792065226,MATH 2,A01,957937,Staff,34,0,35,1
1745792066254,MATH 197,001,957876,Kedlaya; Kiran S.,9993,0,9999,6
1745792067284,MCWP 40,A00,892729,Duru; Nur,13,0,20,7
1745792067284,MCWP 40,B00,893304,Montejo; Carolina,20,0,20,0
1745792068310,MCWP 40R,A00,893757,Redela; Pamela Morgan,0,6,20,20
1745792069336,MCWP 50,A00,893758,Morshed; Michael James,2,0,20,18
1745792069336,MCWP 50,B00,893761,Bartulis; Jason Michael,17,0,20,3
1745792070363,MCWP 50R,A00,893766,Compas; Sean Matthew,0,1,20,20
1745792070363,MCWP 50R,B00,893769,Carter; Jennifer A,0,0,20,20
1745792070363,MCWP 50R,C00,893771,Krone; Jarret,0,3,20,20
1745792070363,MCWP 50R,D00,893772,Miller; Elizabeth Deen,3,0,20,17
1745792070363,MCWP 50R,E00,893775,Carter; Andrea L,0,0,20,20
1745792071390,MMW 11R,A01,892721,Herbst; Matthew,11,0,27,16
1745792071390,MMW 11R,A02,892722,Herbst; Matthew,0,0,0,3
1745792072417,MMW 12R,A01,892724,Herbst; Matthew,0,9,16,16
1745792072417,MMW 12R,A02,892725,Herbst; Matthew,0,9,16,16
1745792073445,MMW 13R,A01,892727,Staff,0,4,16,16
1745792073445,MMW 13R,A02,892728,Staff,0,4,16,16
1745792073445,MMW 13R,A03,958032,Staff,0,3,16,16
1745792073445,MMW 13R,A04,958033,Staff,0,2,16,16
1745792073445,MMW 13R,A05,958034,Staff,0,3,16,16
1745792074470,SIO 295LS,A00,894015,Staff,7,0,25,18
1745792075498,SIO 295S,A00,894020,Staff,7,0,25,18
1745792076529,SIOC 290S,B01,958918,Staff,0,0,0,0
1745792077554,SIOC 291S,B01,958922,Staff,0,0,0,0
1745792078582,SOCI 117,A01,895339,Staff,4,0,5,1
1745792079609,WES 237B,A00,894149,Staff,11,0,20,9
1745792081670,AESE 279B,A00,891859,Staff,13,0,35,22
1745792082697,AIP 197,001,891854,Staff,70,0,70,0
1745792083726,ANTH 289S,A00,891856,Gagneux; Pascal,12,0,12,0
1745792084753,BENG 196,001,957946,Engler; Adam J.,9996,0,9999,3
1745792085781,CAT 124RS,A01,956906,Staff,8,0,25,17
1745792086808,CAT 125RS,A01,922013,Staff,8,0,25,17
1745792087837,CLRE 250,A00,891860,Morris; Sheldon,9995,0,9999,4
1745792089890,CLRE 251R,A00,907817,Mehta; Ravindra L.,9994,0,9999,5
1745792090922,CLRE 252,A00,891864,Cuomo; Raphael Eduardo,9993,0,9999,6
1745792091951,CLRE 253,A00,891867,Vaida; Florin,9994,0,9999,5
1745792091951,CLRE 253,B00,907819,Staff,9999,0,9999,0
1745792092978,CLRE 259,A00,891868,Patel; Hemal,9998,0,9999,1
1745792094005,CLRE 260,A00,891872,Cuomo; Raphael Eduardo,9999,0,9999,0
1745792095033,CLRE 297,001,891888,Cuomo; Raphael Eduardo,9999,0,9999,0
1745792096062,CSE 191,A00,958773,Minnes Kemp; Mor Mia,9999,0,9999,0
1745792097090,CSS 201S,A01,892054,Mignozzetti; Umberto,30,0,30,0
1745792098118,CSS 202S,A01,892056,Mignozzetti; Umberto,30,0,30,0
1745792099145,DSC 197,001,956898,Eldridge; Justin Matthew,9998,0,9999,1
1745792100172,DSC 297,001,958000,Mazumdar; Arya,9998,0,9999,1
1745792101198,EAP 100,A00,905686,Staff,9776,0,9999,223
1745792102225,ECE 45,A01,892618,Staff,0,12,50,50
1745792103253,ECE 109,A01,892620,Staff,0,43,0,0
1745792104277,ECE 111,A01,892719,Staff,0,7,50,50
1745792105302,ECE 197,001,957920,Mercier; Patrick Philip,9992,0,9999,7
1745792106329,ECON 178,A01,907814,Zhu; Ying,28,0,35,7
1745792107356,EDS 115,A00,895312,Staff,41,0,45,4
1745792108385,EDS 117,A01,895337,Staff,30,0,30,0
1745792109413,EDS 125,A00,895341,Jones; Gabrielle Anastasia,43,0,45,2
1745792110440,EDS 128A,A01,895459,Fargason; Sharon Gayle,44,0,45,1
1745792111466,EDS 128B,A01,895543,Pappas; Elizabeth,44,0,45,1
1745792112494,EDS 139,A00,897203,Pappas; Elizabeth,44,0,45,1
1745792112494,EDS 139,B00,897209,Fargason; Sharon Gayle,44,0,45,1
1745792113522,EDS 201,A00,895545,Staff,43,0,45,2
1745792114553,EDS 203,A01,895581,Halter; Christopher P.,43,0,45,2
1745792115583,EDS 204R,A01,895625,Heinzman; Erica M.,43,0,45,2
1745792115583,EDS 204R,B01,895693,Halter; Christopher P.,18,0,45,27
1745792116609,EDS 206R,A00,895694,Fargason; Sharon Gayle,9,0,30,21
1745792116609,EDS 206R,B00,895695,Choi; Bailey Miyeon,20,0,30,10
1745792117639,EDS 250,A00,895697,Hemans; Patricia Ann Benitez,43,0,45,2
1745792118669,EDS 281,A00,895701,Meyerott; Theresa Ann,15,0,15,0
1745792119695,EDS 284,A00,895736,Meyerott; Theresa Ann,15,0,15,0
1745792120723,EDS 286,A00,897210,Fine; Sarah,15,0,15,0
1745792121750,EDS 289C,A01,895770,Daly; Alan J.,15,0,15,0
1745792122775,EDS 290,A00,897211,Hofstetter; Carolyn,15,0,15,0
1745792123805,LIGM 5A,A00,896162,Fischer-Grunski; Eva K,15,0,20,5
1745792124835,LIGM 5B,A00,896260,Fischer-Grunski; Eva K,17,0,20,3
1745792125864,LIGM 5C,A00,896308,Fischer-Grunski; Eva K,18,0,20,2
1745792126890,LIIT 5AS,A00,896313,Carnelos; Chiara,18,0,20,2
1745792127918,LIIT 5BS,A00,896416,Carnelos; Chiara,20,0,20,0
1745792128945,LIIT 5CS,A00,896564,Carnelos; Chiara,20,0,20,0
1745792129974,LISP 5A,A00,896588,Munoz Sanchez; Alicia,4,0,20,16
1745792130999,LISP 5B,A00,896653,Munoz Sanchez; Alicia,10,0,20,10
1745792132030,LISP 5C,A00,896655,Munoz Sanchez; Alicia,4,0,20,16
1745792133056,MAE 197,001,957918,Kleissl; Jan,9998,0,9999,1
1745792134082,MATH 2,A01,957937,Staff,34,0,35,1
1745792135111,MATH 197,001,957876,Kedlaya; Kiran S.,9993,0,9999,6
1745792136137,MCWP 40,A00,892729,Duru; Nur,13,0,20,7
1745792136137,MCWP 40,B00,893304,Montejo; Carolina,20,0,20,0
1745792137167,MCWP 40R,A00,893757,Redela; Pamela Morgan,0,6,20,20
1745792138194,MCWP 50,A00,893758,Morshed; Michael James,2,0,20,18
1745792138194,MCWP 50,B00,893761,Bartulis; Jason Michael,17,0,20,3
1745792139224,MCWP 50R,A00,893766,Compas; Sean Matthew,0,1,20,20
1745792139224,MCWP 50R,B00,893769,Carter; Jennifer A,0,0,20,20
1745792139224,MCWP 50R,C00,893771,Krone; Jarret,0,3,20,20
1745792139224,MCWP 50R,D00,893772,Miller; Elizabeth Deen,3,0,20,17
1745792139224,MCWP 50R,E00,893775,Carter; Andrea L,0,0,20,20
1745792140249,MMW 11R,A01,892721,Herbst; Matthew,11,0,27,16
1745792140249,MMW 11R,A02,892722,Herbst; Matthew,0,0,0,3
1745792141276,MMW 12R,A01,892724,Herbst; Matthew,0,9,16,16
1745792141276,MMW 12R,A02,892725,Herbst; Matthew,0,9,16,16
1745792142304,MMW 13R,A01,892727,Staff,0,4,16,16
1745792142304,MMW 13R,A02,892728,Staff,0,4,16,16
1745792142304,MMW 13R,A03,958032,Staff,0,3,16,16
1745792142304,MMW 13R,A04,958033,Staff,0,2,16,16
1745792142304,MMW 13R,A05,958034,Staff,0,3,16,16
1745792143335,SIO 295LS,A00,894015,Staff,7,0,25,18
1745792144361,SIO 295S,A00,894020,Staff,7,0,25,18
1745792145388,SIOC 290S,B01,958918,Staff,0,0,0,0
1745792146415,SIOC 291S,B01,958922,Staff,0,0,0,0
1745792147441,SOCI 117,A01,895339,Staff,4,0,5,1
1745792148470,WES 237B,A00,894149,Staff,11,0,20,9
1745792150526,AESE 279B,A00,891859,Staff,13,0,35,22
1745792151551,AIP 197,001,891854,Staff,70,0,70,0
1745792152576,ANTH 289S,A00,891856,Gagneux; Pascal,12,0,12,0
1745792153602,BENG 196,001,957946,Engler; Adam J.,9996,0,9999,3
1745792154629,CAT 124RS,A01,956906,Staff,8,0,25,17
1745792155653,CAT 125RS,A01,922013,Staff,8,0,25,17
1745792156678,CLRE 250,A00,891860,Morris; Sheldon,9995,0,9999,4
1745792158736,CLRE 251R,A00,907817,Mehta; Ravindra L.,9994,0,9999,5
1745792159761,CLRE 252,A00,891864,Cuomo; Raphael Eduardo,9993,0,9999,6
1745792160788,CLRE 253,A00,891867,Vaida; Florin,9994,0,9999,5
1745792160788,CLRE 253,B00,907819,Staff,9999,0,9999,0
1745792161815,CLRE 259,A00,891868,Patel; Hemal,9998,0,9999,1
1745792162843,CLRE 260,A00,891872,Cuomo; Raphael Eduardo,9999,0,9999,0
1745792163870,CLRE 297,001,891888,Cuomo; Raphael Eduardo,9999,0,9999,0
1745792164898,CSE 191,A00,958773,Minnes Kemp; Mor Mia,9999,0,9999,0
1745792165928,CSS 201S,A01,892054,Mignozzetti; Umberto,30,0,30,0
1745792166955,CSS 202S,A01,892056,Mignozzetti; Umberto,30,0,30,0
1745792167982,DSC 197,001,956898,Eldridge; Justin Matthew,9998,0,9999,1
1745792169010,DSC 297,001,958000,Mazumdar; Arya,9998,0,9999,1
1745792170038,EAP 100,A00,905686,Staff,9776,0,9999,223
1745792171064,ECE 45,A01,892618,Staff,0,12,50,50
1745792172091,ECE 109,A01,892620,Staff,0,43,0,0
1745792173118,ECE 111,A01,892719,Staff,0,7,50,50
1745792174147,ECE 197,001,957920,Mercier; Patrick Philip,9992,0,9999,7
1745792175176,ECON 178,A01,907814,Zhu; Ying,28,0,35,7
1745792176201,EDS 115,A00,895312,Staff,41,0,45,4
1745792177227,EDS 117,A01,895337,Staff,30,0,30,0
1745792178253,EDS 125,A00,895341,Jones; Gabrielle Anastasia,43,0,45,2
1745792179282,EDS 128A,A01,895459,Fargason; Sharon Gayle,44,0,45,1
1745792180310,EDS 128B,A01,895543,Pappas; Elizabeth,44,0,45,1
1745792181340,EDS 139,A00,897203,Pappas; Elizabeth,44,0,45,1
1745792181340,EDS 139,B00,897209,Fargason; Sharon Gayle,44,0,45,1
1745792182369,EDS 201,A00,895545,Staff,43,0,45,2
1745792183396,EDS 203,A01,895581,Halter; Christopher P.,43,0,45,2
1745792184424,EDS 204R,A01,895625,Heinzman; Erica M.,43,0,45,2
1745792184424,EDS 204R,B01,895693,Halter; Christopher P.,18,0,45,27
1745792185449,EDS 206R,A00,895694,Fargason; Sharon Gayle,9,0,30,21
1745792185449,EDS 206R,B00,895695,Choi; Bailey Miyeon,20,0,30,10
1745792186475,EDS 250,A00,895697,Hemans; Patricia Ann Benitez,43,0,45,2
1745792187504,EDS 281,A00,895701,Meyerott; Theresa Ann,15,0,15,0
1745792188527,EDS 284,A00,895736,Meyerott; Theresa Ann,15,0,15,0
1745792189553,EDS 286,A00,897210,Fine; Sarah,15,0,15,0
1745792190583,EDS 289C,A01,895770,Daly; Alan J.,15,0,15,0
1745792191610,EDS 290,A00,897211,Hofstetter; Carolyn,15,0,15,0
1745792192640,LIGM 5A,A00,896162,Fischer-Grunski; Eva K,15,0,20,5
1745792193666,LIGM 5B,A00,896260,Fischer-Grunski; Eva K,17,0,20,3
1745792194692,LIGM 5C,A00,896308,Fischer-Grunski; Eva K,18,0,20,2
1745792195719,LIIT 5AS,A00,896313,Carnelos; Chiara,18,0,20,2
1745792196746,LIIT 5BS,A00,896416,Carnelos; Chiara,20,0,20,0
1745792197771,LIIT 5CS,A00,896564,Carnelos; Chiara,20,0,20,0
1745792198798,LISP 5A,A00,896588,Munoz Sanchez; Alicia,4,0,20,16
1745792199860,LISP 5B,A00,896653,Munoz Sanchez; Alicia,10,0,20,10
1745792200889,LISP 5C,A00,896655,Munoz Sanchez; Alicia,4,0,20,16
1745792201917,MAE 197,001,957918,Kleissl; Jan,9998,0,9999,1
1745792202944,MATH 2,A01,957937,Staff,34,0,35,1
1745792203970,MATH 197,001,957876,Kedlaya; Kiran S.,9993,0,9999,6
1745792204998,MCWP 40,A00,892729,Duru; Nur,13,0,20,7
1745792204998,MCWP 40,B00,893304,Montejo; Carolina,20,0,20,0
1745792206023,MCWP 40R,A00,893757,Redela; Pamela Morgan,0,6,20,20
1745792207052,MCWP 50,A00,893758,Morshed; Michael James,2,0,20,18
1745792207052,MCWP 50,B00,893761,Bartulis; Jason Michael,17,0,20,3
1745792208079,MCWP 50R,A00,893766,Compas; Sean Matthew,0,1,20,20
1745792208079,MCWP 50R,B00,893769,Carter; Jennifer A,0,0,20,20
1745792208079,MCWP 50R,C00,893771,Krone; Jarret,0,3,20,20
1745792208079,MCWP 50R,D00,893772,Miller; Elizabeth Deen,3,0,20,17
1745792208079,MCWP 50R,E00,893775,Carter; Andrea L,0,0,20,20
1745792209105,MMW 11R,A01,892721,Herbst; Matthew,11,0,27,16
1745792209105,MMW 11R,A02,892722,Herbst; Matthew,0,0,0,3
1745792210133,MMW 12R,A01,892724,Herbst; Matthew,0,9,16,16
1745792210133,MMW 12R,A02,892725,Herbst; Matthew,0,9,16,16
1745792211158,MMW 13R,A01,892727,Staff,0,4,16,16
1745792211158,MMW 13R,A02,892728,Staff,0,4,16,16
1745792211158,MMW 13R,A03,958032,Staff,0,3,16,16
1745792211158,MMW 13R,A04,958033,Staff,0,2,16,16
1745792211158,MMW 13R,A05,958034,Staff,0,3,16,16
1745792212186,SIO 295LS,A00,894015,Staff,7,0,25,18
1745792213212,SIO 295S,A00,894020,Staff,7,0,25,18
1745792214241,SIOC 290S,B01,958918,Staff,0,0,0,0
1745792215269,SIOC 291S,B01,958922,Staff,0,0,0,0
1745792216296,SOCI 117,A01,895339,Staff,4,0,5,1
1745792217324,WES 237B,A00,894149,Staff,11,0,20,9
1745792219393,AESE 279B,A00,891859,Staff,13,0,35,22
1745792220422,AIP 197,001,891854,Staff,70,0,70,0
1745792221448,ANTH 289S,A00,891856,Gagneux; Pascal,12,0,12,0
1745792222478,BENG 196,001,957946,Engler; Adam J.,9996,0,9999,3
1745792223506,CAT 124RS,A01,956906,Staff,8,0,25,17
1745792224532,CAT 125RS,A01,922013,Staff,8,0,25,17
1745792225561,CLRE 250,A00,891860,Morris; Sheldon,9995,0,9999,4
1745792227617,CLRE 251R,A00,907817,Mehta; Ravindra L.,9994,0,9999,5
1745792228646,CLRE 252,A00,891864,Cuomo; Raphael Eduardo,9993,0,9999,6
1745792229675,CLRE 253,A00,891867,Vaida; Florin,9994,0,9999,5
1745792229675,CLRE 253,B00,907819,Staff,9999,0,9999,0
1745792230704,CLRE 259,A00,891868,Patel; Hemal,9998,0,9999,1
1745792231730,CLRE 260,A00,891872,Cuomo; Raphael Eduardo,9999,0,9999,0
1745792232757,CLRE 297,001,891888,Cuomo; Raphael Eduardo,9999,0,9999,0
1745792233784,CSE 191,A00,958773,Minnes Kemp; Mor Mia,9999,0,9999,0
1745792234810,CSS 201S,A01,892054,Mignozzetti; Umberto,30,0,30,0
1745792235836,CSS 202S,A01,892056,Mignozzetti; Umberto,30,0,30,0
1745792236863,DSC 197,001,956898,Eldridge; Justin Matthew,9998,0,9999,1
1745792237889,DSC 297,001,958000,Mazumdar; Arya,9998,0,9999,1
1745792238915,EAP 100,A00,905686,Staff,9776,0,9999,223
1745792239941,ECE 45,A01,892618,Staff,0,12,50,50
1745792240966,ECE 109,A01,892620,Staff,0,43,0,0
1745792241993,ECE 111,A01,892719,Staff,0,7,50,50
1745792243019,ECE 197,001,957920,Mercier; Patrick Philip,9992,0,9999,7
1745792244045,ECON 178,A01,907814,Zhu; Ying,28,0,35,7
1745792245073,EDS 115,A00,895312,Staff,41,0,45,4
1745792246100,EDS 117,A01,895337,Staff,30,0,30,0
1745792247125,EDS 125,A00,895341,Jones; Gabrielle Anastasia,43,0,45,2
1745792248150,EDS 128A,A01,895459,Fargason; Sharon Gayle,44,0,45,1
1745792249175,EDS 128B,A01,895543,Pappas; Elizabeth,44,0,45,1
1745792250204,EDS 139,A00,897203,Pappas; Elizabeth,44,0,45,1
1745792250204,EDS 139,B00,897209,Fargason; Sharon Gayle,44,0,45,1
1745792251232,EDS 201,A00,895545,Staff,43,0,45,2
1745792252262,EDS 203,A01,895581,Halter; Christopher P.,43,0,45,2
1745792253289,EDS 204R,A01,895625,Heinzman; Erica M.,43,0,45,2
1745792253289,EDS 204R,B01,895693,Halter; Christopher P.,18,0,45,27
1745792254316,EDS 206R,A00,895694,Fargason; Sharon Gayle,9,0,30,21
1745792254316,EDS 206R,B00,895695,Choi; Bailey Miyeon,20,0,30,10
1745792255343,EDS 250,A00,895697,Hemans; Patricia Ann Benitez,43,0,45,2
1745792256374,EDS 281,A00,895701,Meyerott; Theresa Ann,15,0,15,0
1745792257402,EDS 284,A00,895736,Meyerott; Theresa Ann,15,0,15,0
1745792258429,EDS 286,A00,897210,Fine; Sarah,15,0,15,0
1745792259454,EDS 289C,A01,895770,Daly; Alan J.,15,0,15,0
1745792260478,EDS 290,A00,897211,Hofstetter; Carolyn,15,0,15,0
1745792261506,LIGM 5A,A00,896162,Fischer-Grunski; Eva K,15,0,20,5
1745792262534,LIGM 5B,A00,896260,Fischer-Grunski; Eva K,17,0,20,3
1745792263567,LIGM 5C,A00,896308,Fischer-Grunski; Eva K,18,0,20,2
1745792264594,LIIT 5AS,A00,896313,Carnelos; Chiara,18,0,20,2
1745792265620,LIIT 5BS,A00,896416,Carnelos; Chiara,20,0,20,0
1745792266646,LIIT 5CS,A00,896564,Carnelos; Chiara,20,0,20,0
1745792267675,LISP 5A,A00,896588,Munoz Sanchez; Alicia,4,0,20,16
1745792268702,LISP 5B,A00,896653,Munoz Sanchez; Alicia,10,0,20,10
1745792269727,LISP 5C,A00,896655,Munoz Sanchez; Alicia,4,0,20,16
1745792270752,MAE 197,001,957918,Kleissl; Jan,9998,0,9999,1
1745792271780,MATH 2,A01,957937,Staff,34,0,35,1
1745792272807,MATH 197,001,957876,Kedlaya; Kiran S.,9993,0,9999,6
1745792273833,MCWP 40,A00,892729,Duru; Nur,13,0,20,7
1745792273833,MCWP 40,B00,893304,Montejo; Carolina,20,0,20,0
1745792274861,MCWP 40R,A00,893757,Redela; Pamela Morgan,0,6,20,20
1745792275889,MCWP 50,A00,893758,Morshed; Michael James,2,0,20,18
1745792275889,MCWP 50,B00,893761,Bartulis; Jason Michael,17,0,20,3
1745792276914,MCWP 50R,A00,893766,Compas; Sean Matthew,0,1,20,20
1745792276914,MCWP 50R,B00,893769,Carter; Jennifer A,0,0,20,20
1745792276914,MCWP 50R,C00,893771,Krone; Jarret,0,3,20,20
1745792276914,MCWP 50R,D00,893772,Miller; Elizabeth Deen,3,0,20,17
1745792276914,MCWP 50R,E00,893775,Carter; Andrea L,0,0,20,20
1745792277942,MMW 11R,A01,892721,Herbst; Matthew,11,0,27,16
1745792277942,MMW 11R,A02,892722,Herbst; Matthew,0,0,0,3
1745792278968,MMW 12R,A01,892724,Herbst; Matthew,0,9,16,16
1745792278968,MMW 12R,A02,892725,Herbst; Matthew,0,9,16,16
1745792279993,MMW 13R,A01,892727,Staff,0,4,16,16
1745792279993,MMW 13R,A02,892728,Staff,0,4,16,16
1745792279993,MMW 13R,A03,958032,Staff,0,3,16,16
1745792279993,MMW 13R,A04,958033,Staff,0,2,16,16
1745792279993,MMW 13R,A05,958034,Staff,0,3,16,16
1745792281020,SIO 295LS,A00,894015,Staff,7,0,25,18
1745792282046,SIO 295S,A00,894020,Staff,7,0,25,18
1745792283074,SIOC 290S,B01,958918,Staff,0,0,0,0
1745792284107,SIOC 291S,B01,958922,Staff,0,0,0,0
1745792285132,SOCI 117,A01,895339,Staff,4,0,5,1
1745792286158,WES 237B,A00,894149,Staff,11,0,20,9
1745792288216,AESE 279B,A00,891859,Staff,13,0,35,22
1745792289242,AIP 197,001,891854,Staff,70,0,70,0
1745792290271,ANTH 289S,A00,891856,Gagneux; Pascal,12,0,12,0
1745792291299,BENG 196,001,957946,Engler; Adam J.,9996,0,9999,3
1745792292327,CAT 124RS,A01,956906,Staff,8,0,25,17
1745792293356,CAT 125RS,A01,922013,Staff,8,0,25,17
1745792294380,CLRE 250,A00,891860,Morris; Sheldon,9995,0,9999,4
1745792296436,CLRE 251R,A00,907817,Mehta; Ravindra L.,9994,0,9999,5
1745792297462,CLRE 252,A00,891864,Cuomo; Raphael Eduardo,9993,0,9999,6
1745792298488,CLRE 253,A00,891867,Vaida; Florin,9994,0,9999,5
1745792298488,CLRE 253,B00,907819,Staff,9999,0,9999,0
1745792299521,CLRE 259,A00,891868,Patel; Hemal,9998,0,9999,1
1745792300547,CLRE 260,A00,891872,Cuomo; Raphael Eduardo,9999,0,9999,0
1745792301574,CLRE 297,001,891888,Cuomo; Raphael Eduardo,9999,0,9999,0
1745792302599,CSE 191,A00,958773,Minnes Kemp; Mor Mia,9999,0,9999,0
1745792303626,CSS 201S,A01,892054,Mignozzetti; Umberto,30,0,30,0
1745792304653,CSS 202S,A01,892056,Mignozzetti; Umberto,30,0,30,0
1745792305680,DSC 197,001,956898,Eldridge; Justin Matthew,9998,0,9999,1
1745792306709,DSC 297,001,958000,Mazumdar; Arya,9998,0,9999,1
1745792307737,EAP 100,A00,905686,Staff,9776,0,9999,223
1745792308766,ECE 45,A01,892618,Staff,0,12,50,50
1745792309796,ECE 109,A01,892620,Staff,0,43,0,0
1745792310823,ECE 111,A01,892719,Staff,0,7,50,50
1745792311848,ECE 197,001,957920,Mercier; Patrick Philip,9992,0,9999,7
1745792312879,ECON 178,A01,907814,Zhu; Ying,28,0,35,7
1745792313906,EDS 115,A00,895312,Staff,41,0,45,4
1745792314932,EDS 117,A01,895337,Staff,30,0,30,0
1745792315959,EDS 125,A00,895341,Jones; Gabrielle Anastasia,43,0,45,2
1745792316986,EDS 128A,A01,895459,Fargason; Sharon Gayle,44,0,45,1
1745792318013,EDS 128B,A01,895543,Pappas; Elizabeth,44,0,45,1
1745792319038,EDS 139,A00,897203,Pappas; Elizabeth,44,0,45,1
1745792319038,EDS 139,B00,897209,Fargason; Sharon Gayle,44,0,45,1
1745792320066,EDS 201,A00,895545,Staff,43,0,45,2
1745792321093,EDS 203,A01,895581,Halter; Christopher P.,43,0,45,2
1745792322118,EDS 204R,A01,895625,Heinzman; Erica M.,43,0,45,2
1745792322118,EDS 204R,B01,895693,Halter; Christopher P.,18,0,45,27
1745792323148,EDS 206R,A00,895694,Fargason; Sharon Gayle,9,0,30,21
1745792323148,EDS 206R,B00,895695,Choi; Bailey Miyeon,20,0,30,10
1745792324175,EDS 250,A00,895697,Hemans; Patricia Ann Benitez,43,0,45,2
1745792325202,EDS 281,A00,895701,Meyerott; Theresa Ann,15,0,15,0
1745792326231,EDS 284,A00,895736,Meyerott; Theresa Ann,15,0,15,0
1745792327257,EDS 286,A00,897210,Fine; Sarah,15,0,15,0
1745792328287,EDS 289C,A01,895770,Daly; Alan J.,15,0,15,0
1745792329315,EDS 290,A00,897211,Hofstetter; Carolyn,15,0,15,0
1745792330345,LIGM 5A,A00,896162,Fischer-Grunski; Eva K,15,0,20,5
1745792331376,LIGM 5B,A00,896260,Fischer-Grunski; Eva K,17,0,20,3
1745792332403,LIGM 5C,A00,896308,Fischer-Grunski; Eva K,18,0,20,2
1745792333430,LIIT 5AS,A00,896313,Carnelos; Chiara,18,0,20,2
1745792334455,LIIT 5BS,A00,896416,Carnelos; Chiara,20,0,20,0
1745792335480,LIIT 5CS,A00,896564,Carnelos; Chiara,20,0,20,0
1745792336510,LISP 5A,A00,896588,Munoz Sanchez; Alicia,4,0,20,16
1745792337535,LISP 5B,A00,896653,Munoz Sanchez; Alicia,10,0,20,10
1745792338560,LISP 5C,A00,896655,Munoz Sanchez; Alicia,4,0,20,16
1745792339586,MAE 197,001,957918,Kleissl; Jan,9998,0,9999,1
1745792340616,MATH 2,A01,957937,Staff,34,0,35,1
1745792341672,MATH 197,001,957876,Kedlaya; Kiran S.,9993,0,9999,6
1745792342700,MCWP 40,A00,892729,Duru; Nur,13,0,20,7
1745792342700,MCWP 40,B00,893304,Montejo; Carolina,20,0,20,0
1745792343727,MCWP 40R,A00,893757,Redela; Pamela Morgan,0,6,20,20
1745792344757,MCWP 50,A00,893758,Morshed; Michael James,2,0,20,18
1745792344757,MCWP 50,B00,893761,Bartulis; Jason Michael,17,0,20,3
1745792345787,MCWP 50R,A00,893766,Compas; Sean Matthew,0,1,20,20
1745792345787,MCWP 50R,B00,893769,Carter; Jennifer A,0,0,20,20
1745792345787,MCWP 50R,C00,893771,Krone; Jarret,0,3,20,20
1745792345787,MCWP 50R,D00,893772,Miller; Elizabeth Deen,3,0,20,17
1745792345787,MCWP 50R,E00,893775,Carter; Andrea L,0,0,20,20
1745792346814,MMW 11R,A01,892721,Herbst; Matthew,11,0,27,16
1745792346814,MMW 11R,A02,892722,Herbst; Matthew,0,0,0,3
1745792347844,MMW 12R,A01,892724,Herbst; Matthew,0,9,16,16
1745792347844,MMW 12R,A02,892725,Herbst; Matthew,0,9,16,16
1745792348869,MMW 13R,A01,892727,Staff,0,4,16,16
1745792348869,MMW 13R,A02,892728,Staff,0,4,16,16
1745792348869,MMW 13R,A03,958032,Staff,0,3,16,16
1745792348869,MMW 13R,A04,958033,Staff,0,2,16,16
1745792348869,MMW 13R,A05,958034,Staff,0,3,16,16
1745792349895,SIO 295LS,A00,894015,Staff,7,0,25,18
1745792350924,SIO 295S,A00,894020,Staff,7,0,25,18
1745792351950,SIOC 290S,B01,958918,Staff,0,0,0,0
1745792352979,SIOC 291S,B01,958922,Staff,0,0,0,0
1745792354008,SOCI 117,A01,895339,Staff,4,0,5,1
1745792355035,WES 237B,A00,894149,Staff,11,0,20,9
1745792357099,AESE 279B,A00,891859,Staff,13,0,35,22
1745792358127,AIP 197,001,891854,Staff,70,0,70,0
1745792359153,ANTH 289S,A00,891856,Gagneux; Pascal,12,0,12,0
1745792360181,BENG 196,001,957946,Engler; Adam J.,9996,0,9999,3
1745792361208,CAT 124RS,A01,956906,Staff,8,0,25,17
1745792362233,CAT 125RS,A01,922013,Staff,8,0,25,17
1745792363259,CLRE 250,A00,891860,Morris; Sheldon,9995,0,9999,4
1745792365311,CLRE 251R,A00,907817,Mehta; Ravindra L.,9994,0,9999,5
1745792366341,CLRE 252,A00,891864,Cuomo; Raphael Eduardo,9993,0,9999,6
1745792367366,CLRE 253,A00,891867,Vaida; Florin,9994,0,9999,5
1745792367366,CLRE 253,B00,907819,Staff,9999,0,9999,0
1745792368396,CLRE 259,A00,891868,Patel; Hemal,9998,0,9999,1
1745792369423,CLRE 260,A00,891872,Cuomo; Raphael Eduardo,9999,0,9999,0
1745792370450,CLRE 297,001,891888,Cuomo; Raphael Eduardo,9999,0,9999,0
1745792371478,CSE 191,A00,958773,Minnes Kemp; Mor Mia,9999,0,9999,0
1745792372509,CSS 201S,A01,892054,Mignozzetti; Umberto,30,0,30,0
1745792373536,CSS 202S,A01,892056,Mignozzetti; Umberto,30,0,30,0
1745792374563,DSC 197,001,956898,Eldridge; Justin Matthew,9998,0,9999,1
1745792375591,DSC 297,001,958000,Mazumdar; Arya,9998,0,9999,1
1745792376618,EAP 100,A00,905686,Staff,9776,0,9999,223
1745792377647,ECE 45,A01,892618,Staff,0,12,50,50
1745792378676,ECE 109,A01,892620,Staff,0,43,0,0
1745792379701,ECE 111,A01,892719,Staff,0,7,50,50
1745792380729,ECE 197,001,957920,Mercier; Patrick Philip,9992,0,9999,7
1745792381760,ECON 178,A01,907814,Zhu; Ying,28,0,35,7
1745792382789,EDS 115,A00,895312,Staff,41,0,45,4
1745792383816,EDS 117,A01,895337,Staff,30,0,30,0
1745792384841,EDS 125,A00,895341,Jones; Gabrielle Anastasia,43,0,45,2
1745792385867,EDS 128A,A01,895459,Fargason; Sharon Gayle,44,0,45,1
1745792386893,EDS 128B,A01,895543,Pappas; Elizabeth,44,0,45,1
1745792387918,EDS 139,A00,897203,Pappas; Elizabeth,44,0,45,1
1745792387918,EDS 139,B00,897209,Fargason; Sharon Gayle,44,0,45,1
1745792388945,EDS 201,A00,895545,Staff,43,0,45,2
1745792389971,EDS 203,A01,895581,Halter; Christopher P.,43,0,45,2
1745792390997,EDS 204R,A01,895625,Heinzman; Erica M.,43,0,45,2
1745792390997,EDS 204R,B01,895693,Halter; Christopher P.,18,0,45,27
1745792392023,EDS 206R,A00,895694,Fargason; Sharon Gayle,9,0,30,21
1745792392023,EDS 206R,B00,895695,Choi; Bailey Miyeon,20,0,30,10
1745792393053,EDS 250,A00,895697,Hemans; Patricia Ann Benitez,43,0,45,2
1745792394078,EDS 281,A00,895701,Meyerott; Theresa Ann,15,0,15,0
1745792395104,EDS 284,A00,895736,Meyerott; Theresa Ann,15,0,15,0
1745792396132,EDS 286,A00,897210,Fine; Sarah,15,0,15,0
1745792397159,EDS 289C,A01,895770,Daly; Alan J.,15,0,15,0
1745792398182,EDS 290,A00,897211,Hofstetter; Carolyn,15,0,15,0
1745792399211,LIGM 5A,A00,896162,Fischer-Grunski; Eva K,15,0,20,5
1745792400241,LIGM 5B,A00,896260,Fischer-Grunski; Eva K,17,0,20,3
1745792401267,LIGM 5C,A00,896308,Fischer-Grunski; Eva K,18,0,20,2
1745792402298,LIIT 5AS,A00,896313,Carnelos; Chiara,18,0,20,2
1745792403328,LIIT 5BS,A00,896416,Carnelos; Chiara,20,0,20,0
1745792404358,LIIT 5CS,A00,896564,Carnelos; Chiara,20,0,20,0
1745792405386,LISP 5A,A00,896588,Munoz Sanchez; Alicia,4,0,20,16
1745792406415,LISP 5B,A00,896653,Munoz Sanchez; Alicia,10,0,20,10
1745792407442,LISP 5C,A00,896655,Munoz Sanchez; Alicia,4,0,20,16
1745792408469,MAE 197,001,957918,Kleissl; Jan,9998,0,9999,1
1745792409495,MATH 2,A01,957937,Staff,34,0,35,1
1745792410525,MATH 197,001,957876,Kedlaya; Kiran S.,9993,0,9999,6
1745792411550,MCWP 40,A00,892729,Duru; Nur,13,0,20,7
1745792411550,MCWP 40,B00,893304,Montejo; Carolina,20,0,20,0
1745792412579,MCWP 40R,A00,893757,Redela; Pamela Morgan,0,6,20,20
1745792413605,MCWP 50,A00,893758,Morshed; Michael James,2,0,20,18
1745792413605,MCWP 50,B00,893761,Bartulis; Jason Michael,17,0,20,3
1745792414634,MCWP 50R,A00,893766,Compas; Sean Matthew,0,1,20,20
1745792414634,MCWP 50R,B00,893769,Carter; Jennifer A,0,0,20,20
1745792414634,MCWP 50R,C00,893771,Krone; Jarret,0,3,20,20
1745792414634,MCWP 50R,D00,893772,Miller; Elizabeth Deen,3,0,20,17
1745792414634,MCWP 50R,E00,893775,Carter; Andrea L,0,0,20,20
1745792415659,MMW 11R,A01,892721,Herbst; Matthew,11,0,27,16
1745792415659,MMW 11R,A02,892722,Herbst; Matthew,0,0,0,3
1745792416689,MMW 12R,A01,892724,Herbst; Matthew,0,9,16,16
1745792416689,MMW 12R,A02,892725,Herbst; Matthew,0,9,16,16
1745792417716,MMW 13R,A01,892727,Staff,0,4,16,16
1745792417716,MMW 13R,A02,892728,Staff,0,4,16,16
1745792417716,MMW 13R,A03,958032,Staff,0,3,16,16
1745792417716,MMW 13R,A04,958033,Staff,0,2,16,16
1745792417716,MMW 13R,A05,958034,Staff,0,3,16,16
1745792418742,SIO 295LS,A00,894015,Staff,7,0,25,18
1745792419767,SIO 295S,A00,894020,Staff,7,0,25,18
1745792420798,SIOC 290S,B01,958918,Staff,0,0,0,0
1745792421827,SIOC 291S,B01,958922,Staff,0,0,0,0
1745792422853,SOCI 117,A01,895339,Staff,4,0,5,1
1745792423880,WES 237B,A00,894149,Staff,11,0,20,9
1745792425946,AESE 279B,A00,891859,Staff,13,0,35,22
1745792426971,AIP 197,001,891854,Staff,70,0,70,0
1745792427998,ANTH 289S,A00,891856,Gagneux; Pascal,12,0,12,0
1745792429023,BENG 196,001,957946,Engler; Adam J.,9996,0,9999,3
1745792430048,CAT 124RS,A01,956906,Staff,8,0,25,17
1745792431074,CAT 125RS,A01,922013,Staff,8,0,25,17
1745792432102,CLRE 250,A00,891860,Morris; Sheldon,9995,0,9999,4
1745792434161,CLRE 251R,A00,907817,Mehta; Ravindra L.,9994,0,9999,5
1745792435187,CLRE 252,A00,891864,Cuomo; Raphael Eduardo,9993,0,9999,6
1745792436212,CLRE 253,A00,891867,Vaida; Florin,9994,0,9999,5
1745792436212,CLRE 253,B00,907819,Staff,9999,0,9999,0
1745792437240,CLRE 259,A00,891868,Patel; Hemal,9998,0,9999,1
1745792438266,CLRE 260,A00,891872,Cuomo; Raphael Eduardo,9999,0,9999,0
1745792439291,CLRE 297,001,891888,Cuomo; Raphael Eduardo,9999,0,9999,0
1745792440321,CSE 191,A00,958773,Minnes Kemp; Mor Mia,9999,0,9999,0
1745792441347,CSS 201S,A01,892054,Mignozzetti; Umberto,30,0,30,0
1745792442374,CSS 202S,A01,892056,Mignozzetti; Umberto,30,0,30,0
1745792443399,DSC 197,001,956898,Eldridge; Justin Matthew,9998,0,9999,1
1745792444425,DSC 297,001,958000,Mazumdar; Arya,9998,0,9999,1
1745792445451,EAP 100,A00,905686,Staff,9776,0,9999,223
1745792446480,ECE 45,A01,892618,Staff,0,12,50,50
1745792447505,ECE 109,A01,892620,Staff,0,43,0,0
1745792448533,ECE 111,A01,892719,Staff,0,7,50,50
1745792449560,ECE 197,001,957920,Mercier; Patrick Philip,9992,0,9999,7
1745792450589,ECON 178,A01,907814,Zhu; Ying,28,0,35,7
1745792451615,EDS 115,A00,895312,Staff,41,0,45,4
1745792452639,EDS 117,A01,895337,Staff,30,0,30,0
1745792453667,EDS 125,A00,895341,Jones; Gabrielle Anastasia,43,0,45,2
1745792454693,EDS 128A,A01,895459,Fargason; Sharon Gayle,44,0,45,1
1745792455718,EDS 128B,A01,895543,Pappas; Elizabeth,44,0,45,1
1745792456744,EDS 139,A00,897203,Pappas; Elizabeth,44,0,45,1
1745792456744,EDS 139,B00,897209,Fargason; Sharon Gayle,44,0,45,1
1745792457770,EDS 201,A00,895545,Staff,43,0,45,2
1745792458796,EDS 203,A01,895581,Halter; Christopher P.,43,0,45,2
1745792459823,EDS 204R,A01,895625,Heinzman; Erica M.,43,0,45,2
1745792459823,EDS 204R,B01,895693,Halter; Christopher P.,18,0,45,27
1745792460851,EDS 206R,A00,895694,Fargason; Sharon Gayle,9,0,30,21
1745792460851,EDS 206R,B00,895695,Choi; Bailey Miyeon,20,0,30,10
1745792461881,EDS 250,A00,895697,Hemans; Patricia Ann Benitez,43,0,45,2
1745792462906,EDS 281,A00,895701,Meyerott; Theresa Ann,15,0,15,0
1745792463931,EDS 284,A00,895736,Meyerott; Theresa Ann,15,0,15,0
1745792464959,EDS 286,A00,897210,Fine; Sarah,15,0,15,0
1745792465987,EDS 289C,A01,895770,Daly; Alan J.,15,0,15,0
1745792467015,EDS 290,A00,897211,Hofstetter; Carolyn,15,0,15,0
1745792468041,LIGM 5A,A00,896162,Fischer-Grunski; Eva K,15,0,20,5
1745792469071,LIGM 5B,A00,896260,Fischer-Grunski; Eva K,17,0,20,3
1745792470099,LIGM 5C,A00,896308,Fischer-Grunski; Eva K,18,0,20,2
1745792471127,LIIT 5AS,A00,896313,Carnelos; Chiara,18,0,20,2
1745792472156,LIIT 5BS,A00,896416,Carnelos; Chiara,20,0,20,0
1745792473183,LIIT 5CS,A00,896564,Carnelos; Chiara,20,0,20,0
1745792474211,LISP 5A,A00,896588,Munoz Sanchez; Alicia,4,0,20,16
1745792475237,LISP 5B,A00,896653,Munoz Sanchez; Alicia,10,0,20,10
1745792476263,LISP 5C,A00,896655,Munoz Sanchez; Alicia,4,0,20,16
1745792477289,MAE 197,001,957918,Kleissl; Jan,9998,0,9999,1
1745792478317,MATH 2,A01,957937,Staff,34,0,35,1
1745792479343,MATH 197,001,957876,Kedlaya; Kiran S.,9993,0,9999,6
1745792480374,MCWP 40,A00,892729,Duru; Nur,13,0,20,7
1745792480374,MCWP 40,B00,893304,Montejo; Carolina,20,0,20,0
1745792481402,MCWP 40R,A00,893757,Redela; Pamela Morgan,0,6,20,20
1745792482427,MCWP 50,A00,893758,Morshed; Michael James,2,0,20,18
1745792482427,MCWP 50,B00,893761,Bartulis; Jason Michael,17,0,20,3
1745792483455,MCWP 50R,A00,893766,Compas; Sean Matthew,0,1,20,20
1745792483455,MCWP 50R,B00,893769,Carter; Jennifer A,0,0,20,20
1745792483455,MCWP 50R,C00,893771,Krone; Jarret,0,3,20,20
1745792483455,MCWP 50R,D00,893772,Miller; Elizabeth Deen,3,0,20,17
1745792483455,MCWP 50R,E00,893775,Carter; Andrea L,0,0,20,20
1745792484481,MMW 11R,A01,892721,Herbst; Matthew,11,0,27,16
1745792484481,MMW 11R,A02,892722,Herbst; Matthew,0,0,0,3
1745792485505,MMW 12R,A01,892724,Herbst; Matthew,0,9,16,16
1745792485505,MMW 12R,A02,892725,Herbst; Matthew,0,9,16,16
1745792486532,MMW 13R,A01,892727,Staff,0,4,16,16
1745792486532,MMW 13R,A02,892728,Staff,0,4,16,16
1745792486532,MMW 13R,A03,958032,Staff,0,3,16,16
1745792486532,MMW 13R,A04,958033,Staff,0,2,16,16
1745792486532,MMW 13R,A05,958034,Staff,0,3,16,16
1745792487558,SIO 295LS,A00,894015,Staff,7,0,25,18
1745792488582,SIO 295S,A00,894020,Staff,7,0,25,18
1745792489608,SIOC 290S,B01,958918,Staff,0,0,0,0
1745792490635,SIOC 291S,B01,958922,Staff,0,0,0,0
1745792491660,SOCI 117,A01,895339,Staff,4,0,5,1
1745792492708,WES 237B,A00,894149,Staff,11,0,20,9
1745792494772,AESE 279B,A00,891859,Staff,13,0,35,22
1745792495798,AIP 197,001,891854,Staff,70,0,70,0
1745792496826,ANTH 289S,A00,891856,Gagneux; Pascal,12,0,12,0
1745792497851,BENG 196,001,957946,Engler; Adam J.,9996,0,9999,3
1745792498875,CAT 124RS,A01,956906,Staff,8,0,25,17
1745792499900,CAT 125RS,A01,922013,Staff,8,0,25,17
1745792500928,CLRE 250,A00,891860,Morris; Sheldon,9995,0,9999,4
1745792502981,CLRE 251R,A00,907817,Mehta; Ravindra L.,9994,0,9999,5
1745792504008,CLRE 252,A00,891864,Cuomo; Raphael Eduardo,9993,0,9999,6
1745792505033,CLRE 253,A00,891867,Vaida; Florin,9994,0,9999,5
1745792505033,CLRE 253,B00,907819,Staff,9999,0,9999,0
1745792506062,CLRE 259,A00,891868,Patel; Hemal,9998,0,9999,1
1745792507089,CLRE 260,A00,891872,Cuomo; Raphael Eduardo,9999,0,9999,0
1745792508116,CLRE 297,001,891888,Cuomo; Raphael Eduardo,9999,0,9999,0
1745792509143,CSE 191,A00,958773,Minnes Kemp; Mor Mia,9999,0,9999,0
1745792510174,CSS 201S,A01,892054,Mignozzetti; Umberto,30,0,30,0
1745792511203,CSS 202S,A01,892056,Mignozzetti; Umberto,30,0,30,0
1745792512231,DSC 197,001,956898,Eldridge; Justin Matthew,9998,0,9999,1
1745792513256,DSC 297,001,958000,Mazumdar; Arya,9998,0,9999,1
1745792514282,EAP 100,A00,905686,Staff,9776,0,9999,223
1745792515309,ECE 45,A01,892618,Staff,0,12,50,50
1745792516334,ECE 109,A01,892620,Staff,0,43,0,0
1745792517361,ECE 111,A01,892719,Staff,0,7,50,50
1745792518387,ECE 197,001,957920,Mercier; Patrick Philip,9992,0,9999,7
1745792519416,ECON 178,A01,907814,Zhu; Ying,28,0,35,7
1745792520443,EDS 115,A00,895312,Staff,41,0,45,4
1745792521468,EDS 117,A01,895337,Staff,30,0,30,0
1745792522495,EDS 125,A00,895341,Jones; Gabrielle Anastasia,43,0,45,2
1745792524243,EDS 128A,A01,895459,Fargason; Sharon Gayle,44,0,45,1
1745792525268,EDS 128B,A01,895543,Pappas; Elizabeth,44,0,45,1
1745792526295,EDS 139,A00,897203,Pappas; Elizabeth,44,0,45,1
1745792526295,EDS 139,B00,897209,Fargason; Sharon Gayle,44,0,45,1
1745792527326,EDS 201,A00,895545,Staff,43,0,45,2
1745792528354,EDS 203,A01,895581,Halter; Christopher P.,43,0,45,2
1745792529384,EDS 204R,A01,895625,Heinzman; Erica M.,43,0,45,2
1745792529384,EDS 204R,B01,895693,Halter; Christopher P.,18,0,45,27
1745792530411,EDS 206R,A00,895694,Fargason; Sharon Gayle,9,0,30,21
1745792530411,EDS 206R,B00,895695,Choi; Bailey Miyeon,20,0,30,10
1745792531438,EDS 250,A00,895697,Hemans; Patricia Ann Benitez,43,0,45,2
1745792532466,EDS 281,A00,895701,Meyerott; Theresa Ann,15,0,15,0
1745792533490,EDS 284,A00,895736,Meyerott; Theresa Ann,15,0,15,0
1745792534518,EDS 286,A00,897210,Fine; Sarah,15,0,15,0
1745792535547,EDS 289C,A01,895770,Daly; Alan J.,15,0,15,0
1745792536578,EDS 290,A00,897211,Hofstetter; Carolyn,15,0,15,0
1745792537607,LIGM 5A,A00,896162,Fischer-Grunski; Eva K,15,0,20,5
1745792538631,LIGM 5B,A00,896260,Fischer-Grunski; Eva K,17,0,20,3
1745792539659,LIGM 5C,A00,896308,Fischer-Grunski; Eva K,18,0,20,2
1745792540690,LIIT 5AS,A00,896313,Carnelos; Chiara,18,0,20,2
1745792541714,LIIT 5BS,A00,896416,Carnelos; Chiara,20,0,20,0
1745792542738,LIIT 5CS,A00,896564,Carnelos; Chiara,20,0,20,0
1745792543766,LISP 5A,A00,896588,Munoz Sanchez; Alicia,4,0,20,16
1745792544797,LISP 5B,A00,896653,Munoz Sanchez; Alicia,10,0,20,10
1745792545830,LISP 5C,A00,896655,Munoz Sanchez; Alicia,4,0,20,16
1745792546857,MAE 197,001,957918,Kleissl; Jan,9998,0,9999,1
1745792547883,MATH 2,A01,957937,Staff,34,0,35,1
1745792548909,MATH 197,001,957876,Kedlaya; Kiran S.,9993,0,9999,6
1745792549936,MCWP 40,A00,892729,Duru; Nur,13,0,20,7
1745792549936,MCWP 40,B00,893304,Montejo; Carolina,20,0,20,0
1745792551036,MCWP 40R,A00,893757,Redela; Pamela Morgan,0,6,20,20
1745792552061,MCWP 50,A00,893758,Morshed; Michael James,2,0,20,18
1745792552061,MCWP 50,B00,893761,Bartulis; Jason Michael,17,0,20,3
1745792553089,MCWP 50R,A00,893766,Compas; Sean Matthew,0,1,20,20
1745792553089,MCWP 50R,B00,893769,Carter; Jennifer A,0,0,20,20
1745792553089,MCWP 50R,C00,893771,Krone; Jarret,0,3,20,20
1745792553089,MCWP 50R,D00,893772,Miller; Elizabeth Deen,3,0,20,17
1745792553089,MCWP 50R,E00,893775,Carter; Andrea L,0,0,20,20
1745792554119,MMW 11R,A01,892721,Herbst; Matthew,11,0,27,16
1745792554119,MMW 11R,A02,892722,Herbst; Matthew,0,0,0,3
1745792555171,MMW 12R,A01,892724,Herbst; Matthew,0,9,16,16
1745792555171,MMW 12R,A02,892725,Herbst; Matthew,0,9,16,16
1745792556199,MMW 13R,A01,892727,Staff,0,4,16,16
1745792556199,MMW 13R,A02,892728,Staff,0,4,16,16
1745792556199,MMW 13R,A03,958032,Staff,0,3,16,16
1745792556199,MMW 13R,A04,958033,Staff,0,2,16,16
1745792556199,MMW 13R,A05,958034,Staff,0,3,16,16
1745792557224,SIO 295LS,A00,894015,Staff,7,0,25,18
1745792558250,SIO 295S,A00,894020,Staff,7,0,25,18
1745792559278,SIOC 290S,B01,958918,Staff,0,0,0,0
1745792560306,SIOC 291S,B01,958922,Staff,0,0,0,0
1745792561334,SOCI 117,A01,895339,Staff,4,0,5,1
1745792562363,WES 237B,A00,894149,Staff,11,0,20,9
1745792564423,AESE 279B,A00,891859,Staff,13,0,35,22
1745792565449,AIP 197,001,891854,Staff,70,0,70,0
1745792566475,ANTH 289S,A00,891856,Gagneux; Pascal,12,0,12,0
1745792567498,BENG 196,001,957946,Engler; Adam J.,9996,0,9999,3
1745792568524,CAT 124RS,A01,956906,Staff,8,0,25,17
1745792569607,CAT 125RS,A01,922013,Staff,8,0,25,17
1745792570639,CLRE 250,A00,891860,Morris; Sheldon,9995,0,9999,4
1745792572687,CLRE 251R,A00,907817,Mehta; Ravindra L.,9994,0,9999,5
1745792573716,CLRE 252,A00,891864,Cuomo; Raphael Eduardo,9993,0,9999,6
1745792574742,CLRE 253,A00,891867,Vaida; Florin,9994,0,9999,5
1745792574742,CLRE 253,B00,907819,Staff,9999,0,9999,0
1745792575771,CLRE 259,A00,891868,Patel; Hemal,9998,0,9999,1
1745792576795,CLRE 260,A00,891872,Cuomo; Raphael Eduardo,9999,0,9999,0
1745792577823,CLRE 297,001,891888,Cuomo; Raphael Eduardo,9999,0,9999,0
1745792578847,CSE 191,A00,958773,Minnes Kemp; Mor Mia,9999,0,9999,0
1745792579875,CSS 201S,A01,892054,Mignozzetti; Umberto,30,0,30,0
1745792580903,CSS 202S,A01,892056,Mignozzetti; Umberto,30,0,30,0
1745792581929,DSC 197,001,956898,Eldridge; Justin Matthew,9998,0,9999,1
1745792582959,DSC 297,001,958000,Mazumdar; Arya,9998,0,9999,1
1745792583986,EAP 100,A00,905686,Staff,9776,0,9999,223
1745792585012,ECE 45,A01,892618,Staff,0,12,50,50
1745792586038,ECE 109,A01,892620,Staff,0,43,0,0
1745792587063,ECE 111,A01,892719,Staff,0,7,50,50
1745792588091,ECE 197,001,957920,Mercier; Patrick Philip,9992,0,9999,7
1745792589116,ECON 178,A01,907814,Zhu; Ying,28,0,35,7
1745792590143,EDS 115,A00,895312,Staff,41,0,45,4
1745792591168,EDS 117,A01,895337,Staff,30,0,30,0
1745792592195,EDS 125,A00,895341,Jones; Gabrielle Anastasia,43,0,45,2
1745792593220,EDS 128A,A01,895459,Fargason; Sharon Gayle,44,0,45,1
1745792594245,EDS 128B,A01,895543,Pappas; Elizabeth,44,0,45,1
1745792595273,EDS 139,A00,897203,Pappas; Elizabeth,44,0,45,1
1745792595273,EDS 139,B00,897209,Fargason; Sharon Gayle,44,0,45,1
1745792596298,EDS 201,A00,895545,Staff,43,0,45,2
1745792597323,EDS 203,A01,895581,Halter; Christopher P.,43,0,45,2
1745792598349,EDS 204R,A01,895625,Heinzman; Erica M.,43,0,45,2
1745792598349,EDS 204R,B01,895693,Halter; Christopher P.,18,0,45,27
1745792599374,EDS 206R,A00,895694,Fargason; Sharon Gayle,9,0,30,21
1745792599374,EDS 206R,B00,895695,Choi; Bailey Miyeon,20,0,30,10
1745792600400,EDS 250,A00,895697,Hemans; Patricia Ann Benitez,43,0,45,2
1745792601427,EDS 281,A00,895701,Meyerott; Theresa Ann,15,0,15,0
1745792602451,EDS 284,A00,895736,Meyerott; Theresa Ann,15,0,15,0
1745792603479,EDS 286,A00,897210,Fine; Sarah,15,0,15,0
1745792604503,EDS 289C,A01,895770,Daly; Alan J.,15,0,15,0
1745792605532,EDS 290,A00,897211,Hofstetter; Carolyn,15,0,15,0
1745792606560,LIGM 5A,A00,896162,Fischer-Grunski; Eva K,15,0,20,5
1745792607584,LIGM 5B,A00,896260,Fischer-Grunski; Eva K,17,0,20,3
1745792608610,LIGM 5C,A00,896308,Fischer-Grunski; Eva K,18,0,20,2
1745792609634,LIIT 5AS,A00,896313,Carnelos; Chiara,18,0,20,2
1745792610661,LIIT 5BS,A00,896416,Carnelos; Chiara,20,0,20,0
1745792611685,LIIT 5CS,A00,896564,Carnelos; Chiara,20,0,20,0
1745792612713,LISP 5A,A00,896588,Munoz Sanchez; Alicia,4,0,20,16
1745792613741,LISP 5B,A00,896653,Munoz Sanchez; Alicia,10,0,20,10
1745792614771,LISP 5C,A00,896655,Munoz Sanchez; Alicia,4,0,20,16
1745792615796,MAE 197,001,957918,Kleissl; Jan,9998,0,9999,1
1745792616823,MATH 2,A01,957937,Staff,34,0,35,1
1745792617851,MATH 197,001,957876,Kedlaya; Kiran S.,9993,0,9999,6
1745792618880,MCWP 40,A00,892729,Duru; Nur,13,0,20,7
1745792618880,MCWP 40,B00,893304,Montejo; Carolina,20,0,20,0
1745792619906,MCWP 40R,A00,893757,Redela; Pamela Morgan,0,6,20,20
1745792620933,MCWP 50,A00,893758,Morshed; Michael James,2,0,20,18
1745792620933,MCWP 50,B00,893761,Bartulis; Jason Michael,17,0,20,3
1745792621958,MCWP 50R,A00,893766,Compas; Sean Matthew,0,1,20,20
1745792621958,MCWP 50R,B00,893769,Carter; Jennifer A,0,0,20,20
1745792621958,MCWP 50R,C00,893771,Krone; Jarret,0,3,20,20
1745792621958,MCWP 50R,D00,893772,Miller; Elizabeth Deen,3,0,20,17
1745792621958,MCWP 50R,E00,893775,Carter; Andrea L,0,0,20,20
1745792622984,MMW 11R,A01,892721,Herbst; Matthew,11,0,27,16
1745792622984,MMW 11R,A02,892722,Herbst; Matthew,0,0,0,3
1745792624012,MMW 12R,A01,892724,Herbst; Matthew,0,9,16,16
1745792624012,MMW 12R,A02,892725,Herbst; Matthew,0,9,16,16
1745792625039,MMW 13R,A01,892727,Staff,0,4,16,16
1745792625039,MMW 13R,A02,892728,Staff,0,4,16,16
1745792625039,MMW 13R,A03,958032,Staff,0,3,16,16
1745792625039,MMW 13R,A04,958033,Staff,0,2,16,16
1745792625039,MMW 13R,A05,958034,Staff,0,3,16,16
1745792626065,SIO 295LS,A00,894015,Staff,7,0,25,18
1745792627090,SIO 295S,A00,894020,Staff,7,0,25,18
1745792628124,SIOC 290S,B01,958918,Staff,0,0,0,0
1745792629154,SIOC 291S,B01,958922,Staff,0,0,0,0
1745792630180,SOCI 117,A01,895339,Staff,4,0,5,1
1745792631208,WES 237B,A00,894149,Staff,11,0,20,9
1745792633277,AESE 279B,A00,891859,Staff,13,0,35,22
1745792634302,AIP 197,001,891854,Staff,70,0,70,0
1745792635331,ANTH 289S,A00,891856,Gagneux; Pascal,12,0,12,0
1745792636358,BENG 196,001,957946,Engler; Adam J.,9996,0,9999,3
1745792637383,CAT 124RS,A01,956906,Staff,8,0,25,17
1745792638406,CAT 125RS,A01,922013,Staff,8,0,25,17
1745792639434,CLRE 250,A00,891860,Morris; Sheldon,9995,0,9999,4
1745792641483,CLRE 251R,A00,907817,Mehta; Ravindra L.,9994,0,9999,5
1745792642509,CLRE 252,A00,891864,Cuomo; Raphael Eduardo,9993,0,9999,6
1745792643538,CLRE 253,A00,891867,Vaida; Florin,9994,0,9999,5
1745792643538,CLRE 253,B00,907819,Staff,9999,0,9999,0
1745792644566,CLRE 259,A00,891868,Patel; Hemal,9998,0,9999,1
1745792645594,CLRE 260,A00,891872,Cuomo; Raphael Eduardo,9999,0,9999,0
1745792646620,CLRE 297,001,891888,Cuomo; Raphael Eduardo,9999,0,9999,0
1745792647647,CSE 191,A00,958773,Minnes Kemp; Mor Mia,9999,0,9999,0
1745792648672,CSS 201S,A01,892054,Mignozzetti; Umberto,30,0,30,0
1745792649701,CSS 202S,A01,892056,Mignozzetti; Umberto,30,0,30,0
1745792650727,DSC 197,001,956898,Eldridge; Justin Matthew,9998,0,9999,1
1745792651752,DSC 297,001,958000,Mazumdar; Arya,9998,0,9999,1
1745792652780,EAP 100,A00,905686,Staff,9776,0,9999,223
1745792653806,ECE 45,A01,892618,Staff,0,12,50,50
1745792654833,ECE 109,A01,892620,Staff,0,43,0,0
1745792655860,ECE 111,A01,892719,Staff,0,7,50,50
1745792656884,ECE 197,001,957920,Mercier; Patrick Philip,9992,0,9999,7
1745792657909,ECON 178,A01,907814,Zhu; Ying,28,0,35,7
1745792658936,EDS 115,A00,895312,Staff,41,0,45,4
1745792659961,EDS 117,A01,895337,Staff,30,0,30,0
1745792660989,EDS 125,A00,895341,Jones; Gabrielle Anastasia,43,0,45,2
1745792662014,EDS 128A,A01,895459,Fargason; Sharon Gayle,44,0,45,1
1745792663041,EDS 128B,A01,895543,Pappas; Elizabeth,44,0,45,1
1745792664067,EDS 139,A00,897203,Pappas; Elizabeth,44,0,45,1
1745792664067,EDS 139,B00,897209,Fargason; Sharon Gayle,44,0,45,1
1745792665093,EDS 201,A00,895545,Staff,43,0,45,2
1745792666117,EDS 203,A01,895581,Halter; Christopher P.,43,0,45,2
1745792667145,EDS 204R,A01,895625,Heinzman; Erica M.,43,0,45,2
1745792667145,EDS 204R,B01,895693,Halter; Christopher P.,18,0,45,27
1745792668171,EDS 206R,A00,895694,Fargason; Sharon Gayle,9,0,30,21
1745792668171,EDS 206R,B00,895695,Choi; Bailey Miyeon,20,0,30,10
1745792669199,EDS 250,A00,895697,Hemans; Patricia Ann Benitez,43,0,45,2
1745792670223,EDS 281,A00,895701,Meyerott; Theresa Ann,15,0,15,0
1745792671252,EDS 284,A00,895736,Meyerott; Theresa Ann,15,0,15,0
1745792672276,EDS 286,A00,897210,Fine; Sarah,15,0,15,0
1745792673301,EDS 289C,A01,895770,Daly; Alan J.,15,0,15,0
1745792674329,EDS 290,A00,897211,Hofstetter; Carolyn,15,0,15,0
1745792675356,LIGM 5A,A00,896162,Fischer-Grunski; Eva K,15,0,20,5
1745792676384,LIGM 5B,A00,896260,Fischer-Grunski; Eva K,17,0,20,3
1745792677411,LIGM 5C,A00,896308,Fischer-Grunski; Eva K,18,0,20,2
1745792678438,LIIT 5AS,A00,896313,Carnelos; Chiara,18,0,20,2
1745792679466,LIIT 5BS,A00,896416,Carnelos; Chiara,20,0,20,0
1745792680495,LIIT 5CS,A00,896564,Carnelos; Chiara,20,0,20,0
1745792681521,LISP 5A,A00,896588,Munoz Sanchez; Alicia,4,0,20,16
1745792682550,LISP 5B,A00,896653,Munoz Sanchez; Alicia,10,0,20,10
1745792683576,LISP 5C,A00,896655,Munoz Sanchez; Alicia,4,0,20,16
1745792684603,MAE 197,001,957918,Kleissl; Jan,9998,0,9999,1
1745792685628,MATH 2,A01,957937,Staff,34,0,35,1
1745792686654,MATH 197,001,957876,Kedlaya; Kiran S.,9993,0,9999,6
1745792687680,MCWP 40,A00,892729,Duru; Nur,13,0,20,7
1745792687680,MCWP 40,B00,893304,Montejo; Carolina,20,0,20,0
1745792688704,MCWP 40R,A00,893757,Redela; Pamela Morgan,0,6,20,20
1745792689760,MCWP 50,A00,893758,Morshed; Michael James,2,0,20,18
1745792689760,MCWP 50,B00,893761,Bartulis; Jason Michael,17,0,20,3
1745792690785,MCWP 50R,A00,893766,Compas; Sean Matthew,0,1,20,20
1745792690785,MCWP 50R,B00,893769,Carter; Jennifer A,0,0,20,20
1745792690785,MCWP 50R,C00,893771,Krone; Jarret,0,3,20,20
1745792690785,MCWP 50R,D00,893772,Miller; Elizabeth Deen,3,0,20,17
1745792690785,MCWP 50R,E00,893775,Carter; Andrea L,0,0,20,20
1745792691812,MMW 11R,A01,892721,Herbst; Matthew,11,0,27,16
1745792691812,MMW 11R,A02,892722,Herbst; Matthew,0,0,0,3
1745792692836,MMW 12R,A01,892724,Herbst; Matthew,0,9,16,16
1745792692836,MMW 12R,A02,892725,Herbst; Matthew,0,9,16,16
1745792693862,MMW 13R,A01,892727,Staff,0,4,16,16
1745792693862,MMW 13R,A02,892728,Staff,0,4,16,16
1745792693862,MMW 13R,A03,958032,Staff,0,3,16,16
1745792693862,MMW 13R,A04,958033,Staff,0,2,16,16
1745792693862,MMW 13R,A05,958034,Staff,0,3,16,16
1745792694892,SIO 295LS,A00,894015,Staff,7,0,25,18
1745792695915,SIO 295S,A00,894020,Staff,7,0,25,18
1745792696941,SIOC 290S,B01,958918,Staff,0,0,0,0
1745792697966,SIOC 291S,B01,958922,Staff,0,0,0,0
1745792698994,SOCI 117,A01,895339,Staff,4,0,5,1
1745792700019,WES 237B,A00,894149,Staff,11,0,20,9
1745792702080,AESE 279B,A00,891859,Staff,13,0,35,22
1745792703107,AIP 197,001,891854,Staff,70,0,70,0
1745792704137,ANTH 289S,A00,891856,Gagneux; Pascal,12,0,12,0
1745792705165,BENG 196,001,957946,Engler; Adam J.,9996,0,9999,3
1745792706191,CAT 124RS,A01,956906,Staff,8,0,25,17
1745792707216,CAT 125RS,A01,922013,Staff,8,0,25,17
1745792708241,CLRE 250,A00,891860,Morris; Sheldon,9995,0,9999,4
1745792710318,CLRE 251R,A00,907817,Mehta; Ravindra L.,9994,0,9999,5
1745792711343,CLRE 252,A00,891864,Cuomo; Raphael Eduardo,9993,0,9999,6
1745792712373,CLRE 253,A00,891867,Vaida; Florin,9994,0,9999,5
1745792712373,CLRE 253,B00,907819,Staff,9999,0,9999,0
1745792713401,CLRE 259,A00,891868,Patel; Hemal,9998,0,9999,1
1745792714427,CLRE 260,A00,891872,Cuomo; Raphael Eduardo,9999,0,9999,0
1745792715452,CLRE 297,001,891888,Cuomo; Raphael Eduardo,9999,0,9999,0
1745792716478,CSE 191,A00,958773,Minnes Kemp; Mor Mia,9999,0,9999,0
1745792717506,CSS 201S,A01,892054,Mignozzetti; Umberto,30,0,30,0
1745792718532,CSS 202S,A01,892056,Mignozzetti; Umberto,30,0,30,0
1745792719556,DSC 197,001,956898,Eldridge; Justin Matthew,9998,0,9999,1
1745792720581,DSC 297,001,958000,Mazumdar; Arya,9998,0,9999,1
1745792721608,EAP 100,A00,905686,Staff,9776,0,9999,223
1745792722632,ECE 45,A01,892618,Staff,0,12,50,50
1745792723660,ECE 109,A01,892620,Staff,0,43,0,0
1745792724685,ECE 111,A01,892719,Staff,0,7,50,50
1745792725711,ECE 197,001,957920,Mercier; Patrick Philip,9992,0,9999,7
1745792726753,ECON 178,A01,907814,Zhu; Ying,28,0,35,7
1745792727778,EDS 115,A00,895312,Staff,41,0,45,4
1745792728803,EDS 117,A01,895337,Staff,30,0,30,0
1745792729832,EDS 125,A00,895341,Jones; Gabrielle Anastasia,43,0,45,2
1745792730858,EDS 128A,A01,895459,Fargason; Sharon Gayle,44,0,45,1
1745792731883,EDS 128B,A01,895543,Pappas; Elizabeth,44,0,45,1
1745792732907,EDS 139,A00,897203,Pappas; Elizabeth,44,0,45,1
1745792732907,EDS 139,B00,897209,Fargason; Sharon Gayle,44,0,45,1
1745792733933,EDS 201,A00,895545,Staff,43,0,45,2
1745792734960,EDS 203,A01,895581,Halter; Christopher P.,43,0,45,2
1745792735984,EDS 204R,A01,895625,Heinzman; Erica M.,43,0,45,2
1745792735984,EDS 204R,B01,895693,Halter; Christopher P.,18,0,45,27
1745792737011,EDS 206R,A00,895694,Fargason; Sharon Gayle,9,0,30,21
1745792737011,EDS 206R,B00,895695,Choi; Bailey Miyeon,20,0,30,10
1745792738038,EDS 250,A00,895697,Hemans; Patricia Ann Benitez,43,0,45,2
1745792739063,EDS 281,A00,895701,Meyerott; Theresa Ann,15,0,15,0
1745792740088,EDS 284,A00,895736,Meyerott; Theresa Ann,15,0,15,0
1745792741118,EDS 286,A00,897210,Fine; Sarah,15,0,15,0
1745792742146,EDS 289C,A01,895770,Daly; Alan J.,15,0,15,0
1745792743171,EDS 290,A00,897211,Hofstetter; Carolyn,15,0,15,0
1745792744197,LIGM 5A,A00,896162,Fischer-Grunski; Eva K,15,0,20,5
1745792745226,LIGM 5B,A00,896260,Fischer-Grunski; Eva K,17,0,20,3
1745792746255,LIGM 5C,A00,896308,Fischer-Grunski; Eva K,18,0,20,2
1745792747284,LIIT 5AS,A00,896313,Carnelos; Chiara,18,0,20,2
1745792748309,LIIT 5BS,A00,896416,Carnelos; Chiara,20,0,20,0
1745792749338,LIIT 5CS,A00,896564,Carnelos; Chiara,20,0,20,0
1745792750367,LISP 5A,A00,896588,Munoz Sanchez; Alicia,4,0,20,16
1745792751395,LISP 5B,A00,896653,Munoz Sanchez; Alicia,10,0,20,10
1745792752420,LISP 5C,A00,896655,Munoz Sanchez; Alicia,4,0,20,16
1745792753446,MAE 197,001,957918,Kleissl; Jan,9998,0,9999,1
1745792754474,MATH 2,A01,957937,Staff,34,0,35,1
1745792755500,MATH 197,001,957876,Kedlaya; Kiran S.,9993,0,9999,6
1745792756525,MCWP 40,A00,892729,Duru; Nur,13,0,20,7
1745792756525,MCWP 40,B00,893304,Montejo; Carolina,20,0,20,0
1745792757550,MCWP 40R,A00,893757,Redela; Pamela Morgan,0,6,20,20
1745792758577,MCWP 50,A00,893758,Morshed; Michael James,2,0,20,18
1745792758577,MCWP 50,B00,893761,Bartulis; Jason Michael,17,0,20,3
1745792759606,MCWP 50R,A00,893766,Compas; Sean Matthew,0,1,20,20
1745792759606,MCWP 50R,B00,893769,Carter; Jennifer A,0,0,20,20
1745792759606,MCWP 50R,C00,893771,Krone; Jarret,0,3,20,20
1745792759606,MCWP 50R,D00,893772,Miller; Elizabeth Deen,3,0,20,17
1745792759606,MCWP 50R,E00,893775,Carter; Andrea L,0,0,20,20
1745792760631,MMW 11R,A01,892721,Herbst; Matthew,11,0,27,16
1745792760631,MMW 11R,A02,892722,Herbst; Matthew,0,0,0,3
1745792761656,MMW 12R,A01,892724,Herbst; Matthew,0,9,16,16
1745792761656,MMW 12R,A02,892725,Herbst; Matthew,0,9,16,16
1745792762682,MMW 13R,A01,892727,Staff,0,4,16,16
1745792762682,MMW 13R,A02,892728,Staff,0,4,16,16
1745792762682,MMW 13R,A03,958032,Staff,0,3,16,16
1745792762682,MMW 13R,A04,958033,Staff,0,2,16,16
1745792762682,MMW 13R,A05,958034,Staff,0,3,16,16
1745792763708,SIO 295LS,A00,894015,Staff,7,0,25,18
1745792764733,SIO 295S,A00,894020,Staff,7,0,25,18
1745792765762,SIOC 290S,B01,958918,Staff,0,0,0,0
1745792766788,SIOC 291S,B01,958922,Staff,0,0,0,0
1745792767814,SOCI 117,A01,895339,Staff,4,0,5,1
1745792768840,WES 237B,A00,894149,Staff,11,0,20,9
1745792770896,AESE 279B,A00,891859,Staff,13,0,35,22
1745792771922,AIP 197,001,891854,Staff,70,0,70,0
1745792772950,ANTH 289S,A00,891856,Gagneux; Pascal,12,0,12,0
1745792773983,BENG 196,001,957946,Engler; Adam J.,9996,0,9999,3
1745792775009,CAT 124RS,A01,956906,Staff,8,0,25,17
1745792776033,CAT 125RS,A01,922013,Staff,8,0,25,17
1745792777073,CLRE 250,A00,891860,Morris; Sheldon,9995,0,9999,4
1745792779124,CLRE 251R,A00,907817,Mehta; Ravindra L.,9994,0,9999,5
1745792780149,CLRE 252,A00,891864,Cuomo; Raphael Eduardo,9993,0,9999,6
1745792781176,CLRE 253,A00,891867,Vaida; Florin,9994,0,9999,5
1745792781176,CLRE 253,B00,907819,Staff,9999,0,9999,0
1745792782202,CLRE 259,A00,891868,Patel; Hemal,9998,0,9999,1
1745792783227,CLRE 260,A00,891872,Cuomo; Raphael Eduardo,9999,0,9999,0
1745792784253,CLRE 297,001,891888,Cuomo; Raphael Eduardo,9999,0,9999,0
1745792785277,CSE 191,A00,958773,Minnes Kemp; Mor Mia,9999,0,9999,0
1745792786303,CSS 201S,A01,892054,Mignozzetti; Umberto,30,0,30,0
1745792787332,CSS 202S,A01,892056,Mignozzetti; Umberto,30,0,30,0
1745792788358,DSC 197,001,956898,Eldridge; Justin Matthew,9998,0,9999,1
1745792789383,DSC 297,001,958000,Mazumdar; Arya,9998,0,9999,1
1745792790409,EAP 100,A00,905686,Staff,9776,0,9999,223
1745792791434,ECE 45,A01,892618,Staff,0,12,50,50
1745792792461,ECE 109,A01,892620,Staff,0,43,0,0
1745792793487,ECE 111,A01,892719,Staff,0,7,50,50
1745792794512,ECE 197,001,957920,Mercier; Patrick Philip,9992,0,9999,7
1745792795538,ECON 178,A01,907814,Zhu; Ying,28,0,35,7
1745792796566,EDS 115,A00,895312,Staff,41,0,45,4
1745792797592,EDS 117,A01,895337,Staff,30,0,30,0
1745792798618,EDS 125,A00,895341,Jones; Gabrielle Anastasia,43,0,45,2
1745792799648,EDS 128A,A01,895459,Fargason; Sharon Gayle,44,0,45,1
1745792800676,EDS 128B,A01,895543,Pappas; Elizabeth,44,0,45,1
1745792801705,EDS 139,A00,897203,Pappas; Elizabeth,44,0,45,1
1745792801705,EDS 139,B00,897209,Fargason; Sharon Gayle,44,0,45,1
1745792802733,EDS 201,A00,895545,Staff,43,0,45,2
1745792803760,EDS 203,A01,895581,Halter; Christopher P.,43,0,45,2
1745792804788,EDS 204R,A01,895625,Heinzman; Erica M.,43,0,45,2
1745792804788,EDS 204R,B01,895693,Halter; Christopher P.,18,0,45,27
1745792805818,EDS 206R,A00,895694,Fargason; Sharon Gayle,9,0,30,21
1745792805818,EDS 206R,B00,895695,Choi; Bailey Miyeon,20,0,30,10
1745792806845,EDS 250,A00,895697,Hemans; Patricia Ann Benitez,43,0,45,2
1745792807873,EDS 281,A00,895701,Meyerott; Theresa Ann,15,0,15,0
1745792808901,EDS 284,A00,895736,Meyerott; Theresa Ann,15,0,15,0
1745792809925,EDS 286,A00,897210,Fine; Sarah,15,0,15,0
1745792810956,EDS 289C,A01,895770,Daly; Alan J.,15,0,15,0
1745792811983,EDS 290,A00,897211,Hofstetter; Carolyn,15,0,15,0
1745792813008,LIGM 5A,A00,896162,Fischer-Grunski; Eva K,15,0,20,5
1745792814038,LIGM 5B,A00,896260,Fischer-Grunski; Eva K,17,0,20,3
1745792815066,LIGM 5C,A00,896308,Fischer-Grunski; Eva K,18,0,20,2
1745792816093,LIIT 5AS,A00,896313,Carnelos; Chiara,18,0,20,2
1745792817120,LIIT 5BS,A00,896416,Carnelos; Chiara,20,0,20,0
1745792818147,LIIT 5CS,A00,896564,Carnelos; Chiara,20,0,20,0
1745792819175,LISP 5A,A00,896588,Munoz Sanchez; Alicia,4,0,20,16
1745792820204,LISP 5B,A00,896653,Munoz Sanchez; Alicia,10,0,20,10
1745792821236,LISP 5C,A00,896655,Munoz Sanchez; Alicia,4,0,20,16
1745792822262,MAE 197,001,957918,Kleissl; Jan,9998,0,9999,1
1745792823289,MATH 2,A01,957937,Staff,34,0,35,1
1745792824317,MATH 197,001,957876,Kedlaya; Kiran S.,9993,0,9999,6
1745792825345,MCWP 40,A00,892729,Duru; Nur,13,0,20,7
1745792825345,MCWP 40,B00,893304,Montejo; Carolina,20,0,20,0
1745792826374,MCWP 40R,A00,893757,Redela; Pamela Morgan,0,6,20,20
1745792827403,MCWP 50,A00,893758,Morshed; Michael James,2,0,20,18
1745792827403,MCWP 50,B00,893761,Bartulis; Jason Michael,17,0,20,3
1745792828433,MCWP 50R,A00,893766,Compas; Sean Matthew,0,1,20,20
1745792828433,MCWP 50R,B00,893769,Carter; Jennifer A,0,0,20,20
1745792828433,MCWP 50R,C00,893771,Krone; Jarret,0,3,20,20
1745792828433,MCWP 50R,D00,893772,Miller; Elizabeth Deen,3,0,20,17
1745792828433,MCWP 50R,E00,893775,Carter; Andrea L,0,0,20,20
1745792829462,MMW 11R,A01,892721,Herbst; Matthew,11,0,27,16
1745792829462,MMW 11R,A02,892722,Herbst; Matthew,0,0,0,3
1745792830490,MMW 12R,A01,892724,Herbst; Matthew,0,9,16,16
1745792830490,MMW 12R,A02,892725,Herbst; Matthew,0,9,16,16
1745792831516,MMW 13R,A01,892727,Staff,0,4,16,16
1745792831516,MMW 13R,A02,892728,Staff,0,4,16,16
1745792831516,MMW 13R,A03,958032,Staff,0,3,16,16
1745792831516,MMW 13R,A04,958033,Staff,0,2,16,16
1745792831516,MMW 13R,A05,958034,Staff,0,3,16,16
1745792832545,SIO 295LS,A00,894015,Staff,7,0,25,18
1745792833572,SIO 295S,A00,894020,Staff,7,0,25,18
1745792834599,SIOC 290S,B01,958918,Staff,0,0,0,0
1745792835626,SIOC 291S,B01,958922,Staff,0,0,0,0
1745792836650,SOCI 117,A01,895339,Staff,4,0,5,1
1745792837677,WES 237B,A00,894149,Staff,11,0,20,9
1745792839736,AESE 279B,A00,891859,Staff,13,0,35,22
1745792840761,AIP 197,001,891854,Staff,70,0,70,0
1745792841786,ANTH 289S,A00,891856,Gagneux; Pascal,12,0,12,0
1745792842813,BENG 196,001,957946,Engler; Adam J.,9996,0,9999,3
1745792843843,CAT 124RS,A01,956906,Staff,8,0,25,17
1745792844869,CAT 125RS,A01,922013,Staff,8,0,25,17
1745792845896,CLRE 250,A00,891860,Morris; Sheldon,9995,0,9999,4
1745792847954,CLRE 251R,A00,907817,Mehta; Ravindra L.,9994,0,9999,5
1745792848979,CLRE 252,A00,891864,Cuomo; Raphael Eduardo,9993,0,9999,6
1745792850007,CLRE 253,A00,891867,Vaida; Florin,9994,0,9999,5
1745792850007,CLRE 253,B00,907819,Staff,9999,0,9999,0
1745792851033,CLRE 259,A00,891868,Patel; Hemal,9998,0,9999,1
1745792852063,CLRE 260,A00,891872,Cuomo; Raphael Eduardo,9999,0,9999,0
1745792853090,CLRE 297,001,891888,Cuomo; Raphael Eduardo,9999,0,9999,0
1745792854117,CSE 191,A00,958773,Minnes Kemp; Mor Mia,9999,0,9999,0
1745792855144,CSS 201S,A01,892054,Mignozzetti; Umberto,30,0,30,0
1745792856175,CSS 202S,A01,892056,Mignozzetti; Umberto,30,0,30,0
1745792857203,DSC 197,001,956898,Eldridge; Justin Matthew,9998,0,9999,1
1745792858228,DSC 297,001,958000,Mazumdar; Arya,9998,0,9999,1
1745792859255,EAP 100,A00,905686,Staff,9776,0,9999,223
1745792860283,ECE 45,A01,892618,Staff,0,12,50,50
1745792861311,ECE 109,A01,892620,Staff,0,43,0,0
1745792862338,ECE 111,A01,892719,Staff,0,7,50,50
1745792863365,ECE 197,001,957920,Mercier; Patrick Philip,9992,0,9999,7
1745792864396,ECON 178,A01,907814,Zhu; Ying,28,0,35,7
1745792865420,EDS 115,A00,895312,Staff,41,0,45,4
1745792866448,EDS 117,A01,895337,Staff,30,0,30,0
1745792867476,EDS 125,A00,895341,Jones; Gabrielle Anastasia,43,0,45,2
1745792868504,EDS 128A,A01,895459,Fargason; Sharon Gayle,44,0,45,1
1745792869531,EDS 128B,A01,895543,Pappas; Elizabeth,44,0,45,1
1745792870555,EDS 139,A00,897203,Pappas; Elizabeth,44,0,45,1
1745792870555,EDS 139,B00,897209,Fargason; Sharon Gayle,44,0,45,1
1745792871582,EDS 201,A00,895545,Staff,43,0,45,2
1745792872611,EDS 203,A01,895581,Halter; Christopher P.,43,0,45,2
1745792873636,EDS 204R,A01,895625,Heinzman; Erica M.,43,0,45,2
1745792873636,EDS 204R,B01,895693,Halter; Christopher P.,18,0,45,27
1745792874661,EDS 206R,A00,895694,Fargason; Sharon Gayle,9,0,30,21
1745792874661,EDS 206R,B00,895695,Choi; Bailey Miyeon,20,0,30,10
1745792875688,EDS 250,A00,895697,Hemans; Patricia Ann Benitez,43,0,45,2
1745792876713,EDS 281,A00,895701,Meyerott; Theresa Ann,15,0,15,0
1745792877741,EDS 284,A00,895736,Meyerott; Theresa Ann,15,0,15,0
1745792878770,EDS 286,A00,897210,Fine; Sarah,15,0,15,0
1745792879795,EDS 289C,A01,895770,Daly; Alan J.,15,0,15,0
1745792880821,EDS 290,A00,897211,Hofstetter; Carolyn,15,0,15,0
1745792881848,LIGM 5A,A00,896162,Fischer-Grunski; Eva K,15,0,20,5
1745792882875,LIGM 5B,A00,896260,Fischer-Grunski; Eva K,17,0,20,3
1745792883903,LIGM 5C,A00,896308,Fischer-Grunski; Eva K,18,0,20,2
1745792884933,LIIT 5AS,A00,896313,Carnelos; Chiara,18,0,20,2
1745792885959,LIIT 5BS,A00,896416,Carnelos; Chiara,20,0,20,0
1745792886986,LIIT 5CS,A00,896564,Carnelos; Chiara,20,0,20,0
1745792888014,LISP 5A,A00,896588,Munoz Sanchez; Alicia,4,0,20,16
1745792889046,LISP 5B,A00,896653,Munoz Sanchez; Alicia,10,0,20,10
1745792890075,LISP 5C,A00,896655,Munoz Sanchez; Alicia,4,0,20,16
1745792891104,MAE 197,001,957918,Kleissl; Jan,9998,0,9999,1
1745792892132,MATH 2,A01,957937,Staff,34,0,35,1
1745792893158,MATH 197,001,957876,Kedlaya; Kiran S.,9993,0,9999,6
1745792894186,MCWP 40,A00,892729,Duru; Nur,13,0,20,7
1745792894186,MCWP 40,B00,893304,Montejo; Carolina,20,0,20,0
1745792895214,MCWP 40R,A00,893757,Redela; Pamela Morgan,0,6,20,20
1745792896243,MCWP 50,A00,893758,Morshed; Michael James,2,0,20,18
1745792896243,MCWP 50,B00,893761,Bartulis; Jason Michael,17,0,20,3
1745792897279,MCWP 50R,A00,893766,Compas; Sean Matthew,0,1,20,20
1745792897279,MCWP 50R,B00,893769,Carter; Jennifer A,0,0,20,20
1745792897279,MCWP 50R,C00,893771,Krone; Jarret,0,3,20,20
1745792897279,MCWP 50R,D00,893772,Miller; Elizabeth Deen,3,0,20,17
1745792897279,MCWP 50R,E00,893775,Carter; Andrea L,0,0,20,20
1745792898303,MMW 11R,A01,892721,Herbst; Matthew,11,0,27,16
1745792898303,MMW 11R,A02,892722,Herbst; Matthew,0,0,0,3
1745792899326,MMW 12R,A01,892724,Herbst; Matthew,0,9,16,16
1745792899326,MMW 12R,A02,892725,Herbst; Matthew,0,9,16,16
1745792900352,MMW 13R,A01,892727,Staff,0,4,16,16
1745792900352,MMW 13R,A02,892728,Staff,0,4,16,16
1745792900352,MMW 13R,A03,958032,Staff,0,3,16,16
1745792900352,MMW 13R,A04,958033,Staff,0,2,16,16
1745792900352,MMW 13R,A05,958034,Staff,0,3,16,16
1745792901380,SIO 295LS,A00,894015,Staff,7,0,25,18
1745792902405,SIO 295S,A00,894020,Staff,7,0,25,18
1745792903433,SIOC 290S,B01,958918,Staff,0,0,0,0
1745792904462,SIOC 291S,B01,958922,Staff,0,0,0,0
1745792905490,SOCI 117,A01,895339,Staff,4,0,5,1
1745792906519,WES 237B,A00,894149,Staff,11,0,20,9
1745792908574,AESE 279B,A00,891859,Staff,13,0,35,22
1745792909601,AIP 197,001,891854,Staff,70,0,70,0
1745792910630,ANTH 289S,A00,891856,Gagneux; Pascal,12,0,12,0
1745792911655,BENG 196,001,957946,Engler; Adam J.,9996,0,9999,3
1745792912680,CAT 124RS,A01,956906,Staff,8,0,25,17
1745792913705,CAT 125RS,A01,922013,Staff,8,0,25,17
1745792914732,CLRE 250,A00,891860,Morris; Sheldon,9995,0,9999,4
1745792916786,CLRE 251R,A00,907817,Mehta; Ravindra L.,9994,0,9999,5
1745792917814,CLRE 252,A00,891864,Cuomo; Raphael Eduardo,9993,0,9999,6
1745792918843,CLRE 253,A00,891867,Vaida; Florin,9994,0,9999,5
1745792918843,CLRE 253,B00,907819,Staff,9999,0,9999,0
1745792919867,CLRE 259,A00,891868,Patel; Hemal,9998,0,9999,1
1745792920895,CLRE 260,A00,891872,Cuomo; Raphael Eduardo,9999,0,9999,0
1745792921923,CLRE 297,001,891888,Cuomo; Raphael Eduardo,9999,0,9999,0
1745792922951,CSE 191,A00,958773,Minnes Kemp; Mor Mia,9999,0,9999,0
1745792923977,CSS 201S,A01,892054,Mignozzetti; Umberto,30,0,30,0
1745792925005,CSS 202S,A01,892056,Mignozzetti; Umberto,30,0,30,0
1745792926034,DSC 197,001,956898,Eldridge; Justin Matthew,9998,0,9999,1
1745792927060,DSC 297,001,958000,Mazumdar; Arya,9998,0,9999,1
1745792928086,EAP 100,A00,905686,Staff,9776,0,9999,223
1745792929113,ECE 45,A01,892618,Staff,0,12,50,50
1745792930138,ECE 109,A01,892620,Staff,0,43,0,0
1745792931165,ECE 111,A01,892719,Staff,0,7,50,50
1745792932193,ECE 197,001,957920,Mercier; Patrick Philip,9992,0,9999,7
1745792933223,ECON 178,A01,907814,Zhu; Ying,28,0,35,7
1745792934249,EDS 115,A00,895312,Staff,41,0,45,4
1745792935274,EDS 117,A01,895337,Staff,30,0,30,0
1745792936302,EDS 125,A00,895341,Jones; Gabrielle Anastasia,43,0,45,2
1745792937328,EDS 128A,A01,895459,Fargason; Sharon Gayle,44,0,45,1
1745792938359,EDS 128B,A01,895543,Pappas; Elizabeth,44,0,45,1
1745792939388,EDS 139,A00,897203,Pappas; Elizabeth,44,0,45,1
1745792939388,EDS 139,B00,897209,Fargason; Sharon Gayle,44,0,45,1
1745792940416,EDS 201,A00,895545,Staff,43,0,45,2
1745792941441,EDS 203,A01,895581,Halter; Christopher P.,43,0,45,2
1745792942469,EDS 204R,A01,895625,Heinzman; Erica M.,43,0,45,2
1745792942469,EDS 204R,B01,895693,Halter; Christopher P.,18,0,45,27
1745792943496,EDS 206R,A00,895694,Fargason; Sharon Gayle,9,0,30,21
1745792943496,EDS 206R,B00,895695,Choi; Bailey Miyeon,20,0,30,10
1745792944523,EDS 250,A00,895697,Hemans; Patricia Ann Benitez,43,0,45,2
1745792945551,EDS 281,A00,895701,Meyerott; Theresa Ann,15,0,15,0
1745792946580,EDS 284,A00,895736,Meyerott; Theresa Ann,15,0,15,0
1745792947605,EDS 286,A00,897210,Fine; Sarah,15,0,15,0
1745792948632,EDS 289C,A01,895770,Daly; Alan J.,15,0,15,0
1745792949659,EDS 290,A00,897211,Hofstetter; Carolyn,15,0,15,0
1745792950686,LIGM 5A,A00,896162,Fischer-Grunski; Eva K,15,0,20,5
1745792951717,LIGM 5B,A00,896260,Fischer-Grunski; Eva K,17,0,20,3
1745792952745,LIGM 5C,A00,896308,Fischer-Grunski; Eva K,18,0,20,2
1745792953774,LIIT 5AS,A00,896313,Carnelos; Chiara,18,0,20,2
1745792954802,LIIT 5BS,A00,896416,Carnelos; Chiara,20,0,20,0
1745792955830,LIIT 5CS,A00,896564,Carnelos; Chiara,20,0,20,0
1745792956856,LISP 5A,A00,896588,Munoz Sanchez; Alicia,4,0,20,16
1745792957882,LISP 5B,A00,896653,Munoz Sanchez; Alicia,10,0,20,10
1745792958909,LISP 5C,A00,896655,Munoz Sanchez; Alicia,4,0,20,16
1745792959938,MAE 197,001,957918,Kleissl; Jan,9998,0,9999,1
1745792960964,MATH 2,A01,957937,Staff,34,0,35,1
1745792961993,MATH 197,001,957876,Kedlaya; Kiran S.,9993,0,9999,6
1745792963020,MCWP 40,A00,892729,Duru; Nur,13,0,20,7
1745792963020,MCWP 40,B00,893304,Montejo; Carolina,20,0,20,0
1745792964046,MCWP 40R,A00,893757,Redela; Pamela Morgan,0,6,20,20
1745792965073,MCWP 50,A00,893758,Morshed; Michael James,2,0,20,18
1745792965073,MCWP 50,B00,893761,Bartulis; Jason Michael,17,0,20,3
1745792966104,MCWP 50R,A00,893766,Compas; Sean Matthew,0,1,20,20
1745792966104,MCWP 50R,B00,893769,Carter; Jennifer A,0,0,20,20
1745792966104,MCWP 50R,C00,893771,Krone; Jarret,0,3,20,20
1745792966104,MCWP 50R,D00,893772,Miller; Elizabeth Deen,3,0,20,17
1745792966104,MCWP 50R,E00,893775,Carter; Andrea L,0,0,20,20
1745792967128,MMW 11R,A01,892721,Herbst; Matthew,11,0,27,16
1745792967128,MMW 11R,A02,892722,Herbst; Matthew,0,0,0,3
1745792968155,MMW 12R,A01,892724,Herbst; Matthew,0,9,16,16
1745792968155,MMW 12R,A02,892725,Herbst; Matthew,0,9,16,16
1745792969182,MMW 13R,A01,892727,Staff,0,4,16,16
1745792969182,MMW 13R,A02,892728,Staff,0,4,16,16
1745792969182,MMW 13R,A03,958032,Staff,0,3,16,16
1745792969182,MMW 13R,A04,958033,Staff,0,2,16,16
1745792969182,MMW 13R,A05,958034,Staff,0,3,16,16
1745792970207,SIO 295LS,A00,894015,Staff,7,0,25,18
1745792971233,SIO 295S,A00,894020,Staff,7,0,25,18
1745792972261,SIOC 290S,B01,958918,Staff,0,0,0,0
1745792973291,SIOC 291S,B01,958922,Staff,0,0,0,0
1745792974319,SOCI 117,A01,895339,Staff,4,0,5,1
1745792975346,WES 237B,A00,894149,Staff,11,0,20,9
1745792977403,AESE 279B,A00,891859,Staff,13,0,35,22
1745792978428,AIP 197,001,891854,Staff,70,0,70,0
1745792979454,ANTH 289S,A00,891856,Gagneux; Pascal,12,0,12,0
1745792980483,BENG 196,001,957946,Engler; Adam J.,9996,0,9999,3
1745792981512,CAT 124RS,A01,956906,Staff,8,0,25,17
1745792982539,CAT 125RS,A01,922013,Staff,8,0,25,17
1745792983568,CLRE 250,A00,891860,Morris; Sheldon,9995,0,9999,4
1745792985627,CLRE 251R,A00,907817,Mehta; Ravindra L.,9994,0,9999,5
1745792986652,CLRE 252,A00,891864,Cuomo; Raphael Eduardo,9993,0,9999,6
1745792987680,CLRE 253,A00,891867,Vaida; Florin,9994,0,9999,5
1745792987680,CLRE 253,B00,907819,Staff,9999,0,9999,0
1745792988704,CLRE 259,A00,891868,Patel; Hemal,9998,0,9999,1
1745792989730,CLRE 260,A00,891872,Cuomo; Raphael Eduardo,9999,0,9999,0
1745792990754,CLRE 297,001,891888,Cuomo; Raphael Eduardo,9999,0,9999,0
1745792991782,CSE 191,A00,958773,Minnes Kemp; Mor Mia,9999,0,9999,0
1745792992806,CSS 201S,A01,892054,Mignozzetti; Umberto,30,0,30,0
1745792993835,CSS 202S,A01,892056,Mignozzetti; Umberto,30,0,30,0
1745792994859,DSC 197,001,956898,Eldridge; Justin Matthew,9998,0,9999,1
1745792995884,DSC 297,001,958000,Mazumdar; Arya,9998,0,9999,1
1745792996908,EAP 100,A00,905686,Staff,9776,0,9999,223
1745792997933,ECE 45,A01,892618,Staff,0,12,50,50
1745792998957,ECE 109,A01,892620,Staff,0,43,0,0
1745792999983,ECE 111,A01,892719,Staff,0,7,50,50
1745793001010,ECE 197,001,957920,Mercier; Patrick Philip,9992,0,9999,7
1745793002038,ECON 178,A01,907814,Zhu; Ying,28,0,35,7
1745793003154,EDS 115,A00,895312,Staff,41,0,45,4
1745793004179,EDS 117,A01,895337,Staff,30,0,30,0
1745793005204,EDS 125,A00,895341,Jones; Gabrielle Anastasia,43,0,45,2
1745793006230,EDS 128A,A01,895459,Fargason; Sharon Gayle,44,0,45,1
1745793007258,EDS 128B,A01,895543,Pappas; Elizabeth,44,0,45,1
1745793008285,EDS 139,A00,897203,Pappas; Elizabeth,44,0,45,1
1745793008285,EDS 139,B00,897209,Fargason; Sharon Gayle,44,0,45,1
1745793009309,EDS 201,A00,895545,Staff,43,0,45,2
1745793010333,EDS 203,A01,895581,Halter; Christopher P.,43,0,45,2
1745793011361,EDS 204R,A01,895625,Heinzman; Erica M.,43,0,45,2
1745793011361,EDS 204R,B01,895693,Halter; Christopher P.,18,0,45,27
1745793012399,EDS 206R,A00,895694,Fargason; Sharon Gayle,9,0,30,21
1745793012399,EDS 206R,B00,895695,Choi; Bailey Miyeon,20,0,30,10
1745793013447,EDS 250,A00,895697,Hemans; Patricia Ann Benitez,43,0,45,2
1745793014475,EDS 281,A00,895701,Meyerott; Theresa Ann,15,0,15,0
1745793015502,EDS 284,A00,895736,Meyerott; Theresa Ann,15,0,15,0
1745793016529,EDS 286,A00,897210,Fine; Sarah,15,0,15,0
1745793017552,EDS 289C,A01,895770,Daly; Alan J.,15,0,15,0
1745793018577,EDS 290,A00,897211,Hofstetter; Carolyn,15,0,15,0
1745793019601,LIGM 5A,A00,896162,Fischer-Grunski; Eva K,15,0,20,5
1745793020624,LIGM 5B,A00,896260,Fischer-Grunski; Eva K,17,0,20,3
1745793021652,LIGM 5C,A00,896308,Fischer-Grunski; Eva K,18,0,20,2
1745793022679,LIIT 5AS,A00,896313,Carnelos; Chiara,18,0,20,2
1745793023706,LIIT 5BS,A00,896416,Carnelos; Chiara,20,0,20,0
1745793024731,LIIT 5CS,A00,896564,Carnelos; Chiara,20,0,20,0
1745793025759,LISP 5A,A00,896588,Munoz Sanchez; Alicia,4,0,20,16
1745793026786,LISP 5B,A00,896653,Munoz Sanchez; Alicia,10,0,20,10
1745793027810,LISP 5C,A00,896655,Munoz Sanchez; Alicia,4,0,20,16
1745793028837,MAE 197,001,957918,Kleissl; Jan,9998,0,9999,1
1745793029865,MATH 2,A01,957937,Staff,34,0,35,1
1745793030892,MATH 197,001,957876,Kedlaya; Kiran S.,9993,0,9999,6
1745793031918,MCWP 40,A00,892729,Duru; Nur,13,0,20,7
1745793031918,MCWP 40,B00,893304,Montejo; Carolina,20,0,20,0
1745793032943,MCWP 40R,A00,893757,Redela; Pamela Morgan,0,6,20,20
1745793033971,MCWP 50,A00,893758,Morshed; Michael James,2,0,20,18
1745793033971,MCWP 50,B00,893761,Bartulis; Jason Michael,17,0,20,3
1745793035001,MCWP 50R,A00,893766,Compas; Sean Matthew,0,1,20,20
1745793035001,MCWP 50R,B00,893769,Carter; Jennifer A,0,0,20,20
1745793035001,MCWP 50R,C00,893771,Krone; Jarret,0,3,20,20
1745793035001,MCWP 50R,D00,893772,Miller; Elizabeth Deen,3,0,20,17
1745793035001,MCWP 50R,E00,893775,Carter; Andrea L,0,0,20,20
1745793036027,MMW 11R,A01,892721,Herbst; Matthew,11,0,27,16
1745793036027,MMW 11R,A02,892722,Herbst; Matthew,0,0,0,3
1745793037051,MMW 12R,A01,892724,Herbst; Matthew,0,9,16,16
1745793037051,MMW 12R,A02,892725,Herbst; Matthew,0,9,16,16
1745793038078,MMW 13R,A01,892727,Staff,0,4,16,16
1745793038078,MMW 13R,A02,892728,Staff,0,4,16,16
1745793038078,MMW 13R,A03,958032,Staff,0,3,16,16
1745793038078,MMW 13R,A04,958033,Staff,0,2,16,16
1745793038078,MMW 13R,A05,958034,Staff,0,3,16,16
1745793039102,SIO 295LS,A00,894015,Staff,7,0,25,18
1745793040126,SIO 295S,A00,894020,Staff,7,0,25,18
1745793041152,SIOC 290S,B01,958918,Staff,0,0,0,0
1745793042181,SIOC 291S,B01,958922,Staff,0,0,0,0
1745793043207,SOCI 117,A01,895339,Staff,4,0,5,1
1745793044235,WES 237B,A00,894149,Staff,11,0,20,9
1745793046293,AESE 279B,A00,891859,Staff,13,0,35,22
1745793047318,AIP 197,001,891854,Staff,70,0,70,0
1745793048344,ANTH 289S,A00,891856,Gagneux; Pascal,12,0,12,0
1745793049368,BENG 196,001,957946,Engler; Adam J.,9996,0,9999,3
1745793050392,CAT 124RS,A01,956906,Staff,8,0,25,17
1745793051419,CAT 125RS,A01,922013,Staff,8,0,25,17
1745793052445,CLRE 250,A00,891860,Morris; Sheldon,9995,0,9999,4
1745793054495,CLRE 251R,A00,907817,Mehta; Ravindra L.,9994,0,9999,5
1745793055521,CLRE 252,A00,891864,Cuomo; Raphael Eduardo,9993,0,9999,6
1745793056548,CLRE 253,A00,891867,Vaida; Florin,9994,0,9999,5
1745793056548,CLRE 253,B00,907819,Staff,9999,0,9999,0
1745793057575,CLRE 259,A00,891868,Patel; Hemal,9998,0,9999,1
1745793058601,CLRE 260,A00,891872,Cuomo; Raphael Eduardo,9999,0,9999,0
1745793059631,CLRE 297,001,891888,Cuomo; Raphael Eduardo,9999,0,9999,0
1745793060654,CSE 191,A00,958773,Minnes Kemp; Mor Mia,9999,0,9999,0
1745793061678,CSS 201S,A01,892054,Mignozzetti; Umberto,30,0,30,0
1745793062707,CSS 202S,A01,892056,Mignozzetti; Umberto,30,0,30,0
1745793063731,DSC 197,001,956898,Eldridge; Justin Matthew,9998,0,9999,1
1745793064757,DSC 297,001,958000,Mazumdar; Arya,9998,0,9999,1
1745793065784,EAP 100,A00,905686,Staff,9776,0,9999,223
1745793066809,ECE 45,A01,892618,Staff,0,12,50,50
1745793067836,ECE 109,A01,892620,Staff,0,43,0,0
1745793068860,ECE 111,A01,892719,Staff,0,7,50,50
1745793069884,ECE 197,001,957920,Mercier; Patrick Philip,9992,0,9999,7
1745793070909,ECON 178,A01,907814,Zhu; Ying,28,0,35,7
1745793071937,EDS 115,A00,895312,Staff,41,0,45,4
1745793072965,EDS 117,A01,895337,Staff,30,0,30,0
1745793073992,EDS 125,A00,895341,Jones; Gabrielle Anastasia,43,0,45,2
1745793075023,EDS 128A,A01,895459,Fargason; Sharon Gayle,44,0,45,1
1745793076050,EDS 128B,A01,895543,Pappas; Elizabeth,44,0,45,1
1745793077078,EDS 139,A00,897203,Pappas; Elizabeth,44,0,45,1
1745793077078,EDS 139,B00,897209,Fargason; Sharon Gayle,44,0,45,1
1745793078104,EDS 201,A00,895545,Staff,43,0,45,2
1745793079132,EDS 203,A01,895581,Halter; Christopher P.,43,0,45,2
1745793080160,EDS 204R,A01,895625,Heinzman; Erica M.,43,0,45,2
1745793080160,EDS 204R,B01,895693,Halter; Christopher P.,18,0,45,27
1745793081191,EDS 206R,A00,895694,Fargason; Sharon Gayle,9,0,30,21
1745793081191,EDS 206R,B00,895695,Choi; Bailey Miyeon,20,0,30,10
1745793082220,EDS 250,A00,895697,Hemans; Patricia Ann Benitez,43,0,45,2
1745793083246,EDS 281,A00,895701,Meyerott; Theresa Ann,15,0,15,0
1745793084273,EDS 284,A00,895736,Meyerott; Theresa Ann,15,0,15,0
1745793094015,EDS 286,A00,897210,Fine; Sarah,15,0,15,0
1745793095042,EDS 289C,A01,895770,Daly; Alan J.,15,0,15,0
1745793096068,EDS 290,A00,897211,Hofstetter; Carolyn,15,0,15,0
1745793097133,LIGM 5A,A00,896162,Fischer-Grunski; Eva K,15,0,20,5
1745793098161,LIGM 5B,A00,896260,Fischer-Grunski; Eva K,17,0,20,3
1745793099189,LIGM 5C,A00,896308,Fischer-Grunski; Eva K,18,0,20,2
1745793100217,LIIT 5AS,A00,896313,Carnelos; Chiara,18,0,20,2
1745793101244,LIIT 5BS,A00,896416,Carnelos; Chiara,20,0,20,0
1745793102273,LIIT 5CS,A00,896564,Carnelos; Chiara,20,0,20,0
1745793103298,LISP 5A,A00,896588,Munoz Sanchez; Alicia,4,0,20,16
1745793104326,LISP 5B,A00,896653,Munoz Sanchez; Alicia,10,0,20,10
1745793105356,LISP 5C,A00,896655,Munoz Sanchez; Alicia,4,0,20,16
1745793106381,MAE 197,001,957918,Kleissl; Jan,9998,0,9999,1
1745793107405,MATH 2,A01,957937,Staff,34,0,35,1
1745793108430,MATH 197,001,957876,Kedlaya; Kiran S.,9993,0,9999,6
1745793109454,MCWP 40,A00,892729,Duru; Nur,13,0,20,7
1745793109454,MCWP 40,B00,893304,Montejo; Carolina,20,0,20,0
1745793110480,MCWP 40R,A00,893757,Redela; Pamela Morgan,0,6,20,20
1745793111511,MCWP 50,A00,893758,Morshed; Michael James,2,0,20,18
1745793111511,MCWP 50,B00,893761,Bartulis; Jason Michael,17,0,20,3
1745793112536,MCWP 50R,A00,893766,Compas; Sean Matthew,0,1,20,20
1745793112536,MCWP 50R,B00,893769,Carter; Jennifer A,0,0,20,20
1745793112536,MCWP 50R,C00,893771,Krone; Jarret,0,3,20,20
1745793112536,MCWP 50R,D00,893772,Miller; Elizabeth Deen,3,0,20,17
1745793112536,MCWP 50R,E00,893775,Carter; Andrea L,0,0,20,20
1745793113562,MMW 11R,A01,892721,Herbst; Matthew,11,0,27,16
1745793113562,MMW 11R,A02,892722,Herbst; Matthew,0,0,0,3
1745793114586,MMW 12R,A01,892724,Herbst; Matthew,0,9,16,16
1745793114586,MMW 12R,A02,892725,Herbst; Matthew,0,9,16,16
1745793115611,MMW 13R,A01,892727,Staff,0,4,16,16
1745793115611,MMW 13R,A02,892728,Staff,0,4,16,16
1745793115611,MMW 13R,A03,958032,Staff,0,3,16,16
1745793115611,MMW 13R,A04,958033,Staff,0,2,16,16
1745793115611,MMW 13R,A05,958034,Staff,0,3,16,16
1745793116635,SIO 295LS,A00,894015,Staff,7,0,25,18
1745793117661,SIO 295S,A00,894020,Staff,7,0,25,18
1745793118686,SIOC 290S,B01,958918,Staff,0,0,0,0
1745793119714,SIOC 291S,B01,958922,Staff,0,0,0,0
1745793120741,SOCI 117,A01,895339,Staff,4,0,5,1
1745793121769,WES 237B,A00,894149,Staff,11,0,20,9
1745793123840,AESE 279B,A00,891859,Staff,13,0,35,22
1745793124865,AIP 197,001,891854,Staff,70,0,70,0
1745793125888,ANTH 289S,A00,891856,Gagneux; Pascal,12,0,12,0
1745793126913,BENG 196,001,957946,Engler; Adam J.,9996,0,9999,3
1745793127940,CAT 124RS,A01,956906,Staff,8,0,25,17
1745793128964,CAT 125RS,A01,922013,Staff,8,0,25,17
1745793129989,CLRE 250,A00,891860,Morris; Sheldon,9995,0,9999,4
1745793132041,CLRE 251R,A00,907817,Mehta; Ravindra L.,9994,0,9999,5
1745793133065,CLRE 252,A00,891864,Cuomo; Raphael Eduardo,9993,0,9999,6
1745793134094,CLRE 253,A00,891867,Vaida; Florin,9994,0,9999,5
1745793134094,CLRE 253,B00,907819,Staff,9999,0,9999,0
1745793135125,CLRE 259,A00,891868,Patel; Hemal,9998,0,9999,1
1745793136153,CLRE 260,A00,891872,Cuomo; Raphael Eduardo,9999,0,9999,0
1745793137178,CLRE 297,001,891888,Cuomo; Raphael Eduardo,9999,0,9999,0
1745793138202,CSE 191,A00,958773,Minnes Kemp; Mor Mia,9999,0,9999,0
1745793139228,CSS 201S,A01,892054,Mignozzetti; Umberto,30,0,30,0
1745793140254,CSS 202S,A01,892056,Mignozzetti; Umberto,30,0,30,0
1745793141279,DSC 197,001,956898,Eldridge; Justin Matthew,9998,0,9999,1
1745793142305,DSC 297,001,958000,Mazumdar; Arya,9998,0,9999,1
1745793143329,EAP 100,A00,905686,Staff,9776,0,9999,223
1745793144354,ECE 45,A01,892618,Staff,0,12,50,50
1745793145381,ECE 109,A01,892620,Staff,0,43,0,0
1745793146405,ECE 111,A01,892719,Staff,0,7,50,50
1745793147431,ECE 197,001,957920,Mercier; Patrick Philip,9992,0,9999,7
1745793148461,ECON 178,A01,907814,Zhu; Ying,28,0,35,7
1745793149488,EDS 115,A00,895312,Staff,41,0,45,4
1745793150513,EDS 117,A01,895337,Staff,30,0,30,0
1745793151544,EDS 125,A00,895341,Jones; Gabrielle Anastasia,43,0,45,2
1745793152569,EDS 128A,A01,895459,Fargason; Sharon Gayle,44,0,45,1
1745793153600,EDS 128B,A01,895543,Pappas; Elizabeth,44,0,45,1
1745793154628,EDS 139,A00,897203,Pappas; Elizabeth,44,0,45,1
1745793154628,EDS 139,B00,897209,Fargason; Sharon Gayle,44,0,45,1
1745793155656,EDS 201,A00,895545,Staff,43,0,45,2
1745793156681,EDS 203,A01,895581,Halter; Christopher P.,43,0,45,2
1745793157712,EDS 204R,A01,895625,Heinzman; Erica M.,43,0,45,2
1745793157712,EDS 204R,B01,895693,Halter; Christopher P.,18,0,45,27
1745793158739,EDS 206R,A00,895694,Fargason; Sharon Gayle,9,0,30,21
1745793158739,EDS 206R,B00,895695,Choi; Bailey Miyeon,20,0,30,10
1745793159766,EDS 250,A00,895697,Hemans; Patricia Ann Benitez,43,0,45,2
1745793160793,EDS 281,A00,895701,Meyerott; Theresa Ann,15,0,15,0
1745793161818,EDS 284,A00,895736,Meyerott; Theresa Ann,15,0,15,0
1745793162848,EDS 286,A00,897210,Fine; Sarah,15,0,15,0
1745793163876,EDS 289C,A01,895770,Daly; Alan J.,15,0,15,0
1745793164903,EDS 290,A00,897211,Hofstetter; Carolyn,15,0,15,0
1745793165928,LIGM 5A,A00,896162,Fischer-Grunski; Eva K,15,0,20,5
1745793166955,LIGM 5B,A00,896260,Fischer-Grunski; Eva K,17,0,20,3
1745793167984,LIGM 5C,A00,896308,Fischer-Grunski; Eva K,18,0,20,2
1745793169013,LIIT 5AS,A00,896313,Carnelos; Chiara,18,0,20,2
1745793170040,LIIT 5BS,A00,896416,Carnelos; Chiara,20,0,20,0
1745793171064,LIIT 5CS,A00,896564,Carnelos; Chiara,20,0,20,0
1745793172094,LISP 5A,A00,896588,Munoz Sanchez; Alicia,4,0,20,16
1745793173123,LISP 5B,A00,896653,Munoz Sanchez; Alicia,10,0,20,10
1745793174150,LISP 5C,A00,896655,Munoz Sanchez; Alicia,4,0,20,16
1745793175177,MAE 197,001,957918,Kleissl; Jan,9998,0,9999,1
1745793176204,MATH 2,A01,957937,Staff,34,0,35,1
1745793177230,MATH 197,001,957876,Kedlaya; Kiran S.,9993,0,9999,6
1745793178260,MCWP 40,A00,892729,Duru; Nur,13,0,20,7
1745793178260,MCWP 40,B00,893304,Montejo; Carolina,20,0,20,0
1745793179286,MCWP 40R,A00,893757,Redela; Pamela Morgan,0,6,20,20
1745793180317,MCWP 50,A00,893758,Morshed; Michael James,2,0,20,18
1745793180317,MCWP 50,B00,893761,Bartulis; Jason Michael,17,0,20,3
1745793181348,MCWP 50R,A00,893766,Compas; Sean Matthew,0,1,20,20
1745793181348,MCWP 50R,B00,893769,Carter; Jennifer A,0,0,20,20
1745793181348,MCWP 50R,C00,893771,Krone; Jarret,0,3,20,20
1745793181348,MCWP 50R,D00,893772,Miller; Elizabeth Deen,3,0,20,17
1745793181348,MCWP 50R,E00,893775,Carter; Andrea L,0,0,20,20
1745793182385,MMW 11R,A01,892721,Herbst; Matthew,11,0,27,16
1745793182385,MMW 11R,A02,892722,Herbst; Matthew,0,0,0,3
1745793183414,MMW 12R,A01,892724,Herbst; Matthew,0,9,16,16
1745793183414,MMW 12R,A02,892725,Herbst; Matthew,0,9,16,16
1745793184443,MMW 13R,A01,892727,Staff,0,4,16,16
1745793184443,MMW 13R,A02,892728,Staff,0,4,16,16
1745793184443,MMW 13R,A03,958032,Staff,0,3,16,16
1745793184443,MMW 13R,A04,958033,Staff,0,2,16,16
1745793184443,MMW 13R,A05,958034,Staff,0,3,16,16
1745793185471,SIO 295LS,A00,894015,Staff,7,0,25,18
1745793186498,SIO 295S,A00,894020,Staff,7,0,25,18
1745793187522,SIOC 290S,B01,958918,Staff,0,0,0,0
1745793188548,SIOC 291S,B01,958922,Staff,0,0,0,0
1745793189576,SOCI 117,A01,895339,Staff,4,0,5,1
1745793190601,WES 237B,A00,894149,Staff,11,0,20,9
1745793192661,AESE 279B,A00,891859,Staff,13,0,35,22
1745793193685,AIP 197,001,891854,Staff,70,0,70,0
1745793194714,ANTH 289S,A00,891856,Gagneux; Pascal,12,0,12,0
1745793195738,BENG 196,001,957946,Engler; Adam J.,9996,0,9999,3
1745793196765,CAT 124RS,A01,956906,Staff,8,0,25,17
1745793197792,CAT 125RS,A01,922013,Staff,8,0,25,17
1745793198817,CLRE 250,A00,891860,Morris; Sheldon,9995,0,9999,4
1745793200866,CLRE 251R,A00,907817,Mehta; Ravindra L.,9994,0,9999,5
1745793201893,CLRE 252,A00,891864,Cuomo; Raphael Eduardo,9993,0,9999,6
1745793202919,CLRE 253,A00,891867,Vaida; Florin,9994,0,9999,5
1745793202919,CLRE 253,B00,907819,Staff,9999,0,9999,0
1745793203946,CLRE 259,A00,891868,Patel; Hemal,9998,0,9999,1
1745793204971,CLRE 260,A00,891872,Cuomo; Raphael Eduardo,9999,0,9999,0
1745793205996,CLRE 297,001,891888,Cuomo; Raphael Eduardo,9999,0,9999,0
1745793207024,CSE 191,A00,958773,Minnes Kemp; Mor Mia,9999,0,9999,0
1745793208052,CSS 201S,A01,892054,Mignozzetti; Umberto,30,0,30,0
1745793209080,CSS 202S,A01,892056,Mignozzetti; Umberto,30,0,30,0
1745793210105,DSC 197,001,956898,Eldridge; Justin Matthew,9998,0,9999,1
1745793211134,DSC 297,001,958000,Mazumdar; Arya,9998,0,9999,1
1745793212159,EAP 100,A00,905686,Staff,9776,0,9999,223
1745793213186,ECE 45,A01,892618,Staff,0,12,50,50
1745793214211,ECE 109,A01,892620,Staff,0,43,0,0
1745793215242,ECE 111,A01,892719,Staff,0,7,50,50
1745793216269,ECE 197,001,957920,Mercier; Patrick Philip,9992,0,9999,7
1745793217296,ECON 178,A01,907814,Zhu; Ying,28,0,35,7
1745793218326,EDS 115,A00,895312,Staff,41,0,45,4
1745793219353,EDS 117,A01,895337,Staff,30,0,30,0
1745793220380,EDS 125,A00,895341,Jones; Gabrielle Anastasia,43,0,45,2
1745793221406,EDS 128A,A01,895459,Fargason; Sharon Gayle,44,0,45,1
1745793222430,EDS 128B,A01,895543,Pappas; Elizabeth,44,0,45,1
1745793223457,EDS 139,A00,897203,Pappas; Elizabeth,44,0,45,1
1745793223457,EDS 139,B00,897209,Fargason; Sharon Gayle,44,0,45,1
1745793224486,EDS 201,A00,895545,Staff,43,0,45,2
1745793225513,EDS 203,A01,895581,Halter; Christopher P.,43,0,45,2
1745793226541,EDS 204R,A01,895625,Heinzman; Erica M.,43,0,45,2
1745793226541,EDS 204R,B01,895693,Halter; Christopher P.,18,0,45,27
1745793227566,EDS 206R,A00,895694,Fargason; Sharon Gayle,9,0,30,21
1745793227566,EDS 206R,B00,895695,Choi; Bailey Miyeon,20,0,30,10
1745793228593,EDS 250,A00,895697,Hemans; Patricia Ann Benitez,43,0,45,2
1745793229618,EDS 281,A00,895701,Meyerott; Theresa Ann,15,0,15,0
1745793230645,EDS 284,A00,895736,Meyerott; Theresa Ann,15,0,15,0
1745793231672,EDS 286,A00,897210,Fine; Sarah,15,0,15,0
1745793232700,EDS 289C,A01,895770,Daly; Alan J.,15,0,15,0
1745793233727,EDS 290,A00,897211,Hofstetter; Carolyn,15,0,15,0
1745793234754,LIGM 5A,A00,896162,Fischer-Grunski; Eva K,15,0,20,5
1745793235782,LIGM 5B,A00,896260,Fischer-Grunski; Eva K,17,0,20,3
1745793236811,LIGM 5C,A00,896308,Fischer-Grunski; Eva K,18,0,20,2
1745793237839,LIIT 5AS,A00,896313,Carnelos; Chiara,18,0,20,2
1745793238893,LIIT 5BS,A00,896416,Carnelos; Chiara,20,0,20,0
1745793239921,LIIT 5CS,A00,896564,Carnelos; Chiara,20,0,20,0
1745793240948,LISP 5A,A00,896588,Munoz Sanchez; Alicia,4,0,20,16
1745793241972,LISP 5B,A00,896653,Munoz Sanchez; Alicia,10,0,20,10
1745793242998,LISP 5C,A00,896655,Munoz Sanchez; Alicia,4,0,20,16
1745793244023,MAE 197,001,957918,Kleissl; Jan,9998,0,9999,1
1745793245049,MATH 2,A01,957937,Staff,34,0,35,1
1745793246077,MATH 197,001,957876,Kedlaya; Kiran S.,9993,0,9999,6
1745793247102,MCWP 40,A00,892729,Duru; Nur,13,0,20,7
1745793247102,MCWP 40,B00,893304,Montejo; Carolina,20,0,20,0
1745793248129,MCWP 40R,A00,893757,Redela; Pamela Morgan,0,6,20,20
1745793249174,MCWP 50,A00,893758,Morshed; Michael James,2,0,20,18
1745793249174,MCWP 50,B00,893761,Bartulis; Jason Michael,17,0,20,3
1745793250203,MCWP 50R,A00,893766,Compas; Sean Matthew,0,1,20,20
1745793250203,MCWP 50R,B00,893769,Carter; Jennifer A,0,0,20,20
1745793250203,MCWP 50R,C00,893771,Krone; Jarret,0,3,20,20
1745793250203,MCWP 50R,D00,893772,Miller; Elizabeth Deen,3,0,20,17
1745793250203,MCWP 50R,E00,893775,Carter; Andrea L,0,0,20,20
1745793251231,MMW 11R,A01,892721,Herbst; Matthew,11,0,27,16
1745793251231,MMW 11R,A02,892722,Herbst; Matthew,0,0,0,3
1745793252255,MMW 12R,A01,892724,Herbst; Matthew,0,9,16,16
1745793252255,MMW 12R,A02,892725,Herbst; Matthew,0,9,16,16
1745793253281,MMW 13R,A01,892727,Staff,0,4,16,16
1745793253281,MMW 13R,A02,892728,Staff,0,4,16,16
1745793253281,MMW 13R,A03,958032,Staff,0,3,16,16
1745793253281,MMW 13R,A04,958033,Staff,0,2,16,16
1745793253281,MMW 13R,A05,958034,Staff,0,3,16,16
1745793254308,SIO 295LS,A00,894015,Staff,7,0,25,18
1745793255333,SIO 295S,A00,894020,Staff,7,0,25,18
1745793256360,SIOC 290S,B01,958918,Staff,0,0,0,0
1745793257388,SIOC 291S,B01,958922,Staff,0,0,0,0
1745793258417,SOCI 117,A01,895339,Staff,4,0,5,1
1745793259440,WES 237B,A00,894149,Staff,11,0,20,9
1745793261499,AESE 279B,A00,891859,Staff,13,0,35,22
1745793262521,AIP 197,001,891854,Staff,70,0,70,0
1745793263546,ANTH 289S,A00,891856,Gagneux; Pascal,12,0,12,0
1745793264574,BENG 196,001,957946,Engler; Adam J.,9996,0,9999,3
1745793265599,CAT 124RS,A01,956906,Staff,8,0,25,17
1745793266625,CAT 125RS,A01,922013,Staff,8,0,25,17
1745793267650,CLRE 250,A00,891860,Morris; Sheldon,9995,0,9999,4
1745793269701,CLRE 251R,A00,907817,Mehta; Ravindra L.,9994,0,9999,5
1745793270725,CLRE 252,A00,891864,Cuomo; Raphael Eduardo,9993,0,9999,6
1745793271752,CLRE 253,A00,891867,Vaida; Florin,9994,0,9999,5
1745793271752,CLRE 253,B00,907819,Staff,9999,0,9999,0
1745793272780,CLRE 259,A00,891868,Patel; Hemal,9998,0,9999,1
1745793273807,CLRE 260,A00,891872,Cuomo; Raphael Eduardo,9999,0,9999,0
1745793274836,CLRE 297,001,891888,Cuomo; Raphael Eduardo,9999,0,9999,0
1745793275866,CSE 191,A00,958773,Minnes Kemp; Mor Mia,9999,0,9999,0
1745793276899,CSS 201S,A01,892054,Mignozzetti; Umberto,30,0,30,0
1745793277927,CSS 202S,A01,892056,Mignozzetti; Umberto,30,0,30,0
1745793278955,DSC 197,001,956898,Eldridge; Justin Matthew,9998,0,9999,1
1745793279980,DSC 297,001,958000,Mazumdar; Arya,9998,0,9999,1
1745793281009,EAP 100,A00,905686,Staff,9776,0,9999,223
1745793282038,ECE 45,A01,892618,Staff,0,12,50,50
1745793283063,ECE 109,A01,892620,Staff,0,43,0,0
1745793284089,ECE 111,A01,892719,Staff,0,7,50,50
1745793285114,ECE 197,001,957920,Mercier; Patrick Philip,9992,0,9999,7
1745793286140,ECON 178,A01,907814,Zhu; Ying,28,0,35,7
1745793287169,EDS 115,A00,895312,Staff,41,0,45,4
1745793288213,EDS 117,A01,895337,Staff,30,0,30,0
1745793289237,EDS 125,A00,895341,Jones; Gabrielle Anastasia,43,0,45,2
1745793290265,EDS 128A,A01,895459,Fargason; Sharon Gayle,44,0,45,1
1745793291291,EDS 128B,A01,895543,Pappas; Elizabeth,44,0,45,1
1745793292314,EDS 139,A00,897203,Pappas; Elizabeth,44,0,45,1
1745793292314,EDS 139,B00,897209,Fargason; Sharon Gayle,44,0,45,1
1745793293337,EDS 201,A00,895545,Staff,43,0,45,2
1745793294361,EDS 203,A01,895581,Halter; Christopher P.,43,0,45,2
1745793295391,EDS 204R,A01,895625,Heinzman; Erica M.,43,0,45,2
1745793295391,EDS 204R,B01,895693,Halter; Christopher P.,18,0,45,27
1745793296418,EDS 206R,A00,895694,Fargason; Sharon Gayle,9,0,30,21
1745793296418,EDS 206R,B00,895695,Choi; Bailey Miyeon,20,0,30,10
1745793297445,EDS 250,A00,895697,Hemans; Patricia Ann Benitez,43,0,45,2
1745793298472,EDS 281,A00,895701,Meyerott; Theresa Ann,15,0,15,0
1745793299497,EDS 284,A00,895736,Meyerott; Theresa Ann,15,0,15,0
1745793300528,EDS 286,A00,897210,Fine; Sarah,15,0,15,0
1745793301555,EDS 289C,A01,895770,Daly; Alan J.,15,0,15,0
1745793302586,EDS 290,A00,897211,Hofstetter; Carolyn,15,0,15,0
1745793303619,LIGM 5A,A00,896162,Fischer-Grunski; Eva K,15,0,20,5
1745793304649,LIGM 5B,A00,896260,Fischer-Grunski; Eva K,17,0,20,3
1745793305676,LIGM 5C,A00,896308,Fischer-Grunski; Eva K,18,0,20,2
1745793306704,LIIT 5AS,A00,896313,Carnelos; Chiara,18,0,20,2
1745793307731,LIIT 5BS,A00,896416,Carnelos; Chiara,20,0,20,0
1745793308757,LIIT 5CS,A00,896564,Carnelos; Chiara,20,0,20,0
1745793309786,LISP 5A,A00,896588,Munoz Sanchez; Alicia,4,0,20,16
1745793310813,LISP 5B,A00,896653,Munoz Sanchez; Alicia,10,0,20,10
1745793311842,LISP 5C,A00,896655,Munoz Sanchez; Alicia,4,0,20,16
1745793312866,MAE 197,001,957918,Kleissl; Jan,9998,0,9999,1
1745793313896,MATH 2,A01,957937,Staff,34,0,35,1
1745793314926,MATH 197,001,957876,Kedlaya; Kiran S.,9993,0,9999,6
1745793315955,MCWP 40,A00,892729,Duru; Nur,13,0,20,7
1745793315955,MCWP 40,B00,893304,Montejo; Carolina,20,0,20,0
1745793316985,MCWP 40R,A00,893757,Redela; Pamela Morgan,0,6,20,20
1745793318015,MCWP 50,A00,893758,Morshed; Michael James,2,0,20,18
1745793318015,MCWP 50,B00,893761,Bartulis; Jason Michael,17,0,20,3
1745793319041,MCWP 50R,A00,893766,Compas; Sean Matthew,0,1,20,20
1745793319041,MCWP 50R,B00,893769,Carter; Jennifer A,0,0,20,20
1745793319041,MCWP 50R,C00,893771,Krone; Jarret,0,3,20,20
1745793319041,MCWP 50R,D00,893772,Miller; Elizabeth Deen,3,0,20,17
1745793319041,MCWP 50R,E00,893775,Carter; Andrea L,0,0,20,20
1745793320071,MMW 11R,A01,892721,Herbst; Matthew,11,0,27,16
1745793320071,MMW 11R,A02,892722,Herbst; Matthew,0,0,0,3
1745793321097,MMW 12R,A01,892724,Herbst; Matthew,0,9,16,16
1745793321097,MMW 12R,A02,892725,Herbst; Matthew,0,9,16,16
1745793322142,MMW 13R,A01,892727,Staff,0,4,16,16
1745793322142,MMW 13R,A02,892728,Staff,0,4,16,16
1745793322142,MMW 13R,A03,958032,Staff,0,3,16,16
1745793322142,MMW 13R,A04,958033,Staff,0,2,16,16
1745793322142,MMW 13R,A05,958034,Staff,0,3,16,16
1745793323167,SIO 295LS,A00,894015,Staff,7,0,25,18
1745793324194,SIO 295S,A00,894020,Staff,7,0,25,18
1745793325224,SIOC 290S,B01,958918,Staff,0,0,0,0
1745793326251,SIOC 291S,B01,958922,Staff,0,0,0,0
1745793327280,SOCI 117,A01,895339,Staff,4,0,5,1
1745793328309,WES 237B,A00,894149,Staff,11,0,20,9
1745793330374,AESE 279B,A00,891859,Staff,13,0,35,22
1745793331401,AIP 197,001,891854,Staff,70,0,70,0
1745793332426,ANTH 289S,A00,891856,Gagneux; Pascal,12,0,12,0
1745793333455,BENG 196,001,957946,Engler; Adam J.,9996,0,9999,3
1745793334480,CAT 124RS,A01,956906,Staff,8,0,25,17
1745793335509,CAT 125RS,A01,922013,Staff,8,0,25,17
1745793336535,CLRE 250,A00,891860,Morris; Sheldon,9995,0,9999,4
1745793338591,CLRE 251R,A00,907817,Mehta; Ravindra L.,9994,0,9999,5
1745793339622,CLRE 252,A00,891864,Cuomo; Raphael Eduardo,9993,0,9999,6
1745793340651,CLRE 253,A00,891867,Vaida; Florin,9994,0,9999,5
1745793340651,CLRE 253,B00,907819,Staff,9999,0,9999,0
1745793341676,CLRE 259,A00,891868,Patel; Hemal,9998,0,9999,1
1745793342701,CLRE 260,A00,891872,Cuomo; Raphael Eduardo,9999,0,9999,0
1745793343726,CLRE 297,001,891888,Cuomo; Raphael Eduardo,9999,0,9999,0
1745793344753,CSE 191,A00,958773,Minnes Kemp; Mor Mia,9999,0,9999,0
1745793345784,CSS 201S,A01,892054,Mignozzetti; Umberto,30,0,30,0
1745793346812,CSS 202S,A01,892056,Mignozzetti; Umberto,30,0,30,0
1745793347838,DSC 197,001,956898,Eldridge; Justin Matthew,9998,0,9999,1
1745793348861,DSC 297,001,958000,Mazumdar; Arya,9998,0,9999,1
1745793349891,EAP 100,A00,905686,Staff,9776,0,9999,223
1745793350916,ECE 45,A01,892618,Staff,0,12,50,50
1745793351945,ECE 109,A01,892620,Staff,0,43,0,0
1745793352971,ECE 111,A01,892719,Staff,0,7,50,50
1745793353998,ECE 197,001,957920,Mercier; Patrick Philip,9992,0,9999,7
1745793355024,ECON 178,A01,907814,Zhu; Ying,28,0,35,7
1745793356052,EDS 115,A00,895312,Staff,41,0,45,4
1745793357083,EDS 117,A01,895337,Staff,30,0,30,0
1745793358109,EDS 125,A00,895341,Jones; Gabrielle Anastasia,43,0,45,2
1745793359136,EDS 128A,A01,895459,Fargason; Sharon Gayle,44,0,45,1
1745793360163,EDS 128B,A01,895543,Pappas; Elizabeth,44,0,45,1
1745793361190,EDS 139,A00,897203,Pappas; Elizabeth,44,0,45,1
1745793361190,EDS 139,B00,897209,Fargason; Sharon Gayle,44,0,45,1
1745793362217,EDS 201,A00,895545,Staff,43,0,45,2
1745793363245,EDS 203,A01,895581,Halter; Christopher P.,43,0,45,2
1745793364272,EDS 204R,A01,895625,Heinzman; Erica M.,43,0,45,2
1745793364272,EDS 204R,B01,895693,Halter; Christopher P.,18,0,45,27
1745793365303,EDS 206R,A00,895694,Fargason; Sharon Gayle,9,0,30,21
1745793365303,EDS 206R,B00,895695,Choi; Bailey Miyeon,20,0,30,10
1745793366331,EDS 250,A00,895697,Hemans; Patricia Ann Benitez,43,0,45,2
1745793367359,EDS 281,A00,895701,Meyerott; Theresa Ann,15,0,15,0
1745793368389,EDS 284,A00,895736,Meyerott; Theresa Ann,15,0,15,0
1745793369418,EDS 286,A00,897210,Fine; Sarah,15,0,15,0
1745793370445,EDS 289C,A01,895770,Daly; Alan J.,15,0,15,0
1745793371475,EDS 290,A00,897211,Hofstetter; Carolyn,15,0,15,0
1745793372501,LIGM 5A,A00,896162,Fischer-Grunski; Eva K,15,0,20,5
1745793373530,LIGM 5B,A00,896260,Fischer-Grunski; Eva K,17,0,20,3
1745793374555,LIGM 5C,A00,896308,Fischer-Grunski; Eva K,18,0,20,2
1745793375584,LIIT 5AS,A00,896313,Carnelos; Chiara,18,0,20,2
1745793376615,LIIT 5BS,A00,896416,Carnelos; Chiara,20,0,20,0
1745793377644,LIIT 5CS,A00,896564,Carnelos; Chiara,20,0,20,0
1745793378672,LISP 5A,A00,896588,Munoz Sanchez; Alicia,4,0,20,16
1745793379695,LISP 5B,A00,896653,Munoz Sanchez; Alicia,10,0,20,10
1745793380722,LISP 5C,A00,896655,Munoz Sanchez; Alicia,4,0,20,16
1745793381747,MAE 197,001,957918,Kleissl; Jan,9998,0,9999,1
1745793382772,MATH 2,A01,957937,Staff,34,0,35,1
1745793383798,MATH 197,001,957876,Kedlaya; Kiran S.,9993,0,9999,6
1745793384826,MCWP 40,A00,892729,Duru; Nur,13,0,20,7
1745793384826,MCWP 40,B00,893304,Montejo; Carolina,20,0,20,0
1745793385855,MCWP 40R,A00,893757,Redela; Pamela Morgan,0,6,20,20
1745793386882,MCWP 50,A00,893758,Morshed; Michael James,2,0,20,18
1745793386882,MCWP 50,B00,893761,Bartulis; Jason Michael,17,0,20,3
1745793387910,MCWP 50R,A00,893766,Compas; Sean Matthew,0,1,20,20
1745793387910,MCWP 50R,B00,893769,Carter; Jennifer A,0,0,20,20
1745793387910,MCWP 50R,C00,893771,Krone; Jarret,0,3,20,20
1745793387910,MCWP 50R,D00,893772,Miller; Elizabeth Deen,3,0,20,17
1745793387910,MCWP 50R,E00,893775,Carter; Andrea L,0,0,20,20
1745793388938,MMW 11R,A01,892721,Herbst; Matthew,11,0,27,16
1745793388938,MMW 11R,A02,892722,Herbst; Matthew,0,0,0,3
1745793389965,MMW 12R,A01,892724,Herbst; Matthew,0,9,16,16
1745793389965,MMW 12R,A02,892725,Herbst; Matthew,0,9,16,16
1745793390992,MMW 13R,A01,892727,Staff,0,4,16,16
1745793390992,MMW 13R,A02,892728,Staff,0,4,16,16
1745793390992,MMW 13R,A03,958032,Staff,0,3,16,16
1745793390992,MMW 13R,A04,958033,Staff,0,2,16,16
1745793390992,MMW 13R,A05,958034,Staff,0,3,16,16
1745793392023,SIO 295LS,A00,894015,Staff,7,0,25,18
1745793393054,SIO 295S,A00,894020,Staff,7,0,25,18
1745793394083,SIOC 290S,B01,958918,Staff,0,0,0,0
1745793395111,SIOC 291S,B01,958922,Staff,0,0,0,0
1745793396137,SOCI 117,A01,895339,Staff,4,0,5,1
1745793397163,WES 237B,A00,894149,Staff,11,0,20,9
1745793399225,AESE 279B,A00,891859,Staff,13,0,35,22
1745793400250,AIP 197,001,891854,Staff,70,0,70,0
1745793401280,ANTH 289S,A00,891856,Gagneux; Pascal,12,0,12,0
1745793402310,BENG 196,001,957946,Engler; Adam J.,9996,0,9999,3
1745793403339,CAT 124RS,A01,956906,Staff,8,0,25,17
1745793404366,CAT 125RS,A01,922013,Staff,8,0,25,17
1745793405390,CLRE 250,A00,891860,Morris; Sheldon,9995,0,9999,4
1745793407445,CLRE 251R,A00,907817,Mehta; Ravindra L.,9994,0,9999,5
1745793408476,CLRE 252,A00,891864,Cuomo; Raphael Eduardo,9993,0,9999,6
1745793409502,CLRE 253,A00,891867,Vaida; Florin,9994,0,9999,5
1745793409502,CLRE 253,B00,907819,Staff,9999,0,9999,0
1745793410528,CLRE 259,A00,891868,Patel; Hemal,9998,0,9999,1
1745793411557,CLRE 260,A00,891872,Cuomo; Raphael Eduardo,9999,0,9999,0
1745793412582,CLRE 297,001,891888,Cuomo; Raphael Eduardo,9999,0,9999,0
1745793413608,CSE 191,A00,958773,Minnes Kemp; Mor Mia,9999,0,9999,0
1745793414638,CSS 201S,A01,892054,Mignozzetti; Umberto,30,0,30,0
1745793415663,CSS 202S,A01,892056,Mignozzetti; Umberto,30,0,30,0
1745793416690,DSC 197,001,956898,Eldridge; Justin Matthew,9998,0,9999,1
1745793417717,DSC 297,001,958000,Mazumdar; Arya,9998,0,9999,1
1745793418745,EAP 100,A00,905686,Staff,9776,0,9999,223
1745793419774,ECE 45,A01,892618,Staff,0,12,50,50
1745793420801,ECE 109,A01,892620,Staff,0,43,0,0
1745793421831,ECE 111,A01,892719,Staff,0,7,50,50
1745793422865,ECE 197,001,957920,Mercier; Patrick Philip,9992,0,9999,7
1745793423892,ECON 178,A01,907814,Zhu; Ying,28,0,35,7
1745793424919,EDS 115,A00,895312,Staff,41,0,45,4
1745793425949,EDS 117,A01,895337,Staff,30,0,30,0
1745793426975,EDS 125,A00,895341,Jones; Gabrielle Anastasia,43,0,45,2
1745793428003,EDS 128A,A01,895459,Fargason; Sharon Gayle,44,0,45,1
1745793429032,EDS 128B,A01,895543,Pappas; Elizabeth,44,0,45,1
1745793430056,EDS 139,A00,897203,Pappas; Elizabeth,44,0,45,1
1745793430056,EDS 139,B00,897209,Fargason; Sharon Gayle,44,0,45,1
1745793431081,EDS 201,A00,895545,Staff,43,0,45,2
1745793432109,EDS 203,A01,895581,Halter; Christopher P.,43,0,45,2
1745793433135,EDS 204R,A01,895625,Heinzman; Erica M.,43,0,45,2
1745793433135,EDS 204R,B01,895693,Halter; Christopher P.,18,0,45,27
1745793434163,EDS 206R,A00,895694,Fargason; Sharon Gayle,9,0,30,21
1745793434163,EDS 206R,B00,895695,Choi; Bailey Miyeon,20,0,30,10
1745793435192,EDS 250,A00,895697,Hemans; Patricia Ann Benitez,43,0,45,2
1745793436218,EDS 281,A00,895701,Meyerott; Theresa Ann,15,0,15,0
1745793437246,EDS 284,A00,895736,Meyerott; Theresa Ann,15,0,15,0
1745793438269,EDS 286,A00,897210,Fine; Sarah,15,0,15,0
1745793439293,EDS 289C,A01,895770,Daly; Alan J.,15,0,15,0
1745793440321,EDS 290,A00,897211,Hofstetter; Carolyn,15,0,15,0
1745793441346,LIGM 5A,A00,896162,Fischer-Grunski; Eva K,15,0,20,5
1745793442385,LIGM 5B,A00,896260,Fischer-Grunski; Eva K,17,0,20,3
1745793443411,LIGM 5C,A00,896308,Fischer-Grunski; Eva K,18,0,20,2
1745793444439,LIIT 5AS,A00,896313,Carnelos; Chiara,18,0,20,2
1745793445464,LIIT 5BS,A00,896416,Carnelos; Chiara,20,0,20,0
1745793446491,LIIT 5CS,A00,896564,Carnelos; Chiara,20,0,20,0
1745793447515,LISP 5A,A00,896588,Munoz Sanchez; Alicia,4,0,20,16
1745793448540,LISP 5B,A00,896653,Munoz Sanchez; Alicia,10,0,20,10
1745793449565,LISP 5C,A00,896655,Munoz Sanchez; Alicia,4,0,20,16
1745793450590,MAE 197,001,957918,Kleissl; Jan,9998,0,9999,1
1745793451617,MATH 2,A01,957937,Staff,34,0,35,1
1745793452644,MATH 197,001,957876,Kedlaya; Kiran S.,9993,0,9999,6
1745793453674,MCWP 40,A00,892729,Duru; Nur,13,0,20,7
1745793453674,MCWP 40,B00,893304,Montejo; Carolina,20,0,20,0
1745793454704,MCWP 40R,A00,893757,Redela; Pamela Morgan,0,6,20,20
1745793455730,MCWP 50,A00,893758,Morshed; Michael James,2,0,20,18
1745793455730,MCWP 50,B00,893761,Bartulis; Jason Michael,17,0,20,3
1745793456759,MCWP 50R,A00,893766,Compas; Sean Matthew,0,1,20,20
1745793456759,MCWP 50R,B00,893769,Carter; Jennifer A,0,0,20,20
1745793456759,MCWP 50R,C00,893771,Krone; Jarret,0,3,20,20
1745793456759,MCWP 50R,D00,893772,Miller; Elizabeth Deen,3,0,20,17
1745793456759,MCWP 50R,E00,893775,Carter; Andrea L,0,0,20,20
1745793457786,MMW 11R,A01,892721,Herbst; Matthew,11,0,27,16
1745793457786,MMW 11R,A02,892722,Herbst; Matthew,0,0,0,3
1745793458814,MMW 12R,A01,892724,Herbst; Matthew,0,9,16,16
1745793458814,MMW 12R,A02,892725,Herbst; Matthew,0,9,16,16
1745793459841,MMW 13R,A01,892727,Staff,0,4,16,16
1745793459841,MMW 13R,A02,892728,Staff,0,4,16,16
1745793459841,MMW 13R,A03,958032,Staff,0,3,16,16
1745793459841,MMW 13R,A04,958033,Staff,0,2,16,16
1745793459841,MMW 13R,A05,958034,Staff,0,3,16,16
1745793460868,SIO 295LS,A00,894015,Staff,7,0,25,18
1745793461898,SIO 295S,A00,894020,Staff,7,0,25,18
1745793462927,SIOC 290S,B01,958918,Staff,0,0,0,0
1745793463959,SIOC 291S,B01,958922,Staff,0,0,0,0
1745793464984,SOCI 117,A01,895339,Staff,4,0,5,1
1745793466012,WES 237B,A00,894149,Staff,11,0,20,9
1745793468073,AESE 279B,A00,891859,Staff,13,0,35,22
1745793469100,AIP 197,001,891854,Staff,70,0,70,0
1745793470125,ANTH 289S,A00,891856,Gagneux; Pascal,12,0,12,0
1745793471150,BENG 196,001,957946,Engler; Adam J.,9996,0,9999,3
1745793472177,CAT 124RS,A01,956906,Staff,8,0,25,17
1745793473205,CAT 125RS,A01,922013,Staff,8,0,25,17
1745793474231,CLRE 250,A00,891860,Morris; Sheldon,9995,0,9999,4
1745793476288,CLRE 251R,A00,907817,Mehta; Ravindra L.,9994,0,9999,5
1745793477315,CLRE 252,A00,891864,Cuomo; Raphael Eduardo,9993,0,9999,6
1745793478341,CLRE 253,A00,891867,Vaida; Florin,9994,0,9999,5
1745793478341,CLRE 253,B00,907819,Staff,9999,0,9999,0
1745793479370,CLRE 259,A00,891868,Patel; Hemal,9998,0,9999,1
1745793480396,CLRE 260,A00,891872,Cuomo; Raphael Eduardo,9999,0,9999,0
1745793481424,CLRE 297,001,891888,Cuomo; Raphael Eduardo,9999,0,9999,0
1745793482450,CSE 191,A00,958773,Minnes Kemp; Mor Mia,9999,0,9999,0
1745793483478,CSS 201S,A01,892054,Mignozzetti; Umberto,30,0,30,0
1745793484533,CSS 202S,A01,892056,Mignozzetti; Umberto,30,0,30,0
1745793485562,DSC 197,001,956898,Eldridge; Justin Matthew,9998,0,9999,1
1745793486593,DSC 297,001,958000,Mazumdar; Arya,9998,0,9999,1
1745793487618,EAP 100,A00,905686,Staff,9776,0,9999,223
1745793488645,ECE 45,A01,892618,Staff,0,12,50,50
1745793489673,ECE 109,A01,892620,Staff,0,43,0,0
1745793490697,ECE 111,A01,892719,Staff,0,7,50,50
1745793491726,ECE 197,001,957920,Mercier; Patrick Philip,9992,0,9999,7
1745793492752,ECON 178,A01,907814,Zhu; Ying,28,0,35,7
1745793493779,EDS 115,A00,895312,Staff,41,0,45,4
1745793494808,EDS 117,A01,895337,Staff,30,0,30,0
1745793495836,EDS 125,A00,895341,Jones; Gabrielle Anastasia,43,0,45,2
1745793496861,EDS 128A,A01,895459,Fargason; Sharon Gayle,44,0,45,1
1745793497890,EDS 128B,A01,895543,Pappas; Elizabeth,44,0,45,1
1745793498915,EDS 139,A00,897203,Pappas; Elizabeth,44,0,45,1
1745793498915,EDS 139,B00,897209,Fargason; Sharon Gayle,44,0,45,1
1745793499939,EDS 201,A00,895545,Staff,43,0,45,2
1745793500969,EDS 203,A01,895581,Halter; Christopher P.,43,0,45,2
1745793501994,EDS 204R,A01,895625,Heinzman; Erica M.,43,0,45,2
1745793501994,EDS 204R,B01,895693,Halter; Christopher P.,18,0,45,27
1745793503024,EDS 206R,A00,895694,Fargason; Sharon Gayle,9,0,30,21
1745793503024,EDS 206R,B00,895695,Choi; Bailey Miyeon,20,0,30,10
1745793504049,EDS 250,A00,895697,Hemans; Patricia Ann Benitez,43,0,45,2
1745793505075,EDS 281,A00,895701,Meyerott; Theresa Ann,15,0,15,0
1745793506100,EDS 284,A00,895736,Meyerott; Theresa Ann,15,0,15,0
1745793507127,EDS 286,A00,897210,Fine; Sarah,15,0,15,0
1745793508154,EDS 289C,A01,895770,Daly; Alan J.,15,0,15,0
1745793509181,EDS 290,A00,897211,Hofstetter; Carolyn,15,0,15,0
1745793510207,LIGM 5A,A00,896162,Fischer-Grunski; Eva K,15,0,20,5
1745793511234,LIGM 5B,A00,896260,Fischer-Grunski; Eva K,17,0,20,3
1745793512262,LIGM 5C,A00,896308,Fischer-Grunski; Eva K,18,0,20,2
1745793513289,LIIT 5AS,A00,896313,Carnelos; Chiara,18,0,20,2
1745793514317,LIIT 5BS,A00,896416,Carnelos; Chiara,20,0,20,0
1745793515345,LIIT 5CS,A00,896564,Carnelos; Chiara,20,0,20,0
1745793516372,LISP 5A,A00,896588,Munoz Sanchez; Alicia,4,0,20,16
1745793517402,LISP 5B,A00,896653,Munoz Sanchez; Alicia,10,0,20,10
1745793518434,LISP 5C,A00,896655,Munoz Sanchez; Alicia,4,0,20,16
1745793519461,MAE 197,001,957918,Kleissl; Jan,9998,0,9999,1
1745793520490,MATH 2,A01,957937,Staff,34,0,35,1
1745793521518,MATH 197,001,957876,Kedlaya; Kiran S.,9993,0,9999,6
1745793522547,MCWP 40,A00,892729,Duru; Nur,13,0,20,7
1745793522547,MCWP 40,B00,893304,Montejo; Carolina,20,0,20,0
1745793523574,MCWP 40R,A00,893757,Redela; Pamela Morgan,0,6,20,20
1745793524600,MCWP 50,A00,893758,Morshed; Michael James,2,0,20,18
1745793524600,MCWP 50,B00,893761,Bartulis; Jason Michael,17,0,20,3
1745793525628,MCWP 50R,A00,893766,Compas; Sean Matthew,0,1,20,20
1745793525628,MCWP 50R,B00,893769,Carter; Jennifer A,0,0,20,20
1745793525628,MCWP 50R,C00,893771,Krone; Jarret,0,3,20,20
1745793525628,MCWP 50R,D00,893772,Miller; Elizabeth Deen,3,0,20,17
1745793525628,MCWP 50R,E00,893775,Carter; Andrea L,0,0,20,20
1745793526652,MMW 11R,A01,892721,Herbst; Matthew,11,0,27,16
1745793526652,MMW 11R,A02,892722,Herbst; Matthew,0,0,0,3
1745793527681,MMW 12R,A01,892724,Herbst; Matthew,0,9,16,16
1745793527681,MMW 12R,A02,892725,Herbst; Matthew,0,9,16,16
1745793528711,MMW 13R,A01,892727,Staff,0,4,16,16
1745793528711,MMW 13R,A02,892728,Staff,0,4,16,16
1745793528711,MMW 13R,A03,958032,Staff,0,3,16,16
1745793528711,MMW 13R,A04,958033,Staff,0,2,16,16
1745793528711,MMW 13R,A05,958034,Staff,0,3,16,16
1745793529738,SIO 295LS,A00,894015,Staff,7,0,25,18
1745793530763,SIO 295S,A00,894020,Staff,7,0,25,18
1745793531790,SIOC 290S,B01,958918,Staff,0,0,0,0
1745793532816,SIOC 291S,B01,958922,Staff,0,0,0,0
1745793533844,SOCI 117,A01,895339,Staff,4,0,5,1
1745793534870,WES 237B,A00,894149,Staff,11,0,20,9
1745793536934,AESE 279B,A00,891859,Staff,13,0,35,22
1745793537962,AIP 197,001,891854,Staff,70,0,70,0
1745793538988,ANTH 289S,A00,891856,Gagneux; Pascal,12,0,12,0
1745793540013,BENG 196,001,957946,Engler; Adam J.,9996,0,9999,3
1745793541041,CAT 124RS,A01,956906,Staff,8,0,25,17
1745793542072,CAT 125RS,A01,922013,Staff,8,0,25,17
1745793543103,CLRE 250,A00,891860,Morris; Sheldon,9995,0,9999,4
1745793545158,CLRE 251R,A00,907817,Mehta; Ravindra L.,9994,0,9999,5
1745793546188,CLRE 252,A00,891864,Cuomo; Raphael Eduardo,9993,0,9999,6
1745793547215,CLRE 253,A00,891867,Vaida; Florin,9994,0,9999,5
1745793547215,CLRE 253,B00,907819,Staff,9999,0,9999,0
1745793548243,CLRE 259,A00,891868,Patel; Hemal,9998,0,9999,1
1745793549272,CLRE 260,A00,891872,Cuomo; Raphael Eduardo,9999,0,9999,0
1745793550302,CLRE 297,001,891888,Cuomo; Raphael Eduardo,9999,0,9999,0
1745793551329,CSE 191,A00,958773,Minnes Kemp; Mor Mia,9999,0,9999,0
1745793552361,CSS 201S,A01,892054,Mignozzetti; Umberto,30,0,30,0
1745793553391,CSS 202S,A01,892056,Mignozzetti; Umberto,30,0,30,0
1745793554420,DSC 197,001,956898,Eldridge; Justin Matthew,9998,0,9999,1
1745793555447,DSC 297,001,958000,Mazumdar; Arya,9998,0,9999,1
1745793556471,EAP 100,A00,905686,Staff,9776,0,9999,223
1745793557496,ECE 45,A01,892618,Staff,0,12,50,50
1745793558525,ECE 109,A01,892620,Staff,0,43,0,0
1745793559552,ECE 111,A01,892719,Staff,0,7,50,50
1745793560578,ECE 197,001,957920,Mercier; Patrick Philip,9992,0,9999,7
1745793561608,ECON 178,A01,907814,Zhu; Ying,28,0,35,7
1745793562633,EDS 115,A00,895312,Staff,41,0,45,4
1745793563662,EDS 117,A01,895337,Staff,30,0,30,0
1745793564689,EDS 125,A00,895341,Jones; Gabrielle Anastasia,43,0,45,2
1745793565716,EDS 128A,A01,895459,Fargason; Sharon Gayle,44,0,45,1
1745793566746,EDS 128B,A01,895543,Pappas; Elizabeth,44,0,45,1
1745793567776,EDS 139,A00,897203,Pappas; Elizabeth,44,0,45,1
1745793567776,EDS 139,B00,897209,Fargason; Sharon Gayle,44,0,45,1
1745793568803,EDS 201,A00,895545,Staff,43,0,45,2
1745793569834,EDS 203,A01,895581,Halter; Christopher P.,43,0,45,2
1745793570864,EDS 204R,A01,895625,Heinzman; Erica M.,43,0,45,2
1745793570864,EDS 204R,B01,895693,Halter; Christopher P.,18,0,45,27
1745793571889,EDS 206R,A00,895694,Fargason; Sharon Gayle,9,0,30,21
1745793571889,EDS 206R,B00,895695,Choi; Bailey Miyeon,20,0,30,10
1745793572915,EDS 250,A00,895697,Hemans; Patricia Ann Benitez,43,0,45,2
1745793573944,EDS 281,A00,895701,Meyerott; Theresa Ann,15,0,15,0
1745793574972,EDS 284,A00,895736,Meyerott; Theresa Ann,15,0,15,0
1745793575998,EDS 286,A00,897210,Fine; Sarah,15,0,15,0
1745793577025,EDS 289C,A01,895770,Daly; Alan J.,15,0,15,0
1745793578053,EDS 290,A00,897211,Hofstetter; Carolyn,15,0,15,0
1745793579080,LIGM 5A,A00,896162,Fischer-Grunski; Eva K,15,0,20,5
1745793580117,LIGM 5B,A00,896260,Fischer-Grunski; Eva K,17,0,20,3
1745793581143,LIGM 5C,A00,896308,Fischer-Grunski; Eva K,18,0,20,2
1745793582172,LIIT 5AS,A00,896313,Carnelos; Chiara,18,0,20,2
1745793583199,LIIT 5BS,A00,896416,Carnelos; Chiara,20,0,20,0
1745793584230,LIIT 5CS,A00,896564,Carnelos; Chiara,20,0,20,0
1745793585258,LISP 5A,A00,896588,Munoz Sanchez; Alicia,4,0,20,16
1745793586284,LISP 5B,A00,896653,Munoz Sanchez; Alicia,10,0,20,10
1745793587313,LISP 5C,A00,896655,Munoz Sanchez; Alicia,4,0,20,16
1745793588340,MAE 197,001,957918,Kleissl; Jan,9998,0,9999,1
1745793589366,MATH 2,A01,957937,Staff,34,0,35,1
1745793590397,MATH 197,001,957876,Kedlaya; Kiran S.,9993,0,9999,6
1745793591423,MCWP 40,A00,892729,Duru; Nur,13,0,20,7
1745793591423,MCWP 40,B00,893304,Montejo; Carolina,20,0,20,0
1745793592450,MCWP 40R,A00,893757,Redela; Pamela Morgan,0,6,20,20
1745793593477,MCWP 50,A00,893758,Morshed; Michael James,2,0,20,18
1745793593477,MCWP 50,B00,893761,Bartulis; Jason Michael,17,0,20,3
1745793594505,MCWP 50R,A00,893766,Compas; Sean Matthew,0,1,20,20
1745793594505,MCWP 50R,B00,893769,Carter; Jennifer A,0,0,20,20
1745793594505,MCWP 50R,C00,893771,Krone; Jarret,0,3,20,20
1745793594505,MCWP 50R,D00,893772,Miller; Elizabeth Deen,3,0,20,17
1745793594505,MCWP 50R,E00,893775,Carter; Andrea L,0,0,20,20
1745793595611,MMW 11R,A01,892721,Herbst; Matthew,11,0,27,16
1745793595611,MMW 11R,A02,892722,Herbst; Matthew,0,0,0,3
1745793596638,MMW 12R,A01,892724,Herbst; Matthew,0,9,16,16
1745793596638,MMW 12R,A02,892725,Herbst; Matthew,0,9,16,16
1745793597666,MMW 13R,A01,892727,Staff,0,4,16,16
1745793597666,MMW 13R,A02,892728,Staff,0,4,16,16
1745793597666,MMW 13R,A03,958032,Staff,0,3,16,16
1745793597666,MMW 13R,A04,958033,Staff,0,2,16,16
1745793597666,MMW 13R,A05,958034,Staff,0,3,16,16
1745793598694,SIO 295LS,A00,894015,Staff,7,0,25,18
1745793599724,SIO 295S,A00,894020,Staff,7,0,25,18
1745793600753,SIOC 290S,B01,958918,Staff,0,0,0,0
1745793601785,SIOC 291S,B01,958922,Staff,0,0,0,0
1745793602812,SOCI 117,A01,895339,Staff,4,0,5,1
1745793603840,WES 237B,A00,894149,Staff,11,0,20,9
1745793605902,AESE 279B,A00,891859,Staff,13,0,35,22
1745793606928,AIP 197,001,891854,Staff,70,0,70,0
1745793607957,ANTH 289S,A00,891856,Gagneux; Pascal,12,0,12,0
1745793608984,BENG 196,001,957946,Engler; Adam J.,9996,0,9999,3
1745793610011,CAT 124RS,A01,956906,Staff,8,0,25,17
1745793611038,CAT 125RS,A01,922013,Staff,8,0,25,17
1745793612066,CLRE 250,A00,891860,Morris; Sheldon,9995,0,9999,4
1745793614122,CLRE 251R,A00,907817,Mehta; Ravindra L.,9994,0,9999,5
1745793615147,CLRE 252,A00,891864,Cuomo; Raphael Eduardo,9993,0,9999,6
1745793616174,CLRE 253,A00,891867,Vaida; Florin,9994,0,9999,5
1745793616174,CLRE 253,B00,907819,Staff,9999,0,9999,0
1745793617201,CLRE 259,A00,891868,Patel; Hemal,9998,0,9999,1
1745793618239,CLRE 260,A00,891872,Cuomo; Raphael Eduardo,9999,0,9999,0
1745793619266,CLRE 297,001,891888,Cuomo; Raphael Eduardo,9999,0,9999,0
1745793620294,CSE 191,A00,958773,Minnes Kemp; Mor Mia,9999,0,9999,0
1745793621328,CSS 201S,A01,892054,Mignozzetti; Umberto,30,0,30,0
1745793622360,CSS 202S,A01,892056,Mignozzetti; Umberto,30,0,30,0
1745793623384,DSC 197,001,956898,Eldridge; Justin Matthew,9998,0,9999,1
1745793624411,DSC 297,001,958000,Mazumdar; Arya,9998,0,9999,1
1745793625442,EAP 100,A00,905686,Staff,9776,0,9999,223
1745793626470,ECE 45,A01,892618,Staff,0,12,50,50
1745793627497,ECE 109,A01,892620,Staff,0,43,0,0
1745793628522,ECE 111,A01,892719,Staff,0,7,50,50
1745793629551,ECE 197,001,957920,Mercier; Patrick Philip,9992,0,9999,7
1745793630579,ECON 178,A01,907814,Zhu; Ying,28,0,35,7
1745793631606,EDS 115,A00,895312,Staff,41,0,45,4
1745793632631,EDS 117,A01,895337,Staff,30,0,30,0
1745793633659,EDS 125,A00,895341,Jones; Gabrielle Anastasia,43,0,45,2
1745793634686,EDS 128A,A01,895459,Fargason; Sharon Gayle,44,0,45,1
1745793635714,EDS 128B,A01,895543,Pappas; Elizabeth,44,0,45,1
1745793636741,EDS 139,A00,897203,Pappas; Elizabeth,44,0,45,1
1745793636741,EDS 139,B00,897209,Fargason; Sharon Gayle,44,0,45,1
1745793637770,EDS 201,A00,895545,Staff,43,0,45,2
1745793638799,EDS 203,A01,895581,Halter; Christopher P.,43,0,45,2
1745793639828,EDS 204R,A01,895625,Heinzman; Erica M.,43,0,45,2
1745793639828,EDS 204R,B01,895693,Halter; Christopher P.,18,0,45,27
1745793640856,EDS 206R,A00,895694,Fargason; Sharon Gayle,9,0,30,21
1745793640856,EDS 206R,B00,895695,Choi; Bailey Miyeon,20,0,30,10
1745793641882,EDS 250,A00,895697,Hemans; Patricia Ann Benitez,43,0,45,2
1745793642909,EDS 281,A00,895701,Meyerott; Theresa Ann,15,0,15,0
1745793643934,EDS 284,A00,895736,Meyerott; Theresa Ann,15,0,15,0
1745793644961,EDS 286,A00,897210,Fine; Sarah,15,0,15,0
1745793645988,EDS 289C,A01,895770,Daly; Alan J.,15,0,15,0
1745793647018,EDS 290,A00,897211,Hofstetter; Carolyn,15,0,15,0
1745793648048,LIGM 5A,A00,896162,Fischer-Grunski; Eva K,15,0,20,5
1745793649074,LIGM 5B,A00,896260,Fischer-Grunski; Eva K,17,0,20,3
1745793650103,LIGM 5C,A00,896308,Fischer-Grunski; Eva K,18,0,20,2
1745793651130,LIIT 5AS,A00,896313,Carnelos; Chiara,18,0,20,2
1745793652183,LIIT 5BS,A00,896416,Carnelos; Chiara,20,0,20,0
1745793653209,LIIT 5CS,A00,896564,Carnelos; Chiara,20,0,20,0
1745793654235,LISP 5A,A00,896588,Munoz Sanchez; Alicia,4,0,20,16
1745793655261,LISP 5B,A00,896653,Munoz Sanchez; Alicia,10,0,20,10
1745793656288,LISP 5C,A00,896655,Munoz Sanchez; Alicia,4,0,20,16
1745793657314,MAE 197,001,957918,Kleissl; Jan,9998,0,9999,1
1745793658339,MATH 2,A01,957937,Staff,34,0,35,1
1745793659364,MATH 197,001,957876,Kedlaya; Kiran S.,9993,0,9999,6
1745793660391,MCWP 40,A00,892729,Duru; Nur,13,0,20,7
1745793660391,MCWP 40,B00,893304,Montejo; Carolina,20,0,20,0
1745793661418,MCWP 40R,A00,893757,Redela; Pamela Morgan,0,6,20,20
1745793662449,MCWP 50,A00,893758,Morshed; Michael James,2,0,20,18
1745793662449,MCWP 50,B00,893761,Bartulis; Jason Michael,17,0,20,3
1745793663477,MCWP 50R,A00,893766,Compas; Sean Matthew,0,1,20,20
1745793663477,MCWP 50R,B00,893769,Carter; Jennifer A,0,0,20,20
1745793663477,MCWP 50R,C00,893771,Krone; Jarret,0,3,20,20
1745793663477,MCWP 50R,D00,893772,Miller; Elizabeth Deen,3,0,20,17
1745793663477,MCWP 50R,E00,893775,Carter; Andrea L,0,0,20,20
1745793664505,MMW 11R,A01,892721,Herbst; Matthew,11,0,27,16
1745793664505,MMW 11R,A02,892722,Herbst; Matthew,0,0,0,3
1745793665531,MMW 12R,A01,892724,Herbst; Matthew,0,9,16,16
1745793665531,MMW 12R,A02,892725,Herbst; Matthew,0,9,16,16
1745793666556,MMW 13R,A01,892727,Staff,0,4,16,16
1745793666556,MMW 13R,A02,892728,Staff,0,4,16,16
1745793666556,MMW 13R,A03,958032,Staff,0,3,16,16
1745793666556,MMW 13R,A04,958033,Staff,0,2,16,16
1745793666556,MMW 13R,A05,958034,Staff,0,3,16,16
1745793667590,SIO 295LS,A00,894015,Staff,7,0,25,18
1745793668616,SIO 295S,A00,894020,Staff,7,0,25,18
1745793669645,SIOC 290S,B01,958918,Staff,0,0,0,0
1745793670670,SIOC 291S,B01,958922,Staff,0,0,0,0
1745793671697,SOCI 117,A01,895339,Staff,4,0,5,1
1745793672724,WES 237B,A00,894149,Staff,11,0,20,9
1745793674780,AESE 279B,A00,891859,Staff,13,0,35,22
1745793675804,AIP 197,001,891854,Staff,70,0,70,0
1745793676828,ANTH 289S,A00,891856,Gagneux; Pascal,12,0,12,0
1745793677854,BENG 196,001,957946,Engler; Adam J.,9996,0,9999,3
1745793678879,CAT 124RS,A01,956906,Staff,8,0,25,17
1745793679904,CAT 125RS,A01,922013,Staff,8,0,25,17
1745793680931,CLRE 250,A00,891860,Morris; Sheldon,9995,0,9999,4
1745793682987,CLRE 251R,A00,907817,Mehta; Ravindra L.,9994,0,9999,5
1745793684016,CLRE 252,A00,891864,Cuomo; Raphael Eduardo,9993,0,9999,6
1745793685042,CLRE 253,A00,891867,Vaida; Florin,9994,0,9999,5
1745793685042,CLRE 253,B00,907819,Staff,9999,0,9999,0
1745793686069,CLRE 259,A00,891868,Patel; Hemal,9998,0,9999,1
1745793687097,CLRE 260,A00,891872,Cuomo; Raphael Eduardo,9999,0,9999,0
1745793688123,CLRE 297,001,891888,Cuomo; Raphael Eduardo,9999,0,9999,0
1745793689149,CSE 191,A00,958773,Minnes Kemp; Mor Mia,9999,0,9999,0
1745793690175,CSS 201S,A01,892054,Mignozzetti; Umberto,30,0,30,0
1745793691206,CSS 202S,A01,892056,Mignozzetti; Umberto,30,0,30,0
1745793692230,DSC 197,001,956898,Eldridge; Justin Matthew,9998,0,9999,1
1745793693258,DSC 297,001,958000,Mazumdar; Arya,9998,0,9999,1
1745793694284,EAP 100,A00,905686,Staff,9776,0,9999,223
1745793695312,ECE 45,A01,892618,Staff,0,12,50,50
1745793696338,ECE 109,A01,892620,Staff,0,43,0,0
1745793697363,ECE 111,A01,892719,Staff,0,7,50,50
1745793698392,ECE 197,001,957920,Mercier; Patrick Philip,9992,0,9999,7
1745793699421,ECON 178,A01,907814,Zhu; Ying,28,0,35,7
1745793700446,EDS 115,A00,895312,Staff,41,0,45,4
1745793701474,EDS 117,A01,895337,Staff,30,0,30,0
1745793702502,EDS 125,A00,895341,Jones; Gabrielle Anastasia,43,0,45,2
1745793703527,EDS 128A,A01,895459,Fargason; Sharon Gayle,44,0,45,1
1745793704555,EDS 128B,A01,895543,Pappas; Elizabeth,44,0,45,1
1745793705581,EDS 139,A00,897203,Pappas; Elizabeth,44,0,45,1
1745793705581,EDS 139,B00,897209,Fargason; Sharon Gayle,44,0,45,1
1745793706606,EDS 201,A00,895545,Staff,43,0,45,2
1745793707638,EDS 203,A01,895581,Halter; Christopher P.,43,0,45,2
1745793708667,EDS 204R,A01,895625,Heinzman; Erica M.,43,0,45,2
1745793708667,EDS 204R,B01,895693,Halter; Christopher P.,18,0,45,27
1745793709691,EDS 206R,A00,895694,Fargason; Sharon Gayle,9,0,30,21
1745793709691,EDS 206R,B00,895695,Choi; Bailey Miyeon,20,0,30,10
1745793710719,EDS 250,A00,895697,Hemans; Patricia Ann Benitez,43,0,45,2
1745793711744,EDS 281,A00,895701,Meyerott; Theresa Ann,15,0,15,0
1745793712770,EDS 284,A00,895736,Meyerott; Theresa Ann,15,0,15,0
1745793713798,EDS 286,A00,897210,Fine; Sarah,15,0,15,0
1745793714824,EDS 289C,A01,895770,Daly; Alan J.,15,0,15,0
1745793715850,EDS 290,A00,897211,Hofstetter; Carolyn,15,0,15,0
1745793716877,LIGM 5A,A00,896162,Fischer-Grunski; Eva K,15,0,20,5
1745793717913,LIGM 5B,A00,896260,Fischer-Grunski; Eva K,17,0,20,3
1745793718942,LIGM 5C,A00,896308,Fischer-Grunski; Eva K,18,0,20,2
1745793719969,LIIT 5AS,A00,896313,Carnelos; Chiara,18,0,20,2
1745793721000,LIIT 5BS,A00,896416,Carnelos; Chiara,20,0,20,0
1745793722029,LIIT 5CS,A00,896564,Carnelos; Chiara,20,0,20,0
1745793723056,LISP 5A,A00,896588,Munoz Sanchez; Alicia,4,0,20,16
1745793724106,LISP 5B,A00,896653,Munoz Sanchez; Alicia,10,0,20,10
1745793725135,LISP 5C,A00,896655,Munoz Sanchez; Alicia,4,0,20,16
1745793726162,MAE 197,001,957918,Kleissl; Jan,9998,0,9999,1
1745793727187,MATH 2,A01,957937,Staff,34,0,35,1
1745793728212,MATH 197,001,957876,Kedlaya; Kiran S.,9993,0,9999,6
1745793729240,MCWP 40,A00,892729,Duru; Nur,13,0,20,7
1745793729240,MCWP 40,B00,893304,Montejo; Carolina,20,0,20,0
1745793730265,MCWP 40R,A00,893757,Redela; Pamela Morgan,0,6,20,20
1745793731291,MCWP 50,A00,893758,Morshed; Michael James,2,0,20,18
1745793731291,MCWP 50,B00,893761,Bartulis; Jason Michael,17,0,20,3
1745793732321,MCWP 50R,A00,893766,Compas; Sean Matthew,0,1,20,20
1745793732321,MCWP 50R,B00,893769,Carter; Jennifer A,0,0,20,20
1745793732321,MCWP 50R,C00,893771,Krone; Jarret,0,3,20,20
1745793732321,MCWP 50R,D00,893772,Miller; Elizabeth Deen,3,0,20,17
1745793732321,MCWP 50R,E00,893775,Carter; Andrea L,0,0,20,20
1745793733347,MMW 11R,A01,892721,Herbst; Matthew,11,0,27,16
1745793733347,MMW 11R,A02,892722,Herbst; Matthew,0,0,0,3
1745793734376,MMW 12R,A01,892724,Herbst; Matthew,0,9,16,16
1745793734376,MMW 12R,A02,892725,Herbst; Matthew,0,9,16,16
1745793735404,MMW 13R,A01,892727,Staff,0,4,16,16
1745793735404,MMW 13R,A02,892728,Staff,0,4,16,16
1745793735404,MMW 13R,A03,958032,Staff,0,3,16,16
1745793735404,MMW 13R,A04,958033,Staff,0,2,16,16
1745793735404,MMW 13R,A05,958034,Staff,0,3,16,16
1745793736431,SIO 295LS,A00,894015,Staff,7,0,25,18
1745793737458,SIO 295S,A00,894020,Staff,7,0,25,18
1745793738493,SIOC 290S,B01,958918,Staff,0,0,0,0
1745793739523,SIOC 291S,B01,958922,Staff,0,0,0,0
1745793740548,SOCI 117,A01,895339,Staff,4,0,5,1
1745793741575,WES 237B,A00,894149,Staff,11,0,20,9
1745793743639,AESE 279B,A00,891859,Staff,13,0,35,22
1745793744665,AIP 197,001,891854,Staff,70,0,70,0
1745793745692,ANTH 289S,A00,891856,Gagneux; Pascal,12,0,12,0
1745793746718,BENG 196,001,957946,Engler; Adam J.,9996,0,9999,3
1745793747743,CAT 124RS,A01,956906,Staff,8,0,25,17
1745793748770,CAT 125RS,A01,922013,Staff,8,0,25,17
1745793749797,CLRE 250,A00,891860,Morris; Sheldon,9995,0,9999,4
1745793751847,CLRE 251R,A00,907817,Mehta; Ravindra L.,9994,0,9999,5
1745793752872,CLRE 252,A00,891864,Cuomo; Raphael Eduardo,9993,0,9999,6
1745793753898,CLRE 253,A00,891867,Vaida; Florin,9994,0,9999,5
1745793753898,CLRE 253,B00,907819,Staff,9999,0,9999,0
1745793754924,CLRE 259,A00,891868,Patel; Hemal,9998,0,9999,1
1745793755952,CLRE 260,A00,891872,Cuomo; Raphael Eduardo,9999,0,9999,0
1745793756978,CLRE 297,001,891888,Cuomo; Raphael Eduardo,9999,0,9999,0
1745793758008,CSE 191,A00,958773,Minnes Kemp; Mor Mia,9999,0,9999,0
1745793759039,CSS 201S,A01,892054,Mignozzetti; Umberto,30,0,30,0
1745793760063,CSS 202S,A01,892056,Mignozzetti; Umberto,30,0,30,0
1745793761088,DSC 197,001,956898,Eldridge; Justin Matthew,9998,0,9999,1
1745793762115,DSC 297,001,958000,Mazumdar; Arya,9998,0,9999,1
1745793763144,EAP 100,A00,905686,Staff,9776,0,9999,223
1745793764172,ECE 45,A01,892618,Staff,0,12,50,50
1745793765198,ECE 109,A01,892620,Staff,0,43,0,0
1745793766223,ECE 111,A01,892719,Staff,0,7,50,50
1745793767250,ECE 197,001,957920,Mercier; Patrick Philip,9992,0,9999,7
1745793768280,ECON 178,A01,907814,Zhu; Ying,28,0,35,7
1745793769305,EDS 115,A00,895312,Staff,41,0,45,4
1745793770333,EDS 117,A01,895337,Staff,30,0,30,0
1745793771358,EDS 125,A00,895341,Jones; Gabrielle Anastasia,43,0,45,2
1745793772391,EDS 128A,A01,895459,Fargason; Sharon Gayle,44,0,45,1
1745793773426,EDS 128B,A01,895543,Pappas; Elizabeth,44,0,45,1
1745793774451,EDS 139,A00,897203,Pappas; Elizabeth,44,0,45,1
1745793774451,EDS 139,B00,897209,Fargason; Sharon Gayle,44,0,45,1
1745793775475,EDS 201,A00,895545,Staff,43,0,45,2
1745793776503,EDS 203,A01,895581,Halter; Christopher P.,43,0,45,2
1745793777527,EDS 204R,A01,895625,Heinzman; Erica M.,43,0,45,2
1745793777527,EDS 204R,B01,895693,Halter; Christopher P.,18,0,45,27
1745793778577,EDS 206R,A00,895694,Fargason; Sharon Gayle,9,0,30,21
1745793778577,EDS 206R,B00,895695,Choi; Bailey Miyeon,20,0,30,10
1745793779605,EDS 250,A00,895697,Hemans; Patricia Ann Benitez,43,0,45,2
1745793780633,EDS 281,A00,895701,Meyerott; Theresa Ann,15,0,15,0
1745793781660,EDS 284,A00,895736,Meyerott; Theresa Ann,15,0,15,0
1745793782684,EDS 286,A00,897210,Fine; Sarah,15,0,15,0
1745793783709,EDS 289C,A01,895770,Daly; Alan J.,15,0,15,0
1745793784736,EDS 290,A00,897211,Hofstetter; Carolyn,15,0,15,0
1745793785761,LIGM 5A,A00,896162,Fischer-Grunski; Eva K,15,0,20,5
1745793786786,LIGM 5B,A00,896260,Fischer-Grunski; Eva K,17,0,20,3
1745793787813,LIGM 5C,A00,896308,Fischer-Grunski; Eva K,18,0,20,2
1745793788838,LIIT 5AS,A00,896313,Carnelos; Chiara,18,0,20,2
1745793789867,LIIT 5BS,A00,896416,Carnelos; Chiara,20,0,20,0
1745793790892,LIIT 5CS,A00,896564,Carnelos; Chiara,20,0,20,0
1745793791917,LISP 5A,A00,896588,Munoz Sanchez; Alicia,4,0,20,16
1745793792941,LISP 5B,A00,896653,Munoz Sanchez; Alicia,10,0,20,10
1745793793965,LISP 5C,A00,896655,Munoz Sanchez; Alicia,4,0,20,16
1745793794992,MAE 197,001,957918,Kleissl; Jan,9998,0,9999,1
1745793796021,MATH 2,A01,957937,Staff,34,0,35,1
1745793797044,MATH 197,001,957876,Kedlaya; Kiran S.,9993,0,9999,6
1745793798069,MCWP 40,A00,892729,Duru; Nur,13,0,20,7
1745793798069,MCWP 40,B00,893304,Montejo; Carolina,20,0,20,0
1745793799096,MCWP 40R,A00,893757,Redela; Pamela Morgan,0,6,20,20
1745793800126,MCWP 50,A00,893758,Morshed; Michael James,2,0,20,18
1745793800126,MCWP 50,B00,893761,Bartulis; Jason Michael,17,0,20,3
1745793801153,MCWP 50R,A00,893766,Compas; Sean Matthew,0,1,20,20
1745793801153,MCWP 50R,B00,893769,Carter; Jennifer A,0,0,20,20
1745793801153,MCWP 50R,C00,893771,Krone; Jarret,0,3,20,20
1745793801153,MCWP 50R,D00,893772,Miller; Elizabeth Deen,3,0,20,17
1745793801153,MCWP 50R,E00,893775,Carter; Andrea L,0,0,20,20
1745793802179,MMW 11R,A01,892721,Herbst; Matthew,11,0,27,16
1745793802179,MMW 11R,A02,892722,Herbst; Matthew,0,0,0,3
1745793803206,MMW 12R,A01,892724,Herbst; Matthew,0,9,16,16
1745793803206,MMW 12R,A02,892725,Herbst; Matthew,0,9,16,16
1745793804233,MMW 13R,A01,892727,Staff,0,4,16,16
1745793804233,MMW 13R,A02,892728,Staff,0,4,16,16
1745793804233,MMW 13R,A03,958032,Staff,0,3,16,16
1745793804233,MMW 13R,A04,958033,Staff,0,2,16,16
1745793804233,MMW 13R,A05,958034,Staff,0,3,16,16
1745793805260,SIO 295LS,A00,894015,Staff,7,0,25,18
1745793806290,SIO 295S,A00,894020,Staff,7,0,25,18
1745793807317,SIOC 290S,B01,958918,Staff,0,0,0,0
1745793808343,SIOC 291S,B01,958922,Staff,0,0,0,0
1745793809369,SOCI 117,A01,895339,Staff,4,0,5,1
1745793810398,WES 237B,A00,894149,Staff,11,0,20,9
1745793812460,AESE 279B,A00,891859,Staff,13,0,35,22
1745793813509,AIP 197,001,891854,Staff,70,0,70,0
1745793814537,ANTH 289S,A00,891856,Gagneux; Pascal,12,0,12,0
1745793815562,BENG 196,001,957946,Engler; Adam J.,9996,0,9999,3
1745793816586,CAT 124RS,A01,956906,Staff,8,0,25,17
1745793817610,CAT 125RS,A01,922013,Staff,8,0,25,17
1745793818638,CLRE 250,A00,891860,Morris; Sheldon,9995,0,9999,4
1745793820686,CLRE 251R,A00,907817,Mehta; Ravindra L.,9994,0,9999,5
1745793821714,CLRE 252,A00,891864,Cuomo; Raphael Eduardo,9993,0,9999,6
1745793822742,CLRE 253,A00,891867,Vaida; Florin,9994,0,9999,5
1745793822742,CLRE 253,B00,907819,Staff,9999,0,9999,0
1745793823770,CLRE 259,A00,891868,Patel; Hemal,9998,0,9999,1
1745793824798,CLRE 260,A00,891872,Cuomo; Raphael Eduardo,9999,0,9999,0
1745793825825,CLRE 297,001,891888,Cuomo; Raphael Eduardo,9999,0,9999,0
1745793826853,CSE 191,A00,958773,Minnes Kemp; Mor Mia,9999,0,9999,0
1745793827877,CSS 201S,A01,892054,Mignozzetti; Umberto,30,0,30,0
1745793828907,CSS 202S,A01,892056,Mignozzetti; Umberto,30,0,30,0
1745793829935,DSC 197,001,956898,Eldridge; Justin Matthew,9998,0,9999,1
1745793830961,DSC 297,001,958000,Mazumdar; Arya,9998,0,9999,1
1745793831986,EAP 100,A00,905686,Staff,9776,0,9999,223
1745793833015,ECE 45,A01,892618,Staff,0,12,50,50
1745793834043,ECE 109,A01,892620,Staff,0,43,0,0
1745793835073,ECE 111,A01,892719,Staff,0,7,50,50
1745793836103,ECE 197,001,957920,Mercier; Patrick Philip,9992,0,9999,7
1745793837131,ECON 178,A01,907814,Zhu; Ying,28,0,35,7
1745793838159,EDS 115,A00,895312,Staff,41,0,45,4
1745793839188,EDS 117,A01,895337,Staff,30,0,30,0
1745793840220,EDS 125,A00,895341,Jones; Gabrielle Anastasia,43,0,45,2
1745793841249,EDS 128A,A01,895459,Fargason; Sharon Gayle,44,0,45,1
1745793842279,EDS 128B,A01,895543,Pappas; Elizabeth,44,0,45,1
1745793843307,EDS 139,A00,897203,Pappas; Elizabeth,44,0,45,1
1745793843307,EDS 139,B00,897209,Fargason; Sharon Gayle,44,0,45,1
1745793844336,EDS 201,A00,895545,Staff,43,0,45,2
1745793845363,EDS 203,A01,895581,Halter; Christopher P.,43,0,45,2
1745793846393,EDS 204R,A01,895625,Heinzman; Erica M.,43,0,45,2
1745793846393,EDS 204R,B01,895693,Halter; Christopher P.,18,0,45,27
1745793847418,EDS 206R,A00,895694,Fargason; Sharon Gayle,9,0,30,21
1745793847418,EDS 206R,B00,895695,Choi; Bailey Miyeon,20,0,30,10
1745793848448,EDS 250,A00,895697,Hemans; Patricia Ann Benitez,43,0,45,2
1745793849474,EDS 281,A00,895701,Meyerott; Theresa Ann,15,0,15,0
1745793850506,EDS 284,A00,895736,Meyerott; Theresa Ann,15,0,15,0
1745793851531,EDS 286,A00,897210,Fine; Sarah,15,0,15,0
1745793852567,EDS 289C,A01,895770,Daly; Alan J.,15,0,15,0
1745793853618,EDS 290,A00,897211,Hofstetter; Carolyn,15,0,15,0
1745793854645,LIGM 5A,A00,896162,Fischer-Grunski; Eva K,15,0,20,5
1745793855671,LIGM 5B,A00,896260,Fischer-Grunski; Eva K,17,0,20,3
1745793856700,LIGM 5C,A00,896308,Fischer-Grunski; Eva K,18,0,20,2
1745793857725,LIIT 5AS,A00,896313,Carnelos; Chiara,18,0,20,2
1745793858754,LIIT 5BS,A00,896416,Carnelos; Chiara,20,0,20,0
1745793859781,LIIT 5CS,A00,896564,Carnelos; Chiara,20,0,20,0
1745793860806,LISP 5A,A00,896588,Munoz Sanchez; Alicia,4,0,20,16
1745793861835,LISP 5B,A00,896653,Munoz Sanchez; Alicia,10,0,20,10
1745793862863,LISP 5C,A00,896655,Munoz Sanchez; Alicia,4,0,20,16
1745793863889,MAE 197,001,957918,Kleissl; Jan,9998,0,9999,1
1745793864915,MATH 2,A01,957937,Staff,34,0,35,1
1745793865943,MATH 197,001,957876,Kedlaya; Kiran S.,9993,0,9999,6
1745793866972,MCWP 40,A00,892729,Duru; Nur,13,0,20,7
1745793866972,MCWP 40,B00,893304,Montejo; Carolina,20,0,20,0
1745793868001,MCWP 40R,A00,893757,Redela; Pamela Morgan,0,6,20,20
1745793869027,MCWP 50,A00,893758,Morshed; Michael James,2,0,20,18
1745793869027,MCWP 50,B00,893761,Bartulis; Jason Michael,17,0,20,3
1745793870054,MCWP 50R,A00,893766,Compas; Sean Matthew,0,1,20,20
1745793870054,MCWP 50R,B00,893769,Carter; Jennifer A,0,0,20,20
1745793870054,MCWP 50R,C00,893771,Krone; Jarret,0,3,20,20
1745793870054,MCWP 50R,D00,893772,Miller; Elizabeth Deen,3,0,20,17
1745793870054,MCWP 50R,E00,893775,Carter; Andrea L,0,0,20,20
1745793871080,MMW 11R,A01,892721,Herbst; Matthew,11,0,27,16
1745793871080,MMW 11R,A02,892722,Herbst; Matthew,0,0,0,3
1745793872107,MMW 12R,A01,892724,Herbst; Matthew,0,9,16,16
1745793872107,MMW 12R,A02,892725,Herbst; Matthew,0,9,16,16
1745793873132,MMW 13R,A01,892727,Staff,0,4,16,16
1745793873132,MMW 13R,A02,892728,Staff,0,4,16,16
1745793873132,MMW 13R,A03,958032,Staff,0,3,16,16
1745793873132,MMW 13R,A04,958033,Staff,0,2,16,16
1745793873132,MMW 13R,A05,958034,Staff,0,3,16,16
1745793874159,SIO 295LS,A00,894015,Staff,7,0,25,18
1745793875188,SIO 295S,A00,894020,Staff,7,0,25,18
1745793876216,SIOC 290S,B01,958918,Staff,0,0,0,0
1745793877243,SIOC 291S,B01,958922,Staff,0,0,0,0
1745793878270,SOCI 117,A01,895339,Staff,4,0,5,1
1745793879293,WES 237B,A00,894149,Staff,11,0,20,9
1745793881352,AESE 279B,A00,891859,Staff,13,0,35,22
1745793882377,AIP 197,001,891854,Staff,70,0,70,0
1745793883404,ANTH 289S,A00,891856,Gagneux; Pascal,12,0,12,0
1745793884428,BENG 196,001,957946,Engler; Adam J.,9996,0,9999,3
1745793885453,CAT 124RS,A01,956906,Staff,8,0,25,17
1745793886476,CAT 125RS,A01,922013,Staff,8,0,25,17
1745793887504,CLRE 250,A00,891860,Morris; Sheldon,9995,0,9999,4
1745793889556,CLRE 251R,A00,907817,Mehta; Ravindra L.,9994,0,9999,5
1745793890585,CLRE 252,A00,891864,Cuomo; Raphael Eduardo,9993,0,9999,6
1745793891610,CLRE 253,A00,891867,Vaida; Florin,9994,0,9999,5
1745793891610,CLRE 253,B00,907819,Staff,9999,0,9999,0
1745793892639,CLRE 259,A00,891868,Patel; Hemal,9998,0,9999,1
1745793893668,CLRE 260,A00,891872,Cuomo; Raphael Eduardo,9999,0,9999,0
1745793894698,CLRE 297,001,891888,Cuomo; Raphael Eduardo,9999,0,9999,0
1745793895727,CSE 191,A00,958773,Minnes Kemp; Mor Mia,9999,0,9999,0
1745793896755,CSS 201S,A01,892054,Mignozzetti; Umberto,30,0,30,0
1745793897783,CSS 202S,A01,892056,Mignozzetti; Umberto,30,0,30,0
1745793898810,DSC 197,001,956898,Eldridge; Justin Matthew,9998,0,9999,1
1745793899840,DSC 297,001,958000,Mazumdar; Arya,9998,0,9999,1
1745793900866,EAP 100,A00,905686,Staff,9776,0,9999,223
1745793901895,ECE 45,A01,892618,Staff,0,12,50,50
1745793902925,ECE 109,A01,892620,Staff,0,43,0,0
1745793903950,ECE 111,A01,892719,Staff,0,7,50,50
1745793904979,ECE 197,001,957920,Mercier; Patrick Philip,9992,0,9999,7
1745793906008,ECON 178,A01,907814,Zhu; Ying,28,0,35,7
1745793907036,EDS 115,A00,895312,Staff,41,0,45,4
1745793908067,EDS 117,A01,895337,Staff,30,0,30,0
1745793909095,EDS 125,A00,895341,Jones; Gabrielle Anastasia,43,0,45,2
1745793910128,EDS 128A,A01,895459,Fargason; Sharon Gayle,44,0,45,1
1745793911155,EDS 128B,A01,895543,Pappas; Elizabeth,44,0,45,1
1745793912183,EDS 139,A00,897203,Pappas; Elizabeth,44,0,45,1
1745793912183,EDS 139,B00,897209,Fargason; Sharon Gayle,44,0,45,1
1745793913210,EDS 201,A00,895545,Staff,43,0,45,2
1745793914236,EDS 203,A01,895581,Halter; Christopher P.,43,0,45,2
1745793915262,EDS 204R,A01,895625,Heinzman; Erica M.,43,0,45,2
1745793915262,EDS 204R,B01,895693,Halter; Christopher P.,18,0,45,27
1745793916288,EDS 206R,A00,895694,Fargason; Sharon Gayle,9,0,30,21
1745793916288,EDS 206R,B00,895695,Choi; Bailey Miyeon,20,0,30,10
1745793917314,EDS 250,A00,895697,Hemans; Patricia Ann Benitez,43,0,45,2
1745793918340,EDS 281,A00,895701,Meyerott; Theresa Ann,15,0,15,0
1745793919369,EDS 284,A00,895736,Meyerott; Theresa Ann,15,0,15,0
1745793920395,EDS 286,A00,897210,Fine; Sarah,15,0,15,0
1745793921420,EDS 289C,A01,895770,Daly; Alan J.,15,0,15,0
1745793922449,EDS 290,A00,897211,Hofstetter; Carolyn,15,0,15,0
1745793923489,LIGM 5A,A00,896162,Fischer-Grunski; Eva K,15,0,20,5
1745793924512,LIGM 5B,A00,896260,Fischer-Grunski; Eva K,17,0,20,3
1745793925538,LIGM 5C,A00,896308,Fischer-Grunski; Eva K,18,0,20,2
1745793926564,LIIT 5AS,A00,896313,Carnelos; Chiara,18,0,20,2
1745793927594,LIIT 5BS,A00,896416,Carnelos; Chiara,20,0,20,0
1745793928619,LIIT 5CS,A00,896564,Carnelos; Chiara,20,0,20,0
1745793929647,LISP 5A,A00,896588,Munoz Sanchez; Alicia,4,0,20,16
1745793930675,LISP 5B,A00,896653,Munoz Sanchez; Alicia,10,0,20,10
1745793931703,LISP 5C,A00,896655,Munoz Sanchez; Alicia,4,0,20,16
1745793932729,MAE 197,001,957918,Kleissl; Jan,9998,0,9999,1
1745793933761,MATH 2,A01,957937,Staff,34,0,35,1
1745793934789,MATH 197,001,957876,Kedlaya; Kiran S.,9993,0,9999,6
1745793935820,MCWP 40,A00,892729,Duru; Nur,13,0,20,7
1745793935820,MCWP 40,B00,893304,Montejo; Carolina,20,0,20,0
1745793936844,MCWP 40R,A00,893757,Redela; Pamela Morgan,0,6,20,20
1745793937873,MCWP 50,A00,893758,Morshed; Michael James,2,0,20,18
1745793937873,MCWP 50,B00,893761,Bartulis; Jason Michael,17,0,20,3
1745793938898,MCWP 50R,A00,893766,Compas; Sean Matthew,0,1,20,20
1745793938898,MCWP 50R,B00,893769,Carter; Jennifer A,0,0,20,20
1745793938898,MCWP 50R,C00,893771,Krone; Jarret,0,3,20,20
1745793938898,MCWP 50R,D00,893772,Miller; Elizabeth Deen,3,0,20,17
1745793938898,MCWP 50R,E00,893775,Carter; Andrea L,0,0,20,20
1745793939927,MMW 11R,A01,892721,Herbst; Matthew,11,0,27,16
1745793939927,MMW 11R,A02,892722,Herbst; Matthew,0,0,0,3
1745793940955,MMW 12R,A01,892724,Herbst; Matthew,0,9,16,16
1745793940955,MMW 12R,A02,892725,Herbst; Matthew,0,9,16,16
1745793941979,MMW 13R,A01,892727,Staff,0,4,16,16
1745793941979,MMW 13R,A02,892728,Staff,0,4,16,16
1745793941979,MMW 13R,A03,958032,Staff,0,3,16,16
1745793941979,MMW 13R,A04,958033,Staff,0,2,16,16
1745793941979,MMW 13R,A05,958034,Staff,0,3,16,16
1745793943004,SIO 295LS,A00,894015,Staff,7,0,25,18
1745793944028,SIO 295S,A00,894020,Staff,7,0,25,18
1745793945057,SIOC 290S,B01,958918,Staff,0,0,0,0
1745793946085,SIOC 291S,B01,958922,Staff,0,0,0,0
1745793947111,SOCI 117,A01,895339,Staff,4,0,5,1
1745793948163,WES 237B,A00,894149,Staff,11,0,20,9
1745793950230,AESE 279B,A00,891859,Staff,13,0,35,22
1745793951255,AIP 197,001,891854,Staff,70,0,70,0
1745793952280,ANTH 289S,A00,891856,Gagneux; Pascal,12,0,12,0
1745793953308,BENG 196,001,957946,Engler; Adam J.,9996,0,9999,3
1745793954336,CAT 124RS,A01,956906,Staff,8,0,25,17
1745793955364,CAT 125RS,A01,922013,Staff,8,0,25,17
1745793956391,CLRE 250,A00,891860,Morris; Sheldon,9995,0,9999,4
1745793958441,CLRE 251R,A00,907817,Mehta; Ravindra L.,9994,0,9999,5
1745793959466,CLRE 252,A00,891864,Cuomo; Raphael Eduardo,9993,0,9999,6
1745793960492,CLRE 253,A00,891867,Vaida; Florin,9994,0,9999,5
1745793960492,CLRE 253,B00,907819,Staff,9999,0,9999,0
1745793961520,CLRE 259,A00,891868,Patel; Hemal,9998,0,9999,1
1745793962546,CLRE 260,A00,891872,Cuomo; Raphael Eduardo,9999,0,9999,0
1745793963573,CLRE 297,001,891888,Cuomo; Raphael Eduardo,9999,0,9999,0
1745793964601,CSE 191,A00,958773,Minnes Kemp; Mor Mia,9999,0,9999,0
1745793965626,CSS 201S,A01,892054,Mignozzetti; Umberto,30,0,30,0
1745793966655,CSS 202S,A01,892056,Mignozzetti; Umberto,30,0,30,0
1745793967681,DSC 197,001,956898,Eldridge; Justin Matthew,9998,0,9999,1
1745793968705,DSC 297,001,958000,Mazumdar; Arya,9998,0,9999,1
1745793969735,EAP 100,A00,905686,Staff,9776,0,9999,223
1745793970759,ECE 45,A01,892618,Staff,0,12,50,50
1745793971783,ECE 109,A01,892620,Staff,0,43,0,0
1745793972809,ECE 111,A01,892719,Staff,0,7,50,50
1745793973835,ECE 197,001,957920,Mercier; Patrick Philip,9992,0,9999,7
1745793974864,ECON 178,A01,907814,Zhu; Ying,28,0,35,7
1745793975889,EDS 115,A00,895312,Staff,41,0,45,4
1745793976917,EDS 117,A01,895337,Staff,30,0,30,0
1745793977942,EDS 125,A00,895341,Jones; Gabrielle Anastasia,43,0,45,2
1745793978967,EDS 128A,A01,895459,Fargason; Sharon Gayle,44,0,45,1
1745793979992,EDS 128B,A01,895543,Pappas; Elizabeth,44,0,45,1
1745793981021,EDS 139,A00,897203,Pappas; Elizabeth,44,0,45,1
1745793981021,EDS 139,B00,897209,Fargason; Sharon Gayle,44,0,45,1
1745793982049,EDS 201,A00,895545,Staff,43,0,45,2
1745793983075,EDS 203,A01,895581,Halter; Christopher P.,43,0,45,2
1745793984105,EDS 204R,A01,895625,Heinzman; Erica M.,43,0,45,2
1745793984105,EDS 204R,B01,895693,Halter; Christopher P.,18,0,45,27
1745793985130,EDS 206R,A00,895694,Fargason; Sharon Gayle,9,0,30,21
1745793985130,EDS 206R,B00,895695,Choi; Bailey Miyeon,20,0,30,10
1745793986160,EDS 250,A00,895697,Hemans; Patricia Ann Benitez,43,0,45,2
1745793987185,EDS 281,A00,895701,Meyerott; Theresa Ann,15,0,15,0
1745793988211,EDS 284,A00,895736,Meyerott; Theresa Ann,15,0,15,0
1745793989235,EDS 286,A00,897210,Fine; Sarah,15,0,15,0
1745793990262,EDS 289C,A01,895770,Daly; Alan J.,15,0,15,0
1745793991288,EDS 290,A00,897211,Hofstetter; Carolyn,15,0,15,0
1745793992321,LIGM 5A,A00,896162,Fischer-Grunski; Eva K,15,0,20,5
1745793993350,LIGM 5B,A00,896260,Fischer-Grunski; Eva K,17,0,20,3
1745793994376,LIGM 5C,A00,896308,Fischer-Grunski; Eva K,18,0,20,2
1745793995402,LIIT 5AS,A00,896313,Carnelos; Chiara,18,0,20,2
1745793996431,LIIT 5BS,A00,896416,Carnelos; Chiara,20,0,20,0
1745793997461,LIIT 5CS,A00,896564,Carnelos; Chiara,20,0,20,0
1745793998488,LISP 5A,A00,896588,Munoz Sanchez; Alicia,4,0,20,16
1745793999513,LISP 5B,A00,896653,Munoz Sanchez; Alicia,10,0,20,10
1745794000542,LISP 5C,A00,896655,Munoz Sanchez; Alicia,4,0,20,16
1745794001568,MAE 197,001,957918,Kleissl; Jan,9998,0,9999,1
1745794002593,MATH 2,A01,957937,Staff,34,0,35,1
1745794003622,MATH 197,001,957876,Kedlaya; Kiran S.,9993,0,9999,6
1745794004655,MCWP 40,A00,892729,Duru; Nur,13,0,20,7
1745794004655,MCWP 40,B00,893304,Montejo; Carolina,20,0,20,0
1745794005681,MCWP 40R,A00,893757,Redela; Pamela Morgan,0,6,20,20
1745794006708,MCWP 50,A00,893758,Morshed; Michael James,2,0,20,18
1745794006708,MCWP 50,B00,893761,Bartulis; Jason Michael,17,0,20,3
1745794007735,MCWP 50R,A00,893766,Compas; Sean Matthew,0,1,20,20
1745794007735,MCWP 50R,B00,893769,Carter; Jennifer A,0,0,20,20
1745794007735,MCWP 50R,C00,893771,Krone; Jarret,0,3,20,20
1745794007735,MCWP 50R,D00,893772,Miller; Elizabeth Deen,3,0,20,17
1745794007735,MCWP 50R,E00,893775,Carter; Andrea L,0,0,20,20
1745794008760,MMW 11R,A01,892721,Herbst; Matthew,11,0,27,16
1745794008760,MMW 11R,A02,892722,Herbst; Matthew,0,0,0,3
1745794009785,MMW 12R,A01,892724,Herbst; Matthew,0,9,16,16
1745794009785,MMW 12R,A02,892725,Herbst; Matthew,0,9,16,16
1745794010814,MMW 13R,A01,892727,Staff,0,4,16,16
1745794010814,MMW 13R,A02,892728,Staff,0,4,16,16
1745794010814,MMW 13R,A03,958032,Staff,0,3,16,16
1745794010814,MMW 13R,A04,958033,Staff,0,2,16,16
1745794010814,MMW 13R,A05,958034,Staff,0,3,16,16
1745794011841,SIO 295LS,A00,894015,Staff,7,0,25,18
1745794012868,SIO 295S,A00,894020,Staff,7,0,25,18
1745794013897,SIOC 290S,B01,958918,Staff,0,0,0,0
1745794014929,SIOC 291S,B01,958922,Staff,0,0,0,0
1745794015962,SOCI 117,A01,895339,Staff,4,0,5,1
1745794016986,WES 237B,A00,894149,Staff,11,0,20,9
1745794019047,AESE 279B,A00,891859,Staff,13,0,35,22
1745794020072,AIP 197,001,891854,Staff,70,0,70,0
1745794021098,ANTH 289S,A00,891856,Gagneux; Pascal,12,0,12,0
1745794022124,BENG 196,001,957946,Engler; Adam J.,9996,0,9999,3
1745794023152,CAT 124RS,A01,956906,Staff,8,0,25,17
1745794024182,CAT 125RS,A01,922013,Staff,8,0,25,17
1745794025209,CLRE 250,A00,891860,Morris; Sheldon,9995,0,9999,4
1745794027264,CLRE 251R,A00,907817,Mehta; Ravindra L.,9994,0,9999,5
1745794028290,CLRE 252,A00,891864,Cuomo; Raphael Eduardo,9993,0,9999,6
1745794029316,CLRE 253,A00,891867,Vaida; Florin,9994,0,9999,5
1745794029316,CLRE 253,B00,907819,Staff,9999,0,9999,0
1745794030343,CLRE 259,A00,891868,Patel; Hemal,9998,0,9999,1
1745794031368,CLRE 260,A00,891872,Cuomo; Raphael Eduardo,9999,0,9999,0
1745794032395,CLRE 297,001,891888,Cuomo; Raphael Eduardo,9999,0,9999,0
1745794033422,CSE 191,A00,958773,Minnes Kemp; Mor Mia,9999,0,9999,0
1745794034448,CSS 201S,A01,892054,Mignozzetti; Umberto,30,0,30,0
1745794035476,CSS 202S,A01,892056,Mignozzetti; Umberto,30,0,30,0
1745794036504,DSC 197,001,956898,Eldridge; Justin Matthew,9998,0,9999,1
1745794037531,DSC 297,001,958000,Mazumdar; Arya,9998,0,9999,1
1745794038559,EAP 100,A00,905686,Staff,9776,0,9999,223
1745794039586,ECE 45,A01,892618,Staff,0,12,50,50
1745794040611,ECE 109,A01,892620,Staff,0,43,0,0
1745794041638,ECE 111,A01,892719,Staff,0,7,50,50
1745794042665,ECE 197,001,957920,Mercier; Patrick Philip,9992,0,9999,7
1745794043692,ECON 178,A01,907814,Zhu; Ying,28,0,35,7
1745794044718,EDS 115,A00,895312,Staff,41,0,45,4
1745794045750,EDS 117,A01,895337,Staff,30,0,30,0
1745794046776,EDS 125,A00,895341,Jones; Gabrielle Anastasia,43,0,45,2
1745794047802,EDS 128A,A01,895459,Fargason; Sharon Gayle,44,0,45,1
1745794048831,EDS 128B,A01,895543,Pappas; Elizabeth,44,0,45,1
1745794049859,EDS 139,A00,897203,Pappas; Elizabeth,44,0,45,1
1745794049859,EDS 139,B00,897209,Fargason; Sharon Gayle,44,0,45,1
1745794050889,EDS 201,A00,895545,Staff,43,0,45,2
1745794051914,EDS 203,A01,895581,Halter; Christopher P.,43,0,45,2
1745794052943,EDS 204R,A01,895625,Heinzman; Erica M.,43,0,45,2
1745794052943,EDS 204R,B01,895693,Halter; Christopher P.,18,0,45,27
1745794053969,EDS 206R,A00,895694,Fargason; Sharon Gayle,9,0,30,21
1745794053969,EDS 206R,B00,895695,Choi; Bailey Miyeon,20,0,30,10
1745794054997,EDS 250,A00,895697,Hemans; Patricia Ann Benitez,43,0,45,2
1745794056044,EDS 281,A00,895701,Meyerott; Theresa Ann,15,0,15,0
1745794057069,EDS 284,A00,895736,Meyerott; Theresa Ann,15,0,15,0
1745794058093,EDS 286,A00,897210,Fine; Sarah,15,0,15,0
1745794059121,EDS 289C,A01,895770,Daly; Alan J.,15,0,15,0
1745794060146,EDS 290,A00,897211,Hofstetter; Carolyn,15,0,15,0
1745794061175,LIGM 5A,A00,896162,Fischer-Grunski; Eva K,15,0,20,5
1745794062202,LIGM 5B,A00,896260,Fischer-Grunski; Eva K,17,0,20,3
1745794063230,LIGM 5C,A00,896308,Fischer-Grunski; Eva K,18,0,20,2
1745794064256,LIIT 5AS,A00,896313,Carnelos; Chiara,18,0,20,2
1745794065284,LIIT 5BS,A00,896416,Carnelos; Chiara,20,0,20,0
1745794066308,LIIT 5CS,A00,896564,Carnelos; Chiara,20,0,20,0
1745794067334,LISP 5A,A00,896588,Munoz Sanchez; Alicia,4,0,20,16
1745794068359,LISP 5B,A00,896653,Munoz Sanchez; Alicia,10,0,20,10
1745794069383,LISP 5C,A00,896655,Munoz Sanchez; Alicia,4,0,20,16
1745794070407,MAE 197,001,957918,Kleissl; Jan,9998,0,9999,1
1745794071433,MATH 2,A01,957937,Staff,34,0,35,1
1745794072461,MATH 197,001,957876,Kedlaya; Kiran S.,9993,0,9999,6
1745794073486,MCWP 40,A00,892729,Duru; Nur,13,0,20,7
1745794073486,MCWP 40,B00,893304,Montejo; Carolina,20,0,20,0
1745794074516,MCWP 40R,A00,893757,Redela; Pamela Morgan,0,6,20,20
1745794075544,MCWP 50,A00,893758,Morshed; Michael James,2,0,20,18
1745794075544,MCWP 50,B00,893761,Bartulis; Jason Michael,17,0,20,3
1745794076573,MCWP 50R,A00,893766,Compas; Sean Matthew,0,1,20,20
1745794076573,MCWP 50R,B00,893769,Carter; Jennifer A,0,0,20,20
1745794076573,MCWP 50R,C00,893771,Krone; Jarret,0,3,20,20
1745794076573,MCWP 50R,D00,893772,Miller; Elizabeth Deen,3,0,20,17
1745794076573,MCWP 50R,E00,893775,Carter; Andrea L,0,0,20,20
1745794077596,MMW 11R,A01,892721,Herbst; Matthew,11,0,27,16
1745794077596,MMW 11R,A02,892722,Herbst; Matthew,0,0,0,3
1745794078620,MMW 12R,A01,892724,Herbst; Matthew,0,9,16,16
1745794078620,MMW 12R,A02,892725,Herbst; Matthew,0,9,16,16
1745794079649,MMW 13R,A01,892727,Staff,0,4,16,16
1745794079649,MMW 13R,A02,892728,Staff,0,4,16,16
1745794079649,MMW 13R,A03,958032,Staff,0,3,16,16
1745794079649,MMW 13R,A04,958033,Staff,0,2,16,16
1745794079649,MMW 13R,A05,958034,Staff,0,3,16,16
1745794080675,SIO 295LS,A00,894015,Staff,7,0,25,18
1745794081704,SIO 295S,A00,894020,Staff,7,0,25,18
1745794082732,SIOC 290S,B01,958918,Staff,0,0,0,0
1745794083759,SIOC 291S,B01,958922,Staff,0,0,0,0
1745794084789,SOCI 117,A01,895339,Staff,4,0,5,1
1745794085814,WES 237B,A00,894149,Staff,11,0,20,9
1745794087875,AESE 279B,A00,891859,Staff,13,0,35,22
1745794088902,AIP 197,001,891854,Staff,70,0,70,0
1745794089928,ANTH 289S,A00,891856,Gagneux; Pascal,12,0,12,0
1745794090953,BENG 196,001,957946,Engler; Adam J.,9996,0,9999,3
1745794091979,CAT 124RS,A01,956906,Staff,8,0,25,17
1745794093006,CAT 125RS,A01,922013,Staff,8,0,25,17
1745794094030,CLRE 250,A00,891860,Morris; Sheldon,9995,0,9999,4
1745794096086,CLRE 251R,A00,907817,Mehta; Ravindra L.,9994,0,9999,5
1745794097111,CLRE 252,A00,891864,Cuomo; Raphael Eduardo,9993,0,9999,6
1745794098141,CLRE 253,A00,891867,Vaida; Florin,9994,0,9999,5
1745794098141,CLRE 253,B00,907819,Staff,9999,0,9999,0
1745794099170,CLRE 259,A00,891868,Patel; Hemal,9998,0,9999,1
1745794100195,CLRE 260,A00,891872,Cuomo; Raphael Eduardo,9999,0,9999,0
1745794101224,CLRE 297,001,891888,Cuomo; Raphael Eduardo,9999,0,9999,0
1745794102252,CSE 191,A00,958773,Minnes Kemp; Mor Mia,9999,0,9999,0
1745794103277,CSS 201S,A01,892054,Mignozzetti; Umberto,30,0,30,0
1745794104306,CSS 202S,A01,892056,Mignozzetti; Umberto,30,0,30,0
1745794105332,DSC 197,001,956898,Eldridge; Justin Matthew,9998,0,9999,1
1745794106358,DSC 297,001,958000,Mazumdar; Arya,9998,0,9999,1
1745794107384,EAP 100,A00,905686,Staff,9776,0,9999,223
1745794108410,ECE 45,A01,892618,Staff,0,12,50,50
1745794109436,ECE 109,A01,892620,Staff,0,43,0,0
1745794110464,ECE 111,A01,892719,Staff,0,7,50,50
1745794111489,ECE 197,001,957920,Mercier; Patrick Philip,9992,0,9999,7
1745794112517,ECON 178,A01,907814,Zhu; Ying,28,0,35,7
1745794113544,EDS 115,A00,895312,Staff,41,0,45,4
1745794114570,EDS 117,A01,895337,Staff,30,0,30,0
1745794115596,EDS 125,A00,895341,Jones; Gabrielle Anastasia,43,0,45,2
1745794116623,EDS 128A,A01,895459,Fargason; Sharon Gayle,44,0,45,1
1745794117652,EDS 128B,A01,895543,Pappas; Elizabeth,44,0,45,1
1745794118679,EDS 139,A00,897203,Pappas; Elizabeth,44,0,45,1
1745794118679,EDS 139,B00,897209,Fargason; Sharon Gayle,44,0,45,1
1745794119706,EDS 201,A00,895545,Staff,43,0,45,2
1745794120735,EDS 203,A01,895581,Halter; Christopher P.,43,0,45,2
1745794121759,EDS 204R,A01,895625,Heinzman; Erica M.,43,0,45,2
1745794121759,EDS 204R,B01,895693,Halter; Christopher P.,18,0,45,27
1745794122787,EDS 206R,A00,895694,Fargason; Sharon Gayle,9,0,30,21
1745794122787,EDS 206R,B00,895695,Choi; Bailey Miyeon,20,0,30,10
1745794123815,EDS 250,A00,895697,Hemans; Patricia Ann Benitez,43,0,45,2
1745794124844,EDS 281,A00,895701,Meyerott; Theresa Ann,15,0,15,0
1745794125871,EDS 284,A00,895736,Meyerott; Theresa Ann,15,0,15,0
1745794126896,EDS 286,A00,897210,Fine; Sarah,15,0,15,0
1745794127925,EDS 289C,A01,895770,Daly; Alan J.,15,0,15,0
1745794128953,EDS 290,A00,897211,Hofstetter; Carolyn,15,0,15,0
1745794129979,LIGM 5A,A00,896162,Fischer-Grunski; Eva K,15,0,20,5
1745794131011,LIGM 5B,A00,896260,Fischer-Grunski; Eva K,17,0,20,3
1745794132039,LIGM 5C,A00,896308,Fischer-Grunski; Eva K,18,0,20,2
1745794133066,LIIT 5AS,A00,896313,Carnelos; Chiara,18,0,20,2
1745794134093,LIIT 5BS,A00,896416,Carnelos; Chiara,20,0,20,0
1745794135119,LIIT 5CS,A00,896564,Carnelos; Chiara,20,0,20,0
1745794136146,LISP 5A,A00,896588,Munoz Sanchez; Alicia,4,0,20,16
1745794137173,LISP 5B,A00,896653,Munoz Sanchez; Alicia,10,0,20,10
1745794138203,LISP 5C,A00,896655,Munoz Sanchez; Alicia,4,0,20,16
1745794139233,MAE 197,001,957918,Kleissl; Jan,9998,0,9999,1
1745794140259,MATH 2,A01,957937,Staff,34,0,35,1
1745794141289,MATH 197,001,957876,Kedlaya; Kiran S.,9993,0,9999,6
1745794142317,MCWP 40,A00,892729,Duru; Nur,13,0,20,7
1745794142317,MCWP 40,B00,893304,Montejo; Carolina,20,0,20,0
1745794143343,MCWP 40R,A00,893757,Redela; Pamela Morgan,0,6,20,20
1745794144371,MCWP 50,A00,893758,Morshed; Michael James,2,0,20,18
1745794144371,MCWP 50,B00,893761,Bartulis; Jason Michael,17,0,20,3
1745794145401,MCWP 50R,A00,893766,Compas; Sean Matthew,0,1,20,20
1745794145401,MCWP 50R,B00,893769,Carter; Jennifer A,0,0,20,20
1745794145401,MCWP 50R,C00,893771,Krone; Jarret,0,3,20,20
1745794145401,MCWP 50R,D00,893772,Miller; Elizabeth Deen,3,0,20,17
1745794145401,MCWP 50R,E00,893775,Carter; Andrea L,0,0,20,20
1745794146428,MMW 11R,A01,892721,Herbst; Matthew,11,0,27,16
1745794146428,MMW 11R,A02,892722,Herbst; Matthew,0,0,0,3
1745794147453,MMW 12R,A01,892724,Herbst; Matthew,0,9,16,16
1745794147453,MMW 12R,A02,892725,Herbst; Matthew,0,9,16,16
1745794148481,MMW 13R,A01,892727,Staff,0,4,16,16
1745794148481,MMW 13R,A02,892728,Staff,0,4,16,16
1745794148481,MMW 13R,A03,958032,Staff,0,3,16,16
1745794148481,MMW 13R,A04,958033,Staff,0,2,16,16
1745794148481,MMW 13R,A05,958034,Staff,0,3,16,16
1745794149508,SIO 295LS,A00,894015,Staff,7,0,25,18
1745794150537,SIO 295S,A00,894020,Staff,7,0,25,18
1745794151566,SIOC 290S,B01,958918,Staff,0,0,0,0
1745794152592,SIOC 291S,B01,958922,Staff,0,0,0,0
1745794153619,SOCI 117,A01,895339,Staff,4,0,5,1
1745794154644,WES 237B,A00,894149,Staff,11,0,20,9
1745794156706,AESE 279B,A00,891859,Staff,13,0,35,22
1745794157731,AIP 197,001,891854,Staff,70,0,70,0
1745794158756,ANTH 289S,A00,891856,Gagneux; Pascal,12,0,12,0
1745794159779,BENG 196,001,957946,Engler; Adam J.,9996,0,9999,3
1745794160807,CAT 124RS,A01,956906,Staff,8,0,25,17
1745794161833,CAT 125RS,A01,922013,Staff,8,0,25,17
1745794162857,CLRE 250,A00,891860,Morris; Sheldon,9995,0,9999,4
1745794164910,CLRE 251R,A00,907817,Mehta; Ravindra L.,9994,0,9999,5
1745794165932,CLRE 252,A00,891864,Cuomo; Raphael Eduardo,9993,0,9999,6
1745794166960,CLRE 253,A00,891867,Vaida; Florin,9994,0,9999,5
1745794166960,CLRE 253,B00,907819,Staff,9999,0,9999,0
1745794167987,CLRE 259,A00,891868,Patel; Hemal,9998,0,9999,1
1745794169014,CLRE 260,A00,891872,Cuomo; Raphael Eduardo,9999,0,9999,0
1745794170045,CLRE 297,001,891888,Cuomo; Raphael Eduardo,9999,0,9999,0
1745794171076,CSE 191,A00,958773,Minnes Kemp; Mor Mia,9999,0,9999,0
1745794172105,CSS 201S,A01,892054,Mignozzetti; Umberto,30,0,30,0
1745794173130,CSS 202S,A01,892056,Mignozzetti; Umberto,30,0,30,0
1745794174157,DSC 197,001,956898,Eldridge; Justin Matthew,9998,0,9999,1
1745794175182,DSC 297,001,958000,Mazumdar; Arya,9998,0,9999,1
1745794176209,EAP 100,A00,905686,Staff,9776,0,9999,223
1745794177238,ECE 45,A01,892618,Staff,0,12,50,50
1745794178264,ECE 109,A01,892620,Staff,0,43,0,0
1745794179290,ECE 111,A01,892719,Staff,0,7,50,50
1745794180317,ECE 197,001,957920,Mercier; Patrick Philip,9992,0,9999,7
1745794181346,ECON 178,A01,907814,Zhu; Ying,28,0,35,7
1745794182382,EDS 115,A00,895312,Staff,41,0,45,4
1745794183411,EDS 117,A01,895337,Staff,30,0,30,0
1745794184440,EDS 125,A00,895341,Jones; Gabrielle Anastasia,43,0,45,2
1745794185467,EDS 128A,A01,895459,Fargason; Sharon Gayle,44,0,45,1
1745794186494,EDS 128B,A01,895543,Pappas; Elizabeth,44,0,45,1
1745794187527,EDS 139,A00,897203,Pappas; Elizabeth,44,0,45,1
1745794187527,EDS 139,B00,897209,Fargason; Sharon Gayle,44,0,45,1
1745794188552,EDS 201,A00,895545,Staff,43,0,45,2
1745794189580,EDS 203,A01,895581,Halter; Christopher P.,43,0,45,2
1745794190609,EDS 204R,A01,895625,Heinzman; Erica M.,43,0,45,2
1745794190609,EDS 204R,B01,895693,Halter; Christopher P.,18,0,45,27
1745794191666,EDS 206R,A00,895694,Fargason; Sharon Gayle,9,0,30,21
1745794191666,EDS 206R,B00,895695,Choi; Bailey Miyeon,20,0,30,10
1745794192691,EDS 250,A00,895697,Hemans; Patricia Ann Benitez,43,0,45,2
1745794193714,EDS 281,A00,895701,Meyerott; Theresa Ann,15,0,15,0
1745794194739,EDS 284,A00,895736,Meyerott; Theresa Ann,15,0,15,0
1745794195763,EDS 286,A00,897210,Fine; Sarah,15,0,15,0
1745794196790,EDS 289C,A01,895770,Daly; Alan J.,15,0,15,0
1745794197816,EDS 290,A00,897211,Hofstetter; Carolyn,15,0,15,0
1745794198845,LIGM 5A,A00,896162,Fischer-Grunski; Eva K,15,0,20,5
1745794199870,LIGM 5B,A00,896260,Fischer-Grunski; Eva K,17,0,20,3
1745794200894,LIGM 5C,A00,896308,Fischer-Grunski; Eva K,18,0,20,2
1745794201918,LIIT 5AS,A00,896313,Carnelos; Chiara,18,0,20,2
1745794202944,LIIT 5BS,A00,896416,Carnelos; Chiara,20,0,20,0
1745794203972,LIIT 5CS,A00,896564,Carnelos; Chiara,20,0,20,0
1745794205005,LISP 5A,A00,896588,Munoz Sanchez; Alicia,4,0,20,16
1745794206033,LISP 5B,A00,896653,Munoz Sanchez; Alicia,10,0,20,10
1745794207060,LISP 5C,A00,896655,Munoz Sanchez; Alicia,4,0,20,16
1745794208090,MAE 197,001,957918,Kleissl; Jan,9998,0,9999,1
1745794209121,MATH 2,A01,957937,Staff,34,0,35,1
1745794210149,MATH 197,001,957876,Kedlaya; Kiran S.,9993,0,9999,6
1745794211177,MCWP 40,A00,892729,Duru; Nur,13,0,20,7
1745794211177,MCWP 40,B00,893304,Montejo; Carolina,20,0,20,0
1745794212206,MCWP 40R,A00,893757,Redela; Pamela Morgan,0,6,20,20
1745794213232,MCWP 50,A00,893758,Morshed; Michael James,2,0,20,18
1745794213232,MCWP 50,B00,893761,Bartulis; Jason Michael,17,0,20,3
1745794214260,MCWP 50R,A00,893766,Compas; Sean Matthew,0,1,20,20
1745794214260,MCWP 50R,B00,893769,Carter; Jennifer A,0,0,20,20
1745794214260,MCWP 50R,C00,893771,Krone; Jarret,0,3,20,20
1745794214260,MCWP 50R,D00,893772,Miller; Elizabeth Deen,3,0,20,17
1745794214260,MCWP 50R,E00,893775,Carter; Andrea L,0,0,20,20
1745794215292,MMW 11R,A01,892721,Herbst; Matthew,11,0,27,16
1745794215292,MMW 11R,A02,892722,Herbst; Matthew,0,0,0,3
1745794216321,MMW 12R,A01,892724,Herbst; Matthew,0,9,16,16
1745794216321,MMW 12R,A02,892725,Herbst; Matthew,0,9,16,16
1745794217348,MMW 13R,A01,892727,Staff,0,4,16,16
1745794217348,MMW 13R,A02,892728,Staff,0,4,16,16
1745794217348,MMW 13R,A03,958032,Staff,0,3,16,16
1745794217348,MMW 13R,A04,958033,Staff,0,2,16,16
1745794217348,MMW 13R,A05,958034,Staff,0,3,16,16
1745794218376,SIO 295LS,A00,894015,Staff,7,0,25,18
1745794219400,SIO 295S,A00,894020,Staff,7,0,25,18
1745794220425,SIOC 290S,B01,958918,Staff,0,0,0,0
1745794221454,SIOC 291S,B01,958922,Staff,0,0,0,0
1745794222477,SOCI 117,A01,895339,Staff,4,0,5,1
1745794223501,WES 237B,A00,894149,Staff,11,0,20,9
1745794225580,AESE 279B,A00,891859,Staff,13,0,35,22
1745794226606,AIP 197,001,891854,Staff,70,0,70,0
1745794227632,ANTH 289S,A00,891856,Gagneux; Pascal,12,0,12,0
1745794228656,BENG 196,001,957946,Engler; Adam J.,9996,0,9999,3
1745794229681,CAT 124RS,A01,956906,Staff,8,0,25,17
1745794230706,CAT 125RS,A01,922013,Staff,8,0,25,17
1745794231730,CLRE 250,A00,891860,Morris; Sheldon,9995,0,9999,4
1745794233782,CLRE 251R,A00,907817,Mehta; Ravindra L.,9994,0,9999,5
1745794234805,CLRE 252,A00,891864,Cuomo; Raphael Eduardo,9993,0,9999,6
1745794235833,CLRE 253,A00,891867,Vaida; Florin,9994,0,9999,5
1745794235833,CLRE 253,B00,907819,Staff,9999,0,9999,0
1745794236859,CLRE 259,A00,891868,Patel; Hemal,9998,0,9999,1
1745794237886,CLRE 260,A00,891872,Cuomo; Raphael Eduardo,9999,0,9999,0
1745794238914,CLRE 297,001,891888,Cuomo; Raphael Eduardo,9999,0,9999,0
1745794239941,CSE 191,A00,958773,Minnes Kemp; Mor Mia,9999,0,9999,0
1745794240967,CSS 201S,A01,892054,Mignozzetti; Umberto,30,0,30,0
1745794241995,CSS 202S,A01,892056,Mignozzetti; Umberto,30,0,30,0
1745794243022,DSC 197,001,956898,Eldridge; Justin Matthew,9998,0,9999,1
1745794244049,DSC 297,001,958000,Mazumdar; Arya,9998,0,9999,1
1745794245074,EAP 100,A00,905686,Staff,9776,0,9999,223
1745794246102,ECE 45,A01,892618,Staff,0,12,50,50
1745794247129,ECE 109,A01,892620,Staff,0,43,0,0
1745794248155,ECE 111,A01,892719,Staff,0,7,50,50
1745794249181,ECE 197,001,957920,Mercier; Patrick Philip,9992,0,9999,7
1745794250209,ECON 178,A01,907814,Zhu; Ying,28,0,35,7
1745794251235,EDS 115,A00,895312,Staff,41,0,45,4
1745794252261,EDS 117,A01,895337,Staff,30,0,30,0
1745794253291,EDS 125,A00,895341,Jones; Gabrielle Anastasia,43,0,45,2
1745794254318,EDS 128A,A01,895459,Fargason; Sharon Gayle,44,0,45,1
1745794255346,EDS 128B,A01,895543,Pappas; Elizabeth,44,0,45,1
1745794256373,EDS 139,A00,897203,Pappas; Elizabeth,44,0,45,1
1745794256373,EDS 139,B00,897209,Fargason; Sharon Gayle,44,0,45,1
1745794257398,EDS 201,A00,895545,Staff,43,0,45,2
1745794258425,EDS 203,A01,895581,Halter; Christopher P.,43,0,45,2
1745794259451,EDS 204R,A01,895625,Heinzman; Erica M.,43,0,45,2
1745794259451,EDS 204R,B01,895693,Halter; Christopher P.,18,0,45,27
1745794260477,EDS 206R,A00,895694,Fargason; Sharon Gayle,9,0,30,21
1745794260477,EDS 206R,B00,895695,Choi; Bailey Miyeon,20,0,30,10
1745794261504,EDS 250,A00,895697,Hemans; Patricia Ann Benitez,43,0,45,2
1745794262531,EDS 281,A00,895701,Meyerott; Theresa Ann,15,0,15,0
1745794263557,EDS 284,A00,895736,Meyerott; Theresa Ann,15,0,15,0
1745794264584,EDS 286,A00,897210,Fine; Sarah,15,0,15,0
1745794265610,EDS 289C,A01,895770,Daly; Alan J.,15,0,15,0
1745794266635,EDS 290,A00,897211,Hofstetter; Carolyn,15,0,15,0
1745794267659,LIGM 5A,A00,896162,Fischer-Grunski; Eva K,15,0,20,5
1745794268685,LIGM 5B,A00,896260,Fischer-Grunski; Eva K,17,0,20,3
1745794269714,LIGM 5C,A00,896308,Fischer-Grunski; Eva K,18,0,20,2
1745794270744,LIIT 5AS,A00,896313,Carnelos; Chiara,18,0,20,2
1745794271769,LIIT 5BS,A00,896416,Carnelos; Chiara,20,0,20,0
1745794273813,LIIT 5CS,A00,896564,Carnelos; Chiara,20,0,20,0
1745794274843,LISP 5A,A00,896588,Munoz Sanchez; Alicia,4,0,20,16
1745794275869,LISP 5B,A00,896653,Munoz Sanchez; Alicia,10,0,20,10
1745794276897,LISP 5C,A00,896655,Munoz Sanchez; Alicia,4,0,20,16
1745794277922,MAE 197,001,957918,Kleissl; Jan,9998,0,9999,1
1745794278948,MATH 2,A01,957937,Staff,34,0,35,1
1745794279974,MATH 197,001,957876,Kedlaya; Kiran S.,9993,0,9999,6
1745794280999,MCWP 40,A00,892729,Duru; Nur,13,0,20,7
1745794280999,MCWP 40,B00,893304,Montejo; Carolina,20,0,20,0
1745794282026,MCWP 40R,A00,893757,Redela; Pamela Morgan,0,6,20,20
1745794283054,MCWP 50,A00,893758,Morshed; Michael James,2,0,20,18
1745794283054,MCWP 50,B00,893761,Bartulis; Jason Michael,17,0,20,3
1745794284079,MCWP 50R,A00,893766,Compas; Sean Matthew,0,1,20,20
1745794284079,MCWP 50R,B00,893769,Carter; Jennifer A,0,0,20,20
1745794284079,MCWP 50R,C00,893771,Krone; Jarret,0,3,20,20
1745794284079,MCWP 50R,D00,893772,Miller; Elizabeth Deen,3,0,20,17
1745794284079,MCWP 50R,E00,893775,Carter; Andrea L,0,0,20,20
1745794285107,MMW 11R,A01,892721,Herbst; Matthew,11,0,27,16
1745794285107,MMW 11R,A02,892722,Herbst; Matthew,0,0,0,3
1745794286134,MMW 12R,A01,892724,Herbst; Matthew,0,9,16,16
1745794286134,MMW 12R,A02,892725,Herbst; Matthew,0,9,16,16
1745794287163,MMW 13R,A01,892727,Staff,0,4,16,16
1745794287163,MMW 13R,A02,892728,Staff,0,4,16,16
1745794287163,MMW 13R,A03,958032,Staff,0,3,16,16
1745794287163,MMW 13R,A04,958033,Staff,0,2,16,16
1745794287163,MMW 13R,A05,958034,Staff,0,3,16,16
1745794288193,SIO 295LS,A00,894015,Staff,7,0,25,18
1745794289223,SIO 295S,A00,894020,Staff,7,0,25,18
1745794290252,SIOC 290S,B01,958918,Staff,0,0,0,0
1745794291279,SIOC 291S,B01,958922,Staff,0,0,0,0
1745794292307,SOCI 117,A01,895339,Staff,4,0,5,1
1745794293334,WES 237B,A00,894149,Staff,11,0,20,9
1745794295394,AESE 279B,A00,891859,Staff,13,0,35,22
1745794296421,AIP 197,001,891854,Staff,70,0,70,0
1745794297445,ANTH 289S,A00,891856,Gagneux; Pascal,12,0,12,0
1745794298473,BENG 196,001,957946,Engler; Adam J.,9996,0,9999,3
1745794299500,CAT 124RS,A01,956906,Staff,8,0,25,17
1745794300524,CAT 125RS,A01,922013,Staff,8,0,25,17
1745794301553,CLRE 250,A00,891860,Morris; Sheldon,9995,0,9999,4
1745794303603,CLRE 251R,A00,907817,Mehta; Ravindra L.,9994,0,9999,5
1745794304630,CLRE 252,A00,891864,Cuomo; Raphael Eduardo,9993,0,9999,6
1745794305656,CLRE 253,A00,891867,Vaida; Florin,9994,0,9999,5
1745794305656,CLRE 253,B00,907819,Staff,9999,0,9999,0
1745794306683,CLRE 259,A00,891868,Patel; Hemal,9998,0,9999,1
1745794307712,CLRE 260,A00,891872,Cuomo; Raphael Eduardo,9999,0,9999,0
1745794308740,CLRE 297,001,891888,Cuomo; Raphael Eduardo,9999,0,9999,0
1745794309765,CSE 191,A00,958773,Minnes Kemp; Mor Mia,9999,0,9999,0
1745794310792,CSS 201S,A01,892054,Mignozzetti; Umberto,30,0,30,0
1745794311820,CSS 202S,A01,892056,Mignozzetti; Umberto,30,0,30,0
1745794312846,DSC 197,001,956898,Eldridge; Justin Matthew,9998,0,9999,1
1745794313876,DSC 297,001,958000,Mazumdar; Arya,9998,0,9999,1
1745794314903,EAP 100,A00,905686,Staff,9776,0,9999,223
1745794315928,ECE 45,A01,892618,Staff,0,12,50,50
1745794316957,ECE 109,A01,892620,Staff,0,43,0,0
1745794317983,ECE 111,A01,892719,Staff,0,7,50,50
1745794319012,ECE 197,001,957920,Mercier; Patrick Philip,9992,0,9999,7
1745794320041,ECON 178,A01,907814,Zhu; Ying,28,0,35,7
1745794321069,EDS 115,A00,895312,Staff,41,0,45,4
1745794322093,EDS 117,A01,895337,Staff,30,0,30,0
1745794323122,EDS 125,A00,895341,Jones; Gabrielle Anastasia,43,0,45,2
1745794324153,EDS 128A,A01,895459,Fargason; Sharon Gayle,44,0,45,1
1745794325186,EDS 128B,A01,895543,Pappas; Elizabeth,44,0,45,1
1745794326211,EDS 139,A00,897203,Pappas; Elizabeth,44,0,45,1
1745794326211,EDS 139,B00,897209,Fargason; Sharon Gayle,44,0,45,1
1745794327237,EDS 201,A00,895545,Staff,43,0,45,2
1745794328266,EDS 203,A01,895581,Halter; Christopher P.,43,0,45,2
1745794329295,EDS 204R,A01,895625,Heinzman; Erica M.,43,0,45,2
1745794329295,EDS 204R,B01,895693,Halter; Christopher P.,18,0,45,27
1745794330326,EDS 206R,A00,895694,Fargason; Sharon Gayle,9,0,30,21
1745794330326,EDS 206R,B00,895695,Choi; Bailey Miyeon,20,0,30,10
1745794331351,EDS 250,A00,895697,Hemans; Patricia Ann Benitez,43,0,45,2
1745794332392,EDS 281,A00,895701,Meyerott; Theresa Ann,15,0,15,0
1745794333417,EDS 284,A00,895736,Meyerott; Theresa Ann,15,0,15,0
1745794334442,EDS 286,A00,897210,Fine; Sarah,15,0,15,0
1745794335469,EDS 289C,A01,895770,Daly; Alan J.,15,0,15,0
1745794336497,EDS 290,A00,897211,Hofstetter; Carolyn,15,0,15,0
1745794337524,LIGM 5A,A00,896162,Fischer-Grunski; Eva K,15,0,20,5
1745794338551,LIGM 5B,A00,896260,Fischer-Grunski; Eva K,17,0,20,3
1745794339579,LIGM 5C,A00,896308,Fischer-Grunski; Eva K,18,0,20,2
1745794340608,LIIT 5AS,A00,896313,Carnelos; Chiara,18,0,20,2
1745794341638,LIIT 5BS,A00,896416,Carnelos; Chiara,20,0,20,0
1745794342662,LIIT 5CS,A00,896564,Carnelos; Chiara,20,0,20,0
1745794343688,LISP 5A,A00,896588,Munoz Sanchez; Alicia,4,0,20,16
1745794344714,LISP 5B,A00,896653,Munoz Sanchez; Alicia,10,0,20,10
1745794345737,LISP 5C,A00,896655,Munoz Sanchez; Alicia,4,0,20,16
1745794346765,MAE 197,001,957918,Kleissl; Jan,9998,0,9999,1
1745794347789,MATH 2,A01,957937,Staff,34,0,35,1
1745794348815,MATH 197,001,957876,Kedlaya; Kiran S.,9993,0,9999,6
1745794349841,MCWP 40,A00,892729,Duru; Nur,13,0,20,7
1745794349841,MCWP 40,B00,893304,Montejo; Carolina,20,0,20,0
1745794350867,MCWP 40R,A00,893757,Redela; Pamela Morgan,0,6,20,20
1745794351893,MCWP 50,A00,893758,Morshed; Michael James,2,0,20,18
1745794351893,MCWP 50,B00,893761,Bartulis; Jason Michael,17,0,20,3
1745794352920,MCWP 50R,A00,893766,Compas; Sean Matthew,0,1,20,20
1745794352920,MCWP 50R,B00,893769,Carter; Jennifer A,0,0,20,20
1745794352920,MCWP 50R,C00,893771,Krone; Jarret,0,3,20,20
1745794352920,MCWP 50R,D00,893772,Miller; Elizabeth Deen,3,0,20,17
1745794352920,MCWP 50R,E00,893775,Carter; Andrea L,0,0,20,20
1745794353947,MMW 11R,A01,892721,Herbst; Matthew,11,0,27,16
1745794353947,MMW 11R,A02,892722,Herbst; Matthew,0,0,0,3
1745794354973,MMW 12R,A01,892724,Herbst; Matthew,0,9,16,16
1745794354973,MMW 12R,A02,892725,Herbst; Matthew,0,9,16,16
1745794355999,MMW 13R,A01,892727,Staff,0,4,16,16
1745794355999,MMW 13R,A02,892728,Staff,0,4,16,16
1745794355999,MMW 13R,A03,958032,Staff,0,3,16,16
1745794355999,MMW 13R,A04,958033,Staff,0,2,16,16
1745794355999,MMW 13R,A05,958034,Staff,0,3,16,16
1745794357027,SIO 295LS,A00,894015,Staff,7,0,25,18
1745794358056,SIO 295S,A00,894020,Staff,7,0,25,18
1745794359085,SIOC 290S,B01,958918,Staff,0,0,0,0
1745794360113,SIOC 291S,B01,958922,Staff,0,0,0,0
1745794361139,SOCI 117,A01,895339,Staff,4,0,5,1
1745794362166,WES 237B,A00,894149,Staff,11,0,20,9
1745794364229,AESE 279B,A00,891859,Staff,13,0,35,22
1745794365255,AIP 197,001,891854,Staff,70,0,70,0
1745794366279,ANTH 289S,A00,891856,Gagneux; Pascal,12,0,12,0
1745794367304,BENG 196,001,957946,Engler; Adam J.,9996,0,9999,3
1745794368345,CAT 124RS,A01,956906,Staff,8,0,25,17
1745794369370,CAT 125RS,A01,922013,Staff,8,0,25,17
1745794370394,CLRE 250,A00,891860,Morris; Sheldon,9995,0,9999,4
1745794372447,CLRE 251R,A00,907817,Mehta; Ravindra L.,9994,0,9999,5
1745794373473,CLRE 252,A00,891864,Cuomo; Raphael Eduardo,9993,0,9999,6
1745794374500,CLRE 253,A00,891867,Vaida; Florin,9994,0,9999,5
1745794374500,CLRE 253,B00,907819,Staff,9999,0,9999,0
1745794375527,CLRE 259,A00,891868,Patel; Hemal,9998,0,9999,1
1745794376552,CLRE 260,A00,891872,Cuomo; Raphael Eduardo,9999,0,9999,0
1745794377576,CLRE 297,001,891888,Cuomo; Raphael Eduardo,9999,0,9999,0
1745794378600,CSE 191,A00,958773,Minnes Kemp; Mor Mia,9999,0,9999,0
1745794379625,CSS 201S,A01,892054,Mignozzetti; Umberto,30,0,30,0
1745794380651,CSS 202S,A01,892056,Mignozzetti; Umberto,30,0,30,0
1745794381699,DSC 197,001,956898,Eldridge; Justin Matthew,9998,0,9999,1
1745794382725,DSC 297,001,958000,Mazumdar; Arya,9998,0,9999,1
1745794383750,EAP 100,A00,905686,Staff,9776,0,9999,223
1745794384775,ECE 45,A01,892618,Staff,0,12,50,50
1745794385799,ECE 109,A01,892620,Staff,0,43,0,0
1745794386831,ECE 111,A01,892719,Staff,0,7,50,50
1745794387857,ECE 197,001,957920,Mercier; Patrick Philip,9992,0,9999,7
1745794388881,ECON 178,A01,907814,Zhu; Ying,28,0,35,7
1745794389907,EDS 115,A00,895312,Staff,41,0,45,4
1745794390935,EDS 117,A01,895337,Staff,30,0,30,0
1745794391959,EDS 125,A00,895341,Jones; Gabrielle Anastasia,43,0,45,2
1745794392984,EDS 128A,A01,895459,Fargason; Sharon Gayle,44,0,45,1
1745794394008,EDS 128B,A01,895543,Pappas; Elizabeth,44,0,45,1
1745794395033,EDS 139,A00,897203,Pappas; Elizabeth,44,0,45,1
1745794395033,EDS 139,B00,897209,Fargason; Sharon Gayle,44,0,45,1
1745794396058,EDS 201,A00,895545,Staff,43,0,45,2
1745794397086,EDS 203,A01,895581,Halter; Christopher P.,43,0,45,2
1745794398128,EDS 204R,A01,895625,Heinzman; Erica M.,43,0,45,2
1745794398128,EDS 204R,B01,895693,Halter; Christopher P.,18,0,45,27
1745794399154,EDS 206R,A00,895694,Fargason; Sharon Gayle,9,0,30,21
1745794399154,EDS 206R,B00,895695,Choi; Bailey Miyeon,20,0,30,10
1745794400181,EDS 250,A00,895697,Hemans; Patricia Ann Benitez,43,0,45,2
1745794401206,EDS 281,A00,895701,Meyerott; Theresa Ann,15,0,15,0
1745794402231,EDS 284,A00,895736,Meyerott; Theresa Ann,15,0,15,0
1745794403257,EDS 286,A00,897210,Fine; Sarah,15,0,15,0
1745794404284,EDS 289C,A01,895770,Daly; Alan J.,15,0,15,0
1745794405311,EDS 290,A00,897211,Hofstetter; Carolyn,15,0,15,0
1745794406338,LIGM 5A,A00,896162,Fischer-Grunski; Eva K,15,0,20,5
1745794407363,LIGM 5B,A00,896260,Fischer-Grunski; Eva K,17,0,20,3
1745794408389,LIGM 5C,A00,896308,Fischer-Grunski; Eva K,18,0,20,2
1745794409415,LIIT 5AS,A00,896313,Carnelos; Chiara,18,0,20,2
1745794410444,LIIT 5BS,A00,896416,Carnelos; Chiara,20,0,20,0
1745794411474,LIIT 5CS,A00,896564,Carnelos; Chiara,20,0,20,0
1745794412502,LISP 5A,A00,896588,Munoz Sanchez; Alicia,4,0,20,16
1745794413529,LISP 5B,A00,896653,Munoz Sanchez; Alicia,10,0,20,10
1745794414554,LISP 5C,A00,896655,Munoz Sanchez; Alicia,4,0,20,16
1745794415581,MAE 197,001,957918,Kleissl; Jan,9998,0,9999,1
1745794416608,MATH 2,A01,957937,Staff,34,0,35,1
1745794417634,MATH 197,001,957876,Kedlaya; Kiran S.,9993,0,9999,6
1745794418661,MCWP 40,A00,892729,Duru; Nur,13,0,20,7
1745794418661,MCWP 40,B00,893304,Montejo; Carolina,20,0,20,0
1745794419689,MCWP 40R,A00,893757,Redela; Pamela Morgan,0,6,20,20
1745794420718,MCWP 50,A00,893758,Morshed; Michael James,2,0,20,18
1745794420718,MCWP 50,B00,893761,Bartulis; Jason Michael,17,0,20,3
1745794421749,MCWP 50R,A00,893766,Compas; Sean Matthew,0,1,20,20
1745794421749,MCWP 50R,B00,893769,Carter; Jennifer A,0,0,20,20
1745794421749,MCWP 50R,C00,893771,Krone; Jarret,0,3,20,20
1745794421749,MCWP 50R,D00,893772,Miller; Elizabeth Deen,3,0,20,17
1745794421749,MCWP 50R,E00,893775,Carter; Andrea L,0,0,20,20
1745794422775,MMW 11R,A01,892721,Herbst; Matthew,11,0,27,16
1745794422775,MMW 11R,A02,892722,Herbst; Matthew,0,0,0,3
1745794423804,MMW 12R,A01,892724,Herbst; Matthew,0,9,16,16
1745794423804,MMW 12R,A02,892725,Herbst; Matthew,0,9,16,16
1745794424831,MMW 13R,A01,892727,Staff,0,4,16,16
1745794424831,MMW 13R,A02,892728,Staff,0,4,16,16
1745794424831,MMW 13R,A03,958032,Staff,0,3,16,16
1745794424831,MMW 13R,A04,958033,Staff,0,2,16,16
1745794424831,MMW 13R,A05,958034,Staff,0,3,16,16
1745794425857,SIO 295LS,A00,894015,Staff,7,0,25,18
1745794426883,SIO 295S,A00,894020,Staff,7,0,25,18
1745794427910,SIOC 290S,B01,958918,Staff,0,0,0,0
1745794428935,SIOC 291S,B01,958922,Staff,0,0,0,0
1745794429964,SOCI 117,A01,895339,Staff,4,0,5,1
1745794430993,WES 237B,A00,894149,Staff,11,0,20,9
1745794433055,AESE 279B,A00,891859,Staff,13,0,35,22
1745794434082,AIP 197,001,891854,Staff,70,0,70,0
1745794435110,ANTH 289S,A00,891856,Gagneux; Pascal,12,0,12,0
1745794436161,BENG 196,001,957946,Engler; Adam J.,9996,0,9999,3
1745794437191,CAT 124RS,A01,956906,Staff,8,0,25,17
1745794438219,CAT 125RS,A01,922013,Staff,8,0,25,17
1745794439246,CLRE 250,A00,891860,Morris; Sheldon,9995,0,9999,4
1745794441300,CLRE 251R,A00,907817,Mehta; Ravindra L.,9994,0,9999,5
1745794442329,CLRE 252,A00,891864,Cuomo; Raphael Eduardo,9993,0,9999,6
1745794443354,CLRE 253,A00,891867,Vaida; Florin,9994,0,9999,5
1745794443354,CLRE 253,B00,907819,Staff,9999,0,9999,0
1745794444382,CLRE 259,A00,891868,Patel; Hemal,9998,0,9999,1
1745794445408,CLRE 260,A00,891872,Cuomo; Raphael Eduardo,9999,0,9999,0
1745794446433,CLRE 297,001,891888,Cuomo; Raphael Eduardo,9999,0,9999,0
1745794447456,CSE 191,A00,958773,Minnes Kemp; Mor Mia,9999,0,9999,0
1745794448486,CSS 201S,A01,892054,Mignozzetti; Umberto,30,0,30,0
1745794449515,CSS 202S,A01,892056,Mignozzetti; Umberto,30,0,30,0
1745794450538,DSC 197,001,956898,Eldridge; Justin Matthew,9998,0,9999,1
1745794451564,DSC 297,001,958000,Mazumdar; Arya,9998,0,9999,1
1745794452590,EAP 100,A00,905686,Staff,9776,0,9999,223
1745794453614,ECE 45,A01,892618,Staff,0,12,50,50
1745794454639,ECE 109,A01,892620,Staff,0,43,0,0
1745794455669,ECE 111,A01,892719,Staff,0,7,50,50
1745794456694,ECE 197,001,957920,Mercier; Patrick Philip,9992,0,9999,7
1745794457720,ECON 178,A01,907814,Zhu; Ying,28,0,35,7
1745794458745,EDS 115,A00,895312,Staff,41,0,45,4
1745794459772,EDS 117,A01,895337,Staff,30,0,30,0
1745794460798,EDS 125,A00,895341,Jones; Gabrielle Anastasia,43,0,45,2
1745794461822,EDS 128A,A01,895459,Fargason; Sharon Gayle,44,0,45,1
1745794462847,EDS 128B,A01,895543,Pappas; Elizabeth,44,0,45,1
1745794463875,EDS 139,A00,897203,Pappas; Elizabeth,44,0,45,1
1745794463875,EDS 139,B00,897209,Fargason; Sharon Gayle,44,0,45,1
1745794464903,EDS 201,A00,895545,Staff,43,0,45,2
1745794465930,EDS 203,A01,895581,Halter; Christopher P.,43,0,45,2
1745794466958,EDS 204R,A01,895625,Heinzman; Erica M.,43,0,45,2
1745794466958,EDS 204R,B01,895693,Halter; Christopher P.,18,0,45,27
1745794467983,EDS 206R,A00,895694,Fargason; Sharon Gayle,9,0,30,21
1745794467983,EDS 206R,B00,895695,Choi; Bailey Miyeon,20,0,30,10
1745794469010,EDS 250,A00,895697,Hemans; Patricia Ann Benitez,43,0,45,2
1745794470037,EDS 281,A00,895701,Meyerott; Theresa Ann,15,0,15,0
1745794471064,EDS 284,A00,895736,Meyerott; Theresa Ann,15,0,15,0
1745794472092,EDS 286,A00,897210,Fine; Sarah,15,0,15,0
1745794473121,EDS 289C,A01,895770,Daly; Alan J.,15,0,15,0
1745794474146,EDS 290,A00,897211,Hofstetter; Carolyn,15,0,15,0
1745794475172,LIGM 5A,A00,896162,Fischer-Grunski; Eva K,15,0,20,5
1745794476199,LIGM 5B,A00,896260,Fischer-Grunski; Eva K,17,0,20,3
1745794477224,LIGM 5C,A00,896308,Fischer-Grunski; Eva K,18,0,20,2
1745794478256,LIIT 5AS,A00,896313,Carnelos; Chiara,18,0,20,2
1745794479284,LIIT 5BS,A00,896416,Carnelos; Chiara,20,0,20,0
1745794480309,LIIT 5CS,A00,896564,Carnelos; Chiara,20,0,20,0
1745794481335,LISP 5A,A00,896588,Munoz Sanchez; Alicia,4,0,20,16
1745794482381,LISP 5B,A00,896653,Munoz Sanchez; Alicia,10,0,20,10
1745794483411,LISP 5C,A00,896655,Munoz Sanchez; Alicia,4,0,20,16
1745794484436,MAE 197,001,957918,Kleissl; Jan,9998,0,9999,1
1745794485463,MATH 2,A01,957937,Staff,34,0,35,1
1745794486488,MATH 197,001,957876,Kedlaya; Kiran S.,9993,0,9999,6
1745794487514,MCWP 40,A00,892729,Duru; Nur,13,0,20,7
1745794487514,MCWP 40,B00,893304,Montejo; Carolina,20,0,20,0
1745794488539,MCWP 40R,A00,893757,Redela; Pamela Morgan,0,6,20,20
1745794489563,MCWP 50,A00,893758,Morshed; Michael James,2,0,20,18
1745794489563,MCWP 50,B00,893761,Bartulis; Jason Michael,17,0,20,3
1745794490590,MCWP 50R,A00,893766,Compas; Sean Matthew,0,1,20,20
1745794490590,MCWP 50R,B00,893769,Carter; Jennifer A,0,0,20,20
1745794490590,MCWP 50R,C00,893771,Krone; Jarret,0,3,20,20
1745794490590,MCWP 50R,D00,893772,Miller; Elizabeth Deen,3,0,20,17
1745794490590,MCWP 50R,E00,893775,Carter; Andrea L,0,0,20,20
1745794491615,MMW 11R,A01,892721,Herbst; Matthew,11,0,27,16
1745794491615,MMW 11R,A02,892722,Herbst; Matthew,0,0,0,3
1745794492640,MMW 12R,A01,892724,Herbst; Matthew,0,9,16,16
1745794492640,MMW 12R,A02,892725,Herbst; Matthew,0,9,16,16
1745794493666,MMW 13R,A01,892727,Staff,0,4,16,16
1745794493666,MMW 13R,A02,892728,Staff,0,4,16,16
1745794493666,MMW 13R,A03,958032,Staff,0,3,16,16
1745794493666,MMW 13R,A04,958033,Staff,0,2,16,16
1745794493666,MMW 13R,A05,958034,Staff,0,3,16,16
1745794494696,SIO 295LS,A00,894015,Staff,7,0,25,18
1745794495722,SIO 295S,A00,894020,Staff,7,0,25,18
1745794496751,SIOC 290S,B01,958918,Staff,0,0,0,0
1745794497781,SIOC 291S,B01,958922,Staff,0,0,0,0
1745794498806,SOCI 117,A01,895339,Staff,4,0,5,1
1745794499833,WES 237B,A00,894149,Staff,11,0,20,9
1745794501902,AESE 279B,A00,891859,Staff,13,0,35,22
1745794502927,AIP 197,001,891854,Staff,70,0,70,0
1745794503953,ANTH 289S,A00,891856,Gagneux; Pascal,12,0,12,0
1745794504981,BENG 196,001,957946,Engler; Adam J.,9996,0,9999,3
1745794506008,CAT 124RS,A01,956906,Staff,8,0,25,17
1745794507034,CAT 125RS,A01,922013,Staff,8,0,25,17
1745794508059,CLRE 250,A00,891860,Morris; Sheldon,9995,0,9999,4
1745794510130,CLRE 251R,A00,907817,Mehta; Ravindra L.,9994,0,9999,5
1745794511158,CLRE 252,A00,891864,Cuomo; Raphael Eduardo,9993,0,9999,6
1745794512184,CLRE 253,A00,891867,Vaida; Florin,9994,0,9999,5
1745794512184,CLRE 253,B00,907819,Staff,9999,0,9999,0
1745794513211,CLRE 259,A00,891868,Patel; Hemal,9998,0,9999,1
1745794514236,CLRE 260,A00,891872,Cuomo; Raphael Eduardo,9999,0,9999,0
1745794515261,CLRE 297,001,891888,Cuomo; Raphael Eduardo,9999,0,9999,0
1745794516286,CSE 191,A00,958773,Minnes Kemp; Mor Mia,9999,0,9999,0
1745794517330,CSS 201S,A01,892054,Mignozzetti; Umberto,30,0,30,0
1745794518361,CSS 202S,A01,892056,Mignozzetti; Umberto,30,0,30,0
1745794519389,DSC 197,001,956898,Eldridge; Justin Matthew,9998,0,9999,1
1745794520414,DSC 297,001,958000,Mazumdar; Arya,9998,0,9999,1
1745794521441,EAP 100,A00,905686,Staff,9776,0,9999,223
1745794522467,ECE 45,A01,892618,Staff,0,12,50,50
1745794523495,ECE 109,A01,892620,Staff,0,43,0,0
1745794524521,ECE 111,A01,892719,Staff,0,7,50,50
1745794525549,ECE 197,001,957920,Mercier; Patrick Philip,9992,0,9999,7
1745794526578,ECON 178,A01,907814,Zhu; Ying,28,0,35,7
1745794527605,EDS 115,A00,895312,Staff,41,0,45,4
1745794528628,EDS 117,A01,895337,Staff,30,0,30,0
1745794529658,EDS 125,A00,895341,Jones; Gabrielle Anastasia,43,0,45,2
1745794530687,EDS 128A,A01,895459,Fargason; Sharon Gayle,44,0,45,1
1745794531714,EDS 128B,A01,895543,Pappas; Elizabeth,44,0,45,1
1745794532740,EDS 139,A00,897203,Pappas; Elizabeth,44,0,45,1
1745794532740,EDS 139,B00,897209,Fargason; Sharon Gayle,44,0,45,1
1745794533766,EDS 201,A00,895545,Staff,43,0,45,2
1745794534791,EDS 203,A01,895581,Halter; Christopher P.,43,0,45,2
1745794535817,EDS 204R,A01,895625,Heinzman; Erica M.,43,0,45,2
1745794535817,EDS 204R,B01,895693,Halter; Christopher P.,18,0,45,27
1745794536846,EDS 206R,A00,895694,Fargason; Sharon Gayle,9,0,30,21
1745794536846,EDS 206R,B00,895695,Choi; Bailey Miyeon,20,0,30,10
1745794537872,EDS 250,A00,895697,Hemans; Patricia Ann Benitez,43,0,45,2
1745794538897,EDS 281,A00,895701,Meyerott; Theresa Ann,15,0,15,0
1745794539923,EDS 284,A00,895736,Meyerott; Theresa Ann,15,0,15,0
1745794540950,EDS 286,A00,897210,Fine; Sarah,15,0,15,0
1745794541977,EDS 289C,A01,895770,Daly; Alan J.,15,0,15,0
1745794543004,EDS 290,A00,897211,Hofstetter; Carolyn,15,0,15,0
1745794544032,LIGM 5A,A00,896162,Fischer-Grunski; Eva K,15,0,20,5
1745794545058,LIGM 5B,A00,896260,Fischer-Grunski; Eva K,17,0,20,3
1745794546087,LIGM 5C,A00,896308,Fischer-Grunski; Eva K,18,0,20,2
1745794547112,LIIT 5AS,A00,896313,Carnelos; Chiara,18,0,20,2
1745794548137,LIIT 5BS,A00,896416,Carnelos; Chiara,20,0,20,0
1745794549166,LIIT 5CS,A00,896564,Carnelos; Chiara,20,0,20,0
1745794550192,LISP 5A,A00,896588,Munoz Sanchez; Alicia,4,0,20,16
1745794551217,LISP 5B,A00,896653,Munoz Sanchez; Alicia,10,0,20,10
1745794552245,LISP 5C,A00,896655,Munoz Sanchez; Alicia,4,0,20,16
1745794553272,MAE 197,001,957918,Kleissl; Jan,9998,0,9999,1
1745794554299,MATH 2,A01,957937,Staff,34,0,35,1
1745794555324,MATH 197,001,957876,Kedlaya; Kiran S.,9993,0,9999,6
1745794556350,MCWP 40,A00,892729,Duru; Nur,13,0,20,7
1745794556350,MCWP 40,B00,893304,Montejo; Carolina,20,0,20,0
1745794557376,MCWP 40R,A00,893757,Redela; Pamela Morgan,0,6,20,20
1745794558403,MCWP 50,A00,893758,Morshed; Michael James,2,0,20,18
1745794558403,MCWP 50,B00,893761,Bartulis; Jason Michael,17,0,20,3
1745794559429,MCWP 50R,A00,893766,Compas; Sean Matthew,0,1,20,20
1745794559429,MCWP 50R,B00,893769,Carter; Jennifer A,0,0,20,20
1745794559429,MCWP 50R,C00,893771,Krone; Jarret,0,3,20,20
1745794559429,MCWP 50R,D00,893772,Miller; Elizabeth Deen,3,0,20,17
1745794559429,MCWP 50R,E00,893775,Carter; Andrea L,0,0,20,20
1745794560453,MMW 11R,A01,892721,Herbst; Matthew,11,0,27,16
1745794560453,MMW 11R,A02,892722,Herbst; Matthew,0,0,0,3
1745794561480,MMW 12R,A01,892724,Herbst; Matthew,0,9,16,16
1745794561480,MMW 12R,A02,892725,Herbst; Matthew,0,9,16,16
1745794562507,MMW 13R,A01,892727,Staff,0,4,16,16
1745794562507,MMW 13R,A02,892728,Staff,0,4,16,16
1745794562507,MMW 13R,A03,958032,Staff,0,3,16,16
1745794562507,MMW 13R,A04,958033,Staff,0,2,16,16
1745794562507,MMW 13R,A05,958034,Staff,0,3,16,16
1745794563533,SIO 295LS,A00,894015,Staff,7,0,25,18
1745794564558,SIO 295S,A00,894020,Staff,7,0,25,18
1745794565586,SIOC 290S,B01,958918,Staff,0,0,0,0
1745794566618,SIOC 291S,B01,958922,Staff,0,0,0,0
1745794567644,SOCI 117,A01,895339,Staff,4,0,5,1
1745794568670,WES 237B,A00,894149,Staff,11,0,20,9
1745794570729,AESE 279B,A00,891859,Staff,13,0,35,22
1745794571756,AIP 197,001,891854,Staff,70,0,70,0
1745794572780,ANTH 289S,A00,891856,Gagneux; Pascal,12,0,12,0
1745794573806,BENG 196,001,957946,Engler; Adam J.,9996,0,9999,3
1745794574835,CAT 124RS,A01,956906,Staff,8,0,25,17
1745794575865,CAT 125RS,A01,922013,Staff,8,0,25,17
1745794576891,CLRE 250,A00,891860,Morris; Sheldon,9995,0,9999,4
1745794578947,CLRE 251R,A00,907817,Mehta; Ravindra L.,9994,0,9999,5
1745794579974,CLRE 252,A00,891864,Cuomo; Raphael Eduardo,9993,0,9999,6
1745794581003,CLRE 253,A00,891867,Vaida; Florin,9994,0,9999,5
1745794581003,CLRE 253,B00,907819,Staff,9999,0,9999,0
1745794582051,CLRE 259,A00,891868,Patel; Hemal,9998,0,9999,1
1745794583082,CLRE 260,A00,891872,Cuomo; Raphael Eduardo,9999,0,9999,0
1745794584110,CLRE 297,001,891888,Cuomo; Raphael Eduardo,9999,0,9999,0
1745794585139,CSE 191,A00,958773,Minnes Kemp; Mor Mia,9999,0,9999,0
1745794586164,CSS 201S,A01,892054,Mignozzetti; Umberto,30,0,30,0
1745794587190,CSS 202S,A01,892056,Mignozzetti; Umberto,30,0,30,0
1745794588218,DSC 197,001,956898,Eldridge; Justin Matthew,9998,0,9999,1
1745794589243,DSC 297,001,958000,Mazumdar; Arya,9998,0,9999,1
1745794590268,EAP 100,A00,905686,Staff,9776,0,9999,223
1745794591297,ECE 45,A01,892618,Staff,0,12,50,50
1745794592327,ECE 109,A01,892620,Staff,0,43,0,0
1745794593355,ECE 111,A01,892719,Staff,0,7,50,50
1745794594392,ECE 197,001,957920,Mercier; Patrick Philip,9992,0,9999,7
1745794595419,ECON 178,A01,907814,Zhu; Ying,28,0,35,7
1745794596445,EDS 115,A00,895312,Staff,41,0,45,4
1745794597470,EDS 117,A01,895337,Staff,30,0,30,0
1745794598497,EDS 125,A00,895341,Jones; Gabrielle Anastasia,43,0,45,2
1745794599525,EDS 128A,A01,895459,Fargason; Sharon Gayle,44,0,45,1
1745794600548,EDS 128B,A01,895543,Pappas; Elizabeth,44,0,45,1
1745794601577,EDS 139,A00,897203,Pappas; Elizabeth,44,0,45,1
1745794601577,EDS 139,B00,897209,Fargason; Sharon Gayle,44,0,45,1
1745794602602,EDS 201,A00,895545,Staff,43,0,45,2
1745794603626,EDS 203,A01,895581,Halter; Christopher P.,43,0,45,2
1745794604650,EDS 204R,A01,895625,Heinzman; Erica M.,43,0,45,2
1745794604650,EDS 204R,B01,895693,Halter; Christopher P.,18,0,45,27
1745794605678,EDS 206R,A00,895694,Fargason; Sharon Gayle,9,0,30,21
1745794605678,EDS 206R,B00,895695,Choi; Bailey Miyeon,20,0,30,10
1745794606704,EDS 250,A00,895697,Hemans; Patricia Ann Benitez,43,0,45,2
1745794607731,EDS 281,A00,895701,Meyerott; Theresa Ann,15,0,15,0
1745794608755,EDS 284,A00,895736,Meyerott; Theresa Ann,15,0,15,0
1745794609779,EDS 286,A00,897210,Fine; Sarah,15,0,15,0
1745794610808,EDS 289C,A01,895770,Daly; Alan J.,15,0,15,0
1745794611833,EDS 290,A00,897211,Hofstetter; Carolyn,15,0,15,0
1745794612861,LIGM 5A,A00,896162,Fischer-Grunski; Eva K,15,0,20,5
1745794613891,LIGM 5B,A00,896260,Fischer-Grunski; Eva K,17,0,20,3
1745794614918,LIGM 5C,A00,896308,Fischer-Grunski; Eva K,18,0,20,2
1745794615948,LIIT 5AS,A00,896313,Carnelos; Chiara,18,0,20,2
1745794616977,LIIT 5BS,A00,896416,Carnelos; Chiara,20,0,20,0
1745794618005,LIIT 5CS,A00,896564,Carnelos; Chiara,20,0,20,0
1745794619032,LISP 5A,A00,896588,Munoz Sanchez; Alicia,4,0,20,16
1745794620058,LISP 5B,A00,896653,Munoz Sanchez; Alicia,10,0,20,10
1745794621083,LISP 5C,A00,896655,Munoz Sanchez; Alicia,4,0,20,16
1745794622113,MAE 197,001,957918,Kleissl; Jan,9998,0,9999,1
1745794623139,MATH 2,A01,957937,Staff,34,0,35,1
1745794624169,MATH 197,001,957876,Kedlaya; Kiran S.,9993,0,9999,6
1745794625196,MCWP 40,A00,892729,Duru; Nur,13,0,20,7
1745794625196,MCWP 40,B00,893304,Montejo; Carolina,20,0,20,0
1745794626223,MCWP 40R,A00,893757,Redela; Pamela Morgan,0,6,20,20
1745794627251,MCWP 50,A00,893758,Morshed; Michael James,2,0,20,18
1745794627251,MCWP 50,B00,893761,Bartulis; Jason Michael,17,0,20,3
1745794628281,MCWP 50R,A00,893766,Compas; Sean Matthew,0,1,20,20
1745794628281,MCWP 50R,B00,893769,Carter; Jennifer A,0,0,20,20
1745794628281,MCWP 50R,C00,893771,Krone; Jarret,0,3,20,20
1745794628281,MCWP 50R,D00,893772,Miller; Elizabeth Deen,3,0,20,17
1745794628281,MCWP 50R,E00,893775,Carter; Andrea L,0,0,20,20
1745794629310,MMW 11R,A01,892721,Herbst; Matthew,11,0,27,16
1745794629310,MMW 11R,A02,892722,Herbst; Matthew,0,0,0,3
1745794630336,MMW 12R,A01,892724,Herbst; Matthew,0,9,16,16
1745794630336,MMW 12R,A02,892725,Herbst; Matthew,0,9,16,16
1745794631363,MMW 13R,A01,892727,Staff,0,4,16,16
1745794631363,MMW 13R,A02,892728,Staff,0,4,16,16
1745794631363,MMW 13R,A03,958032,Staff,0,3,16,16
1745794631363,MMW 13R,A04,958033,Staff,0,2,16,16
1745794631363,MMW 13R,A05,958034,Staff,0,3,16,16
1745794632400,SIO 295LS,A00,894015,Staff,7,0,25,18
1745794633428,SIO 295S,A00,894020,Staff,7,0,25,18
1745794634456,SIOC 290S,B01,958918,Staff,0,0,0,0
1745794635483,SIOC 291S,B01,958922,Staff,0,0,0,0
1745794636510,SOCI 117,A01,895339,Staff,4,0,5,1
1745794637536,WES 237B,A00,894149,Staff,11,0,20,9
1745794639599,AESE 279B,A00,891859,Staff,13,0,35,22
1745794640627,AIP 197,001,891854,Staff,70,0,70,0
1745794641653,ANTH 289S,A00,891856,Gagneux; Pascal,12,0,12,0
1745794642678,BENG 196,001,957946,Engler; Adam J.,9996,0,9999,3
1745794643704,CAT 124RS,A01,956906,Staff,8,0,25,17
1745794644730,CAT 125RS,A01,922013,Staff,8,0,25,17
1745794645759,CLRE 250,A00,891860,Morris; Sheldon,9995,0,9999,4
1745794647813,CLRE 251R,A00,907817,Mehta; Ravindra L.,9994,0,9999,5
1745794648841,CLRE 252,A00,891864,Cuomo; Raphael Eduardo,9993,0,9999,6
1745794649867,CLRE 253,A00,891867,Vaida; Florin,9994,0,9999,5
1745794649867,CLRE 253,B00,907819,Staff,9999,0,9999,0
1745794650893,CLRE 259,A00,891868,Patel; Hemal,9998,0,9999,1
1745794651925,CLRE 260,A00,891872,Cuomo; Raphael Eduardo,9999,0,9999,0
1745794652949,CLRE 297,001,891888,Cuomo; Raphael Eduardo,9999,0,9999,0
1745794653978,CSE 191,A00,958773,Minnes Kemp; Mor Mia,9999,0,9999,0
1745794655004,CSS 201S,A01,892054,Mignozzetti; Umberto,30,0,30,0
1745794656029,CSS 202S,A01,892056,Mignozzetti; Umberto,30,0,30,0
1745794657055,DSC 197,001,956898,Eldridge; Justin Matthew,9998,0,9999,1
1745794658082,DSC 297,001,958000,Mazumdar; Arya,9998,0,9999,1
1745794659111,EAP 100,A00,905686,Staff,9776,0,9999,223
1745794660136,ECE 45,A01,892618,Staff,0,12,50,50
1745794661163,ECE 109,A01,892620,Staff,0,43,0,0
1745794662192,ECE 111,A01,892719,Staff,0,7,50,50
1745794663218,ECE 197,001,957920,Mercier; Patrick Philip,9992,0,9999,7
1745794664244,ECON 178,A01,907814,Zhu; Ying,28,0,35,7
1745794665272,EDS 115,A00,895312,Staff,41,0,45,4
1745794666298,EDS 117,A01,895337,Staff,30,0,30,0
1745794667325,EDS 125,A00,895341,Jones; Gabrielle Anastasia,43,0,45,2
1745794668351,EDS 128A,A01,895459,Fargason; Sharon Gayle,44,0,45,1
1745794669381,EDS 128B,A01,895543,Pappas; Elizabeth,44,0,45,1
1745794670408,EDS 139,A00,897203,Pappas; Elizabeth,44,0,45,1
1745794670408,EDS 139,B00,897209,Fargason; Sharon Gayle,44,0,45,1
1745794671437,EDS 201,A00,895545,Staff,43,0,45,2
1745794672468,EDS 203,A01,895581,Halter; Christopher P.,43,0,45,2
1745794673494,EDS 204R,A01,895625,Heinzman; Erica M.,43,0,45,2
1745794673494,EDS 204R,B01,895693,Halter; Christopher P.,18,0,45,27
1745794674521,EDS 206R,A00,895694,Fargason; Sharon Gayle,9,0,30,21
1745794674521,EDS 206R,B00,895695,Choi; Bailey Miyeon,20,0,30,10
1745794675550,EDS 250,A00,895697,Hemans; Patricia Ann Benitez,43,0,45,2
1745794676577,EDS 281,A00,895701,Meyerott; Theresa Ann,15,0,15,0
1745794677607,EDS 284,A00,895736,Meyerott; Theresa Ann,15,0,15,0
1745794678631,EDS 286,A00,897210,Fine; Sarah,15,0,15,0
1745794679656,EDS 289C,A01,895770,Daly; Alan J.,15,0,15,0
1745794680683,EDS 290,A00,897211,Hofstetter; Carolyn,15,0,15,0
1745794681708,LIGM 5A,A00,896162,Fischer-Grunski; Eva K,15,0,20,5
1745794682735,LIGM 5B,A00,896260,Fischer-Grunski; Eva K,17,0,20,3
1745794683762,LIGM 5C,A00,896308,Fischer-Grunski; Eva K,18,0,20,2
1745794684788,LIIT 5AS,A00,896313,Carnelos; Chiara,18,0,20,2
1745794685815,LIIT 5BS,A00,896416,Carnelos; Chiara,20,0,20,0
1745794686842,LIIT 5CS,A00,896564,Carnelos; Chiara,20,0,20,0
1745794687869,LISP 5A,A00,896588,Munoz Sanchez; Alicia,4,0,20,16
1745794688894,LISP 5B,A00,896653,Munoz Sanchez; Alicia,10,0,20,10
1745794689924,LISP 5C,A00,896655,Munoz Sanchez; Alicia,4,0,20,16
1745794690954,MAE 197,001,957918,Kleissl; Jan,9998,0,9999,1
1745794691980,MATH 2,A01,957937,Staff,34,0,35,1
1745794693004,MATH 197,001,957876,Kedlaya; Kiran S.,9993,0,9999,6
1745794694033,MCWP 40,A00,892729,Duru; Nur,13,0,20,7
1745794694033,MCWP 40,B00,893304,Montejo; Carolina,20,0,20,0
1745794695059,MCWP 40R,A00,893757,Redela; Pamela Morgan,0,6,20,20
1745794696088,MCWP 50,A00,893758,Morshed; Michael James,2,0,20,18
1745794696088,MCWP 50,B00,893761,Bartulis; Jason Michael,17,0,20,3
1745794697116,MCWP 50R,A00,893766,Compas; Sean Matthew,0,1,20,20
1745794697116,MCWP 50R,B00,893769,Carter; Jennifer A,0,0,20,20
1745794697116,MCWP 50R,C00,893771,Krone; Jarret,0,3,20,20
1745794697116,MCWP 50R,D00,893772,Miller; Elizabeth Deen,3,0,20,17
1745794697116,MCWP 50R,E00,893775,Carter; Andrea L,0,0,20,20
1745794698141,MMW 11R,A01,892721,Herbst; Matthew,11,0,27,16
1745794698141,MMW 11R,A02,892722,Herbst; Matthew,0,0,0,3
1745794699167,MMW 12R,A01,892724,Herbst; Matthew,0,9,16,16
1745794699167,MMW 12R,A02,892725,Herbst; Matthew,0,9,16,16
1745794700193,MMW 13R,A01,892727,Staff,0,4,16,16
1745794700193,MMW 13R,A02,892728,Staff,0,4,16,16
1745794700193,MMW 13R,A03,958032,Staff,0,3,16,16
1745794700193,MMW 13R,A04,958033,Staff,0,2,16,16
1745794700193,MMW 13R,A05,958034,Staff,0,3,16,16
1745794701219,SIO 295LS,A00,894015,Staff,7,0,25,18
1745794702245,SIO 295S,A00,894020,Staff,7,0,25,18
1745794703273,SIOC 290S,B01,958918,Staff,0,0,0,0
1745794704302,SIOC 291S,B01,958922,Staff,0,0,0,0
1745794705331,SOCI 117,A01,895339,Staff,4,0,5,1
1745794706361,WES 237B,A00,894149,Staff,11,0,20,9
1745794708434,AESE 279B,A00,891859,Staff,13,0,35,22
1745794709458,AIP 197,001,891854,Staff,70,0,70,0
1745794710483,ANTH 289S,A00,891856,Gagneux; Pascal,12,0,12,0
1745794711513,BENG 196,001,957946,Engler; Adam J.,9996,0,9999,3
1745794712540,CAT 124RS,A01,956906,Staff,8,0,25,17
1745794713567,CAT 125RS,A01,922013,Staff,8,0,25,17
1745794714592,CLRE 250,A00,891860,Morris; Sheldon,9995,0,9999,4
1745794716651,CLRE 251R,A00,907817,Mehta; Ravindra L.,9994,0,9999,5
1745794717675,CLRE 252,A00,891864,Cuomo; Raphael Eduardo,9993,0,9999,6
1745794718705,CLRE 253,A00,891867,Vaida; Florin,9994,0,9999,5
1745794718705,CLRE 253,B00,907819,Staff,9999,0,9999,0
1745794719731,CLRE 259,A00,891868,Patel; Hemal,9998,0,9999,1
1745794720758,CLRE 260,A00,891872,Cuomo; Raphael Eduardo,9999,0,9999,0
1745794721786,CLRE 297,001,891888,Cuomo; Raphael Eduardo,9999,0,9999,0
1745794722812,CSE 191,A00,958773,Minnes Kemp; Mor Mia,9999,0,9999,0
1745794723840,CSS 201S,A01,892054,Mignozzetti; Umberto,30,0,30,0
1745794724870,CSS 202S,A01,892056,Mignozzetti; Umberto,30,0,30,0
1745794725895,DSC 197,001,956898,Eldridge; Justin Matthew,9998,0,9999,1
1745794726923,DSC 297,001,958000,Mazumdar; Arya,9998,0,9999,1
1745794727950,EAP 100,A00,905686,Staff,9776,0,9999,223
1745794728978,ECE 45,A01,892618,Staff,0,12,50,50
1745794730006,ECE 109,A01,892620,Staff,0,43,0,0
1745794731035,ECE 111,A01,892719,Staff,0,7,50,50
1745794732063,ECE 197,001,957920,Mercier; Patrick Philip,9992,0,9999,7
1745794733090,ECON 178,A01,907814,Zhu; Ying,28,0,35,7
1745794734118,EDS 115,A00,895312,Staff,41,0,45,4
1745794735149,EDS 117,A01,895337,Staff,30,0,30,0
1745794736175,EDS 125,A00,895341,Jones; Gabrielle Anastasia,43,0,45,2
1745794737202,EDS 128A,A01,895459,Fargason; Sharon Gayle,44,0,45,1
1745794738228,EDS 128B,A01,895543,Pappas; Elizabeth,44,0,45,1
1745794739254,EDS 139,A00,897203,Pappas; Elizabeth,44,0,45,1
1745794739254,EDS 139,B00,897209,Fargason; Sharon Gayle,44,0,45,1
1745794740284,EDS 201,A00,895545,Staff,43,0,45,2
1745794741315,EDS 203,A01,895581,Halter; Christopher P.,43,0,45,2
1745794742343,EDS 204R,A01,895625,Heinzman; Erica M.,43,0,45,2
1745794742343,EDS 204R,B01,895693,Halter; Christopher P.,18,0,45,27
1745794743369,EDS 206R,A00,895694,Fargason; Sharon Gayle,9,0,30,21
1745794743369,EDS 206R,B00,895695,Choi; Bailey Miyeon,20,0,30,10
1745794744397,EDS 250,A00,895697,Hemans; Patricia Ann Benitez,43,0,45,2
1745794745425,EDS 281,A00,895701,Meyerott; Theresa Ann,15,0,15,0
1745794746453,EDS 284,A00,895736,Meyerott; Theresa Ann,15,0,15,0
1745794747480,EDS 286,A00,897210,Fine; Sarah,15,0,15,0
1745794748508,EDS 289C,A01,895770,Daly; Alan J.,15,0,15,0
1745794749533,EDS 290,A00,897211,Hofstetter; Carolyn,15,0,15,0
1745794750560,LIGM 5A,A00,896162,Fischer-Grunski; Eva K,15,0,20,5
1745794751588,LIGM 5B,A00,896260,Fischer-Grunski; Eva K,17,0,20,3
1745794752615,LIGM 5C,A00,896308,Fischer-Grunski; Eva K,18,0,20,2
1745794753643,LIIT 5AS,A00,896313,Carnelos; Chiara,18,0,20,2
1745794754674,LIIT 5BS,A00,896416,Carnelos; Chiara,20,0,20,0
1745794755702,LIIT 5CS,A00,896564,Carnelos; Chiara,20,0,20,0
1745794756728,LISP 5A,A00,896588,Munoz Sanchez; Alicia,4,0,20,16
1745794757756,LISP 5B,A00,896653,Munoz Sanchez; Alicia,10,0,20,10
1745794758787,LISP 5C,A00,896655,Munoz Sanchez; Alicia,4,0,20,16
1745794759813,MAE 197,001,957918,Kleissl; Jan,9998,0,9999,1
1745794760839,MATH 2,A01,957937,Staff,34,0,35,1
1745794761866,MATH 197,001,957876,Kedlaya; Kiran S.,9993,0,9999,6
1745794762895,MCWP 40,A00,892729,Duru; Nur,13,0,20,7
1745794762895,MCWP 40,B00,893304,Montejo; Carolina,20,0,20,0
1745794764517,MCWP 40R,A00,893757,Redela; Pamela Morgan,0,6,20,20
1745794765544,MCWP 50,A00,893758,Morshed; Michael James,2,0,20,18
1745794765544,MCWP 50,B00,893761,Bartulis; Jason Michael,17,0,20,3
1745794766572,MCWP 50R,A00,893766,Compas; Sean Matthew,0,1,20,20
1745794766572,MCWP 50R,B00,893769,Carter; Jennifer A,0,0,20,20
1745794766572,MCWP 50R,C00,893771,Krone; Jarret,0,3,20,20
1745794766572,MCWP 50R,D00,893772,Miller; Elizabeth Deen,3,0,20,17
1745794766572,MCWP 50R,E00,893775,Carter; Andrea L,0,0,20,20
1745794767601,MMW 11R,A01,892721,Herbst; Matthew,11,0,27,16
1745794767601,MMW 11R,A02,892722,Herbst; Matthew,0,0,0,3
1745794768629,MMW 12R,A01,892724,Herbst; Matthew,0,9,16,16
1745794768629,MMW 12R,A02,892725,Herbst; Matthew,0,9,16,16
1745794769654,MMW 13R,A01,892727,Staff,0,4,16,16
1745794769654,MMW 13R,A02,892728,Staff,0,4,16,16
1745794769654,MMW 13R,A03,958032,Staff,0,3,16,16
1745794769654,MMW 13R,A04,958033,Staff,0,2,16,16
1745794769654,MMW 13R,A05,958034,Staff,0,3,16,16
1745794770679,SIO 295LS,A00,894015,Staff,7,0,25,18
1745794771705,SIO 295S,A00,894020,Staff,7,0,25,18
1745794772735,SIOC 290S,B01,958918,Staff,0,0,0,0
1745794773762,SIOC 291S,B01,958922,Staff,0,0,0,0
1745794774789,SOCI 117,A01,895339,Staff,4,0,5,1
1745794775818,WES 237B,A00,894149,Staff,11,0,20,9
1745794777875,AESE 279B,A00,891859,Staff,13,0,35,22
1745794778903,AIP 197,001,891854,Staff,70,0,70,0
1745794779929,ANTH 289S,A00,891856,Gagneux; Pascal,12,0,12,0
1745794780955,BENG 196,001,957946,Engler; Adam J.,9996,0,9999,3
1745794781982,CAT 124RS,A01,956906,Staff,8,0,25,17
1745794783007,CAT 125RS,A01,922013,Staff,8,0,25,17
1745794784032,CLRE 250,A00,891860,Morris; Sheldon,9995,0,9999,4
1745794786087,CLRE 251R,A00,907817,Mehta; Ravindra L.,9994,0,9999,5
1745794787112,CLRE 252,A00,891864,Cuomo; Raphael Eduardo,9993,0,9999,6
1745794788138,CLRE 253,A00,891867,Vaida; Florin,9994,0,9999,5
1745794788138,CLRE 253,B00,907819,Staff,9999,0,9999,0
1745794789166,CLRE 259,A00,891868,Patel; Hemal,9998,0,9999,1
1745794790194,CLRE 260,A00,891872,Cuomo; Raphael Eduardo,9999,0,9999,0
1745794791222,CLRE 297,001,891888,Cuomo; Raphael Eduardo,9999,0,9999,0
1745794792249,CSE 191,A00,958773,Minnes Kemp; Mor Mia,9999,0,9999,0
1745794793278,CSS 201S,A01,892054,Mignozzetti; Umberto,30,0,30,0
1745794794310,CSS 202S,A01,892056,Mignozzetti; Umberto,30,0,30,0
1745794795337,DSC 197,001,956898,Eldridge; Justin Matthew,9998,0,9999,1
1745794796364,DSC 297,001,958000,Mazumdar; Arya,9998,0,9999,1
1745794797391,EAP 100,A00,905686,Staff,9776,0,9999,223
1745794798419,ECE 45,A01,892618,Staff,0,12,50,50
1745794799449,ECE 109,A01,892620,Staff,0,43,0,0
1745794800474,ECE 111,A01,892719,Staff,0,7,50,50
1745794801499,ECE 197,001,957920,Mercier; Patrick Philip,9992,0,9999,7
1745794802532,ECON 178,A01,907814,Zhu; Ying,28,0,35,7
1745794803558,EDS 115,A00,895312,Staff,41,0,45,4
1745794804584,EDS 117,A01,895337,Staff,30,0,30,0
1745794805612,EDS 125,A00,895341,Jones; Gabrielle Anastasia,43,0,45,2
1745794806639,EDS 128A,A01,895459,Fargason; Sharon Gayle,44,0,45,1
1745794807669,EDS 128B,A01,895543,Pappas; Elizabeth,44,0,45,1
1745794808695,EDS 139,A00,897203,Pappas; Elizabeth,44,0,45,1
1745794808695,EDS 139,B00,897209,Fargason; Sharon Gayle,44,0,45,1
1745794809722,EDS 201,A00,895545,Staff,43,0,45,2
1745794810749,EDS 203,A01,895581,Halter; Christopher P.,43,0,45,2
1745794811774,EDS 204R,A01,895625,Heinzman; Erica M.,43,0,45,2
1745794811774,EDS 204R,B01,895693,Halter; Christopher P.,18,0,45,27
1745794812801,EDS 206R,A00,895694,Fargason; Sharon Gayle,9,0,30,21
1745794812801,EDS 206R,B00,895695,Choi; Bailey Miyeon,20,0,30,10
1745794813829,EDS 250,A00,895697,Hemans; Patricia Ann Benitez,43,0,45,2
1745794814855,EDS 281,A00,895701,Meyerott; Theresa Ann,15,0,15,0
1745794815883,EDS 284,A00,895736,Meyerott; Theresa Ann,15,0,15,0
1745794816911,EDS 286,A00,897210,Fine; Sarah,15,0,15,0
1745794817935,EDS 289C,A01,895770,Daly; Alan J.,15,0,15,0
1745794818962,EDS 290,A00,897211,Hofstetter; Carolyn,15,0,15,0
1745794819991,LIGM 5A,A00,896162,Fischer-Grunski; Eva K,15,0,20,5
1745794821017,LIGM 5B,A00,896260,Fischer-Grunski; Eva K,17,0,20,3
1745794822043,LIGM 5C,A00,896308,Fischer-Grunski; Eva K,18,0,20,2
1745794823069,LIIT 5AS,A00,896313,Carnelos; Chiara,18,0,20,2
1745794824096,LIIT 5BS,A00,896416,Carnelos; Chiara,20,0,20,0
1745794825123,LIIT 5CS,A00,896564,Carnelos; Chiara,20,0,20,0
1745794826151,LISP 5A,A00,896588,Munoz Sanchez; Alicia,4,0,20,16
1745794827178,LISP 5B,A00,896653,Munoz Sanchez; Alicia,10,0,20,10
1745794828207,LISP 5C,A00,896655,Munoz Sanchez; Alicia,4,0,20,16
1745794829236,MAE 197,001,957918,Kleissl; Jan,9998,0,9999,1
1745794830262,MATH 2,A01,957937,Staff,34,0,35,1
1745794831288,MATH 197,001,957876,Kedlaya; Kiran S.,9993,0,9999,6
1745794832314,MCWP 40,A00,892729,Duru; Nur,13,0,20,7
1745794832314,MCWP 40,B00,893304,Montejo; Carolina,20,0,20,0
1745794833342,MCWP 40R,A00,893757,Redela; Pamela Morgan,0,6,20,20
1745794834371,MCWP 50,A00,893758,Morshed; Michael James,2,0,20,18
1745794834371,MCWP 50,B00,893761,Bartulis; Jason Michael,17,0,20,3
1745794835396,MCWP 50R,A00,893766,Compas; Sean Matthew,0,1,20,20
1745794835396,MCWP 50R,B00,893769,Carter; Jennifer A,0,0,20,20
1745794835396,MCWP 50R,C00,893771,Krone; Jarret,0,3,20,20
1745794835396,MCWP 50R,D00,893772,Miller; Elizabeth Deen,3,0,20,17
1745794835396,MCWP 50R,E00,893775,Carter; Andrea L,0,0,20,20
1745794836422,MMW 11R,A01,892721,Herbst; Matthew,11,0,27,16
1745794836422,MMW 11R,A02,892722,Herbst; Matthew,0,0,0,3
1745794837449,MMW 12R,A01,892724,Herbst; Matthew,0,9,16,16
1745794837449,MMW 12R,A02,892725,Herbst; Matthew,0,9,16,16
1745794838475,MMW 13R,A01,892727,Staff,0,4,16,16
1745794838475,MMW 13R,A02,892728,Staff,0,4,16,16
1745794838475,MMW 13R,A03,958032,Staff,0,3,16,16
1745794838475,MMW 13R,A04,958033,Staff,0,2,16,16
1745794838475,MMW 13R,A05,958034,Staff,0,3,16,16
1745794839500,SIO 295LS,A00,894015,Staff,7,0,25,18
1745794840523,SIO 295S,A00,894020,Staff,7,0,25,18
1745794841552,SIOC 290S,B01,958918,Staff,0,0,0,0
1745794842581,SIOC 291S,B01,958922,Staff,0,0,0,0
1745794843606,SOCI 117,A01,895339,Staff,4,0,5,1
1745794844631,WES 237B,A00,894149,Staff,11,0,20,9
1745794846698,AESE 279B,A00,891859,Staff,13,0,35,22
1745794847726,AIP 197,001,891854,Staff,70,0,70,0
1745794848753,ANTH 289S,A00,891856,Gagneux; Pascal,12,0,12,0
1745794849779,BENG 196,001,957946,Engler; Adam J.,9996,0,9999,3
1745794850806,CAT 124RS,A01,956906,Staff,8,0,25,17
1745794851831,CAT 125RS,A01,922013,Staff,8,0,25,17
1745794852857,CLRE 250,A00,891860,Morris; Sheldon,9995,0,9999,4
1745794854908,CLRE 251R,A00,907817,Mehta; Ravindra L.,9994,0,9999,5
1745794855932,CLRE 252,A00,891864,Cuomo; Raphael Eduardo,9993,0,9999,6
1745794856960,CLRE 253,A00,891867,Vaida; Florin,9994,0,9999,5
1745794856960,CLRE 253,B00,907819,Staff,9999,0,9999,0
1745794857987,CLRE 259,A00,891868,Patel; Hemal,9998,0,9999,1
1745794859013,CLRE 260,A00,891872,Cuomo; Raphael Eduardo,9999,0,9999,0
1745794860039,CLRE 297,001,891888,Cuomo; Raphael Eduardo,9999,0,9999,0
1745794861066,CSE 191,A00,958773,Minnes Kemp; Mor Mia,9999,0,9999,0
1745794862094,CSS 201S,A01,892054,Mignozzetti; Umberto,30,0,30,0
1745794863122,CSS 202S,A01,892056,Mignozzetti; Umberto,30,0,30,0
1745794864149,DSC 197,001,956898,Eldridge; Justin Matthew,9998,0,9999,1
1745794865176,DSC 297,001,958000,Mazumdar; Arya,9998,0,9999,1
1745794866201,EAP 100,A00,905686,Staff,9776,0,9999,223
1745794867230,ECE 45,A01,892618,Staff,0,12,50,50
1745794868255,ECE 109,A01,892620,Staff,0,43,0,0
1745794869281,ECE 111,A01,892719,Staff,0,7,50,50
1745794870310,ECE 197,001,957920,Mercier; Patrick Philip,9992,0,9999,7
1745794871337,ECON 178,A01,907814,Zhu; Ying,28,0,35,7
1745794872365,EDS 115,A00,895312,Staff,41,0,45,4
1745794873393,EDS 117,A01,895337,Staff,30,0,30,0
1745794874422,EDS 125,A00,895341,Jones; Gabrielle Anastasia,43,0,45,2
1745794875447,EDS 128A,A01,895459,Fargason; Sharon Gayle,44,0,45,1
1745794876474,EDS 128B,A01,895543,Pappas; Elizabeth,44,0,45,1
1745794877501,EDS 139,A00,897203,Pappas; Elizabeth,44,0,45,1
1745794877501,EDS 139,B00,897209,Fargason; Sharon Gayle,44,0,45,1
1745794878527,EDS 201,A00,895545,Staff,43,0,45,2
1745794879553,EDS 203,A01,895581,Halter; Christopher P.,43,0,45,2
1745794880579,EDS 204R,A01,895625,Heinzman; Erica M.,43,0,45,2
1745794880579,EDS 204R,B01,895693,Halter; Christopher P.,18,0,45,27
1745794881607,EDS 206R,A00,895694,Fargason; Sharon Gayle,9,0,30,21
1745794881607,EDS 206R,B00,895695,Choi; Bailey Miyeon,20,0,30,10
1745794882632,EDS 250,A00,895697,Hemans; Patricia Ann Benitez,43,0,45,2
1745794883660,EDS 281,A00,895701,Meyerott; Theresa Ann,15,0,15,0
1745794884686,EDS 284,A00,895736,Meyerott; Theresa Ann,15,0,15,0
1745794885712,EDS 286,A00,897210,Fine; Sarah,15,0,15,0
1745794886741,EDS 289C,A01,895770,Daly; Alan J.,15,0,15,0
1745794887766,EDS 290,A00,897211,Hofstetter; Carolyn,15,0,15,0
1745794888793,LIGM 5A,A00,896162,Fischer-Grunski; Eva K,15,0,20,5
1745794889818,LIGM 5B,A00,896260,Fischer-Grunski; Eva K,17,0,20,3
1745794890845,LIGM 5C,A00,896308,Fischer-Grunski; Eva K,18,0,20,2
1745794891910,LIIT 5AS,A00,896313,Carnelos; Chiara,18,0,20,2
1745794892935,LIIT 5BS,A00,896416,Carnelos; Chiara,20,0,20,0
1745794893965,LIIT 5CS,A00,896564,Carnelos; Chiara,20,0,20,0
1745794894991,LISP 5A,A00,896588,Munoz Sanchez; Alicia,4,0,20,16
1745794896022,LISP 5B,A00,896653,Munoz Sanchez; Alicia,10,0,20,10
1745794897051,LISP 5C,A00,896655,Munoz Sanchez; Alicia,4,0,20,16
1745794898077,MAE 197,001,957918,Kleissl; Jan,9998,0,9999,1
1745794899102,MATH 2,A01,957937,Staff,34,0,35,1
1745794900128,MATH 197,001,957876,Kedlaya; Kiran S.,9993,0,9999,6
1745794901155,MCWP 40,A00,892729,Duru; Nur,13,0,20,7
1745794901155,MCWP 40,B00,893304,Montejo; Carolina,20,0,20,0
1745794902179,MCWP 40R,A00,893757,Redela; Pamela Morgan,0,6,20,20
1745794903204,MCWP 50,A00,893758,Morshed; Michael James,2,0,20,18
1745794903204,MCWP 50,B00,893761,Bartulis; Jason Michael,17,0,20,3
1745794904230,MCWP 50R,A00,893766,Compas; Sean Matthew,0,1,20,20
1745794904230,MCWP 50R,B00,893769,Carter; Jennifer A,0,0,20,20
1745794904230,MCWP 50R,C00,893771,Krone; Jarret,0,3,20,20
1745794904230,MCWP 50R,D00,893772,Miller; Elizabeth Deen,3,0,20,17
1745794904230,MCWP 50R,E00,893775,Carter; Andrea L,0,0,20,20
1745794905259,MMW 11R,A01,892721,Herbst; Matthew,11,0,27,16
1745794905259,MMW 11R,A02,892722,Herbst; Matthew,0,0,0,3
1745794906287,MMW 12R,A01,892724,Herbst; Matthew,0,9,16,16
1745794906287,MMW 12R,A02,892725,Herbst; Matthew,0,9,16,16
1745794907324,MMW 13R,A01,892727,Staff,0,4,16,16
1745794907324,MMW 13R,A02,892728,Staff,0,4,16,16
1745794907324,MMW 13R,A03,958032,Staff,0,3,16,16
1745794907324,MMW 13R,A04,958033,Staff,0,2,16,16
1745794907324,MMW 13R,A05,958034,Staff,0,3,16,16
1745794908350,SIO 295LS,A00,894015,Staff,7,0,25,18
1745794909375,SIO 295S,A00,894020,Staff,7,0,25,18
1745794910400,SIOC 290S,B01,958918,Staff,0,0,0,0
1745794911430,SIOC 291S,B01,958922,Staff,0,0,0,0
1745794912456,SOCI 117,A01,895339,Staff,4,0,5,1
1745794913484,WES 237B,A00,894149,Staff,11,0,20,9
1745794915541,AESE 279B,A00,891859,Staff,13,0,35,22
1745794916565,AIP 197,001,891854,Staff,70,0,70,0
1745794917591,ANTH 289S,A00,891856,Gagneux; Pascal,12,0,12,0
1745794918615,BENG 196,001,957946,Engler; Adam J.,9996,0,9999,3
1745794919642,CAT 124RS,A01,956906,Staff,8,0,25,17
1745794920669,CAT 125RS,A01,922013,Staff,8,0,25,17
1745794921698,CLRE 250,A00,891860,Morris; Sheldon,9995,0,9999,4
1745794923751,CLRE 251R,A00,907817,Mehta; Ravindra L.,9994,0,9999,5
1745794924780,CLRE 252,A00,891864,Cuomo; Raphael Eduardo,9993,0,9999,6
1745794925809,CLRE 253,A00,891867,Vaida; Florin,9994,0,9999,5
1745794925809,CLRE 253,B00,907819,Staff,9999,0,9999,0
1745794926838,CLRE 259,A00,891868,Patel; Hemal,9998,0,9999,1
1745794927866,CLRE 260,A00,891872,Cuomo; Raphael Eduardo,9999,0,9999,0
1745794928892,CLRE 297,001,891888,Cuomo; Raphael Eduardo,9999,0,9999,0
1745794929917,CSE 191,A00,958773,Minnes Kemp; Mor Mia,9999,0,9999,0
1745794930943,CSS 201S,A01,892054,Mignozzetti; Umberto,30,0,30,0
1745794931970,CSS 202S,A01,892056,Mignozzetti; Umberto,30,0,30,0
1745794932995,DSC 197,001,956898,Eldridge; Justin Matthew,9998,0,9999,1
1745794934020,DSC 297,001,958000,Mazumdar; Arya,9998,0,9999,1
1745794935047,EAP 100,A00,905686,Staff,9776,0,9999,223
1745794936079,ECE 45,A01,892618,Staff,0,12,50,50
1745794937104,ECE 109,A01,892620,Staff,0,43,0,0
1745794938129,ECE 111,A01,892719,Staff,0,7,50,50
1745794939155,ECE 197,001,957920,Mercier; Patrick Philip,9992,0,9999,7
1745794940181,ECON 178,A01,907814,Zhu; Ying,28,0,35,7
1745794941206,EDS 115,A00,895312,Staff,41,0,45,4
1745794942232,EDS 117,A01,895337,Staff,30,0,30,0
1745794943258,EDS 125,A00,895341,Jones; Gabrielle Anastasia,43,0,45,2
1745794944284,EDS 128A,A01,895459,Fargason; Sharon Gayle,44,0,45,1
1745794945310,EDS 128B,A01,895543,Pappas; Elizabeth,44,0,45,1
1745794946336,EDS 139,A00,897203,Pappas; Elizabeth,44,0,45,1
1745794946336,EDS 139,B00,897209,Fargason; Sharon Gayle,44,0,45,1
1745794947364,EDS 201,A00,895545,Staff,43,0,45,2
1745794948389,EDS 203,A01,895581,Halter; Christopher P.,43,0,45,2
1745794949415,EDS 204R,A01,895625,Heinzman; Erica M.,43,0,45,2
1745794949415,EDS 204R,B01,895693,Halter; Christopher P.,18,0,45,27
1745794950439,EDS 206R,A00,895694,Fargason; Sharon Gayle,9,0,30,21
1745794950439,EDS 206R,B00,895695,Choi; Bailey Miyeon,20,0,30,10
1745794951464,EDS 250,A00,895697,Hemans; Patricia Ann Benitez,43,0,45,2
1745794952489,EDS 281,A00,895701,Meyerott; Theresa Ann,15,0,15,0
1745794953515,EDS 284,A00,895736,Meyerott; Theresa Ann,15,0,15,0
1745794954540,EDS 286,A00,897210,Fine; Sarah,15,0,15,0
1745794955565,EDS 289C,A01,895770,Daly; Alan J.,15,0,15,0
1745794956591,EDS 290,A00,897211,Hofstetter; Carolyn,15,0,15,0
1745794957617,LIGM 5A,A00,896162,Fischer-Grunski; Eva K,15,0,20,5
1745794958641,LIGM 5B,A00,896260,Fischer-Grunski; Eva K,17,0,20,3
1745794959667,LIGM 5C,A00,896308,Fischer-Grunski; Eva K,18,0,20,2
1745794960692,LIIT 5AS,A00,896313,Carnelos; Chiara,18,0,20,2
1745794961719,LIIT 5BS,A00,896416,Carnelos; Chiara,20,0,20,0
1745794962744,LIIT 5CS,A00,896564,Carnelos; Chiara,20,0,20,0
1745794963773,LISP 5A,A00,896588,Munoz Sanchez; Alicia,4,0,20,16
1745794964798,LISP 5B,A00,896653,Munoz Sanchez; Alicia,10,0,20,10
1745794965825,LISP 5C,A00,896655,Munoz Sanchez; Alicia,4,0,20,16
1745794966852,MAE 197,001,957918,Kleissl; Jan,9998,0,9999,1
1745794967878,MATH 2,A01,957937,Staff,34,0,35,1
1745794968907,MATH 197,001,957876,Kedlaya; Kiran S.,9993,0,9999,6
1745794969932,MCWP 40,A00,892729,Duru; Nur,13,0,20,7
1745794969932,MCWP 40,B00,893304,Montejo; Carolina,20,0,20,0
1745794970957,MCWP 40R,A00,893757,Redela; Pamela Morgan,0,6,20,20
1745794971984,MCWP 50,A00,893758,Morshed; Michael James,2,0,20,18
1745794971984,MCWP 50,B00,893761,Bartulis; Jason Michael,17,0,20,3
1745794973009,MCWP 50R,A00,893766,Compas; Sean Matthew,0,1,20,20
1745794973009,MCWP 50R,B00,893769,Carter; Jennifer A,0,0,20,20
1745794973009,MCWP 50R,C00,893771,Krone; Jarret,0,3,20,20
1745794973009,MCWP 50R,D00,893772,Miller; Elizabeth Deen,3,0,20,17
1745794973009,MCWP 50R,E00,893775,Carter; Andrea L,0,0,20,20
1745794974038,MMW 11R,A01,892721,Herbst; Matthew,11,0,27,16
1745794974038,MMW 11R,A02,892722,Herbst; Matthew,0,0,0,3
1745794975070,MMW 12R,A01,892724,Herbst; Matthew,0,9,16,16
1745794975070,MMW 12R,A02,892725,Herbst; Matthew,0,9,16,16
1745794976099,MMW 13R,A01,892727,Staff,0,4,16,16
1745794976099,MMW 13R,A02,892728,Staff,0,4,16,16
1745794976099,MMW 13R,A03,958032,Staff,0,3,16,16
1745794976099,MMW 13R,A04,958033,Staff,0,2,16,16
1745794976099,MMW 13R,A05,958034,Staff,0,3,16,16
1745794977125,SIO 295LS,A00,894015,Staff,7,0,25,18
1745794978150,SIO 295S,A00,894020,Staff,7,0,25,18
1745794979175,SIOC 290S,B01,958918,Staff,0,0,0,0
1745794980201,SIOC 291S,B01,958922,Staff,0,0,0,0
1745794981226,SOCI 117,A01,895339,Staff,4,0,5,1
1745794982251,WES 237B,A00,894149,Staff,11,0,20,9
1745794984311,AESE 279B,A00,891859,Staff,13,0,35,22
1745794985337,AIP 197,001,891854,Staff,70,0,70,0
1745794986363,ANTH 289S,A00,891856,Gagneux; Pascal,12,0,12,0
1745794987389,BENG 196,001,957946,Engler; Adam J.,9996,0,9999,3
1745794988416,CAT 124RS,A01,956906,Staff,8,0,25,17
1745794989445,CAT 125RS,A01,922013,Staff,8,0,25,17
1745794990473,CLRE 250,A00,891860,Morris; Sheldon,9995,0,9999,4
1745794992524,CLRE 251R,A00,907817,Mehta; Ravindra L.,9994,0,9999,5
1745794993552,CLRE 252,A00,891864,Cuomo; Raphael Eduardo,9993,0,9999,6
1745794994578,CLRE 253,A00,891867,Vaida; Florin,9994,0,9999,5
1745794994578,CLRE 253,B00,907819,Staff,9999,0,9999,0
1745794995643,CLRE 259,A00,891868,Patel; Hemal,9998,0,9999,1
1745794996666,CLRE 260,A00,891872,Cuomo; Raphael Eduardo,9999,0,9999,0
1745794997695,CLRE 297,001,891888,Cuomo; Raphael Eduardo,9999,0,9999,0
1745794998720,CSE 191,A00,958773,Minnes Kemp; Mor Mia,9999,0,9999,0
1745794999745,CSS 201S,A01,892054,Mignozzetti; Umberto,30,0,30,0
1745795000774,CSS 202S,A01,892056,Mignozzetti; Umberto,30,0,30,0
1745795001801,DSC 197,001,956898,Eldridge; Justin Matthew,9998,0,9999,1
1745795002826,DSC 297,001,958000,Mazumdar; Arya,9998,0,9999,1
1745795003853,EAP 100,A00,905686,Staff,9776,0,9999,223
1745795004882,ECE 45,A01,892618,Staff,0,12,50,50
1745795005909,ECE 109,A01,892620,Staff,0,43,0,0
1745795006938,ECE 111,A01,892719,Staff,0,7,50,50
1745795007966,ECE 197,001,957920,Mercier; Patrick Philip,9992,0,9999,7
1745795008994,ECON 178,A01,907814,Zhu; Ying,28,0,35,7
1745795010024,EDS 115,A00,895312,Staff,41,0,45,4
1745795011052,EDS 117,A01,895337,Staff,30,0,30,0
1745795012078,EDS 125,A00,895341,Jones; Gabrielle Anastasia,43,0,45,2
1745795013103,EDS 128A,A01,895459,Fargason; Sharon Gayle,44,0,45,1
1745795014131,EDS 128B,A01,895543,Pappas; Elizabeth,44,0,45,1
1745795015158,EDS 139,A00,897203,Pappas; Elizabeth,44,0,45,1
1745795015158,EDS 139,B00,897209,Fargason; Sharon Gayle,44,0,45,1
1745795016387,EDS 201,A00,895545,Staff,43,0,45,2
1745795017414,EDS 203,A01,895581,Halter; Christopher P.,43,0,45,2
1745795018441,EDS 204R,A01,895625,Heinzman; Erica M.,43,0,45,2
1745795018441,EDS 204R,B01,895693,Halter; Christopher P.,18,0,45,27
1745795019472,EDS 206R,A00,895694,Fargason; Sharon Gayle,9,0,30,21
1745795019472,EDS 206R,B00,895695,Choi; Bailey Miyeon,20,0,30,10
1745795020499,EDS 250,A00,895697,Hemans; Patricia Ann Benitez,43,0,45,2
1745795021525,EDS 281,A00,895701,Meyerott; Theresa Ann,15,0,15,0
1745795022553,EDS 284,A00,895736,Meyerott; Theresa Ann,15,0,15,0
1745795023581,EDS 286,A00,897210,Fine; Sarah,15,0,15,0
1745795024606,EDS 289C,A01,895770,Daly; Alan J.,15,0,15,0
1745795025634,EDS 290,A00,897211,Hofstetter; Carolyn,15,0,15,0
1745795026658,LIGM 5A,A00,896162,Fischer-Grunski; Eva K,15,0,20,5
1745795027687,LIGM 5B,A00,896260,Fischer-Grunski; Eva K,17,0,20,3
1745795028712,LIGM 5C,A00,896308,Fischer-Grunski; Eva K,18,0,20,2
1745795029736,LIIT 5AS,A00,896313,Carnelos; Chiara,18,0,20,2
1745795030765,LIIT 5BS,A00,896416,Carnelos; Chiara,20,0,20,0
1745795031795,LIIT 5CS,A00,896564,Carnelos; Chiara,20,0,20,0
1745795032824,LISP 5A,A00,896588,Munoz Sanchez; Alicia,4,0,20,16
1745795033852,LISP 5B,A00,896653,Munoz Sanchez; Alicia,10,0,20,10
1745795034882,LISP 5C,A00,896655,Munoz Sanchez; Alicia,4,0,20,16
1745795035907,MAE 197,001,957918,Kleissl; Jan,9998,0,9999,1
1745795036934,MATH 2,A01,957937,Staff,34,0,35,1
1745795037963,MATH 197,001,957876,Kedlaya; Kiran S.,9993,0,9999,6
1745795038993,MCWP 40,A00,892729,Duru; Nur,13,0,20,7
1745795038993,MCWP 40,B00,893304,Montejo; Carolina,20,0,20,0
1745795040028,MCWP 40R,A00,893757,Redela; Pamela Morgan,0,6,20,20
1745795041054,MCWP 50,A00,893758,Morshed; Michael James,2,0,20,18
1745795041054,MCWP 50,B00,893761,Bartulis; Jason Michael,17,0,20,3
1745795042082,MCWP 50R,A00,893766,Compas; Sean Matthew,0,1,20,20
1745795042082,MCWP 50R,B00,893769,Carter; Jennifer A,0,0,20,20
1745795042082,MCWP 50R,C00,893771,Krone; Jarret,0,3,20,20
1745795042082,MCWP 50R,D00,893772,Miller; Elizabeth Deen,3,0,20,17
1745795042082,MCWP 50R,E00,893775,Carter; Andrea L,0,0,20,20
1745795043108,MMW 11R,A01,892721,Herbst; Matthew,11,0,27,16
1745795043108,MMW 11R,A02,892722,Herbst; Matthew,0,0,0,3
1745795044134,MMW 12R,A01,892724,Herbst; Matthew,0,9,16,16
1745795044134,MMW 12R,A02,892725,Herbst; Matthew,0,9,16,16
1745795045163,MMW 13R,A01,892727,Staff,0,4,16,16
1745795045163,MMW 13R,A02,892728,Staff,0,4,16,16
1745795045163,MMW 13R,A03,958032,Staff,0,3,16,16
1745795045163,MMW 13R,A04,958033,Staff,0,2,16,16
1745795045163,MMW 13R,A05,958034,Staff,0,3,16,16
1745795046192,SIO 295LS,A00,894015,Staff,7,0,25,18
1745795047218,SIO 295S,A00,894020,Staff,7,0,25,18
1745795048244,SIOC 290S,B01,958918,Staff,0,0,0,0
1745795049270,SIOC 291S,B01,958922,Staff,0,0,0,0
1745795050299,SOCI 117,A01,895339,Staff,4,0,5,1
1745795051325,WES 237B,A00,894149,Staff,11,0,20,9
1745795053383,AESE 279B,A00,891859,Staff,13,0,35,22
1745795054408,AIP 197,001,891854,Staff,70,0,70,0
1745795055436,ANTH 289S,A00,891856,Gagneux; Pascal,12,0,12,0
1745795056463,BENG 196,001,957946,Engler; Adam J.,9996,0,9999,3
1745795057489,CAT 124RS,A01,956906,Staff,8,0,25,17
1745795058517,CAT 125RS,A01,922013,Staff,8,0,25,17
1745795059546,CLRE 250,A00,891860,Morris; Sheldon,9995,0,9999,4
1745795061598,CLRE 251R,A00,907817,Mehta; Ravindra L.,9994,0,9999,5
1745795062624,CLRE 252,A00,891864,Cuomo; Raphael Eduardo,9993,0,9999,6
1745795063650,CLRE 253,A00,891867,Vaida; Florin,9994,0,9999,5
1745795063650,CLRE 253,B00,907819,Staff,9999,0,9999,0
1745795064677,CLRE 259,A00,891868,Patel; Hemal,9998,0,9999,1
1745795065702,CLRE 260,A00,891872,Cuomo; Raphael Eduardo,9999,0,9999,0
1745795066729,CLRE 297,001,891888,Cuomo; Raphael Eduardo,9999,0,9999,0
1745795067755,CSE 191,A00,958773,Minnes Kemp; Mor Mia,9999,0,9999,0
1745795068783,CSS 201S,A01,892054,Mignozzetti; Umberto,30,0,30,0
1745795069813,CSS 202S,A01,892056,Mignozzetti; Umberto,30,0,30,0
1745795070838,DSC 197,001,956898,Eldridge; Justin Matthew,9998,0,9999,1
1745795071867,DSC 297,001,958000,Mazumdar; Arya,9998,0,9999,1
1745795072895,EAP 100,A00,905686,Staff,9776,0,9999,223
1745795073924,ECE 45,A01,892618,Staff,0,12,50,50
1745795074950,ECE 109,A01,892620,Staff,0,43,0,0
1745795075976,ECE 111,A01,892719,Staff,0,7,50,50
1745795077005,ECE 197,001,957920,Mercier; Patrick Philip,9992,0,9999,7
1745795078035,ECON 178,A01,907814,Zhu; Ying,28,0,35,7
1745795079061,EDS 115,A00,895312,Staff,41,0,45,4
1745795080086,EDS 117,A01,895337,Staff,30,0,30,0
1745795081112,EDS 125,A00,895341,Jones; Gabrielle Anastasia,43,0,45,2
1745795082139,EDS 128A,A01,895459,Fargason; Sharon Gayle,44,0,45,1
1745795083170,EDS 128B,A01,895543,Pappas; Elizabeth,44,0,45,1
1745795084198,EDS 139,A00,897203,Pappas; Elizabeth,44,0,45,1
1745795084198,EDS 139,B00,897209,Fargason; Sharon Gayle,44,0,45,1
1745795085225,EDS 201,A00,895545,Staff,43,0,45,2
1745795086251,EDS 203,A01,895581,Halter; Christopher P.,43,0,45,2
1745795087281,EDS 204R,A01,895625,Heinzman; Erica M.,43,0,45,2
1745795087281,EDS 204R,B01,895693,Halter; Christopher P.,18,0,45,27
1745795088313,EDS 206R,A00,895694,Fargason; Sharon Gayle,9,0,30,21
1745795088313,EDS 206R,B00,895695,Choi; Bailey Miyeon,20,0,30,10
1745795089342,EDS 250,A00,895697,Hemans; Patricia Ann Benitez,43,0,45,2
1745795090368,EDS 281,A00,895701,Meyerott; Theresa Ann,15,0,15,0
1745795091394,EDS 284,A00,895736,Meyerott; Theresa Ann,15,0,15,0
1745795092421,EDS 286,A00,897210,Fine; Sarah,15,0,15,0
1745795093448,EDS 289C,A01,895770,Daly; Alan J.,15,0,15,0
1745795094477,EDS 290,A00,897211,Hofstetter; Carolyn,15,0,15,0
1745795095503,LIGM 5A,A00,896162,Fischer-Grunski; Eva K,15,0,20,5
1745795096532,LIGM 5B,A00,896260,Fischer-Grunski; Eva K,17,0,20,3
1745795097559,LIGM 5C,A00,896308,Fischer-Grunski; Eva K,18,0,20,2
1745795098585,LIIT 5AS,A00,896313,Carnelos; Chiara,18,0,20,2
1745795099614,LIIT 5BS,A00,896416,Carnelos; Chiara,20,0,20,0
1745795100641,LIIT 5CS,A00,896564,Carnelos; Chiara,20,0,20,0
1745795101682,LISP 5A,A00,896588,Munoz Sanchez; Alicia,4,0,20,16
1745795102712,LISP 5B,A00,896653,Munoz Sanchez; Alicia,10,0,20,10
1745795103739,LISP 5C,A00,896655,Munoz Sanchez; Alicia,4,0,20,16
1745795104768,MAE 197,001,957918,Kleissl; Jan,9998,0,9999,1
1745795105795,MATH 2,A01,957937,Staff,34,0,35,1
1745795106827,MATH 197,001,957876,Kedlaya; Kiran S.,9993,0,9999,6
1745795107856,MCWP 40,A00,892729,Duru; Nur,13,0,20,7
1745795107856,MCWP 40,B00,893304,Montejo; Carolina,20,0,20,0
1745795108884,MCWP 40R,A00,893757,Redela; Pamela Morgan,0,6,20,20
1745795109910,MCWP 50,A00,893758,Morshed; Michael James,2,0,20,18
1745795109910,MCWP 50,B00,893761,Bartulis; Jason Michael,17,0,20,3
1745795110939,MCWP 50R,A00,893766,Compas; Sean Matthew,0,1,20,20
1745795110939,MCWP 50R,B00,893769,Carter; Jennifer A,0,0,20,20
1745795110939,MCWP 50R,C00,893771,Krone; Jarret,0,3,20,20
1745795110939,MCWP 50R,D00,893772,Miller; Elizabeth Deen,3,0,20,17
1745795110939,MCWP 50R,E00,893775,Carter; Andrea L,0,0,20,20
1745795111966,MMW 11R,A01,892721,Herbst; Matthew,11,0,27,16
1745795111966,MMW 11R,A02,892722,Herbst; Matthew,0,0,0,3
1745795112993,MMW 12R,A01,892724,Herbst; Matthew,0,9,16,16
1745795112993,MMW 12R,A02,892725,Herbst; Matthew,0,9,16,16
1745795114021,MMW 13R,A01,892727,Staff,0,4,16,16
1745795114021,MMW 13R,A02,892728,Staff,0,4,16,16
1745795114021,MMW 13R,A03,958032,Staff,0,3,16,16
1745795114021,MMW 13R,A04,958033,Staff,0,2,16,16
1745795114021,MMW 13R,A05,958034,Staff,0,3,16,16
1745795115050,SIO 295LS,A00,894015,Staff,7,0,25,18
1745795116075,SIO 295S,A00,894020,Staff,7,0,25,18
1745795117102,SIOC 290S,B01,958918,Staff,0,0,0,0
1745795118135,SIOC 291S,B01,958922,Staff,0,0,0,0
1745795119162,SOCI 117,A01,895339,Staff,4,0,5,1
1745795120188,WES 237B,A00,894149,Staff,11,0,20,9
1745795122254,AESE 279B,A00,891859,Staff,13,0,35,22
1745795123281,AIP 197,001,891854,Staff,70,0,70,0
1745795124310,ANTH 289S,A00,891856,Gagneux; Pascal,12,0,12,0
1745795125339,BENG 196,001,957946,Engler; Adam J.,9996,0,9999,3
1745795126365,CAT 124RS,A01,956906,Staff,8,0,25,17
1745795127392,CAT 125RS,A01,922013,Staff,8,0,25,17
1745795128417,CLRE 250,A00,891860,Morris; Sheldon,9995,0,9999,4
1745795130472,CLRE 251R,A00,907817,Mehta; Ravindra L.,9994,0,9999,5
1745795131500,CLRE 252,A00,891864,Cuomo; Raphael Eduardo,9993,0,9999,6
1745795132524,CLRE 253,A00,891867,Vaida; Florin,9994,0,9999,5
1745795132524,CLRE 253,B00,907819,Staff,9999,0,9999,0
1745795133549,CLRE 259,A00,891868,Patel; Hemal,9998,0,9999,1
1745795134574,CLRE 260,A00,891872,Cuomo; Raphael Eduardo,9999,0,9999,0
1745795135603,CLRE 297,001,891888,Cuomo; Raphael Eduardo,9999,0,9999,0
1745795136629,CSE 191,A00,958773,Minnes Kemp; Mor Mia,9999,0,9999,0
1745795137658,CSS 201S,A01,892054,Mignozzetti; Umberto,30,0,30,0
1745795138683,CSS 202S,A01,892056,Mignozzetti; Umberto,30,0,30,0
1745795139709,DSC 197,001,956898,Eldridge; Justin Matthew,9998,0,9999,1
1745795140734,DSC 297,001,958000,Mazumdar; Arya,9998,0,9999,1
1745795141762,EAP 100,A00,905686,Staff,9776,0,9999,223
1745795142791,ECE 45,A01,892618,Staff,0,12,50,50
1745795143818,ECE 109,A01,892620,Staff,0,43,0,0
1745795144845,ECE 111,A01,892719,Staff,0,7,50,50
1745795145886,ECE 197,001,957920,Mercier; Patrick Philip,9992,0,9999,7
1745795146917,ECON 178,A01,907814,Zhu; Ying,28,0,35,7
1745795147943,EDS 115,A00,895312,Staff,41,0,45,4
1745795148972,EDS 117,A01,895337,Staff,30,0,30,0
1745795150003,EDS 125,A00,895341,Jones; Gabrielle Anastasia,43,0,45,2
1745795151029,EDS 128A,A01,895459,Fargason; Sharon Gayle,44,0,45,1
1745795152059,EDS 128B,A01,895543,Pappas; Elizabeth,44,0,45,1
1745795153088,EDS 139,A00,897203,Pappas; Elizabeth,44,0,45,1
1745795153088,EDS 139,B00,897209,Fargason; Sharon Gayle,44,0,45,1
1745795154115,EDS 201,A00,895545,Staff,43,0,45,2
1745795155141,EDS 203,A01,895581,Halter; Christopher P.,43,0,45,2
1745795156170,EDS 204R,A01,895625,Heinzman; Erica M.,43,0,45,2
1745795156170,EDS 204R,B01,895693,Halter; Christopher P.,18,0,45,27
1745795157198,EDS 206R,A00,895694,Fargason; Sharon Gayle,9,0,30,21
1745795157198,EDS 206R,B00,895695,Choi; Bailey Miyeon,20,0,30,10
1745795158227,EDS 250,A00,895697,Hemans; Patricia Ann Benitez,43,0,45,2
1745795159254,EDS 281,A00,895701,Meyerott; Theresa Ann,15,0,15,0
1745795160279,EDS 284,A00,895736,Meyerott; Theresa Ann,15,0,15,0
1745795161304,EDS 286,A00,897210,Fine; Sarah,15,0,15,0
1745795162336,EDS 289C,A01,895770,Daly; Alan J.,15,0,15,0
1745795163365,EDS 290,A00,897211,Hofstetter; Carolyn,15,0,15,0
1745795164391,LIGM 5A,A00,896162,Fischer-Grunski; Eva K,15,0,20,5
1745795165422,LIGM 5B,A00,896260,Fischer-Grunski; Eva K,17,0,20,3
1745795166449,LIGM 5C,A00,896308,Fischer-Grunski; Eva K,18,0,20,2
1745795167477,LIIT 5AS,A00,896313,Carnelos; Chiara,18,0,20,2
1745795168509,LIIT 5BS,A00,896416,Carnelos; Chiara,20,0,20,0
1745795169540,LIIT 5CS,A00,896564,Carnelos; Chiara,20,0,20,0
1745795170568,LISP 5A,A00,896588,Munoz Sanchez; Alicia,4,0,20,16
1745795171598,LISP 5B,A00,896653,Munoz Sanchez; Alicia,10,0,20,10
1745795172625,LISP 5C,A00,896655,Munoz Sanchez; Alicia,4,0,20,16
1745795173653,MAE 197,001,957918,Kleissl; Jan,9998,0,9999,1
1745795174682,MATH 2,A01,957937,Staff,34,0,35,1
1745795175710,MATH 197,001,957876,Kedlaya; Kiran S.,9993,0,9999,6
1745795176735,MCWP 40,A00,892729,Duru; Nur,13,0,20,7
1745795176735,MCWP 40,B00,893304,Montejo; Carolina,20,0,20,0
1745795177762,MCWP 40R,A00,893757,Redela; Pamela Morgan,0,6,20,20
1745795178789,MCWP 50,A00,893758,Morshed; Michael James,2,0,20,18
1745795178789,MCWP 50,B00,893761,Bartulis; Jason Michael,17,0,20,3
1745795179817,MCWP 50R,A00,893766,Compas; Sean Matthew,0,1,20,20
1745795179817,MCWP 50R,B00,893769,Carter; Jennifer A,0,0,20,20
1745795179817,MCWP 50R,C00,893771,Krone; Jarret,0,3,20,20
1745795179817,MCWP 50R,D00,893772,Miller; Elizabeth Deen,3,0,20,17
1745795179817,MCWP 50R,E00,893775,Carter; Andrea L,0,0,20,20
1745795180847,MMW 11R,A01,892721,Herbst; Matthew,11,0,27,16
1745795180847,MMW 11R,A02,892722,Herbst; Matthew,0,0,0,3
1745795181875,MMW 12R,A01,892724,Herbst; Matthew,0,9,16,16
1745795181875,MMW 12R,A02,892725,Herbst; Matthew,0,9,16,16
1745795182905,MMW 13R,A01,892727,Staff,0,4,16,16
1745795182905,MMW 13R,A02,892728,Staff,0,4,16,16
1745795182905,MMW 13R,A03,958032,Staff,0,3,16,16
1745795182905,MMW 13R,A04,958033,Staff,0,2,16,16
1745795182905,MMW 13R,A05,958034,Staff,0,3,16,16
1745795183932,SIO 295LS,A00,894015,Staff,7,0,25,18
1745795184962,SIO 295S,A00,894020,Staff,7,0,25,18
1745795185992,SIOC 290S,B01,958918,Staff,0,0,0,0
1745795187021,SIOC 291S,B01,958922,Staff,0,0,0,0
1745795188048,SOCI 117,A01,895339,Staff,4,0,5,1
1745795189073,WES 237B,A00,894149,Staff,11,0,20,9
1745795191142,AESE 279B,A00,891859,Staff,13,0,35,22
1745795192171,AIP 197,001,891854,Staff,70,0,70,0
1745795193200,ANTH 289S,A00,891856,Gagneux; Pascal,12,0,12,0
1745795194225,BENG 196,001,957946,Engler; Adam J.,9996,0,9999,3
1745795195253,CAT 124RS,A01,956906,Staff,8,0,25,17
1745795196281,CAT 125RS,A01,922013,Staff,8,0,25,17
1745795197308,CLRE 250,A00,891860,Morris; Sheldon,9995,0,9999,4
1745795199362,CLRE 251R,A00,907817,Mehta; Ravindra L.,9994,0,9999,5
1745795200390,CLRE 252,A00,891864,Cuomo; Raphael Eduardo,9993,0,9999,6
1745795201416,CLRE 253,A00,891867,Vaida; Florin,9994,0,9999,5
1745795201416,CLRE 253,B00,907819,Staff,9999,0,9999,0
1745795202441,CLRE 259,A00,891868,Patel; Hemal,9998,0,9999,1
1745795203467,CLRE 260,A00,891872,Cuomo; Raphael Eduardo,9999,0,9999,0
1745795204495,CLRE 297,001,891888,Cuomo; Raphael Eduardo,9999,0,9999,0
1745795205521,CSE 191,A00,958773,Minnes Kemp; Mor Mia,9999,0,9999,0
1745795206548,CSS 201S,A01,892054,Mignozzetti; Umberto,30,0,30,0
1745795207577,CSS 202S,A01,892056,Mignozzetti; Umberto,30,0,30,0
1745795208604,DSC 197,001,956898,Eldridge; Justin Matthew,9998,0,9999,1
1745795209631,DSC 297,001,958000,Mazumdar; Arya,9998,0,9999,1
1745795210655,EAP 100,A00,905686,Staff,9776,0,9999,223
1745795211682,ECE 45,A01,892618,Staff,0,12,50,50
1745795212708,ECE 109,A01,892620,Staff,0,43,0,0
1745795213735,ECE 111,A01,892719,Staff,0,7,50,50
1745795214765,ECE 197,001,957920,Mercier; Patrick Philip,9992,0,9999,7
1745795215794,ECON 178,A01,907814,Zhu; Ying,28,0,35,7
1745795216822,EDS 115,A00,895312,Staff,41,0,45,4
1745795217850,EDS 117,A01,895337,Staff,30,0,30,0
1745795218878,EDS 125,A00,895341,Jones; Gabrielle Anastasia,43,0,45,2
1745795219904,EDS 128A,A01,895459,Fargason; Sharon Gayle,44,0,45,1
1745795220930,EDS 128B,A01,895543,Pappas; Elizabeth,44,0,45,1
1745795221958,EDS 139,A00,897203,Pappas; Elizabeth,44,0,45,1
1745795221958,EDS 139,B00,897209,Fargason; Sharon Gayle,44,0,45,1
1745795222983,EDS 201,A00,895545,Staff,43,0,45,2
1745795224015,EDS 203,A01,895581,Halter; Christopher P.,43,0,45,2
1745795225040,EDS 204R,A01,895625,Heinzman; Erica M.,43,0,45,2
1745795225040,EDS 204R,B01,895693,Halter; Christopher P.,18,0,45,27
1745795226067,EDS 206R,A00,895694,Fargason; Sharon Gayle,9,0,30,21
1745795226067,EDS 206R,B00,895695,Choi; Bailey Miyeon,20,0,30,10
1745795227093,EDS 250,A00,895697,Hemans; Patricia Ann Benitez,43,0,45,2
1745795228123,EDS 281,A00,895701,Meyerott; Theresa Ann,15,0,15,0
1745795229152,EDS 284,A00,895736,Meyerott; Theresa Ann,15,0,15,0
1745795230178,EDS 286,A00,897210,Fine; Sarah,15,0,15,0
1745795231204,EDS 289C,A01,895770,Daly; Alan J.,15,0,15,0
1745795232231,EDS 290,A00,897211,Hofstetter; Carolyn,15,0,15,0
1745795233259,LIGM 5A,A00,896162,Fischer-Grunski; Eva K,15,0,20,5
1745795234287,LIGM 5B,A00,896260,Fischer-Grunski; Eva K,17,0,20,3
1745795235317,LIGM 5C,A00,896308,Fischer-Grunski; Eva K,18,0,20,2
1745795236346,LIIT 5AS,A00,896313,Carnelos; Chiara,18,0,20,2
1745795237374,LIIT 5BS,A00,896416,Carnelos; Chiara,20,0,20,0
1745795238401,LIIT 5CS,A00,896564,Carnelos; Chiara,20,0,20,0
1745795239430,LISP 5A,A00,896588,Munoz Sanchez; Alicia,4,0,20,16
1745795240460,LISP 5B,A00,896653,Munoz Sanchez; Alicia,10,0,20,10
1745795241489,LISP 5C,A00,896655,Munoz Sanchez; Alicia,4,0,20,16
1745795242515,MAE 197,001,957918,Kleissl; Jan,9998,0,9999,1
1745795243544,MATH 2,A01,957937,Staff,34,0,35,1
1745795244571,MATH 197,001,957876,Kedlaya; Kiran S.,9993,0,9999,6
1745795245597,MCWP 40,A00,892729,Duru; Nur,13,0,20,7
1745795245597,MCWP 40,B00,893304,Montejo; Carolina,20,0,20,0
1745795246624,MCWP 40R,A00,893757,Redela; Pamela Morgan,0,6,20,20
1745795247649,MCWP 50,A00,893758,Morshed; Michael James,2,0,20,18
1745795247649,MCWP 50,B00,893761,Bartulis; Jason Michael,17,0,20,3
1745795248677,MCWP 50R,A00,893766,Compas; Sean Matthew,0,1,20,20
1745795248677,MCWP 50R,B00,893769,Carter; Jennifer A,0,0,20,20
1745795248677,MCWP 50R,C00,893771,Krone; Jarret,0,3,20,20
1745795248677,MCWP 50R,D00,893772,Miller; Elizabeth Deen,3,0,20,17
1745795248677,MCWP 50R,E00,893775,Carter; Andrea L,0,0,20,20
1745795249701,MMW 11R,A01,892721,Herbst; Matthew,11,0,27,16
1745795249701,MMW 11R,A02,892722,Herbst; Matthew,0,0,0,3
1745795250728,MMW 12R,A01,892724,Herbst; Matthew,0,9,16,16
1745795250728,MMW 12R,A02,892725,Herbst; Matthew,0,9,16,16
1745795251752,MMW 13R,A01,892727,Staff,0,4,16,16
1745795251752,MMW 13R,A02,892728,Staff,0,4,16,16
1745795251752,MMW 13R,A03,958032,Staff,0,3,16,16
1745795251752,MMW 13R,A04,958033,Staff,0,2,16,16
1745795251752,MMW 13R,A05,958034,Staff,0,3,16,16
1745795252781,SIO 295LS,A00,894015,Staff,7,0,25,18
1745795253808,SIO 295S,A00,894020,Staff,7,0,25,18
1745795254834,SIOC 290S,B01,958918,Staff,0,0,0,0
1745795255860,SIOC 291S,B01,958922,Staff,0,0,0,0
1745795256885,SOCI 117,A01,895339,Staff,4,0,5,1
1745795257911,WES 237B,A00,894149,Staff,11,0,20,9
1745795259968,AESE 279B,A00,891859,Staff,13,0,35,22
1745795260996,AIP 197,001,891854,Staff,70,0,70,0
1745795262026,ANTH 289S,A00,891856,Gagneux; Pascal,12,0,12,0
1745795263050,BENG 196,001,957946,Engler; Adam J.,9996,0,9999,3
1745795264080,CAT 124RS,A01,956906,Staff,8,0,25,17
1745795265104,CAT 125RS,A01,922013,Staff,8,0,25,17
1745795266130,CLRE 250,A00,891860,Morris; Sheldon,9995,0,9999,4
1745795268185,CLRE 251R,A00,907817,Mehta; Ravindra L.,9994,0,9999,5
1745795269213,CLRE 252,A00,891864,Cuomo; Raphael Eduardo,9993,0,9999,6
1745795270239,CLRE 253,A00,891867,Vaida; Florin,9994,0,9999,5
1745795270239,CLRE 253,B00,907819,Staff,9999,0,9999,0
1745795271267,CLRE 259,A00,891868,Patel; Hemal,9998,0,9999,1
1745795272295,CLRE 260,A00,891872,Cuomo; Raphael Eduardo,9999,0,9999,0
1745795273322,CLRE 297,001,891888,Cuomo; Raphael Eduardo,9999,0,9999,0
1745795274349,CSE 191,A00,958773,Minnes Kemp; Mor Mia,9999,0,9999,0
1745795275379,CSS 201S,A01,892054,Mignozzetti; Umberto,30,0,30,0
1745795276410,CSS 202S,A01,892056,Mignozzetti; Umberto,30,0,30,0
1745795277439,DSC 197,001,956898,Eldridge; Justin Matthew,9998,0,9999,1
1745795278463,DSC 297,001,958000,Mazumdar; Arya,9998,0,9999,1
1745795279490,EAP 100,A00,905686,Staff,9776,0,9999,223
1745795280518,ECE 45,A01,892618,Staff,0,12,50,50
1745795281543,ECE 109,A01,892620,Staff,0,43,0,0
1745795282569,ECE 111,A01,892719,Staff,0,7,50,50
1745795283596,ECE 197,001,957920,Mercier; Patrick Philip,9992,0,9999,7
1745795284620,ECON 178,A01,907814,Zhu; Ying,28,0,35,7
1745795285685,EDS 115,A00,895312,Staff,41,0,45,4
1745795286712,EDS 117,A01,895337,Staff,30,0,30,0
1745795287739,EDS 125,A00,895341,Jones; Gabrielle Anastasia,43,0,45,2
1745795288766,EDS 128A,A01,895459,Fargason; Sharon Gayle,44,0,45,1
1745795289792,EDS 128B,A01,895543,Pappas; Elizabeth,44,0,45,1
1745795290819,EDS 139,A00,897203,Pappas; Elizabeth,44,0,45,1
1745795290819,EDS 139,B00,897209,Fargason; Sharon Gayle,44,0,45,1
1745795291846,EDS 201,A00,895545,Staff,43,0,45,2
1745795292871,EDS 203,A01,895581,Halter; Christopher P.,43,0,45,2
1745795293900,EDS 204R,A01,895625,Heinzman; Erica M.,43,0,45,2
1745795293900,EDS 204R,B01,895693,Halter; Christopher P.,18,0,45,27
1745795294929,EDS 206R,A00,895694,Fargason; Sharon Gayle,9,0,30,21
1745795294929,EDS 206R,B00,895695,Choi; Bailey Miyeon,20,0,30,10
1745795295957,EDS 250,A00,895697,Hemans; Patricia Ann Benitez,43,0,45,2
1745795296982,EDS 281,A00,895701,Meyerott; Theresa Ann,15,0,15,0
1745795298009,EDS 284,A00,895736,Meyerott; Theresa Ann,15,0,15,0
1745795299037,EDS 286,A00,897210,Fine; Sarah,15,0,15,0
1745795300063,EDS 289C,A01,895770,Daly; Alan J.,15,0,15,0
1745795301090,EDS 290,A00,897211,Hofstetter; Carolyn,15,0,15,0
1745795302117,LIGM 5A,A00,896162,Fischer-Grunski; Eva K,15,0,20,5
1745795303144,LIGM 5B,A00,896260,Fischer-Grunski; Eva K,17,0,20,3
1745795304173,LIGM 5C,A00,896308,Fischer-Grunski; Eva K,18,0,20,2
1745795305199,LIIT 5AS,A00,896313,Carnelos; Chiara,18,0,20,2
1745795306226,LIIT 5BS,A00,896416,Carnelos; Chiara,20,0,20,0
1745795307252,LIIT 5CS,A00,896564,Carnelos; Chiara,20,0,20,0
1745795308284,LISP 5A,A00,896588,Munoz Sanchez; Alicia,4,0,20,16
1745795309313,LISP 5B,A00,896653,Munoz Sanchez; Alicia,10,0,20,10
1745795310341,LISP 5C,A00,896655,Munoz Sanchez; Alicia,4,0,20,16
1745795311371,MAE 197,001,957918,Kleissl; Jan,9998,0,9999,1
1745795312399,MATH 2,A01,957937,Staff,34,0,35,1
1745795313424,MATH 197,001,957876,Kedlaya; Kiran S.,9993,0,9999,6
1745795314452,MCWP 40,A00,892729,Duru; Nur,13,0,20,7
1745795314452,MCWP 40,B00,893304,Montejo; Carolina,20,0,20,0
1745795315480,MCWP 40R,A00,893757,Redela; Pamela Morgan,0,6,20,20
1745795316507,MCWP 50,A00,893758,Morshed; Michael James,2,0,20,18
1745795316507,MCWP 50,B00,893761,Bartulis; Jason Michael,17,0,20,3
1745795317534,MCWP 50R,A00,893766,Compas; Sean Matthew,0,1,20,20
1745795317534,MCWP 50R,B00,893769,Carter; Jennifer A,0,0,20,20
1745795317534,MCWP 50R,C00,893771,Krone; Jarret,0,3,20,20
1745795317534,MCWP 50R,D00,893772,Miller; Elizabeth Deen,3,0,20,17
1745795317534,MCWP 50R,E00,893775,Carter; Andrea L,0,0,20,20
1745795318563,MMW 11R,A01,892721,Herbst; Matthew,11,0,27,16
1745795318563,MMW 11R,A02,892722,Herbst; Matthew,0,0,0,3
1745795319590,MMW 12R,A01,892724,Herbst; Matthew,0,9,16,16
1745795319590,MMW 12R,A02,892725,Herbst; Matthew,0,9,16,16
1745795320616,MMW 13R,A01,892727,Staff,0,4,16,16
1745795320616,MMW 13R,A02,892728,Staff,0,4,16,16
1745795320616,MMW 13R,A03,958032,Staff,0,3,16,16
1745795320616,MMW 13R,A04,958033,Staff,0,2,16,16
1745795320616,MMW 13R,A05,958034,Staff,0,3,16,16
1745795321643,SIO 295LS,A00,894015,Staff,7,0,25,18
1745795322669,SIO 295S,A00,894020,Staff,7,0,25,18
1745795323698,SIOC 290S,B01,958918,Staff,0,0,0,0
1745795324727,SIOC 291S,B01,958922,Staff,0,0,0,0
1745795325753,SOCI 117,A01,895339,Staff,4,0,5,1
1745795326779,WES 237B,A00,894149,Staff,11,0,20,9
1745795328839,AESE 279B,A00,891859,Staff,13,0,35,22
1745795329862,AIP 197,001,891854,Staff,70,0,70,0
1745795330890,ANTH 289S,A00,891856,Gagneux; Pascal,12,0,12,0
1745795331916,BENG 196,001,957946,Engler; Adam J.,9996,0,9999,3
1745795332944,CAT 124RS,A01,956906,Staff,8,0,25,17
1745795333972,CAT 125RS,A01,922013,Staff,8,0,25,17
1745795334999,CLRE 250,A00,891860,Morris; Sheldon,9995,0,9999,4
1745795337056,CLRE 251R,A00,907817,Mehta; Ravindra L.,9994,0,9999,5
1745795338085,CLRE 252,A00,891864,Cuomo; Raphael Eduardo,9993,0,9999,6
1745795339112,CLRE 253,A00,891867,Vaida; Florin,9994,0,9999,5
1745795339112,CLRE 253,B00,907819,Staff,9999,0,9999,0
1745795340140,CLRE 259,A00,891868,Patel; Hemal,9998,0,9999,1
1745795341167,CLRE 260,A00,891872,Cuomo; Raphael Eduardo,9999,0,9999,0
1745795342195,CLRE 297,001,891888,Cuomo; Raphael Eduardo,9999,0,9999,0
1745795343228,CSE 191,A00,958773,Minnes Kemp; Mor Mia,9999,0,9999,0
1745795344259,CSS 201S,A01,892054,Mignozzetti; Umberto,30,0,30,0
1745795345286,CSS 202S,A01,892056,Mignozzetti; Umberto,30,0,30,0
1745795346314,DSC 197,001,956898,Eldridge; Justin Matthew,9998,0,9999,1
1745795347343,DSC 297,001,958000,Mazumdar; Arya,9998,0,9999,1
1745795348369,EAP 100,A00,905686,Staff,9776,0,9999,223
1745795349395,ECE 45,A01,892618,Staff,0,12,50,50
1745795350420,ECE 109,A01,892620,Staff,0,43,0,0
1745795351447,ECE 111,A01,892719,Staff,0,7,50,50
1745795352472,ECE 197,001,957920,Mercier; Patrick Philip,9992,0,9999,7
1745795353499,ECON 178,A01,907814,Zhu; Ying,28,0,35,7
1745795354540,EDS 115,A00,895312,Staff,41,0,45,4
1745795355567,EDS 117,A01,895337,Staff,30,0,30,0
1745795356594,EDS 125,A00,895341,Jones; Gabrielle Anastasia,43,0,45,2
1745795357620,EDS 128A,A01,895459,Fargason; Sharon Gayle,44,0,45,1
1745795358647,EDS 128B,A01,895543,Pappas; Elizabeth,44,0,45,1
1745795359675,EDS 139,A00,897203,Pappas; Elizabeth,44,0,45,1
1745795359675,EDS 139,B00,897209,Fargason; Sharon Gayle,44,0,45,1
1745795360702,EDS 201,A00,895545,Staff,43,0,45,2
1745795361731,EDS 203,A01,895581,Halter; Christopher P.,43,0,45,2
1745795362759,EDS 204R,A01,895625,Heinzman; Erica M.,43,0,45,2
1745795362759,EDS 204R,B01,895693,Halter; Christopher P.,18,0,45,27
1745795363786,EDS 206R,A00,895694,Fargason; Sharon Gayle,9,0,30,21
1745795363786,EDS 206R,B00,895695,Choi; Bailey Miyeon,20,0,30,10
1745795364811,EDS 250,A00,895697,Hemans; Patricia Ann Benitez,43,0,45,2
1745795365837,EDS 281,A00,895701,Meyerott; Theresa Ann,15,0,15,0
1745795366863,EDS 284,A00,895736,Meyerott; Theresa Ann,15,0,15,0
1745795367889,EDS 286,A00,897210,Fine; Sarah,15,0,15,0
1745795368915,EDS 289C,A01,895770,Daly; Alan J.,15,0,15,0
1745795369943,EDS 290,A00,897211,Hofstetter; Carolyn,15,0,15,0
1745795370973,LIGM 5A,A00,896162,Fischer-Grunski; Eva K,15,0,20,5
1745795372001,LIGM 5B,A00,896260,Fischer-Grunski; Eva K,17,0,20,3
1745795373030,LIGM 5C,A00,896308,Fischer-Grunski; Eva K,18,0,20,2
1745795374055,LIIT 5AS,A00,896313,Carnelos; Chiara,18,0,20,2
1745795375083,LIIT 5BS,A00,896416,Carnelos; Chiara,20,0,20,0
1745795376108,LIIT 5CS,A00,896564,Carnelos; Chiara,20,0,20,0
1745795377140,LISP 5A,A00,896588,Munoz Sanchez; Alicia,4,0,20,16
1745795378170,LISP 5B,A00,896653,Munoz Sanchez; Alicia,10,0,20,10
1745795379200,LISP 5C,A00,896655,Munoz Sanchez; Alicia,4,0,20,16
1745795380227,MAE 197,001,957918,Kleissl; Jan,9998,0,9999,1
1745795381252,MATH 2,A01,957937,Staff,34,0,35,1
1745795382281,MATH 197,001,957876,Kedlaya; Kiran S.,9993,0,9999,6
1745795383310,MCWP 40,A00,892729,Duru; Nur,13,0,20,7
1745795383310,MCWP 40,B00,893304,Montejo; Carolina,20,0,20,0
1745795384336,MCWP 40R,A00,893757,Redela; Pamela Morgan,0,6,20,20
1745795385362,MCWP 50,A00,893758,Morshed; Michael James,2,0,20,18
1745795385362,MCWP 50,B00,893761,Bartulis; Jason Michael,17,0,20,3
1745795386389,MCWP 50R,A00,893766,Compas; Sean Matthew,0,1,20,20
1745795386389,MCWP 50R,B00,893769,Carter; Jennifer A,0,0,20,20
1745795386389,MCWP 50R,C00,893771,Krone; Jarret,0,3,20,20
1745795386389,MCWP 50R,D00,893772,Miller; Elizabeth Deen,3,0,20,17
1745795386389,MCWP 50R,E00,893775,Carter; Andrea L,0,0,20,20
1745795387416,MMW 11R,A01,892721,Herbst; Matthew,11,0,27,16
1745795387416,MMW 11R,A02,892722,Herbst; Matthew,0,0,0,3
1745795388446,MMW 12R,A01,892724,Herbst; Matthew,0,9,16,16
1745795388446,MMW 12R,A02,892725,Herbst; Matthew,0,9,16,16
1745795389475,MMW 13R,A01,892727,Staff,0,4,16,16
1745795389475,MMW 13R,A02,892728,Staff,0,4,16,16
1745795389475,MMW 13R,A03,958032,Staff,0,3,16,16
1745795389475,MMW 13R,A04,958033,Staff,0,2,16,16
1745795389475,MMW 13R,A05,958034,Staff,0,3,16,16
1745795390503,SIO 295LS,A00,894015,Staff,7,0,25,18
1745795391531,SIO 295S,A00,894020,Staff,7,0,25,18
1745795392561,SIOC 290S,B01,958918,Staff,0,0,0,0
1745795393592,SIOC 291S,B01,958922,Staff,0,0,0,0
1745795394619,SOCI 117,A01,895339,Staff,4,0,5,1
1745795395649,WES 237B,A00,894149,Staff,11,0,20,9
1745795397707,AESE 279B,A00,891859,Staff,13,0,35,22
1745795398733,AIP 197,001,891854,Staff,70,0,70,0
1745795399759,ANTH 289S,A00,891856,Gagneux; Pascal,12,0,12,0
1745795400784,BENG 196,001,957946,Engler; Adam J.,9996,0,9999,3
1745795401812,CAT 124RS,A01,956906,Staff,8,0,25,17
1745795402841,CAT 125RS,A01,922013,Staff,8,0,25,17
1745795403869,CLRE 250,A00,891860,Morris; Sheldon,9995,0,9999,4
1745795405928,CLRE 251R,A00,907817,Mehta; Ravindra L.,9994,0,9999,5
1745795406957,CLRE 252,A00,891864,Cuomo; Raphael Eduardo,9993,0,9999,6
1745795407987,CLRE 253,A00,891867,Vaida; Florin,9994,0,9999,5
1745795407987,CLRE 253,B00,907819,Staff,9999,0,9999,0
1745795409013,CLRE 259,A00,891868,Patel; Hemal,9998,0,9999,1
1745795410040,CLRE 260,A00,891872,Cuomo; Raphael Eduardo,9999,0,9999,0
1745795411066,CLRE 297,001,891888,Cuomo; Raphael Eduardo,9999,0,9999,0
1745795412096,CSE 191,A00,958773,Minnes Kemp; Mor Mia,9999,0,9999,0
1745795413124,CSS 201S,A01,892054,Mignozzetti; Umberto,30,0,30,0
1745795414151,CSS 202S,A01,892056,Mignozzetti; Umberto,30,0,30,0
1745795415177,DSC 197,001,956898,Eldridge; Justin Matthew,9998,0,9999,1
1745795416204,DSC 297,001,958000,Mazumdar; Arya,9998,0,9999,1
1745795417230,EAP 100,A00,905686,Staff,9776,0,9999,223
1745795418256,ECE 45,A01,892618,Staff,0,12,50,50
1745795419283,ECE 109,A01,892620,Staff,0,43,0,0
1745795420310,ECE 111,A01,892719,Staff,0,7,50,50
1745795421352,ECE 197,001,957920,Mercier; Patrick Philip,9992,0,9999,7
1745795422392,ECON 178,A01,907814,Zhu; Ying,28,0,35,7
1745795423420,EDS 115,A00,895312,Staff,41,0,45,4
1745795424450,EDS 117,A01,895337,Staff,30,0,30,0
1745795425477,EDS 125,A00,895341,Jones; Gabrielle Anastasia,43,0,45,2
1745795426503,EDS 128A,A01,895459,Fargason; Sharon Gayle,44,0,45,1
1745795427528,EDS 128B,A01,895543,Pappas; Elizabeth,44,0,45,1
1745795428551,EDS 139,A00,897203,Pappas; Elizabeth,44,0,45,1
1745795428551,EDS 139,B00,897209,Fargason; Sharon Gayle,44,0,45,1
1745795429575,EDS 201,A00,895545,Staff,43,0,45,2
1745795430602,EDS 203,A01,895581,Halter; Christopher P.,43,0,45,2
1745795431627,EDS 204R,A01,895625,Heinzman; Erica M.,43,0,45,2
1745795431627,EDS 204R,B01,895693,Halter; Christopher P.,18,0,45,27
1745795432652,EDS 206R,A00,895694,Fargason; Sharon Gayle,9,0,30,21
1745795432652,EDS 206R,B00,895695,Choi; Bailey Miyeon,20,0,30,10
1745795433678,EDS 250,A00,895697,Hemans; Patricia Ann Benitez,43,0,45,2
1745795434707,EDS 281,A00,895701,Meyerott; Theresa Ann,15,0,15,0
1745795435734,EDS 284,A00,895736,Meyerott; Theresa Ann,15,0,15,0
1745795436759,EDS 286,A00,897210,Fine; Sarah,15,0,15,0
1745795437784,EDS 289C,A01,895770,Daly; Alan J.,15,0,15,0
1745795438811,EDS 290,A00,897211,Hofstetter; Carolyn,15,0,15,0
1745795439840,LIGM 5A,A00,896162,Fischer-Grunski; Eva K,15,0,20,5
1745795440870,LIGM 5B,A00,896260,Fischer-Grunski; Eva K,17,0,20,3
1745795441897,LIGM 5C,A00,896308,Fischer-Grunski; Eva K,18,0,20,2
1745795442926,LIIT 5AS,A00,896313,Carnelos; Chiara,18,0,20,2
1745795443951,LIIT 5BS,A00,896416,Carnelos; Chiara,20,0,20,0
1745795444980,LIIT 5CS,A00,896564,Carnelos; Chiara,20,0,20,0
1745795446007,LISP 5A,A00,896588,Munoz Sanchez; Alicia,4,0,20,16
1745795447037,LISP 5B,A00,896653,Munoz Sanchez; Alicia,10,0,20,10
1745795448066,LISP 5C,A00,896655,Munoz Sanchez; Alicia,4,0,20,16
1745795449093,MAE 197,001,957918,Kleissl; Jan,9998,0,9999,1
1745795450121,MATH 2,A01,957937,Staff,34,0,35,1
1745795451150,MATH 197,001,957876,Kedlaya; Kiran S.,9993,0,9999,6
1745795452179,MCWP 40,A00,892729,Duru; Nur,13,0,20,7
1745795452179,MCWP 40,B00,893304,Montejo; Carolina,20,0,20,0
1745795453203,MCWP 40R,A00,893757,Redela; Pamela Morgan,0,6,20,20
1745795454230,MCWP 50,A00,893758,Morshed; Michael James,2,0,20,18
1745795454230,MCWP 50,B00,893761,Bartulis; Jason Michael,17,0,20,3
1745795455259,MCWP 50R,A00,893766,Compas; Sean Matthew,0,1,20,20
1745795455259,MCWP 50R,B00,893769,Carter; Jennifer A,0,0,20,20
1745795455259,MCWP 50R,C00,893771,Krone; Jarret,0,3,20,20
1745795455259,MCWP 50R,D00,893772,Miller; Elizabeth Deen,3,0,20,17
1745795455259,MCWP 50R,E00,893775,Carter; Andrea L,0,0,20,20
1745795456287,MMW 11R,A01,892721,Herbst; Matthew,11,0,27,16
1745795456287,MMW 11R,A02,892722,Herbst; Matthew,0,0,0,3
1745795457315,MMW 12R,A01,892724,Herbst; Matthew,0,9,16,16
1745795457315,MMW 12R,A02,892725,Herbst; Matthew,0,9,16,16
1745795458341,MMW 13R,A01,892727,Staff,0,4,16,16
1745795458341,MMW 13R,A02,892728,Staff,0,4,16,16
1745795458341,MMW 13R,A03,958032,Staff,0,3,16,16
1745795458341,MMW 13R,A04,958033,Staff,0,2,16,16
1745795458341,MMW 13R,A05,958034,Staff,0,3,16,16
1745795459367,SIO 295LS,A00,894015,Staff,7,0,25,18
1745795460395,SIO 295S,A00,894020,Staff,7,0,25,18
1745795461422,SIOC 290S,B01,958918,Staff,0,0,0,0
1745795462458,SIOC 291S,B01,958922,Staff,0,0,0,0
1745795463484,SOCI 117,A01,895339,Staff,4,0,5,1
1745795464510,WES 237B,A00,894149,Staff,11,0,20,9
1745795466577,AESE 279B,A00,891859,Staff,13,0,35,22
1745795467603,AIP 197,001,891854,Staff,70,0,70,0
1745795468630,ANTH 289S,A00,891856,Gagneux; Pascal,12,0,12,0
1745795469655,BENG 196,001,957946,Engler; Adam J.,9996,0,9999,3
1745795470681,CAT 124RS,A01,956906,Staff,8,0,25,17
1745795471709,CAT 125RS,A01,922013,Staff,8,0,25,17
1745795472734,CLRE 250,A00,891860,Morris; Sheldon,9995,0,9999,4
1745795474790,CLRE 251R,A00,907817,Mehta; Ravindra L.,9994,0,9999,5
1745795475815,CLRE 252,A00,891864,Cuomo; Raphael Eduardo,9993,0,9999,6
1745795476843,CLRE 253,A00,891867,Vaida; Florin,9994,0,9999,5
1745795476843,CLRE 253,B00,907819,Staff,9999,0,9999,0
1745795477869,CLRE 259,A00,891868,Patel; Hemal,9998,0,9999,1
1745795478896,CLRE 260,A00,891872,Cuomo; Raphael Eduardo,9999,0,9999,0
1745795479922,CLRE 297,001,891888,Cuomo; Raphael Eduardo,9999,0,9999,0
1745795480946,CSE 191,A00,958773,Minnes Kemp; Mor Mia,9999,0,9999,0
1745795481976,CSS 201S,A01,892054,Mignozzetti; Umberto,30,0,30,0
1745795483003,CSS 202S,A01,892056,Mignozzetti; Umberto,30,0,30,0
1745795484030,DSC 197,001,956898,Eldridge; Justin Matthew,9998,0,9999,1
1745795485057,DSC 297,001,958000,Mazumdar; Arya,9998,0,9999,1
1745795486083,EAP 100,A00,905686,Staff,9776,0,9999,223
1745795487112,ECE 45,A01,892618,Staff,0,12,50,50
1745795488137,ECE 109,A01,892620,Staff,0,43,0,0
1745795489164,ECE 111,A01,892719,Staff,0,7,50,50
1745795490194,ECE 197,001,957920,Mercier; Patrick Philip,9992,0,9999,7
1745795491223,ECON 178,A01,907814,Zhu; Ying,28,0,35,7
1745795492248,EDS 115,A00,895312,Staff,41,0,45,4
1745795493276,EDS 117,A01,895337,Staff,30,0,30,0
1745795494302,EDS 125,A00,895341,Jones; Gabrielle Anastasia,43,0,45,2
1745795495327,EDS 128A,A01,895459,Fargason; Sharon Gayle,44,0,45,1
1745795496353,EDS 128B,A01,895543,Pappas; Elizabeth,44,0,45,1
1745795497379,EDS 139,A00,897203,Pappas; Elizabeth,44,0,45,1
1745795497379,EDS 139,B00,897209,Fargason; Sharon Gayle,44,0,45,1
1745795498408,EDS 201,A00,895545,Staff,43,0,45,2
1745795499434,EDS 203,A01,895581,Halter; Christopher P.,43,0,45,2
1745795500458,EDS 204R,A01,895625,Heinzman; Erica M.,43,0,45,2
1745795500458,EDS 204R,B01,895693,Halter; Christopher P.,18,0,45,27
1745795501486,EDS 206R,A00,895694,Fargason; Sharon Gayle,9,0,30,21
1745795501486,EDS 206R,B00,895695,Choi; Bailey Miyeon,20,0,30,10
1745795502511,EDS 250,A00,895697,Hemans; Patricia Ann Benitez,43,0,45,2
1745795503539,EDS 281,A00,895701,Meyerott; Theresa Ann,15,0,15,0
1745795504565,EDS 284,A00,895736,Meyerott; Theresa Ann,15,0,15,0
1745795505589,EDS 286,A00,897210,Fine; Sarah,15,0,15,0
1745795506615,EDS 289C,A01,895770,Daly; Alan J.,15,0,15,0
1745795507641,EDS 290,A00,897211,Hofstetter; Carolyn,15,0,15,0
1745795508666,LIGM 5A,A00,896162,Fischer-Grunski; Eva K,15,0,20,5
1745795509690,LIGM 5B,A00,896260,Fischer-Grunski; Eva K,17,0,20,3
1745795510721,LIGM 5C,A00,896308,Fischer-Grunski; Eva K,18,0,20,2
1745795511747,LIIT 5AS,A00,896313,Carnelos; Chiara,18,0,20,2
1745795512773,LIIT 5BS,A00,896416,Carnelos; Chiara,20,0,20,0
1745795513798,LIIT 5CS,A00,896564,Carnelos; Chiara,20,0,20,0
1745795514826,LISP 5A,A00,896588,Munoz Sanchez; Alicia,4,0,20,16
1745795515853,LISP 5B,A00,896653,Munoz Sanchez; Alicia,10,0,20,10
1745795516878,LISP 5C,A00,896655,Munoz Sanchez; Alicia,4,0,20,16
1745795517905,MAE 197,001,957918,Kleissl; Jan,9998,0,9999,1
1745795518930,MATH 2,A01,957937,Staff,34,0,35,1
1745795519958,MATH 197,001,957876,Kedlaya; Kiran S.,9993,0,9999,6
1745795520984,MCWP 40,A00,892729,Duru; Nur,13,0,20,7
1745795520984,MCWP 40,B00,893304,Montejo; Carolina,20,0,20,0
1745795522010,MCWP 40R,A00,893757,Redela; Pamela Morgan,0,6,20,20
1745795523039,MCWP 50,A00,893758,Morshed; Michael James,2,0,20,18
1745795523039,MCWP 50,B00,893761,Bartulis; Jason Michael,17,0,20,3
1745795524065,MCWP 50R,A00,893766,Compas; Sean Matthew,0,1,20,20
1745795524065,MCWP 50R,B00,893769,Carter; Jennifer A,0,0,20,20
1745795524065,MCWP 50R,C00,893771,Krone; Jarret,0,3,20,20
1745795524065,MCWP 50R,D00,893772,Miller; Elizabeth Deen,3,0,20,17
1745795524065,MCWP 50R,E00,893775,Carter; Andrea L,0,0,20,20
1745795525091,MMW 11R,A01,892721,Herbst; Matthew,11,0,27,16
1745795525091,MMW 11R,A02,892722,Herbst; Matthew,0,0,0,3
1745795526116,MMW 12R,A01,892724,Herbst; Matthew,0,9,16,16
1745795526116,MMW 12R,A02,892725,Herbst; Matthew,0,9,16,16
1745795527144,MMW 13R,A01,892727,Staff,0,4,16,16
1745795527144,MMW 13R,A02,892728,Staff,0,4,16,16
1745795527144,MMW 13R,A03,958032,Staff,0,3,16,16
1745795527144,MMW 13R,A04,958033,Staff,0,2,16,16
1745795527144,MMW 13R,A05,958034,Staff,0,3,16,16
1745795528172,SIO 295LS,A00,894015,Staff,7,0,25,18
1745795529198,SIO 295S,A00,894020,Staff,7,0,25,18
1745795530224,SIOC 290S,B01,958918,Staff,0,0,0,0
1745795531251,SIOC 291S,B01,958922,Staff,0,0,0,0
1745795532276,SOCI 117,A01,895339,Staff,4,0,5,1
1745795533300,WES 237B,A00,894149,Staff,11,0,20,9
1745795535370,AESE 279B,A00,891859,Staff,13,0,35,22
1745795536423,AIP 197,001,891854,Staff,70,0,70,0
1745795537451,ANTH 289S,A00,891856,Gagneux; Pascal,12,0,12,0
1745795538479,BENG 196,001,957946,Engler; Adam J.,9996,0,9999,3
1745795539505,CAT 124RS,A01,956906,Staff,8,0,25,17
1745795540532,CAT 125RS,A01,922013,Staff,8,0,25,17
1745795541560,CLRE 250,A00,891860,Morris; Sheldon,9995,0,9999,4
1745795543613,CLRE 251R,A00,907817,Mehta; Ravindra L.,9994,0,9999,5
1745795544642,CLRE 252,A00,891864,Cuomo; Raphael Eduardo,9993,0,9999,6
1745795545670,CLRE 253,A00,891867,Vaida; Florin,9994,0,9999,5
1745795545670,CLRE 253,B00,907819,Staff,9999,0,9999,0
1745795546699,CLRE 259,A00,891868,Patel; Hemal,9998,0,9999,1
1745795547724,CLRE 260,A00,891872,Cuomo; Raphael Eduardo,9999,0,9999,0
1745795548750,CLRE 297,001,891888,Cuomo; Raphael Eduardo,9999,0,9999,0
1745795549778,CSE 191,A00,958773,Minnes Kemp; Mor Mia,9999,0,9999,0
1745795550806,CSS 201S,A01,892054,Mignozzetti; Umberto,30,0,30,0
1745795551835,CSS 202S,A01,892056,Mignozzetti; Umberto,30,0,30,0
1745795552862,DSC 197,001,956898,Eldridge; Justin Matthew,9998,0,9999,1
1745795553887,DSC 297,001,958000,Mazumdar; Arya,9998,0,9999,1
1745795554912,EAP 100,A00,905686,Staff,9776,0,9999,223
1745795555937,ECE 45,A01,892618,Staff,0,12,50,50
1745795556966,ECE 109,A01,892620,Staff,0,43,0,0
1745795557991,ECE 111,A01,892719,Staff,0,7,50,50
1745795559018,ECE 197,001,957920,Mercier; Patrick Philip,9992,0,9999,7
1745795560047,ECON 178,A01,907814,Zhu; Ying,28,0,35,7
1745795561073,EDS 115,A00,895312,Staff,41,0,45,4
1745795562099,EDS 117,A01,895337,Staff,30,0,30,0
1745795563127,EDS 125,A00,895341,Jones; Gabrielle Anastasia,43,0,45,2
1745795564151,EDS 128A,A01,895459,Fargason; Sharon Gayle,44,0,45,1
1745795565177,EDS 128B,A01,895543,Pappas; Elizabeth,44,0,45,1
1745795566226,EDS 139,A00,897203,Pappas; Elizabeth,44,0,45,1
1745795566226,EDS 139,B00,897209,Fargason; Sharon Gayle,44,0,45,1
1745795567253,EDS 201,A00,895545,Staff,43,0,45,2
1745795568279,EDS 203,A01,895581,Halter; Christopher P.,43,0,45,2
1745795569304,EDS 204R,A01,895625,Heinzman; Erica M.,43,0,45,2
1745795569304,EDS 204R,B01,895693,Halter; Christopher P.,18,0,45,27
1745795570332,EDS 206R,A00,895694,Fargason; Sharon Gayle,9,0,30,21
1745795570332,EDS 206R,B00,895695,Choi; Bailey Miyeon,20,0,30,10
1745795571361,EDS 250,A00,895697,Hemans; Patricia Ann Benitez,43,0,45,2
1745795572387,EDS 281,A00,895701,Meyerott; Theresa Ann,15,0,15,0
1745795573413,EDS 284,A00,895736,Meyerott; Theresa Ann,15,0,15,0
1745795574441,EDS 286,A00,897210,Fine; Sarah,15,0,15,0
1745795575467,EDS 289C,A01,895770,Daly; Alan J.,15,0,15,0
1745795576492,EDS 290,A00,897211,Hofstetter; Carolyn,15,0,15,0
1745795577517,LIGM 5A,A00,896162,Fischer-Grunski; Eva K,15,0,20,5
1745795578548,LIGM 5B,A00,896260,Fischer-Grunski; Eva K,17,0,20,3
1745795579574,LIGM 5C,A00,896308,Fischer-Grunski; Eva K,18,0,20,2
1745795580604,LIIT 5AS,A00,896313,Carnelos; Chiara,18,0,20,2
1745795581632,LIIT 5BS,A00,896416,Carnelos; Chiara,20,0,20,0
1745795582660,LIIT 5CS,A00,896564,Carnelos; Chiara,20,0,20,0
1745795583686,LISP 5A,A00,896588,Munoz Sanchez; Alicia,4,0,20,16
1745795584713,LISP 5B,A00,896653,Munoz Sanchez; Alicia,10,0,20,10
1745795585740,LISP 5C,A00,896655,Munoz Sanchez; Alicia,4,0,20,16
1745795586766,MAE 197,001,957918,Kleissl; Jan,9998,0,9999,1
1745795587790,MATH 2,A01,957937,Staff,34,0,35,1
1745795588814,MATH 197,001,957876,Kedlaya; Kiran S.,9993,0,9999,6
1745795589841,MCWP 40,A00,892729,Duru; Nur,13,0,20,7
1745795589841,MCWP 40,B00,893304,Montejo; Carolina,20,0,20,0
1745795590866,MCWP 40R,A00,893757,Redela; Pamela Morgan,0,6,20,20
1745795591892,MCWP 50,A00,893758,Morshed; Michael James,2,0,20,18
1745795591892,MCWP 50,B00,893761,Bartulis; Jason Michael,17,0,20,3
1745795592918,MCWP 50R,A00,893766,Compas; Sean Matthew,0,1,20,20
1745795592918,MCWP 50R,B00,893769,Carter; Jennifer A,0,0,20,20
1745795592918,MCWP 50R,C00,893771,Krone; Jarret,0,3,20,20
1745795592918,MCWP 50R,D00,893772,Miller; Elizabeth Deen,3,0,20,17
1745795592918,MCWP 50R,E00,893775,Carter; Andrea L,0,0,20,20
1745795593944,MMW 11R,A01,892721,Herbst; Matthew,11,0,27,16
1745795593944,MMW 11R,A02,892722,Herbst; Matthew,0,0,0,3
1745795594970,MMW 12R,A01,892724,Herbst; Matthew,0,9,16,16
1745795594970,MMW 12R,A02,892725,Herbst; Matthew,0,9,16,16
1745795595994,MMW 13R,A01,892727,Staff,0,4,16,16
1745795595994,MMW 13R,A02,892728,Staff,0,4,16,16
1745795595994,MMW 13R,A03,958032,Staff,0,3,16,16
1745795595994,MMW 13R,A04,958033,Staff,0,2,16,16
1745795595994,MMW 13R,A05,958034,Staff,0,3,16,16
1745795597021,SIO 295LS,A00,894015,Staff,7,0,25,18
1745795598046,SIO 295S,A00,894020,Staff,7,0,25,18
1745795599076,SIOC 290S,B01,958918,Staff,0,0,0,0
1745795600103,SIOC 291S,B01,958922,Staff,0,0,0,0
1745795601129,SOCI 117,A01,895339,Staff,4,0,5,1
1745795602157,WES 237B,A00,894149,Staff,11,0,20,9
1745795604225,AESE 279B,A00,891859,Staff,13,0,35,22
1745795605253,AIP 197,001,891854,Staff,70,0,70,0
1745795606279,ANTH 289S,A00,891856,Gagneux; Pascal,12,0,12,0
1745795607306,BENG 196,001,957946,Engler; Adam J.,9996,0,9999,3
1745795608333,CAT 124RS,A01,956906,Staff,8,0,25,17
1745795609359,CAT 125RS,A01,922013,Staff,8,0,25,17
1745795610388,CLRE 250,A00,891860,Morris; Sheldon,9995,0,9999,4
1745795612442,CLRE 251R,A00,907817,Mehta; Ravindra L.,9994,0,9999,5
1745795613467,CLRE 252,A00,891864,Cuomo; Raphael Eduardo,9993,0,9999,6
1745795614493,CLRE 253,A00,891867,Vaida; Florin,9994,0,9999,5
1745795614493,CLRE 253,B00,907819,Staff,9999,0,9999,0
1745795615519,CLRE 259,A00,891868,Patel; Hemal,9998,0,9999,1
1745795616547,CLRE 260,A00,891872,Cuomo; Raphael Eduardo,9999,0,9999,0
1745795617573,CLRE 297,001,891888,Cuomo; Raphael Eduardo,9999,0,9999,0
1745795618599,CSE 191,A00,958773,Minnes Kemp; Mor Mia,9999,0,9999,0
1745795619625,CSS 201S,A01,892054,Mignozzetti; Umberto,30,0,30,0
1745795620648,CSS 202S,A01,892056,Mignozzetti; Umberto,30,0,30,0
1745795621675,DSC 197,001,956898,Eldridge; Justin Matthew,9998,0,9999,1
1745795622701,DSC 297,001,958000,Mazumdar; Arya,9998,0,9999,1
1745795623726,EAP 100,A00,905686,Staff,9776,0,9999,223
1745795624753,ECE 45,A01,892618,Staff,0,12,50,50
1745795625781,ECE 109,A01,892620,Staff,0,43,0,0
1745795626809,ECE 111,A01,892719,Staff,0,7,50,50
1745795627837,ECE 197,001,957920,Mercier; Patrick Philip,9992,0,9999,7
1745795628867,ECON 178,A01,907814,Zhu; Ying,28,0,35,7
1745795629894,EDS 115,A00,895312,Staff,41,0,45,4
1745795630920,EDS 117,A01,895337,Staff,30,0,30,0
1745795631949,EDS 125,A00,895341,Jones; Gabrielle Anastasia,43,0,45,2
1745795632979,EDS 128A,A01,895459,Fargason; Sharon Gayle,44,0,45,1
1745795634005,EDS 128B,A01,895543,Pappas; Elizabeth,44,0,45,1
1745795635032,EDS 139,A00,897203,Pappas; Elizabeth,44,0,45,1
1745795635032,EDS 139,B00,897209,Fargason; Sharon Gayle,44,0,45,1
1745795636059,EDS 201,A00,895545,Staff,43,0,45,2
1745795637089,EDS 203,A01,895581,Halter; Christopher P.,43,0,45,2
1745795638116,EDS 204R,A01,895625,Heinzman; Erica M.,43,0,45,2
1745795638116,EDS 204R,B01,895693,Halter; Christopher P.,18,0,45,27
1745795639143,EDS 206R,A00,895694,Fargason; Sharon Gayle,9,0,30,21
1745795639143,EDS 206R,B00,895695,Choi; Bailey Miyeon,20,0,30,10
1745795640170,EDS 250,A00,895697,Hemans; Patricia Ann Benitez,43,0,45,2
1745795641195,EDS 281,A00,895701,Meyerott; Theresa Ann,15,0,15,0
1745795642226,EDS 284,A00,895736,Meyerott; Theresa Ann,15,0,15,0
1745795643252,EDS 286,A00,897210,Fine; Sarah,15,0,15,0
1745795644280,EDS 289C,A01,895770,Daly; Alan J.,15,0,15,0
1745795645309,EDS 290,A00,897211,Hofstetter; Carolyn,15,0,15,0
1745795646334,LIGM 5A,A00,896162,Fischer-Grunski; Eva K,15,0,20,5
1745795647364,LIGM 5B,A00,896260,Fischer-Grunski; Eva K,17,0,20,3
1745795648390,LIGM 5C,A00,896308,Fischer-Grunski; Eva K,18,0,20,2
1745795649415,LIIT 5AS,A00,896313,Carnelos; Chiara,18,0,20,2
1745795650442,LIIT 5BS,A00,896416,Carnelos; Chiara,20,0,20,0
1745795651468,LIIT 5CS,A00,896564,Carnelos; Chiara,20,0,20,0
1745795652494,LISP 5A,A00,896588,Munoz Sanchez; Alicia,4,0,20,16
1745795653520,LISP 5B,A00,896653,Munoz Sanchez; Alicia,10,0,20,10
1745795654547,LISP 5C,A00,896655,Munoz Sanchez; Alicia,4,0,20,16
1745795655575,MAE 197,001,957918,Kleissl; Jan,9998,0,9999,1
1745795656602,MATH 2,A01,957937,Staff,34,0,35,1
1745795657654,MATH 197,001,957876,Kedlaya; Kiran S.,9993,0,9999,6
1745795658681,MCWP 40,A00,892729,Duru; Nur,13,0,20,7
1745795658681,MCWP 40,B00,893304,Montejo; Carolina,20,0,20,0
1745795659708,MCWP 40R,A00,893757,Redela; Pamela Morgan,0,6,20,20
1745795660734,MCWP 50,A00,893758,Morshed; Michael James,2,0,20,18
1745795660734,MCWP 50,B00,893761,Bartulis; Jason Michael,17,0,20,3
1745795661759,MCWP 50R,A00,893766,Compas; Sean Matthew,0,1,20,20
1745795661759,MCWP 50R,B00,893769,Carter; Jennifer A,0,0,20,20
1745795661759,MCWP 50R,C00,893771,Krone; Jarret,0,3,20,20
1745795661759,MCWP 50R,D00,893772,Miller; Elizabeth Deen,3,0,20,17
1745795661759,MCWP 50R,E00,893775,Carter; Andrea L,0,0,20,20
1745795662785,MMW 11R,A01,892721,Herbst; Matthew,11,0,27,16
1745795662785,MMW 11R,A02,892722,Herbst; Matthew,0,0,0,3
1745795663814,MMW 12R,A01,892724,Herbst; Matthew,0,9,16,16
1745795663814,MMW 12R,A02,892725,Herbst; Matthew,0,9,16,16
1745795664844,MMW 13R,A01,892727,Staff,0,4,16,16
1745795664844,MMW 13R,A02,892728,Staff,0,4,16,16
1745795664844,MMW 13R,A03,958032,Staff,0,3,16,16
1745795664844,MMW 13R,A04,958033,Staff,0,2,16,16
1745795664844,MMW 13R,A05,958034,Staff,0,3,16,16
1745795665872,SIO 295LS,A00,894015,Staff,7,0,25,18
1745795666899,SIO 295S,A00,894020,Staff,7,0,25,18
1745795667925,SIOC 290S,B01,958918,Staff,0,0,0,0
1745795668952,SIOC 291S,B01,958922,Staff,0,0,0,0
1745795669979,SOCI 117,A01,895339,Staff,4,0,5,1
1745795671006,WES 237B,A00,894149,Staff,11,0,20,9
1745795673060,AESE 279B,A00,891859,Staff,13,0,35,22
1745795674087,AIP 197,001,891854,Staff,70,0,70,0
1745795675114,ANTH 289S,A00,891856,Gagneux; Pascal,12,0,12,0
1745795676140,BENG 196,001,957946,Engler; Adam J.,9996,0,9999,3
1745795677166,CAT 124RS,A01,956906,Staff,8,0,25,17
1745795678193,CAT 125RS,A01,922013,Staff,8,0,25,17
1745795679222,CLRE 250,A00,891860,Morris; Sheldon,9995,0,9999,4
1745795681276,CLRE 251R,A00,907817,Mehta; Ravindra L.,9994,0,9999,5
1745795682303,CLRE 252,A00,891864,Cuomo; Raphael Eduardo,9993,0,9999,6
1745795683332,CLRE 253,A00,891867,Vaida; Florin,9994,0,9999,5
1745795683332,CLRE 253,B00,907819,Staff,9999,0,9999,0
1745795684357,CLRE 259,A00,891868,Patel; Hemal,9998,0,9999,1
1745795685382,CLRE 260,A00,891872,Cuomo; Raphael Eduardo,9999,0,9999,0
1745795686409,CLRE 297,001,891888,Cuomo; Raphael Eduardo,9999,0,9999,0
1745795687436,CSE 191,A00,958773,Minnes Kemp; Mor Mia,9999,0,9999,0
1745795688465,CSS 201S,A01,892054,Mignozzetti; Umberto,30,0,30,0
1745795689494,CSS 202S,A01,892056,Mignozzetti; Umberto,30,0,30,0
1745795690522,DSC 197,001,956898,Eldridge; Justin Matthew,9998,0,9999,1
1745795691547,DSC 297,001,958000,Mazumdar; Arya,9998,0,9999,1
1745795692573,EAP 100,A00,905686,Staff,9776,0,9999,223
1745795693599,ECE 45,A01,892618,Staff,0,12,50,50
1745795694626,ECE 109,A01,892620,Staff,0,43,0,0
1745795695651,ECE 111,A01,892719,Staff,0,7,50,50
1745795696680,ECE 197,001,957920,Mercier; Patrick Philip,9992,0,9999,7
1745795697705,ECON 178,A01,907814,Zhu; Ying,28,0,35,7
1745795698729,EDS 115,A00,895312,Staff,41,0,45,4
1745795699756,EDS 117,A01,895337,Staff,30,0,30,0
1745795700780,EDS 125,A00,895341,Jones; Gabrielle Anastasia,43,0,45,2
1745795701808,EDS 128A,A01,895459,Fargason; Sharon Gayle,44,0,45,1
1745795702834,EDS 128B,A01,895543,Pappas; Elizabeth,44,0,45,1
1745795703860,EDS 139,A00,897203,Pappas; Elizabeth,44,0,45,1
1745795703860,EDS 139,B00,897209,Fargason; Sharon Gayle,44,0,45,1
1745795704889,EDS 201,A00,895545,Staff,43,0,45,2
1745795705915,EDS 203,A01,895581,Halter; Christopher P.,43,0,45,2
1745795706944,EDS 204R,A01,895625,Heinzman; Erica M.,43,0,45,2
1745795706944,EDS 204R,B01,895693,Halter; Christopher P.,18,0,45,27
1745795707971,EDS 206R,A00,895694,Fargason; Sharon Gayle,9,0,30,21
1745795707971,EDS 206R,B00,895695,Choi; Bailey Miyeon,20,0,30,10
1745795708996,EDS 250,A00,895697,Hemans; Patricia Ann Benitez,43,0,45,2
1745795710022,EDS 281,A00,895701,Meyerott; Theresa Ann,15,0,15,0
1745795711051,EDS 284,A00,895736,Meyerott; Theresa Ann,15,0,15,0
1745795712077,EDS 286,A00,897210,Fine; Sarah,15,0,15,0
1745795713105,EDS 289C,A01,895770,Daly; Alan J.,15,0,15,0
1745795714130,EDS 290,A00,897211,Hofstetter; Carolyn,15,0,15,0
1745795715157,LIGM 5A,A00,896162,Fischer-Grunski; Eva K,15,0,20,5
1745795716182,LIGM 5B,A00,896260,Fischer-Grunski; Eva K,17,0,20,3
1745795717213,LIGM 5C,A00,896308,Fischer-Grunski; Eva K,18,0,20,2
1745795718240,LIIT 5AS,A00,896313,Carnelos; Chiara,18,0,20,2
1745795719265,LIIT 5BS,A00,896416,Carnelos; Chiara,20,0,20,0
1745795720293,LIIT 5CS,A00,896564,Carnelos; Chiara,20,0,20,0
1745795721323,LISP 5A,A00,896588,Munoz Sanchez; Alicia,4,0,20,16
1745795722347,LISP 5B,A00,896653,Munoz Sanchez; Alicia,10,0,20,10
1745795723372,LISP 5C,A00,896655,Munoz Sanchez; Alicia,4,0,20,16
1745795724401,MAE 197,001,957918,Kleissl; Jan,9998,0,9999,1
1745795725428,MATH 2,A01,957937,Staff,34,0,35,1
1745795726454,MATH 197,001,957876,Kedlaya; Kiran S.,9993,0,9999,6
1745795727480,MCWP 40,A00,892729,Duru; Nur,13,0,20,7
1745795727480,MCWP 40,B00,893304,Montejo; Carolina,20,0,20,0
1745795728507,MCWP 40R,A00,893757,Redela; Pamela Morgan,0,6,20,20
1745795729533,MCWP 50,A00,893758,Morshed; Michael James,2,0,20,18
1745795729533,MCWP 50,B00,893761,Bartulis; Jason Michael,17,0,20,3
1745795730561,MCWP 50R,A00,893766,Compas; Sean Matthew,0,1,20,20
1745795730561,MCWP 50R,B00,893769,Carter; Jennifer A,0,0,20,20
1745795730561,MCWP 50R,C00,893771,Krone; Jarret,0,3,20,20
1745795730561,MCWP 50R,D00,893772,Miller; Elizabeth Deen,3,0,20,17
1745795730561,MCWP 50R,E00,893775,Carter; Andrea L,0,0,20,20
1745795731588,MMW 11R,A01,892721,Herbst; Matthew,11,0,27,16
1745795731588,MMW 11R,A02,892722,Herbst; Matthew,0,0,0,3
1745795732614,MMW 12R,A01,892724,Herbst; Matthew,0,9,16,16
1745795732614,MMW 12R,A02,892725,Herbst; Matthew,0,9,16,16
1745795733643,MMW 13R,A01,892727,Staff,0,4,16,16
1745795733643,MMW 13R,A02,892728,Staff,0,4,16,16
1745795733643,MMW 13R,A03,958032,Staff,0,3,16,16
1745795733643,MMW 13R,A04,958033,Staff,0,2,16,16
1745795733643,MMW 13R,A05,958034,Staff,0,3,16,16
1745795734670,SIO 295LS,A00,894015,Staff,7,0,25,18
1745795735695,SIO 295S,A00,894020,Staff,7,0,25,18
1745795736722,SIOC 290S,B01,958918,Staff,0,0,0,0
1745795737748,SIOC 291S,B01,958922,Staff,0,0,0,0
1745795738773,SOCI 117,A01,895339,Staff,4,0,5,1
1745795739798,WES 237B,A00,894149,Staff,11,0,20,9
1745795741856,AESE 279B,A00,891859,Staff,13,0,35,22
1745795742882,AIP 197,001,891854,Staff,70,0,70,0
1745795743912,ANTH 289S,A00,891856,Gagneux; Pascal,12,0,12,0
1745795744940,BENG 196,001,957946,Engler; Adam J.,9996,0,9999,3
1745795745966,CAT 124RS,A01,956906,Staff,8,0,25,17
1745795746992,CAT 125RS,A01,922013,Staff,8,0,25,17
1745795748021,CLRE 250,A00,891860,Morris; Sheldon,9995,0,9999,4
1745795750074,CLRE 251R,A00,907817,Mehta; Ravindra L.,9994,0,9999,5
1745795751100,CLRE 252,A00,891864,Cuomo; Raphael Eduardo,9993,0,9999,6
1745795752126,CLRE 253,A00,891867,Vaida; Florin,9994,0,9999,5
1745795752126,CLRE 253,B00,907819,Staff,9999,0,9999,0
1745795753153,CLRE 259,A00,891868,Patel; Hemal,9998,0,9999,1
1745795754181,CLRE 260,A00,891872,Cuomo; Raphael Eduardo,9999,0,9999,0
1745795755206,CLRE 297,001,891888,Cuomo; Raphael Eduardo,9999,0,9999,0
1745795756232,CSE 191,A00,958773,Minnes Kemp; Mor Mia,9999,0,9999,0
1745795757258,CSS 201S,A01,892054,Mignozzetti; Umberto,30,0,30,0
1745795758284,CSS 202S,A01,892056,Mignozzetti; Umberto,30,0,30,0
1745795759311,DSC 197,001,956898,Eldridge; Justin Matthew,9998,0,9999,1
1745795760338,DSC 297,001,958000,Mazumdar; Arya,9998,0,9999,1
1745795761362,EAP 100,A00,905686,Staff,9776,0,9999,223
1745795762391,ECE 45,A01,892618,Staff,0,12,50,50
1745795763419,ECE 109,A01,892620,Staff,0,43,0,0
1745795764445,ECE 111,A01,892719,Staff,0,7,50,50
1745795765471,ECE 197,001,957920,Mercier; Patrick Philip,9992,0,9999,7
1745795766512,ECON 178,A01,907814,Zhu; Ying,28,0,35,7
1745795767537,EDS 115,A00,895312,Staff,41,0,45,4
1745795768562,EDS 117,A01,895337,Staff,30,0,30,0
1745795769588,EDS 125,A00,895341,Jones; Gabrielle Anastasia,43,0,45,2
1745795770613,EDS 128A,A01,895459,Fargason; Sharon Gayle,44,0,45,1
1745795771639,EDS 128B,A01,895543,Pappas; Elizabeth,44,0,45,1
1745795772666,EDS 139,A00,897203,Pappas; Elizabeth,44,0,45,1
1745795772666,EDS 139,B00,897209,Fargason; Sharon Gayle,44,0,45,1
1745795773691,EDS 201,A00,895545,Staff,43,0,45,2
1745795774718,EDS 203,A01,895581,Halter; Christopher P.,43,0,45,2
1745795775745,EDS 204R,A01,895625,Heinzman; Erica M.,43,0,45,2
1745795775745,EDS 204R,B01,895693,Halter; Christopher P.,18,0,45,27
1745795776772,EDS 206R,A00,895694,Fargason; Sharon Gayle,9,0,30,21
1745795776772,EDS 206R,B00,895695,Choi; Bailey Miyeon,20,0,30,10
1745795777800,EDS 250,A00,895697,Hemans; Patricia Ann Benitez,43,0,45,2
1745795778824,EDS 281,A00,895701,Meyerott; Theresa Ann,15,0,15,0
1745795779850,EDS 284,A00,895736,Meyerott; Theresa Ann,15,0,15,0
1745795780877,EDS 286,A00,897210,Fine; Sarah,15,0,15,0
1745795781905,EDS 289C,A01,895770,Daly; Alan J.,15,0,15,0
1745795782930,EDS 290,A00,897211,Hofstetter; Carolyn,15,0,15,0
1745795783956,LIGM 5A,A00,896162,Fischer-Grunski; Eva K,15,0,20,5
1745795784986,LIGM 5B,A00,896260,Fischer-Grunski; Eva K,17,0,20,3
1745795786015,LIGM 5C,A00,896308,Fischer-Grunski; Eva K,18,0,20,2
1745795787040,LIIT 5AS,A00,896313,Carnelos; Chiara,18,0,20,2
1745795788067,LIIT 5BS,A00,896416,Carnelos; Chiara,20,0,20,0
1745795789095,LIIT 5CS,A00,896564,Carnelos; Chiara,20,0,20,0
1745795790124,LISP 5A,A00,896588,Munoz Sanchez; Alicia,4,0,20,16
1745795791150,LISP 5B,A00,896653,Munoz Sanchez; Alicia,10,0,20,10
1745795792179,LISP 5C,A00,896655,Munoz Sanchez; Alicia,4,0,20,16
1745795793205,MAE 197,001,957918,Kleissl; Jan,9998,0,9999,1
1745795794231,MATH 2,A01,957937,Staff,34,0,35,1
1745795795258,MATH 197,001,957876,Kedlaya; Kiran S.,9993,0,9999,6
1745795796284,MCWP 40,A00,892729,Duru; Nur,13,0,20,7
1745795796284,MCWP 40,B00,893304,Montejo; Carolina,20,0,20,0
1745795797308,MCWP 40R,A00,893757,Redela; Pamela Morgan,0,6,20,20
1745795798335,MCWP 50,A00,893758,Morshed; Michael James,2,0,20,18
1745795798335,MCWP 50,B00,893761,Bartulis; Jason Michael,17,0,20,3
1745795799364,MCWP 50R,A00,893766,Compas; Sean Matthew,0,1,20,20
1745795799364,MCWP 50R,B00,893769,Carter; Jennifer A,0,0,20,20
1745795799364,MCWP 50R,C00,893771,Krone; Jarret,0,3,20,20
1745795799364,MCWP 50R,D00,893772,Miller; Elizabeth Deen,3,0,20,17
1745795799364,MCWP 50R,E00,893775,Carter; Andrea L,0,0,20,20
1745795800393,MMW 11R,A01,892721,Herbst; Matthew,11,0,27,16
1745795800393,MMW 11R,A02,892722,Herbst; Matthew,0,0,0,3
1745795801418,MMW 12R,A01,892724,Herbst; Matthew,0,9,16,16
1745795801418,MMW 12R,A02,892725,Herbst; Matthew,0,9,16,16
1745795802442,MMW 13R,A01,892727,Staff,0,4,16,16
1745795802442,MMW 13R,A02,892728,Staff,0,4,16,16
1745795802442,MMW 13R,A03,958032,Staff,0,3,16,16
1745795802442,MMW 13R,A04,958033,Staff,0,2,16,16
1745795802442,MMW 13R,A05,958034,Staff,0,3,16,16
1745795803469,SIO 295LS,A00,894015,Staff,7,0,25,18
1745795804495,SIO 295S,A00,894020,Staff,7,0,25,18
1745795805524,SIOC 290S,B01,958918,Staff,0,0,0,0
1745795806552,SIOC 291S,B01,958922,Staff,0,0,0,0
1745795807580,SOCI 117,A01,895339,Staff,4,0,5,1
1745795808604,WES 237B,A00,894149,Staff,11,0,20,9
1745795810663,AESE 279B,A00,891859,Staff,13,0,35,22
1745795811690,AIP 197,001,891854,Staff,70,0,70,0
1745795812715,ANTH 289S,A00,891856,Gagneux; Pascal,12,0,12,0
1745795813741,BENG 196,001,957946,Engler; Adam J.,9996,0,9999,3
1745795814769,CAT 124RS,A01,956906,Staff,8,0,25,17
1745795815796,CAT 125RS,A01,922013,Staff,8,0,25,17
1745795816820,CLRE 250,A00,891860,Morris; Sheldon,9995,0,9999,4
1745795818869,CLRE 251R,A00,907817,Mehta; Ravindra L.,9994,0,9999,5
1745795819894,CLRE 252,A00,891864,Cuomo; Raphael Eduardo,9993,0,9999,6
1745795820919,CLRE 253,A00,891867,Vaida; Florin,9994,0,9999,5
1745795820919,CLRE 253,B00,907819,Staff,9999,0,9999,0
1745795821947,CLRE 259,A00,891868,Patel; Hemal,9998,0,9999,1
1745795822972,CLRE 260,A00,891872,Cuomo; Raphael Eduardo,9999,0,9999,0
1745795823998,CLRE 297,001,891888,Cuomo; Raphael Eduardo,9999,0,9999,0
1745795825023,CSE 191,A00,958773,Minnes Kemp; Mor Mia,9999,0,9999,0
1745795826054,CSS 201S,A01,892054,Mignozzetti; Umberto,30,0,30,0
1745795827085,CSS 202S,A01,892056,Mignozzetti; Umberto,30,0,30,0
1745795828109,DSC 197,001,956898,Eldridge; Justin Matthew,9998,0,9999,1
1745795829134,DSC 297,001,958000,Mazumdar; Arya,9998,0,9999,1
1745795830160,EAP 100,A00,905686,Staff,9776,0,9999,223
1745795831184,ECE 45,A01,892618,Staff,0,12,50,50
1745795832211,ECE 109,A01,892620,Staff,0,43,0,0
1745795833238,ECE 111,A01,892719,Staff,0,7,50,50
1745795834275,ECE 197,001,957920,Mercier; Patrick Philip,9992,0,9999,7
1745795835303,ECON 178,A01,907814,Zhu; Ying,28,0,35,7
1745795836328,EDS 115,A00,895312,Staff,41,0,45,4
1745795837355,EDS 117,A01,895337,Staff,30,0,30,0
1745795838384,EDS 125,A00,895341,Jones; Gabrielle Anastasia,43,0,45,2
1745795839411,EDS 128A,A01,895459,Fargason; Sharon Gayle,44,0,45,1
1745795840437,EDS 128B,A01,895543,Pappas; Elizabeth,44,0,45,1
1745795841461,EDS 139,A00,897203,Pappas; Elizabeth,44,0,45,1
1745795841461,EDS 139,B00,897209,Fargason; Sharon Gayle,44,0,45,1
1745795842487,EDS 201,A00,895545,Staff,43,0,45,2
1745795843515,EDS 203,A01,895581,Halter; Christopher P.,43,0,45,2
1745795844542,EDS 204R,A01,895625,Heinzman; Erica M.,43,0,45,2
1745795844542,EDS 204R,B01,895693,Halter; Christopher P.,18,0,45,27
1745795845566,EDS 206R,A00,895694,Fargason; Sharon Gayle,9,0,30,21
1745795845566,EDS 206R,B00,895695,Choi; Bailey Miyeon,20,0,30,10
1745795846595,EDS 250,A00,895697,Hemans; Patricia Ann Benitez,43,0,45,2
1745795847624,EDS 281,A00,895701,Meyerott; Theresa Ann,15,0,15,0
1745795848647,EDS 284,A00,895736,Meyerott; Theresa Ann,15,0,15,0
1745795849674,EDS 286,A00,897210,Fine; Sarah,15,0,15,0
1745795850703,EDS 289C,A01,895770,Daly; Alan J.,15,0,15,0
1745795851729,EDS 290,A00,897211,Hofstetter; Carolyn,15,0,15,0
1745795852754,LIGM 5A,A00,896162,Fischer-Grunski; Eva K,15,0,20,5
1745795853779,LIGM 5B,A00,896260,Fischer-Grunski; Eva K,17,0,20,3
1745795854807,LIGM 5C,A00,896308,Fischer-Grunski; Eva K,18,0,20,2
1745795855833,LIIT 5AS,A00,896313,Carnelos; Chiara,18,0,20,2
1745795856861,LIIT 5BS,A00,896416,Carnelos; Chiara,20,0,20,0
1745795857886,LIIT 5CS,A00,896564,Carnelos; Chiara,20,0,20,0
1745795858915,LISP 5A,A00,896588,Munoz Sanchez; Alicia,4,0,20,16
1745795859941,LISP 5B,A00,896653,Munoz Sanchez; Alicia,10,0,20,10
1745795860971,LISP 5C,A00,896655,Munoz Sanchez; Alicia,4,0,20,16
1745795861999,MAE 197,001,957918,Kleissl; Jan,9998,0,9999,1
1745795863025,MATH 2,A01,957937,Staff,34,0,35,1
1745795864053,MATH 197,001,957876,Kedlaya; Kiran S.,9993,0,9999,6
1745795865079,MCWP 40,A00,892729,Duru; Nur,13,0,20,7
1745795865079,MCWP 40,B00,893304,Montejo; Carolina,20,0,20,0
1745795866107,MCWP 40R,A00,893757,Redela; Pamela Morgan,0,6,20,20
1745795867134,MCWP 50,A00,893758,Morshed; Michael James,2,0,20,18
1745795867134,MCWP 50,B00,893761,Bartulis; Jason Michael,17,0,20,3
1745795868160,MCWP 50R,A00,893766,Compas; Sean Matthew,0,1,20,20
1745795868160,MCWP 50R,B00,893769,Carter; Jennifer A,0,0,20,20
1745795868160,MCWP 50R,C00,893771,Krone; Jarret,0,3,20,20
1745795868160,MCWP 50R,D00,893772,Miller; Elizabeth Deen,3,0,20,17
1745795868160,MCWP 50R,E00,893775,Carter; Andrea L,0,0,20,20
1745795869188,MMW 11R,A01,892721,Herbst; Matthew,11,0,27,16
1745795869188,MMW 11R,A02,892722,Herbst; Matthew,0,0,0,3
1745795870214,MMW 12R,A01,892724,Herbst; Matthew,0,9,16,16
1745795870214,MMW 12R,A02,892725,Herbst; Matthew,0,9,16,16
1745795871242,MMW 13R,A01,892727,Staff,0,4,16,16
1745795871242,MMW 13R,A02,892728,Staff,0,4,16,16
1745795871242,MMW 13R,A03,958032,Staff,0,3,16,16
1745795871242,MMW 13R,A04,958033,Staff,0,2,16,16
1745795871242,MMW 13R,A05,958034,Staff,0,3,16,16
1745795872271,SIO 295LS,A00,894015,Staff,7,0,25,18
1745795873297,SIO 295S,A00,894020,Staff,7,0,25,18
1745795874326,SIOC 290S,B01,958918,Staff,0,0,0,0
1745795875356,SIOC 291S,B01,958922,Staff,0,0,0,0
1745795876381,SOCI 117,A01,895339,Staff,4,0,5,1
1745795877408,WES 237B,A00,894149,Staff,11,0,20,9
1745795879475,AESE 279B,A00,891859,Staff,13,0,35,22
1745795880502,AIP 197,001,891854,Staff,70,0,70,0
1745795881528,ANTH 289S,A00,891856,Gagneux; Pascal,12,0,12,0
1745795882556,BENG 196,001,957946,Engler; Adam J.,9996,0,9999,3
1745795883583,CAT 124RS,A01,956906,Staff,8,0,25,17
1745795884608,CAT 125RS,A01,922013,Staff,8,0,25,17
1745795885634,CLRE 250,A00,891860,Morris; Sheldon,9995,0,9999,4
1745795887685,CLRE 251R,A00,907817,Mehta; Ravindra L.,9994,0,9999,5
1745795888712,CLRE 252,A00,891864,Cuomo; Raphael Eduardo,9993,0,9999,6
1745795889739,CLRE 253,A00,891867,Vaida; Florin,9994,0,9999,5
1745795889739,CLRE 253,B00,907819,Staff,9999,0,9999,0
1745795890765,CLRE 259,A00,891868,Patel; Hemal,9998,0,9999,1
1745795891791,CLRE 260,A00,891872,Cuomo; Raphael Eduardo,9999,0,9999,0
1745795892819,CLRE 297,001,891888,Cuomo; Raphael Eduardo,9999,0,9999,0
1745795893844,CSE 191,A00,958773,Minnes Kemp; Mor Mia,9999,0,9999,0
1745795894875,CSS 201S,A01,892054,Mignozzetti; Umberto,30,0,30,0
1745795895902,CSS 202S,A01,892056,Mignozzetti; Umberto,30,0,30,0
1745795896928,DSC 197,001,956898,Eldridge; Justin Matthew,9998,0,9999,1
1745795897954,DSC 297,001,958000,Mazumdar; Arya,9998,0,9999,1
1745795898980,EAP 100,A00,905686,Staff,9776,0,9999,223
1745795900007,ECE 45,A01,892618,Staff,0,12,50,50
1745795901035,ECE 109,A01,892620,Staff,0,43,0,0
1745795902062,ECE 111,A01,892719,Staff,0,7,50,50
1745795903088,ECE 197,001,957920,Mercier; Patrick Philip,9992,0,9999,7
1745795904119,ECON 178,A01,907814,Zhu; Ying,28,0,35,7
1745795905146,EDS 115,A00,895312,Staff,41,0,45,4
1745795906170,EDS 117,A01,895337,Staff,30,0,30,0
1745795907200,EDS 125,A00,895341,Jones; Gabrielle Anastasia,43,0,45,2
1745795908226,EDS 128A,A01,895459,Fargason; Sharon Gayle,44,0,45,1
1745795909252,EDS 128B,A01,895543,Pappas; Elizabeth,44,0,45,1
1745795910277,EDS 139,A00,897203,Pappas; Elizabeth,44,0,45,1
1745795910277,EDS 139,B00,897209,Fargason; Sharon Gayle,44,0,45,1
1745795911358,EDS 201,A00,895545,Staff,43,0,45,2
1745795912392,EDS 203,A01,895581,Halter; Christopher P.,43,0,45,2
1745795913417,EDS 204R,A01,895625,Heinzman; Erica M.,43,0,45,2
1745795913417,EDS 204R,B01,895693,Halter; Christopher P.,18,0,45,27
1745795914443,EDS 206R,A00,895694,Fargason; Sharon Gayle,9,0,30,21
1745795914443,EDS 206R,B00,895695,Choi; Bailey Miyeon,20,0,30,10
1745795915470,EDS 250,A00,895697,Hemans; Patricia Ann Benitez,43,0,45,2
1745795916496,EDS 281,A00,895701,Meyerott; Theresa Ann,15,0,15,0
1745795917525,EDS 284,A00,895736,Meyerott; Theresa Ann,15,0,15,0
1745795918551,EDS 286,A00,897210,Fine; Sarah,15,0,15,0
1745795919578,EDS 289C,A01,895770,Daly; Alan J.,15,0,15,0
1745795920603,EDS 290,A00,897211,Hofstetter; Carolyn,15,0,15,0
1745795921629,LIGM 5A,A00,896162,Fischer-Grunski; Eva K,15,0,20,5
1745795922659,LIGM 5B,A00,896260,Fischer-Grunski; Eva K,17,0,20,3
1745795923684,LIGM 5C,A00,896308,Fischer-Grunski; Eva K,18,0,20,2
1745795924710,LIIT 5AS,A00,896313,Carnelos; Chiara,18,0,20,2
1745795925735,LIIT 5BS,A00,896416,Carnelos; Chiara,20,0,20,0
1745795926764,LIIT 5CS,A00,896564,Carnelos; Chiara,20,0,20,0
1745795927790,LISP 5A,A00,896588,Munoz Sanchez; Alicia,4,0,20,16
1745795928817,LISP 5B,A00,896653,Munoz Sanchez; Alicia,10,0,20,10
1745795929842,LISP 5C,A00,896655,Munoz Sanchez; Alicia,4,0,20,16
1745795930869,MAE 197,001,957918,Kleissl; Jan,9998,0,9999,1
1745795931894,MATH 2,A01,957937,Staff,34,0,35,1
1745795932920,MATH 197,001,957876,Kedlaya; Kiran S.,9993,0,9999,6
1745795933946,MCWP 40,A00,892729,Duru; Nur,13,0,20,7
1745795933946,MCWP 40,B00,893304,Montejo; Carolina,20,0,20,0
1745795934975,MCWP 40R,A00,893757,Redela; Pamela Morgan,0,6,20,20
1745795936003,MCWP 50,A00,893758,Morshed; Michael James,2,0,20,18
1745795936003,MCWP 50,B00,893761,Bartulis; Jason Michael,17,0,20,3
1745795937028,MCWP 50R,A00,893766,Compas; Sean Matthew,0,1,20,20
1745795937028,MCWP 50R,B00,893769,Carter; Jennifer A,0,0,20,20
1745795937028,MCWP 50R,C00,893771,Krone; Jarret,0,3,20,20
1745795937028,MCWP 50R,D00,893772,Miller; Elizabeth Deen,3,0,20,17
1745795937028,MCWP 50R,E00,893775,Carter; Andrea L,0,0,20,20
1745795938054,MMW 11R,A01,892721,Herbst; Matthew,11,0,27,16
1745795938054,MMW 11R,A02,892722,Herbst; Matthew,0,0,0,3
1745795939082,MMW 12R,A01,892724,Herbst; Matthew,0,9,16,16
1745795939082,MMW 12R,A02,892725,Herbst; Matthew,0,9,16,16
1745795940113,MMW 13R,A01,892727,Staff,0,4,16,16
1745795940113,MMW 13R,A02,892728,Staff,0,4,16,16
1745795940113,MMW 13R,A03,958032,Staff,0,3,16,16
1745795940113,MMW 13R,A04,958033,Staff,0,2,16,16
1745795940113,MMW 13R,A05,958034,Staff,0,3,16,16
1745795941138,SIO 295LS,A00,894015,Staff,7,0,25,18
1745795942168,SIO 295S,A00,894020,Staff,7,0,25,18
1745795943195,SIOC 290S,B01,958918,Staff,0,0,0,0
1745795944223,SIOC 291S,B01,958922,Staff,0,0,0,0
1745795945249,SOCI 117,A01,895339,Staff,4,0,5,1
1745795946276,WES 237B,A00,894149,Staff,11,0,20,9
1745795948332,AESE 279B,A00,891859,Staff,13,0,35,22
1745795949357,AIP 197,001,891854,Staff,70,0,70,0
1745795950386,ANTH 289S,A00,891856,Gagneux; Pascal,12,0,12,0
1745795951412,BENG 196,001,957946,Engler; Adam J.,9996,0,9999,3
1745795952437,CAT 124RS,A01,956906,Staff,8,0,25,17
1745795953463,CAT 125RS,A01,922013,Staff,8,0,25,17
1745795954490,CLRE 250,A00,891860,Morris; Sheldon,9995,0,9999,4
1745795956544,CLRE 251R,A00,907817,Mehta; Ravindra L.,9994,0,9999,5
1745795957569,CLRE 252,A00,891864,Cuomo; Raphael Eduardo,9993,0,9999,6
1745795958599,CLRE 253,A00,891867,Vaida; Florin,9994,0,9999,5
1745795958599,CLRE 253,B00,907819,Staff,9999,0,9999,0
1745795959626,CLRE 259,A00,891868,Patel; Hemal,9998,0,9999,1
1745795960655,CLRE 260,A00,891872,Cuomo; Raphael Eduardo,9999,0,9999,0
1745795961681,CLRE 297,001,891888,Cuomo; Raphael Eduardo,9999,0,9999,0
1745795962705,CSE 191,A00,958773,Minnes Kemp; Mor Mia,9999,0,9999,0
1745795963732,CSS 201S,A01,892054,Mignozzetti; Umberto,30,0,30,0
1745795964757,CSS 202S,A01,892056,Mignozzetti; Umberto,30,0,30,0
1745795965782,DSC 197,001,956898,Eldridge; Justin Matthew,9998,0,9999,1
1745795966812,DSC 297,001,958000,Mazumdar; Arya,9998,0,9999,1
1745795967839,EAP 100,A00,905686,Staff,9776,0,9999,223
1745795968872,ECE 45,A01,892618,Staff,0,12,50,50
1745795969897,ECE 109,A01,892620,Staff,0,43,0,0
1745795970927,ECE 111,A01,892719,Staff,0,7,50,50
1745795971957,ECE 197,001,957920,Mercier; Patrick Philip,9992,0,9999,7
1745795972988,ECON 178,A01,907814,Zhu; Ying,28,0,35,7
1745795974016,EDS 115,A00,895312,Staff,41,0,45,4
1745795975041,EDS 117,A01,895337,Staff,30,0,30,0
1745795976067,EDS 125,A00,895341,Jones; Gabrielle Anastasia,43,0,45,2
1745795977093,EDS 128A,A01,895459,Fargason; Sharon Gayle,44,0,45,1
1745795978120,EDS 128B,A01,895543,Pappas; Elizabeth,44,0,45,1
1745795979146,EDS 139,A00,897203,Pappas; Elizabeth,44,0,45,1
1745795979146,EDS 139,B00,897209,Fargason; Sharon Gayle,44,0,45,1
1745795980174,EDS 201,A00,895545,Staff,43,0,45,2
1745795981203,EDS 203,A01,895581,Halter; Christopher P.,43,0,45,2
1745795982229,EDS 204R,A01,895625,Heinzman; Erica M.,43,0,45,2
1745795982229,EDS 204R,B01,895693,Halter; Christopher P.,18,0,45,27
1745795983256,EDS 206R,A00,895694,Fargason; Sharon Gayle,9,0,30,21
1745795983256,EDS 206R,B00,895695,Choi; Bailey Miyeon,20,0,30,10
1745795984282,EDS 250,A00,895697,Hemans; Patricia Ann Benitez,43,0,45,2
1745795985308,EDS 281,A00,895701,Meyerott; Theresa Ann,15,0,15,0
1745795986335,EDS 284,A00,895736,Meyerott; Theresa Ann,15,0,15,0
1745795987360,EDS 286,A00,897210,Fine; Sarah,15,0,15,0
1745795988387,EDS 289C,A01,895770,Daly; Alan J.,15,0,15,0
1745795989414,EDS 290,A00,897211,Hofstetter; Carolyn,15,0,15,0
1745795990444,LIGM 5A,A00,896162,Fischer-Grunski; Eva K,15,0,20,5
1745795991471,LIGM 5B,A00,896260,Fischer-Grunski; Eva K,17,0,20,3
1745795992496,LIGM 5C,A00,896308,Fischer-Grunski; Eva K,18,0,20,2
1745795993524,LIIT 5AS,A00,896313,Carnelos; Chiara,18,0,20,2
1745795994554,LIIT 5BS,A00,896416,Carnelos; Chiara,20,0,20,0
1745795995583,LIIT 5CS,A00,896564,Carnelos; Chiara,20,0,20,0
1745795996612,LISP 5A,A00,896588,Munoz Sanchez; Alicia,4,0,20,16
1745795997639,LISP 5B,A00,896653,Munoz Sanchez; Alicia,10,0,20,10
1745795998664,LISP 5C,A00,896655,Munoz Sanchez; Alicia,4,0,20,16
1745795999693,MAE 197,001,957918,Kleissl; Jan,9998,0,9999,1
1745796000718,MATH 2,A01,957937,Staff,34,0,35,1
1745796001744,MATH 197,001,957876,Kedlaya; Kiran S.,9993,0,9999,6
1745796002772,MCWP 40,A00,892729,Duru; Nur,13,0,20,7
1745796002772,MCWP 40,B00,893304,Montejo; Carolina,20,0,20,0
1745796003801,MCWP 40R,A00,893757,Redela; Pamela Morgan,0,6,20,20
1745796004828,MCWP 50,A00,893758,Morshed; Michael James,2,0,20,18
1745796004828,MCWP 50,B00,893761,Bartulis; Jason Michael,17,0,20,3
1745796005856,MCWP 50R,A00,893766,Compas; Sean Matthew,0,1,20,20
1745796005856,MCWP 50R,B00,893769,Carter; Jennifer A,0,0,20,20
1745796005856,MCWP 50R,C00,893771,Krone; Jarret,0,3,20,20
1745796005856,MCWP 50R,D00,893772,Miller; Elizabeth Deen,3,0,20,17
1745796005856,MCWP 50R,E00,893775,Carter; Andrea L,0,0,20,20
1745796006881,MMW 11R,A01,892721,Herbst; Matthew,11,0,27,16
1745796006881,MMW 11R,A02,892722,Herbst; Matthew,0,0,0,3
1745796007908,MMW 12R,A01,892724,Herbst; Matthew,0,9,16,16
1745796007908,MMW 12R,A02,892725,Herbst; Matthew,0,9,16,16
1745796008934,MMW 13R,A01,892727,Staff,0,4,16,16
1745796008934,MMW 13R,A02,892728,Staff,0,4,16,16
1745796008934,MMW 13R,A03,958032,Staff,0,3,16,16
1745796008934,MMW 13R,A04,958033,Staff,0,2,16,16
1745796008934,MMW 13R,A05,958034,Staff,0,3,16,16
1745796009959,SIO 295LS,A00,894015,Staff,7,0,25,18
1745796010988,SIO 295S,A00,894020,Staff,7,0,25,18
1745796012016,SIOC 290S,B01,958918,Staff,0,0,0,0
1745796013043,SIOC 291S,B01,958922,Staff,0,0,0,0
1745796014070,SOCI 117,A01,895339,Staff,4,0,5,1
1745796015137,WES 237B,A00,894149,Staff,11,0,20,9
1745796017201,AESE 279B,A00,891859,Staff,13,0,35,22
1745796018227,AIP 197,001,891854,Staff,70,0,70,0
1745796019256,ANTH 289S,A00,891856,Gagneux; Pascal,12,0,12,0
1745796020285,BENG 196,001,957946,Engler; Adam J.,9996,0,9999,3
1745796021310,CAT 124RS,A01,956906,Staff,8,0,25,17
1745796022335,CAT 125RS,A01,922013,Staff,8,0,25,17
1745796023364,CLRE 250,A00,891860,Morris; Sheldon,9995,0,9999,4
1745796025415,CLRE 251R,A00,907817,Mehta; Ravindra L.,9994,0,9999,5
1745796026441,CLRE 252,A00,891864,Cuomo; Raphael Eduardo,9993,0,9999,6
1745796027466,CLRE 253,A00,891867,Vaida; Florin,9994,0,9999,5
1745796027466,CLRE 253,B00,907819,Staff,9999,0,9999,0
1745796028491,CLRE 259,A00,891868,Patel; Hemal,9998,0,9999,1
1745796029523,CLRE 260,A00,891872,Cuomo; Raphael Eduardo,9999,0,9999,0
1745796030548,CLRE 297,001,891888,Cuomo; Raphael Eduardo,9999,0,9999,0
1745796031572,CSE 191,A00,958773,Minnes Kemp; Mor Mia,9999,0,9999,0
1745796032603,CSS 201S,A01,892054,Mignozzetti; Umberto,30,0,30,0
1745796033629,CSS 202S,A01,892056,Mignozzetti; Umberto,30,0,30,0
1745796034653,DSC 197,001,956898,Eldridge; Justin Matthew,9998,0,9999,1
1745796035682,DSC 297,001,958000,Mazumdar; Arya,9998,0,9999,1
1745796036707,EAP 100,A00,905686,Staff,9776,0,9999,223
1745796037733,ECE 45,A01,892618,Staff,0,12,50,50
1745796038761,ECE 109,A01,892620,Staff,0,43,0,0
1745796039788,ECE 111,A01,892719,Staff,0,7,50,50
1745796040813,ECE 197,001,957920,Mercier; Patrick Philip,9992,0,9999,7
1745796041838,ECON 178,A01,907814,Zhu; Ying,28,0,35,7
1745796042865,EDS 115,A00,895312,Staff,41,0,45,4
1745796043893,EDS 117,A01,895337,Staff,30,0,30,0
1745796044920,EDS 125,A00,895341,Jones; Gabrielle Anastasia,43,0,45,2
1745796045944,EDS 128A,A01,895459,Fargason; Sharon Gayle,44,0,45,1
1745796046970,EDS 128B,A01,895543,Pappas; Elizabeth,44,0,45,1
1745796047997,EDS 139,A00,897203,Pappas; Elizabeth,44,0,45,1
1745796047997,EDS 139,B00,897209,Fargason; Sharon Gayle,44,0,45,1
1745796049026,EDS 201,A00,895545,Staff,43,0,45,2
1745796050055,EDS 203,A01,895581,Halter; Christopher P.,43,0,45,2
1745796051085,EDS 204R,A01,895625,Heinzman; Erica M.,43,0,45,2
1745796051085,EDS 204R,B01,895693,Halter; Christopher P.,18,0,45,27
1745796052110,EDS 206R,A00,895694,Fargason; Sharon Gayle,9,0,30,21
1745796052110,EDS 206R,B00,895695,Choi; Bailey Miyeon,20,0,30,10
1745796053136,EDS 250,A00,895697,Hemans; Patricia Ann Benitez,43,0,45,2
1745796054164,EDS 281,A00,895701,Meyerott; Theresa Ann,15,0,15,0
1745796055190,EDS 284,A00,895736,Meyerott; Theresa Ann,15,0,15,0
1745796056216,EDS 286,A00,897210,Fine; Sarah,15,0,15,0
1745796057242,EDS 289C,A01,895770,Daly; Alan J.,15,0,15,0
1745796058268,EDS 290,A00,897211,Hofstetter; Carolyn,15,0,15,0
1745796059294,LIGM 5A,A00,896162,Fischer-Grunski; Eva K,15,0,20,5
1745796060321,LIGM 5B,A00,896260,Fischer-Grunski; Eva K,17,0,20,3
1745796061349,LIGM 5C,A00,896308,Fischer-Grunski; Eva K,18,0,20,2
1745796062377,LIIT 5AS,A00,896313,Carnelos; Chiara,18,0,20,2
1745796063405,LIIT 5BS,A00,896416,Carnelos; Chiara,20,0,20,0
1745796064434,LIIT 5CS,A00,896564,Carnelos; Chiara,20,0,20,0
1745796065459,LISP 5A,A00,896588,Munoz Sanchez; Alicia,4,0,20,16
1745796066486,LISP 5B,A00,896653,Munoz Sanchez; Alicia,10,0,20,10
1745796067511,LISP 5C,A00,896655,Munoz Sanchez; Alicia,4,0,20,16
1745796068536,MAE 197,001,957918,Kleissl; Jan,9998,0,9999,1
1745796069562,MATH 2,A01,957937,Staff,34,0,35,1
1745796070589,MATH 197,001,957876,Kedlaya; Kiran S.,9993,0,9999,6
1745796071615,MCWP 40,A00,892729,Duru; Nur,13,0,20,7
1745796071615,MCWP 40,B00,893304,Montejo; Carolina,20,0,20,0
1745796072642,MCWP 40R,A00,893757,Redela; Pamela Morgan,0,6,20,20
1745796073668,MCWP 50,A00,893758,Morshed; Michael James,2,0,20,18
1745796073668,MCWP 50,B00,893761,Bartulis; Jason Michael,17,0,20,3
1745796074697,MCWP 50R,A00,893766,Compas; Sean Matthew,0,1,20,20
1745796074697,MCWP 50R,B00,893769,Carter; Jennifer A,0,0,20,20
1745796074697,MCWP 50R,C00,893771,Krone; Jarret,0,3,20,20
1745796074697,MCWP 50R,D00,893772,Miller; Elizabeth Deen,3,0,20,17
1745796074697,MCWP 50R,E00,893775,Carter; Andrea L,0,0,20,20
1745796075726,MMW 11R,A01,892721,Herbst; Matthew,11,0,27,16
1745796075726,MMW 11R,A02,892722,Herbst; Matthew,0,0,0,3
1745796076755,MMW 12R,A01,892724,Herbst; Matthew,0,9,16,16
1745796076755,MMW 12R,A02,892725,Herbst; Matthew,0,9,16,16
1745796077781,MMW 13R,A01,892727,Staff,0,4,16,16
1745796077781,MMW 13R,A02,892728,Staff,0,4,16,16
1745796077781,MMW 13R,A03,958032,Staff,0,3,16,16
1745796077781,MMW 13R,A04,958033,Staff,0,2,16,16
1745796077781,MMW 13R,A05,958034,Staff,0,3,16,16
1745796078810,SIO 295LS,A00,894015,Staff,7,0,25,18
1745796079835,SIO 295S,A00,894020,Staff,7,0,25,18
1745796080863,SIOC 290S,B01,958918,Staff,0,0,0,0
1745796081890,SIOC 291S,B01,958922,Staff,0,0,0,0
1745796082915,SOCI 117,A01,895339,Staff,4,0,5,1
1745796083946,WES 237B,A00,894149,Staff,11,0,20,9
1745796086008,AESE 279B,A00,891859,Staff,13,0,35,22
1745796087037,AIP 197,001,891854,Staff,70,0,70,0
1745796088062,ANTH 289S,A00,891856,Gagneux; Pascal,12,0,12,0
1745796089089,BENG 196,001,957946,Engler; Adam J.,9996,0,9999,3
1745796090115,CAT 124RS,A01,956906,Staff,8,0,25,17
1745796091141,CAT 125RS,A01,922013,Staff,8,0,25,17
1745796092168,CLRE 250,A00,891860,Morris; Sheldon,9995,0,9999,4
1745796094221,CLRE 251R,A00,907817,Mehta; Ravindra L.,9994,0,9999,5
1745796095249,CLRE 252,A00,891864,Cuomo; Raphael Eduardo,9993,0,9999,6
1745796096278,CLRE 253,A00,891867,Vaida; Florin,9994,0,9999,5
1745796096278,CLRE 253,B00,907819,Staff,9999,0,9999,0
1745796097304,CLRE 259,A00,891868,Patel; Hemal,9998,0,9999,1
1745796098331,CLRE 260,A00,891872,Cuomo; Raphael Eduardo,9999,0,9999,0
1745796099359,CLRE 297,001,891888,Cuomo; Raphael Eduardo,9999,0,9999,0
1745796100386,CSE 191,A00,958773,Minnes Kemp; Mor Mia,9999,0,9999,0
1745796101417,CSS 201S,A01,892054,Mignozzetti; Umberto,30,0,30,0
1745796102444,CSS 202S,A01,892056,Mignozzetti; Umberto,30,0,30,0
1745796103468,DSC 197,001,956898,Eldridge; Justin Matthew,9998,0,9999,1
1745796104497,DSC 297,001,958000,Mazumdar; Arya,9998,0,9999,1
1745796105526,EAP 100,A00,905686,Staff,9776,0,9999,223
1745796106550,ECE 45,A01,892618,Staff,0,12,50,50
1745796107577,ECE 109,A01,892620,Staff,0,43,0,0
1745796108606,ECE 111,A01,892719,Staff,0,7,50,50
1745796109631,ECE 197,001,957920,Mercier; Patrick Philip,9992,0,9999,7
1745796110657,ECON 178,A01,907814,Zhu; Ying,28,0,35,7
1745796111686,EDS 115,A00,895312,Staff,41,0,45,4
1745796112711,EDS 117,A01,895337,Staff,30,0,30,0
1745796113737,EDS 125,A00,895341,Jones; Gabrielle Anastasia,43,0,45,2
1745796114765,EDS 128A,A01,895459,Fargason; Sharon Gayle,44,0,45,1
1745796115792,EDS 128B,A01,895543,Pappas; Elizabeth,44,0,45,1
1745796116817,EDS 139,A00,897203,Pappas; Elizabeth,44,0,45,1
1745796116817,EDS 139,B00,897209,Fargason; Sharon Gayle,44,0,45,1
1745796117843,EDS 201,A00,895545,Staff,43,0,45,2
1745796118869,EDS 203,A01,895581,Halter; Christopher P.,43,0,45,2
1745796119897,EDS 204R,A01,895625,Heinzman; Erica M.,43,0,45,2
1745796119897,EDS 204R,B01,895693,Halter; Christopher P.,18,0,45,27
1745796120925,EDS 206R,A00,895694,Fargason; Sharon Gayle,9,0,30,21
1745796120925,EDS 206R,B00,895695,Choi; Bailey Miyeon,20,0,30,10
1745796121952,EDS 250,A00,895697,Hemans; Patricia Ann Benitez,43,0,45,2
1745796122978,EDS 281,A00,895701,Meyerott; Theresa Ann,15,0,15,0
1745796124006,EDS 284,A00,895736,Meyerott; Theresa Ann,15,0,15,0
1745796125032,EDS 286,A00,897210,Fine; Sarah,15,0,15,0
1745796126057,EDS 289C,A01,895770,Daly; Alan J.,15,0,15,0
1745796127082,EDS 290,A00,897211,Hofstetter; Carolyn,15,0,15,0
1745796128112,LIGM 5A,A00,896162,Fischer-Grunski; Eva K,15,0,20,5
1745796129138,LIGM 5B,A00,896260,Fischer-Grunski; Eva K,17,0,20,3
1745796130166,LIGM 5C,A00,896308,Fischer-Grunski; Eva K,18,0,20,2
1745796131191,LIIT 5AS,A00,896313,Carnelos; Chiara,18,0,20,2
1745796132219,LIIT 5BS,A00,896416,Carnelos; Chiara,20,0,20,0
1745796133244,LIIT 5CS,A00,896564,Carnelos; Chiara,20,0,20,0
1745796134270,LISP 5A,A00,896588,Munoz Sanchez; Alicia,4,0,20,16
1745796135298,LISP 5B,A00,896653,Munoz Sanchez; Alicia,10,0,20,10
1745796136324,LISP 5C,A00,896655,Munoz Sanchez; Alicia,4,0,20,16
1745796137353,MAE 197,001,957918,Kleissl; Jan,9998,0,9999,1
1745796138378,MATH 2,A01,957937,Staff,34,0,35,1
1745796139406,MATH 197,001,957876,Kedlaya; Kiran S.,9993,0,9999,6
1745796140436,MCWP 40,A00,892729,Duru; Nur,13,0,20,7
1745796140436,MCWP 40,B00,893304,Montejo; Carolina,20,0,20,0
1745796141465,MCWP 40R,A00,893757,Redela; Pamela Morgan,0,6,20,20
1745796142490,MCWP 50,A00,893758,Morshed; Michael James,2,0,20,18
1745796142490,MCWP 50,B00,893761,Bartulis; Jason Michael,17,0,20,3
1745796143517,MCWP 50R,A00,893766,Compas; Sean Matthew,0,1,20,20
1745796143517,MCWP 50R,B00,893769,Carter; Jennifer A,0,0,20,20
1745796143517,MCWP 50R,C00,893771,Krone; Jarret,0,3,20,20
1745796143517,MCWP 50R,D00,893772,Miller; Elizabeth Deen,3,0,20,17
1745796143517,MCWP 50R,E00,893775,Carter; Andrea L,0,0,20,20
1745796144543,MMW 11R,A01,892721,Herbst; Matthew,11,0,27,16
1745796144543,MMW 11R,A02,892722,Herbst; Matthew,0,0,0,3
1745796145568,MMW 12R,A01,892724,Herbst; Matthew,0,9,16,16
1745796145568,MMW 12R,A02,892725,Herbst; Matthew,0,9,16,16
1745796146599,MMW 13R,A01,892727,Staff,0,4,16,16
1745796146599,MMW 13R,A02,892728,Staff,0,4,16,16
1745796146599,MMW 13R,A03,958032,Staff,0,3,16,16
1745796146599,MMW 13R,A04,958033,Staff,0,2,16,16
1745796146599,MMW 13R,A05,958034,Staff,0,3,16,16
1745796147628,SIO 295LS,A00,894015,Staff,7,0,25,18
1745796148653,SIO 295S,A00,894020,Staff,7,0,25,18
1745796149678,SIOC 290S,B01,958918,Staff,0,0,0,0
1745796150709,SIOC 291S,B01,958922,Staff,0,0,0,0
1745796151735,SOCI 117,A01,895339,Staff,4,0,5,1
1745796152771,WES 237B,A00,894149,Staff,11,0,20,9
1745796154836,AESE 279B,A00,891859,Staff,13,0,35,22
1745796155866,AIP 197,001,891854,Staff,70,0,70,0
1745796156892,ANTH 289S,A00,891856,Gagneux; Pascal,12,0,12,0
1745796157918,BENG 196,001,957946,Engler; Adam J.,9996,0,9999,3
1745796158946,CAT 124RS,A01,956906,Staff,8,0,25,17
1745796159974,CAT 125RS,A01,922013,Staff,8,0,25,17
1745796161000,CLRE 250,A00,891860,Morris; Sheldon,9995,0,9999,4
1745796163054,CLRE 251R,A00,907817,Mehta; Ravindra L.,9994,0,9999,5
1745796164083,CLRE 252,A00,891864,Cuomo; Raphael Eduardo,9993,0,9999,6
1745796165108,CLRE 253,A00,891867,Vaida; Florin,9994,0,9999,5
1745796165108,CLRE 253,B00,907819,Staff,9999,0,9999,0
1745796166137,CLRE 259,A00,891868,Patel; Hemal,9998,0,9999,1
1745796167164,CLRE 260,A00,891872,Cuomo; Raphael Eduardo,9999,0,9999,0
1745796168190,CLRE 297,001,891888,Cuomo; Raphael Eduardo,9999,0,9999,0
1745796169215,CSE 191,A00,958773,Minnes Kemp; Mor Mia,9999,0,9999,0
1745796170244,CSS 201S,A01,892054,Mignozzetti; Umberto,30,0,30,0
1745796171271,CSS 202S,A01,892056,Mignozzetti; Umberto,30,0,30,0
1745796172299,DSC 197,001,956898,Eldridge; Justin Matthew,9998,0,9999,1
1745796173325,DSC 297,001,958000,Mazumdar; Arya,9998,0,9999,1
1745796174354,EAP 100,A00,905686,Staff,9776,0,9999,223
1745796175380,ECE 45,A01,892618,Staff,0,12,50,50
1745796176406,ECE 109,A01,892620,Staff,0,43,0,0
1745796177433,ECE 111,A01,892719,Staff,0,7,50,50
1745796178461,ECE 197,001,957920,Mercier; Patrick Philip,9992,0,9999,7
1745796179490,ECON 178,A01,907814,Zhu; Ying,28,0,35,7
1745796180517,EDS 115,A00,895312,Staff,41,0,45,4
1745796181543,EDS 117,A01,895337,Staff,30,0,30,0
1745796182572,EDS 125,A00,895341,Jones; Gabrielle Anastasia,43,0,45,2
1745796183598,EDS 128A,A01,895459,Fargason; Sharon Gayle,44,0,45,1
1745796184625,EDS 128B,A01,895543,Pappas; Elizabeth,44,0,45,1
1745796185654,EDS 139,A00,897203,Pappas; Elizabeth,44,0,45,1
1745796185654,EDS 139,B00,897209,Fargason; Sharon Gayle,44,0,45,1
1745796186684,EDS 201,A00,895545,Staff,43,0,45,2
1745796187712,EDS 203,A01,895581,Halter; Christopher P.,43,0,45,2
1745796188741,EDS 204R,A01,895625,Heinzman; Erica M.,43,0,45,2
1745796188741,EDS 204R,B01,895693,Halter; Christopher P.,18,0,45,27
1745796189769,EDS 206R,A00,895694,Fargason; Sharon Gayle,9,0,30,21
1745796189769,EDS 206R,B00,895695,Choi; Bailey Miyeon,20,0,30,10
1745796190795,EDS 250,A00,895697,Hemans; Patricia Ann Benitez,43,0,45,2
1745796191822,EDS 281,A00,895701,Meyerott; Theresa Ann,15,0,15,0
1745796192848,EDS 284,A00,895736,Meyerott; Theresa Ann,15,0,15,0
1745796193876,EDS 286,A00,897210,Fine; Sarah,15,0,15,0
1745796194903,EDS 289C,A01,895770,Daly; Alan J.,15,0,15,0
1745796195931,EDS 290,A00,897211,Hofstetter; Carolyn,15,0,15,0
1745796196960,LIGM 5A,A00,896162,Fischer-Grunski; Eva K,15,0,20,5
1745796197988,LIGM 5B,A00,896260,Fischer-Grunski; Eva K,17,0,20,3
1745796199016,LIGM 5C,A00,896308,Fischer-Grunski; Eva K,18,0,20,2
1745796200048,LIIT 5AS,A00,896313,Carnelos; Chiara,18,0,20,2
1745796201075,LIIT 5BS,A00,896416,Carnelos; Chiara,20,0,20,0
1745796202101,LIIT 5CS,A00,896564,Carnelos; Chiara,20,0,20,0
1745796203127,LISP 5A,A00,896588,Munoz Sanchez; Alicia,4,0,20,16
1745796204153,LISP 5B,A00,896653,Munoz Sanchez; Alicia,10,0,20,10
1745796205179,LISP 5C,A00,896655,Munoz Sanchez; Alicia,4,0,20,16
1745796206206,MAE 197,001,957918,Kleissl; Jan,9998,0,9999,1
1745796207236,MATH 2,A01,957937,Staff,34,0,35,1
1745796208264,MATH 197,001,957876,Kedlaya; Kiran S.,9993,0,9999,6
1745796209295,MCWP 40,A00,892729,Duru; Nur,13,0,20,7
1745796209295,MCWP 40,B00,893304,Montejo; Carolina,20,0,20,0
1745796210321,MCWP 40R,A00,893757,Redela; Pamela Morgan,0,6,20,20
1745796211351,MCWP 50,A00,893758,Morshed; Michael James,2,0,20,18
1745796211351,MCWP 50,B00,893761,Bartulis; Jason Michael,17,0,20,3
1745796212378,MCWP 50R,A00,893766,Compas; Sean Matthew,0,1,20,20
1745796212378,MCWP 50R,B00,893769,Carter; Jennifer A,0,0,20,20
1745796212378,MCWP 50R,C00,893771,Krone; Jarret,0,3,20,20
1745796212378,MCWP 50R,D00,893772,Miller; Elizabeth Deen,3,0,20,17
1745796212378,MCWP 50R,E00,893775,Carter; Andrea L,0,0,20,20
1745796213405,MMW 11R,A01,892721,Herbst; Matthew,11,0,27,16
1745796213405,MMW 11R,A02,892722,Herbst; Matthew,0,0,0,3
1745796214430,MMW 12R,A01,892724,Herbst; Matthew,0,9,16,16
1745796214430,MMW 12R,A02,892725,Herbst; Matthew,0,9,16,16
1745796215458,MMW 13R,A01,892727,Staff,0,4,16,16
1745796215458,MMW 13R,A02,892728,Staff,0,4,16,16
1745796215458,MMW 13R,A03,958032,Staff,0,3,16,16
1745796215458,MMW 13R,A04,958033,Staff,0,2,16,16
1745796215458,MMW 13R,A05,958034,Staff,0,3,16,16
1745796216486,SIO 295LS,A00,894015,Staff,7,0,25,18
1745796217512,SIO 295S,A00,894020,Staff,7,0,25,18
1745796218542,SIOC 290S,B01,958918,Staff,0,0,0,0
1745796219568,SIOC 291S,B01,958922,Staff,0,0,0,0
1745796220592,SOCI 117,A01,895339,Staff,4,0,5,1
1745796221622,WES 237B,A00,894149,Staff,11,0,20,9
1745796223685,AESE 279B,A00,891859,Staff,13,0,35,22
1745796224710,AIP 197,001,891854,Staff,70,0,70,0
1745796225735,ANTH 289S,A00,891856,Gagneux; Pascal,12,0,12,0
1745796226761,BENG 196,001,957946,Engler; Adam J.,9996,0,9999,3
1745796227789,CAT 124RS,A01,956906,Staff,8,0,25,17
1745796228816,CAT 125RS,A01,922013,Staff,8,0,25,17
1745796229842,CLRE 250,A00,891860,Morris; Sheldon,9995,0,9999,4
1745796231898,CLRE 251R,A00,907817,Mehta; Ravindra L.,9994,0,9999,5
1745796232927,CLRE 252,A00,891864,Cuomo; Raphael Eduardo,9993,0,9999,6
1745796233955,CLRE 253,A00,891867,Vaida; Florin,9994,0,9999,5
1745796233955,CLRE 253,B00,907819,Staff,9999,0,9999,0
1745796234981,CLRE 259,A00,891868,Patel; Hemal,9998,0,9999,1
1745796236006,CLRE 260,A00,891872,Cuomo; Raphael Eduardo,9999,0,9999,0
1745796237033,CLRE 297,001,891888,Cuomo; Raphael Eduardo,9999,0,9999,0
1745796238062,CSE 191,A00,958773,Minnes Kemp; Mor Mia,9999,0,9999,0
1745796239089,CSS 201S,A01,892054,Mignozzetti; Umberto,30,0,30,0
1745796240118,CSS 202S,A01,892056,Mignozzetti; Umberto,30,0,30,0
1745796241145,DSC 197,001,956898,Eldridge; Justin Matthew,9998,0,9999,1
1745796242170,DSC 297,001,958000,Mazumdar; Arya,9998,0,9999,1
1745796243196,EAP 100,A00,905686,Staff,9776,0,9999,223
1745796244225,ECE 45,A01,892618,Staff,0,12,50,50
1745796245254,ECE 109,A01,892620,Staff,0,43,0,0
1745796246281,ECE 111,A01,892719,Staff,0,7,50,50
1745796247309,ECE 197,001,957920,Mercier; Patrick Philip,9992,0,9999,7
1745796248335,ECON 178,A01,907814,Zhu; Ying,28,0,35,7
1745796249363,EDS 115,A00,895312,Staff,41,0,45,4
1745796250390,EDS 117,A01,895337,Staff,30,0,30,0
1745796251417,EDS 125,A00,895341,Jones; Gabrielle Anastasia,43,0,45,2
1745796252442,EDS 128A,A01,895459,Fargason; Sharon Gayle,44,0,45,1
1745796253466,EDS 128B,A01,895543,Pappas; Elizabeth,44,0,45,1
1745796254494,EDS 139,A00,897203,Pappas; Elizabeth,44,0,45,1
1745796254494,EDS 139,B00,897209,Fargason; Sharon Gayle,44,0,45,1
1745796255520,EDS 201,A00,895545,Staff,43,0,45,2
1745796256546,EDS 203,A01,895581,Halter; Christopher P.,43,0,45,2
1745796257573,EDS 204R,A01,895625,Heinzman; Erica M.,43,0,45,2
1745796257573,EDS 204R,B01,895693,Halter; Christopher P.,18,0,45,27
1745796258599,EDS 206R,A00,895694,Fargason; Sharon Gayle,9,0,30,21
1745796258599,EDS 206R,B00,895695,Choi; Bailey Miyeon,20,0,30,10
1745796259626,EDS 250,A00,895697,Hemans; Patricia Ann Benitez,43,0,45,2
1745796260656,EDS 281,A00,895701,Meyerott; Theresa Ann,15,0,15,0
1745796261682,EDS 284,A00,895736,Meyerott; Theresa Ann,15,0,15,0
1745796262709,EDS 286,A00,897210,Fine; Sarah,15,0,15,0
1745796263737,EDS 289C,A01,895770,Daly; Alan J.,15,0,15,0
1745796264767,EDS 290,A00,897211,Hofstetter; Carolyn,15,0,15,0
1745796265794,LIGM 5A,A00,896162,Fischer-Grunski; Eva K,15,0,20,5
1745796266822,LIGM 5B,A00,896260,Fischer-Grunski; Eva K,17,0,20,3
1745796267849,LIGM 5C,A00,896308,Fischer-Grunski; Eva K,18,0,20,2
1745796268877,LIIT 5AS,A00,896313,Carnelos; Chiara,18,0,20,2
1745796269906,LIIT 5BS,A00,896416,Carnelos; Chiara,20,0,20,0
1745796270937,LIIT 5CS,A00,896564,Carnelos; Chiara,20,0,20,0
1745796271964,LISP 5A,A00,896588,Munoz Sanchez; Alicia,4,0,20,16
1745796272993,LISP 5B,A00,896653,Munoz Sanchez; Alicia,10,0,20,10
1745796274022,LISP 5C,A00,896655,Munoz Sanchez; Alicia,4,0,20,16
1745796275052,MAE 197,001,957918,Kleissl; Jan,9998,0,9999,1
1745796276081,MATH 2,A01,957937,Staff,34,0,35,1
1745796277108,MATH 197,001,957876,Kedlaya; Kiran S.,9993,0,9999,6
1745796278133,MCWP 40,A00,892729,Duru; Nur,13,0,20,7
1745796278133,MCWP 40,B00,893304,Montejo; Carolina,20,0,20,0
1745796279159,MCWP 40R,A00,893757,Redela; Pamela Morgan,0,6,20,20
1745796280188,MCWP 50,A00,893758,Morshed; Michael James,2,0,20,18
1745796280188,MCWP 50,B00,893761,Bartulis; Jason Michael,17,0,20,3
1745796281213,MCWP 50R,A00,893766,Compas; Sean Matthew,0,1,20,20
1745796281213,MCWP 50R,B00,893769,Carter; Jennifer A,0,0,20,20
1745796281213,MCWP 50R,C00,893771,Krone; Jarret,0,3,20,20
1745796281213,MCWP 50R,D00,893772,Miller; Elizabeth Deen,3,0,20,17
1745796281213,MCWP 50R,E00,893775,Carter; Andrea L,0,0,20,20
1745796282241,MMW 11R,A01,892721,Herbst; Matthew,11,0,27,16
1745796282241,MMW 11R,A02,892722,Herbst; Matthew,0,0,0,3
1745796283269,MMW 12R,A01,892724,Herbst; Matthew,0,9,16,16
1745796283269,MMW 12R,A02,892725,Herbst; Matthew,0,9,16,16
1745796284295,MMW 13R,A01,892727,Staff,0,4,16,16
1745796284295,MMW 13R,A02,892728,Staff,0,4,16,16
1745796284295,MMW 13R,A03,958032,Staff,0,3,16,16
1745796284295,MMW 13R,A04,958033,Staff,0,2,16,16
1745796284295,MMW 13R,A05,958034,Staff,0,3,16,16
1745796285322,SIO 295LS,A00,894015,Staff,7,0,25,18
1745796286348,SIO 295S,A00,894020,Staff,7,0,25,18
1745796287375,SIOC 290S,B01,958918,Staff,0,0,0,0
1745796288402,SIOC 291S,B01,958922,Staff,0,0,0,0
1745796289429,SOCI 117,A01,895339,Staff,4,0,5,1
1745796290457,WES 237B,A00,894149,Staff,11,0,20,9
1745796292521,AESE 279B,A00,891859,Staff,13,0,35,22
1745796293548,AIP 197,001,891854,Staff,70,0,70,0
1745796294573,ANTH 289S,A00,891856,Gagneux; Pascal,12,0,12,0
1745796295598,BENG 196,001,957946,Engler; Adam J.,9996,0,9999,3
1745796296625,CAT 124RS,A01,956906,Staff,8,0,25,17
1745796297651,CAT 125RS,A01,922013,Staff,8,0,25,17
1745796298676,CLRE 250,A00,891860,Morris; Sheldon,9995,0,9999,4
1745796300731,CLRE 251R,A00,907817,Mehta; Ravindra L.,9994,0,9999,5
1745796301756,CLRE 252,A00,891864,Cuomo; Raphael Eduardo,9993,0,9999,6
1745796302783,CLRE 253,A00,891867,Vaida; Florin,9994,0,9999,5
1745796302783,CLRE 253,B00,907819,Staff,9999,0,9999,0
1745796303813,CLRE 259,A00,891868,Patel; Hemal,9998,0,9999,1
1745796304840,CLRE 260,A00,891872,Cuomo; Raphael Eduardo,9999,0,9999,0
1745796305867,CLRE 297,001,891888,Cuomo; Raphael Eduardo,9999,0,9999,0
1745796306896,CSE 191,A00,958773,Minnes Kemp; Mor Mia,9999,0,9999,0
1745796307921,CSS 201S,A01,892054,Mignozzetti; Umberto,30,0,30,0
1745796308948,CSS 202S,A01,892056,Mignozzetti; Umberto,30,0,30,0
1745796309973,DSC 197,001,956898,Eldridge; Justin Matthew,9998,0,9999,1
1745796311000,DSC 297,001,958000,Mazumdar; Arya,9998,0,9999,1
1745796312027,EAP 100,A00,905686,Staff,9776,0,9999,223
1745796313054,ECE 45,A01,892618,Staff,0,12,50,50
1745796314083,ECE 109,A01,892620,Staff,0,43,0,0
1745796315110,ECE 111,A01,892719,Staff,0,7,50,50
1745796316136,ECE 197,001,957920,Mercier; Patrick Philip,9992,0,9999,7
1745796317167,ECON 178,A01,907814,Zhu; Ying,28,0,35,7
1745796318193,EDS 115,A00,895312,Staff,41,0,45,4
1745796319220,EDS 117,A01,895337,Staff,30,0,30,0
1745796320249,EDS 125,A00,895341,Jones; Gabrielle Anastasia,43,0,45,2
1745796321275,EDS 128A,A01,895459,Fargason; Sharon Gayle,44,0,45,1
1745796322301,EDS 128B,A01,895543,Pappas; Elizabeth,44,0,45,1
1745796323329,EDS 139,A00,897203,Pappas; Elizabeth,44,0,45,1
1745796323329,EDS 139,B00,897209,Fargason; Sharon Gayle,44,0,45,1
1745796324358,EDS 201,A00,895545,Staff,43,0,45,2
1745796325387,EDS 203,A01,895581,Halter; Christopher P.,43,0,45,2
1745796326416,EDS 204R,A01,895625,Heinzman; Erica M.,43,0,45,2
1745796326416,EDS 204R,B01,895693,Halter; Christopher P.,18,0,45,27
1745796327444,EDS 206R,A00,895694,Fargason; Sharon Gayle,9,0,30,21
1745796327444,EDS 206R,B00,895695,Choi; Bailey Miyeon,20,0,30,10
1745796328468,EDS 250,A00,895697,Hemans; Patricia Ann Benitez,43,0,45,2
1745796329494,EDS 281,A00,895701,Meyerott; Theresa Ann,15,0,15,0
1745796330520,EDS 284,A00,895736,Meyerott; Theresa Ann,15,0,15,0
1745796331545,EDS 286,A00,897210,Fine; Sarah,15,0,15,0
1745796332572,EDS 289C,A01,895770,Daly; Alan J.,15,0,15,0
1745796333598,EDS 290,A00,897211,Hofstetter; Carolyn,15,0,15,0
1745796334623,LIGM 5A,A00,896162,Fischer-Grunski; Eva K,15,0,20,5
1745796335650,LIGM 5B,A00,896260,Fischer-Grunski; Eva K,17,0,20,3
1745796336676,LIGM 5C,A00,896308,Fischer-Grunski; Eva K,18,0,20,2
1745796337706,LIIT 5AS,A00,896313,Carnelos; Chiara,18,0,20,2
1745796338731,LIIT 5BS,A00,896416,Carnelos; Chiara,20,0,20,0
1745796339759,LIIT 5CS,A00,896564,Carnelos; Chiara,20,0,20,0
1745796340788,LISP 5A,A00,896588,Munoz Sanchez; Alicia,4,0,20,16
1745796341814,LISP 5B,A00,896653,Munoz Sanchez; Alicia,10,0,20,10
1745796342839,LISP 5C,A00,896655,Munoz Sanchez; Alicia,4,0,20,16
1745796343867,MAE 197,001,957918,Kleissl; Jan,9998,0,9999,1
1745796344894,MATH 2,A01,957937,Staff,34,0,35,1
1745796345919,MATH 197,001,957876,Kedlaya; Kiran S.,9993,0,9999,6
1745796346947,MCWP 40,A00,892729,Duru; Nur,13,0,20,7
1745796346947,MCWP 40,B00,893304,Montejo; Carolina,20,0,20,0
1745796347972,MCWP 40R,A00,893757,Redela; Pamela Morgan,0,6,20,20
1745796349001,MCWP 50,A00,893758,Morshed; Michael James,2,0,20,18
1745796349001,MCWP 50,B00,893761,Bartulis; Jason Michael,17,0,20,3
1745796350028,MCWP 50R,A00,893766,Compas; Sean Matthew,0,1,20,20
1745796350028,MCWP 50R,B00,893769,Carter; Jennifer A,0,0,20,20
1745796350028,MCWP 50R,C00,893771,Krone; Jarret,0,3,20,20
1745796350028,MCWP 50R,D00,893772,Miller; Elizabeth Deen,3,0,20,17
1745796350028,MCWP 50R,E00,893775,Carter; Andrea L,0,0,20,20
1745796351055,MMW 11R,A01,892721,Herbst; Matthew,11,0,27,16
1745796351055,MMW 11R,A02,892722,Herbst; Matthew,0,0,0,3
1745796352082,MMW 12R,A01,892724,Herbst; Matthew,0,9,16,16
1745796352082,MMW 12R,A02,892725,Herbst; Matthew,0,9,16,16
1745796353108,MMW 13R,A01,892727,Staff,0,4,16,16
1745796353108,MMW 13R,A02,892728,Staff,0,4,16,16
1745796353108,MMW 13R,A03,958032,Staff,0,3,16,16
1745796353108,MMW 13R,A04,958033,Staff,0,2,16,16
1745796353108,MMW 13R,A05,958034,Staff,0,3,16,16
1745796354137,SIO 295LS,A00,894015,Staff,7,0,25,18
1745796355163,SIO 295S,A00,894020,Staff,7,0,25,18
1745796356192,SIOC 290S,B01,958918,Staff,0,0,0,0
1745796357218,SIOC 291S,B01,958922,Staff,0,0,0,0
1745796358246,SOCI 117,A01,895339,Staff,4,0,5,1
1745796359274,WES 237B,A00,894149,Staff,11,0,20,9
1745796361335,AESE 279B,A00,891859,Staff,13,0,35,22
1745796362359,AIP 197,001,891854,Staff,70,0,70,0
1745796363388,ANTH 289S,A00,891856,Gagneux; Pascal,12,0,12,0
1745796364413,BENG 196,001,957946,Engler; Adam J.,9996,0,9999,3
1745796365440,CAT 124RS,A01,956906,Staff,8,0,25,17
1745796366468,CAT 125RS,A01,922013,Staff,8,0,25,17
1745796367494,CLRE 250,A00,891860,Morris; Sheldon,9995,0,9999,4
1745796369549,CLRE 251R,A00,907817,Mehta; Ravindra L.,9994,0,9999,5
1745796370573,CLRE 252,A00,891864,Cuomo; Raphael Eduardo,9993,0,9999,6
1745796371599,CLRE 253,A00,891867,Vaida; Florin,9994,0,9999,5
1745796371599,CLRE 253,B00,907819,Staff,9999,0,9999,0
1745796372626,CLRE 259,A00,891868,Patel; Hemal,9998,0,9999,1
1745796373651,CLRE 260,A00,891872,Cuomo; Raphael Eduardo,9999,0,9999,0
1745796374678,CLRE 297,001,891888,Cuomo; Raphael Eduardo,9999,0,9999,0
1745796375703,CSE 191,A00,958773,Minnes Kemp; Mor Mia,9999,0,9999,0
1745796376728,CSS 201S,A01,892054,Mignozzetti; Umberto,30,0,30,0
1745796377755,CSS 202S,A01,892056,Mignozzetti; Umberto,30,0,30,0
1745796378839,DSC 197,001,956898,Eldridge; Justin Matthew,9998,0,9999,1
1745796379863,DSC 297,001,958000,Mazumdar; Arya,9998,0,9999,1
1745796380889,EAP 100,A00,905686,Staff,9776,0,9999,223
1745796381914,ECE 45,A01,892618,Staff,0,12,50,50
1745796382941,ECE 109,A01,892620,Staff,0,43,0,0
1745796383968,ECE 111,A01,892719,Staff,0,7,50,50
1745796384996,ECE 197,001,957920,Mercier; Patrick Philip,9992,0,9999,7
1745796386022,ECON 178,A01,907814,Zhu; Ying,28,0,35,7
1745796387051,EDS 115,A00,895312,Staff,41,0,45,4
1745796388079,EDS 117,A01,895337,Staff,30,0,30,0
1745796389108,EDS 125,A00,895341,Jones; Gabrielle Anastasia,43,0,45,2
1745796390134,EDS 128A,A01,895459,Fargason; Sharon Gayle,44,0,45,1
1745796391164,EDS 128B,A01,895543,Pappas; Elizabeth,44,0,45,1
1745796392191,EDS 139,A00,897203,Pappas; Elizabeth,44,0,45,1
1745796392191,EDS 139,B00,897209,Fargason; Sharon Gayle,44,0,45,1
1745796393216,EDS 201,A00,895545,Staff,43,0,45,2
1745796394245,EDS 203,A01,895581,Halter; Christopher P.,43,0,45,2
1745796395270,EDS 204R,A01,895625,Heinzman; Erica M.,43,0,45,2
1745796395270,EDS 204R,B01,895693,Halter; Christopher P.,18,0,45,27
1745796396296,EDS 206R,A00,895694,Fargason; Sharon Gayle,9,0,30,21
1745796396296,EDS 206R,B00,895695,Choi; Bailey Miyeon,20,0,30,10
1745796397321,EDS 250,A00,895697,Hemans; Patricia Ann Benitez,43,0,45,2
1745796398346,EDS 281,A00,895701,Meyerott; Theresa Ann,15,0,15,0
1745796399371,EDS 284,A00,895736,Meyerott; Theresa Ann,15,0,15,0
1745796400397,EDS 286,A00,897210,Fine; Sarah,15,0,15,0
1745796401424,EDS 289C,A01,895770,Daly; Alan J.,15,0,15,0
1745796402451,EDS 290,A00,897211,Hofstetter; Carolyn,15,0,15,0
1745796403477,LIGM 5A,A00,896162,Fischer-Grunski; Eva K,15,0,20,5
1745796404503,LIGM 5B,A00,896260,Fischer-Grunski; Eva K,17,0,20,3
1745796405529,LIGM 5C,A00,896308,Fischer-Grunski; Eva K,18,0,20,2
1745796406559,LIIT 5AS,A00,896313,Carnelos; Chiara,18,0,20,2
1745796407585,LIIT 5BS,A00,896416,Carnelos; Chiara,20,0,20,0
1745796408611,LIIT 5CS,A00,896564,Carnelos; Chiara,20,0,20,0
1745796409637,LISP 5A,A00,896588,Munoz Sanchez; Alicia,4,0,20,16
1745796410663,LISP 5B,A00,896653,Munoz Sanchez; Alicia,10,0,20,10
1745796411690,LISP 5C,A00,896655,Munoz Sanchez; Alicia,4,0,20,16
1745796412715,MAE 197,001,957918,Kleissl; Jan,9998,0,9999,1
1745796413742,MATH 2,A01,957937,Staff,34,0,35,1
1745796414769,MATH 197,001,957876,Kedlaya; Kiran S.,9993,0,9999,6
1745796415794,MCWP 40,A00,892729,Duru; Nur,13,0,20,7
1745796415794,MCWP 40,B00,893304,Montejo; Carolina,20,0,20,0
1745796416836,MCWP 40R,A00,893757,Redela; Pamela Morgan,0,6,20,20
1745796417862,MCWP 50,A00,893758,Morshed; Michael James,2,0,20,18
1745796417862,MCWP 50,B00,893761,Bartulis; Jason Michael,17,0,20,3
1745796418892,MCWP 50R,A00,893766,Compas; Sean Matthew,0,1,20,20
1745796418892,MCWP 50R,B00,893769,Carter; Jennifer A,0,0,20,20
1745796418892,MCWP 50R,C00,893771,Krone; Jarret,0,3,20,20
1745796418892,MCWP 50R,D00,893772,Miller; Elizabeth Deen,3,0,20,17
1745796418892,MCWP 50R,E00,893775,Carter; Andrea L,0,0,20,20
1745796419919,MMW 11R,A01,892721,Herbst; Matthew,11,0,27,16
1745796419919,MMW 11R,A02,892722,Herbst; Matthew,0,0,0,3
1745796420947,MMW 12R,A01,892724,Herbst; Matthew,0,9,16,16
1745796420947,MMW 12R,A02,892725,Herbst; Matthew,0,9,16,16
1745796421977,MMW 13R,A01,892727,Staff,0,4,16,16
1745796421977,MMW 13R,A02,892728,Staff,0,4,16,16
1745796421977,MMW 13R,A03,958032,Staff,0,3,16,16
1745796421977,MMW 13R,A04,958033,Staff,0,2,16,16
1745796421977,MMW 13R,A05,958034,Staff,0,3,16,16
1745796423005,SIO 295LS,A00,894015,Staff,7,0,25,18
1745796424034,SIO 295S,A00,894020,Staff,7,0,25,18
1745796425060,SIOC 290S,B01,958918,Staff,0,0,0,0
1745796426090,SIOC 291S,B01,958922,Staff,0,0,0,0
1745796427115,SOCI 117,A01,895339,Staff,4,0,5,1
1745796428143,WES 237B,A00,894149,Staff,11,0,20,9
1745796430203,AESE 279B,A00,891859,Staff,13,0,35,22
1745796431232,AIP 197,001,891854,Staff,70,0,70,0
1745796432257,ANTH 289S,A00,891856,Gagneux; Pascal,12,0,12,0
1745796433285,BENG 196,001,957946,Engler; Adam J.,9996,0,9999,3
1745796434314,CAT 124RS,A01,956906,Staff,8,0,25,17
1745796435340,CAT 125RS,A01,922013,Staff,8,0,25,17
1745796436373,CLRE 250,A00,891860,Morris; Sheldon,9995,0,9999,4
1745796438426,CLRE 251R,A00,907817,Mehta; Ravindra L.,9994,0,9999,5
1745796439454,CLRE 252,A00,891864,Cuomo; Raphael Eduardo,9993,0,9999,6
1745796440484,CLRE 253,A00,891867,Vaida; Florin,9994,0,9999,5
1745796440484,CLRE 253,B00,907819,Staff,9999,0,9999,0
1745796441509,CLRE 259,A00,891868,Patel; Hemal,9998,0,9999,1
1745796442538,CLRE 260,A00,891872,Cuomo; Raphael Eduardo,9999,0,9999,0
1745796443563,CLRE 297,001,891888,Cuomo; Raphael Eduardo,9999,0,9999,0
1745796444590,CSE 191,A00,958773,Minnes Kemp; Mor Mia,9999,0,9999,0
1745796445615,CSS 201S,A01,892054,Mignozzetti; Umberto,30,0,30,0
1745796446641,CSS 202S,A01,892056,Mignozzetti; Umberto,30,0,30,0
1745796447667,DSC 197,001,956898,Eldridge; Justin Matthew,9998,0,9999,1
1745796448691,DSC 297,001,958000,Mazumdar; Arya,9998,0,9999,1
1745796449718,EAP 100,A00,905686,Staff,9776,0,9999,223
1745796450745,ECE 45,A01,892618,Staff,0,12,50,50
1745796451773,ECE 109,A01,892620,Staff,0,43,0,0
1745796452801,ECE 111,A01,892719,Staff,0,7,50,50
1745796453829,ECE 197,001,957920,Mercier; Patrick Philip,9992,0,9999,7
1745796454855,ECON 178,A01,907814,Zhu; Ying,28,0,35,7
1745796455882,EDS 115,A00,895312,Staff,41,0,45,4
1745796456909,EDS 117,A01,895337,Staff,30,0,30,0
1745796457938,EDS 125,A00,895341,Jones; Gabrielle Anastasia,43,0,45,2
1745796458965,EDS 128A,A01,895459,Fargason; Sharon Gayle,44,0,45,1
1745796459994,EDS 128B,A01,895543,Pappas; Elizabeth,44,0,45,1
1745796461018,EDS 139,A00,897203,Pappas; Elizabeth,44,0,45,1
1745796461018,EDS 139,B00,897209,Fargason; Sharon Gayle,44,0,45,1
1745796462571,EDS 201,A00,895545,Staff,43,0,45,2
1745796463599,EDS 203,A01,895581,Halter; Christopher P.,43,0,45,2
1745796464628,EDS 204R,A01,895625,Heinzman; Erica M.,43,0,45,2
1745796464628,EDS 204R,B01,895693,Halter; Christopher P.,18,0,45,27
1745796465657,EDS 206R,A00,895694,Fargason; Sharon Gayle,9,0,30,21
1745796465657,EDS 206R,B00,895695,Choi; Bailey Miyeon,20,0,30,10
1745796466682,EDS 250,A00,895697,Hemans; Patricia Ann Benitez,43,0,45,2
1745796467707,EDS 281,A00,895701,Meyerott; Theresa Ann,15,0,15,0
1745796468732,EDS 284,A00,895736,Meyerott; Theresa Ann,15,0,15,0
1745796469759,EDS 286,A00,897210,Fine; Sarah,15,0,15,0
1745796470785,EDS 289C,A01,895770,Daly; Alan J.,15,0,15,0
1745796471812,EDS 290,A00,897211,Hofstetter; Carolyn,15,0,15,0
1745796472842,LIGM 5A,A00,896162,Fischer-Grunski; Eva K,15,0,20,5
1745796473871,LIGM 5B,A00,896260,Fischer-Grunski; Eva K,17,0,20,3
1745796474897,LIGM 5C,A00,896308,Fischer-Grunski; Eva K,18,0,20,2
1745796475925,LIIT 5AS,A00,896313,Carnelos; Chiara,18,0,20,2
1745796476951,LIIT 5BS,A00,896416,Carnelos; Chiara,20,0,20,0
1745796477981,LIIT 5CS,A00,896564,Carnelos; Chiara,20,0,20,0
1745796479008,LISP 5A,A00,896588,Munoz Sanchez; Alicia,4,0,20,16
1745796480037,LISP 5B,A00,896653,Munoz Sanchez; Alicia,10,0,20,10
1745796481066,LISP 5C,A00,896655,Munoz Sanchez; Alicia,4,0,20,16
1745796482094,MAE 197,001,957918,Kleissl; Jan,9998,0,9999,1
1745796483121,MATH 2,A01,957937,Staff,34,0,35,1
1745796484148,MATH 197,001,957876,Kedlaya; Kiran S.,9993,0,9999,6
1745796485174,MCWP 40,A00,892729,Duru; Nur,13,0,20,7
1745796485174,MCWP 40,B00,893304,Montejo; Carolina,20,0,20,0
1745796486199,MCWP 40R,A00,893757,Redela; Pamela Morgan,0,6,20,20
1745796487226,MCWP 50,A00,893758,Morshed; Michael James,2,0,20,18
1745796487226,MCWP 50,B00,893761,Bartulis; Jason Michael,17,0,20,3
1745796488253,MCWP 50R,A00,893766,Compas; Sean Matthew,0,1,20,20
1745796488253,MCWP 50R,B00,893769,Carter; Jennifer A,0,0,20,20
1745796488253,MCWP 50R,C00,893771,Krone; Jarret,0,3,20,20
1745796488253,MCWP 50R,D00,893772,Miller; Elizabeth Deen,3,0,20,17
1745796488253,MCWP 50R,E00,893775,Carter; Andrea L,0,0,20,20
1745796489278,MMW 11R,A01,892721,Herbst; Matthew,11,0,27,16
1745796489278,MMW 11R,A02,892722,Herbst; Matthew,0,0,0,3
1745796490304,MMW 12R,A01,892724,Herbst; Matthew,0,9,16,16
1745796490304,MMW 12R,A02,892725,Herbst; Matthew,0,9,16,16
1745796491334,MMW 13R,A01,892727,Staff,0,4,16,16
1745796491334,MMW 13R,A02,892728,Staff,0,4,16,16
1745796491334,MMW 13R,A03,958032,Staff,0,3,16,16
1745796491334,MMW 13R,A04,958033,Staff,0,2,16,16
1745796491334,MMW 13R,A05,958034,Staff,0,3,16,16
1745796492362,SIO 295LS,A00,894015,Staff,7,0,25,18
1745796493387,SIO 295S,A00,894020,Staff,7,0,25,18
1745796494413,SIOC 290S,B01,958918,Staff,0,0,0,0
1745796495443,SIOC 291S,B01,958922,Staff,0,0,0,0
1745796496471,SOCI 117,A01,895339,Staff,4,0,5,1
1745796497499,WES 237B,A00,894149,Staff,11,0,20,9
1745796499557,AESE 279B,A00,891859,Staff,13,0,35,22
1745796500585,AIP 197,001,891854,Staff,70,0,70,0
1745796501612,ANTH 289S,A00,891856,Gagneux; Pascal,12,0,12,0
1745796502639,BENG 196,001,957946,Engler; Adam J.,9996,0,9999,3
1745796503664,CAT 124RS,A01,956906,Staff,8,0,25,17
1745796504690,CAT 125RS,A01,922013,Staff,8,0,25,17
1745796505719,CLRE 250,A00,891860,Morris; Sheldon,9995,0,9999,4
1745796507774,CLRE 251R,A00,907817,Mehta; Ravindra L.,9994,0,9999,5
1745796508825,CLRE 252,A00,891864,Cuomo; Raphael Eduardo,9993,0,9999,6
1745796509854,CLRE 253,A00,891867,Vaida; Florin,9994,0,9999,5
1745796509854,CLRE 253,B00,907819,Staff,9999,0,9999,0
1745796510881,CLRE 259,A00,891868,Patel; Hemal,9998,0,9999,1
1745796511907,CLRE 260,A00,891872,Cuomo; Raphael Eduardo,9999,0,9999,0
1745796512932,CLRE 297,001,891888,Cuomo; Raphael Eduardo,9999,0,9999,0
1745796513958,CSE 191,A00,958773,Minnes Kemp; Mor Mia,9999,0,9999,0
1745796514985,CSS 201S,A01,892054,Mignozzetti; Umberto,30,0,30,0
1745796516012,CSS 202S,A01,892056,Mignozzetti; Umberto,30,0,30,0
1745796517092,DSC 197,001,956898,Eldridge; Justin Matthew,9998,0,9999,1
1745796518120,DSC 297,001,958000,Mazumdar; Arya,9998,0,9999,1
1745796519147,EAP 100,A00,905686,Staff,9776,0,9999,223
1745796520178,ECE 45,A01,892618,Staff,0,12,50,50
1745796521205,ECE 109,A01,892620,Staff,0,43,0,0
1745796522230,ECE 111,A01,892719,Staff,0,7,50,50
1745796523256,ECE 197,001,957920,Mercier; Patrick Philip,9992,0,9999,7
1745796524286,ECON 178,A01,907814,Zhu; Ying,28,0,35,7
1745796525315,EDS 115,A00,895312,Staff,41,0,45,4
1745796526341,EDS 117,A01,895337,Staff,30,0,30,0
1745796527371,EDS 125,A00,895341,Jones; Gabrielle Anastasia,43,0,45,2
1745796528397,EDS 128A,A01,895459,Fargason; Sharon Gayle,44,0,45,1
1745796529426,EDS 128B,A01,895543,Pappas; Elizabeth,44,0,45,1
1745796530455,EDS 139,A00,897203,Pappas; Elizabeth,44,0,45,1
1745796530455,EDS 139,B00,897209,Fargason; Sharon Gayle,44,0,45,1
1745796531481,EDS 201,A00,895545,Staff,43,0,45,2
1745796532510,EDS 203,A01,895581,Halter; Christopher P.,43,0,45,2
1745796533535,EDS 204R,A01,895625,Heinzman; Erica M.,43,0,45,2
1745796533535,EDS 204R,B01,895693,Halter; Christopher P.,18,0,45,27
1745796534562,EDS 206R,A00,895694,Fargason; Sharon Gayle,9,0,30,21
1745796534562,EDS 206R,B00,895695,Choi; Bailey Miyeon,20,0,30,10
1745796535589,EDS 250,A00,895697,Hemans; Patricia Ann Benitez,43,0,45,2
1745796536616,EDS 281,A00,895701,Meyerott; Theresa Ann,15,0,15,0
1745796537641,EDS 284,A00,895736,Meyerott; Theresa Ann,15,0,15,0
1745796538666,EDS 286,A00,897210,Fine; Sarah,15,0,15,0
1745796539691,EDS 289C,A01,895770,Daly; Alan J.,15,0,15,0
1745796540717,EDS 290,A00,897211,Hofstetter; Carolyn,15,0,15,0
1745796541743,LIGM 5A,A00,896162,Fischer-Grunski; Eva K,15,0,20,5
1745796542770,LIGM 5B,A00,896260,Fischer-Grunski; Eva K,17,0,20,3
1745796543800,LIGM 5C,A00,896308,Fischer-Grunski; Eva K,18,0,20,2
1745796544831,LIIT 5AS,A00,896313,Carnelos; Chiara,18,0,20,2
1745796545857,LIIT 5BS,A00,896416,Carnelos; Chiara,20,0,20,0
1745796546886,LIIT 5CS,A00,896564,Carnelos; Chiara,20,0,20,0
1745796547915,LISP 5A,A00,896588,Munoz Sanchez; Alicia,4,0,20,16
1745796548945,LISP 5B,A00,896653,Munoz Sanchez; Alicia,10,0,20,10
1745796549971,LISP 5C,A00,896655,Munoz Sanchez; Alicia,4,0,20,16
1745796551000,MAE 197,001,957918,Kleissl; Jan,9998,0,9999,1
1745796552028,MATH 2,A01,957937,Staff,34,0,35,1
1745796553055,MATH 197,001,957876,Kedlaya; Kiran S.,9993,0,9999,6
1745796554080,MCWP 40,A00,892729,Duru; Nur,13,0,20,7
1745796554080,MCWP 40,B00,893304,Montejo; Carolina,20,0,20,0
1745796555105,MCWP 40R,A00,893757,Redela; Pamela Morgan,0,6,20,20
1745796556130,MCWP 50,A00,893758,Morshed; Michael James,2,0,20,18
1745796556130,MCWP 50,B00,893761,Bartulis; Jason Michael,17,0,20,3
1745796557157,MCWP 50R,A00,893766,Compas; Sean Matthew,0,1,20,20
1745796557157,MCWP 50R,B00,893769,Carter; Jennifer A,0,0,20,20
1745796557157,MCWP 50R,C00,893771,Krone; Jarret,0,3,20,20
1745796557157,MCWP 50R,D00,893772,Miller; Elizabeth Deen,3,0,20,17
1745796557157,MCWP 50R,E00,893775,Carter; Andrea L,0,0,20,20
1745796558187,MMW 11R,A01,892721,Herbst; Matthew,11,0,27,16
1745796558187,MMW 11R,A02,892722,Herbst; Matthew,0,0,0,3
1745796559213,MMW 12R,A01,892724,Herbst; Matthew,0,9,16,16
1745796559213,MMW 12R,A02,892725,Herbst; Matthew,0,9,16,16
1745796560242,MMW 13R,A01,892727,Staff,0,4,16,16
1745796560242,MMW 13R,A02,892728,Staff,0,4,16,16
1745796560242,MMW 13R,A03,958032,Staff,0,3,16,16
1745796560242,MMW 13R,A04,958033,Staff,0,2,16,16
1745796560242,MMW 13R,A05,958034,Staff,0,3,16,16
1745796561272,SIO 295LS,A00,894015,Staff,7,0,25,18
1745796562299,SIO 295S,A00,894020,Staff,7,0,25,18
1745796563330,SIOC 290S,B01,958918,Staff,0,0,0,0
1745796564359,SIOC 291S,B01,958922,Staff,0,0,0,0
1745796565383,SOCI 117,A01,895339,Staff,4,0,5,1
1745796566411,WES 237B,A00,894149,Staff,11,0,20,9
1745796568469,AESE 279B,A00,891859,Staff,13,0,35,22
1745796569493,AIP 197,001,891854,Staff,70,0,70,0
1745796570519,ANTH 289S,A00,891856,Gagneux; Pascal,12,0,12,0
1745796571546,BENG 196,001,957946,Engler; Adam J.,9996,0,9999,3
1745796572572,CAT 124RS,A01,956906,Staff,8,0,25,17
1745796573602,CAT 125RS,A01,922013,Staff,8,0,25,17
1745796574626,CLRE 250,A00,891860,Morris; Sheldon,9995,0,9999,4
1745796576681,CLRE 251R,A00,907817,Mehta; Ravindra L.,9994,0,9999,5
1745796577707,CLRE 252,A00,891864,Cuomo; Raphael Eduardo,9993,0,9999,6
1745796578734,CLRE 253,A00,891867,Vaida; Florin,9994,0,9999,5
1745796578734,CLRE 253,B00,907819,Staff,9999,0,9999,0
1745796579760,CLRE 259,A00,891868,Patel; Hemal,9998,0,9999,1
1745796580787,CLRE 260,A00,891872,Cuomo; Raphael Eduardo,9999,0,9999,0
1745796581813,CLRE 297,001,891888,Cuomo; Raphael Eduardo,9999,0,9999,0
1745796582840,CSE 191,A00,958773,Minnes Kemp; Mor Mia,9999,0,9999,0
1745796583869,CSS 201S,A01,892054,Mignozzetti; Umberto,30,0,30,0
1745796584900,CSS 202S,A01,892056,Mignozzetti; Umberto,30,0,30,0
1745796585926,DSC 197,001,956898,Eldridge; Justin Matthew,9998,0,9999,1
1745796586952,DSC 297,001,958000,Mazumdar; Arya,9998,0,9999,1
1745796587979,EAP 100,A00,905686,Staff,9776,0,9999,223
1745796589005,ECE 45,A01,892618,Staff,0,12,50,50
1745796590031,ECE 109,A01,892620,Staff,0,43,0,0
1745796591059,ECE 111,A01,892719,Staff,0,7,50,50
1745796592084,ECE 197,001,957920,Mercier; Patrick Philip,9992,0,9999,7
1745796593113,ECON 178,A01,907814,Zhu; Ying,28,0,35,7
1745796594142,EDS 115,A00,895312,Staff,41,0,45,4
1745796595166,EDS 117,A01,895337,Staff,30,0,30,0
1745796596193,EDS 125,A00,895341,Jones; Gabrielle Anastasia,43,0,45,2
1745796597219,EDS 128A,A01,895459,Fargason; Sharon Gayle,44,0,45,1
1745796598246,EDS 128B,A01,895543,Pappas; Elizabeth,44,0,45,1
1745796599276,EDS 139,A00,897203,Pappas; Elizabeth,44,0,45,1
1745796599276,EDS 139,B00,897209,Fargason; Sharon Gayle,44,0,45,1
1745796600303,EDS 201,A00,895545,Staff,43,0,45,2
1745796601330,EDS 203,A01,895581,Halter; Christopher P.,43,0,45,2
1745796602357,EDS 204R,A01,895625,Heinzman; Erica M.,43,0,45,2
1745796602357,EDS 204R,B01,895693,Halter; Christopher P.,18,0,45,27
1745796603385,EDS 206R,A00,895694,Fargason; Sharon Gayle,9,0,30,21
1745796603385,EDS 206R,B00,895695,Choi; Bailey Miyeon,20,0,30,10
1745796604413,EDS 250,A00,895697,Hemans; Patricia Ann Benitez,43,0,45,2
1745796605442,EDS 281,A00,895701,Meyerott; Theresa Ann,15,0,15,0
1745796606467,EDS 284,A00,895736,Meyerott; Theresa Ann,15,0,15,0
1745796607492,EDS 286,A00,897210,Fine; Sarah,15,0,15,0
1745796608519,EDS 289C,A01,895770,Daly; Alan J.,15,0,15,0
1745796609546,EDS 290,A00,897211,Hofstetter; Carolyn,15,0,15,0
1745796610571,LIGM 5A,A00,896162,Fischer-Grunski; Eva K,15,0,20,5
1745796611597,LIGM 5B,A00,896260,Fischer-Grunski; Eva K,17,0,20,3
1745796612632,LIGM 5C,A00,896308,Fischer-Grunski; Eva K,18,0,20,2
1745796613655,LIIT 5AS,A00,896313,Carnelos; Chiara,18,0,20,2
1745796614681,LIIT 5BS,A00,896416,Carnelos; Chiara,20,0,20,0
1745796615711,LIIT 5CS,A00,896564,Carnelos; Chiara,20,0,20,0
1745796616737,LISP 5A,A00,896588,Munoz Sanchez; Alicia,4,0,20,16
1745796617764,LISP 5B,A00,896653,Munoz Sanchez; Alicia,10,0,20,10
1745796618791,LISP 5C,A00,896655,Munoz Sanchez; Alicia,4,0,20,16
1745796619815,MAE 197,001,957918,Kleissl; Jan,9998,0,9999,1
1745796620880,MATH 2,A01,957937,Staff,34,0,35,1
1745796621907,MATH 197,001,957876,Kedlaya; Kiran S.,9993,0,9999,6
1745796622933,MCWP 40,A00,892729,Duru; Nur,13,0,20,7
1745796622933,MCWP 40,B00,893304,Montejo; Carolina,20,0,20,0
1745796623962,MCWP 40R,A00,893757,Redela; Pamela Morgan,0,6,20,20
1745796624990,MCWP 50,A00,893758,Morshed; Michael James,2,0,20,18
1745796624990,MCWP 50,B00,893761,Bartulis; Jason Michael,17,0,20,3
1745796626016,MCWP 50R,A00,893766,Compas; Sean Matthew,0,1,20,20
1745796626016,MCWP 50R,B00,893769,Carter; Jennifer A,0,0,20,20
1745796626016,MCWP 50R,C00,893771,Krone; Jarret,0,3,20,20
1745796626016,MCWP 50R,D00,893772,Miller; Elizabeth Deen,3,0,20,17
1745796626016,MCWP 50R,E00,893775,Carter; Andrea L,0,0,20,20
1745796627045,MMW 11R,A01,892721,Herbst; Matthew,11,0,27,16
1745796627045,MMW 11R,A02,892722,Herbst; Matthew,0,0,0,3
1745796628070,MMW 12R,A01,892724,Herbst; Matthew,0,9,16,16
1745796628070,MMW 12R,A02,892725,Herbst; Matthew,0,9,16,16
1745796629097,MMW 13R,A01,892727,Staff,0,4,16,16
1745796629097,MMW 13R,A02,892728,Staff,0,4,16,16
1745796629097,MMW 13R,A03,958032,Staff,0,3,16,16
1745796629097,MMW 13R,A04,958033,Staff,0,2,16,16
1745796629097,MMW 13R,A05,958034,Staff,0,3,16,16
1745796630123,SIO 295LS,A00,894015,Staff,7,0,25,18
1745796631150,SIO 295S,A00,894020,Staff,7,0,25,18
1745796632180,SIOC 290S,B01,958918,Staff,0,0,0,0
1745796633209,SIOC 291S,B01,958922,Staff,0,0,0,0
1745796634236,SOCI 117,A01,895339,Staff,4,0,5,1
1745796635262,WES 237B,A00,894149,Staff,11,0,20,9
1745796637321,AESE 279B,A00,891859,Staff,13,0,35,22
1745796638348,AIP 197,001,891854,Staff,70,0,70,0
1745796639375,ANTH 289S,A00,891856,Gagneux; Pascal,12,0,12,0
1745796640402,BENG 196,001,957946,Engler; Adam J.,9996,0,9999,3
1745796641430,CAT 124RS,A01,956906,Staff,8,0,25,17
1745796642459,CAT 125RS,A01,922013,Staff,8,0,25,17
1745796643485,CLRE 250,A00,891860,Morris; Sheldon,9995,0,9999,4
1745796645542,CLRE 251R,A00,907817,Mehta; Ravindra L.,9994,0,9999,5
1745796646567,CLRE 252,A00,891864,Cuomo; Raphael Eduardo,9993,0,9999,6
1745796647643,CLRE 253,A00,891867,Vaida; Florin,9994,0,9999,5
1745796647643,CLRE 253,B00,907819,Staff,9999,0,9999,0
1745796648667,CLRE 259,A00,891868,Patel; Hemal,9998,0,9999,1
1745796649693,CLRE 260,A00,891872,Cuomo; Raphael Eduardo,9999,0,9999,0
1745796650718,CLRE 297,001,891888,Cuomo; Raphael Eduardo,9999,0,9999,0
1745796651743,CSE 191,A00,958773,Minnes Kemp; Mor Mia,9999,0,9999,0
1745796652769,CSS 201S,A01,892054,Mignozzetti; Umberto,30,0,30,0
1745796653795,CSS 202S,A01,892056,Mignozzetti; Umberto,30,0,30,0
1745796654819,DSC 197,001,956898,Eldridge; Justin Matthew,9998,0,9999,1
1745796655846,DSC 297,001,958000,Mazumdar; Arya,9998,0,9999,1
1745796656873,EAP 100,A00,905686,Staff,9776,0,9999,223
1745796657898,ECE 45,A01,892618,Staff,0,12,50,50
1745796658923,ECE 109,A01,892620,Staff,0,43,0,0
1745796659952,ECE 111,A01,892719,Staff,0,7,50,50
1745796660981,ECE 197,001,957920,Mercier; Patrick Philip,9992,0,9999,7
1745796662007,ECON 178,A01,907814,Zhu; Ying,28,0,35,7
1745796663035,EDS 115,A00,895312,Staff,41,0,45,4
1745796664060,EDS 117,A01,895337,Staff,30,0,30,0
1745796665089,EDS 125,A00,895341,Jones; Gabrielle Anastasia,43,0,45,2
1745796666114,EDS 128A,A01,895459,Fargason; Sharon Gayle,44,0,45,1
1745796667142,EDS 128B,A01,895543,Pappas; Elizabeth,44,0,45,1
1745796668167,EDS 139,A00,897203,Pappas; Elizabeth,44,0,45,1
1745796668167,EDS 139,B00,897209,Fargason; Sharon Gayle,44,0,45,1
1745796669192,EDS 201,A00,895545,Staff,43,0,45,2
1745796670219,EDS 203,A01,895581,Halter; Christopher P.,43,0,45,2
1745796671246,EDS 204R,A01,895625,Heinzman; Erica M.,43,0,45,2
1745796671246,EDS 204R,B01,895693,Halter; Christopher P.,18,0,45,27
1745796672272,EDS 206R,A00,895694,Fargason; Sharon Gayle,9,0,30,21
1745796672272,EDS 206R,B00,895695,Choi; Bailey Miyeon,20,0,30,10
1745796673297,EDS 250,A00,895697,Hemans; Patricia Ann Benitez,43,0,45,2
1745796674323,EDS 281,A00,895701,Meyerott; Theresa Ann,15,0,15,0
1745796675347,EDS 284,A00,895736,Meyerott; Theresa Ann,15,0,15,0
1745796676374,EDS 286,A00,897210,Fine; Sarah,15,0,15,0
1745796677400,EDS 289C,A01,895770,Daly; Alan J.,15,0,15,0
1745796678428,EDS 290,A00,897211,Hofstetter; Carolyn,15,0,15,0
1745796679458,LIGM 5A,A00,896162,Fischer-Grunski; Eva K,15,0,20,5
1745796680486,LIGM 5B,A00,896260,Fischer-Grunski; Eva K,17,0,20,3
1745796681512,LIGM 5C,A00,896308,Fischer-Grunski; Eva K,18,0,20,2
1745796682538,LIIT 5AS,A00,896313,Carnelos; Chiara,18,0,20,2
1745796683565,LIIT 5BS,A00,896416,Carnelos; Chiara,20,0,20,0
1745796684595,LIIT 5CS,A00,896564,Carnelos; Chiara,20,0,20,0
1745796685620,LISP 5A,A00,896588,Munoz Sanchez; Alicia,4,0,20,16
1745796686650,LISP 5B,A00,896653,Munoz Sanchez; Alicia,10,0,20,10
1745796687681,LISP 5C,A00,896655,Munoz Sanchez; Alicia,4,0,20,16
1745796688708,MAE 197,001,957918,Kleissl; Jan,9998,0,9999,1
1745796689734,MATH 2,A01,957937,Staff,34,0,35,1
1745796690760,MATH 197,001,957876,Kedlaya; Kiran S.,9993,0,9999,6
1745796691789,MCWP 40,A00,892729,Duru; Nur,13,0,20,7
1745796691789,MCWP 40,B00,893304,Montejo; Carolina,20,0,20,0
1745796692817,MCWP 40R,A00,893757,Redela; Pamela Morgan,0,6,20,20
1745796693845,MCWP 50,A00,893758,Morshed; Michael James,2,0,20,18
1745796693845,MCWP 50,B00,893761,Bartulis; Jason Michael,17,0,20,3
1745796694871,MCWP 50R,A00,893766,Compas; Sean Matthew,0,1,20,20
1745796694871,MCWP 50R,B00,893769,Carter; Jennifer A,0,0,20,20
1745796694871,MCWP 50R,C00,893771,Krone; Jarret,0,3,20,20
1745796694871,MCWP 50R,D00,893772,Miller; Elizabeth Deen,3,0,20,17
1745796694871,MCWP 50R,E00,893775,Carter; Andrea L,0,0,20,20
1745796695896,MMW 11R,A01,892721,Herbst; Matthew,11,0,27,16
1745796695896,MMW 11R,A02,892722,Herbst; Matthew,0,0,0,3
1745796696947,MMW 12R,A01,892724,Herbst; Matthew,0,9,16,16
1745796696947,MMW 12R,A02,892725,Herbst; Matthew,0,9,16,16
1745796697972,MMW 13R,A01,892727,Staff,0,4,16,16
1745796697972,MMW 13R,A02,892728,Staff,0,4,16,16
1745796697972,MMW 13R,A03,958032,Staff,0,3,16,16
1745796697972,MMW 13R,A04,958033,Staff,0,2,16,16
1745796697972,MMW 13R,A05,958034,Staff,0,3,16,16
1745796699002,SIO 295LS,A00,894015,Staff,7,0,25,18
1745796700027,SIO 295S,A00,894020,Staff,7,0,25,18
1745796701058,SIOC 290S,B01,958918,Staff,0,0,0,0
1745796702089,SIOC 291S,B01,958922,Staff,0,0,0,0
1745796703115,SOCI 117,A01,895339,Staff,4,0,5,1
1745796704139,WES 237B,A00,894149,Staff,11,0,20,9
1745796706199,AESE 279B,A00,891859,Staff,13,0,35,22
1745796707223,AIP 197,001,891854,Staff,70,0,70,0
1745796708250,ANTH 289S,A00,891856,Gagneux; Pascal,12,0,12,0
1745796709276,BENG 196,001,957946,Engler; Adam J.,9996,0,9999,3
1745796710300,CAT 124RS,A01,956906,Staff,8,0,25,17
1745796711326,CAT 125RS,A01,922013,Staff,8,0,25,17
1745796712351,CLRE 250,A00,891860,Morris; Sheldon,9995,0,9999,4
1745796714443,CLRE 251R,A00,907817,Mehta; Ravindra L.,9994,0,9999,5
1745796715474,CLRE 252,A00,891864,Cuomo; Raphael Eduardo,9993,0,9999,6
1745796716503,CLRE 253,A00,891867,Vaida; Florin,9994,0,9999,5
1745796716503,CLRE 253,B00,907819,Staff,9999,0,9999,0
1745796717531,CLRE 259,A00,891868,Patel; Hemal,9998,0,9999,1
1745796718556,CLRE 260,A00,891872,Cuomo; Raphael Eduardo,9999,0,9999,0
1745796719582,CLRE 297,001,891888,Cuomo; Raphael Eduardo,9999,0,9999,0
1745796720608,CSE 191,A00,958773,Minnes Kemp; Mor Mia,9999,0,9999,0
1745796721633,CSS 201S,A01,892054,Mignozzetti; Umberto,30,0,30,0
1745796722685,CSS 202S,A01,892056,Mignozzetti; Umberto,30,0,30,0
1745796723713,DSC 197,001,956898,Eldridge; Justin Matthew,9998,0,9999,1
1745796724738,DSC 297,001,958000,Mazumdar; Arya,9998,0,9999,1
1745796725766,EAP 100,A00,905686,Staff,9776,0,9999,223
1745796726793,ECE 45,A01,892618,Staff,0,12,50,50
1745796727822,ECE 109,A01,892620,Staff,0,43,0,0
1745796728849,ECE 111,A01,892719,Staff,0,7,50,50
1745796729878,ECE 197,001,957920,Mercier; Patrick Philip,9992,0,9999,7
1745796730907,ECON 178,A01,907814,Zhu; Ying,28,0,35,7
1745796731934,EDS 115,A00,895312,Staff,41,0,45,4
1745796732963,EDS 117,A01,895337,Staff,30,0,30,0
1745796733991,EDS 125,A00,895341,Jones; Gabrielle Anastasia,43,0,45,2
1745796735020,EDS 128A,A01,895459,Fargason; Sharon Gayle,44,0,45,1
1745796736045,EDS 128B,A01,895543,Pappas; Elizabeth,44,0,45,1
1745796737072,EDS 139,A00,897203,Pappas; Elizabeth,44,0,45,1
1745796737072,EDS 139,B00,897209,Fargason; Sharon Gayle,44,0,45,1
1745796738101,EDS 201,A00,895545,Staff,43,0,45,2
1745796739129,EDS 203,A01,895581,Halter; Christopher P.,43,0,45,2
1745796740158,EDS 204R,A01,895625,Heinzman; Erica M.,43,0,45,2
1745796740158,EDS 204R,B01,895693,Halter; Christopher P.,18,0,45,27
1745796741183,EDS 206R,A00,895694,Fargason; Sharon Gayle,9,0,30,21
1745796741183,EDS 206R,B00,895695,Choi; Bailey Miyeon,20,0,30,10
1745796742211,EDS 250,A00,895697,Hemans; Patricia Ann Benitez,43,0,45,2
1745796743237,EDS 281,A00,895701,Meyerott; Theresa Ann,15,0,15,0
1745796744261,EDS 284,A00,895736,Meyerott; Theresa Ann,15,0,15,0
1745796745286,EDS 286,A00,897210,Fine; Sarah,15,0,15,0
1745796746315,EDS 289C,A01,895770,Daly; Alan J.,15,0,15,0
1745796747340,EDS 290,A00,897211,Hofstetter; Carolyn,15,0,15,0
1745796748366,LIGM 5A,A00,896162,Fischer-Grunski; Eva K,15,0,20,5
1745796749395,LIGM 5B,A00,896260,Fischer-Grunski; Eva K,17,0,20,3
1745796750423,LIGM 5C,A00,896308,Fischer-Grunski; Eva K,18,0,20,2
1745796751448,LIIT 5AS,A00,896313,Carnelos; Chiara,18,0,20,2
1745796752474,LIIT 5BS,A00,896416,Carnelos; Chiara,20,0,20,0
1745796753499,LIIT 5CS,A00,896564,Carnelos; Chiara,20,0,20,0
1745796754524,LISP 5A,A00,896588,Munoz Sanchez; Alicia,4,0,20,16
1745796755552,LISP 5B,A00,896653,Munoz Sanchez; Alicia,10,0,20,10
1745796756576,LISP 5C,A00,896655,Munoz Sanchez; Alicia,4,0,20,16
1745796757603,MAE 197,001,957918,Kleissl; Jan,9998,0,9999,1
1745796758626,MATH 2,A01,957937,Staff,34,0,35,1
1745796759654,MATH 197,001,957876,Kedlaya; Kiran S.,9993,0,9999,6
1745796760682,MCWP 40,A00,892729,Duru; Nur,13,0,20,7
1745796760682,MCWP 40,B00,893304,Montejo; Carolina,20,0,20,0
1745796761707,MCWP 40R,A00,893757,Redela; Pamela Morgan,0,6,20,20
1745796762731,MCWP 50,A00,893758,Morshed; Michael James,2,0,20,18
1745796762731,MCWP 50,B00,893761,Bartulis; Jason Michael,17,0,20,3
1745796763761,MCWP 50R,A00,893766,Compas; Sean Matthew,0,1,20,20
1745796763761,MCWP 50R,B00,893769,Carter; Jennifer A,0,0,20,20
1745796763761,MCWP 50R,C00,893771,Krone; Jarret,0,3,20,20
1745796763761,MCWP 50R,D00,893772,Miller; Elizabeth Deen,3,0,20,17
1745796763761,MCWP 50R,E00,893775,Carter; Andrea L,0,0,20,20
1745796764790,MMW 11R,A01,892721,Herbst; Matthew,11,0,27,16
1745796764790,MMW 11R,A02,892722,Herbst; Matthew,0,0,0,3
1745796765818,MMW 12R,A01,892724,Herbst; Matthew,0,9,16,16
1745796765818,MMW 12R,A02,892725,Herbst; Matthew,0,9,16,16
1745796766845,MMW 13R,A01,892727,Staff,0,4,16,16
1745796766845,MMW 13R,A02,892728,Staff,0,4,16,16
1745796766845,MMW 13R,A03,958032,Staff,0,3,16,16
1745796766845,MMW 13R,A04,958033,Staff,0,2,16,16
1745796766845,MMW 13R,A05,958034,Staff,0,3,16,16
1745796767872,SIO 295LS,A00,894015,Staff,7,0,25,18
1745796768899,SIO 295S,A00,894020,Staff,7,0,25,18
1745796769929,SIOC 290S,B01,958918,Staff,0,0,0,0
1745796770955,SIOC 291S,B01,958922,Staff,0,0,0,0
1745796771983,SOCI 117,A01,895339,Staff,4,0,5,1
1745796773011,WES 237B,A00,894149,Staff,11,0,20,9
1745796775070,AESE 279B,A00,891859,Staff,13,0,35,22
1745796776095,AIP 197,001,891854,Staff,70,0,70,0
1745796777123,ANTH 289S,A00,891856,Gagneux; Pascal,12,0,12,0
1745796778150,BENG 196,001,957946,Engler; Adam J.,9996,0,9999,3
1745796779176,CAT 124RS,A01,956906,Staff,8,0,25,17
1745796780203,CAT 125RS,A01,922013,Staff,8,0,25,17
1745796781229,CLRE 250,A00,891860,Morris; Sheldon,9995,0,9999,4
1745796783286,CLRE 251R,A00,907817,Mehta; Ravindra L.,9994,0,9999,5
1745796784315,CLRE 252,A00,891864,Cuomo; Raphael Eduardo,9993,0,9999,6
1745796785344,CLRE 253,A00,891867,Vaida; Florin,9994,0,9999,5
1745796785344,CLRE 253,B00,907819,Staff,9999,0,9999,0
1745796786369,CLRE 259,A00,891868,Patel; Hemal,9998,0,9999,1
1745796787395,CLRE 260,A00,891872,Cuomo; Raphael Eduardo,9999,0,9999,0
1745796788425,CLRE 297,001,891888,Cuomo; Raphael Eduardo,9999,0,9999,0
1745796789453,CSE 191,A00,958773,Minnes Kemp; Mor Mia,9999,0,9999,0
1745796790479,CSS 201S,A01,892054,Mignozzetti; Umberto,30,0,30,0
1745796791505,CSS 202S,A01,892056,Mignozzetti; Umberto,30,0,30,0
1745796792534,DSC 197,001,956898,Eldridge; Justin Matthew,9998,0,9999,1
1745796793564,DSC 297,001,958000,Mazumdar; Arya,9998,0,9999,1
1745796794590,EAP 100,A00,905686,Staff,9776,0,9999,223
1745796795619,ECE 45,A01,892618,Staff,0,12,50,50
1745796796646,ECE 109,A01,892620,Staff,0,43,0,0
1745796797672,ECE 111,A01,892719,Staff,0,7,50,50
1745796798700,ECE 197,001,957920,Mercier; Patrick Philip,9992,0,9999,7
1745796799726,ECON 178,A01,907814,Zhu; Ying,28,0,35,7
1745796800751,EDS 115,A00,895312,Staff,41,0,45,4
1745796801779,EDS 117,A01,895337,Staff,30,0,30,0
1745796802807,EDS 125,A00,895341,Jones; Gabrielle Anastasia,43,0,45,2
1745796803834,EDS 128A,A01,895459,Fargason; Sharon Gayle,44,0,45,1
1745796804862,EDS 128B,A01,895543,Pappas; Elizabeth,44,0,45,1
1745796805890,EDS 139,A00,897203,Pappas; Elizabeth,44,0,45,1
1745796805890,EDS 139,B00,897209,Fargason; Sharon Gayle,44,0,45,1
1745796806920,EDS 201,A00,895545,Staff,43,0,45,2
1745796807949,EDS 203,A01,895581,Halter; Christopher P.,43,0,45,2
1745796808976,EDS 204R,A01,895625,Heinzman; Erica M.,43,0,45,2
1745796808976,EDS 204R,B01,895693,Halter; Christopher P.,18,0,45,27
1745796810002,EDS 206R,A00,895694,Fargason; Sharon Gayle,9,0,30,21
1745796810002,EDS 206R,B00,895695,Choi; Bailey Miyeon,20,0,30,10
1745796811027,EDS 250,A00,895697,Hemans; Patricia Ann Benitez,43,0,45,2
1745796812056,EDS 281,A00,895701,Meyerott; Theresa Ann,15,0,15,0
1745796813081,EDS 284,A00,895736,Meyerott; Theresa Ann,15,0,15,0
1745796814106,EDS 286,A00,897210,Fine; Sarah,15,0,15,0
1745796815134,EDS 289C,A01,895770,Daly; Alan J.,15,0,15,0
1745796816163,EDS 290,A00,897211,Hofstetter; Carolyn,15,0,15,0
1745796817190,LIGM 5A,A00,896162,Fischer-Grunski; Eva K,15,0,20,5
1745796818220,LIGM 5B,A00,896260,Fischer-Grunski; Eva K,17,0,20,3
1745796819248,LIGM 5C,A00,896308,Fischer-Grunski; Eva K,18,0,20,2
1745796820274,LIIT 5AS,A00,896313,Carnelos; Chiara,18,0,20,2
1745796821304,LIIT 5BS,A00,896416,Carnelos; Chiara,20,0,20,0
1745796822333,LIIT 5CS,A00,896564,Carnelos; Chiara,20,0,20,0
1745796823359,LISP 5A,A00,896588,Munoz Sanchez; Alicia,4,0,20,16
1745796824389,LISP 5B,A00,896653,Munoz Sanchez; Alicia,10,0,20,10
1745796825415,LISP 5C,A00,896655,Munoz Sanchez; Alicia,4,0,20,16
1745796826443,MAE 197,001,957918,Kleissl; Jan,9998,0,9999,1
1745796827469,MATH 2,A01,957937,Staff,34,0,35,1
1745796828496,MATH 197,001,957876,Kedlaya; Kiran S.,9993,0,9999,6
1745796829521,MCWP 40,A00,892729,Duru; Nur,13,0,20,7
1745796829521,MCWP 40,B00,893304,Montejo; Carolina,20,0,20,0
1745796830546,MCWP 40R,A00,893757,Redela; Pamela Morgan,0,6,20,20
1745796831574,MCWP 50,A00,893758,Morshed; Michael James,2,0,20,18
1745796831574,MCWP 50,B00,893761,Bartulis; Jason Michael,17,0,20,3
1745796832598,MCWP 50R,A00,893766,Compas; Sean Matthew,0,1,20,20
1745796832598,MCWP 50R,B00,893769,Carter; Jennifer A,0,0,20,20
1745796832598,MCWP 50R,C00,893771,Krone; Jarret,0,3,20,20
1745796832598,MCWP 50R,D00,893772,Miller; Elizabeth Deen,3,0,20,17
1745796832598,MCWP 50R,E00,893775,Carter; Andrea L,0,0,20,20
1745796833623,MMW 11R,A01,892721,Herbst; Matthew,11,0,27,16
1745796833623,MMW 11R,A02,892722,Herbst; Matthew,0,0,0,3
1745796834649,MMW 12R,A01,892724,Herbst; Matthew,0,9,16,16
1745796834649,MMW 12R,A02,892725,Herbst; Matthew,0,9,16,16
1745796835674,MMW 13R,A01,892727,Staff,0,4,16,16
1745796835674,MMW 13R,A02,892728,Staff,0,4,16,16
1745796835674,MMW 13R,A03,958032,Staff,0,3,16,16
1745796835674,MMW 13R,A04,958033,Staff,0,2,16,16
1745796835674,MMW 13R,A05,958034,Staff,0,3,16,16
1745796836701,SIO 295LS,A00,894015,Staff,7,0,25,18
1745796837730,SIO 295S,A00,894020,Staff,7,0,25,18
1745796838759,SIOC 290S,B01,958918,Staff,0,0,0,0
1745796839789,SIOC 291S,B01,958922,Staff,0,0,0,0
1745796840818,SOCI 117,A01,895339,Staff,4,0,5,1
1745796841846,WES 237B,A00,894149,Staff,11,0,20,9
1745796843906,AESE 279B,A00,891859,Staff,13,0,35,22
1745796844933,AIP 197,001,891854,Staff,70,0,70,0
1745796845958,ANTH 289S,A00,891856,Gagneux; Pascal,12,0,12,0
1745796846985,BENG 196,001,957946,Engler; Adam J.,9996,0,9999,3
1745796848010,CAT 124RS,A01,956906,Staff,8,0,25,17
1745796849037,CAT 125RS,A01,922013,Staff,8,0,25,17
1745796850066,CLRE 250,A00,891860,Morris; Sheldon,9995,0,9999,4
1745796852120,CLRE 251R,A00,907817,Mehta; Ravindra L.,9994,0,9999,5
1745796853147,CLRE 252,A00,891864,Cuomo; Raphael Eduardo,9993,0,9999,6
1745796854173,CLRE 253,A00,891867,Vaida; Florin,9994,0,9999,5
1745796854173,CLRE 253,B00,907819,Staff,9999,0,9999,0
1745796855199,CLRE 259,A00,891868,Patel; Hemal,9998,0,9999,1
1745796856222,CLRE 260,A00,891872,Cuomo; Raphael Eduardo,9999,0,9999,0
1745796857248,CLRE 297,001,891888,Cuomo; Raphael Eduardo,9999,0,9999,0
1745796858274,CSE 191,A00,958773,Minnes Kemp; Mor Mia,9999,0,9999,0
1745796859343,CSS 201S,A01,892054,Mignozzetti; Umberto,30,0,30,0
1745796860370,CSS 202S,A01,892056,Mignozzetti; Umberto,30,0,30,0
1745796861397,DSC 197,001,956898,Eldridge; Justin Matthew,9998,0,9999,1
1745796862424,DSC 297,001,958000,Mazumdar; Arya,9998,0,9999,1
1745796863450,EAP 100,A00,905686,Staff,9776,0,9999,223
1745796864478,ECE 45,A01,892618,Staff,0,12,50,50
1745796865505,ECE 109,A01,892620,Staff,0,43,0,0
1745796866531,ECE 111,A01,892719,Staff,0,7,50,50
1745796867559,ECE 197,001,957920,Mercier; Patrick Philip,9992,0,9999,7
1745796868588,ECON 178,A01,907814,Zhu; Ying,28,0,35,7
1745796869615,EDS 115,A00,895312,Staff,41,0,45,4
1745796870642,EDS 117,A01,895337,Staff,30,0,30,0
1745796871666,EDS 125,A00,895341,Jones; Gabrielle Anastasia,43,0,45,2
1745796872696,EDS 128A,A01,895459,Fargason; Sharon Gayle,44,0,45,1
1745796873721,EDS 128B,A01,895543,Pappas; Elizabeth,44,0,45,1
1745796874747,EDS 139,A00,897203,Pappas; Elizabeth,44,0,45,1
1745796874747,EDS 139,B00,897209,Fargason; Sharon Gayle,44,0,45,1
1745796875773,EDS 201,A00,895545,Staff,43,0,45,2
1745796876801,EDS 203,A01,895581,Halter; Christopher P.,43,0,45,2
1745796877826,EDS 204R,A01,895625,Heinzman; Erica M.,43,0,45,2
1745796877826,EDS 204R,B01,895693,Halter; Christopher P.,18,0,45,27
1745796878855,EDS 206R,A00,895694,Fargason; Sharon Gayle,9,0,30,21
1745796878855,EDS 206R,B00,895695,Choi; Bailey Miyeon,20,0,30,10
1745796879883,EDS 250,A00,895697,Hemans; Patricia Ann Benitez,43,0,45,2
1745796880910,EDS 281,A00,895701,Meyerott; Theresa Ann,15,0,15,0
1745796881937,EDS 284,A00,895736,Meyerott; Theresa Ann,15,0,15,0
1745796882962,EDS 286,A00,897210,Fine; Sarah,15,0,15,0
1745796883989,EDS 289C,A01,895770,Daly; Alan J.,15,0,15,0
1745796885016,EDS 290,A00,897211,Hofstetter; Carolyn,15,0,15,0
1745796886042,LIGM 5A,A00,896162,Fischer-Grunski; Eva K,15,0,20,5
1745796887067,LIGM 5B,A00,896260,Fischer-Grunski; Eva K,17,0,20,3
1745796888094,LIGM 5C,A00,896308,Fischer-Grunski; Eva K,18,0,20,2
1745796889119,LIIT 5AS,A00,896313,Carnelos; Chiara,18,0,20,2
1745796890149,LIIT 5BS,A00,896416,Carnelos; Chiara,20,0,20,0
1745796891178,LIIT 5CS,A00,896564,Carnelos; Chiara,20,0,20,0
1745796892207,LISP 5A,A00,896588,Munoz Sanchez; Alicia,4,0,20,16
1745796893234,LISP 5B,A00,896653,Munoz Sanchez; Alicia,10,0,20,10
1745796894265,LISP 5C,A00,896655,Munoz Sanchez; Alicia,4,0,20,16
1745796895295,MAE 197,001,957918,Kleissl; Jan,9998,0,9999,1
1745796896325,MATH 2,A01,957937,Staff,34,0,35,1
1745796897349,MATH 197,001,957876,Kedlaya; Kiran S.,9993,0,9999,6
1745796898376,MCWP 40,A00,892729,Duru; Nur,13,0,20,7
1745796898376,MCWP 40,B00,893304,Montejo; Carolina,20,0,20,0
1745796899405,MCWP 40R,A00,893757,Redela; Pamela Morgan,0,6,20,20
1745796900433,MCWP 50,A00,893758,Morshed; Michael James,2,0,20,18
1745796900433,MCWP 50,B00,893761,Bartulis; Jason Michael,17,0,20,3
1745796901476,MCWP 50R,A00,893766,Compas; Sean Matthew,0,1,20,20
1745796901476,MCWP 50R,B00,893769,Carter; Jennifer A,0,0,20,20
1745796901476,MCWP 50R,C00,893771,Krone; Jarret,0,3,20,20
1745796901476,MCWP 50R,D00,893772,Miller; Elizabeth Deen,3,0,20,17
1745796901476,MCWP 50R,E00,893775,Carter; Andrea L,0,0,20,20
1745796902503,MMW 11R,A01,892721,Herbst; Matthew,11,0,27,16
1745796902503,MMW 11R,A02,892722,Herbst; Matthew,0,0,0,3
1745796903529,MMW 12R,A01,892724,Herbst; Matthew,0,9,16,16
1745796903529,MMW 12R,A02,892725,Herbst; Matthew,0,9,16,16
1745796904556,MMW 13R,A01,892727,Staff,0,4,16,16
1745796904556,MMW 13R,A02,892728,Staff,0,4,16,16
1745796904556,MMW 13R,A03,958032,Staff,0,3,16,16
1745796904556,MMW 13R,A04,958033,Staff,0,2,16,16
1745796904556,MMW 13R,A05,958034,Staff,0,3,16,16
1745796905585,SIO 295LS,A00,894015,Staff,7,0,25,18
1745796906613,SIO 295S,A00,894020,Staff,7,0,25,18
1745796907637,SIOC 290S,B01,958918,Staff,0,0,0,0
1745796908667,SIOC 291S,B01,958922,Staff,0,0,0,0
1745796909695,SOCI 117,A01,895339,Staff,4,0,5,1
1745796910722,WES 237B,A00,894149,Staff,11,0,20,9
1745796912789,AESE 279B,A00,891859,Staff,13,0,35,22
1745796913813,AIP 197,001,891854,Staff,70,0,70,0
1745796914842,ANTH 289S,A00,891856,Gagneux; Pascal,12,0,12,0
1745796915870,BENG 196,001,957946,Engler; Adam J.,9996,0,9999,3
1745796916895,CAT 124RS,A01,956906,Staff,8,0,25,17
1745796917920,CAT 125RS,A01,922013,Staff,8,0,25,17
1745796918948,CLRE 250,A00,891860,Morris; Sheldon,9995,0,9999,4
1745796920997,CLRE 251R,A00,907817,Mehta; Ravindra L.,9994,0,9999,5
1745796922026,CLRE 252,A00,891864,Cuomo; Raphael Eduardo,9993,0,9999,6
1745796923050,CLRE 253,A00,891867,Vaida; Florin,9994,0,9999,5
1745796923050,CLRE 253,B00,907819,Staff,9999,0,9999,0
1745796924090,CLRE 259,A00,891868,Patel; Hemal,9998,0,9999,1
1745796925115,CLRE 260,A00,891872,Cuomo; Raphael Eduardo,9999,0,9999,0
1745796926142,CLRE 297,001,891888,Cuomo; Raphael Eduardo,9999,0,9999,0
1745796927167,CSE 191,A00,958773,Minnes Kemp; Mor Mia,9999,0,9999,0
1745796928192,CSS 201S,A01,892054,Mignozzetti; Umberto,30,0,30,0
1745796929222,CSS 202S,A01,892056,Mignozzetti; Umberto,30,0,30,0
1745796930246,DSC 197,001,956898,Eldridge; Justin Matthew,9998,0,9999,1
1745796931270,DSC 297,001,958000,Mazumdar; Arya,9998,0,9999,1
1745796932297,EAP 100,A00,905686,Staff,9776,0,9999,223
1745796933325,ECE 45,A01,892618,Staff,0,12,50,50
1745796934352,ECE 109,A01,892620,Staff,0,43,0,0
1745796935377,ECE 111,A01,892719,Staff,0,7,50,50
1745796936403,ECE 197,001,957920,Mercier; Patrick Philip,9992,0,9999,7
1745796937429,ECON 178,A01,907814,Zhu; Ying,28,0,35,7
1745796938453,EDS 115,A00,895312,Staff,41,0,45,4
1745796939481,EDS 117,A01,895337,Staff,30,0,30,0
1745796940506,EDS 125,A00,895341,Jones; Gabrielle Anastasia,43,0,45,2
1745796941532,EDS 128A,A01,895459,Fargason; Sharon Gayle,44,0,45,1
1745796942554,EDS 128B,A01,895543,Pappas; Elizabeth,44,0,45,1
1745796943583,EDS 139,A00,897203,Pappas; Elizabeth,44,0,45,1
1745796943583,EDS 139,B00,897209,Fargason; Sharon Gayle,44,0,45,1
1745796944608,EDS 201,A00,895545,Staff,43,0,45,2
1745796945634,EDS 203,A01,895581,Halter; Christopher P.,43,0,45,2
1745796946660,EDS 204R,A01,895625,Heinzman; Erica M.,43,0,45,2
1745796946660,EDS 204R,B01,895693,Halter; Christopher P.,18,0,45,27
1745796947685,EDS 206R,A00,895694,Fargason; Sharon Gayle,9,0,30,21
1745796947685,EDS 206R,B00,895695,Choi; Bailey Miyeon,20,0,30,10
1745796948710,EDS 250,A00,895697,Hemans; Patricia Ann Benitez,43,0,45,2
1745796949734,EDS 281,A00,895701,Meyerott; Theresa Ann,15,0,15,0
1745796950761,EDS 284,A00,895736,Meyerott; Theresa Ann,15,0,15,0
1745796951785,EDS 286,A00,897210,Fine; Sarah,15,0,15,0
1745796952812,EDS 289C,A01,895770,Daly; Alan J.,15,0,15,0
1745796953837,EDS 290,A00,897211,Hofstetter; Carolyn,15,0,15,0
1745796954865,LIGM 5A,A00,896162,Fischer-Grunski; Eva K,15,0,20,5
1745796955892,LIGM 5B,A00,896260,Fischer-Grunski; Eva K,17,0,20,3
1745796956920,LIGM 5C,A00,896308,Fischer-Grunski; Eva K,18,0,20,2
1745796957946,LIIT 5AS,A00,896313,Carnelos; Chiara,18,0,20,2
1745796958972,LIIT 5BS,A00,896416,Carnelos; Chiara,20,0,20,0
1745796960001,LIIT 5CS,A00,896564,Carnelos; Chiara,20,0,20,0
1745796961029,LISP 5A,A00,896588,Munoz Sanchez; Alicia,4,0,20,16
1745796962059,LISP 5B,A00,896653,Munoz Sanchez; Alicia,10,0,20,10
1745796963088,LISP 5C,A00,896655,Munoz Sanchez; Alicia,4,0,20,16
1745796964113,MAE 197,001,957918,Kleissl; Jan,9998,0,9999,1
1745796965142,MATH 2,A01,957937,Staff,34,0,35,1
1745796966167,MATH 197,001,957876,Kedlaya; Kiran S.,9993,0,9999,6
1745796967193,MCWP 40,A00,892729,Duru; Nur,13,0,20,7
1745796967193,MCWP 40,B00,893304,Montejo; Carolina,20,0,20,0
1745796968217,MCWP 40R,A00,893757,Redela; Pamela Morgan,0,6,20,20
1745796969247,MCWP 50,A00,893758,Morshed; Michael James,2,0,20,18
1745796969247,MCWP 50,B00,893761,Bartulis; Jason Michael,17,0,20,3
1745796970277,MCWP 50R,A00,893766,Compas; Sean Matthew,0,1,20,20
1745796970277,MCWP 50R,B00,893769,Carter; Jennifer A,0,0,20,20
1745796970277,MCWP 50R,C00,893771,Krone; Jarret,0,3,20,20
1745796970277,MCWP 50R,D00,893772,Miller; Elizabeth Deen,3,0,20,17
1745796970277,MCWP 50R,E00,893775,Carter; Andrea L,0,0,20,20
1745796971305,MMW 11R,A01,892721,Herbst; Matthew,11,0,27,16
1745796971305,MMW 11R,A02,892722,Herbst; Matthew,0,0,0,3
1745796972330,MMW 12R,A01,892724,Herbst; Matthew,0,9,16,16
1745796972330,MMW 12R,A02,892725,Herbst; Matthew,0,9,16,16
1745796973359,MMW 13R,A01,892727,Staff,0,4,16,16
1745796973359,MMW 13R,A02,892728,Staff,0,4,16,16
1745796973359,MMW 13R,A03,958032,Staff,0,3,16,16
1745796973359,MMW 13R,A04,958033,Staff,0,2,16,16
1745796973359,MMW 13R,A05,958034,Staff,0,3,16,16
1745796974385,SIO 295LS,A00,894015,Staff,7,0,25,18
1745796975411,SIO 295S,A00,894020,Staff,7,0,25,18
1745796976438,SIOC 290S,B01,958918,Staff,0,0,0,0
1745796977470,SIOC 291S,B01,958922,Staff,0,0,0,0
1745796978500,SOCI 117,A01,895339,Staff,4,0,5,1
1745796979525,WES 237B,A00,894149,Staff,11,0,20,9
1745796981593,AESE 279B,A00,891859,Staff,13,0,35,22
1745796982616,AIP 197,001,891854,Staff,70,0,70,0
1745796983642,ANTH 289S,A00,891856,Gagneux; Pascal,12,0,12,0
1745796984667,BENG 196,001,957946,Engler; Adam J.,9996,0,9999,3
1745796985693,CAT 124RS,A01,956906,Staff,8,0,25,17
1745796986718,CAT 125RS,A01,922013,Staff,8,0,25,17
1745796987745,CLRE 250,A00,891860,Morris; Sheldon,9995,0,9999,4
1745796989796,CLRE 251R,A00,907817,Mehta; Ravindra L.,9994,0,9999,5
1745796990822,CLRE 252,A00,891864,Cuomo; Raphael Eduardo,9993,0,9999,6
1745796991847,CLRE 253,A00,891867,Vaida; Florin,9994,0,9999,5
1745796991847,CLRE 253,B00,907819,Staff,9999,0,9999,0
1745796992873,CLRE 259,A00,891868,Patel; Hemal,9998,0,9999,1
1745796993901,CLRE 260,A00,891872,Cuomo; Raphael Eduardo,9999,0,9999,0
1745796994928,CLRE 297,001,891888,Cuomo; Raphael Eduardo,9999,0,9999,0
1745796995962,CSE 191,A00,958773,Minnes Kemp; Mor Mia,9999,0,9999,0
1745796996991,CSS 201S,A01,892054,Mignozzetti; Umberto,30,0,30,0
1745796998021,CSS 202S,A01,892056,Mignozzetti; Umberto,30,0,30,0
1745796999046,DSC 197,001,956898,Eldridge; Justin Matthew,9998,0,9999,1
1745797000072,DSC 297,001,958000,Mazumdar; Arya,9998,0,9999,1
1745797001099,EAP 100,A00,905686,Staff,9776,0,9999,223
1745797002125,ECE 45,A01,892618,Staff,0,12,50,50
1745797003151,ECE 109,A01,892620,Staff,0,43,0,0
1745797004176,ECE 111,A01,892719,Staff,0,7,50,50
1745797005204,ECE 197,001,957920,Mercier; Patrick Philip,9992,0,9999,7
1745797006229,ECON 178,A01,907814,Zhu; Ying,28,0,35,7
1745797007255,EDS 115,A00,895312,Staff,41,0,45,4
1745797008281,EDS 117,A01,895337,Staff,30,0,30,0
1745797009310,EDS 125,A00,895341,Jones; Gabrielle Anastasia,43,0,45,2
1745797010335,EDS 128A,A01,895459,Fargason; Sharon Gayle,44,0,45,1
1745797011365,EDS 128B,A01,895543,Pappas; Elizabeth,44,0,45,1
1745797012400,EDS 139,A00,897203,Pappas; Elizabeth,44,0,45,1
1745797012400,EDS 139,B00,897209,Fargason; Sharon Gayle,44,0,45,1
1745797013428,EDS 201,A00,895545,Staff,43,0,45,2
1745797014456,EDS 203,A01,895581,Halter; Christopher P.,43,0,45,2
1745797015480,EDS 204R,A01,895625,Heinzman; Erica M.,43,0,45,2
1745797015480,EDS 204R,B01,895693,Halter; Christopher P.,18,0,45,27
1745797016506,EDS 206R,A00,895694,Fargason; Sharon Gayle,9,0,30,21
1745797016506,EDS 206R,B00,895695,Choi; Bailey Miyeon,20,0,30,10
1745797017531,EDS 250,A00,895697,Hemans; Patricia Ann Benitez,43,0,45,2
1745797018557,EDS 281,A00,895701,Meyerott; Theresa Ann,15,0,15,0
1745797019583,EDS 284,A00,895736,Meyerott; Theresa Ann,15,0,15,0
1745797020611,EDS 286,A00,897210,Fine; Sarah,15,0,15,0
1745797021637,EDS 289C,A01,895770,Daly; Alan J.,15,0,15,0
1745797022662,EDS 290,A00,897211,Hofstetter; Carolyn,15,0,15,0
1745797023690,LIGM 5A,A00,896162,Fischer-Grunski; Eva K,15,0,20,5
1745797024715,LIGM 5B,A00,896260,Fischer-Grunski; Eva K,17,0,20,3
1745797025742,LIGM 5C,A00,896308,Fischer-Grunski; Eva K,18,0,20,2
1745797026768,LIIT 5AS,A00,896313,Carnelos; Chiara,18,0,20,2
1745797027794,LIIT 5BS,A00,896416,Carnelos; Chiara,20,0,20,0
1745797028824,LIIT 5CS,A00,896564,Carnelos; Chiara,20,0,20,0
1745797029852,LISP 5A,A00,896588,Munoz Sanchez; Alicia,4,0,20,16
1745797030876,LISP 5B,A00,896653,Munoz Sanchez; Alicia,10,0,20,10
1745797031903,LISP 5C,A00,896655,Munoz Sanchez; Alicia,4,0,20,16
1745797032928,MAE 197,001,957918,Kleissl; Jan,9998,0,9999,1
1745797033954,MATH 2,A01,957937,Staff,34,0,35,1
1745797034980,MATH 197,001,957876,Kedlaya; Kiran S.,9993,0,9999,6
1745797036010,MCWP 40,A00,892729,Duru; Nur,13,0,20,7
1745797036010,MCWP 40,B00,893304,Montejo; Carolina,20,0,20,0
1745797037034,MCWP 40R,A00,893757,Redela; Pamela Morgan,0,6,20,20
1745797038058,MCWP 50,A00,893758,Morshed; Michael James,2,0,20,18
1745797038058,MCWP 50,B00,893761,Bartulis; Jason Michael,17,0,20,3
1745797039088,MCWP 50R,A00,893766,Compas; Sean Matthew,0,1,20,20
1745797039088,MCWP 50R,B00,893769,Carter; Jennifer A,0,0,20,20
1745797039088,MCWP 50R,C00,893771,Krone; Jarret,0,3,20,20
1745797039088,MCWP 50R,D00,893772,Miller; Elizabeth Deen,3,0,20,17
1745797039088,MCWP 50R,E00,893775,Carter; Andrea L,0,0,20,20
1745797040113,MMW 11R,A01,892721,Herbst; Matthew,11,0,27,16
1745797040113,MMW 11R,A02,892722,Herbst; Matthew,0,0,0,3
1745797041139,MMW 12R,A01,892724,Herbst; Matthew,0,9,16,16
1745797041139,MMW 12R,A02,892725,Herbst; Matthew,0,9,16,16
1745797042165,MMW 13R,A01,892727,Staff,0,4,16,16
1745797042165,MMW 13R,A02,892728,Staff,0,4,16,16
1745797042165,MMW 13R,A03,958032,Staff,0,3,16,16
1745797042165,MMW 13R,A04,958033,Staff,0,2,16,16
1745797042165,MMW 13R,A05,958034,Staff,0,3,16,16
1745797043194,SIO 295LS,A00,894015,Staff,7,0,25,18
1745797044224,SIO 295S,A00,894020,Staff,7,0,25,18
1745797045250,SIOC 290S,B01,958918,Staff,0,0,0,0
1745797046279,SIOC 291S,B01,958922,Staff,0,0,0,0
1745797047308,SOCI 117,A01,895339,Staff,4,0,5,1
1745797048334,WES 237B,A00,894149,Staff,11,0,20,9
1745797050401,AESE 279B,A00,891859,Staff,13,0,35,22
1745797051429,AIP 197,001,891854,Staff,70,0,70,0
1745797052453,ANTH 289S,A00,891856,Gagneux; Pascal,12,0,12,0
1745797053482,BENG 196,001,957946,Engler; Adam J.,9996,0,9999,3
1745797054509,CAT 124RS,A01,956906,Staff,8,0,25,17
1745797055537,CAT 125RS,A01,922013,Staff,8,0,25,17
1745797056563,CLRE 250,A00,891860,Morris; Sheldon,9995,0,9999,4
1745797058613,CLRE 251R,A00,907817,Mehta; Ravindra L.,9994,0,9999,5
1745797059638,CLRE 252,A00,891864,Cuomo; Raphael Eduardo,9993,0,9999,6
1745797060665,CLRE 253,A00,891867,Vaida; Florin,9994,0,9999,5
1745797060665,CLRE 253,B00,907819,Staff,9999,0,9999,0
1745797061694,CLRE 259,A00,891868,Patel; Hemal,9998,0,9999,1
1745797062719,CLRE 260,A00,891872,Cuomo; Raphael Eduardo,9999,0,9999,0
1745797063748,CLRE 297,001,891888,Cuomo; Raphael Eduardo,9999,0,9999,0
1745797064774,CSE 191,A00,958773,Minnes Kemp; Mor Mia,9999,0,9999,0
1745797065803,CSS 201S,A01,892054,Mignozzetti; Umberto,30,0,30,0
1745797066869,CSS 202S,A01,892056,Mignozzetti; Umberto,30,0,30,0
1745797067896,DSC 197,001,956898,Eldridge; Justin Matthew,9998,0,9999,1
1745797068921,DSC 297,001,958000,Mazumdar; Arya,9998,0,9999,1
1745797069947,EAP 100,A00,905686,Staff,9776,0,9999,223
1745797070974,ECE 45,A01,892618,Staff,0,12,50,50
1745797072003,ECE 109,A01,892620,Staff,0,43,0,0
1745797073029,ECE 111,A01,892719,Staff,0,7,50,50
1745797074058,ECE 197,001,957920,Mercier; Patrick Philip,9992,0,9999,7
1745797075086,ECON 178,A01,907814,Zhu; Ying,28,0,35,7
1745797076112,EDS 115,A00,895312,Staff,41,0,45,4
1745797077137,EDS 117,A01,895337,Staff,30,0,30,0
1745797078163,EDS 125,A00,895341,Jones; Gabrielle Anastasia,43,0,45,2
1745797079190,EDS 128A,A01,895459,Fargason; Sharon Gayle,44,0,45,1
1745797080217,EDS 128B,A01,895543,Pappas; Elizabeth,44,0,45,1
1745797081244,EDS 139,A00,897203,Pappas; Elizabeth,44,0,45,1
1745797081244,EDS 139,B00,897209,Fargason; Sharon Gayle,44,0,45,1
1745797082272,EDS 201,A00,895545,Staff,43,0,45,2
1745797083302,EDS 203,A01,895581,Halter; Christopher P.,43,0,45,2
1745797084327,EDS 204R,A01,895625,Heinzman; Erica M.,43,0,45,2
1745797084327,EDS 204R,B01,895693,Halter; Christopher P.,18,0,45,27
1745797085354,EDS 206R,A00,895694,Fargason; Sharon Gayle,9,0,30,21
1745797085354,EDS 206R,B00,895695,Choi; Bailey Miyeon,20,0,30,10
1745797086379,EDS 250,A00,895697,Hemans; Patricia Ann Benitez,43,0,45,2
1745797087404,EDS 281,A00,895701,Meyerott; Theresa Ann,15,0,15,0
1745797088430,EDS 284,A00,895736,Meyerott; Theresa Ann,15,0,15,0
1745797089457,EDS 286,A00,897210,Fine; Sarah,15,0,15,0
1745797090483,EDS 289C,A01,895770,Daly; Alan J.,15,0,15,0
1745797091510,EDS 290,A00,897211,Hofstetter; Carolyn,15,0,15,0
1745797092536,LIGM 5A,A00,896162,Fischer-Grunski; Eva K,15,0,20,5
1745797093561,LIGM 5B,A00,896260,Fischer-Grunski; Eva K,17,0,20,3
1745797094589,LIGM 5C,A00,896308,Fischer-Grunski; Eva K,18,0,20,2
1745797095617,LIIT 5AS,A00,896313,Carnelos; Chiara,18,0,20,2
1745797096646,LIIT 5BS,A00,896416,Carnelos; Chiara,20,0,20,0
1745797097675,LIIT 5CS,A00,896564,Carnelos; Chiara,20,0,20,0
1745797098705,LISP 5A,A00,896588,Munoz Sanchez; Alicia,4,0,20,16
1745797099732,LISP 5B,A00,896653,Munoz Sanchez; Alicia,10,0,20,10
1745797100758,LISP 5C,A00,896655,Munoz Sanchez; Alicia,4,0,20,16
1745797101784,MAE 197,001,957918,Kleissl; Jan,9998,0,9999,1
1745797102813,MATH 2,A01,957937,Staff,34,0,35,1
1745797103839,MATH 197,001,957876,Kedlaya; Kiran S.,9993,0,9999,6
1745797104869,MCWP 40,A00,892729,Duru; Nur,13,0,20,7
1745797104869,MCWP 40,B00,893304,Montejo; Carolina,20,0,20,0
1745797105898,MCWP 40R,A00,893757,Redela; Pamela Morgan,0,6,20,20
1745797106924,MCWP 50,A00,893758,Morshed; Michael James,2,0,20,18
1745797106924,MCWP 50,B00,893761,Bartulis; Jason Michael,17,0,20,3
1745797107951,MCWP 50R,A00,893766,Compas; Sean Matthew,0,1,20,20
1745797107951,MCWP 50R,B00,893769,Carter; Jennifer A,0,0,20,20
1745797107951,MCWP 50R,C00,893771,Krone; Jarret,0,3,20,20
1745797107951,MCWP 50R,D00,893772,Miller; Elizabeth Deen,3,0,20,17
1745797107951,MCWP 50R,E00,893775,Carter; Andrea L,0,0,20,20
1745797108980,MMW 11R,A01,892721,Herbst; Matthew,11,0,27,16
1745797108980,MMW 11R,A02,892722,Herbst; Matthew,0,0,0,3
1745797110006,MMW 12R,A01,892724,Herbst; Matthew,0,9,16,16
1745797110006,MMW 12R,A02,892725,Herbst; Matthew,0,9,16,16
1745797111033,MMW 13R,A01,892727,Staff,0,4,16,16
1745797111033,MMW 13R,A02,892728,Staff,0,4,16,16
1745797111033,MMW 13R,A03,958032,Staff,0,3,16,16
1745797111033,MMW 13R,A04,958033,Staff,0,2,16,16
1745797111033,MMW 13R,A05,958034,Staff,0,3,16,16
1745797112056,SIO 295LS,A00,894015,Staff,7,0,25,18
1745797113086,SIO 295S,A00,894020,Staff,7,0,25,18
1745797114116,SIOC 290S,B01,958918,Staff,0,0,0,0
1745797115146,SIOC 291S,B01,958922,Staff,0,0,0,0
1745797116174,SOCI 117,A01,895339,Staff,4,0,5,1
1745797117201,WES 237B,A00,894149,Staff,11,0,20,9
1745797119270,AESE 279B,A00,891859,Staff,13,0,35,22
1745797120298,AIP 197,001,891854,Staff,70,0,70,0
1745797121326,ANTH 289S,A00,891856,Gagneux; Pascal,12,0,12,0
1745797122356,BENG 196,001,957946,Engler; Adam J.,9996,0,9999,3
1745797123381,CAT 124RS,A01,956906,Staff,8,0,25,17
1745797124409,CAT 125RS,A01,922013,Staff,8,0,25,17
1745797125438,CLRE 250,A00,891860,Morris; Sheldon,9995,0,9999,4
1745797127490,CLRE 251R,A00,907817,Mehta; Ravindra L.,9994,0,9999,5
1745797128518,CLRE 252,A00,891864,Cuomo; Raphael Eduardo,9993,0,9999,6
1745797129546,CLRE 253,A00,891867,Vaida; Florin,9994,0,9999,5
1745797129546,CLRE 253,B00,907819,Staff,9999,0,9999,0
1745797130573,CLRE 259,A00,891868,Patel; Hemal,9998,0,9999,1
1745797131600,CLRE 260,A00,891872,Cuomo; Raphael Eduardo,9999,0,9999,0
1745797132629,CLRE 297,001,891888,Cuomo; Raphael Eduardo,9999,0,9999,0
1745797133656,CSE 191,A00,958773,Minnes Kemp; Mor Mia,9999,0,9999,0
1745797134687,CSS 201S,A01,892054,Mignozzetti; Umberto,30,0,30,0
1745797135717,CSS 202S,A01,892056,Mignozzetti; Umberto,30,0,30,0
1745797136743,DSC 197,001,956898,Eldridge; Justin Matthew,9998,0,9999,1
1745797137770,DSC 297,001,958000,Mazumdar; Arya,9998,0,9999,1
1745797138798,EAP 100,A00,905686,Staff,9776,0,9999,223
1745797139822,ECE 45,A01,892618,Staff,0,12,50,50
1745797140849,ECE 109,A01,892620,Staff,0,43,0,0
1745797141876,ECE 111,A01,892719,Staff,0,7,50,50
1745797142904,ECE 197,001,957920,Mercier; Patrick Philip,9992,0,9999,7
1745797143936,ECON 178,A01,907814,Zhu; Ying,28,0,35,7
1745797144963,EDS 115,A00,895312,Staff,41,0,45,4
1745797145992,EDS 117,A01,895337,Staff,30,0,30,0
1745797147018,EDS 125,A00,895341,Jones; Gabrielle Anastasia,43,0,45,2
1745797148045,EDS 128A,A01,895459,Fargason; Sharon Gayle,44,0,45,1
1745797149073,EDS 128B,A01,895543,Pappas; Elizabeth,44,0,45,1
1745797150099,EDS 139,A00,897203,Pappas; Elizabeth,44,0,45,1
1745797150099,EDS 139,B00,897209,Fargason; Sharon Gayle,44,0,45,1
1745797151127,EDS 201,A00,895545,Staff,43,0,45,2
1745797152152,EDS 203,A01,895581,Halter; Christopher P.,43,0,45,2
1745797153178,EDS 204R,A01,895625,Heinzman; Erica M.,43,0,45,2
1745797153178,EDS 204R,B01,895693,Halter; Christopher P.,18,0,45,27
1745797154207,EDS 206R,A00,895694,Fargason; Sharon Gayle,9,0,30,21
1745797154207,EDS 206R,B00,895695,Choi; Bailey Miyeon,20,0,30,10
1745797155234,EDS 250,A00,895697,Hemans; Patricia Ann Benitez,43,0,45,2
1745797156264,EDS 281,A00,895701,Meyerott; Theresa Ann,15,0,15,0
1745797157290,EDS 284,A00,895736,Meyerott; Theresa Ann,15,0,15,0
1745797158319,EDS 286,A00,897210,Fine; Sarah,15,0,15,0
1745797159347,EDS 289C,A01,895770,Daly; Alan J.,15,0,15,0
1745797160373,EDS 290,A00,897211,Hofstetter; Carolyn,15,0,15,0
1745797161399,LIGM 5A,A00,896162,Fischer-Grunski; Eva K,15,0,20,5
1745797162426,LIGM 5B,A00,896260,Fischer-Grunski; Eva K,17,0,20,3
1745797163452,LIGM 5C,A00,896308,Fischer-Grunski; Eva K,18,0,20,2
1745797164481,LIIT 5AS,A00,896313,Carnelos; Chiara,18,0,20,2
1745797165508,LIIT 5BS,A00,896416,Carnelos; Chiara,20,0,20,0
1745797166535,LIIT 5CS,A00,896564,Carnelos; Chiara,20,0,20,0
1745797167561,LISP 5A,A00,896588,Munoz Sanchez; Alicia,4,0,20,16
1745797168585,LISP 5B,A00,896653,Munoz Sanchez; Alicia,10,0,20,10
1745797169614,LISP 5C,A00,896655,Munoz Sanchez; Alicia,4,0,20,16
1745797170643,MAE 197,001,957918,Kleissl; Jan,9998,0,9999,1
1745797171668,MATH 2,A01,957937,Staff,34,0,35,1
1745797172693,MATH 197,001,957876,Kedlaya; Kiran S.,9993,0,9999,6
1745797173722,MCWP 40,A00,892729,Duru; Nur,13,0,20,7
1745797173722,MCWP 40,B00,893304,Montejo; Carolina,20,0,20,0
1745797174750,MCWP 40R,A00,893757,Redela; Pamela Morgan,0,6,20,20
1745797175776,MCWP 50,A00,893758,Morshed; Michael James,2,0,20,18
1745797175776,MCWP 50,B00,893761,Bartulis; Jason Michael,17,0,20,3
1745797176803,MCWP 50R,A00,893766,Compas; Sean Matthew,0,1,20,20
1745797176803,MCWP 50R,B00,893769,Carter; Jennifer A,0,0,20,20
1745797176803,MCWP 50R,C00,893771,Krone; Jarret,0,3,20,20
1745797176803,MCWP 50R,D00,893772,Miller; Elizabeth Deen,3,0,20,17
1745797176803,MCWP 50R,E00,893775,Carter; Andrea L,0,0,20,20
1745797177833,MMW 11R,A01,892721,Herbst; Matthew,11,0,27,16
1745797177833,MMW 11R,A02,892722,Herbst; Matthew,0,0,0,3
1745797178858,MMW 12R,A01,892724,Herbst; Matthew,0,9,16,16
1745797178858,MMW 12R,A02,892725,Herbst; Matthew,0,9,16,16
1745797179885,MMW 13R,A01,892727,Staff,0,4,16,16
1745797179885,MMW 13R,A02,892728,Staff,0,4,16,16
1745797179885,MMW 13R,A03,958032,Staff,0,3,16,16
1745797179885,MMW 13R,A04,958033,Staff,0,2,16,16
1745797179885,MMW 13R,A05,958034,Staff,0,3,16,16
1745797180911,SIO 295LS,A00,894015,Staff,7,0,25,18
1745797181936,SIO 295S,A00,894020,Staff,7,0,25,18
1745797182962,SIOC 290S,B01,958918,Staff,0,0,0,0
1745797183987,SIOC 291S,B01,958922,Staff,0,0,0,0
1745797185013,SOCI 117,A01,895339,Staff,4,0,5,1
1745797186042,WES 237B,A00,894149,Staff,11,0,20,9
1745797188110,AESE 279B,A00,891859,Staff,13,0,35,22
1745797189136,AIP 197,001,891854,Staff,70,0,70,0
1745797190202,ANTH 289S,A00,891856,Gagneux; Pascal,12,0,12,0
1745797191228,BENG 196,001,957946,Engler; Adam J.,9996,0,9999,3
1745797192256,CAT 124RS,A01,956906,Staff,8,0,25,17
1745797193282,CAT 125RS,A01,922013,Staff,8,0,25,17
1745797194307,CLRE 250,A00,891860,Morris; Sheldon,9995,0,9999,4
1745797196367,CLRE 251R,A00,907817,Mehta; Ravindra L.,9994,0,9999,5
1745797197392,CLRE 252,A00,891864,Cuomo; Raphael Eduardo,9993,0,9999,6
1745797198419,CLRE 253,A00,891867,Vaida; Florin,9994,0,9999,5
1745797198419,CLRE 253,B00,907819,Staff,9999,0,9999,0
1745797199449,CLRE 259,A00,891868,Patel; Hemal,9998,0,9999,1
1745797200476,CLRE 260,A00,891872,Cuomo; Raphael Eduardo,9999,0,9999,0
1745797201507,CLRE 297,001,891888,Cuomo; Raphael Eduardo,9999,0,9999,0
1745797202533,CSE 191,A00,958773,Minnes Kemp; Mor Mia,9999,0,9999,0
1745797203560,CSS 201S,A01,892054,Mignozzetti; Umberto,30,0,30,0
1745797204588,CSS 202S,A01,892056,Mignozzetti; Umberto,30,0,30,0
1745797205615,DSC 197,001,956898,Eldridge; Justin Matthew,9998,0,9999,1
1745797206642,DSC 297,001,958000,Mazumdar; Arya,9998,0,9999,1
1745797207667,EAP 100,A00,905686,Staff,9776,0,9999,223
1745797208696,ECE 45,A01,892618,Staff,0,12,50,50
1745797209724,ECE 109,A01,892620,Staff,0,43,0,0
1745797210750,ECE 111,A01,892719,Staff,0,7,50,50
1745797211779,ECE 197,001,957920,Mercier; Patrick Philip,9992,0,9999,7
1745797212808,ECON 178,A01,907814,Zhu; Ying,28,0,35,7
1745797213833,EDS 115,A00,895312,Staff,41,0,45,4
1745797214858,EDS 117,A01,895337,Staff,30,0,30,0
1745797215888,EDS 125,A00,895341,Jones; Gabrielle Anastasia,43,0,45,2
1745797216914,EDS 128A,A01,895459,Fargason; Sharon Gayle,44,0,45,1
1745797217942,EDS 128B,A01,895543,Pappas; Elizabeth,44,0,45,1
1745797218968,EDS 139,A00,897203,Pappas; Elizabeth,44,0,45,1
1745797218968,EDS 139,B00,897209,Fargason; Sharon Gayle,44,0,45,1
1745797219996,EDS 201,A00,895545,Staff,43,0,45,2
1745797221022,EDS 203,A01,895581,Halter; Christopher P.,43,0,45,2
1745797222051,EDS 204R,A01,895625,Heinzman; Erica M.,43,0,45,2
1745797222051,EDS 204R,B01,895693,Halter; Christopher P.,18,0,45,27
1745797223077,EDS 206R,A00,895694,Fargason; Sharon Gayle,9,0,30,21
1745797223077,EDS 206R,B00,895695,Choi; Bailey Miyeon,20,0,30,10
1745797224106,EDS 250,A00,895697,Hemans; Patricia Ann Benitez,43,0,45,2
1745797225130,EDS 281,A00,895701,Meyerott; Theresa Ann,15,0,15,0
1745797226156,EDS 284,A00,895736,Meyerott; Theresa Ann,15,0,15,0
1745797227184,EDS 286,A00,897210,Fine; Sarah,15,0,15,0
1745797228211,EDS 289C,A01,895770,Daly; Alan J.,15,0,15,0
1745797229237,EDS 290,A00,897211,Hofstetter; Carolyn,15,0,15,0
1745797230268,LIGM 5A,A00,896162,Fischer-Grunski; Eva K,15,0,20,5
1745797231297,LIGM 5B,A00,896260,Fischer-Grunski; Eva K,17,0,20,3
1745797232323,LIGM 5C,A00,896308,Fischer-Grunski; Eva K,18,0,20,2
1745797233348,LIIT 5AS,A00,896313,Carnelos; Chiara,18,0,20,2
1745797234374,LIIT 5BS,A00,896416,Carnelos; Chiara,20,0,20,0
1745797235401,LIIT 5CS,A00,896564,Carnelos; Chiara,20,0,20,0
1745797236426,LISP 5A,A00,896588,Munoz Sanchez; Alicia,4,0,20,16
1745797237453,LISP 5B,A00,896653,Munoz Sanchez; Alicia,10,0,20,10
1745797238479,LISP 5C,A00,896655,Munoz Sanchez; Alicia,4,0,20,16
1745797239505,MAE 197,001,957918,Kleissl; Jan,9998,0,9999,1
1745797240531,MATH 2,A01,957937,Staff,34,0,35,1
1745797241556,MATH 197,001,957876,Kedlaya; Kiran S.,9993,0,9999,6
1745797242583,MCWP 40,A00,892729,Duru; Nur,13,0,20,7
1745797242583,MCWP 40,B00,893304,Montejo; Carolina,20,0,20,0
1745797243609,MCWP 40R,A00,893757,Redela; Pamela Morgan,0,6,20,20
1745797244638,MCWP 50,A00,893758,Morshed; Michael James,2,0,20,18
1745797244638,MCWP 50,B00,893761,Bartulis; Jason Michael,17,0,20,3
1745797245664,MCWP 50R,A00,893766,Compas; Sean Matthew,0,1,20,20
1745797245664,MCWP 50R,B00,893769,Carter; Jennifer A,0,0,20,20
1745797245664,MCWP 50R,C00,893771,Krone; Jarret,0,3,20,20
1745797245664,MCWP 50R,D00,893772,Miller; Elizabeth Deen,3,0,20,17
1745797245664,MCWP 50R,E00,893775,Carter; Andrea L,0,0,20,20
1745797246690,MMW 11R,A01,892721,Herbst; Matthew,11,0,27,16
1745797246690,MMW 11R,A02,892722,Herbst; Matthew,0,0,0,3
1745797247716,MMW 12R,A01,892724,Herbst; Matthew,0,9,16,16
1745797247716,MMW 12R,A02,892725,Herbst; Matthew,0,9,16,16
1745797248743,MMW 13R,A01,892727,Staff,0,4,16,16
1745797248743,MMW 13R,A02,892728,Staff,0,4,16,16
1745797248743,MMW 13R,A03,958032,Staff,0,3,16,16
1745797248743,MMW 13R,A04,958033,Staff,0,2,16,16
1745797248743,MMW 13R,A05,958034,Staff,0,3,16,16
1745797249770,SIO 295LS,A00,894015,Staff,7,0,25,18
1745797250797,SIO 295S,A00,894020,Staff,7,0,25,18
1745797251825,SIOC 290S,B01,958918,Staff,0,0,0,0
1745797252854,SIOC 291S,B01,958922,Staff,0,0,0,0
1745797253881,SOCI 117,A01,895339,Staff,4,0,5,1
1745797254910,WES 237B,A00,894149,Staff,11,0,20,9
1745797256968,AESE 279B,A00,891859,Staff,13,0,35,22
1745797257994,AIP 197,001,891854,Staff,70,0,70,0
1745797259020,ANTH 289S,A00,891856,Gagneux; Pascal,12,0,12,0
1745797260046,BENG 196,001,957946,Engler; Adam J.,9996,0,9999,3
1745797261072,CAT 124RS,A01,956906,Staff,8,0,25,17
1745797262099,CAT 125RS,A01,922013,Staff,8,0,25,17
1745797263123,CLRE 250,A00,891860,Morris; Sheldon,9995,0,9999,4
1745797265177,CLRE 251R,A00,907817,Mehta; Ravindra L.,9994,0,9999,5
1745797266205,CLRE 252,A00,891864,Cuomo; Raphael Eduardo,9993,0,9999,6
1745797267230,CLRE 253,A00,891867,Vaida; Florin,9994,0,9999,5
1745797267230,CLRE 253,B00,907819,Staff,9999,0,9999,0
1745797268257,CLRE 259,A00,891868,Patel; Hemal,9998,0,9999,1
1745797269284,CLRE 260,A00,891872,Cuomo; Raphael Eduardo,9999,0,9999,0
1745797270313,CLRE 297,001,891888,Cuomo; Raphael Eduardo,9999,0,9999,0
1745797271340,CSE 191,A00,958773,Minnes Kemp; Mor Mia,9999,0,9999,0
1745797272366,CSS 201S,A01,892054,Mignozzetti; Umberto,30,0,30,0
1745797273391,CSS 202S,A01,892056,Mignozzetti; Umberto,30,0,30,0
1745797274416,DSC 197,001,956898,Eldridge; Justin Matthew,9998,0,9999,1
1745797275440,DSC 297,001,958000,Mazumdar; Arya,9998,0,9999,1
1745797276467,EAP 100,A00,905686,Staff,9776,0,9999,223
1745797277493,ECE 45,A01,892618,Staff,0,12,50,50
1745797278520,ECE 109,A01,892620,Staff,0,43,0,0
1745797279546,ECE 111,A01,892719,Staff,0,7,50,50
1745797280575,ECE 197,001,957920,Mercier; Patrick Philip,9992,0,9999,7
1745797281604,ECON 178,A01,907814,Zhu; Ying,28,0,35,7
1745797282630,EDS 115,A00,895312,Staff,41,0,45,4
1745797283658,EDS 117,A01,895337,Staff,30,0,30,0
1745797284683,EDS 125,A00,895341,Jones; Gabrielle Anastasia,43,0,45,2
1745797285708,EDS 128A,A01,895459,Fargason; Sharon Gayle,44,0,45,1
1745797286737,EDS 128B,A01,895543,Pappas; Elizabeth,44,0,45,1
1745797287762,EDS 139,A00,897203,Pappas; Elizabeth,44,0,45,1
1745797287762,EDS 139,B00,897209,Fargason; Sharon Gayle,44,0,45,1
1745797288789,EDS 201,A00,895545,Staff,43,0,45,2
1745797289816,EDS 203,A01,895581,Halter; Christopher P.,43,0,45,2
1745797290843,EDS 204R,A01,895625,Heinzman; Erica M.,43,0,45,2
1745797290843,EDS 204R,B01,895693,Halter; Christopher P.,18,0,45,27
1745797291873,EDS 206R,A00,895694,Fargason; Sharon Gayle,9,0,30,21
1745797291873,EDS 206R,B00,895695,Choi; Bailey Miyeon,20,0,30,10
1745797292898,EDS 250,A00,895697,Hemans; Patricia Ann Benitez,43,0,45,2
1745797293963,EDS 281,A00,895701,Meyerott; Theresa Ann,15,0,15,0
1745797294988,EDS 284,A00,895736,Meyerott; Theresa Ann,15,0,15,0
1745797296014,EDS 286,A00,897210,Fine; Sarah,15,0,15,0
1745797297042,EDS 289C,A01,895770,Daly; Alan J.,15,0,15,0
1745797298071,EDS 290,A00,897211,Hofstetter; Carolyn,15,0,15,0
1745797299100,LIGM 5A,A00,896162,Fischer-Grunski; Eva K,15,0,20,5
1745797300127,LIGM 5B,A00,896260,Fischer-Grunski; Eva K,17,0,20,3
1745797301156,LIGM 5C,A00,896308,Fischer-Grunski; Eva K,18,0,20,2
1745797302181,LIIT 5AS,A00,896313,Carnelos; Chiara,18,0,20,2
1745797303207,LIIT 5BS,A00,896416,Carnelos; Chiara,20,0,20,0
1745797304234,LIIT 5CS,A00,896564,Carnelos; Chiara,20,0,20,0
1745797305264,LISP 5A,A00,896588,Munoz Sanchez; Alicia,4,0,20,16
1745797306293,LISP 5B,A00,896653,Munoz Sanchez; Alicia,10,0,20,10
1745797307322,LISP 5C,A00,896655,Munoz Sanchez; Alicia,4,0,20,16
1745797308350,MAE 197,001,957918,Kleissl; Jan,9998,0,9999,1
1745797309375,MATH 2,A01,957937,Staff,34,0,35,1
1745797310403,MATH 197,001,957876,Kedlaya; Kiran S.,9993,0,9999,6
1745797311432,MCWP 40,A00,892729,Duru; Nur,13,0,20,7
1745797311432,MCWP 40,B00,893304,Montejo; Carolina,20,0,20,0
1745797312458,MCWP 40R,A00,893757,Redela; Pamela Morgan,0,6,20,20
1745797313484,MCWP 50,A00,893758,Morshed; Michael James,2,0,20,18
1745797313484,MCWP 50,B00,893761,Bartulis; Jason Michael,17,0,20,3
1745797314514,MCWP 50R,A00,893766,Compas; Sean Matthew,0,1,20,20
1745797314514,MCWP 50R,B00,893769,Carter; Jennifer A,0,0,20,20
1745797314514,MCWP 50R,C00,893771,Krone; Jarret,0,3,20,20
1745797314514,MCWP 50R,D00,893772,Miller; Elizabeth Deen,3,0,20,17
1745797314514,MCWP 50R,E00,893775,Carter; Andrea L,0,0,20,20
1745797315540,MMW 11R,A01,892721,Herbst; Matthew,11,0,27,16
1745797315540,MMW 11R,A02,892722,Herbst; Matthew,0,0,0,3
1745797316565,MMW 12R,A01,892724,Herbst; Matthew,0,9,16,16
1745797316565,MMW 12R,A02,892725,Herbst; Matthew,0,9,16,16
1745797317590,MMW 13R,A01,892727,Staff,0,4,16,16
1745797317590,MMW 13R,A02,892728,Staff,0,4,16,16
1745797317590,MMW 13R,A03,958032,Staff,0,3,16,16
1745797317590,MMW 13R,A04,958033,Staff,0,2,16,16
1745797317590,MMW 13R,A05,958034,Staff,0,3,16,16
1745797318614,SIO 295LS,A00,894015,Staff,7,0,25,18
1745797319643,SIO 295S,A00,894020,Staff,7,0,25,18
1745797320668,SIOC 290S,B01,958918,Staff,0,0,0,0
1745797321698,SIOC 291S,B01,958922,Staff,0,0,0,0
1745797322723,SOCI 117,A01,895339,Staff,4,0,5,1
1745797323747,WES 237B,A00,894149,Staff,11,0,20,9
1745797325818,AESE 279B,A00,891859,Staff,13,0,35,22
1745797326842,AIP 197,001,891854,Staff,70,0,70,0
1745797327867,ANTH 289S,A00,891856,Gagneux; Pascal,12,0,12,0
1745797328892,BENG 196,001,957946,Engler; Adam J.,9996,0,9999,3
1745797329918,CAT 124RS,A01,956906,Staff,8,0,25,17
1745797330944,CAT 125RS,A01,922013,Staff,8,0,25,17
1745797331972,CLRE 250,A00,891860,Morris; Sheldon,9995,0,9999,4
1745797334027,CLRE 251R,A00,907817,Mehta; Ravindra L.,9994,0,9999,5
1745797335052,CLRE 252,A00,891864,Cuomo; Raphael Eduardo,9993,0,9999,6
1745797336078,CLRE 253,A00,891867,Vaida; Florin,9994,0,9999,5
1745797336078,CLRE 253,B00,907819,Staff,9999,0,9999,0
1745797337103,CLRE 259,A00,891868,Patel; Hemal,9998,0,9999,1
1745797338129,CLRE 260,A00,891872,Cuomo; Raphael Eduardo,9999,0,9999,0
1745797339155,CLRE 297,001,891888,Cuomo; Raphael Eduardo,9999,0,9999,0
1745797340183,CSE 191,A00,958773,Minnes Kemp; Mor Mia,9999,0,9999,0
1745797341207,CSS 201S,A01,892054,Mignozzetti; Umberto,30,0,30,0
1745797342237,CSS 202S,A01,892056,Mignozzetti; Umberto,30,0,30,0
1745797343262,DSC 197,001,956898,Eldridge; Justin Matthew,9998,0,9999,1
1745797344287,DSC 297,001,958000,Mazumdar; Arya,9998,0,9999,1
1745797345314,EAP 100,A00,905686,Staff,9776,0,9999,223
1745797346342,ECE 45,A01,892618,Staff,0,12,50,50
1745797347368,ECE 109,A01,892620,Staff,0,43,0,0
1745797348394,ECE 111,A01,892719,Staff,0,7,50,50
1745797349423,ECE 197,001,957920,Mercier; Patrick Philip,9992,0,9999,7
1745797350453,ECON 178,A01,907814,Zhu; Ying,28,0,35,7
1745797351479,EDS 115,A00,895312,Staff,41,0,45,4
1745797352504,EDS 117,A01,895337,Staff,30,0,30,0
1745797353529,EDS 125,A00,895341,Jones; Gabrielle Anastasia,43,0,45,2
1745797354554,EDS 128A,A01,895459,Fargason; Sharon Gayle,44,0,45,1
1745797355579,EDS 128B,A01,895543,Pappas; Elizabeth,44,0,45,1
1745797356606,EDS 139,A00,897203,Pappas; Elizabeth,44,0,45,1
1745797356606,EDS 139,B00,897209,Fargason; Sharon Gayle,44,0,45,1
1745797357632,EDS 201,A00,895545,Staff,43,0,45,2
1745797358659,EDS 203,A01,895581,Halter; Christopher P.,43,0,45,2
1745797359687,EDS 204R,A01,895625,Heinzman; Erica M.,43,0,45,2
1745797359687,EDS 204R,B01,895693,Halter; Christopher P.,18,0,45,27
1745797360713,EDS 206R,A00,895694,Fargason; Sharon Gayle,9,0,30,21
1745797360713,EDS 206R,B00,895695,Choi; Bailey Miyeon,20,0,30,10
1745797361739,EDS 250,A00,895697,Hemans; Patricia Ann Benitez,43,0,45,2
1745797362764,EDS 281,A00,895701,Meyerott; Theresa Ann,15,0,15,0
1745797363790,EDS 284,A00,895736,Meyerott; Theresa Ann,15,0,15,0
1745797364816,EDS 286,A00,897210,Fine; Sarah,15,0,15,0
1745797365845,EDS 289C,A01,895770,Daly; Alan J.,15,0,15,0
1745797366871,EDS 290,A00,897211,Hofstetter; Carolyn,15,0,15,0
1745797367898,LIGM 5A,A00,896162,Fischer-Grunski; Eva K,15,0,20,5
1745797368922,LIGM 5B,A00,896260,Fischer-Grunski; Eva K,17,0,20,3
1745797369948,LIGM 5C,A00,896308,Fischer-Grunski; Eva K,18,0,20,2
1745797370978,LIIT 5AS,A00,896313,Carnelos; Chiara,18,0,20,2
1745797372005,LIIT 5BS,A00,896416,Carnelos; Chiara,20,0,20,0
1745797373031,LIIT 5CS,A00,896564,Carnelos; Chiara,20,0,20,0
1745797374057,LISP 5A,A00,896588,Munoz Sanchez; Alicia,4,0,20,16
1745797375084,LISP 5B,A00,896653,Munoz Sanchez; Alicia,10,0,20,10
1745797376110,LISP 5C,A00,896655,Munoz Sanchez; Alicia,4,0,20,16
1745797377137,MAE 197,001,957918,Kleissl; Jan,9998,0,9999,1
1745797378162,MATH 2,A01,957937,Staff,34,0,35,1
1745797379186,MATH 197,001,957876,Kedlaya; Kiran S.,9993,0,9999,6
1745797380212,MCWP 40,A00,892729,Duru; Nur,13,0,20,7
1745797380212,MCWP 40,B00,893304,Montejo; Carolina,20,0,20,0
1745797381237,MCWP 40R,A00,893757,Redela; Pamela Morgan,0,6,20,20
1745797382267,MCWP 50,A00,893758,Morshed; Michael James,2,0,20,18
1745797382267,MCWP 50,B00,893761,Bartulis; Jason Michael,17,0,20,3
1745797383293,MCWP 50R,A00,893766,Compas; Sean Matthew,0,1,20,20
1745797383293,MCWP 50R,B00,893769,Carter; Jennifer A,0,0,20,20
1745797383293,MCWP 50R,C00,893771,Krone; Jarret,0,3,20,20
1745797383293,MCWP 50R,D00,893772,Miller; Elizabeth Deen,3,0,20,17
1745797383293,MCWP 50R,E00,893775,Carter; Andrea L,0,0,20,20
1745797384319,MMW 11R,A01,892721,Herbst; Matthew,11,0,27,16
1745797384319,MMW 11R,A02,892722,Herbst; Matthew,0,0,0,3
1745797385347,MMW 12R,A01,892724,Herbst; Matthew,0,9,16,16
1745797385347,MMW 12R,A02,892725,Herbst; Matthew,0,9,16,16
1745797386374,MMW 13R,A01,892727,Staff,0,4,16,16
1745797386374,MMW 13R,A02,892728,Staff,0,4,16,16
1745797386374,MMW 13R,A03,958032,Staff,0,3,16,16
1745797386374,MMW 13R,A04,958033,Staff,0,2,16,16
1745797386374,MMW 13R,A05,958034,Staff,0,3,16,16
1745797387402,SIO 295LS,A00,894015,Staff,7,0,25,18
1745797388430,SIO 295S,A00,894020,Staff,7,0,25,18
1745797389457,SIOC 290S,B01,958918,Staff,0,0,0,0
1745797390484,SIOC 291S,B01,958922,Staff,0,0,0,0
1745797391509,SOCI 117,A01,895339,Staff,4,0,5,1
1745797392535,WES 237B,A00,894149,Staff,11,0,20,9
1745797394593,AESE 279B,A00,891859,Staff,13,0,35,22
1745797395621,AIP 197,001,891854,Staff,70,0,70,0
1745797396648,ANTH 289S,A00,891856,Gagneux; Pascal,12,0,12,0
1745797397714,BENG 196,001,957946,Engler; Adam J.,9996,0,9999,3
1745797398742,CAT 124RS,A01,956906,Staff,8,0,25,17
1745797399768,CAT 125RS,A01,922013,Staff,8,0,25,17
1745797400797,CLRE 250,A00,891860,Morris; Sheldon,9995,0,9999,4
1745797402852,CLRE 251R,A00,907817,Mehta; Ravindra L.,9994,0,9999,5
1745797403878,CLRE 252,A00,891864,Cuomo; Raphael Eduardo,9993,0,9999,6
1745797404907,CLRE 253,A00,891867,Vaida; Florin,9994,0,9999,5
1745797404907,CLRE 253,B00,907819,Staff,9999,0,9999,0
1745797405937,CLRE 259,A00,891868,Patel; Hemal,9998,0,9999,1
1745797406966,CLRE 260,A00,891872,Cuomo; Raphael Eduardo,9999,0,9999,0
1745797407993,CLRE 297,001,891888,Cuomo; Raphael Eduardo,9999,0,9999,0
1745797409018,CSE 191,A00,958773,Minnes Kemp; Mor Mia,9999,0,9999,0
1745797410044,CSS 201S,A01,892054,Mignozzetti; Umberto,30,0,30,0
1745797411070,CSS 202S,A01,892056,Mignozzetti; Umberto,30,0,30,0
1745797412097,DSC 197,001,956898,Eldridge; Justin Matthew,9998,0,9999,1
1745797413121,DSC 297,001,958000,Mazumdar; Arya,9998,0,9999,1
1745797414148,EAP 100,A00,905686,Staff,9776,0,9999,223
1745797415177,ECE 45,A01,892618,Staff,0,12,50,50
1745797416203,ECE 109,A01,892620,Staff,0,43,0,0
1745797417231,ECE 111,A01,892719,Staff,0,7,50,50
1745797418258,ECE 197,001,957920,Mercier; Patrick Philip,9992,0,9999,7
1745797419282,ECON 178,A01,907814,Zhu; Ying,28,0,35,7
1745797420311,EDS 115,A00,895312,Staff,41,0,45,4
1745797421336,EDS 117,A01,895337,Staff,30,0,30,0
1745797422362,EDS 125,A00,895341,Jones; Gabrielle Anastasia,43,0,45,2
1745797423392,EDS 128A,A01,895459,Fargason; Sharon Gayle,44,0,45,1
1745797424421,EDS 128B,A01,895543,Pappas; Elizabeth,44,0,45,1
1745797425453,EDS 139,A00,897203,Pappas; Elizabeth,44,0,45,1
1745797425453,EDS 139,B00,897209,Fargason; Sharon Gayle,44,0,45,1
1745797426481,EDS 201,A00,895545,Staff,43,0,45,2
1745797427506,EDS 203,A01,895581,Halter; Christopher P.,43,0,45,2
1745797428532,EDS 204R,A01,895625,Heinzman; Erica M.,43,0,45,2
1745797428532,EDS 204R,B01,895693,Halter; Christopher P.,18,0,45,27
1745797429556,EDS 206R,A00,895694,Fargason; Sharon Gayle,9,0,30,21
1745797429556,EDS 206R,B00,895695,Choi; Bailey Miyeon,20,0,30,10
1745797430582,EDS 250,A00,895697,Hemans; Patricia Ann Benitez,43,0,45,2
1745797431608,EDS 281,A00,895701,Meyerott; Theresa Ann,15,0,15,0
1745797432634,EDS 284,A00,895736,Meyerott; Theresa Ann,15,0,15,0
1745797433662,EDS 286,A00,897210,Fine; Sarah,15,0,15,0
1745797434688,EDS 289C,A01,895770,Daly; Alan J.,15,0,15,0
1745797435717,EDS 290,A00,897211,Hofstetter; Carolyn,15,0,15,0
1745797436746,LIGM 5A,A00,896162,Fischer-Grunski; Eva K,15,0,20,5
1745797437775,LIGM 5B,A00,896260,Fischer-Grunski; Eva K,17,0,20,3
1745797438800,LIGM 5C,A00,896308,Fischer-Grunski; Eva K,18,0,20,2
1745797439827,LIIT 5AS,A00,896313,Carnelos; Chiara,18,0,20,2
1745797440854,LIIT 5BS,A00,896416,Carnelos; Chiara,20,0,20,0
1745797441884,LIIT 5CS,A00,896564,Carnelos; Chiara,20,0,20,0
1745797442912,LISP 5A,A00,896588,Munoz Sanchez; Alicia,4,0,20,16
1745797443941,LISP 5B,A00,896653,Munoz Sanchez; Alicia,10,0,20,10
1745797444966,LISP 5C,A00,896655,Munoz Sanchez; Alicia,4,0,20,16
1745797445991,MAE 197,001,957918,Kleissl; Jan,9998,0,9999,1
1745797447017,MATH 2,A01,957937,Staff,34,0,35,1
1745797448046,MATH 197,001,957876,Kedlaya; Kiran S.,9993,0,9999,6
1745797449075,MCWP 40,A00,892729,Duru; Nur,13,0,20,7
1745797449075,MCWP 40,B00,893304,Montejo; Carolina,20,0,20,0
1745797450102,MCWP 40R,A00,893757,Redela; Pamela Morgan,0,6,20,20
1745797451128,MCWP 50,A00,893758,Morshed; Michael James,2,0,20,18
1745797451128,MCWP 50,B00,893761,Bartulis; Jason Michael,17,0,20,3
1745797452155,MCWP 50R,A00,893766,Compas; Sean Matthew,0,1,20,20
1745797452155,MCWP 50R,B00,893769,Carter; Jennifer A,0,0,20,20
1745797452155,MCWP 50R,C00,893771,Krone; Jarret,0,3,20,20
1745797452155,MCWP 50R,D00,893772,Miller; Elizabeth Deen,3,0,20,17
1745797452155,MCWP 50R,E00,893775,Carter; Andrea L,0,0,20,20
1745797453181,MMW 11R,A01,892721,Herbst; Matthew,11,0,27,16
1745797453181,MMW 11R,A02,892722,Herbst; Matthew,0,0,0,3
1745797454206,MMW 12R,A01,892724,Herbst; Matthew,0,9,16,16
1745797454206,MMW 12R,A02,892725,Herbst; Matthew,0,9,16,16
1745797455232,MMW 13R,A01,892727,Staff,0,4,16,16
1745797455232,MMW 13R,A02,892728,Staff,0,4,16,16
1745797455232,MMW 13R,A03,958032,Staff,0,3,16,16
1745797455232,MMW 13R,A04,958033,Staff,0,2,16,16
1745797455232,MMW 13R,A05,958034,Staff,0,3,16,16
1745797456261,SIO 295LS,A00,894015,Staff,7,0,25,18
1745797457290,SIO 295S,A00,894020,Staff,7,0,25,18
1745797458317,SIOC 290S,B01,958918,Staff,0,0,0,0
1745797459348,SIOC 291S,B01,958922,Staff,0,0,0,0
1745797460377,SOCI 117,A01,895339,Staff,4,0,5,1
1745797461402,WES 237B,A00,894149,Staff,11,0,20,9
1745797463467,AESE 279B,A00,891859,Staff,13,0,35,22
1745797464497,AIP 197,001,891854,Staff,70,0,70,0
1745797465522,ANTH 289S,A00,891856,Gagneux; Pascal,12,0,12,0
1745797466551,BENG 196,001,957946,Engler; Adam J.,9996,0,9999,3
1745797467590,CAT 124RS,A01,956906,Staff,8,0,25,17
1745797468614,CAT 125RS,A01,922013,Staff,8,0,25,17
1745797469640,CLRE 250,A00,891860,Morris; Sheldon,9995,0,9999,4
1745797471693,CLRE 251R,A00,907817,Mehta; Ravindra L.,9994,0,9999,5
1745797472720,CLRE 252,A00,891864,Cuomo; Raphael Eduardo,9993,0,9999,6
1745797473750,CLRE 253,A00,891867,Vaida; Florin,9994,0,9999,5
1745797473750,CLRE 253,B00,907819,Staff,9999,0,9999,0
1745797474781,CLRE 259,A00,891868,Patel; Hemal,9998,0,9999,1
1745797475810,CLRE 260,A00,891872,Cuomo; Raphael Eduardo,9999,0,9999,0
1745797476836,CLRE 297,001,891888,Cuomo; Raphael Eduardo,9999,0,9999,0
1745797477863,CSE 191,A00,958773,Minnes Kemp; Mor Mia,9999,0,9999,0
1745797478890,CSS 201S,A01,892054,Mignozzetti; Umberto,30,0,30,0
1745797479916,CSS 202S,A01,892056,Mignozzetti; Umberto,30,0,30,0
1745797480944,DSC 197,001,956898,Eldridge; Justin Matthew,9998,0,9999,1
1745797481971,DSC 297,001,958000,Mazumdar; Arya,9998,0,9999,1
1745797482997,EAP 100,A00,905686,Staff,9776,0,9999,223
1745797484024,ECE 45,A01,892618,Staff,0,12,50,50
1745797485051,ECE 109,A01,892620,Staff,0,43,0,0
1745797486077,ECE 111,A01,892719,Staff,0,7,50,50
1745797487105,ECE 197,001,957920,Mercier; Patrick Philip,9992,0,9999,7
1745797488134,ECON 178,A01,907814,Zhu; Ying,28,0,35,7
1745797489161,EDS 115,A00,895312,Staff,41,0,45,4
1745797490190,EDS 117,A01,895337,Staff,30,0,30,0
1745797491215,EDS 125,A00,895341,Jones; Gabrielle Anastasia,43,0,45,2
1745797492241,EDS 128A,A01,895459,Fargason; Sharon Gayle,44,0,45,1
1745797493269,EDS 128B,A01,895543,Pappas; Elizabeth,44,0,45,1
1745797494298,EDS 139,A00,897203,Pappas; Elizabeth,44,0,45,1
1745797494298,EDS 139,B00,897209,Fargason; Sharon Gayle,44,0,45,1
1745797495327,EDS 201,A00,895545,Staff,43,0,45,2
1745797496353,EDS 203,A01,895581,Halter; Christopher P.,43,0,45,2
1745797497380,EDS 204R,A01,895625,Heinzman; Erica M.,43,0,45,2
1745797497380,EDS 204R,B01,895693,Halter; Christopher P.,18,0,45,27
1745797498408,EDS 206R,A00,895694,Fargason; Sharon Gayle,9,0,30,21
1745797498408,EDS 206R,B00,895695,Choi; Bailey Miyeon,20,0,30,10
1745797499435,EDS 250,A00,895697,Hemans; Patricia Ann Benitez,43,0,45,2
1745797500460,EDS 281,A00,895701,Meyerott; Theresa Ann,15,0,15,0
1745797501531,EDS 284,A00,895736,Meyerott; Theresa Ann,15,0,15,0
1745797502557,EDS 286,A00,897210,Fine; Sarah,15,0,15,0
1745797503582,EDS 289C,A01,895770,Daly; Alan J.,15,0,15,0
1745797504606,EDS 290,A00,897211,Hofstetter; Carolyn,15,0,15,0
1745797505635,LIGM 5A,A00,896162,Fischer-Grunski; Eva K,15,0,20,5
1745797506665,LIGM 5B,A00,896260,Fischer-Grunski; Eva K,17,0,20,3
1745797507690,LIGM 5C,A00,896308,Fischer-Grunski; Eva K,18,0,20,2
1745797508717,LIIT 5AS,A00,896313,Carnelos; Chiara,18,0,20,2
1745797509745,LIIT 5BS,A00,896416,Carnelos; Chiara,20,0,20,0
1745797510771,LIIT 5CS,A00,896564,Carnelos; Chiara,20,0,20,0
1745797511800,LISP 5A,A00,896588,Munoz Sanchez; Alicia,4,0,20,16
1745797512830,LISP 5B,A00,896653,Munoz Sanchez; Alicia,10,0,20,10
1745797513856,LISP 5C,A00,896655,Munoz Sanchez; Alicia,4,0,20,16
1745797514881,MAE 197,001,957918,Kleissl; Jan,9998,0,9999,1
1745797515907,MATH 2,A01,957937,Staff,34,0,35,1
1745797516933,MATH 197,001,957876,Kedlaya; Kiran S.,9993,0,9999,6
1745797517959,MCWP 40,A00,892729,Duru; Nur,13,0,20,7
1745797517959,MCWP 40,B00,893304,Montejo; Carolina,20,0,20,0
1745797518986,MCWP 40R,A00,893757,Redela; Pamela Morgan,0,6,20,20
1745797520016,MCWP 50,A00,893758,Morshed; Michael James,2,0,20,18
1745797520016,MCWP 50,B00,893761,Bartulis; Jason Michael,17,0,20,3
1745797521044,MCWP 50R,A00,893766,Compas; Sean Matthew,0,1,20,20
1745797521044,MCWP 50R,B00,893769,Carter; Jennifer A,0,0,20,20
1745797521044,MCWP 50R,C00,893771,Krone; Jarret,0,3,20,20
1745797521044,MCWP 50R,D00,893772,Miller; Elizabeth Deen,3,0,20,17
1745797521044,MCWP 50R,E00,893775,Carter; Andrea L,0,0,20,20
1745797522071,MMW 11R,A01,892721,Herbst; Matthew,11,0,27,16
1745797522071,MMW 11R,A02,892722,Herbst; Matthew,0,0,0,3
1745797523096,MMW 12R,A01,892724,Herbst; Matthew,0,9,16,16
1745797523096,MMW 12R,A02,892725,Herbst; Matthew,0,9,16,16
1745797524124,MMW 13R,A01,892727,Staff,0,4,16,16
1745797524124,MMW 13R,A02,892728,Staff,0,4,16,16
1745797524124,MMW 13R,A03,958032,Staff,0,3,16,16
1745797524124,MMW 13R,A04,958033,Staff,0,2,16,16
1745797524124,MMW 13R,A05,958034,Staff,0,3,16,16
1745797525150,SIO 295LS,A00,894015,Staff,7,0,25,18
1745797526178,SIO 295S,A00,894020,Staff,7,0,25,18
1745797527204,SIOC 290S,B01,958918,Staff,0,0,0,0
1745797528229,SIOC 291S,B01,958922,Staff,0,0,0,0
1745797529255,SOCI 117,A01,895339,Staff,4,0,5,1
1745797530281,WES 237B,A00,894149,Staff,11,0,20,9
1745797532348,AESE 279B,A00,891859,Staff,13,0,35,22
1745797533375,AIP 197,001,891854,Staff,70,0,70,0
1745797534400,ANTH 289S,A00,891856,Gagneux; Pascal,12,0,12,0
1745797535425,BENG 196,001,957946,Engler; Adam J.,9996,0,9999,3
1745797536452,CAT 124RS,A01,956906,Staff,8,0,25,17
1745797537477,CAT 125RS,A01,922013,Staff,8,0,25,17
1745797538503,CLRE 250,A00,891860,Morris; Sheldon,9995,0,9999,4
1745797540558,CLRE 251R,A00,907817,Mehta; Ravindra L.,9994,0,9999,5
1745797541586,CLRE 252,A00,891864,Cuomo; Raphael Eduardo,9993,0,9999,6
1745797542611,CLRE 253,A00,891867,Vaida; Florin,9994,0,9999,5
1745797542611,CLRE 253,B00,907819,Staff,9999,0,9999,0
1745797543639,CLRE 259,A00,891868,Patel; Hemal,9998,0,9999,1
1745797544667,CLRE 260,A00,891872,Cuomo; Raphael Eduardo,9999,0,9999,0
1745797545692,CLRE 297,001,891888,Cuomo; Raphael Eduardo,9999,0,9999,0
1745797546718,CSE 191,A00,958773,Minnes Kemp; Mor Mia,9999,0,9999,0
1745797547745,CSS 201S,A01,892054,Mignozzetti; Umberto,30,0,30,0
1745797548773,CSS 202S,A01,892056,Mignozzetti; Umberto,30,0,30,0
1745797549796,DSC 197,001,956898,Eldridge; Justin Matthew,9998,0,9999,1
1745797550823,DSC 297,001,958000,Mazumdar; Arya,9998,0,9999,1
1745797551850,EAP 100,A00,905686,Staff,9776,0,9999,223
1745797552878,ECE 45,A01,892618,Staff,0,12,50,50
1745797553903,ECE 109,A01,892620,Staff,0,43,0,0
1745797554928,ECE 111,A01,892719,Staff,0,7,50,50
1745797555956,ECE 197,001,957920,Mercier; Patrick Philip,9992,0,9999,7
1745797556982,ECON 178,A01,907814,Zhu; Ying,28,0,35,7
1745797558007,EDS 115,A00,895312,Staff,41,0,45,4
1745797559035,EDS 117,A01,895337,Staff,30,0,30,0
1745797560060,EDS 125,A00,895341,Jones; Gabrielle Anastasia,43,0,45,2
1745797561086,EDS 128A,A01,895459,Fargason; Sharon Gayle,44,0,45,1
1745797562112,EDS 128B,A01,895543,Pappas; Elizabeth,44,0,45,1
1745797563140,EDS 139,A00,897203,Pappas; Elizabeth,44,0,45,1
1745797563140,EDS 139,B00,897209,Fargason; Sharon Gayle,44,0,45,1
1745797564165,EDS 201,A00,895545,Staff,43,0,45,2
1745797565191,EDS 203,A01,895581,Halter; Christopher P.,43,0,45,2
1745797566220,EDS 204R,A01,895625,Heinzman; Erica M.,43,0,45,2
1745797566220,EDS 204R,B01,895693,Halter; Christopher P.,18,0,45,27
1745797567248,EDS 206R,A00,895694,Fargason; Sharon Gayle,9,0,30,21
1745797567248,EDS 206R,B00,895695,Choi; Bailey Miyeon,20,0,30,10
1745797568277,EDS 250,A00,895697,Hemans; Patricia Ann Benitez,43,0,45,2
1745797569305,EDS 281,A00,895701,Meyerott; Theresa Ann,15,0,15,0
1745797570331,EDS 284,A00,895736,Meyerott; Theresa Ann,15,0,15,0
1745797571356,EDS 286,A00,897210,Fine; Sarah,15,0,15,0
1745797572479,EDS 289C,A01,895770,Daly; Alan J.,15,0,15,0
1745797573506,EDS 290,A00,897211,Hofstetter; Carolyn,15,0,15,0
1745797574536,LIGM 5A,A00,896162,Fischer-Grunski; Eva K,15,0,20,5
1745797575561,LIGM 5B,A00,896260,Fischer-Grunski; Eva K,17,0,20,3
1745797576590,LIGM 5C,A00,896308,Fischer-Grunski; Eva K,18,0,20,2
1745797577616,LIIT 5AS,A00,896313,Carnelos; Chiara,18,0,20,2
1745797578645,LIIT 5BS,A00,896416,Carnelos; Chiara,20,0,20,0
1745797579671,LIIT 5CS,A00,896564,Carnelos; Chiara,20,0,20,0
1745797580697,LISP 5A,A00,896588,Munoz Sanchez; Alicia,4,0,20,16
1745797581724,LISP 5B,A00,896653,Munoz Sanchez; Alicia,10,0,20,10
1745797582749,LISP 5C,A00,896655,Munoz Sanchez; Alicia,4,0,20,16
1745797583778,MAE 197,001,957918,Kleissl; Jan,9998,0,9999,1
1745797584804,MATH 2,A01,957937,Staff,34,0,35,1
1745797585832,MATH 197,001,957876,Kedlaya; Kiran S.,9993,0,9999,6
1745797586861,MCWP 40,A00,892729,Duru; Nur,13,0,20,7
1745797586861,MCWP 40,B00,893304,Montejo; Carolina,20,0,20,0
1745797587890,MCWP 40R,A00,893757,Redela; Pamela Morgan,0,6,20,20
1745797588916,MCWP 50,A00,893758,Morshed; Michael James,2,0,20,18
1745797588916,MCWP 50,B00,893761,Bartulis; Jason Michael,17,0,20,3
1745797589942,MCWP 50R,A00,893766,Compas; Sean Matthew,0,1,20,20
1745797589942,MCWP 50R,B00,893769,Carter; Jennifer A,0,0,20,20
1745797589942,MCWP 50R,C00,893771,Krone; Jarret,0,3,20,20
1745797589942,MCWP 50R,D00,893772,Miller; Elizabeth Deen,3,0,20,17
1745797589942,MCWP 50R,E00,893775,Carter; Andrea L,0,0,20,20
1745797590967,MMW 11R,A01,892721,Herbst; Matthew,11,0,27,16
1745797590967,MMW 11R,A02,892722,Herbst; Matthew,0,0,0,3
1745797591993,MMW 12R,A01,892724,Herbst; Matthew,0,9,16,16
1745797591993,MMW 12R,A02,892725,Herbst; Matthew,0,9,16,16
1745797593017,MMW 13R,A01,892727,Staff,0,4,16,16
1745797593017,MMW 13R,A02,892728,Staff,0,4,16,16
1745797593017,MMW 13R,A03,958032,Staff,0,3,16,16
1745797593017,MMW 13R,A04,958033,Staff,0,2,16,16
1745797593017,MMW 13R,A05,958034,Staff,0,3,16,16
1745797594049,SIO 295LS,A00,894015,Staff,7,0,25,18
1745797595076,SIO 295S,A00,894020,Staff,7,0,25,18
1745797596104,SIOC 290S,B01,958918,Staff,0,0,0,0
1745797597133,SIOC 291S,B01,958922,Staff,0,0,0,0
1745797598160,SOCI 117,A01,895339,Staff,4,0,5,1
1745797599187,WES 237B,A00,894149,Staff,11,0,20,9
1745797601241,AESE 279B,A00,891859,Staff,13,0,35,22
1745797602264,AIP 197,001,891854,Staff,70,0,70,0
1745797603291,ANTH 289S,A00,891856,Gagneux; Pascal,12,0,12,0
1745797604315,BENG 196,001,957946,Engler; Adam J.,9996,0,9999,3
1745797605383,CAT 124RS,A01,956906,Staff,8,0,25,17
1745797606409,CAT 125RS,A01,922013,Staff,8,0,25,17
1745797607438,CLRE 250,A00,891860,Morris; Sheldon,9995,0,9999,4
1745797609494,CLRE 251R,A00,907817,Mehta; Ravindra L.,9994,0,9999,5
1745797610520,CLRE 252,A00,891864,Cuomo; Raphael Eduardo,9993,0,9999,6
1745797611550,CLRE 253,A00,891867,Vaida; Florin,9994,0,9999,5
1745797611550,CLRE 253,B00,907819,Staff,9999,0,9999,0
1745797612580,CLRE 259,A00,891868,Patel; Hemal,9998,0,9999,1
1745797613606,CLRE 260,A00,891872,Cuomo; Raphael Eduardo,9999,0,9999,0
1745797614633,CLRE 297,001,891888,Cuomo; Raphael Eduardo,9999,0,9999,0
1745797615662,CSE 191,A00,958773,Minnes Kemp; Mor Mia,9999,0,9999,0
1745797616688,CSS 201S,A01,892054,Mignozzetti; Umberto,30,0,30,0
1745797617714,CSS 202S,A01,892056,Mignozzetti; Umberto,30,0,30,0
1745797618738,DSC 197,001,956898,Eldridge; Justin Matthew,9998,0,9999,1
1745797619763,DSC 297,001,958000,Mazumdar; Arya,9998,0,9999,1
1745797620789,EAP 100,A00,905686,Staff,9776,0,9999,223
1745797621818,ECE 45,A01,892618,Staff,0,12,50,50
1745797622845,ECE 109,A01,892620,Staff,0,43,0,0
1745797623872,ECE 111,A01,892719,Staff,0,7,50,50
1745797624897,ECE 197,001,957920,Mercier; Patrick Philip,9992,0,9999,7
1745797625922,ECON 178,A01,907814,Zhu; Ying,28,0,35,7
1745797626948,EDS 115,A00,895312,Staff,41,0,45,4
1745797627974,EDS 117,A01,895337,Staff,30,0,30,0
1745797629003,EDS 125,A00,895341,Jones; Gabrielle Anastasia,43,0,45,2
1745797630029,EDS 128A,A01,895459,Fargason; Sharon Gayle,44,0,45,1
1745797631058,EDS 128B,A01,895543,Pappas; Elizabeth,44,0,45,1
1745797632083,EDS 139,A00,897203,Pappas; Elizabeth,44,0,45,1
1745797632083,EDS 139,B00,897209,Fargason; Sharon Gayle,44,0,45,1
1745797633109,EDS 201,A00,895545,Staff,43,0,45,2
1745797634138,EDS 203,A01,895581,Halter; Christopher P.,43,0,45,2
1745797635167,EDS 204R,A01,895625,Heinzman; Erica M.,43,0,45,2
1745797635167,EDS 204R,B01,895693,Halter; Christopher P.,18,0,45,27
1745797636197,EDS 206R,A00,895694,Fargason; Sharon Gayle,9,0,30,21
1745797636197,EDS 206R,B00,895695,Choi; Bailey Miyeon,20,0,30,10
1745797637223,EDS 250,A00,895697,Hemans; Patricia Ann Benitez,43,0,45,2
1745797638249,EDS 281,A00,895701,Meyerott; Theresa Ann,15,0,15,0
1745797639276,EDS 284,A00,895736,Meyerott; Theresa Ann,15,0,15,0
1745797640306,EDS 286,A00,897210,Fine; Sarah,15,0,15,0
1745797641333,EDS 289C,A01,895770,Daly; Alan J.,15,0,15,0
1745797642363,EDS 290,A00,897211,Hofstetter; Carolyn,15,0,15,0
1745797643391,LIGM 5A,A00,896162,Fischer-Grunski; Eva K,15,0,20,5
1745797644416,LIGM 5B,A00,896260,Fischer-Grunski; Eva K,17,0,20,3
1745797645442,LIGM 5C,A00,896308,Fischer-Grunski; Eva K,18,0,20,2
1745797646468,LIIT 5AS,A00,896313,Carnelos; Chiara,18,0,20,2
1745797647495,LIIT 5BS,A00,896416,Carnelos; Chiara,20,0,20,0
1745797648554,LIIT 5CS,A00,896564,Carnelos; Chiara,20,0,20,0
1745797649582,LISP 5A,A00,896588,Munoz Sanchez; Alicia,4,0,20,16
1745797650611,LISP 5B,A00,896653,Munoz Sanchez; Alicia,10,0,20,10
1745797651635,LISP 5C,A00,896655,Munoz Sanchez; Alicia,4,0,20,16
1745797652663,MAE 197,001,957918,Kleissl; Jan,9998,0,9999,1
1745797653690,MATH 2,A01,957937,Staff,34,0,35,1
1745797654717,MATH 197,001,957876,Kedlaya; Kiran S.,9993,0,9999,6
1745797655745,MCWP 40,A00,892729,Duru; Nur,13,0,20,7
1745797655745,MCWP 40,B00,893304,Montejo; Carolina,20,0,20,0
1745797656769,MCWP 40R,A00,893757,Redela; Pamela Morgan,0,6,20,20
1745797657798,MCWP 50,A00,893758,Morshed; Michael James,2,0,20,18
1745797657798,MCWP 50,B00,893761,Bartulis; Jason Michael,17,0,20,3
1745797658825,MCWP 50R,A00,893766,Compas; Sean Matthew,0,1,20,20
1745797658825,MCWP 50R,B00,893769,Carter; Jennifer A,0,0,20,20
1745797658825,MCWP 50R,C00,893771,Krone; Jarret,0,3,20,20
1745797658825,MCWP 50R,D00,893772,Miller; Elizabeth Deen,3,0,20,17
1745797658825,MCWP 50R,E00,893775,Carter; Andrea L,0,0,20,20
1745797659853,MMW 11R,A01,892721,Herbst; Matthew,11,0,27,16
1745797659853,MMW 11R,A02,892722,Herbst; Matthew,0,0,0,3
1745797660881,MMW 12R,A01,892724,Herbst; Matthew,0,9,16,16
1745797660881,MMW 12R,A02,892725,Herbst; Matthew,0,9,16,16
1745797661907,MMW 13R,A01,892727,Staff,0,4,16,16
1745797661907,MMW 13R,A02,892728,Staff,0,4,16,16
1745797661907,MMW 13R,A03,958032,Staff,0,3,16,16
1745797661907,MMW 13R,A04,958033,Staff,0,2,16,16
1745797661907,MMW 13R,A05,958034,Staff,0,3,16,16
1745797662936,SIO 295LS,A00,894015,Staff,7,0,25,18
1745797663961,SIO 295S,A00,894020,Staff,7,0,25,18
1745797664989,SIOC 290S,B01,958918,Staff,0,0,0,0
1745797666015,SIOC 291S,B01,958922,Staff,0,0,0,0
1745797667041,SOCI 117,A01,895339,Staff,4,0,5,1
1745797668067,WES 237B,A00,894149,Staff,11,0,20,9
1745797670134,AESE 279B,A00,891859,Staff,13,0,35,22
1745797671161,AIP 197,001,891854,Staff,70,0,70,0
1745797672187,ANTH 289S,A00,891856,Gagneux; Pascal,12,0,12,0
1745797673212,BENG 196,001,957946,Engler; Adam J.,9996,0,9999,3
1745797674239,CAT 124RS,A01,956906,Staff,8,0,25,17
1745797675266,CAT 125RS,A01,922013,Staff,8,0,25,17
1745797676294,CLRE 250,A00,891860,Morris; Sheldon,9995,0,9999,4
1745797678350,CLRE 251R,A00,907817,Mehta; Ravindra L.,9994,0,9999,5
1745797679376,CLRE 252,A00,891864,Cuomo; Raphael Eduardo,9993,0,9999,6
1745797680403,CLRE 253,A00,891867,Vaida; Florin,9994,0,9999,5
1745797680403,CLRE 253,B00,907819,Staff,9999,0,9999,0
1745797681431,CLRE 259,A00,891868,Patel; Hemal,9998,0,9999,1
1745797682457,CLRE 260,A00,891872,Cuomo; Raphael Eduardo,9999,0,9999,0
1745797683482,CLRE 297,001,891888,Cuomo; Raphael Eduardo,9999,0,9999,0
1745797684507,CSE 191,A00,958773,Minnes Kemp; Mor Mia,9999,0,9999,0
1745797685532,CSS 201S,A01,892054,Mignozzetti; Umberto,30,0,30,0
1745797686557,CSS 202S,A01,892056,Mignozzetti; Umberto,30,0,30,0
1745797687583,DSC 197,001,956898,Eldridge; Justin Matthew,9998,0,9999,1
1745797688607,DSC 297,001,958000,Mazumdar; Arya,9998,0,9999,1
1745797689632,EAP 100,A00,905686,Staff,9776,0,9999,223
1745797690661,ECE 45,A01,892618,Staff,0,12,50,50
1745797691686,ECE 109,A01,892620,Staff,0,43,0,0
1745797692711,ECE 111,A01,892719,Staff,0,7,50,50
1745797693738,ECE 197,001,957920,Mercier; Patrick Philip,9992,0,9999,7
1745797694765,ECON 178,A01,907814,Zhu; Ying,28,0,35,7
1745797695792,EDS 115,A00,895312,Staff,41,0,45,4
1745797696817,EDS 117,A01,895337,Staff,30,0,30,0
1745797697844,EDS 125,A00,895341,Jones; Gabrielle Anastasia,43,0,45,2
1745797698876,EDS 128A,A01,895459,Fargason; Sharon Gayle,44,0,45,1
1745797699901,EDS 128B,A01,895543,Pappas; Elizabeth,44,0,45,1
1745797700932,EDS 139,A00,897203,Pappas; Elizabeth,44,0,45,1
1745797700932,EDS 139,B00,897209,Fargason; Sharon Gayle,44,0,45,1
1745797701958,EDS 201,A00,895545,Staff,43,0,45,2
1745797702989,EDS 203,A01,895581,Halter; Christopher P.,43,0,45,2
1745797704014,EDS 204R,A01,895625,Heinzman; Erica M.,43,0,45,2
1745797704014,EDS 204R,B01,895693,Halter; Christopher P.,18,0,45,27
1745797705040,EDS 206R,A00,895694,Fargason; Sharon Gayle,9,0,30,21
1745797705040,EDS 206R,B00,895695,Choi; Bailey Miyeon,20,0,30,10
1745797706069,EDS 250,A00,895697,Hemans; Patricia Ann Benitez,43,0,45,2
1745797707094,EDS 281,A00,895701,Meyerott; Theresa Ann,15,0,15,0
1745797708123,EDS 284,A00,895736,Meyerott; Theresa Ann,15,0,15,0
1745797709190,EDS 286,A00,897210,Fine; Sarah,15,0,15,0
1745797710221,EDS 289C,A01,895770,Daly; Alan J.,15,0,15,0
1745797711250,EDS 290,A00,897211,Hofstetter; Carolyn,15,0,15,0
1745797712277,LIGM 5A,A00,896162,Fischer-Grunski; Eva K,15,0,20,5
1745797713306,LIGM 5B,A00,896260,Fischer-Grunski; Eva K,17,0,20,3
1745797714330,LIGM 5C,A00,896308,Fischer-Grunski; Eva K,18,0,20,2
1745797715359,LIIT 5AS,A00,896313,Carnelos; Chiara,18,0,20,2
1745797716387,LIIT 5BS,A00,896416,Carnelos; Chiara,20,0,20,0
1745797717416,LIIT 5CS,A00,896564,Carnelos; Chiara,20,0,20,0
1745797718444,LISP 5A,A00,896588,Munoz Sanchez; Alicia,4,0,20,16
1745797719476,LISP 5B,A00,896653,Munoz Sanchez; Alicia,10,0,20,10
1745797720502,LISP 5C,A00,896655,Munoz Sanchez; Alicia,4,0,20,16
1745797721531,MAE 197,001,957918,Kleissl; Jan,9998,0,9999,1
1745797722561,MATH 2,A01,957937,Staff,34,0,35,1
1745797723586,MATH 197,001,957876,Kedlaya; Kiran S.,9993,0,9999,6
1745797724614,MCWP 40,A00,892729,Duru; Nur,13,0,20,7
1745797724614,MCWP 40,B00,893304,Montejo; Carolina,20,0,20,0
1745797725641,MCWP 40R,A00,893757,Redela; Pamela Morgan,0,6,20,20
1745797726670,MCWP 50,A00,893758,Morshed; Michael James,2,0,20,18
1745797726670,MCWP 50,B00,893761,Bartulis; Jason Michael,17,0,20,3
1745797727697,MCWP 50R,A00,893766,Compas; Sean Matthew,0,1,20,20
1745797727697,MCWP 50R,B00,893769,Carter; Jennifer A,0,0,20,20
1745797727697,MCWP 50R,C00,893771,Krone; Jarret,0,3,20,20
1745797727697,MCWP 50R,D00,893772,Miller; Elizabeth Deen,3,0,20,17
1745797727697,MCWP 50R,E00,893775,Carter; Andrea L,0,0,20,20
1745797728724,MMW 11R,A01,892721,Herbst; Matthew,11,0,27,16
1745797728724,MMW 11R,A02,892722,Herbst; Matthew,0,0,0,3
1745797729754,MMW 12R,A01,892724,Herbst; Matthew,0,9,16,16
1745797729754,MMW 12R,A02,892725,Herbst; Matthew,0,9,16,16
1745797730782,MMW 13R,A01,892727,Staff,0,4,16,16
1745797730782,MMW 13R,A02,892728,Staff,0,4,16,16
1745797730782,MMW 13R,A03,958032,Staff,0,3,16,16
1745797730782,MMW 13R,A04,958033,Staff,0,2,16,16
1745797730782,MMW 13R,A05,958034,Staff,0,3,16,16
1745797731813,SIO 295LS,A00,894015,Staff,7,0,25,18
1745797732839,SIO 295S,A00,894020,Staff,7,0,25,18
1745797733868,SIOC 290S,B01,958918,Staff,0,0,0,0
1745797734897,SIOC 291S,B01,958922,Staff,0,0,0,0
1745797735926,SOCI 117,A01,895339,Staff,4,0,5,1
1745797736952,WES 237B,A00,894149,Staff,11,0,20,9
1745797739014,AESE 279B,A00,891859,Staff,13,0,35,22
1745797740039,AIP 197,001,891854,Staff,70,0,70,0
1745797741065,ANTH 289S,A00,891856,Gagneux; Pascal,12,0,12,0
1745797742093,BENG 196,001,957946,Engler; Adam J.,9996,0,9999,3
1745797743121,CAT 124RS,A01,956906,Staff,8,0,25,17
1745797744152,CAT 125RS,A01,922013,Staff,8,0,25,17
1745797745181,CLRE 250,A00,891860,Morris; Sheldon,9995,0,9999,4
1745797747234,CLRE 251R,A00,907817,Mehta; Ravindra L.,9994,0,9999,5
1745797748263,CLRE 252,A00,891864,Cuomo; Raphael Eduardo,9993,0,9999,6
1745797749293,CLRE 253,A00,891867,Vaida; Florin,9994,0,9999,5
1745797749293,CLRE 253,B00,907819,Staff,9999,0,9999,0
1745797750319,CLRE 259,A00,891868,Patel; Hemal,9998,0,9999,1
1745797751350,CLRE 260,A00,891872,Cuomo; Raphael Eduardo,9999,0,9999,0
1745797752378,CLRE 297,001,891888,Cuomo; Raphael Eduardo,9999,0,9999,0
1745797753407,CSE 191,A00,958773,Minnes Kemp; Mor Mia,9999,0,9999,0
1745797754436,CSS 201S,A01,892054,Mignozzetti; Umberto,30,0,30,0
1745797755464,CSS 202S,A01,892056,Mignozzetti; Umberto,30,0,30,0
1745797756491,DSC 197,001,956898,Eldridge; Justin Matthew,9998,0,9999,1
1745797757520,DSC 297,001,958000,Mazumdar; Arya,9998,0,9999,1
1745797758548,EAP 100,A00,905686,Staff,9776,0,9999,223
1745797759576,ECE 45,A01,892618,Staff,0,12,50,50
1745797760605,ECE 109,A01,892620,Staff,0,43,0,0
1745797761632,ECE 111,A01,892719,Staff,0,7,50,50
1745797762659,ECE 197,001,957920,Mercier; Patrick Philip,9992,0,9999,7
1745797763688,ECON 178,A01,907814,Zhu; Ying,28,0,35,7
1745797764717,EDS 115,A00,895312,Staff,41,0,45,4
1745797765746,EDS 117,A01,895337,Staff,30,0,30,0
1745797766775,EDS 125,A00,895341,Jones; Gabrielle Anastasia,43,0,45,2
1745797767828,EDS 128A,A01,895459,Fargason; Sharon Gayle,44,0,45,1
1745797768853,EDS 128B,A01,895543,Pappas; Elizabeth,44,0,45,1
1745797769878,EDS 139,A00,897203,Pappas; Elizabeth,44,0,45,1
1745797769878,EDS 139,B00,897209,Fargason; Sharon Gayle,44,0,45,1
1745797770903,EDS 201,A00,895545,Staff,43,0,45,2
1745797771931,EDS 203,A01,895581,Halter; Christopher P.,43,0,45,2
1745797772960,EDS 204R,A01,895625,Heinzman; Erica M.,43,0,45,2
1745797772960,EDS 204R,B01,895693,Halter; Christopher P.,18,0,45,27
1745797773985,EDS 206R,A00,895694,Fargason; Sharon Gayle,9,0,30,21
1745797773985,EDS 206R,B00,895695,Choi; Bailey Miyeon,20,0,30,10
1745797775013,EDS 250,A00,895697,Hemans; Patricia Ann Benitez,43,0,45,2
1745797776038,EDS 281,A00,895701,Meyerott; Theresa Ann,15,0,15,0
1745797777089,EDS 284,A00,895736,Meyerott; Theresa Ann,15,0,15,0
1745797778115,EDS 286,A00,897210,Fine; Sarah,15,0,15,0
1745797779140,EDS 289C,A01,895770,Daly; Alan J.,15,0,15,0
1745797780177,EDS 290,A00,897211,Hofstetter; Carolyn,15,0,15,0
1745797781204,LIGM 5A,A00,896162,Fischer-Grunski; Eva K,15,0,20,5
1745797782231,LIGM 5B,A00,896260,Fischer-Grunski; Eva K,17,0,20,3
1745797783257,LIGM 5C,A00,896308,Fischer-Grunski; Eva K,18,0,20,2
1745797784284,LIIT 5AS,A00,896313,Carnelos; Chiara,18,0,20,2
1745797785311,LIIT 5BS,A00,896416,Carnelos; Chiara,20,0,20,0
1745797786337,LIIT 5CS,A00,896564,Carnelos; Chiara,20,0,20,0
1745797787365,LISP 5A,A00,896588,Munoz Sanchez; Alicia,4,0,20,16
1745797788390,LISP 5B,A00,896653,Munoz Sanchez; Alicia,10,0,20,10
1745797789416,LISP 5C,A00,896655,Munoz Sanchez; Alicia,4,0,20,16
1745797790442,MAE 197,001,957918,Kleissl; Jan,9998,0,9999,1
1745797791469,MATH 2,A01,957937,Staff,34,0,35,1
1745797792495,MATH 197,001,957876,Kedlaya; Kiran S.,9993,0,9999,6
1745797793523,MCWP 40,A00,892729,Duru; Nur,13,0,20,7
1745797793523,MCWP 40,B00,893304,Montejo; Carolina,20,0,20,0
1745797794551,MCWP 40R,A00,893757,Redela; Pamela Morgan,0,6,20,20
1745797795576,MCWP 50,A00,893758,Morshed; Michael James,2,0,20,18
1745797795576,MCWP 50,B00,893761,Bartulis; Jason Michael,17,0,20,3
1745797796602,MCWP 50R,A00,893766,Compas; Sean Matthew,0,1,20,20
1745797796602,MCWP 50R,B00,893769,Carter; Jennifer A,0,0,20,20
1745797796602,MCWP 50R,C00,893771,Krone; Jarret,0,3,20,20
1745797796602,MCWP 50R,D00,893772,Miller; Elizabeth Deen,3,0,20,17
1745797796602,MCWP 50R,E00,893775,Carter; Andrea L,0,0,20,20
1745797797628,MMW 11R,A01,892721,Herbst; Matthew,11,0,27,16
1745797797628,MMW 11R,A02,892722,Herbst; Matthew,0,0,0,3
1745797798651,MMW 12R,A01,892724,Herbst; Matthew,0,9,16,16
1745797798651,MMW 12R,A02,892725,Herbst; Matthew,0,9,16,16
1745797799675,MMW 13R,A01,892727,Staff,0,4,16,16
1745797799675,MMW 13R,A02,892728,Staff,0,4,16,16
1745797799675,MMW 13R,A03,958032,Staff,0,3,16,16
1745797799675,MMW 13R,A04,958033,Staff,0,2,16,16
1745797799675,MMW 13R,A05,958034,Staff,0,3,16,16
1745797800705,SIO 295LS,A00,894015,Staff,7,0,25,18
1745797801733,SIO 295S,A00,894020,Staff,7,0,25,18
1745797802761,SIOC 290S,B01,958918,Staff,0,0,0,0
1745797803790,SIOC 291S,B01,958922,Staff,0,0,0,0
1745797804819,SOCI 117,A01,895339,Staff,4,0,5,1
1745797805848,WES 237B,A00,894149,Staff,11,0,20,9
1745797807910,AESE 279B,A00,891859,Staff,13,0,35,22
1745797808936,AIP 197,001,891854,Staff,70,0,70,0
1745797809961,ANTH 289S,A00,891856,Gagneux; Pascal,12,0,12,0
1745797810987,BENG 196,001,957946,Engler; Adam J.,9996,0,9999,3
1745797812014,CAT 124RS,A01,956906,Staff,8,0,25,17
1745797813040,CAT 125RS,A01,922013,Staff,8,0,25,17
1745797814066,CLRE 250,A00,891860,Morris; Sheldon,9995,0,9999,4
1745797816120,CLRE 251R,A00,907817,Mehta; Ravindra L.,9994,0,9999,5
1745797817147,CLRE 252,A00,891864,Cuomo; Raphael Eduardo,9993,0,9999,6
1745797818175,CLRE 253,A00,891867,Vaida; Florin,9994,0,9999,5
1745797818175,CLRE 253,B00,907819,Staff,9999,0,9999,0
1745797819200,CLRE 259,A00,891868,Patel; Hemal,9998,0,9999,1
1745797820226,CLRE 260,A00,891872,Cuomo; Raphael Eduardo,9999,0,9999,0
1745797821253,CLRE 297,001,891888,Cuomo; Raphael Eduardo,9999,0,9999,0
1745797822283,CSE 191,A00,958773,Minnes Kemp; Mor Mia,9999,0,9999,0
1745797823312,CSS 201S,A01,892054,Mignozzetti; Umberto,30,0,30,0
1745797824342,CSS 202S,A01,892056,Mignozzetti; Umberto,30,0,30,0
1745797825366,DSC 197,001,956898,Eldridge; Justin Matthew,9998,0,9999,1
1745797826390,DSC 297,001,958000,Mazumdar; Arya,9998,0,9999,1
1745797827415,EAP 100,A00,905686,Staff,9776,0,9999,223
1745797828440,ECE 45,A01,892618,Staff,0,12,50,50
1745797829465,ECE 109,A01,892620,Staff,0,43,0,0
1745797830491,ECE 111,A01,892719,Staff,0,7,50,50
1745797831517,ECE 197,001,957920,Mercier; Patrick Philip,9992,0,9999,7
1745797832546,ECON 178,A01,907814,Zhu; Ying,28,0,35,7
1745797833573,EDS 115,A00,895312,Staff,41,0,45,4
1745797834598,EDS 117,A01,895337,Staff,30,0,30,0
1745797835625,EDS 125,A00,895341,Jones; Gabrielle Anastasia,43,0,45,2
1745797836652,EDS 128A,A01,895459,Fargason; Sharon Gayle,44,0,45,1
1745797837678,EDS 128B,A01,895543,Pappas; Elizabeth,44,0,45,1
1745797838705,EDS 139,A00,897203,Pappas; Elizabeth,44,0,45,1
1745797838705,EDS 139,B00,897209,Fargason; Sharon Gayle,44,0,45,1
1745797839732,EDS 201,A00,895545,Staff,43,0,45,2
1745797840761,EDS 203,A01,895581,Halter; Christopher P.,43,0,45,2
1745797841787,EDS 204R,A01,895625,Heinzman; Erica M.,43,0,45,2
1745797841787,EDS 204R,B01,895693,Halter; Christopher P.,18,0,45,27
1745797842813,EDS 206R,A00,895694,Fargason; Sharon Gayle,9,0,30,21
1745797842813,EDS 206R,B00,895695,Choi; Bailey Miyeon,20,0,30,10
1745797843839,EDS 250,A00,895697,Hemans; Patricia Ann Benitez,43,0,45,2
1745797844865,EDS 281,A00,895701,Meyerott; Theresa Ann,15,0,15,0
1745797845892,EDS 284,A00,895736,Meyerott; Theresa Ann,15,0,15,0
1745797846917,EDS 286,A00,897210,Fine; Sarah,15,0,15,0
1745797847946,EDS 289C,A01,895770,Daly; Alan J.,15,0,15,0
1745797848971,EDS 290,A00,897211,Hofstetter; Carolyn,15,0,15,0
1745797850000,LIGM 5A,A00,896162,Fischer-Grunski; Eva K,15,0,20,5
1745797851024,LIGM 5B,A00,896260,Fischer-Grunski; Eva K,17,0,20,3
1745797852053,LIGM 5C,A00,896308,Fischer-Grunski; Eva K,18,0,20,2
1745797853081,LIIT 5AS,A00,896313,Carnelos; Chiara,18,0,20,2
1745797854109,LIIT 5BS,A00,896416,Carnelos; Chiara,20,0,20,0
1745797855137,LIIT 5CS,A00,896564,Carnelos; Chiara,20,0,20,0
1745797856163,LISP 5A,A00,896588,Munoz Sanchez; Alicia,4,0,20,16
1745797857188,LISP 5B,A00,896653,Munoz Sanchez; Alicia,10,0,20,10
1745797858217,LISP 5C,A00,896655,Munoz Sanchez; Alicia,4,0,20,16
1745797859247,MAE 197,001,957918,Kleissl; Jan,9998,0,9999,1
1745797860274,MATH 2,A01,957937,Staff,34,0,35,1
1745797861302,MATH 197,001,957876,Kedlaya; Kiran S.,9993,0,9999,6
1745797862330,MCWP 40,A00,892729,Duru; Nur,13,0,20,7
1745797862330,MCWP 40,B00,893304,Montejo; Carolina,20,0,20,0
1745797863355,MCWP 40R,A00,893757,Redela; Pamela Morgan,0,6,20,20
1745797864382,MCWP 50,A00,893758,Morshed; Michael James,2,0,20,18
1745797864382,MCWP 50,B00,893761,Bartulis; Jason Michael,17,0,20,3
1745797865407,MCWP 50R,A00,893766,Compas; Sean Matthew,0,1,20,20
1745797865407,MCWP 50R,B00,893769,Carter; Jennifer A,0,0,20,20
1745797865407,MCWP 50R,C00,893771,Krone; Jarret,0,3,20,20
1745797865407,MCWP 50R,D00,893772,Miller; Elizabeth Deen,3,0,20,17
1745797865407,MCWP 50R,E00,893775,Carter; Andrea L,0,0,20,20
1745797866433,MMW 11R,A01,892721,Herbst; Matthew,11,0,27,16
1745797866433,MMW 11R,A02,892722,Herbst; Matthew,0,0,0,3
1745797867460,MMW 12R,A01,892724,Herbst; Matthew,0,9,16,16
1745797867460,MMW 12R,A02,892725,Herbst; Matthew,0,9,16,16
1745797868488,MMW 13R,A01,892727,Staff,0,4,16,16
1745797868488,MMW 13R,A02,892728,Staff,0,4,16,16
1745797868488,MMW 13R,A03,958032,Staff,0,3,16,16
1745797868488,MMW 13R,A04,958033,Staff,0,2,16,16
1745797868488,MMW 13R,A05,958034,Staff,0,3,16,16
1745797869514,SIO 295LS,A00,894015,Staff,7,0,25,18
1745797870542,SIO 295S,A00,894020,Staff,7,0,25,18
1745797871572,SIOC 290S,B01,958918,Staff,0,0,0,0
1745797872604,SIOC 291S,B01,958922,Staff,0,0,0,0
1745797873629,SOCI 117,A01,895339,Staff,4,0,5,1
1745797874657,WES 237B,A00,894149,Staff,11,0,20,9
1745797876718,AESE 279B,A00,891859,Staff,13,0,35,22
1745797877743,AIP 197,001,891854,Staff,70,0,70,0
1745797878769,ANTH 289S,A00,891856,Gagneux; Pascal,12,0,12,0
1745797879794,BENG 196,001,957946,Engler; Adam J.,9996,0,9999,3
1745797880822,CAT 124RS,A01,956906,Staff,8,0,25,17
1745797881849,CAT 125RS,A01,922013,Staff,8,0,25,17
1745797882878,CLRE 250,A00,891860,Morris; Sheldon,9995,0,9999,4
1745797884933,CLRE 251R,A00,907817,Mehta; Ravindra L.,9994,0,9999,5
1745797885959,CLRE 252,A00,891864,Cuomo; Raphael Eduardo,9993,0,9999,6
1745797886990,CLRE 253,A00,891867,Vaida; Florin,9994,0,9999,5
1745797886990,CLRE 253,B00,907819,Staff,9999,0,9999,0
1745797888016,CLRE 259,A00,891868,Patel; Hemal,9998,0,9999,1
1745797889043,CLRE 260,A00,891872,Cuomo; Raphael Eduardo,9999,0,9999,0
1745797890072,CLRE 297,001,891888,Cuomo; Raphael Eduardo,9999,0,9999,0
1745797891097,CSE 191,A00,958773,Minnes Kemp; Mor Mia,9999,0,9999,0
1745797892127,CSS 201S,A01,892054,Mignozzetti; Umberto,30,0,30,0
1745797893155,CSS 202S,A01,892056,Mignozzetti; Umberto,30,0,30,0
1745797894181,DSC 197,001,956898,Eldridge; Justin Matthew,9998,0,9999,1
1745797895208,DSC 297,001,958000,Mazumdar; Arya,9998,0,9999,1
1745797896234,EAP 100,A00,905686,Staff,9776,0,9999,223
1745797897264,ECE 45,A01,892618,Staff,0,12,50,50
1745797898293,ECE 109,A01,892620,Staff,0,43,0,0
1745797899319,ECE 111,A01,892719,Staff,0,7,50,50
1745797900344,ECE 197,001,957920,Mercier; Patrick Philip,9992,0,9999,7
1745797901372,ECON 178,A01,907814,Zhu; Ying,28,0,35,7
1745797902400,EDS 115,A00,895312,Staff,41,0,45,4
1745797903429,EDS 117,A01,895337,Staff,30,0,30,0
1745797904454,EDS 125,A00,895341,Jones; Gabrielle Anastasia,43,0,45,2
1745797905481,EDS 128A,A01,895459,Fargason; Sharon Gayle,44,0,45,1
1745797906506,EDS 128B,A01,895543,Pappas; Elizabeth,44,0,45,1
1745797907534,EDS 139,A00,897203,Pappas; Elizabeth,44,0,45,1
1745797907534,EDS 139,B00,897209,Fargason; Sharon Gayle,44,0,45,1
1745797908561,EDS 201,A00,895545,Staff,43,0,45,2
1745797909586,EDS 203,A01,895581,Halter; Christopher P.,43,0,45,2
1745797910615,EDS 204R,A01,895625,Heinzman; Erica M.,43,0,45,2
1745797910615,EDS 204R,B01,895693,Halter; Christopher P.,18,0,45,27
1745797911644,EDS 206R,A00,895694,Fargason; Sharon Gayle,9,0,30,21
1745797911644,EDS 206R,B00,895695,Choi; Bailey Miyeon,20,0,30,10
1745797912669,EDS 250,A00,895697,Hemans; Patricia Ann Benitez,43,0,45,2
1745797913695,EDS 281,A00,895701,Meyerott; Theresa Ann,15,0,15,0
1745797914721,EDS 284,A00,895736,Meyerott; Theresa Ann,15,0,15,0
1745797915748,EDS 286,A00,897210,Fine; Sarah,15,0,15,0
1745797916775,EDS 289C,A01,895770,Daly; Alan J.,15,0,15,0
1745797917800,EDS 290,A00,897211,Hofstetter; Carolyn,15,0,15,0
1745797918825,LIGM 5A,A00,896162,Fischer-Grunski; Eva K,15,0,20,5
1745797919851,LIGM 5B,A00,896260,Fischer-Grunski; Eva K,17,0,20,3
1745797920877,LIGM 5C,A00,896308,Fischer-Grunski; Eva K,18,0,20,2
1745797921905,LIIT 5AS,A00,896313,Carnelos; Chiara,18,0,20,2
1745797922934,LIIT 5BS,A00,896416,Carnelos; Chiara,20,0,20,0
1745797923961,LIIT 5CS,A00,896564,Carnelos; Chiara,20,0,20,0
1745797924991,LISP 5A,A00,896588,Munoz Sanchez; Alicia,4,0,20,16
1745797926016,LISP 5B,A00,896653,Munoz Sanchez; Alicia,10,0,20,10
1745797927046,LISP 5C,A00,896655,Munoz Sanchez; Alicia,4,0,20,16
1745797928073,MAE 197,001,957918,Kleissl; Jan,9998,0,9999,1
1745797929101,MATH 2,A01,957937,Staff,34,0,35,1
1745797930127,MATH 197,001,957876,Kedlaya; Kiran S.,9993,0,9999,6
1745797931154,MCWP 40,A00,892729,Duru; Nur,13,0,20,7
1745797931154,MCWP 40,B00,893304,Montejo; Carolina,20,0,20,0
1745797932179,MCWP 40R,A00,893757,Redela; Pamela Morgan,0,6,20,20
1745797933207,MCWP 50,A00,893758,Morshed; Michael James,2,0,20,18
1745797933207,MCWP 50,B00,893761,Bartulis; Jason Michael,17,0,20,3
1745797934236,MCWP 50R,A00,893766,Compas; Sean Matthew,0,1,20,20
1745797934236,MCWP 50R,B00,893769,Carter; Jennifer A,0,0,20,20
1745797934236,MCWP 50R,C00,893771,Krone; Jarret,0,3,20,20
1745797934236,MCWP 50R,D00,893772,Miller; Elizabeth Deen,3,0,20,17
1745797934236,MCWP 50R,E00,893775,Carter; Andrea L,0,0,20,20
1745797935265,MMW 11R,A01,892721,Herbst; Matthew,11,0,27,16
1745797935265,MMW 11R,A02,892722,Herbst; Matthew,0,0,0,3
1745797936295,MMW 12R,A01,892724,Herbst; Matthew,0,9,16,16
1745797936295,MMW 12R,A02,892725,Herbst; Matthew,0,9,16,16
1745797937324,MMW 13R,A01,892727,Staff,0,4,16,16
1745797937324,MMW 13R,A02,892728,Staff,0,4,16,16
1745797937324,MMW 13R,A03,958032,Staff,0,3,16,16
1745797937324,MMW 13R,A04,958033,Staff,0,2,16,16
1745797937324,MMW 13R,A05,958034,Staff,0,3,16,16
1745797938351,SIO 295LS,A00,894015,Staff,7,0,25,18
1745797939377,SIO 295S,A00,894020,Staff,7,0,25,18
1745797940407,SIOC 290S,B01,958918,Staff,0,0,0,0
1745797941437,SIOC 291S,B01,958922,Staff,0,0,0,0
1745797942461,SOCI 117,A01,895339,Staff,4,0,5,1
1745797943488,WES 237B,A00,894149,Staff,11,0,20,9
1745797945553,AESE 279B,A00,891859,Staff,13,0,35,22
1745797946578,AIP 197,001,891854,Staff,70,0,70,0
1745797947609,ANTH 289S,A00,891856,Gagneux; Pascal,12,0,12,0
1745797948635,BENG 196,001,957946,Engler; Adam J.,9996,0,9999,3
1745797949659,CAT 124RS,A01,956906,Staff,8,0,25,17
1745797950686,CAT 125RS,A01,922013,Staff,8,0,25,17
1745797951710,CLRE 250,A00,891860,Morris; Sheldon,9995,0,9999,4
1745797953766,CLRE 251R,A00,907817,Mehta; Ravindra L.,9994,0,9999,5
1745797954794,CLRE 252,A00,891864,Cuomo; Raphael Eduardo,9993,0,9999,6
1745797955819,CLRE 253,A00,891867,Vaida; Florin,9994,0,9999,5
1745797955819,CLRE 253,B00,907819,Staff,9999,0,9999,0
1745797956846,CLRE 259,A00,891868,Patel; Hemal,9998,0,9999,1
1745797957875,CLRE 260,A00,891872,Cuomo; Raphael Eduardo,9999,0,9999,0
1745797958901,CLRE 297,001,891888,Cuomo; Raphael Eduardo,9999,0,9999,0
1745797959927,CSE 191,A00,958773,Minnes Kemp; Mor Mia,9999,0,9999,0
1745797960954,CSS 201S,A01,892054,Mignozzetti; Umberto,30,0,30,0
1745797961985,CSS 202S,A01,892056,Mignozzetti; Umberto,30,0,30,0
1745797963012,DSC 197,001,956898,Eldridge; Justin Matthew,9998,0,9999,1
1745797964041,DSC 297,001,958000,Mazumdar; Arya,9998,0,9999,1
1745797965065,EAP 100,A00,905686,Staff,9776,0,9999,223
1745797966091,ECE 45,A01,892618,Staff,0,12,50,50
1745797967120,ECE 109,A01,892620,Staff,0,43,0,0
1745797968148,ECE 111,A01,892719,Staff,0,7,50,50
1745797969173,ECE 197,001,957920,Mercier; Patrick Philip,9992,0,9999,7
1745797970198,ECON 178,A01,907814,Zhu; Ying,28,0,35,7
1745797971223,EDS 115,A00,895312,Staff,41,0,45,4
1745797972250,EDS 117,A01,895337,Staff,30,0,30,0
1745797973281,EDS 125,A00,895341,Jones; Gabrielle Anastasia,43,0,45,2
1745797974306,EDS 128A,A01,895459,Fargason; Sharon Gayle,44,0,45,1
1745797975333,EDS 128B,A01,895543,Pappas; Elizabeth,44,0,45,1
1745797976358,EDS 139,A00,897203,Pappas; Elizabeth,44,0,45,1
1745797976358,EDS 139,B00,897209,Fargason; Sharon Gayle,44,0,45,1
1745797977384,EDS 201,A00,895545,Staff,43,0,45,2
1745797978410,EDS 203,A01,895581,Halter; Christopher P.,43,0,45,2
1745797979437,EDS 204R,A01,895625,Heinzman; Erica M.,43,0,45,2
1745797979437,EDS 204R,B01,895693,Halter; Christopher P.,18,0,45,27
1745797980465,EDS 206R,A00,895694,Fargason; Sharon Gayle,9,0,30,21
1745797980465,EDS 206R,B00,895695,Choi; Bailey Miyeon,20,0,30,10
1745797981491,EDS 250,A00,895697,Hemans; Patricia Ann Benitez,43,0,45,2
1745797982517,EDS 281,A00,895701,Meyerott; Theresa Ann,15,0,15,0
1745797983542,EDS 284,A00,895736,Meyerott; Theresa Ann,15,0,15,0
1745797984569,EDS 286,A00,897210,Fine; Sarah,15,0,15,0
1745797985593,EDS 289C,A01,895770,Daly; Alan J.,15,0,15,0
1745797986619,EDS 290,A00,897211,Hofstetter; Carolyn,15,0,15,0
1745797987643,LIGM 5A,A00,896162,Fischer-Grunski; Eva K,15,0,20,5
1745797988668,LIGM 5B,A00,896260,Fischer-Grunski; Eva K,17,0,20,3
1745797989694,LIGM 5C,A00,896308,Fischer-Grunski; Eva K,18,0,20,2
1745797990723,LIIT 5AS,A00,896313,Carnelos; Chiara,18,0,20,2
1745797991749,LIIT 5BS,A00,896416,Carnelos; Chiara,20,0,20,0
1745797992775,LIIT 5CS,A00,896564,Carnelos; Chiara,20,0,20,0
1745797993800,LISP 5A,A00,896588,Munoz Sanchez; Alicia,4,0,20,16
1745797994826,LISP 5B,A00,896653,Munoz Sanchez; Alicia,10,0,20,10
1745797995850,LISP 5C,A00,896655,Munoz Sanchez; Alicia,4,0,20,16
1745797996875,MAE 197,001,957918,Kleissl; Jan,9998,0,9999,1
1745797997903,MATH 2,A01,957937,Staff,34,0,35,1
1745797998929,MATH 197,001,957876,Kedlaya; Kiran S.,9993,0,9999,6
1745797999952,MCWP 40,A00,892729,Duru; Nur,13,0,20,7
1745797999952,MCWP 40,B00,893304,Montejo; Carolina,20,0,20,0
1745798000978,MCWP 40R,A00,893757,Redela; Pamela Morgan,0,6,20,20
1745798002004,MCWP 50,A00,893758,Morshed; Michael James,2,0,20,18
1745798002004,MCWP 50,B00,893761,Bartulis; Jason Michael,17,0,20,3
1745798003035,MCWP 50R,A00,893766,Compas; Sean Matthew,0,1,20,20
1745798003035,MCWP 50R,B00,893769,Carter; Jennifer A,0,0,20,20
1745798003035,MCWP 50R,C00,893771,Krone; Jarret,0,3,20,20
1745798003035,MCWP 50R,D00,893772,Miller; Elizabeth Deen,3,0,20,17
1745798003035,MCWP 50R,E00,893775,Carter; Andrea L,0,0,20,20
1745798004063,MMW 11R,A01,892721,Herbst; Matthew,11,0,27,16
1745798004063,MMW 11R,A02,892722,Herbst; Matthew,0,0,0,3
1745798005088,MMW 12R,A01,892724,Herbst; Matthew,0,9,16,16
1745798005088,MMW 12R,A02,892725,Herbst; Matthew,0,9,16,16
1745798006115,MMW 13R,A01,892727,Staff,0,4,16,16
1745798006115,MMW 13R,A02,892728,Staff,0,4,16,16
1745798006115,MMW 13R,A03,958032,Staff,0,3,16,16
1745798006115,MMW 13R,A04,958033,Staff,0,2,16,16
1745798006115,MMW 13R,A05,958034,Staff,0,3,16,16
1745798007144,SIO 295LS,A00,894015,Staff,7,0,25,18
1745798008173,SIO 295S,A00,894020,Staff,7,0,25,18
1745798009200,SIOC 290S,B01,958918,Staff,0,0,0,0
1745798010226,SIOC 291S,B01,958922,Staff,0,0,0,0
1745798011251,SOCI 117,A01,895339,Staff,4,0,5,1
1745798012275,WES 237B,A00,894149,Staff,11,0,20,9
1745798014332,AESE 279B,A00,891859,Staff,13,0,35,22
1745798015358,AIP 197,001,891854,Staff,70,0,70,0
1745798016383,ANTH 289S,A00,891856,Gagneux; Pascal,12,0,12,0
1745798017412,BENG 196,001,957946,Engler; Adam J.,9996,0,9999,3
1745798018438,CAT 124RS,A01,956906,Staff,8,0,25,17
1745798019464,CAT 125RS,A01,922013,Staff,8,0,25,17
1745798020529,CLRE 250,A00,891860,Morris; Sheldon,9995,0,9999,4
1745798022583,CLRE 251R,A00,907817,Mehta; Ravindra L.,9994,0,9999,5
1745798023609,CLRE 252,A00,891864,Cuomo; Raphael Eduardo,9993,0,9999,6
1745798024634,CLRE 253,A00,891867,Vaida; Florin,9994,0,9999,5
1745798024634,CLRE 253,B00,907819,Staff,9999,0,9999,0
1745798025663,CLRE 259,A00,891868,Patel; Hemal,9998,0,9999,1
1745798026690,CLRE 260,A00,891872,Cuomo; Raphael Eduardo,9999,0,9999,0
1745798027717,CLRE 297,001,891888,Cuomo; Raphael Eduardo,9999,0,9999,0
1745798028743,CSE 191,A00,958773,Minnes Kemp; Mor Mia,9999,0,9999,0
1745798029773,CSS 201S,A01,892054,Mignozzetti; Umberto,30,0,30,0
1745798030804,CSS 202S,A01,892056,Mignozzetti; Umberto,30,0,30,0
1745798031836,DSC 197,001,956898,Eldridge; Justin Matthew,9998,0,9999,1
1745798032866,DSC 297,001,958000,Mazumdar; Arya,9998,0,9999,1
1745798033892,EAP 100,A00,905686,Staff,9776,0,9999,223
1745798034919,ECE 45,A01,892618,Staff,0,12,50,50
1745798035948,ECE 109,A01,892620,Staff,0,43,0,0
1745798036975,ECE 111,A01,892719,Staff,0,7,50,50
1745798038001,ECE 197,001,957920,Mercier; Patrick Philip,9992,0,9999,7
1745798039031,ECON 178,A01,907814,Zhu; Ying,28,0,35,7
1745798040059,EDS 115,A00,895312,Staff,41,0,45,4
1745798041084,EDS 117,A01,895337,Staff,30,0,30,0
1745798042110,EDS 125,A00,895341,Jones; Gabrielle Anastasia,43,0,45,2
1745798043135,EDS 128A,A01,895459,Fargason; Sharon Gayle,44,0,45,1
1745798044162,EDS 128B,A01,895543,Pappas; Elizabeth,44,0,45,1
1745798045188,EDS 139,A00,897203,Pappas; Elizabeth,44,0,45,1
1745798045188,EDS 139,B00,897209,Fargason; Sharon Gayle,44,0,45,1
1745798046215,EDS 201,A00,895545,Staff,43,0,45,2
1745798047241,EDS 203,A01,895581,Halter; Christopher P.,43,0,45,2
1745798048271,EDS 204R,A01,895625,Heinzman; Erica M.,43,0,45,2
1745798048271,EDS 204R,B01,895693,Halter; Christopher P.,18,0,45,27
1745798049297,EDS 206R,A00,895694,Fargason; Sharon Gayle,9,0,30,21
1745798049297,EDS 206R,B00,895695,Choi; Bailey Miyeon,20,0,30,10
1745798050322,EDS 250,A00,895697,Hemans; Patricia Ann Benitez,43,0,45,2
1745798051349,EDS 281,A00,895701,Meyerott; Theresa Ann,15,0,15,0
1745798052393,EDS 284,A00,895736,Meyerott; Theresa Ann,15,0,15,0
1745798053422,EDS 286,A00,897210,Fine; Sarah,15,0,15,0
1745798054447,EDS 289C,A01,895770,Daly; Alan J.,15,0,15,0
1745798055470,EDS 290,A00,897211,Hofstetter; Carolyn,15,0,15,0
1745798056497,LIGM 5A,A00,896162,Fischer-Grunski; Eva K,15,0,20,5
1745798057525,LIGM 5B,A00,896260,Fischer-Grunski; Eva K,17,0,20,3
1745798058552,LIGM 5C,A00,896308,Fischer-Grunski; Eva K,18,0,20,2
1745798059581,LIIT 5AS,A00,896313,Carnelos; Chiara,18,0,20,2
1745798060611,LIIT 5BS,A00,896416,Carnelos; Chiara,20,0,20,0
1745798061643,LIIT 5CS,A00,896564,Carnelos; Chiara,20,0,20,0
1745798062669,LISP 5A,A00,896588,Munoz Sanchez; Alicia,4,0,20,16
1745798063694,LISP 5B,A00,896653,Munoz Sanchez; Alicia,10,0,20,10
1745798064725,LISP 5C,A00,896655,Munoz Sanchez; Alicia,4,0,20,16
1745798065753,MAE 197,001,957918,Kleissl; Jan,9998,0,9999,1
1745798066781,MATH 2,A01,957937,Staff,34,0,35,1
1745798067806,MATH 197,001,957876,Kedlaya; Kiran S.,9993,0,9999,6
1745798068832,MCWP 40,A00,892729,Duru; Nur,13,0,20,7
1745798068832,MCWP 40,B00,893304,Montejo; Carolina,20,0,20,0
1745798069859,MCWP 40R,A00,893757,Redela; Pamela Morgan,0,6,20,20
1745798070888,MCWP 50,A00,893758,Morshed; Michael James,2,0,20,18
1745798070888,MCWP 50,B00,893761,Bartulis; Jason Michael,17,0,20,3
1745798071914,MCWP 50R,A00,893766,Compas; Sean Matthew,0,1,20,20
1745798071914,MCWP 50R,B00,893769,Carter; Jennifer A,0,0,20,20
1745798071914,MCWP 50R,C00,893771,Krone; Jarret,0,3,20,20
1745798071914,MCWP 50R,D00,893772,Miller; Elizabeth Deen,3,0,20,17
1745798071914,MCWP 50R,E00,893775,Carter; Andrea L,0,0,20,20
1745798072943,MMW 11R,A01,892721,Herbst; Matthew,11,0,27,16
1745798072943,MMW 11R,A02,892722,Herbst; Matthew,0,0,0,3
1745798073969,MMW 12R,A01,892724,Herbst; Matthew,0,9,16,16
1745798073969,MMW 12R,A02,892725,Herbst; Matthew,0,9,16,16
1745798074997,MMW 13R,A01,892727,Staff,0,4,16,16
1745798074997,MMW 13R,A02,892728,Staff,0,4,16,16
1745798074997,MMW 13R,A03,958032,Staff,0,3,16,16
1745798074997,MMW 13R,A04,958033,Staff,0,2,16,16
1745798074997,MMW 13R,A05,958034,Staff,0,3,16,16
1745798076023,SIO 295LS,A00,894015,Staff,7,0,25,18
1745798077049,SIO 295S,A00,894020,Staff,7,0,25,18
1745798078082,SIOC 290S,B01,958918,Staff,0,0,0,0
1745798079108,SIOC 291S,B01,958922,Staff,0,0,0,0
1745798080135,SOCI 117,A01,895339,Staff,4,0,5,1
1745798081162,WES 237B,A00,894149,Staff,11,0,20,9
1745798083220,AESE 279B,A00,891859,Staff,13,0,35,22
1745798084247,AIP 197,001,891854,Staff,70,0,70,0
1745798085273,ANTH 289S,A00,891856,Gagneux; Pascal,12,0,12,0
1745798086299,BENG 196,001,957946,Engler; Adam J.,9996,0,9999,3
1745798087326,CAT 124RS,A01,956906,Staff,8,0,25,17
1745798088352,CAT 125RS,A01,922013,Staff,8,0,25,17
1745798089378,CLRE 250,A00,891860,Morris; Sheldon,9995,0,9999,4
1745798091431,CLRE 251R,A00,907817,Mehta; Ravindra L.,9994,0,9999,5
1745798092459,CLRE 252,A00,891864,Cuomo; Raphael Eduardo,9993,0,9999,6
1745798093487,CLRE 253,A00,891867,Vaida; Florin,9994,0,9999,5
1745798093487,CLRE 253,B00,907819,Staff,9999,0,9999,0
1745798094513,CLRE 259,A00,891868,Patel; Hemal,9998,0,9999,1
1745798095538,CLRE 260,A00,891872,Cuomo; Raphael Eduardo,9999,0,9999,0
1745798096564,CLRE 297,001,891888,Cuomo; Raphael Eduardo,9999,0,9999,0
1745798097591,CSE 191,A00,958773,Minnes Kemp; Mor Mia,9999,0,9999,0
1745798098616,CSS 201S,A01,892054,Mignozzetti; Umberto,30,0,30,0
1745798099643,CSS 202S,A01,892056,Mignozzetti; Umberto,30,0,30,0
1745798100669,DSC 197,001,956898,Eldridge; Justin Matthew,9998,0,9999,1
1745798101695,DSC 297,001,958000,Mazumdar; Arya,9998,0,9999,1
1745798102724,EAP 100,A00,905686,Staff,9776,0,9999,223
1745798103751,ECE 45,A01,892618,Staff,0,12,50,50
1745798104783,ECE 109,A01,892620,Staff,0,43,0,0
1745798105809,ECE 111,A01,892719,Staff,0,7,50,50
1745798106838,ECE 197,001,957920,Mercier; Patrick Philip,9992,0,9999,7
1745798107867,ECON 178,A01,907814,Zhu; Ying,28,0,35,7
1745798108892,EDS 115,A00,895312,Staff,41,0,45,4
1745798109919,EDS 117,A01,895337,Staff,30,0,30,0
1745798110945,EDS 125,A00,895341,Jones; Gabrielle Anastasia,43,0,45,2
1745798111971,EDS 128A,A01,895459,Fargason; Sharon Gayle,44,0,45,1
1745798112997,EDS 128B,A01,895543,Pappas; Elizabeth,44,0,45,1
1745798114022,EDS 139,A00,897203,Pappas; Elizabeth,44,0,45,1
1745798114022,EDS 139,B00,897209,Fargason; Sharon Gayle,44,0,45,1
1745798115048,EDS 201,A00,895545,Staff,43,0,45,2
1745798116077,EDS 203,A01,895581,Halter; Christopher P.,43,0,45,2
1745798117103,EDS 204R,A01,895625,Heinzman; Erica M.,43,0,45,2
1745798117103,EDS 204R,B01,895693,Halter; Christopher P.,18,0,45,27
1745798118132,EDS 206R,A00,895694,Fargason; Sharon Gayle,9,0,30,21
1745798118132,EDS 206R,B00,895695,Choi; Bailey Miyeon,20,0,30,10
1745798119159,EDS 250,A00,895697,Hemans; Patricia Ann Benitez,43,0,45,2
1745798120187,EDS 281,A00,895701,Meyerott; Theresa Ann,15,0,15,0
1745798121215,EDS 284,A00,895736,Meyerott; Theresa Ann,15,0,15,0
1745798122242,EDS 286,A00,897210,Fine; Sarah,15,0,15,0
1745798123268,EDS 289C,A01,895770,Daly; Alan J.,15,0,15,0
1745798124336,EDS 290,A00,897211,Hofstetter; Carolyn,15,0,15,0
1745798125369,LIGM 5A,A00,896162,Fischer-Grunski; Eva K,15,0,20,5
1745798126396,LIGM 5B,A00,896260,Fischer-Grunski; Eva K,17,0,20,3
1745798127424,LIGM 5C,A00,896308,Fischer-Grunski; Eva K,18,0,20,2
1745798128451,LIIT 5AS,A00,896313,Carnelos; Chiara,18,0,20,2
1745798129478,LIIT 5BS,A00,896416,Carnelos; Chiara,20,0,20,0
1745798130505,LIIT 5CS,A00,896564,Carnelos; Chiara,20,0,20,0
1745798131529,LISP 5A,A00,896588,Munoz Sanchez; Alicia,4,0,20,16
1745798132555,LISP 5B,A00,896653,Munoz Sanchez; Alicia,10,0,20,10
1745798133580,LISP 5C,A00,896655,Munoz Sanchez; Alicia,4,0,20,16
1745798134606,MAE 197,001,957918,Kleissl; Jan,9998,0,9999,1
1745798135632,MATH 2,A01,957937,Staff,34,0,35,1
1745798136661,MATH 197,001,957876,Kedlaya; Kiran S.,9993,0,9999,6
1745798137686,MCWP 40,A00,892729,Duru; Nur,13,0,20,7
1745798137686,MCWP 40,B00,893304,Montejo; Carolina,20,0,20,0
1745798138713,MCWP 40R,A00,893757,Redela; Pamela Morgan,0,6,20,20
1745798139738,MCWP 50,A00,893758,Morshed; Michael James,2,0,20,18
1745798139738,MCWP 50,B00,893761,Bartulis; Jason Michael,17,0,20,3
1745798140763,MCWP 50R,A00,893766,Compas; Sean Matthew,0,1,20,20
1745798140763,MCWP 50R,B00,893769,Carter; Jennifer A,0,0,20,20
1745798140763,MCWP 50R,C00,893771,Krone; Jarret,0,3,20,20
1745798140763,MCWP 50R,D00,893772,Miller; Elizabeth Deen,3,0,20,17
1745798140763,MCWP 50R,E00,893775,Carter; Andrea L,0,0,20,20
1745798141792,MMW 11R,A01,892721,Herbst; Matthew,11,0,27,16
1745798141792,MMW 11R,A02,892722,Herbst; Matthew,0,0,0,3
1745798142816,MMW 12R,A01,892724,Herbst; Matthew,0,9,16,16
1745798142816,MMW 12R,A02,892725,Herbst; Matthew,0,9,16,16
1745798143845,MMW 13R,A01,892727,Staff,0,4,16,16
1745798143845,MMW 13R,A02,892728,Staff,0,4,16,16
1745798143845,MMW 13R,A03,958032,Staff,0,3,16,16
1745798143845,MMW 13R,A04,958033,Staff,0,2,16,16
1745798143845,MMW 13R,A05,958034,Staff,0,3,16,16
1745798144870,SIO 295LS,A00,894015,Staff,7,0,25,18
1745798145896,SIO 295S,A00,894020,Staff,7,0,25,18
1745798146921,SIOC 290S,B01,958918,Staff,0,0,0,0
1745798147948,SIOC 291S,B01,958922,Staff,0,0,0,0
1745798148976,SOCI 117,A01,895339,Staff,4,0,5,1
1745798150001,WES 237B,A00,894149,Staff,11,0,20,9
1745798152057,AESE 279B,A00,891859,Staff,13,0,35,22
1745798153084,AIP 197,001,891854,Staff,70,0,70,0
1745798154114,ANTH 289S,A00,891856,Gagneux; Pascal,12,0,12,0
1745798155139,BENG 196,001,957946,Engler; Adam J.,9996,0,9999,3
1745798156180,CAT 124RS,A01,956906,Staff,8,0,25,17
1745798157207,CAT 125RS,A01,922013,Staff,8,0,25,17
1745798158232,CLRE 250,A00,891860,Morris; Sheldon,9995,0,9999,4
1745798160288,CLRE 251R,A00,907817,Mehta; Ravindra L.,9994,0,9999,5
1745798161318,CLRE 252,A00,891864,Cuomo; Raphael Eduardo,9993,0,9999,6
1745798162352,CLRE 253,A00,891867,Vaida; Florin,9994,0,9999,5
1745798162352,CLRE 253,B00,907819,Staff,9999,0,9999,0
1745798163379,CLRE 259,A00,891868,Patel; Hemal,9998,0,9999,1
1745798164405,CLRE 260,A00,891872,Cuomo; Raphael Eduardo,9999,0,9999,0
1745798165432,CLRE 297,001,891888,Cuomo; Raphael Eduardo,9999,0,9999,0
1745798166459,CSE 191,A00,958773,Minnes Kemp; Mor Mia,9999,0,9999,0
1745798167492,CSS 201S,A01,892054,Mignozzetti; Umberto,30,0,30,0
1745798168520,CSS 202S,A01,892056,Mignozzetti; Umberto,30,0,30,0
1745798169546,DSC 197,001,956898,Eldridge; Justin Matthew,9998,0,9999,1
1745798170572,DSC 297,001,958000,Mazumdar; Arya,9998,0,9999,1
1745798171598,EAP 100,A00,905686,Staff,9776,0,9999,223
1745798172627,ECE 45,A01,892618,Staff,0,12,50,50
1745798173652,ECE 109,A01,892620,Staff,0,43,0,0
1745798174681,ECE 111,A01,892719,Staff,0,7,50,50
1745798175710,ECE 197,001,957920,Mercier; Patrick Philip,9992,0,9999,7
1745798176736,ECON 178,A01,907814,Zhu; Ying,28,0,35,7
1745798177760,EDS 115,A00,895312,Staff,41,0,45,4
1745798178786,EDS 117,A01,895337,Staff,30,0,30,0
1745798179812,EDS 125,A00,895341,Jones; Gabrielle Anastasia,43,0,45,2
1745798180839,EDS 128A,A01,895459,Fargason; Sharon Gayle,44,0,45,1
1745798181865,EDS 128B,A01,895543,Pappas; Elizabeth,44,0,45,1
1745798182890,EDS 139,A00,897203,Pappas; Elizabeth,44,0,45,1
1745798182890,EDS 139,B00,897209,Fargason; Sharon Gayle,44,0,45,1
1745798183917,EDS 201,A00,895545,Staff,43,0,45,2
1745798184943,EDS 203,A01,895581,Halter; Christopher P.,43,0,45,2
1745798185973,EDS 204R,A01,895625,Heinzman; Erica M.,43,0,45,2
1745798185973,EDS 204R,B01,895693,Halter; Christopher P.,18,0,45,27
1745798186999,EDS 206R,A00,895694,Fargason; Sharon Gayle,9,0,30,21
1745798186999,EDS 206R,B00,895695,Choi; Bailey Miyeon,20,0,30,10
1745798188027,EDS 250,A00,895697,Hemans; Patricia Ann Benitez,43,0,45,2
1745798189054,EDS 281,A00,895701,Meyerott; Theresa Ann,15,0,15,0
1745798190085,EDS 284,A00,895736,Meyerott; Theresa Ann,15,0,15,0
1745798191109,EDS 286,A00,897210,Fine; Sarah,15,0,15,0
1745798192164,EDS 289C,A01,895770,Daly; Alan J.,15,0,15,0
1745798193192,EDS 290,A00,897211,Hofstetter; Carolyn,15,0,15,0
1745798194220,LIGM 5A,A00,896162,Fischer-Grunski; Eva K,15,0,20,5
1745798195250,LIGM 5B,A00,896260,Fischer-Grunski; Eva K,17,0,20,3
1745798196277,LIGM 5C,A00,896308,Fischer-Grunski; Eva K,18,0,20,2
1745798197304,LIIT 5AS,A00,896313,Carnelos; Chiara,18,0,20,2
1745798198331,LIIT 5BS,A00,896416,Carnelos; Chiara,20,0,20,0
1745798199360,LIIT 5CS,A00,896564,Carnelos; Chiara,20,0,20,0
1745798200386,LISP 5A,A00,896588,Munoz Sanchez; Alicia,4,0,20,16
1745798201411,LISP 5B,A00,896653,Munoz Sanchez; Alicia,10,0,20,10
1745798202437,LISP 5C,A00,896655,Munoz Sanchez; Alicia,4,0,20,16
1745798203464,MAE 197,001,957918,Kleissl; Jan,9998,0,9999,1
1745798204490,MATH 2,A01,957937,Staff,34,0,35,1
1745798205517,MATH 197,001,957876,Kedlaya; Kiran S.,9993,0,9999,6
1745798206543,MCWP 40,A00,892729,Duru; Nur,13,0,20,7
1745798206543,MCWP 40,B00,893304,Montejo; Carolina,20,0,20,0
1745798207568,MCWP 40R,A00,893757,Redela; Pamela Morgan,0,6,20,20
1745798208593,MCWP 50,A00,893758,Morshed; Michael James,2,0,20,18
1745798208593,MCWP 50,B00,893761,Bartulis; Jason Michael,17,0,20,3
1745798209617,MCWP 50R,A00,893766,Compas; Sean Matthew,0,1,20,20
1745798209617,MCWP 50R,B00,893769,Carter; Jennifer A,0,0,20,20
1745798209617,MCWP 50R,C00,893771,Krone; Jarret,0,3,20,20
1745798209617,MCWP 50R,D00,893772,Miller; Elizabeth Deen,3,0,20,17
1745798209617,MCWP 50R,E00,893775,Carter; Andrea L,0,0,20,20
1745798210641,MMW 11R,A01,892721,Herbst; Matthew,11,0,27,16
1745798210641,MMW 11R,A02,892722,Herbst; Matthew,0,0,0,3
1745798211667,MMW 12R,A01,892724,Herbst; Matthew,0,9,16,16
1745798211667,MMW 12R,A02,892725,Herbst; Matthew,0,9,16,16
1745798212691,MMW 13R,A01,892727,Staff,0,4,16,16
1745798212691,MMW 13R,A02,892728,Staff,0,4,16,16
1745798212691,MMW 13R,A03,958032,Staff,0,3,16,16
1745798212691,MMW 13R,A04,958033,Staff,0,2,16,16
1745798212691,MMW 13R,A05,958034,Staff,0,3,16,16
1745798213717,SIO 295LS,A00,894015,Staff,7,0,25,18
1745798214741,SIO 295S,A00,894020,Staff,7,0,25,18
1745798215769,SIOC 290S,B01,958918,Staff,0,0,0,0
1745798216794,SIOC 291S,B01,958922,Staff,0,0,0,0
1745798217822,SOCI 117,A01,895339,Staff,4,0,5,1
1745798218845,WES 237B,A00,894149,Staff,11,0,20,9
1745798220903,AESE 279B,A00,891859,Staff,13,0,35,22
1745798221930,AIP 197,001,891854,Staff,70,0,70,0
1745798222956,ANTH 289S,A00,891856,Gagneux; Pascal,12,0,12,0
1745798223983,BENG 196,001,957946,Engler; Adam J.,9996,0,9999,3
1745798225008,CAT 124RS,A01,956906,Staff,8,0,25,17
1745798226034,CAT 125RS,A01,922013,Staff,8,0,25,17
1745798227058,CLRE 250,A00,891860,Morris; Sheldon,9995,0,9999,4
1745798229112,CLRE 251R,A00,907817,Mehta; Ravindra L.,9994,0,9999,5
1745798230139,CLRE 252,A00,891864,Cuomo; Raphael Eduardo,9993,0,9999,6
1745798231166,CLRE 253,A00,891867,Vaida; Florin,9994,0,9999,5
1745798231166,CLRE 253,B00,907819,Staff,9999,0,9999,0
1745798232191,CLRE 259,A00,891868,Patel; Hemal,9998,0,9999,1
1745798233217,CLRE 260,A00,891872,Cuomo; Raphael Eduardo,9999,0,9999,0
1745798234244,CLRE 297,001,891888,Cuomo; Raphael Eduardo,9999,0,9999,0
1745798235269,CSE 191,A00,958773,Minnes Kemp; Mor Mia,9999,0,9999,0
1745798236320,CSS 201S,A01,892054,Mignozzetti; Umberto,30,0,30,0
1745798237349,CSS 202S,A01,892056,Mignozzetti; Umberto,30,0,30,0
1745798238376,DSC 197,001,956898,Eldridge; Justin Matthew,9998,0,9999,1
1745798239399,DSC 297,001,958000,Mazumdar; Arya,9998,0,9999,1
1745798240424,EAP 100,A00,905686,Staff,9776,0,9999,223
1745798241449,ECE 45,A01,892618,Staff,0,12,50,50
1745798242474,ECE 109,A01,892620,Staff,0,43,0,0
1745798243500,ECE 111,A01,892719,Staff,0,7,50,50
1745798244525,ECE 197,001,957920,Mercier; Patrick Philip,9992,0,9999,7
1745798245547,ECON 178,A01,907814,Zhu; Ying,28,0,35,7
1745798246575,EDS 115,A00,895312,Staff,41,0,45,4
1745798247615,EDS 117,A01,895337,Staff,30,0,30,0
1745798248640,EDS 125,A00,895341,Jones; Gabrielle Anastasia,43,0,45,2
1745798249669,EDS 128A,A01,895459,Fargason; Sharon Gayle,44,0,45,1
1745798250696,EDS 128B,A01,895543,Pappas; Elizabeth,44,0,45,1
1745798251721,EDS 139,A00,897203,Pappas; Elizabeth,44,0,45,1
1745798251721,EDS 139,B00,897209,Fargason; Sharon Gayle,44,0,45,1
1745798252744,EDS 201,A00,895545,Staff,43,0,45,2
1745798253771,EDS 203,A01,895581,Halter; Christopher P.,43,0,45,2
1745798254795,EDS 204R,A01,895625,Heinzman; Erica M.,43,0,45,2
1745798254795,EDS 204R,B01,895693,Halter; Christopher P.,18,0,45,27
1745798255820,EDS 206R,A00,895694,Fargason; Sharon Gayle,9,0,30,21
1745798255820,EDS 206R,B00,895695,Choi; Bailey Miyeon,20,0,30,10
1745798256845,EDS 250,A00,895697,Hemans; Patricia Ann Benitez,43,0,45,2
1745798257874,EDS 281,A00,895701,Meyerott; Theresa Ann,15,0,15,0
1745798258901,EDS 284,A00,895736,Meyerott; Theresa Ann,15,0,15,0
1745798259929,EDS 286,A00,897210,Fine; Sarah,15,0,15,0
1745798260955,EDS 289C,A01,895770,Daly; Alan J.,15,0,15,0
1745798261981,EDS 290,A00,897211,Hofstetter; Carolyn,15,0,15,0
1745798263007,LIGM 5A,A00,896162,Fischer-Grunski; Eva K,15,0,20,5
1745798264035,LIGM 5B,A00,896260,Fischer-Grunski; Eva K,17,0,20,3
1745798265061,LIGM 5C,A00,896308,Fischer-Grunski; Eva K,18,0,20,2
1745798266089,LIIT 5AS,A00,896313,Carnelos; Chiara,18,0,20,2
1745798267115,LIIT 5BS,A00,896416,Carnelos; Chiara,20,0,20,0
1745798268142,LIIT 5CS,A00,896564,Carnelos; Chiara,20,0,20,0
1745798269166,LISP 5A,A00,896588,Munoz Sanchez; Alicia,4,0,20,16
1745798270192,LISP 5B,A00,896653,Munoz Sanchez; Alicia,10,0,20,10
1745798271220,LISP 5C,A00,896655,Munoz Sanchez; Alicia,4,0,20,16
1745798272247,MAE 197,001,957918,Kleissl; Jan,9998,0,9999,1
1745798273275,MATH 2,A01,957937,Staff,34,0,35,1
1745798274307,MATH 197,001,957876,Kedlaya; Kiran S.,9993,0,9999,6
1745798275335,MCWP 40,A00,892729,Duru; Nur,13,0,20,7
1745798275335,MCWP 40,B00,893304,Montejo; Carolina,20,0,20,0
1745798276360,MCWP 40R,A00,893757,Redela; Pamela Morgan,0,6,20,20
1745798277388,MCWP 50,A00,893758,Morshed; Michael James,2,0,20,18
1745798277388,MCWP 50,B00,893761,Bartulis; Jason Michael,17,0,20,3
1745798278440,MCWP 50R,A00,893766,Compas; Sean Matthew,0,1,20,20
1745798278440,MCWP 50R,B00,893769,Carter; Jennifer A,0,0,20,20
1745798278440,MCWP 50R,C00,893771,Krone; Jarret,0,3,20,20
1745798278440,MCWP 50R,D00,893772,Miller; Elizabeth Deen,3,0,20,17
1745798278440,MCWP 50R,E00,893775,Carter; Andrea L,0,0,20,20
1745798279467,MMW 11R,A01,892721,Herbst; Matthew,11,0,27,16
1745798279467,MMW 11R,A02,892722,Herbst; Matthew,0,0,0,3
1745798280497,MMW 12R,A01,892724,Herbst; Matthew,0,9,16,16
1745798280497,MMW 12R,A02,892725,Herbst; Matthew,0,9,16,16
1745798281523,MMW 13R,A01,892727,Staff,0,4,16,16
1745798281523,MMW 13R,A02,892728,Staff,0,4,16,16
1745798281523,MMW 13R,A03,958032,Staff,0,3,16,16
1745798281523,MMW 13R,A04,958033,Staff,0,2,16,16
1745798281523,MMW 13R,A05,958034,Staff,0,3,16,16
1745798282548,SIO 295LS,A00,894015,Staff,7,0,25,18
1745798283573,SIO 295S,A00,894020,Staff,7,0,25,18
1745798284602,SIOC 290S,B01,958918,Staff,0,0,0,0
1745798285628,SIOC 291S,B01,958922,Staff,0,0,0,0
1745798286652,SOCI 117,A01,895339,Staff,4,0,5,1
1745798287677,WES 237B,A00,894149,Staff,11,0,20,9
1745798289733,AESE 279B,A00,891859,Staff,13,0,35,22
1745798290756,AIP 197,001,891854,Staff,70,0,70,0
1745798291784,ANTH 289S,A00,891856,Gagneux; Pascal,12,0,12,0
1745798292809,BENG 196,001,957946,Engler; Adam J.,9996,0,9999,3
1745798293835,CAT 124RS,A01,956906,Staff,8,0,25,17
1745798294860,CAT 125RS,A01,922013,Staff,8,0,25,17
1745798295885,CLRE 250,A00,891860,Morris; Sheldon,9995,0,9999,4
1745798297939,CLRE 251R,A00,907817,Mehta; Ravindra L.,9994,0,9999,5
1745798298966,CLRE 252,A00,891864,Cuomo; Raphael Eduardo,9993,0,9999,6
1745798299994,CLRE 253,A00,891867,Vaida; Florin,9994,0,9999,5
1745798299994,CLRE 253,B00,907819,Staff,9999,0,9999,0
1745798301020,CLRE 259,A00,891868,Patel; Hemal,9998,0,9999,1
1745798302044,CLRE 260,A00,891872,Cuomo; Raphael Eduardo,9999,0,9999,0
1745798303071,CLRE 297,001,891888,Cuomo; Raphael Eduardo,9999,0,9999,0
1745798304097,CSE 191,A00,958773,Minnes Kemp; Mor Mia,9999,0,9999,0
1745798305126,CSS 201S,A01,892054,Mignozzetti; Umberto,30,0,30,0
1745798306150,CSS 202S,A01,892056,Mignozzetti; Umberto,30,0,30,0
1745798307175,DSC 197,001,956898,Eldridge; Justin Matthew,9998,0,9999,1
1745798308214,DSC 297,001,958000,Mazumdar; Arya,9998,0,9999,1
1745798309241,EAP 100,A00,905686,Staff,9776,0,9999,223
1745798310265,ECE 45,A01,892618,Staff,0,12,50,50
1745798311292,ECE 109,A01,892620,Staff,0,43,0,0
1745798312319,ECE 111,A01,892719,Staff,0,7,50,50
1745798313345,ECE 197,001,957920,Mercier; Patrick Philip,9992,0,9999,7
1745798314369,ECON 178,A01,907814,Zhu; Ying,28,0,35,7
1745798315423,EDS 115,A00,895312,Staff,41,0,45,4
1745798316450,EDS 117,A01,895337,Staff,30,0,30,0
1745798317475,EDS 125,A00,895341,Jones; Gabrielle Anastasia,43,0,45,2
1745798318501,EDS 128A,A01,895459,Fargason; Sharon Gayle,44,0,45,1
1745798319551,EDS 128B,A01,895543,Pappas; Elizabeth,44,0,45,1
1745798320578,EDS 139,A00,897203,Pappas; Elizabeth,44,0,45,1
1745798320578,EDS 139,B00,897209,Fargason; Sharon Gayle,44,0,45,1
1745798321604,EDS 201,A00,895545,Staff,43,0,45,2
1745798322631,EDS 203,A01,895581,Halter; Christopher P.,43,0,45,2
1745798323655,EDS 204R,A01,895625,Heinzman; Erica M.,43,0,45,2
1745798323655,EDS 204R,B01,895693,Halter; Christopher P.,18,0,45,27
1745798324680,EDS 206R,A00,895694,Fargason; Sharon Gayle,9,0,30,21
1745798324680,EDS 206R,B00,895695,Choi; Bailey Miyeon,20,0,30,10
1745798325704,EDS 250,A00,895697,Hemans; Patricia Ann Benitez,43,0,45,2
1745798326728,EDS 281,A00,895701,Meyerott; Theresa Ann,15,0,15,0
1745798327755,EDS 284,A00,895736,Meyerott; Theresa Ann,15,0,15,0
1745798328778,EDS 286,A00,897210,Fine; Sarah,15,0,15,0
1745798329801,EDS 289C,A01,895770,Daly; Alan J.,15,0,15,0
1745798330825,EDS 290,A00,897211,Hofstetter; Carolyn,15,0,15,0
1745798331853,LIGM 5A,A00,896162,Fischer-Grunski; Eva K,15,0,20,5
1745798332880,LIGM 5B,A00,896260,Fischer-Grunski; Eva K,17,0,20,3
1745798333909,LIGM 5C,A00,896308,Fischer-Grunski; Eva K,18,0,20,2
1745798334936,LIIT 5AS,A00,896313,Carnelos; Chiara,18,0,20,2
1745798335966,LIIT 5BS,A00,896416,Carnelos; Chiara,20,0,20,0
1745798336994,LIIT 5CS,A00,896564,Carnelos; Chiara,20,0,20,0
1745798338020,LISP 5A,A00,896588,Munoz Sanchez; Alicia,4,0,20,16
1745798339047,LISP 5B,A00,896653,Munoz Sanchez; Alicia,10,0,20,10
1745798340077,LISP 5C,A00,896655,Munoz Sanchez; Alicia,4,0,20,16
1745798341104,MAE 197,001,957918,Kleissl; Jan,9998,0,9999,1
1745798342133,MATH 2,A01,957937,Staff,34,0,35,1
1745798343162,MATH 197,001,957876,Kedlaya; Kiran S.,9993,0,9999,6
1745798344191,MCWP 40,A00,892729,Duru; Nur,13,0,20,7
1745798344191,MCWP 40,B00,893304,Montejo; Carolina,20,0,20,0
1745798345243,MCWP 40R,A00,893757,Redela; Pamela Morgan,0,6,20,20
1745798346270,MCWP 50,A00,893758,Morshed; Michael James,2,0,20,18
1745798346270,MCWP 50,B00,893761,Bartulis; Jason Michael,17,0,20,3
1745798347297,MCWP 50R,A00,893766,Compas; Sean Matthew,0,1,20,20
1745798347297,MCWP 50R,B00,893769,Carter; Jennifer A,0,0,20,20
1745798347297,MCWP 50R,C00,893771,Krone; Jarret,0,3,20,20
1745798347297,MCWP 50R,D00,893772,Miller; Elizabeth Deen,3,0,20,17
1745798347297,MCWP 50R,E00,893775,Carter; Andrea L,0,0,20,20
1745798348325,MMW 11R,A01,892721,Herbst; Matthew,11,0,27,16
1745798348325,MMW 11R,A02,892722,Herbst; Matthew,0,0,0,3
1745798349351,MMW 12R,A01,892724,Herbst; Matthew,0,9,16,16
1745798349351,MMW 12R,A02,892725,Herbst; Matthew,0,9,16,16
1745798350378,MMW 13R,A01,892727,Staff,0,4,16,16
1745798350378,MMW 13R,A02,892728,Staff,0,4,16,16
1745798350378,MMW 13R,A03,958032,Staff,0,3,16,16
1745798350378,MMW 13R,A04,958033,Staff,0,2,16,16
1745798350378,MMW 13R,A05,958034,Staff,0,3,16,16
1745798351403,SIO 295LS,A00,894015,Staff,7,0,25,18
1745798352430,SIO 295S,A00,894020,Staff,7,0,25,18
1745798353454,SIOC 290S,B01,958918,Staff,0,0,0,0
1745798354480,SIOC 291S,B01,958922,Staff,0,0,0,0
1745798355506,SOCI 117,A01,895339,Staff,4,0,5,1
1745798356529,WES 237B,A00,894149,Staff,11,0,20,9
1745798358597,AESE 279B,A00,891859,Staff,13,0,35,22
1745798359622,AIP 197,001,891854,Staff,70,0,70,0
1745798360651,ANTH 289S,A00,891856,Gagneux; Pascal,12,0,12,0
1745798361677,BENG 196,001,957946,Engler; Adam J.,9996,0,9999,3
1745798362701,CAT 124RS,A01,956906,Staff,8,0,25,17
1745798363726,CAT 125RS,A01,922013,Staff,8,0,25,17
1745798364752,CLRE 250,A00,891860,Morris; Sheldon,9995,0,9999,4
1745798366804,CLRE 251R,A00,907817,Mehta; Ravindra L.,9994,0,9999,5
1745798367832,CLRE 252,A00,891864,Cuomo; Raphael Eduardo,9993,0,9999,6
1745798368856,CLRE 253,A00,891867,Vaida; Florin,9994,0,9999,5
1745798368856,CLRE 253,B00,907819,Staff,9999,0,9999,0
1745798369883,CLRE 259,A00,891868,Patel; Hemal,9998,0,9999,1
1745798370912,CLRE 260,A00,891872,Cuomo; Raphael Eduardo,9999,0,9999,0
1745798371938,CLRE 297,001,891888,Cuomo; Raphael Eduardo,9999,0,9999,0
1745798372965,CSE 191,A00,958773,Minnes Kemp; Mor Mia,9999,0,9999,0
1745798373994,CSS 201S,A01,892054,Mignozzetti; Umberto,30,0,30,0
1745798375018,CSS 202S,A01,892056,Mignozzetti; Umberto,30,0,30,0
1745798376045,DSC 197,001,956898,Eldridge; Justin Matthew,9998,0,9999,1
1745798377069,DSC 297,001,958000,Mazumdar; Arya,9998,0,9999,1
1745798378095,EAP 100,A00,905686,Staff,9776,0,9999,223
1745798379121,ECE 45,A01,892618,Staff,0,12,50,50
1745798380148,ECE 109,A01,892620,Staff,0,43,0,0
1745798381174,ECE 111,A01,892719,Staff,0,7,50,50
1745798382201,ECE 197,001,957920,Mercier; Patrick Philip,9992,0,9999,7
1745798383226,ECON 178,A01,907814,Zhu; Ying,28,0,35,7
1745798384250,EDS 115,A00,895312,Staff,41,0,45,4
1745798385275,EDS 117,A01,895337,Staff,30,0,30,0
1745798386298,EDS 125,A00,895341,Jones; Gabrielle Anastasia,43,0,45,2
1745798387322,EDS 128A,A01,895459,Fargason; Sharon Gayle,44,0,45,1
1745798388351,EDS 128B,A01,895543,Pappas; Elizabeth,44,0,45,1
1745798389377,EDS 139,A00,897203,Pappas; Elizabeth,44,0,45,1
1745798389377,EDS 139,B00,897209,Fargason; Sharon Gayle,44,0,45,1
1745798390405,EDS 201,A00,895545,Staff,43,0,45,2
1745798391433,EDS 203,A01,895581,Halter; Christopher P.,43,0,45,2
1745798392456,EDS 204R,A01,895625,Heinzman; Erica M.,43,0,45,2
1745798392456,EDS 204R,B01,895693,Halter; Christopher P.,18,0,45,27
1745798393484,EDS 206R,A00,895694,Fargason; Sharon Gayle,9,0,30,21
1745798393484,EDS 206R,B00,895695,Choi; Bailey Miyeon,20,0,30,10
1745798394540,EDS 250,A00,895697,Hemans; Patricia Ann Benitez,43,0,45,2
1745798395565,EDS 281,A00,895701,Meyerott; Theresa Ann,15,0,15,0
1745798396590,EDS 284,A00,895736,Meyerott; Theresa Ann,15,0,15,0
1745798397615,EDS 286,A00,897210,Fine; Sarah,15,0,15,0
1745798398638,EDS 289C,A01,895770,Daly; Alan J.,15,0,15,0
1745798399664,EDS 290,A00,897211,Hofstetter; Carolyn,15,0,15,0
1745798400693,LIGM 5A,A00,896162,Fischer-Grunski; Eva K,15,0,20,5
1745798401718,LIGM 5B,A00,896260,Fischer-Grunski; Eva K,17,0,20,3
1745798402747,LIGM 5C,A00,896308,Fischer-Grunski; Eva K,18,0,20,2
1745798403780,LIIT 5AS,A00,896313,Carnelos; Chiara,18,0,20,2
1745798404810,LIIT 5BS,A00,896416,Carnelos; Chiara,20,0,20,0
1745798405837,LIIT 5CS,A00,896564,Carnelos; Chiara,20,0,20,0
1745798406860,LISP 5A,A00,896588,Munoz Sanchez; Alicia,4,0,20,16
1745798407890,LISP 5B,A00,896653,Munoz Sanchez; Alicia,10,0,20,10
1745798408920,LISP 5C,A00,896655,Munoz Sanchez; Alicia,4,0,20,16
1745798409945,MAE 197,001,957918,Kleissl; Jan,9998,0,9999,1
1745798410973,MATH 2,A01,957937,Staff,34,0,35,1
1745798411998,MATH 197,001,957876,Kedlaya; Kiran S.,9993,0,9999,6
1745798413032,MCWP 40,A00,892729,Duru; Nur,13,0,20,7
1745798413032,MCWP 40,B00,893304,Montejo; Carolina,20,0,20,0
1745798414060,MCWP 40R,A00,893757,Redela; Pamela Morgan,0,6,20,20
1745798415091,MCWP 50,A00,893758,Morshed; Michael James,2,0,20,18
1745798415091,MCWP 50,B00,893761,Bartulis; Jason Michael,17,0,20,3
1745798416121,MCWP 50R,A00,893766,Compas; Sean Matthew,0,1,20,20
1745798416121,MCWP 50R,B00,893769,Carter; Jennifer A,0,0,20,20
1745798416121,MCWP 50R,C00,893771,Krone; Jarret,0,3,20,20
1745798416121,MCWP 50R,D00,893772,Miller; Elizabeth Deen,3,0,20,17
1745798416121,MCWP 50R,E00,893775,Carter; Andrea L,0,0,20,20
1745798417146,MMW 11R,A01,892721,Herbst; Matthew,11,0,27,16
1745798417146,MMW 11R,A02,892722,Herbst; Matthew,0,0,0,3
1745798418172,MMW 12R,A01,892724,Herbst; Matthew,0,9,16,16
1745798418172,MMW 12R,A02,892725,Herbst; Matthew,0,9,16,16
1745798419197,MMW 13R,A01,892727,Staff,0,4,16,16
1745798419197,MMW 13R,A02,892728,Staff,0,4,16,16
1745798419197,MMW 13R,A03,958032,Staff,0,3,16,16
1745798419197,MMW 13R,A04,958033,Staff,0,2,16,16
1745798419197,MMW 13R,A05,958034,Staff,0,3,16,16
1745798420233,SIO 295LS,A00,894015,Staff,7,0,25,18
1745798421260,SIO 295S,A00,894020,Staff,7,0,25,18
1745798422286,SIOC 290S,B01,958918,Staff,0,0,0,0
1745798423313,SIOC 291S,B01,958922,Staff,0,0,0,0
1745798424340,SOCI 117,A01,895339,Staff,4,0,5,1
1745798425365,WES 237B,A00,894149,Staff,11,0,20,9
1745798427429,AESE 279B,A00,891859,Staff,13,0,35,22
1745798428455,AIP 197,001,891854,Staff,70,0,70,0
1745798429484,ANTH 289S,A00,891856,Gagneux; Pascal,12,0,12,0
1745798430509,BENG 196,001,957946,Engler; Adam J.,9996,0,9999,3
1745798431535,CAT 124RS,A01,956906,Staff,8,0,25,17
1745798432563,CAT 125RS,A01,922013,Staff,8,0,25,17
1745798433588,CLRE 250,A00,891860,Morris; Sheldon,9995,0,9999,4
1745798435644,CLRE 251R,A00,907817,Mehta; Ravindra L.,9994,0,9999,5
1745798436670,CLRE 252,A00,891864,Cuomo; Raphael Eduardo,9993,0,9999,6
1745798437697,CLRE 253,A00,891867,Vaida; Florin,9994,0,9999,5
1745798437697,CLRE 253,B00,907819,Staff,9999,0,9999,0
1745798438721,CLRE 259,A00,891868,Patel; Hemal,9998,0,9999,1
1745798439749,CLRE 260,A00,891872,Cuomo; Raphael Eduardo,9999,0,9999,0
1745798440776,CLRE 297,001,891888,Cuomo; Raphael Eduardo,9999,0,9999,0
1745798441801,CSE 191,A00,958773,Minnes Kemp; Mor Mia,9999,0,9999,0
1745798442828,CSS 201S,A01,892054,Mignozzetti; Umberto,30,0,30,0
1745798443854,CSS 202S,A01,892056,Mignozzetti; Umberto,30,0,30,0
1745798444882,DSC 197,001,956898,Eldridge; Justin Matthew,9998,0,9999,1
1745798445907,DSC 297,001,958000,Mazumdar; Arya,9998,0,9999,1
1745798446932,EAP 100,A00,905686,Staff,9776,0,9999,223
1745798447958,ECE 45,A01,892618,Staff,0,12,50,50
1745798448989,ECE 109,A01,892620,Staff,0,43,0,0
1745798450018,ECE 111,A01,892719,Staff,0,7,50,50
1745798451046,ECE 197,001,957920,Mercier; Patrick Philip,9992,0,9999,7
1745798452073,ECON 178,A01,907814,Zhu; Ying,28,0,35,7
1745798453102,EDS 115,A00,895312,Staff,41,0,45,4
1745798454128,EDS 117,A01,895337,Staff,30,0,30,0
1745798455152,EDS 125,A00,895341,Jones; Gabrielle Anastasia,43,0,45,2
1745798456180,EDS 128A,A01,895459,Fargason; Sharon Gayle,44,0,45,1
1745798457209,EDS 128B,A01,895543,Pappas; Elizabeth,44,0,45,1
1745798458234,EDS 139,A00,897203,Pappas; Elizabeth,44,0,45,1
1745798458234,EDS 139,B00,897209,Fargason; Sharon Gayle,44,0,45,1
1745798459260,EDS 201,A00,895545,Staff,43,0,45,2
1745798460289,EDS 203,A01,895581,Halter; Christopher P.,43,0,45,2
1745798461317,EDS 204R,A01,895625,Heinzman; Erica M.,43,0,45,2
1745798461317,EDS 204R,B01,895693,Halter; Christopher P.,18,0,45,27
1745798462349,EDS 206R,A00,895694,Fargason; Sharon Gayle,9,0,30,21
1745798462349,EDS 206R,B00,895695,Choi; Bailey Miyeon,20,0,30,10
1745798463377,EDS 250,A00,895697,Hemans; Patricia Ann Benitez,43,0,45,2
1745798464402,EDS 281,A00,895701,Meyerott; Theresa Ann,15,0,15,0
1745798465427,EDS 284,A00,895736,Meyerott; Theresa Ann,15,0,15,0
1745798466452,EDS 286,A00,897210,Fine; Sarah,15,0,15,0
1745798467488,EDS 289C,A01,895770,Daly; Alan J.,15,0,15,0
1745798468513,EDS 290,A00,897211,Hofstetter; Carolyn,15,0,15,0
1745798469539,LIGM 5A,A00,896162,Fischer-Grunski; Eva K,15,0,20,5
1745798470566,LIGM 5B,A00,896260,Fischer-Grunski; Eva K,17,0,20,3
1745798471593,LIGM 5C,A00,896308,Fischer-Grunski; Eva K,18,0,20,2
1745798472622,LIIT 5AS,A00,896313,Carnelos; Chiara,18,0,20,2
1745798473648,LIIT 5BS,A00,896416,Carnelos; Chiara,20,0,20,0
1745798474674,LIIT 5CS,A00,896564,Carnelos; Chiara,20,0,20,0
1745798475703,LISP 5A,A00,896588,Munoz Sanchez; Alicia,4,0,20,16
1745798476728,LISP 5B,A00,896653,Munoz Sanchez; Alicia,10,0,20,10
1745798477757,LISP 5C,A00,896655,Munoz Sanchez; Alicia,4,0,20,16
1745798478785,MAE 197,001,957918,Kleissl; Jan,9998,0,9999,1
1745798479813,MATH 2,A01,957937,Staff,34,0,35,1
1745798480841,MATH 197,001,957876,Kedlaya; Kiran S.,9993,0,9999,6
1745798481867,MCWP 40,A00,892729,Duru; Nur,13,0,20,7
1745798481867,MCWP 40,B00,893304,Montejo; Carolina,20,0,20,0
1745798482893,MCWP 40R,A00,893757,Redela; Pamela Morgan,0,6,20,20
1745798483923,MCWP 50,A00,893758,Morshed; Michael James,2,0,20,18
1745798483923,MCWP 50,B00,893761,Bartulis; Jason Michael,17,0,20,3
1745798484951,MCWP 50R,A00,893766,Compas; Sean Matthew,0,1,20,20
1745798484951,MCWP 50R,B00,893769,Carter; Jennifer A,0,0,20,20
1745798484951,MCWP 50R,C00,893771,Krone; Jarret,0,3,20,20
1745798484951,MCWP 50R,D00,893772,Miller; Elizabeth Deen,3,0,20,17
1745798484951,MCWP 50R,E00,893775,Carter; Andrea L,0,0,20,20
1745798485979,MMW 11R,A01,892721,Herbst; Matthew,11,0,27,16
1745798485979,MMW 11R,A02,892722,Herbst; Matthew,0,0,0,3
1745798487005,MMW 12R,A01,892724,Herbst; Matthew,0,9,16,16
1745798487005,MMW 12R,A02,892725,Herbst; Matthew,0,9,16,16
1745798488120,MMW 13R,A01,892727,Staff,0,4,16,16
1745798488120,MMW 13R,A02,892728,Staff,0,4,16,16
1745798488120,MMW 13R,A03,958032,Staff,0,3,16,16
1745798488120,MMW 13R,A04,958033,Staff,0,2,16,16
1745798488120,MMW 13R,A05,958034,Staff,0,3,16,16
1745798489145,SIO 295LS,A00,894015,Staff,7,0,25,18
1745798490172,SIO 295S,A00,894020,Staff,7,0,25,18
1745798491200,SIOC 290S,B01,958918,Staff,0,0,0,0
1745798492226,SIOC 291S,B01,958922,Staff,0,0,0,0
1745798493250,SOCI 117,A01,895339,Staff,4,0,5,1
1745798494276,WES 237B,A00,894149,Staff,11,0,20,9
1745798496334,AESE 279B,A00,891859,Staff,13,0,35,22
1745798497363,AIP 197,001,891854,Staff,70,0,70,0
1745798498389,ANTH 289S,A00,891856,Gagneux; Pascal,12,0,12,0
1745798499418,BENG 196,001,957946,Engler; Adam J.,9996,0,9999,3
1745798500445,CAT 124RS,A01,956906,Staff,8,0,25,17
1745798501471,CAT 125RS,A01,922013,Staff,8,0,25,17
1745798502498,CLRE 250,A00,891860,Morris; Sheldon,9995,0,9999,4
1745798504551,CLRE 251R,A00,907817,Mehta; Ravindra L.,9994,0,9999,5
1745798505581,CLRE 252,A00,891864,Cuomo; Raphael Eduardo,9993,0,9999,6
1745798506604,CLRE 253,A00,891867,Vaida; Florin,9994,0,9999,5
1745798506604,CLRE 253,B00,907819,Staff,9999,0,9999,0
1745798507632,CLRE 259,A00,891868,Patel; Hemal,9998,0,9999,1
1745798508657,CLRE 260,A00,891872,Cuomo; Raphael Eduardo,9999,0,9999,0
1745798509685,CLRE 297,001,891888,Cuomo; Raphael Eduardo,9999,0,9999,0
1745798510712,CSE 191,A00,958773,Minnes Kemp; Mor Mia,9999,0,9999,0
1745798511740,CSS 201S,A01,892054,Mignozzetti; Umberto,30,0,30,0
1745798512770,CSS 202S,A01,892056,Mignozzetti; Umberto,30,0,30,0
1745798513795,DSC 197,001,956898,Eldridge; Justin Matthew,9998,0,9999,1
1745798514823,DSC 297,001,958000,Mazumdar; Arya,9998,0,9999,1
1745798515849,EAP 100,A00,905686,Staff,9776,0,9999,223
1745798516874,ECE 45,A01,892618,Staff,0,12,50,50
1745798517902,ECE 109,A01,892620,Staff,0,43,0,0
1745798518928,ECE 111,A01,892719,Staff,0,7,50,50
1745798519953,ECE 197,001,957920,Mercier; Patrick Philip,9992,0,9999,7
1745798520981,ECON 178,A01,907814,Zhu; Ying,28,0,35,7
1745798522006,EDS 115,A00,895312,Staff,41,0,45,4
1745798523031,EDS 117,A01,895337,Staff,30,0,30,0
1745798524057,EDS 125,A00,895341,Jones; Gabrielle Anastasia,43,0,45,2
1745798525083,EDS 128A,A01,895459,Fargason; Sharon Gayle,44,0,45,1
1745798526108,EDS 128B,A01,895543,Pappas; Elizabeth,44,0,45,1
1745798527132,EDS 139,A00,897203,Pappas; Elizabeth,44,0,45,1
1745798527132,EDS 139,B00,897209,Fargason; Sharon Gayle,44,0,45,1
1745798528198,EDS 201,A00,895545,Staff,43,0,45,2
1745798529223,EDS 203,A01,895581,Halter; Christopher P.,43,0,45,2
1745798530249,EDS 204R,A01,895625,Heinzman; Erica M.,43,0,45,2
1745798530249,EDS 204R,B01,895693,Halter; Christopher P.,18,0,45,27
1745798531273,EDS 206R,A00,895694,Fargason; Sharon Gayle,9,0,30,21
1745798531273,EDS 206R,B00,895695,Choi; Bailey Miyeon,20,0,30,10
1745798532302,EDS 250,A00,895697,Hemans; Patricia Ann Benitez,43,0,45,2
1745798533327,EDS 281,A00,895701,Meyerott; Theresa Ann,15,0,15,0
1745798534352,EDS 284,A00,895736,Meyerott; Theresa Ann,15,0,15,0
1745798535377,EDS 286,A00,897210,Fine; Sarah,15,0,15,0
1745798536402,EDS 289C,A01,895770,Daly; Alan J.,15,0,15,0
1745798537427,EDS 290,A00,897211,Hofstetter; Carolyn,15,0,15,0
1745798538453,LIGM 5A,A00,896162,Fischer-Grunski; Eva K,15,0,20,5
1745798539482,LIGM 5B,A00,896260,Fischer-Grunski; Eva K,17,0,20,3
1745798540509,LIGM 5C,A00,896308,Fischer-Grunski; Eva K,18,0,20,2
1745798541536,LIIT 5AS,A00,896313,Carnelos; Chiara,18,0,20,2
1745798542562,LIIT 5BS,A00,896416,Carnelos; Chiara,20,0,20,0
1745798543592,LIIT 5CS,A00,896564,Carnelos; Chiara,20,0,20,0
1745798544618,LISP 5A,A00,896588,Munoz Sanchez; Alicia,4,0,20,16
1745798545647,LISP 5B,A00,896653,Munoz Sanchez; Alicia,10,0,20,10
1745798546680,LISP 5C,A00,896655,Munoz Sanchez; Alicia,4,0,20,16
1745798547706,MAE 197,001,957918,Kleissl; Jan,9998,0,9999,1
1745798548733,MATH 2,A01,957937,Staff,34,0,35,1
1745798549764,MATH 197,001,957876,Kedlaya; Kiran S.,9993,0,9999,6
1745798550792,MCWP 40,A00,892729,Duru; Nur,13,0,20,7
1745798550792,MCWP 40,B00,893304,Montejo; Carolina,20,0,20,0
1745798551820,MCWP 40R,A00,893757,Redela; Pamela Morgan,0,6,20,20
1745798552848,MCWP 50,A00,893758,Morshed; Michael James,2,0,20,18
1745798552848,MCWP 50,B00,893761,Bartulis; Jason Michael,17,0,20,3
1745798553877,MCWP 50R,A00,893766,Compas; Sean Matthew,0,1,20,20
1745798553877,MCWP 50R,B00,893769,Carter; Jennifer A,0,0,20,20
1745798553877,MCWP 50R,C00,893771,Krone; Jarret,0,3,20,20
1745798553877,MCWP 50R,D00,893772,Miller; Elizabeth Deen,3,0,20,17
1745798553877,MCWP 50R,E00,893775,Carter; Andrea L,0,0,20,20
1745798554903,MMW 11R,A01,892721,Herbst; Matthew,11,0,27,16
1745798554903,MMW 11R,A02,892722,Herbst; Matthew,0,0,0,3
1745798555930,MMW 12R,A01,892724,Herbst; Matthew,0,9,16,16
1745798555930,MMW 12R,A02,892725,Herbst; Matthew,0,9,16,16
1745798556981,MMW 13R,A01,892727,Staff,0,4,16,16
1745798556981,MMW 13R,A02,892728,Staff,0,4,16,16
1745798556981,MMW 13R,A03,958032,Staff,0,3,16,16
1745798556981,MMW 13R,A04,958033,Staff,0,2,16,16
1745798556981,MMW 13R,A05,958034,Staff,0,3,16,16
1745798558009,SIO 295LS,A00,894015,Staff,7,0,25,18
1745798559036,SIO 295S,A00,894020,Staff,7,0,25,18
1745798560066,SIOC 290S,B01,958918,Staff,0,0,0,0
1745798561095,SIOC 291S,B01,958922,Staff,0,0,0,0
1745798562120,SOCI 117,A01,895339,Staff,4,0,5,1
1745798563147,WES 237B,A00,894149,Staff,11,0,20,9
1745798565203,AESE 279B,A00,891859,Staff,13,0,35,22
1745798566230,AIP 197,001,891854,Staff,70,0,70,0
1745798567254,ANTH 289S,A00,891856,Gagneux; Pascal,12,0,12,0
1745798568278,BENG 196,001,957946,Engler; Adam J.,9996,0,9999,3
1745798569303,CAT 124RS,A01,956906,Staff,8,0,25,17
1745798570329,CAT 125RS,A01,922013,Staff,8,0,25,17
1745798571354,CLRE 250,A00,891860,Morris; Sheldon,9995,0,9999,4
1745798573416,CLRE 251R,A00,907817,Mehta; Ravindra L.,9994,0,9999,5
1745798574443,CLRE 252,A00,891864,Cuomo; Raphael Eduardo,9993,0,9999,6
1745798575467,CLRE 253,A00,891867,Vaida; Florin,9994,0,9999,5
1745798575467,CLRE 253,B00,907819,Staff,9999,0,9999,0
1745798576493,CLRE 259,A00,891868,Patel; Hemal,9998,0,9999,1
1745798577519,CLRE 260,A00,891872,Cuomo; Raphael Eduardo,9999,0,9999,0
1745798578544,CLRE 297,001,891888,Cuomo; Raphael Eduardo,9999,0,9999,0
1745798579568,CSE 191,A00,958773,Minnes Kemp; Mor Mia,9999,0,9999,0
1745798580597,CSS 201S,A01,892054,Mignozzetti; Umberto,30,0,30,0
1745798581623,CSS 202S,A01,892056,Mignozzetti; Umberto,30,0,30,0
1745798582648,DSC 197,001,956898,Eldridge; Justin Matthew,9998,0,9999,1
1745798583675,DSC 297,001,958000,Mazumdar; Arya,9998,0,9999,1
1745798584699,EAP 100,A00,905686,Staff,9776,0,9999,223
1745798585727,ECE 45,A01,892618,Staff,0,12,50,50
1745798586753,ECE 109,A01,892620,Staff,0,43,0,0
1745798587779,ECE 111,A01,892719,Staff,0,7,50,50
1745798588808,ECE 197,001,957920,Mercier; Patrick Philip,9992,0,9999,7
1745798589849,ECON 178,A01,907814,Zhu; Ying,28,0,35,7
1745798590885,EDS 115,A00,895312,Staff,41,0,45,4
1745798591911,EDS 117,A01,895337,Staff,30,0,30,0
1745798592939,EDS 125,A00,895341,Jones; Gabrielle Anastasia,43,0,45,2
1745798593967,EDS 128A,A01,895459,Fargason; Sharon Gayle,44,0,45,1
1745798594996,EDS 128B,A01,895543,Pappas; Elizabeth,44,0,45,1
1745798596021,EDS 139,A00,897203,Pappas; Elizabeth,44,0,45,1
1745798596021,EDS 139,B00,897209,Fargason; Sharon Gayle,44,0,45,1
1745798597048,EDS 201,A00,895545,Staff,43,0,45,2
1745798598074,EDS 203,A01,895581,Halter; Christopher P.,43,0,45,2
1745798599100,EDS 204R,A01,895625,Heinzman; Erica M.,43,0,45,2
1745798599100,EDS 204R,B01,895693,Halter; Christopher P.,18,0,45,27
1745798600130,EDS 206R,A00,895694,Fargason; Sharon Gayle,9,0,30,21
1745798600130,EDS 206R,B00,895695,Choi; Bailey Miyeon,20,0,30,10
1745798601157,EDS 250,A00,895697,Hemans; Patricia Ann Benitez,43,0,45,2
1745798602184,EDS 281,A00,895701,Meyerott; Theresa Ann,15,0,15,0
1745798603213,EDS 284,A00,895736,Meyerott; Theresa Ann,15,0,15,0
1745798604242,EDS 286,A00,897210,Fine; Sarah,15,0,15,0
1745798605270,EDS 289C,A01,895770,Daly; Alan J.,15,0,15,0
1745798606295,EDS 290,A00,897211,Hofstetter; Carolyn,15,0,15,0
1745798607323,LIGM 5A,A00,896162,Fischer-Grunski; Eva K,15,0,20,5
1745798608353,LIGM 5B,A00,896260,Fischer-Grunski; Eva K,17,0,20,3
1745798609382,LIGM 5C,A00,896308,Fischer-Grunski; Eva K,18,0,20,2
1745798610412,LIIT 5AS,A00,896313,Carnelos; Chiara,18,0,20,2
1745798611438,LIIT 5BS,A00,896416,Carnelos; Chiara,20,0,20,0
1745798612466,LIIT 5CS,A00,896564,Carnelos; Chiara,20,0,20,0
1745798613492,LISP 5A,A00,896588,Munoz Sanchez; Alicia,4,0,20,16
1745798614519,LISP 5B,A00,896653,Munoz Sanchez; Alicia,10,0,20,10
1745798615549,LISP 5C,A00,896655,Munoz Sanchez; Alicia,4,0,20,16
1745798616577,MAE 197,001,957918,Kleissl; Jan,9998,0,9999,1
1745798617605,MATH 2,A01,957937,Staff,34,0,35,1
1745798618631,MATH 197,001,957876,Kedlaya; Kiran S.,9993,0,9999,6
1745798619663,MCWP 40,A00,892729,Duru; Nur,13,0,20,7
1745798619663,MCWP 40,B00,893304,Montejo; Carolina,20,0,20,0
1745798620688,MCWP 40R,A00,893757,Redela; Pamela Morgan,0,6,20,20
1745798621714,MCWP 50,A00,893758,Morshed; Michael James,2,0,20,18
1745798621714,MCWP 50,B00,893761,Bartulis; Jason Michael,17,0,20,3
1745798622745,MCWP 50R,A00,893766,Compas; Sean Matthew,0,1,20,20
1745798622745,MCWP 50R,B00,893769,Carter; Jennifer A,0,0,20,20
1745798622745,MCWP 50R,C00,893771,Krone; Jarret,0,3,20,20
1745798622745,MCWP 50R,D00,893772,Miller; Elizabeth Deen,3,0,20,17
1745798622745,MCWP 50R,E00,893775,Carter; Andrea L,0,0,20,20
1745798623792,MMW 11R,A01,892721,Herbst; Matthew,11,0,27,16
1745798623792,MMW 11R,A02,892722,Herbst; Matthew,0,0,0,3
1745798624819,MMW 12R,A01,892724,Herbst; Matthew,0,9,16,16
1745798624819,MMW 12R,A02,892725,Herbst; Matthew,0,9,16,16
1745798625844,MMW 13R,A01,892727,Staff,0,4,16,16
1745798625844,MMW 13R,A02,892728,Staff,0,4,16,16
1745798625844,MMW 13R,A03,958032,Staff,0,3,16,16
1745798625844,MMW 13R,A04,958033,Staff,0,2,16,16
1745798625844,MMW 13R,A05,958034,Staff,0,3,16,16
1745798626869,SIO 295LS,A00,894015,Staff,7,0,25,18
1745798627897,SIO 295S,A00,894020,Staff,7,0,25,18
1745798628925,SIOC 290S,B01,958918,Staff,0,0,0,0
1745798629951,SIOC 291S,B01,958922,Staff,0,0,0,0
1745798630978,SOCI 117,A01,895339,Staff,4,0,5,1
1745798632008,WES 237B,A00,894149,Staff,11,0,20,9
1745798634074,AESE 279B,A00,891859,Staff,13,0,35,22
1745798635099,AIP 197,001,891854,Staff,70,0,70,0
1745798636128,ANTH 289S,A00,891856,Gagneux; Pascal,12,0,12,0
1745798637154,BENG 196,001,957946,Engler; Adam J.,9996,0,9999,3
1745798638181,CAT 124RS,A01,956906,Staff,8,0,25,17
1745798639209,CAT 125RS,A01,922013,Staff,8,0,25,17
1745798640234,CLRE 250,A00,891860,Morris; Sheldon,9995,0,9999,4
1745798642288,CLRE 251R,A00,907817,Mehta; Ravindra L.,9994,0,9999,5
1745798643319,CLRE 252,A00,891864,Cuomo; Raphael Eduardo,9993,0,9999,6
1745798644344,CLRE 253,A00,891867,Vaida; Florin,9994,0,9999,5
1745798644344,CLRE 253,B00,907819,Staff,9999,0,9999,0
1745798645373,CLRE 259,A00,891868,Patel; Hemal,9998,0,9999,1
1745798646401,CLRE 260,A00,891872,Cuomo; Raphael Eduardo,9999,0,9999,0
1745798647425,CLRE 297,001,891888,Cuomo; Raphael Eduardo,9999,0,9999,0
1745798648454,CSE 191,A00,958773,Minnes Kemp; Mor Mia,9999,0,9999,0
1745798649479,CSS 201S,A01,892054,Mignozzetti; Umberto,30,0,30,0
1745798650508,CSS 202S,A01,892056,Mignozzetti; Umberto,30,0,30,0
1745798651533,DSC 197,001,956898,Eldridge; Justin Matthew,9998,0,9999,1
1745798652559,DSC 297,001,958000,Mazumdar; Arya,9998,0,9999,1
1745798653585,EAP 100,A00,905686,Staff,9776,0,9999,223
1745798654610,ECE 45,A01,892618,Staff,0,12,50,50
1745798655639,ECE 109,A01,892620,Staff,0,43,0,0
1745798656665,ECE 111,A01,892719,Staff,0,7,50,50
1745798657692,ECE 197,001,957920,Mercier; Patrick Philip,9992,0,9999,7
1745798658718,ECON 178,A01,907814,Zhu; Ying,28,0,35,7
1745798659746,EDS 115,A00,895312,Staff,41,0,45,4
1745798660772,EDS 117,A01,895337,Staff,30,0,30,0
1745798661799,EDS 125,A00,895341,Jones; Gabrielle Anastasia,43,0,45,2
1745798662824,EDS 128A,A01,895459,Fargason; Sharon Gayle,44,0,45,1
1745798663852,EDS 128B,A01,895543,Pappas; Elizabeth,44,0,45,1
1745798664882,EDS 139,A00,897203,Pappas; Elizabeth,44,0,45,1
1745798664882,EDS 139,B00,897209,Fargason; Sharon Gayle,44,0,45,1
1745798665907,EDS 201,A00,895545,Staff,43,0,45,2
1745798666931,EDS 203,A01,895581,Halter; Christopher P.,43,0,45,2
1745798667957,EDS 204R,A01,895625,Heinzman; Erica M.,43,0,45,2
1745798667957,EDS 204R,B01,895693,Halter; Christopher P.,18,0,45,27
1745798668983,EDS 206R,A00,895694,Fargason; Sharon Gayle,9,0,30,21
1745798668983,EDS 206R,B00,895695,Choi; Bailey Miyeon,20,0,30,10
1745798670009,EDS 250,A00,895697,Hemans; Patricia Ann Benitez,43,0,45,2
1745798671035,EDS 281,A00,895701,Meyerott; Theresa Ann,15,0,15,0
1745798672062,EDS 284,A00,895736,Meyerott; Theresa Ann,15,0,15,0
1745798673090,EDS 286,A00,897210,Fine; Sarah,15,0,15,0
1745798674119,EDS 289C,A01,895770,Daly; Alan J.,15,0,15,0
1745798675163,EDS 290,A00,897211,Hofstetter; Carolyn,15,0,15,0
1745798676191,LIGM 5A,A00,896162,Fischer-Grunski; Eva K,15,0,20,5
1745798677222,LIGM 5B,A00,896260,Fischer-Grunski; Eva K,17,0,20,3
1745798678251,LIGM 5C,A00,896308,Fischer-Grunski; Eva K,18,0,20,2
1745798679279,LIIT 5AS,A00,896313,Carnelos; Chiara,18,0,20,2
1745798680306,LIIT 5BS,A00,896416,Carnelos; Chiara,20,0,20,0
1745798681332,LIIT 5CS,A00,896564,Carnelos; Chiara,20,0,20,0
1745798682358,LISP 5A,A00,896588,Munoz Sanchez; Alicia,4,0,20,16
1745798683384,LISP 5B,A00,896653,Munoz Sanchez; Alicia,10,0,20,10
1745798684410,LISP 5C,A00,896655,Munoz Sanchez; Alicia,4,0,20,16
1745798685436,MAE 197,001,957918,Kleissl; Jan,9998,0,9999,1
1745798686462,MATH 2,A01,957937,Staff,34,0,35,1
1745798687488,MATH 197,001,957876,Kedlaya; Kiran S.,9993,0,9999,6
1745798688513,MCWP 40,A00,892729,Duru; Nur,13,0,20,7
1745798688513,MCWP 40,B00,893304,Montejo; Carolina,20,0,20,0
1745798689541,MCWP 40R,A00,893757,Redela; Pamela Morgan,0,6,20,20
1745798690564,MCWP 50,A00,893758,Morshed; Michael James,2,0,20,18
1745798690564,MCWP 50,B00,893761,Bartulis; Jason Michael,17,0,20,3
1745798691592,MCWP 50R,A00,893766,Compas; Sean Matthew,0,1,20,20
1745798691592,MCWP 50R,B00,893769,Carter; Jennifer A,0,0,20,20
1745798691592,MCWP 50R,C00,893771,Krone; Jarret,0,3,20,20
1745798691592,MCWP 50R,D00,893772,Miller; Elizabeth Deen,3,0,20,17
1745798691592,MCWP 50R,E00,893775,Carter; Andrea L,0,0,20,20
1745798692618,MMW 11R,A01,892721,Herbst; Matthew,11,0,27,16
1745798692618,MMW 11R,A02,892722,Herbst; Matthew,0,0,0,3
1745798693647,MMW 12R,A01,892724,Herbst; Matthew,0,9,16,16
1745798693647,MMW 12R,A02,892725,Herbst; Matthew,0,9,16,16
1745798694677,MMW 13R,A01,892727,Staff,0,4,16,16
1745798694677,MMW 13R,A02,892728,Staff,0,4,16,16
1745798694677,MMW 13R,A03,958032,Staff,0,3,16,16
1745798694677,MMW 13R,A04,958033,Staff,0,2,16,16
1745798694677,MMW 13R,A05,958034,Staff,0,3,16,16
1745798695704,SIO 295LS,A00,894015,Staff,7,0,25,18
1745798696733,SIO 295S,A00,894020,Staff,7,0,25,18
1745798697763,SIOC 290S,B01,958918,Staff,0,0,0,0
1745798698790,SIOC 291S,B01,958922,Staff,0,0,0,0
1745798699816,SOCI 117,A01,895339,Staff,4,0,5,1
1745798700841,WES 237B,A00,894149,Staff,11,0,20,9
1745798702905,AESE 279B,A00,891859,Staff,13,0,35,22
1745798703931,AIP 197,001,891854,Staff,70,0,70,0
1745798704960,ANTH 289S,A00,891856,Gagneux; Pascal,12,0,12,0
1745798705991,BENG 196,001,957946,Engler; Adam J.,9996,0,9999,3
1745798707018,CAT 124RS,A01,956906,Staff,8,0,25,17
1745798708047,CAT 125RS,A01,922013,Staff,8,0,25,17
1745798709074,CLRE 250,A00,891860,Morris; Sheldon,9995,0,9999,4
1745798711129,CLRE 251R,A00,907817,Mehta; Ravindra L.,9994,0,9999,5
1745798712158,CLRE 252,A00,891864,Cuomo; Raphael Eduardo,9993,0,9999,6
1745798713186,CLRE 253,A00,891867,Vaida; Florin,9994,0,9999,5
1745798713186,CLRE 253,B00,907819,Staff,9999,0,9999,0
1745798714215,CLRE 259,A00,891868,Patel; Hemal,9998,0,9999,1
1745798715244,CLRE 260,A00,891872,Cuomo; Raphael Eduardo,9999,0,9999,0
1745798716274,CLRE 297,001,891888,Cuomo; Raphael Eduardo,9999,0,9999,0
1745798717304,CSE 191,A00,958773,Minnes Kemp; Mor Mia,9999,0,9999,0
1745798718330,CSS 201S,A01,892054,Mignozzetti; Umberto,30,0,30,0
1745798719362,CSS 202S,A01,892056,Mignozzetti; Umberto,30,0,30,0
1745798720390,DSC 197,001,956898,Eldridge; Justin Matthew,9998,0,9999,1
1745798721416,DSC 297,001,958000,Mazumdar; Arya,9998,0,9999,1
1745798722443,EAP 100,A00,905686,Staff,9776,0,9999,223
1745798723473,ECE 45,A01,892618,Staff,0,12,50,50
1745798724501,ECE 109,A01,892620,Staff,0,43,0,0
1745798725530,ECE 111,A01,892719,Staff,0,7,50,50
1745798726556,ECE 197,001,957920,Mercier; Patrick Philip,9992,0,9999,7
1745798727586,ECON 178,A01,907814,Zhu; Ying,28,0,35,7
1745798728610,EDS 115,A00,895312,Staff,41,0,45,4
1745798729636,EDS 117,A01,895337,Staff,30,0,30,0
1745798730664,EDS 125,A00,895341,Jones; Gabrielle Anastasia,43,0,45,2
1745798731690,EDS 128A,A01,895459,Fargason; Sharon Gayle,44,0,45,1
1745798732717,EDS 128B,A01,895543,Pappas; Elizabeth,44,0,45,1
1745798733744,EDS 139,A00,897203,Pappas; Elizabeth,44,0,45,1
1745798733744,EDS 139,B00,897209,Fargason; Sharon Gayle,44,0,45,1
1745798734769,EDS 201,A00,895545,Staff,43,0,45,2
1745798735794,EDS 203,A01,895581,Halter; Christopher P.,43,0,45,2
1745798736821,EDS 204R,A01,895625,Heinzman; Erica M.,43,0,45,2
1745798736821,EDS 204R,B01,895693,Halter; Christopher P.,18,0,45,27
1745798737847,EDS 206R,A00,895694,Fargason; Sharon Gayle,9,0,30,21
1745798737847,EDS 206R,B00,895695,Choi; Bailey Miyeon,20,0,30,10
1745798738876,EDS 250,A00,895697,Hemans; Patricia Ann Benitez,43,0,45,2
1745798739903,EDS 281,A00,895701,Meyerott; Theresa Ann,15,0,15,0
1745798740929,EDS 284,A00,895736,Meyerott; Theresa Ann,15,0,15,0
1745798741954,EDS 286,A00,897210,Fine; Sarah,15,0,15,0
1745798742982,EDS 289C,A01,895770,Daly; Alan J.,15,0,15,0
1745798744007,EDS 290,A00,897211,Hofstetter; Carolyn,15,0,15,0
1745798745038,LIGM 5A,A00,896162,Fischer-Grunski; Eva K,15,0,20,5
1745798746064,LIGM 5B,A00,896260,Fischer-Grunski; Eva K,17,0,20,3
1745798747090,LIGM 5C,A00,896308,Fischer-Grunski; Eva K,18,0,20,2
1745798748117,LIIT 5AS,A00,896313,Carnelos; Chiara,18,0,20,2
1745798749142,LIIT 5BS,A00,896416,Carnelos; Chiara,20,0,20,0
1745798750171,LIIT 5CS,A00,896564,Carnelos; Chiara,20,0,20,0
1745798751200,LISP 5A,A00,896588,Munoz Sanchez; Alicia,4,0,20,16
1745798752226,LISP 5B,A00,896653,Munoz Sanchez; Alicia,10,0,20,10
1745798753252,LISP 5C,A00,896655,Munoz Sanchez; Alicia,4,0,20,16
1745798754278,MAE 197,001,957918,Kleissl; Jan,9998,0,9999,1
1745798755307,MATH 2,A01,957937,Staff,34,0,35,1
1745798756333,MATH 197,001,957876,Kedlaya; Kiran S.,9993,0,9999,6
1745798757361,MCWP 40,A00,892729,Duru; Nur,13,0,20,7
1745798757361,MCWP 40,B00,893304,Montejo; Carolina,20,0,20,0
1745798758391,MCWP 40R,A00,893757,Redela; Pamela Morgan,0,6,20,20
1745798759417,MCWP 50,A00,893758,Morshed; Michael James,2,0,20,18
1745798759417,MCWP 50,B00,893761,Bartulis; Jason Michael,17,0,20,3
1745798760444,MCWP 50R,A00,893766,Compas; Sean Matthew,0,1,20,20
1745798760444,MCWP 50R,B00,893769,Carter; Jennifer A,0,0,20,20
1745798760444,MCWP 50R,C00,893771,Krone; Jarret,0,3,20,20
1745798760444,MCWP 50R,D00,893772,Miller; Elizabeth Deen,3,0,20,17
1745798760444,MCWP 50R,E00,893775,Carter; Andrea L,0,0,20,20
1745798761470,MMW 11R,A01,892721,Herbst; Matthew,11,0,27,16
1745798761470,MMW 11R,A02,892722,Herbst; Matthew,0,0,0,3
1745798762496,MMW 12R,A01,892724,Herbst; Matthew,0,9,16,16
1745798762496,MMW 12R,A02,892725,Herbst; Matthew,0,9,16,16
1745798763524,MMW 13R,A01,892727,Staff,0,4,16,16
1745798763524,MMW 13R,A02,892728,Staff,0,4,16,16
1745798763524,MMW 13R,A03,958032,Staff,0,3,16,16
1745798763524,MMW 13R,A04,958033,Staff,0,2,16,16
1745798763524,MMW 13R,A05,958034,Staff,0,3,16,16
1745798764551,SIO 295LS,A00,894015,Staff,7,0,25,18
1745798765577,SIO 295S,A00,894020,Staff,7,0,25,18
1745798766607,SIOC 290S,B01,958918,Staff,0,0,0,0
1745798767631,SIOC 291S,B01,958922,Staff,0,0,0,0
1745798768658,SOCI 117,A01,895339,Staff,4,0,5,1
1745798769682,WES 237B,A00,894149,Staff,11,0,20,9
1745798771741,AESE 279B,A00,891859,Staff,13,0,35,22
1745798772770,AIP 197,001,891854,Staff,70,0,70,0
1745798773794,ANTH 289S,A00,891856,Gagneux; Pascal,12,0,12,0
1745798774820,BENG 196,001,957946,Engler; Adam J.,9996,0,9999,3
1745798775847,CAT 124RS,A01,956906,Staff,8,0,25,17
1745798776872,CAT 125RS,A01,922013,Staff,8,0,25,17
1745798777900,CLRE 250,A00,891860,Morris; Sheldon,9995,0,9999,4
1745798779954,CLRE 251R,A00,907817,Mehta; Ravindra L.,9994,0,9999,5
1745798780981,CLRE 252,A00,891864,Cuomo; Raphael Eduardo,9993,0,9999,6
1745798782008,CLRE 253,A00,891867,Vaida; Florin,9994,0,9999,5
1745798782008,CLRE 253,B00,907819,Staff,9999,0,9999,0
1745798783036,CLRE 259,A00,891868,Patel; Hemal,9998,0,9999,1
1745798784066,CLRE 260,A00,891872,Cuomo; Raphael Eduardo,9999,0,9999,0
1745798785092,CLRE 297,001,891888,Cuomo; Raphael Eduardo,9999,0,9999,0
1745798786121,CSE 191,A00,958773,Minnes Kemp; Mor Mia,9999,0,9999,0
1745798787150,CSS 201S,A01,892054,Mignozzetti; Umberto,30,0,30,0
1745798788174,CSS 202S,A01,892056,Mignozzetti; Umberto,30,0,30,0
1745798789201,DSC 197,001,956898,Eldridge; Justin Matthew,9998,0,9999,1
1745798790227,DSC 297,001,958000,Mazumdar; Arya,9998,0,9999,1
1745798791254,EAP 100,A00,905686,Staff,9776,0,9999,223
1745798792282,ECE 45,A01,892618,Staff,0,12,50,50
1745798793308,ECE 109,A01,892620,Staff,0,43,0,0
1745798794333,ECE 111,A01,892719,Staff,0,7,50,50
1745798795359,ECE 197,001,957920,Mercier; Patrick Philip,9992,0,9999,7
1745798796388,ECON 178,A01,907814,Zhu; Ying,28,0,35,7
1745798797414,EDS 115,A00,895312,Staff,41,0,45,4
1745798798440,EDS 117,A01,895337,Staff,30,0,30,0
1745798799466,EDS 125,A00,895341,Jones; Gabrielle Anastasia,43,0,45,2
1745798800495,EDS 128A,A01,895459,Fargason; Sharon Gayle,44,0,45,1
1745798801522,EDS 128B,A01,895543,Pappas; Elizabeth,44,0,45,1
1745798802548,EDS 139,A00,897203,Pappas; Elizabeth,44,0,45,1
1745798802548,EDS 139,B00,897209,Fargason; Sharon Gayle,44,0,45,1
1745798803577,EDS 201,A00,895545,Staff,43,0,45,2
1745798804604,EDS 203,A01,895581,Halter; Christopher P.,43,0,45,2
1745798805632,EDS 204R,A01,895625,Heinzman; Erica M.,43,0,45,2
1745798805632,EDS 204R,B01,895693,Halter; Christopher P.,18,0,45,27
1745798806660,EDS 206R,A00,895694,Fargason; Sharon Gayle,9,0,30,21
1745798806660,EDS 206R,B00,895695,Choi; Bailey Miyeon,20,0,30,10
1745798807690,EDS 250,A00,895697,Hemans; Patricia Ann Benitez,43,0,45,2
1745798808716,EDS 281,A00,895701,Meyerott; Theresa Ann,15,0,15,0
1745798809746,EDS 284,A00,895736,Meyerott; Theresa Ann,15,0,15,0
1745798810773,EDS 286,A00,897210,Fine; Sarah,15,0,15,0
1745798811800,EDS 289C,A01,895770,Daly; Alan J.,15,0,15,0
1745798812828,EDS 290,A00,897211,Hofstetter; Carolyn,15,0,15,0
1745798813859,LIGM 5A,A00,896162,Fischer-Grunski; Eva K,15,0,20,5
1745798814889,LIGM 5B,A00,896260,Fischer-Grunski; Eva K,17,0,20,3
1745798815918,LIGM 5C,A00,896308,Fischer-Grunski; Eva K,18,0,20,2
1745798816943,LIIT 5AS,A00,896313,Carnelos; Chiara,18,0,20,2
1745798817971,LIIT 5BS,A00,896416,Carnelos; Chiara,20,0,20,0
1745798819001,LIIT 5CS,A00,896564,Carnelos; Chiara,20,0,20,0
1745798820033,LISP 5A,A00,896588,Munoz Sanchez; Alicia,4,0,20,16
1745798821059,LISP 5B,A00,896653,Munoz Sanchez; Alicia,10,0,20,10
1745798822089,LISP 5C,A00,896655,Munoz Sanchez; Alicia,4,0,20,16
1745798823116,MAE 197,001,957918,Kleissl; Jan,9998,0,9999,1
1745798824141,MATH 2,A01,957937,Staff,34,0,35,1
1745798825169,MATH 197,001,957876,Kedlaya; Kiran S.,9993,0,9999,6
1745798826195,MCWP 40,A00,892729,Duru; Nur,13,0,20,7
1745798826195,MCWP 40,B00,893304,Montejo; Carolina,20,0,20,0
1745798827222,MCWP 40R,A00,893757,Redela; Pamela Morgan,0,6,20,20
1745798828251,MCWP 50,A00,893758,Morshed; Michael James,2,0,20,18
1745798828251,MCWP 50,B00,893761,Bartulis; Jason Michael,17,0,20,3
1745798829277,MCWP 50R,A00,893766,Compas; Sean Matthew,0,1,20,20
1745798829277,MCWP 50R,B00,893769,Carter; Jennifer A,0,0,20,20
1745798829277,MCWP 50R,C00,893771,Krone; Jarret,0,3,20,20
1745798829277,MCWP 50R,D00,893772,Miller; Elizabeth Deen,3,0,20,17
1745798829277,MCWP 50R,E00,893775,Carter; Andrea L,0,0,20,20
1745798830301,MMW 11R,A01,892721,Herbst; Matthew,11,0,27,16
1745798830301,MMW 11R,A02,892722,Herbst; Matthew,0,0,0,3
1745798831328,MMW 12R,A01,892724,Herbst; Matthew,0,9,16,16
1745798831328,MMW 12R,A02,892725,Herbst; Matthew,0,9,16,16
1745798832359,MMW 13R,A01,892727,Staff,0,4,16,16
1745798832359,MMW 13R,A02,892728,Staff,0,4,16,16
1745798832359,MMW 13R,A03,958032,Staff,0,3,16,16
1745798832359,MMW 13R,A04,958033,Staff,0,2,16,16
1745798832359,MMW 13R,A05,958034,Staff,0,3,16,16
1745798833387,SIO 295LS,A00,894015,Staff,7,0,25,18
1745798834413,SIO 295S,A00,894020,Staff,7,0,25,18
1745798835444,SIOC 290S,B01,958918,Staff,0,0,0,0
1745798836472,SIOC 291S,B01,958922,Staff,0,0,0,0
1745798837500,SOCI 117,A01,895339,Staff,4,0,5,1
1745798838529,WES 237B,A00,894149,Staff,11,0,20,9
1745798840595,AESE 279B,A00,891859,Staff,13,0,35,22
1745798841621,AIP 197,001,891854,Staff,70,0,70,0
1745798842644,ANTH 289S,A00,891856,Gagneux; Pascal,12,0,12,0
1745798843671,BENG 196,001,957946,Engler; Adam J.,9996,0,9999,3
1745798844696,CAT 124RS,A01,956906,Staff,8,0,25,17
1745798845721,CAT 125RS,A01,922013,Staff,8,0,25,17
1745798846749,CLRE 250,A00,891860,Morris; Sheldon,9995,0,9999,4
1745798848802,CLRE 251R,A00,907817,Mehta; Ravindra L.,9994,0,9999,5
1745798849829,CLRE 252,A00,891864,Cuomo; Raphael Eduardo,9993,0,9999,6
1745798850853,CLRE 253,A00,891867,Vaida; Florin,9994,0,9999,5
1745798850853,CLRE 253,B00,907819,Staff,9999,0,9999,0
1745798851878,CLRE 259,A00,891868,Patel; Hemal,9998,0,9999,1
1745798852903,CLRE 260,A00,891872,Cuomo; Raphael Eduardo,9999,0,9999,0
1745798853929,CLRE 297,001,891888,Cuomo; Raphael Eduardo,9999,0,9999,0
1745798854955,CSE 191,A00,958773,Minnes Kemp; Mor Mia,9999,0,9999,0
1745798855984,CSS 201S,A01,892054,Mignozzetti; Umberto,30,0,30,0
1745798857008,CSS 202S,A01,892056,Mignozzetti; Umberto,30,0,30,0
1745798858033,DSC 197,001,956898,Eldridge; Justin Matthew,9998,0,9999,1
1745798859059,DSC 297,001,958000,Mazumdar; Arya,9998,0,9999,1
1745798860085,EAP 100,A00,905686,Staff,9776,0,9999,223
1745798861112,ECE 45,A01,892618,Staff,0,12,50,50
1745798862136,ECE 109,A01,892620,Staff,0,43,0,0
1745798863162,ECE 111,A01,892719,Staff,0,7,50,50
1745798864189,ECE 197,001,957920,Mercier; Patrick Philip,9992,0,9999,7
1745798865220,ECON 178,A01,907814,Zhu; Ying,28,0,35,7
1745798866245,EDS 115,A00,895312,Staff,41,0,45,4
1745798867271,EDS 117,A01,895337,Staff,30,0,30,0
1745798868301,EDS 125,A00,895341,Jones; Gabrielle Anastasia,43,0,45,2
1745798869329,EDS 128A,A01,895459,Fargason; Sharon Gayle,44,0,45,1
1745798870357,EDS 128B,A01,895543,Pappas; Elizabeth,44,0,45,1
1745798871382,EDS 139,A00,897203,Pappas; Elizabeth,44,0,45,1
1745798871382,EDS 139,B00,897209,Fargason; Sharon Gayle,44,0,45,1
1745798872409,EDS 201,A00,895545,Staff,43,0,45,2
1745798873433,EDS 203,A01,895581,Halter; Christopher P.,43,0,45,2
1745798874462,EDS 204R,A01,895625,Heinzman; Erica M.,43,0,45,2
1745798874462,EDS 204R,B01,895693,Halter; Christopher P.,18,0,45,27
1745798875488,EDS 206R,A00,895694,Fargason; Sharon Gayle,9,0,30,21
1745798875488,EDS 206R,B00,895695,Choi; Bailey Miyeon,20,0,30,10
1745798876516,EDS 250,A00,895697,Hemans; Patricia Ann Benitez,43,0,45,2
1745798877542,EDS 281,A00,895701,Meyerott; Theresa Ann,15,0,15,0
1745798878567,EDS 284,A00,895736,Meyerott; Theresa Ann,15,0,15,0
1745798879593,EDS 286,A00,897210,Fine; Sarah,15,0,15,0
1745798880619,EDS 289C,A01,895770,Daly; Alan J.,15,0,15,0
1745798881645,EDS 290,A00,897211,Hofstetter; Carolyn,15,0,15,0
1745798882670,LIGM 5A,A00,896162,Fischer-Grunski; Eva K,15,0,20,5
1745798883705,LIGM 5B,A00,896260,Fischer-Grunski; Eva K,17,0,20,3
1745798884734,LIGM 5C,A00,896308,Fischer-Grunski; Eva K,18,0,20,2
1745798885758,LIIT 5AS,A00,896313,Carnelos; Chiara,18,0,20,2
1745798886783,LIIT 5BS,A00,896416,Carnelos; Chiara,20,0,20,0
1745798888389,LIIT 5CS,A00,896564,Carnelos; Chiara,20,0,20,0
1745798889415,LISP 5A,A00,896588,Munoz Sanchez; Alicia,4,0,20,16
1745798890440,LISP 5B,A00,896653,Munoz Sanchez; Alicia,10,0,20,10
1745798891469,LISP 5C,A00,896655,Munoz Sanchez; Alicia,4,0,20,16
1745798892495,MAE 197,001,957918,Kleissl; Jan,9998,0,9999,1
1745798893521,MATH 2,A01,957937,Staff,34,0,35,1
1745798894547,MATH 197,001,957876,Kedlaya; Kiran S.,9993,0,9999,6
1745798895577,MCWP 40,A00,892729,Duru; Nur,13,0,20,7
1745798895577,MCWP 40,B00,893304,Montejo; Carolina,20,0,20,0
1745798896605,MCWP 40R,A00,893757,Redela; Pamela Morgan,0,6,20,20
1745798897631,MCWP 50,A00,893758,Morshed; Michael James,2,0,20,18
1745798897631,MCWP 50,B00,893761,Bartulis; Jason Michael,17,0,20,3
1745798898660,MCWP 50R,A00,893766,Compas; Sean Matthew,0,1,20,20
1745798898660,MCWP 50R,B00,893769,Carter; Jennifer A,0,0,20,20
1745798898660,MCWP 50R,C00,893771,Krone; Jarret,0,3,20,20
1745798898660,MCWP 50R,D00,893772,Miller; Elizabeth Deen,3,0,20,17
1745798898660,MCWP 50R,E00,893775,Carter; Andrea L,0,0,20,20
1745798899686,MMW 11R,A01,892721,Herbst; Matthew,11,0,27,16
1745798899686,MMW 11R,A02,892722,Herbst; Matthew,0,0,0,3
1745798900713,MMW 12R,A01,892724,Herbst; Matthew,0,9,16,16
1745798900713,MMW 12R,A02,892725,Herbst; Matthew,0,9,16,16
1745798901738,MMW 13R,A01,892727,Staff,0,4,16,16
1745798901738,MMW 13R,A02,892728,Staff,0,4,16,16
1745798901738,MMW 13R,A03,958032,Staff,0,3,16,16
1745798901738,MMW 13R,A04,958033,Staff,0,2,16,16
1745798901738,MMW 13R,A05,958034,Staff,0,3,16,16
1745798902769,SIO 295LS,A00,894015,Staff,7,0,25,18
1745798903795,SIO 295S,A00,894020,Staff,7,0,25,18
1745798904826,SIOC 290S,B01,958918,Staff,0,0,0,0
1745798905853,SIOC 291S,B01,958922,Staff,0,0,0,0
1745798906880,SOCI 117,A01,895339,Staff,4,0,5,1
1745798907907,WES 237B,A00,894149,Staff,11,0,20,9
1745798909978,AESE 279B,A00,891859,Staff,13,0,35,22
1745798911004,AIP 197,001,891854,Staff,70,0,70,0
1745798912032,ANTH 289S,A00,891856,Gagneux; Pascal,12,0,12,0
1745798913060,BENG 196,001,957946,Engler; Adam J.,9996,0,9999,3
1745798914087,CAT 124RS,A01,956906,Staff,8,0,25,17
1745798915115,CAT 125RS,A01,922013,Staff,8,0,25,17
1745798916344,CLRE 250,A00,891860,Morris; Sheldon,9995,0,9999,4
1745798918396,CLRE 251R,A00,907817,Mehta; Ravindra L.,9994,0,9999,5
1745798919424,CLRE 252,A00,891864,Cuomo; Raphael Eduardo,9993,0,9999,6
1745798920454,CLRE 253,A00,891867,Vaida; Florin,9994,0,9999,5
1745798920454,CLRE 253,B00,907819,Staff,9999,0,9999,0
1745798921482,CLRE 259,A00,891868,Patel; Hemal,9998,0,9999,1
1745798922509,CLRE 260,A00,891872,Cuomo; Raphael Eduardo,9999,0,9999,0
1745798923536,CLRE 297,001,891888,Cuomo; Raphael Eduardo,9999,0,9999,0
1745798924563,CSE 191,A00,958773,Minnes Kemp; Mor Mia,9999,0,9999,0
1745798925594,CSS 201S,A01,892054,Mignozzetti; Umberto,30,0,30,0
1745798926625,CSS 202S,A01,892056,Mignozzetti; Umberto,30,0,30,0
1745798927651,DSC 197,001,956898,Eldridge; Justin Matthew,9998,0,9999,1
1745798928678,DSC 297,001,958000,Mazumdar; Arya,9998,0,9999,1
1745798929704,EAP 100,A00,905686,Staff,9776,0,9999,223
1745798930728,ECE 45,A01,892618,Staff,0,12,50,50
1745798931758,ECE 109,A01,892620,Staff,0,43,0,0
1745798932786,ECE 111,A01,892719,Staff,0,7,50,50
1745798933815,ECE 197,001,957920,Mercier; Patrick Philip,9992,0,9999,7
1745798934842,ECON 178,A01,907814,Zhu; Ying,28,0,35,7
1745798935869,EDS 115,A00,895312,Staff,41,0,45,4
1745798936895,EDS 117,A01,895337,Staff,30,0,30,0
1745798937920,EDS 125,A00,895341,Jones; Gabrielle Anastasia,43,0,45,2
1745798938945,EDS 128A,A01,895459,Fargason; Sharon Gayle,44,0,45,1
1745798939973,EDS 128B,A01,895543,Pappas; Elizabeth,44,0,45,1
1745798941002,EDS 139,A00,897203,Pappas; Elizabeth,44,0,45,1
1745798941002,EDS 139,B00,897209,Fargason; Sharon Gayle,44,0,45,1
1745798942029,EDS 201,A00,895545,Staff,43,0,45,2
1745798943059,EDS 203,A01,895581,Halter; Christopher P.,43,0,45,2
1745798944087,EDS 204R,A01,895625,Heinzman; Erica M.,43,0,45,2
1745798944087,EDS 204R,B01,895693,Halter; Christopher P.,18,0,45,27
1745798945113,EDS 206R,A00,895694,Fargason; Sharon Gayle,9,0,30,21
1745798945113,EDS 206R,B00,895695,Choi; Bailey Miyeon,20,0,30,10
1745798946141,EDS 250,A00,895697,Hemans; Patricia Ann Benitez,43,0,45,2
1745798947168,EDS 281,A00,895701,Meyerott; Theresa Ann,15,0,15,0
1745798948192,EDS 284,A00,895736,Meyerott; Theresa Ann,15,0,15,0
1745798949263,EDS 286,A00,897210,Fine; Sarah,15,0,15,0
1745798950291,EDS 289C,A01,895770,Daly; Alan J.,15,0,15,0
1745798951315,EDS 290,A00,897211,Hofstetter; Carolyn,15,0,15,0
1745798952342,LIGM 5A,A00,896162,Fischer-Grunski; Eva K,15,0,20,5
1745798953374,LIGM 5B,A00,896260,Fischer-Grunski; Eva K,17,0,20,3
1745798954405,LIGM 5C,A00,896308,Fischer-Grunski; Eva K,18,0,20,2
1745798955432,LIIT 5AS,A00,896313,Carnelos; Chiara,18,0,20,2
1745798956459,LIIT 5BS,A00,896416,Carnelos; Chiara,20,0,20,0
1745798957488,LIIT 5CS,A00,896564,Carnelos; Chiara,20,0,20,0
1745798958517,LISP 5A,A00,896588,Munoz Sanchez; Alicia,4,0,20,16
1745798959544,LISP 5B,A00,896653,Munoz Sanchez; Alicia,10,0,20,10
1745798960574,LISP 5C,A00,896655,Munoz Sanchez; Alicia,4,0,20,16
1745798961601,MAE 197,001,957918,Kleissl; Jan,9998,0,9999,1
1745798962627,MATH 2,A01,957937,Staff,34,0,35,1
1745798963653,MATH 197,001,957876,Kedlaya; Kiran S.,9993,0,9999,6
1745798964679,MCWP 40,A00,892729,Duru; Nur,13,0,20,7
1745798964679,MCWP 40,B00,893304,Montejo; Carolina,20,0,20,0
1745798965709,MCWP 40R,A00,893757,Redela; Pamela Morgan,0,6,20,20
1745798966735,MCWP 50,A00,893758,Morshed; Michael James,2,0,20,18
1745798966735,MCWP 50,B00,893761,Bartulis; Jason Michael,17,0,20,3
1745798967766,MCWP 50R,A00,893766,Compas; Sean Matthew,0,1,20,20
1745798967766,MCWP 50R,B00,893769,Carter; Jennifer A,0,0,20,20
1745798967766,MCWP 50R,C00,893771,Krone; Jarret,0,3,20,20
1745798967766,MCWP 50R,D00,893772,Miller; Elizabeth Deen,3,0,20,17
1745798967766,MCWP 50R,E00,893775,Carter; Andrea L,0,0,20,20
1745798968792,MMW 11R,A01,892721,Herbst; Matthew,11,0,27,16
1745798968792,MMW 11R,A02,892722,Herbst; Matthew,0,0,0,3
1745798969822,MMW 12R,A01,892724,Herbst; Matthew,0,9,16,16
1745798969822,MMW 12R,A02,892725,Herbst; Matthew,0,9,16,16
1745798970850,MMW 13R,A01,892727,Staff,0,4,16,16
1745798970850,MMW 13R,A02,892728,Staff,0,4,16,16
1745798970850,MMW 13R,A03,958032,Staff,0,3,16,16
1745798970850,MMW 13R,A04,958033,Staff,0,2,16,16
1745798970850,MMW 13R,A05,958034,Staff,0,3,16,16
1745798971878,SIO 295LS,A00,894015,Staff,7,0,25,18
1745798972904,SIO 295S,A00,894020,Staff,7,0,25,18
1745798973935,SIOC 290S,B01,958918,Staff,0,0,0,0
1745798974962,SIOC 291S,B01,958922,Staff,0,0,0,0
1745798975990,SOCI 117,A01,895339,Staff,4,0,5,1
1745798977019,WES 237B,A00,894149,Staff,11,0,20,9
1745798979085,AESE 279B,A00,891859,Staff,13,0,35,22
1745798980111,AIP 197,001,891854,Staff,70,0,70,0
1745798981139,ANTH 289S,A00,891856,Gagneux; Pascal,12,0,12,0
1745798982166,BENG 196,001,957946,Engler; Adam J.,9996,0,9999,3
1745798983194,CAT 124RS,A01,956906,Staff,8,0,25,17
1745798984223,CAT 125RS,A01,922013,Staff,8,0,25,17
1745798985253,CLRE 250,A00,891860,Morris; Sheldon,9995,0,9999,4
1745798987307,CLRE 251R,A00,907817,Mehta; Ravindra L.,9994,0,9999,5
1745798988333,CLRE 252,A00,891864,Cuomo; Raphael Eduardo,9993,0,9999,6
1745798989361,CLRE 253,A00,891867,Vaida; Florin,9994,0,9999,5
1745798989361,CLRE 253,B00,907819,Staff,9999,0,9999,0
1745798990388,CLRE 259,A00,891868,Patel; Hemal,9998,0,9999,1
1745798991414,CLRE 260,A00,891872,Cuomo; Raphael Eduardo,9999,0,9999,0
1745798992440,CLRE 297,001,891888,Cuomo; Raphael Eduardo,9999,0,9999,0
1745798993467,CSE 191,A00,958773,Minnes Kemp; Mor Mia,9999,0,9999,0
1745798994498,CSS 201S,A01,892054,Mignozzetti; Umberto,30,0,30,0
1745798995524,CSS 202S,A01,892056,Mignozzetti; Umberto,30,0,30,0
1745798996549,DSC 197,001,956898,Eldridge; Justin Matthew,9998,0,9999,1
1745798997580,DSC 297,001,958000,Mazumdar; Arya,9998,0,9999,1
1745798998609,EAP 100,A00,905686,Staff,9776,0,9999,223
1745798999638,ECE 45,A01,892618,Staff,0,12,50,50
1745799000663,ECE 109,A01,892620,Staff,0,43,0,0
1745799001693,ECE 111,A01,892719,Staff,0,7,50,50
1745799002720,ECE 197,001,957920,Mercier; Patrick Philip,9992,0,9999,7
1745799003745,ECON 178,A01,907814,Zhu; Ying,28,0,35,7
1745799004775,EDS 115,A00,895312,Staff,41,0,45,4
1745799005803,EDS 117,A01,895337,Staff,30,0,30,0
1745799006833,EDS 125,A00,895341,Jones; Gabrielle Anastasia,43,0,45,2
1745799007862,EDS 128A,A01,895459,Fargason; Sharon Gayle,44,0,45,1
1745799008890,EDS 128B,A01,895543,Pappas; Elizabeth,44,0,45,1
1745799009920,EDS 139,A00,897203,Pappas; Elizabeth,44,0,45,1
1745799009920,EDS 139,B00,897209,Fargason; Sharon Gayle,44,0,45,1
1745799010947,EDS 201,A00,895545,Staff,43,0,45,2
1745799011977,EDS 203,A01,895581,Halter; Christopher P.,43,0,45,2
1745799013006,EDS 204R,A01,895625,Heinzman; Erica M.,43,0,45,2
1745799013006,EDS 204R,B01,895693,Halter; Christopher P.,18,0,45,27
1745799014031,EDS 206R,A00,895694,Fargason; Sharon Gayle,9,0,30,21
1745799014031,EDS 206R,B00,895695,Choi; Bailey Miyeon,20,0,30,10
1745799015058,EDS 250,A00,895697,Hemans; Patricia Ann Benitez,43,0,45,2
1745799016086,EDS 281,A00,895701,Meyerott; Theresa Ann,15,0,15,0
1745799017111,EDS 284,A00,895736,Meyerott; Theresa Ann,15,0,15,0
1745799018141,EDS 286,A00,897210,Fine; Sarah,15,0,15,0
1745799019169,EDS 289C,A01,895770,Daly; Alan J.,15,0,15,0
1745799020195,EDS 290,A00,897211,Hofstetter; Carolyn,15,0,15,0
1745799021224,LIGM 5A,A00,896162,Fischer-Grunski; Eva K,15,0,20,5
1745799022252,LIGM 5B,A00,896260,Fischer-Grunski; Eva K,17,0,20,3
1745799023278,LIGM 5C,A00,896308,Fischer-Grunski; Eva K,18,0,20,2
1745799024304,LIIT 5AS,A00,896313,Carnelos; Chiara,18,0,20,2
1745799025331,LIIT 5BS,A00,896416,Carnelos; Chiara,20,0,20,0
1745799026357,LIIT 5CS,A00,896564,Carnelos; Chiara,20,0,20,0
1745799027386,LISP 5A,A00,896588,Munoz Sanchez; Alicia,4,0,20,16
1745799028414,LISP 5B,A00,896653,Munoz Sanchez; Alicia,10,0,20,10
1745799029439,LISP 5C,A00,896655,Munoz Sanchez; Alicia,4,0,20,16
1745799030465,MAE 197,001,957918,Kleissl; Jan,9998,0,9999,1
1745799031492,MATH 2,A01,957937,Staff,34,0,35,1
1745799032518,MATH 197,001,957876,Kedlaya; Kiran S.,9993,0,9999,6
1745799033546,MCWP 40,A00,892729,Duru; Nur,13,0,20,7
1745799033546,MCWP 40,B00,893304,Montejo; Carolina,20,0,20,0
1745799034571,MCWP 40R,A00,893757,Redela; Pamela Morgan,0,6,20,20
1745799035598,MCWP 50,A00,893758,Morshed; Michael James,2,0,20,18
1745799035598,MCWP 50,B00,893761,Bartulis; Jason Michael,17,0,20,3
1745799036625,MCWP 50R,A00,893766,Compas; Sean Matthew,0,1,20,20
1745799036625,MCWP 50R,B00,893769,Carter; Jennifer A,0,0,20,20
1745799036625,MCWP 50R,C00,893771,Krone; Jarret,0,3,20,20
1745799036625,MCWP 50R,D00,893772,Miller; Elizabeth Deen,3,0,20,17
1745799036625,MCWP 50R,E00,893775,Carter; Andrea L,0,0,20,20
1745799037652,MMW 11R,A01,892721,Herbst; Matthew,11,0,27,16
1745799037652,MMW 11R,A02,892722,Herbst; Matthew,0,0,0,3
1745799038679,MMW 12R,A01,892724,Herbst; Matthew,0,9,16,16
1745799038679,MMW 12R,A02,892725,Herbst; Matthew,0,9,16,16
1745799039708,MMW 13R,A01,892727,Staff,0,4,16,16
1745799039708,MMW 13R,A02,892728,Staff,0,4,16,16
1745799039708,MMW 13R,A03,958032,Staff,0,3,16,16
1745799039708,MMW 13R,A04,958033,Staff,0,2,16,16
1745799039708,MMW 13R,A05,958034,Staff,0,3,16,16
1745799040737,SIO 295LS,A00,894015,Staff,7,0,25,18
1745799041762,SIO 295S,A00,894020,Staff,7,0,25,18
1745799042793,SIOC 290S,B01,958918,Staff,0,0,0,0
1745799043819,SIOC 291S,B01,958922,Staff,0,0,0,0
1745799044845,SOCI 117,A01,895339,Staff,4,0,5,1
1745799045872,WES 237B,A00,894149,Staff,11,0,20,9
1745799047929,AESE 279B,A00,891859,Staff,13,0,35,22
1745799048954,AIP 197,001,891854,Staff,70,0,70,0
1745799049982,ANTH 289S,A00,891856,Gagneux; Pascal,12,0,12,0
1745799051008,BENG 196,001,957946,Engler; Adam J.,9996,0,9999,3
1745799052036,CAT 124RS,A01,956906,Staff,8,0,25,17
1745799053102,CAT 125RS,A01,922013,Staff,8,0,25,17
1745799054129,CLRE 250,A00,891860,Morris; Sheldon,9995,0,9999,4
1745799056185,CLRE 251R,A00,907817,Mehta; Ravindra L.,9994,0,9999,5
1745799057209,CLRE 252,A00,891864,Cuomo; Raphael Eduardo,9993,0,9999,6
1745799058239,CLRE 253,A00,891867,Vaida; Florin,9994,0,9999,5
1745799058239,CLRE 253,B00,907819,Staff,9999,0,9999,0
1745799059270,CLRE 259,A00,891868,Patel; Hemal,9998,0,9999,1
1745799060296,CLRE 260,A00,891872,Cuomo; Raphael Eduardo,9999,0,9999,0
1745799061325,CLRE 297,001,891888,Cuomo; Raphael Eduardo,9999,0,9999,0
1745799062359,CSE 191,A00,958773,Minnes Kemp; Mor Mia,9999,0,9999,0
1745799063390,CSS 201S,A01,892054,Mignozzetti; Umberto,30,0,30,0
1745799064417,CSS 202S,A01,892056,Mignozzetti; Umberto,30,0,30,0
1745799065443,DSC 197,001,956898,Eldridge; Justin Matthew,9998,0,9999,1
1745799066468,DSC 297,001,958000,Mazumdar; Arya,9998,0,9999,1
1745799067495,EAP 100,A00,905686,Staff,9776,0,9999,223
1745799068525,ECE 45,A01,892618,Staff,0,12,50,50
1745799069553,ECE 109,A01,892620,Staff,0,43,0,0
1745799070581,ECE 111,A01,892719,Staff,0,7,50,50
1745799071608,ECE 197,001,957920,Mercier; Patrick Philip,9992,0,9999,7
1745799072634,ECON 178,A01,907814,Zhu; Ying,28,0,35,7
1745799073663,EDS 115,A00,895312,Staff,41,0,45,4
1745799074690,EDS 117,A01,895337,Staff,30,0,30,0
1745799075718,EDS 125,A00,895341,Jones; Gabrielle Anastasia,43,0,45,2
1745799076744,EDS 128A,A01,895459,Fargason; Sharon Gayle,44,0,45,1
1745799077774,EDS 128B,A01,895543,Pappas; Elizabeth,44,0,45,1
1745799078802,EDS 139,A00,897203,Pappas; Elizabeth,44,0,45,1
1745799078802,EDS 139,B00,897209,Fargason; Sharon Gayle,44,0,45,1
1745799079830,EDS 201,A00,895545,Staff,43,0,45,2
1745799080860,EDS 203,A01,895581,Halter; Christopher P.,43,0,45,2
1745799081921,EDS 204R,A01,895625,Heinzman; Erica M.,43,0,45,2
1745799081921,EDS 204R,B01,895693,Halter; Christopher P.,18,0,45,27
1745799082951,EDS 206R,A00,895694,Fargason; Sharon Gayle,9,0,30,21
1745799082951,EDS 206R,B00,895695,Choi; Bailey Miyeon,20,0,30,10
1745799083978,EDS 250,A00,895697,Hemans; Patricia Ann Benitez,43,0,45,2
1745799085005,EDS 281,A00,895701,Meyerott; Theresa Ann,15,0,15,0
1745799086035,EDS 284,A00,895736,Meyerott; Theresa Ann,15,0,15,0
1745799087064,EDS 286,A00,897210,Fine; Sarah,15,0,15,0
1745799088094,EDS 289C,A01,895770,Daly; Alan J.,15,0,15,0
1745799089123,EDS 290,A00,897211,Hofstetter; Carolyn,15,0,15,0
1745799090154,LIGM 5A,A00,896162,Fischer-Grunski; Eva K,15,0,20,5
1745799091180,LIGM 5B,A00,896260,Fischer-Grunski; Eva K,17,0,20,3
1745799092206,LIGM 5C,A00,896308,Fischer-Grunski; Eva K,18,0,20,2
1745799093233,LIIT 5AS,A00,896313,Carnelos; Chiara,18,0,20,2
1745799094258,LIIT 5BS,A00,896416,Carnelos; Chiara,20,0,20,0
1745799095286,LIIT 5CS,A00,896564,Carnelos; Chiara,20,0,20,0
1745799096315,LISP 5A,A00,896588,Munoz Sanchez; Alicia,4,0,20,16
1745799097346,LISP 5B,A00,896653,Munoz Sanchez; Alicia,10,0,20,10
1745799098372,LISP 5C,A00,896655,Munoz Sanchez; Alicia,4,0,20,16
1745799099399,MAE 197,001,957918,Kleissl; Jan,9998,0,9999,1
1745799100431,MATH 2,A01,957937,Staff,34,0,35,1
1745799101460,MATH 197,001,957876,Kedlaya; Kiran S.,9993,0,9999,6
1745799102489,MCWP 40,A00,892729,Duru; Nur,13,0,20,7
1745799102489,MCWP 40,B00,893304,Montejo; Carolina,20,0,20,0
1745799103515,MCWP 40R,A00,893757,Redela; Pamela Morgan,0,6,20,20
1745799104543,MCWP 50,A00,893758,Morshed; Michael James,2,0,20,18
1745799104543,MCWP 50,B00,893761,Bartulis; Jason Michael,17,0,20,3
1745799105569,MCWP 50R,A00,893766,Compas; Sean Matthew,0,1,20,20
1745799105569,MCWP 50R,B00,893769,Carter; Jennifer A,0,0,20,20
1745799105569,MCWP 50R,C00,893771,Krone; Jarret,0,3,20,20
1745799105569,MCWP 50R,D00,893772,Miller; Elizabeth Deen,3,0,20,17
1745799105569,MCWP 50R,E00,893775,Carter; Andrea L,0,0,20,20
1745799106597,MMW 11R,A01,892721,Herbst; Matthew,11,0,27,16
1745799106597,MMW 11R,A02,892722,Herbst; Matthew,0,0,0,3
1745799107624,MMW 12R,A01,892724,Herbst; Matthew,0,9,16,16
1745799107624,MMW 12R,A02,892725,Herbst; Matthew,0,9,16,16
1745799108649,MMW 13R,A01,892727,Staff,0,4,16,16
1745799108649,MMW 13R,A02,892728,Staff,0,4,16,16
1745799108649,MMW 13R,A03,958032,Staff,0,3,16,16
1745799108649,MMW 13R,A04,958033,Staff,0,2,16,16
1745799108649,MMW 13R,A05,958034,Staff,0,3,16,16
1745799109677,SIO 295LS,A00,894015,Staff,7,0,25,18
1745799110707,SIO 295S,A00,894020,Staff,7,0,25,18
1745799111739,SIOC 290S,B01,958918,Staff,0,0,0,0
1745799112766,SIOC 291S,B01,958922,Staff,0,0,0,0
1745799113791,SOCI 117,A01,895339,Staff,4,0,5,1
1745799114818,WES 237B,A00,894149,Staff,11,0,20,9
1745799116885,AESE 279B,A00,891859,Staff,13,0,35,22
1745799117910,AIP 197,001,891854,Staff,70,0,70,0
1745799118939,ANTH 289S,A00,891856,Gagneux; Pascal,12,0,12,0
1745799119965,BENG 196,001,957946,Engler; Adam J.,9996,0,9999,3
1745799120992,CAT 124RS,A01,956906,Staff,8,0,25,17
1745799122020,CAT 125RS,A01,922013,Staff,8,0,25,17
1745799123050,CLRE 250,A00,891860,Morris; Sheldon,9995,0,9999,4
1745799125107,CLRE 251R,A00,907817,Mehta; Ravindra L.,9994,0,9999,5
1745799126133,CLRE 252,A00,891864,Cuomo; Raphael Eduardo,9993,0,9999,6
1745799127161,CLRE 253,A00,891867,Vaida; Florin,9994,0,9999,5
1745799127161,CLRE 253,B00,907819,Staff,9999,0,9999,0
1745799128189,CLRE 259,A00,891868,Patel; Hemal,9998,0,9999,1
1745799129218,CLRE 260,A00,891872,Cuomo; Raphael Eduardo,9999,0,9999,0
1745799130245,CLRE 297,001,891888,Cuomo; Raphael Eduardo,9999,0,9999,0
1745799131270,CSE 191,A00,958773,Minnes Kemp; Mor Mia,9999,0,9999,0
1745799132296,CSS 201S,A01,892054,Mignozzetti; Umberto,30,0,30,0
1745799133329,CSS 202S,A01,892056,Mignozzetti; Umberto,30,0,30,0
1745799134357,DSC 197,001,956898,Eldridge; Justin Matthew,9998,0,9999,1
1745799135382,DSC 297,001,958000,Mazumdar; Arya,9998,0,9999,1
1745799136412,EAP 100,A00,905686,Staff,9776,0,9999,223
1745799137437,ECE 45,A01,892618,Staff,0,12,50,50
1745799138464,ECE 109,A01,892620,Staff,0,43,0,0
1745799139491,ECE 111,A01,892719,Staff,0,7,50,50
1745799140522,ECE 197,001,957920,Mercier; Patrick Philip,9992,0,9999,7
1745799141548,ECON 178,A01,907814,Zhu; Ying,28,0,35,7
1745799142577,EDS 115,A00,895312,Staff,41,0,45,4
1745799143608,EDS 117,A01,895337,Staff,30,0,30,0
1745799144633,EDS 125,A00,895341,Jones; Gabrielle Anastasia,43,0,45,2
1745799145660,EDS 128A,A01,895459,Fargason; Sharon Gayle,44,0,45,1
1745799146687,EDS 128B,A01,895543,Pappas; Elizabeth,44,0,45,1
1745799147714,EDS 139,A00,897203,Pappas; Elizabeth,44,0,45,1
1745799147714,EDS 139,B00,897209,Fargason; Sharon Gayle,44,0,45,1
1745799148741,EDS 201,A00,895545,Staff,43,0,45,2
1745799149768,EDS 203,A01,895581,Halter; Christopher P.,43,0,45,2
1745799150795,EDS 204R,A01,895625,Heinzman; Erica M.,43,0,45,2
1745799150795,EDS 204R,B01,895693,Halter; Christopher P.,18,0,45,27
1745799151820,EDS 206R,A00,895694,Fargason; Sharon Gayle,9,0,30,21
1745799151820,EDS 206R,B00,895695,Choi; Bailey Miyeon,20,0,30,10
1745799152848,EDS 250,A00,895697,Hemans; Patricia Ann Benitez,43,0,45,2
1745799153878,EDS 281,A00,895701,Meyerott; Theresa Ann,15,0,15,0
1745799154905,EDS 284,A00,895736,Meyerott; Theresa Ann,15,0,15,0
1745799155932,EDS 286,A00,897210,Fine; Sarah,15,0,15,0
1745799157017,EDS 289C,A01,895770,Daly; Alan J.,15,0,15,0
1745799158047,EDS 290,A00,897211,Hofstetter; Carolyn,15,0,15,0
1745799159081,LIGM 5A,A00,896162,Fischer-Grunski; Eva K,15,0,20,5
1745799160111,LIGM 5B,A00,896260,Fischer-Grunski; Eva K,17,0,20,3
1745799161142,LIGM 5C,A00,896308,Fischer-Grunski; Eva K,18,0,20,2
1745799162169,LIIT 5AS,A00,896313,Carnelos; Chiara,18,0,20,2
1745799163199,LIIT 5BS,A00,896416,Carnelos; Chiara,20,0,20,0
1745799164226,LIIT 5CS,A00,896564,Carnelos; Chiara,20,0,20,0
1745799165255,LISP 5A,A00,896588,Munoz Sanchez; Alicia,4,0,20,16
1745799166288,LISP 5B,A00,896653,Munoz Sanchez; Alicia,10,0,20,10
1745799167316,LISP 5C,A00,896655,Munoz Sanchez; Alicia,4,0,20,16
1745799168342,MAE 197,001,957918,Kleissl; Jan,9998,0,9999,1
1745799169368,MATH 2,A01,957937,Staff,34,0,35,1
1745799170395,MATH 197,001,957876,Kedlaya; Kiran S.,9993,0,9999,6
1745799171425,MCWP 40,A00,892729,Duru; Nur,13,0,20,7
1745799171425,MCWP 40,B00,893304,Montejo; Carolina,20,0,20,0
1745799172455,MCWP 40R,A00,893757,Redela; Pamela Morgan,0,6,20,20
1745799173482,MCWP 50,A00,893758,Morshed; Michael James,2,0,20,18
1745799173482,MCWP 50,B00,893761,Bartulis; Jason Michael,17,0,20,3
1745799174513,MCWP 50R,A00,893766,Compas; Sean Matthew,0,1,20,20
1745799174513,MCWP 50R,B00,893769,Carter; Jennifer A,0,0,20,20
1745799174513,MCWP 50R,C00,893771,Krone; Jarret,0,3,20,20
1745799174513,MCWP 50R,D00,893772,Miller; Elizabeth Deen,3,0,20,17
1745799174513,MCWP 50R,E00,893775,Carter; Andrea L,0,0,20,20
1745799175543,MMW 11R,A01,892721,Herbst; Matthew,11,0,27,16
1745799175543,MMW 11R,A02,892722,Herbst; Matthew,0,0,0,3
1745799176571,MMW 12R,A01,892724,Herbst; Matthew,0,9,16,16
1745799176571,MMW 12R,A02,892725,Herbst; Matthew,0,9,16,16
1745799177601,MMW 13R,A01,892727,Staff,0,4,16,16
1745799177601,MMW 13R,A02,892728,Staff,0,4,16,16
1745799177601,MMW 13R,A03,958032,Staff,0,3,16,16
1745799177601,MMW 13R,A04,958033,Staff,0,2,16,16
1745799177601,MMW 13R,A05,958034,Staff,0,3,16,16
1745799178628,SIO 295LS,A00,894015,Staff,7,0,25,18
1745799179654,SIO 295S,A00,894020,Staff,7,0,25,18
1745799180680,SIOC 290S,B01,958918,Staff,0,0,0,0
1745799181706,SIOC 291S,B01,958922,Staff,0,0,0,0
1745799182736,SOCI 117,A01,895339,Staff,4,0,5,1
1745799183763,WES 237B,A00,894149,Staff,11,0,20,9
1745799185830,AESE 279B,A00,891859,Staff,13,0,35,22
1745799186859,AIP 197,001,891854,Staff,70,0,70,0
1745799187890,ANTH 289S,A00,891856,Gagneux; Pascal,12,0,12,0
1745799188916,BENG 196,001,957946,Engler; Adam J.,9996,0,9999,3
1745799189946,CAT 124RS,A01,956906,Staff,8,0,25,17
1745799190971,CAT 125RS,A01,922013,Staff,8,0,25,17
1745799192001,CLRE 250,A00,891860,Morris; Sheldon,9995,0,9999,4
1745799194052,CLRE 251R,A00,907817,Mehta; Ravindra L.,9994,0,9999,5
1745799195081,CLRE 252,A00,891864,Cuomo; Raphael Eduardo,9993,0,9999,6
1745799196113,CLRE 253,A00,891867,Vaida; Florin,9994,0,9999,5
1745799196113,CLRE 253,B00,907819,Staff,9999,0,9999,0
1745799197142,CLRE 259,A00,891868,Patel; Hemal,9998,0,9999,1
1745799198169,CLRE 260,A00,891872,Cuomo; Raphael Eduardo,9999,0,9999,0
1745799199198,CLRE 297,001,891888,Cuomo; Raphael Eduardo,9999,0,9999,0
1745799200228,CSE 191,A00,958773,Minnes Kemp; Mor Mia,9999,0,9999,0
1745799201259,CSS 201S,A01,892054,Mignozzetti; Umberto,30,0,30,0
1745799202290,CSS 202S,A01,892056,Mignozzetti; Umberto,30,0,30,0
1745799203317,DSC 197,001,956898,Eldridge; Justin Matthew,9998,0,9999,1
1745799204345,DSC 297,001,958000,Mazumdar; Arya,9998,0,9999,1
1745799205374,EAP 100,A00,905686,Staff,9776,0,9999,223
1745799206402,ECE 45,A01,892618,Staff,0,12,50,50
1745799207427,ECE 109,A01,892620,Staff,0,43,0,0
1745799208455,ECE 111,A01,892719,Staff,0,7,50,50
1745799209482,ECE 197,001,957920,Mercier; Patrick Philip,9992,0,9999,7
1745799210512,ECON 178,A01,907814,Zhu; Ying,28,0,35,7
1745799211543,EDS 115,A00,895312,Staff,41,0,45,4
1745799212573,EDS 117,A01,895337,Staff,30,0,30,0
1745799213601,EDS 125,A00,895341,Jones; Gabrielle Anastasia,43,0,45,2
1745799214629,EDS 128A,A01,895459,Fargason; Sharon Gayle,44,0,45,1
1745799215659,EDS 128B,A01,895543,Pappas; Elizabeth,44,0,45,1
1745799216685,EDS 139,A00,897203,Pappas; Elizabeth,44,0,45,1
1745799216685,EDS 139,B00,897209,Fargason; Sharon Gayle,44,0,45,1
1745799217716,EDS 201,A00,895545,Staff,43,0,45,2
1745799218747,EDS 203,A01,895581,Halter; Christopher P.,43,0,45,2
1745799219775,EDS 204R,A01,895625,Heinzman; Erica M.,43,0,45,2
1745799219775,EDS 204R,B01,895693,Halter; Christopher P.,18,0,45,27
1745799220805,EDS 206R,A00,895694,Fargason; Sharon Gayle,9,0,30,21
1745799220805,EDS 206R,B00,895695,Choi; Bailey Miyeon,20,0,30,10
1745799221832,EDS 250,A00,895697,Hemans; Patricia Ann Benitez,43,0,45,2
1745799222865,EDS 281,A00,895701,Meyerott; Theresa Ann,15,0,15,0
1745799223892,EDS 284,A00,895736,Meyerott; Theresa Ann,15,0,15,0
1745799224918,EDS 286,A00,897210,Fine; Sarah,15,0,15,0
1745799225948,EDS 289C,A01,895770,Daly; Alan J.,15,0,15,0
1745799226976,EDS 290,A00,897211,Hofstetter; Carolyn,15,0,15,0
1745799228008,LIGM 5A,A00,896162,Fischer-Grunski; Eva K,15,0,20,5
1745799229037,LIGM 5B,A00,896260,Fischer-Grunski; Eva K,17,0,20,3
1745799230063,LIGM 5C,A00,896308,Fischer-Grunski; Eva K,18,0,20,2
1745799231091,LIIT 5AS,A00,896313,Carnelos; Chiara,18,0,20,2
1745799232119,LIIT 5BS,A00,896416,Carnelos; Chiara,20,0,20,0
1745799233145,LIIT 5CS,A00,896564,Carnelos; Chiara,20,0,20,0
1745799234171,LISP 5A,A00,896588,Munoz Sanchez; Alicia,4,0,20,16
1745799235203,LISP 5B,A00,896653,Munoz Sanchez; Alicia,10,0,20,10
1745799236234,LISP 5C,A00,896655,Munoz Sanchez; Alicia,4,0,20,16
1745799237263,MAE 197,001,957918,Kleissl; Jan,9998,0,9999,1
1745799238291,MATH 2,A01,957937,Staff,34,0,35,1
1745799239320,MATH 197,001,957876,Kedlaya; Kiran S.,9993,0,9999,6
1745799240347,MCWP 40,A00,892729,Duru; Nur,13,0,20,7
1745799240347,MCWP 40,B00,893304,Montejo; Carolina,20,0,20,0
1745799241378,MCWP 40R,A00,893757,Redela; Pamela Morgan,0,6,20,20
1745799242409,MCWP 50,A00,893758,Morshed; Michael James,2,0,20,18
1745799242409,MCWP 50,B00,893761,Bartulis; Jason Michael,17,0,20,3
1745799243439,MCWP 50R,A00,893766,Compas; Sean Matthew,0,1,20,20
1745799243439,MCWP 50R,B00,893769,Carter; Jennifer A,0,0,20,20
1745799243439,MCWP 50R,C00,893771,Krone; Jarret,0,3,20,20
1745799243439,MCWP 50R,D00,893772,Miller; Elizabeth Deen,3,0,20,17
1745799243439,MCWP 50R,E00,893775,Carter; Andrea L,0,0,20,20
1745799244465,MMW 11R,A01,892721,Herbst; Matthew,11,0,27,16
1745799244465,MMW 11R,A02,892722,Herbst; Matthew,0,0,0,3
1745799245496,MMW 12R,A01,892724,Herbst; Matthew,0,9,16,16
1745799245496,MMW 12R,A02,892725,Herbst; Matthew,0,9,16,16
1745799246525,MMW 13R,A01,892727,Staff,0,4,16,16
1745799246525,MMW 13R,A02,892728,Staff,0,4,16,16
1745799246525,MMW 13R,A03,958032,Staff,0,3,16,16
1745799246525,MMW 13R,A04,958033,Staff,0,2,16,16
1745799246525,MMW 13R,A05,958034,Staff,0,3,16,16
1745799247554,SIO 295LS,A00,894015,Staff,7,0,25,18
1745799248581,SIO 295S,A00,894020,Staff,7,0,25,18
1745799249610,SIOC 290S,B01,958918,Staff,0,0,0,0
1745799250640,SIOC 291S,B01,958922,Staff,0,0,0,0
1745799251670,SOCI 117,A01,895339,Staff,4,0,5,1
1745799252699,WES 237B,A00,894149,Staff,11,0,20,9
1745799254759,AESE 279B,A00,891859,Staff,13,0,35,22
1745799255786,AIP 197,001,891854,Staff,70,0,70,0
1745799256815,ANTH 289S,A00,891856,Gagneux; Pascal,12,0,12,0
1745799257842,BENG 196,001,957946,Engler; Adam J.,9996,0,9999,3
1745799258869,CAT 124RS,A01,956906,Staff,8,0,25,17
1745799259895,CAT 125RS,A01,922013,Staff,8,0,25,17
1745799260923,CLRE 250,A00,891860,Morris; Sheldon,9995,0,9999,4
1745799262978,CLRE 251R,A00,907817,Mehta; Ravindra L.,9994,0,9999,5
1745799264010,CLRE 252,A00,891864,Cuomo; Raphael Eduardo,9993,0,9999,6
1745799265042,CLRE 253,A00,891867,Vaida; Florin,9994,0,9999,5
1745799265042,CLRE 253,B00,907819,Staff,9999,0,9999,0
1745799266073,CLRE 259,A00,891868,Patel; Hemal,9998,0,9999,1
1745799267098,CLRE 260,A00,891872,Cuomo; Raphael Eduardo,9999,0,9999,0
1745799268130,CLRE 297,001,891888,Cuomo; Raphael Eduardo,9999,0,9999,0
1745799269159,CSE 191,A00,958773,Minnes Kemp; Mor Mia,9999,0,9999,0
1745799270187,CSS 201S,A01,892054,Mignozzetti; Umberto,30,0,30,0
1745799271214,CSS 202S,A01,892056,Mignozzetti; Umberto,30,0,30,0
1745799272241,DSC 197,001,956898,Eldridge; Justin Matthew,9998,0,9999,1
1745799273271,DSC 297,001,958000,Mazumdar; Arya,9998,0,9999,1
1745799274298,EAP 100,A00,905686,Staff,9776,0,9999,223
1745799275329,ECE 45,A01,892618,Staff,0,12,50,50
1745799276356,ECE 109,A01,892620,Staff,0,43,0,0
1745799277384,ECE 111,A01,892719,Staff,0,7,50,50
1745799278411,ECE 197,001,957920,Mercier; Patrick Philip,9992,0,9999,7
1745799279443,ECON 178,A01,907814,Zhu; Ying,28,0,35,7
1745799280471,EDS 115,A00,895312,Staff,41,0,45,4
1745799281502,EDS 117,A01,895337,Staff,30,0,30,0
1745799282530,EDS 125,A00,895341,Jones; Gabrielle Anastasia,43,0,45,2
1745799283557,EDS 128A,A01,895459,Fargason; Sharon Gayle,44,0,45,1
1745799284584,EDS 128B,A01,895543,Pappas; Elizabeth,44,0,45,1
1745799285612,EDS 139,A00,897203,Pappas; Elizabeth,44,0,45,1
1745799285612,EDS 139,B00,897209,Fargason; Sharon Gayle,44,0,45,1
1745799286637,EDS 201,A00,895545,Staff,43,0,45,2
1745799287663,EDS 203,A01,895581,Halter; Christopher P.,43,0,45,2
1745799288692,EDS 204R,A01,895625,Heinzman; Erica M.,43,0,45,2
1745799288692,EDS 204R,B01,895693,Halter; Christopher P.,18,0,45,27
1745799289718,EDS 206R,A00,895694,Fargason; Sharon Gayle,9,0,30,21
1745799289718,EDS 206R,B00,895695,Choi; Bailey Miyeon,20,0,30,10
1745799290746,EDS 250,A00,895697,Hemans; Patricia Ann Benitez,43,0,45,2
1745799291773,EDS 281,A00,895701,Meyerott; Theresa Ann,15,0,15,0
1745799292799,EDS 284,A00,895736,Meyerott; Theresa Ann,15,0,15,0
1745799293829,EDS 286,A00,897210,Fine; Sarah,15,0,15,0
1745799294859,EDS 289C,A01,895770,Daly; Alan J.,15,0,15,0
1745799295885,EDS 290,A00,897211,Hofstetter; Carolyn,15,0,15,0
1745799296913,LIGM 5A,A00,896162,Fischer-Grunski; Eva K,15,0,20,5
1745799297941,LIGM 5B,A00,896260,Fischer-Grunski; Eva K,17,0,20,3
1745799298967,LIGM 5C,A00,896308,Fischer-Grunski; Eva K,18,0,20,2
1745799299997,LIIT 5AS,A00,896313,Carnelos; Chiara,18,0,20,2
1745799301025,LIIT 5BS,A00,896416,Carnelos; Chiara,20,0,20,0
1745799302050,LIIT 5CS,A00,896564,Carnelos; Chiara,20,0,20,0
1745799303077,LISP 5A,A00,896588,Munoz Sanchez; Alicia,4,0,20,16
1745799304104,LISP 5B,A00,896653,Munoz Sanchez; Alicia,10,0,20,10
1745799305132,LISP 5C,A00,896655,Munoz Sanchez; Alicia,4,0,20,16
1745799306158,MAE 197,001,957918,Kleissl; Jan,9998,0,9999,1
1745799307188,MATH 2,A01,957937,Staff,34,0,35,1
1745799308215,MATH 197,001,957876,Kedlaya; Kiran S.,9993,0,9999,6
1745799309248,MCWP 40,A00,892729,Duru; Nur,13,0,20,7
1745799309248,MCWP 40,B00,893304,Montejo; Carolina,20,0,20,0
1745799310275,MCWP 40R,A00,893757,Redela; Pamela Morgan,0,6,20,20
1745799311301,MCWP 50,A00,893758,Morshed; Michael James,2,0,20,18
1745799311301,MCWP 50,B00,893761,Bartulis; Jason Michael,17,0,20,3
1745799312330,MCWP 50R,A00,893766,Compas; Sean Matthew,0,1,20,20
1745799312330,MCWP 50R,B00,893769,Carter; Jennifer A,0,0,20,20
1745799312330,MCWP 50R,C00,893771,Krone; Jarret,0,3,20,20
1745799312330,MCWP 50R,D00,893772,Miller; Elizabeth Deen,3,0,20,17
1745799312330,MCWP 50R,E00,893775,Carter; Andrea L,0,0,20,20
1745799313354,MMW 11R,A01,892721,Herbst; Matthew,11,0,27,16
1745799313354,MMW 11R,A02,892722,Herbst; Matthew,0,0,0,3
1745799314383,MMW 12R,A01,892724,Herbst; Matthew,0,9,16,16
1745799314383,MMW 12R,A02,892725,Herbst; Matthew,0,9,16,16
1745799315409,MMW 13R,A01,892727,Staff,0,4,16,16
1745799315409,MMW 13R,A02,892728,Staff,0,4,16,16
1745799315409,MMW 13R,A03,958032,Staff,0,3,16,16
1745799315409,MMW 13R,A04,958033,Staff,0,2,16,16
1745799315409,MMW 13R,A05,958034,Staff,0,3,16,16
1745799316438,SIO 295LS,A00,894015,Staff,7,0,25,18
1745799317466,SIO 295S,A00,894020,Staff,7,0,25,18
1745799318493,SIOC 290S,B01,958918,Staff,0,0,0,0
1745799319524,SIOC 291S,B01,958922,Staff,0,0,0,0
1745799320551,SOCI 117,A01,895339,Staff,4,0,5,1
1745799321580,WES 237B,A00,894149,Staff,11,0,20,9
1745799323642,AESE 279B,A00,891859,Staff,13,0,35,22
1745799324667,AIP 197,001,891854,Staff,70,0,70,0
1745799325693,ANTH 289S,A00,891856,Gagneux; Pascal,12,0,12,0
1745799326722,BENG 196,001,957946,Engler; Adam J.,9996,0,9999,3
1745799327750,CAT 124RS,A01,956906,Staff,8,0,25,17
1745799328774,CAT 125RS,A01,922013,Staff,8,0,25,17
1745799329805,CLRE 250,A00,891860,Morris; Sheldon,9995,0,9999,4
1745799331856,CLRE 251R,A00,907817,Mehta; Ravindra L.,9994,0,9999,5
1745799332885,CLRE 252,A00,891864,Cuomo; Raphael Eduardo,9993,0,9999,6
1745799333912,CLRE 253,A00,891867,Vaida; Florin,9994,0,9999,5
1745799333912,CLRE 253,B00,907819,Staff,9999,0,9999,0
1745799334940,CLRE 259,A00,891868,Patel; Hemal,9998,0,9999,1
1745799335965,CLRE 260,A00,891872,Cuomo; Raphael Eduardo,9999,0,9999,0
1745799336993,CLRE 297,001,891888,Cuomo; Raphael Eduardo,9999,0,9999,0
1745799338022,CSE 191,A00,958773,Minnes Kemp; Mor Mia,9999,0,9999,0
1745799339047,CSS 201S,A01,892054,Mignozzetti; Umberto,30,0,30,0
1745799340074,CSS 202S,A01,892056,Mignozzetti; Umberto,30,0,30,0
1745799341101,DSC 197,001,956898,Eldridge; Justin Matthew,9998,0,9999,1
1745799342127,DSC 297,001,958000,Mazumdar; Arya,9998,0,9999,1
1745799343154,EAP 100,A00,905686,Staff,9776,0,9999,223
1745799344180,ECE 45,A01,892618,Staff,0,12,50,50
1745799345206,ECE 109,A01,892620,Staff,0,43,0,0
1745799346230,ECE 111,A01,892719,Staff,0,7,50,50
1745799347258,ECE 197,001,957920,Mercier; Patrick Philip,9992,0,9999,7
1745799348287,ECON 178,A01,907814,Zhu; Ying,28,0,35,7
1745799349311,EDS 115,A00,895312,Staff,41,0,45,4
1745799350337,EDS 117,A01,895337,Staff,30,0,30,0
1745799351364,EDS 125,A00,895341,Jones; Gabrielle Anastasia,43,0,45,2
1745799352399,EDS 128A,A01,895459,Fargason; Sharon Gayle,44,0,45,1
1745799353427,EDS 128B,A01,895543,Pappas; Elizabeth,44,0,45,1
1745799354457,EDS 139,A00,897203,Pappas; Elizabeth,44,0,45,1
1745799354457,EDS 139,B00,897209,Fargason; Sharon Gayle,44,0,45,1
1745799355482,EDS 201,A00,895545,Staff,43,0,45,2
1745799356510,EDS 203,A01,895581,Halter; Christopher P.,43,0,45,2
1745799357536,EDS 204R,A01,895625,Heinzman; Erica M.,43,0,45,2
1745799357536,EDS 204R,B01,895693,Halter; Christopher P.,18,0,45,27
1745799358561,EDS 206R,A00,895694,Fargason; Sharon Gayle,9,0,30,21
1745799358561,EDS 206R,B00,895695,Choi; Bailey Miyeon,20,0,30,10
1745799359586,EDS 250,A00,895697,Hemans; Patricia Ann Benitez,43,0,45,2
1745799360615,EDS 281,A00,895701,Meyerott; Theresa Ann,15,0,15,0
1745799361641,EDS 284,A00,895736,Meyerott; Theresa Ann,15,0,15,0
1745799362668,EDS 286,A00,897210,Fine; Sarah,15,0,15,0
1745799363695,EDS 289C,A01,895770,Daly; Alan J.,15,0,15,0
1745799364721,EDS 290,A00,897211,Hofstetter; Carolyn,15,0,15,0
1745799365746,LIGM 5A,A00,896162,Fischer-Grunski; Eva K,15,0,20,5
1745799366775,LIGM 5B,A00,896260,Fischer-Grunski; Eva K,17,0,20,3
1745799367800,LIGM 5C,A00,896308,Fischer-Grunski; Eva K,18,0,20,2
1745799368826,LIIT 5AS,A00,896313,Carnelos; Chiara,18,0,20,2
1745799369853,LIIT 5BS,A00,896416,Carnelos; Chiara,20,0,20,0
1745799370881,LIIT 5CS,A00,896564,Carnelos; Chiara,20,0,20,0
1745799371907,LISP 5A,A00,896588,Munoz Sanchez; Alicia,4,0,20,16
1745799372933,LISP 5B,A00,896653,Munoz Sanchez; Alicia,10,0,20,10
1745799373959,LISP 5C,A00,896655,Munoz Sanchez; Alicia,4,0,20,16
1745799374984,MAE 197,001,957918,Kleissl; Jan,9998,0,9999,1
1745799376010,MATH 2,A01,957937,Staff,34,0,35,1
1745799377037,MATH 197,001,957876,Kedlaya; Kiran S.,9993,0,9999,6
1745799378062,MCWP 40,A00,892729,Duru; Nur,13,0,20,7
1745799378062,MCWP 40,B00,893304,Montejo; Carolina,20,0,20,0
1745799379090,MCWP 40R,A00,893757,Redela; Pamela Morgan,0,6,20,20
1745799380118,MCWP 50,A00,893758,Morshed; Michael James,2,0,20,18
1745799380118,MCWP 50,B00,893761,Bartulis; Jason Michael,17,0,20,3
1745799381143,MCWP 50R,A00,893766,Compas; Sean Matthew,0,1,20,20
1745799381143,MCWP 50R,B00,893769,Carter; Jennifer A,0,0,20,20
1745799381143,MCWP 50R,C00,893771,Krone; Jarret,0,3,20,20
1745799381143,MCWP 50R,D00,893772,Miller; Elizabeth Deen,3,0,20,17
1745799381143,MCWP 50R,E00,893775,Carter; Andrea L,0,0,20,20
1745799382169,MMW 11R,A01,892721,Herbst; Matthew,11,0,27,16
1745799382169,MMW 11R,A02,892722,Herbst; Matthew,0,0,0,3
1745799383195,MMW 12R,A01,892724,Herbst; Matthew,0,9,16,16
1745799383195,MMW 12R,A02,892725,Herbst; Matthew,0,9,16,16
1745799384225,MMW 13R,A01,892727,Staff,0,4,16,16
1745799384225,MMW 13R,A02,892728,Staff,0,4,16,16
1745799384225,MMW 13R,A03,958032,Staff,0,3,16,16
1745799384225,MMW 13R,A04,958033,Staff,0,2,16,16
1745799384225,MMW 13R,A05,958034,Staff,0,3,16,16
1745799385254,SIO 295LS,A00,894015,Staff,7,0,25,18
1745799386283,SIO 295S,A00,894020,Staff,7,0,25,18
1745799387309,SIOC 290S,B01,958918,Staff,0,0,0,0
1745799388333,SIOC 291S,B01,958922,Staff,0,0,0,0
1745799389359,SOCI 117,A01,895339,Staff,4,0,5,1
1745799390388,WES 237B,A00,894149,Staff,11,0,20,9
1745799392453,AESE 279B,A00,891859,Staff,13,0,35,22
1745799393479,AIP 197,001,891854,Staff,70,0,70,0
1745799394503,ANTH 289S,A00,891856,Gagneux; Pascal,12,0,12,0
1745799395527,BENG 196,001,957946,Engler; Adam J.,9996,0,9999,3
1745799396553,CAT 124RS,A01,956906,Staff,8,0,25,17
1745799397577,CAT 125RS,A01,922013,Staff,8,0,25,17
1745799398606,CLRE 250,A00,891860,Morris; Sheldon,9995,0,9999,4
1745799400657,CLRE 251R,A00,907817,Mehta; Ravindra L.,9994,0,9999,5
1745799401683,CLRE 252,A00,891864,Cuomo; Raphael Eduardo,9993,0,9999,6
1745799402713,CLRE 253,A00,891867,Vaida; Florin,9994,0,9999,5
1745799402713,CLRE 253,B00,907819,Staff,9999,0,9999,0
1745799403742,CLRE 259,A00,891868,Patel; Hemal,9998,0,9999,1
1745799404771,CLRE 260,A00,891872,Cuomo; Raphael Eduardo,9999,0,9999,0
1745799405798,CLRE 297,001,891888,Cuomo; Raphael Eduardo,9999,0,9999,0
1745799406823,CSE 191,A00,958773,Minnes Kemp; Mor Mia,9999,0,9999,0
1745799407852,CSS 201S,A01,892054,Mignozzetti; Umberto,30,0,30,0
1745799408878,CSS 202S,A01,892056,Mignozzetti; Umberto,30,0,30,0
1745799409902,DSC 197,001,956898,Eldridge; Justin Matthew,9998,0,9999,1
1745799410931,DSC 297,001,958000,Mazumdar; Arya,9998,0,9999,1
1745799411956,EAP 100,A00,905686,Staff,9776,0,9999,223
1745799412983,ECE 45,A01,892618,Staff,0,12,50,50
1745799414013,ECE 109,A01,892620,Staff,0,43,0,0
1745799415039,ECE 111,A01,892719,Staff,0,7,50,50
1745799416064,ECE 197,001,957920,Mercier; Patrick Philip,9992,0,9999,7
1745799417090,ECON 178,A01,907814,Zhu; Ying,28,0,35,7
1745799418115,EDS 115,A00,895312,Staff,41,0,45,4
1745799419142,EDS 117,A01,895337,Staff,30,0,30,0
1745799420171,EDS 125,A00,895341,Jones; Gabrielle Anastasia,43,0,45,2
1745799421196,EDS 128A,A01,895459,Fargason; Sharon Gayle,44,0,45,1
1745799422224,EDS 128B,A01,895543,Pappas; Elizabeth,44,0,45,1
1745799423250,EDS 139,A00,897203,Pappas; Elizabeth,44,0,45,1
1745799423250,EDS 139,B00,897209,Fargason; Sharon Gayle,44,0,45,1
1745799424275,EDS 201,A00,895545,Staff,43,0,45,2
1745799425305,EDS 203,A01,895581,Halter; Christopher P.,43,0,45,2
1745799426333,EDS 204R,A01,895625,Heinzman; Erica M.,43,0,45,2
1745799426333,EDS 204R,B01,895693,Halter; Christopher P.,18,0,45,27
1745799427360,EDS 206R,A00,895694,Fargason; Sharon Gayle,9,0,30,21
1745799427360,EDS 206R,B00,895695,Choi; Bailey Miyeon,20,0,30,10
1745799428385,EDS 250,A00,895697,Hemans; Patricia Ann Benitez,43,0,45,2
1745799429413,EDS 281,A00,895701,Meyerott; Theresa Ann,15,0,15,0
1745799430439,EDS 284,A00,895736,Meyerott; Theresa Ann,15,0,15,0
1745799431466,EDS 286,A00,897210,Fine; Sarah,15,0,15,0
1745799432492,EDS 289C,A01,895770,Daly; Alan J.,15,0,15,0
1745799433521,EDS 290,A00,897211,Hofstetter; Carolyn,15,0,15,0
1745799434549,LIGM 5A,A00,896162,Fischer-Grunski; Eva K,15,0,20,5
1745799435577,LIGM 5B,A00,896260,Fischer-Grunski; Eva K,17,0,20,3
1745799436602,LIGM 5C,A00,896308,Fischer-Grunski; Eva K,18,0,20,2
1745799437628,LIIT 5AS,A00,896313,Carnelos; Chiara,18,0,20,2
1745799438658,LIIT 5BS,A00,896416,Carnelos; Chiara,20,0,20,0
1745799439686,LIIT 5CS,A00,896564,Carnelos; Chiara,20,0,20,0
1745799440714,LISP 5A,A00,896588,Munoz Sanchez; Alicia,4,0,20,16
1745799441742,LISP 5B,A00,896653,Munoz Sanchez; Alicia,10,0,20,10
1745799442771,LISP 5C,A00,896655,Munoz Sanchez; Alicia,4,0,20,16
1745799443795,MAE 197,001,957918,Kleissl; Jan,9998,0,9999,1
1745799444823,MATH 2,A01,957937,Staff,34,0,35,1
1745799445848,MATH 197,001,957876,Kedlaya; Kiran S.,9993,0,9999,6
1745799446876,MCWP 40,A00,892729,Duru; Nur,13,0,20,7
1745799446876,MCWP 40,B00,893304,Montejo; Carolina,20,0,20,0
1745799447904,MCWP 40R,A00,893757,Redela; Pamela Morgan,0,6,20,20
1745799448933,MCWP 50,A00,893758,Morshed; Michael James,2,0,20,18
1745799448933,MCWP 50,B00,893761,Bartulis; Jason Michael,17,0,20,3
1745799449959,MCWP 50R,A00,893766,Compas; Sean Matthew,0,1,20,20
1745799449959,MCWP 50R,B00,893769,Carter; Jennifer A,0,0,20,20
1745799449959,MCWP 50R,C00,893771,Krone; Jarret,0,3,20,20
1745799449959,MCWP 50R,D00,893772,Miller; Elizabeth Deen,3,0,20,17
1745799449959,MCWP 50R,E00,893775,Carter; Andrea L,0,0,20,20
1745799450986,MMW 11R,A01,892721,Herbst; Matthew,11,0,27,16
1745799450986,MMW 11R,A02,892722,Herbst; Matthew,0,0,0,3
1745799452013,MMW 12R,A01,892724,Herbst; Matthew,0,9,16,16
1745799452013,MMW 12R,A02,892725,Herbst; Matthew,0,9,16,16
1745799453041,MMW 13R,A01,892727,Staff,0,4,16,16
1745799453041,MMW 13R,A02,892728,Staff,0,4,16,16
1745799453041,MMW 13R,A03,958032,Staff,0,3,16,16
1745799453041,MMW 13R,A04,958033,Staff,0,2,16,16
1745799453041,MMW 13R,A05,958034,Staff,0,3,16,16
1745799454070,SIO 295LS,A00,894015,Staff,7,0,25,18
1745799455097,SIO 295S,A00,894020,Staff,7,0,25,18
1745799456123,SIOC 290S,B01,958918,Staff,0,0,0,0
1745799457152,SIOC 291S,B01,958922,Staff,0,0,0,0
1745799458175,SOCI 117,A01,895339,Staff,4,0,5,1
1745799459200,WES 237B,A00,894149,Staff,11,0,20,9
1745799461257,AESE 279B,A00,891859,Staff,13,0,35,22
1745799462284,AIP 197,001,891854,Staff,70,0,70,0
1745799463308,ANTH 289S,A00,891856,Gagneux; Pascal,12,0,12,0
1745799464333,BENG 196,001,957946,Engler; Adam J.,9996,0,9999,3
1745799465357,CAT 124RS,A01,956906,Staff,8,0,25,17
1745799466382,CAT 125RS,A01,922013,Staff,8,0,25,17
1745799467410,CLRE 250,A00,891860,Morris; Sheldon,9995,0,9999,4
1745799469502,CLRE 251R,A00,907817,Mehta; Ravindra L.,9994,0,9999,5
1745799470527,CLRE 252,A00,891864,Cuomo; Raphael Eduardo,9993,0,9999,6
1745799471553,CLRE 253,A00,891867,Vaida; Florin,9994,0,9999,5
1745799471553,CLRE 253,B00,907819,Staff,9999,0,9999,0
1745799472578,CLRE 259,A00,891868,Patel; Hemal,9998,0,9999,1
1745799473603,CLRE 260,A00,891872,Cuomo; Raphael Eduardo,9999,0,9999,0
1745799474632,CLRE 297,001,891888,Cuomo; Raphael Eduardo,9999,0,9999,0
1745799475657,CSE 191,A00,958773,Minnes Kemp; Mor Mia,9999,0,9999,0
1745799476682,CSS 201S,A01,892054,Mignozzetti; Umberto,30,0,30,0
1745799477711,CSS 202S,A01,892056,Mignozzetti; Umberto,30,0,30,0
1745799478735,DSC 197,001,956898,Eldridge; Justin Matthew,9998,0,9999,1
1745799479766,DSC 297,001,958000,Mazumdar; Arya,9998,0,9999,1
1745799480794,EAP 100,A00,905686,Staff,9776,0,9999,223
1745799481822,ECE 45,A01,892618,Staff,0,12,50,50
1745799482849,ECE 109,A01,892620,Staff,0,43,0,0
1745799483874,ECE 111,A01,892719,Staff,0,7,50,50
1745799484899,ECE 197,001,957920,Mercier; Patrick Philip,9992,0,9999,7
1745799485929,ECON 178,A01,907814,Zhu; Ying,28,0,35,7
1745799486957,EDS 115,A00,895312,Staff,41,0,45,4
1745799487983,EDS 117,A01,895337,Staff,30,0,30,0
1745799489013,EDS 125,A00,895341,Jones; Gabrielle Anastasia,43,0,45,2
1745799490038,EDS 128A,A01,895459,Fargason; Sharon Gayle,44,0,45,1
1745799491065,EDS 128B,A01,895543,Pappas; Elizabeth,44,0,45,1
1745799492093,EDS 139,A00,897203,Pappas; Elizabeth,44,0,45,1
1745799492093,EDS 139,B00,897209,Fargason; Sharon Gayle,44,0,45,1
1745799493121,EDS 201,A00,895545,Staff,43,0,45,2
1745799494150,EDS 203,A01,895581,Halter; Christopher P.,43,0,45,2
1745799495174,EDS 204R,A01,895625,Heinzman; Erica M.,43,0,45,2
1745799495174,EDS 204R,B01,895693,Halter; Christopher P.,18,0,45,27
1745799496202,EDS 206R,A00,895694,Fargason; Sharon Gayle,9,0,30,21
1745799496202,EDS 206R,B00,895695,Choi; Bailey Miyeon,20,0,30,10
1745799497231,EDS 250,A00,895697,Hemans; Patricia Ann Benitez,43,0,45,2
1745799498257,EDS 281,A00,895701,Meyerott; Theresa Ann,15,0,15,0
1745799499282,EDS 284,A00,895736,Meyerott; Theresa Ann,15,0,15,0
1745799500311,EDS 286,A00,897210,Fine; Sarah,15,0,15,0
1745799501337,EDS 289C,A01,895770,Daly; Alan J.,15,0,15,0
1745799502364,EDS 290,A00,897211,Hofstetter; Carolyn,15,0,15,0
1745799503391,LIGM 5A,A00,896162,Fischer-Grunski; Eva K,15,0,20,5
1745799504420,LIGM 5B,A00,896260,Fischer-Grunski; Eva K,17,0,20,3
1745799505446,LIGM 5C,A00,896308,Fischer-Grunski; Eva K,18,0,20,2
1745799506475,LIIT 5AS,A00,896313,Carnelos; Chiara,18,0,20,2
1745799507501,LIIT 5BS,A00,896416,Carnelos; Chiara,20,0,20,0
1745799508525,LIIT 5CS,A00,896564,Carnelos; Chiara,20,0,20,0
1745799509551,LISP 5A,A00,896588,Munoz Sanchez; Alicia,4,0,20,16
1745799510579,LISP 5B,A00,896653,Munoz Sanchez; Alicia,10,0,20,10
1745799511608,LISP 5C,A00,896655,Munoz Sanchez; Alicia,4,0,20,16
1745799512634,MAE 197,001,957918,Kleissl; Jan,9998,0,9999,1
1745799513659,MATH 2,A01,957937,Staff,34,0,35,1
1745799514686,MATH 197,001,957876,Kedlaya; Kiran S.,9993,0,9999,6
1745799515713,MCWP 40,A00,892729,Duru; Nur,13,0,20,7
1745799515713,MCWP 40,B00,893304,Montejo; Carolina,20,0,20,0
1745799516743,MCWP 40R,A00,893757,Redela; Pamela Morgan,0,6,20,20
1745799517768,MCWP 50,A00,893758,Morshed; Michael James,2,0,20,18
1745799517768,MCWP 50,B00,893761,Bartulis; Jason Michael,17,0,20,3
1745799518795,MCWP 50R,A00,893766,Compas; Sean Matthew,0,1,20,20
1745799518795,MCWP 50R,B00,893769,Carter; Jennifer A,0,0,20,20
1745799518795,MCWP 50R,C00,893771,Krone; Jarret,0,3,20,20
1745799518795,MCWP 50R,D00,893772,Miller; Elizabeth Deen,3,0,20,17
1745799518795,MCWP 50R,E00,893775,Carter; Andrea L,0,0,20,20
1745799519820,MMW 11R,A01,892721,Herbst; Matthew,11,0,27,16
1745799519820,MMW 11R,A02,892722,Herbst; Matthew,0,0,0,3
1745799520843,MMW 12R,A01,892724,Herbst; Matthew,0,9,16,16
1745799520843,MMW 12R,A02,892725,Herbst; Matthew,0,9,16,16
1745799521871,MMW 13R,A01,892727,Staff,0,4,16,16
1745799521871,MMW 13R,A02,892728,Staff,0,4,16,16
1745799521871,MMW 13R,A03,958032,Staff,0,3,16,16
1745799521871,MMW 13R,A04,958033,Staff,0,2,16,16
1745799521871,MMW 13R,A05,958034,Staff,0,3,16,16
1745799522897,SIO 295LS,A00,894015,Staff,7,0,25,18
1745799523925,SIO 295S,A00,894020,Staff,7,0,25,18
1745799524954,SIOC 290S,B01,958918,Staff,0,0,0,0
1745799525980,SIOC 291S,B01,958922,Staff,0,0,0,0
1745799527007,SOCI 117,A01,895339,Staff,4,0,5,1
1745799528034,WES 237B,A00,894149,Staff,11,0,20,9
1745799530111,AESE 279B,A00,891859,Staff,13,0,35,22
1745799531137,AIP 197,001,891854,Staff,70,0,70,0
1745799532163,ANTH 289S,A00,891856,Gagneux; Pascal,12,0,12,0
1745799533190,BENG 196,001,957946,Engler; Adam J.,9996,0,9999,3
1745799534216,CAT 124RS,A01,956906,Staff,8,0,25,17
1745799535244,CAT 125RS,A01,922013,Staff,8,0,25,17
1745799536271,CLRE 250,A00,891860,Morris; Sheldon,9995,0,9999,4
1745799538326,CLRE 251R,A00,907817,Mehta; Ravindra L.,9994,0,9999,5
1745799539353,CLRE 252,A00,891864,Cuomo; Raphael Eduardo,9993,0,9999,6
1745799540383,CLRE 253,A00,891867,Vaida; Florin,9994,0,9999,5
1745799540383,CLRE 253,B00,907819,Staff,9999,0,9999,0
1745799541408,CLRE 259,A00,891868,Patel; Hemal,9998,0,9999,1
1745799542434,CLRE 260,A00,891872,Cuomo; Raphael Eduardo,9999,0,9999,0
1745799543462,CLRE 297,001,891888,Cuomo; Raphael Eduardo,9999,0,9999,0
1745799544488,CSE 191,A00,958773,Minnes Kemp; Mor Mia,9999,0,9999,0
1745799545517,CSS 201S,A01,892054,Mignozzetti; Umberto,30,0,30,0
1745799546541,CSS 202S,A01,892056,Mignozzetti; Umberto,30,0,30,0
1745799547565,DSC 197,001,956898,Eldridge; Justin Matthew,9998,0,9999,1
1745799548591,DSC 297,001,958000,Mazumdar; Arya,9998,0,9999,1
1745799549616,EAP 100,A00,905686,Staff,9776,0,9999,223
1745799550646,ECE 45,A01,892618,Staff,0,12,50,50
1745799551672,ECE 109,A01,892620,Staff,0,43,0,0
1745799552701,ECE 111,A01,892719,Staff,0,7,50,50
1745799553727,ECE 197,001,957920,Mercier; Patrick Philip,9992,0,9999,7
1745799554755,ECON 178,A01,907814,Zhu; Ying,28,0,35,7
1745799555782,EDS 115,A00,895312,Staff,41,0,45,4
1745799556807,EDS 117,A01,895337,Staff,30,0,30,0
1745799557833,EDS 125,A00,895341,Jones; Gabrielle Anastasia,43,0,45,2
1745799558859,EDS 128A,A01,895459,Fargason; Sharon Gayle,44,0,45,1
1745799559888,EDS 128B,A01,895543,Pappas; Elizabeth,44,0,45,1
1745799560914,EDS 139,A00,897203,Pappas; Elizabeth,44,0,45,1
1745799560914,EDS 139,B00,897209,Fargason; Sharon Gayle,44,0,45,1
1745799561940,EDS 201,A00,895545,Staff,43,0,45,2
1745799562965,EDS 203,A01,895581,Halter; Christopher P.,43,0,45,2
1745799563994,EDS 204R,A01,895625,Heinzman; Erica M.,43,0,45,2
1745799563994,EDS 204R,B01,895693,Halter; Christopher P.,18,0,45,27
1745799565019,EDS 206R,A00,895694,Fargason; Sharon Gayle,9,0,30,21
1745799565019,EDS 206R,B00,895695,Choi; Bailey Miyeon,20,0,30,10
1745799566047,EDS 250,A00,895697,Hemans; Patricia Ann Benitez,43,0,45,2
1745799567073,EDS 281,A00,895701,Meyerott; Theresa Ann,15,0,15,0
1745799568102,EDS 284,A00,895736,Meyerott; Theresa Ann,15,0,15,0
1745799569129,EDS 286,A00,897210,Fine; Sarah,15,0,15,0
1745799570153,EDS 289C,A01,895770,Daly; Alan J.,15,0,15,0
1745799571261,EDS 290,A00,897211,Hofstetter; Carolyn,15,0,15,0
1745799572346,LIGM 5A,A00,896162,Fischer-Grunski; Eva K,15,0,20,5
1745799573372,LIGM 5B,A00,896260,Fischer-Grunski; Eva K,17,0,20,3
1745799574399,LIGM 5C,A00,896308,Fischer-Grunski; Eva K,18,0,20,2
1745799575426,LIIT 5AS,A00,896313,Carnelos; Chiara,18,0,20,2
1745799576453,LIIT 5BS,A00,896416,Carnelos; Chiara,20,0,20,0
1745799577479,LIIT 5CS,A00,896564,Carnelos; Chiara,20,0,20,0
1745799578504,LISP 5A,A00,896588,Munoz Sanchez; Alicia,4,0,20,16
1745799579528,LISP 5B,A00,896653,Munoz Sanchez; Alicia,10,0,20,10
1745799580558,LISP 5C,A00,896655,Munoz Sanchez; Alicia,4,0,20,16
1745799581606,MAE 197,001,957918,Kleissl; Jan,9998,0,9999,1
1745799582632,MATH 2,A01,957937,Staff,34,0,35,1
1745799583662,MATH 197,001,957876,Kedlaya; Kiran S.,9993,0,9999,6
1745799584689,MCWP 40,A00,892729,Duru; Nur,13,0,20,7
1745799584689,MCWP 40,B00,893304,Montejo; Carolina,20,0,20,0
1745799585717,MCWP 40R,A00,893757,Redela; Pamela Morgan,0,6,20,20
1745799586746,MCWP 50,A00,893758,Morshed; Michael James,2,0,20,18
1745799586746,MCWP 50,B00,893761,Bartulis; Jason Michael,17,0,20,3
1745799587771,MCWP 50R,A00,893766,Compas; Sean Matthew,0,1,20,20
1745799587771,MCWP 50R,B00,893769,Carter; Jennifer A,0,0,20,20
1745799587771,MCWP 50R,C00,893771,Krone; Jarret,0,3,20,20
1745799587771,MCWP 50R,D00,893772,Miller; Elizabeth Deen,3,0,20,17
1745799587771,MCWP 50R,E00,893775,Carter; Andrea L,0,0,20,20
1745799588797,MMW 11R,A01,892721,Herbst; Matthew,11,0,27,16
1745799588797,MMW 11R,A02,892722,Herbst; Matthew,0,0,0,3
1745799589822,MMW 12R,A01,892724,Herbst; Matthew,0,9,16,16
1745799589822,MMW 12R,A02,892725,Herbst; Matthew,0,9,16,16
1745799590850,MMW 13R,A01,892727,Staff,0,4,16,16
1745799590850,MMW 13R,A02,892728,Staff,0,4,16,16
1745799590850,MMW 13R,A03,958032,Staff,0,3,16,16
1745799590850,MMW 13R,A04,958033,Staff,0,2,16,16
1745799590850,MMW 13R,A05,958034,Staff,0,3,16,16
1745799591876,SIO 295LS,A00,894015,Staff,7,0,25,18
1745799592902,SIO 295S,A00,894020,Staff,7,0,25,18
1745799593929,SIOC 290S,B01,958918,Staff,0,0,0,0
1745799594953,SIOC 291S,B01,958922,Staff,0,0,0,0
1745799595979,SOCI 117,A01,895339,Staff,4,0,5,1
1745799597007,WES 237B,A00,894149,Staff,11,0,20,9
1745799599072,AESE 279B,A00,891859,Staff,13,0,35,22
1745799600097,AIP 197,001,891854,Staff,70,0,70,0
1745799601124,ANTH 289S,A00,891856,Gagneux; Pascal,12,0,12,0
1745799602150,BENG 196,001,957946,Engler; Adam J.,9996,0,9999,3
1745799603177,CAT 124RS,A01,956906,Staff,8,0,25,17
1745799604205,CAT 125RS,A01,922013,Staff,8,0,25,17
1745799605233,CLRE 250,A00,891860,Morris; Sheldon,9995,0,9999,4
1745799607286,CLRE 251R,A00,907817,Mehta; Ravindra L.,9994,0,9999,5
1745799608312,CLRE 252,A00,891864,Cuomo; Raphael Eduardo,9993,0,9999,6
1745799609339,CLRE 253,A00,891867,Vaida; Florin,9994,0,9999,5
1745799609339,CLRE 253,B00,907819,Staff,9999,0,9999,0
1745799610366,CLRE 259,A00,891868,Patel; Hemal,9998,0,9999,1
1745799611393,CLRE 260,A00,891872,Cuomo; Raphael Eduardo,9999,0,9999,0
1745799612419,CLRE 297,001,891888,Cuomo; Raphael Eduardo,9999,0,9999,0
1745799613444,CSE 191,A00,958773,Minnes Kemp; Mor Mia,9999,0,9999,0
1745799614470,CSS 201S,A01,892054,Mignozzetti; Umberto,30,0,30,0
1745799615498,CSS 202S,A01,892056,Mignozzetti; Umberto,30,0,30,0
1745799616523,DSC 197,001,956898,Eldridge; Justin Matthew,9998,0,9999,1
1745799617551,DSC 297,001,958000,Mazumdar; Arya,9998,0,9999,1
1745799618580,EAP 100,A00,905686,Staff,9776,0,9999,223
1745799619606,ECE 45,A01,892618,Staff,0,12,50,50
1745799620632,ECE 109,A01,892620,Staff,0,43,0,0
1745799621658,ECE 111,A01,892719,Staff,0,7,50,50
1745799622683,ECE 197,001,957920,Mercier; Patrick Philip,9992,0,9999,7
1745799623712,ECON 178,A01,907814,Zhu; Ying,28,0,35,7
1745799624737,EDS 115,A00,895312,Staff,41,0,45,4
1745799625764,EDS 117,A01,895337,Staff,30,0,30,0
1745799626789,EDS 125,A00,895341,Jones; Gabrielle Anastasia,43,0,45,2
1745799627815,EDS 128A,A01,895459,Fargason; Sharon Gayle,44,0,45,1
1745799628843,EDS 128B,A01,895543,Pappas; Elizabeth,44,0,45,1
1745799629869,EDS 139,A00,897203,Pappas; Elizabeth,44,0,45,1
1745799629869,EDS 139,B00,897209,Fargason; Sharon Gayle,44,0,45,1
1745799630896,EDS 201,A00,895545,Staff,43,0,45,2
1745799631921,EDS 203,A01,895581,Halter; Christopher P.,43,0,45,2
1745799632950,EDS 204R,A01,895625,Heinzman; Erica M.,43,0,45,2
1745799632950,EDS 204R,B01,895693,Halter; Christopher P.,18,0,45,27
1745799633976,EDS 206R,A00,895694,Fargason; Sharon Gayle,9,0,30,21
1745799633976,EDS 206R,B00,895695,Choi; Bailey Miyeon,20,0,30,10
1745799635002,EDS 250,A00,895697,Hemans; Patricia Ann Benitez,43,0,45,2
1745799636031,EDS 281,A00,895701,Meyerott; Theresa Ann,15,0,15,0
1745799637060,EDS 284,A00,895736,Meyerott; Theresa Ann,15,0,15,0
1745799638088,EDS 286,A00,897210,Fine; Sarah,15,0,15,0
1745799639113,EDS 289C,A01,895770,Daly; Alan J.,15,0,15,0
1745799640141,EDS 290,A00,897211,Hofstetter; Carolyn,15,0,15,0
1745799641170,LIGM 5A,A00,896162,Fischer-Grunski; Eva K,15,0,20,5
1745799642200,LIGM 5B,A00,896260,Fischer-Grunski; Eva K,17,0,20,3
1745799643225,LIGM 5C,A00,896308,Fischer-Grunski; Eva K,18,0,20,2
1745799644251,LIIT 5AS,A00,896313,Carnelos; Chiara,18,0,20,2
1745799645278,LIIT 5BS,A00,896416,Carnelos; Chiara,20,0,20,0
1745799646305,LIIT 5CS,A00,896564,Carnelos; Chiara,20,0,20,0
1745799647330,LISP 5A,A00,896588,Munoz Sanchez; Alicia,4,0,20,16
1745799648357,LISP 5B,A00,896653,Munoz Sanchez; Alicia,10,0,20,10
1745799649383,LISP 5C,A00,896655,Munoz Sanchez; Alicia,4,0,20,16
1745799650409,MAE 197,001,957918,Kleissl; Jan,9998,0,9999,1
1745799651435,MATH 2,A01,957937,Staff,34,0,35,1
1745799652459,MATH 197,001,957876,Kedlaya; Kiran S.,9993,0,9999,6
1745799653485,MCWP 40,A00,892729,Duru; Nur,13,0,20,7
1745799653485,MCWP 40,B00,893304,Montejo; Carolina,20,0,20,0
1745799654510,MCWP 40R,A00,893757,Redela; Pamela Morgan,0,6,20,20
1745799655536,MCWP 50,A00,893758,Morshed; Michael James,2,0,20,18
1745799655536,MCWP 50,B00,893761,Bartulis; Jason Michael,17,0,20,3
1745799656562,MCWP 50R,A00,893766,Compas; Sean Matthew,0,1,20,20
1745799656562,MCWP 50R,B00,893769,Carter; Jennifer A,0,0,20,20
1745799656562,MCWP 50R,C00,893771,Krone; Jarret,0,3,20,20
1745799656562,MCWP 50R,D00,893772,Miller; Elizabeth Deen,3,0,20,17
1745799656562,MCWP 50R,E00,893775,Carter; Andrea L,0,0,20,20
1745799657589,MMW 11R,A01,892721,Herbst; Matthew,11,0,27,16
1745799657589,MMW 11R,A02,892722,Herbst; Matthew,0,0,0,3
1745799658616,MMW 12R,A01,892724,Herbst; Matthew,0,9,16,16
1745799658616,MMW 12R,A02,892725,Herbst; Matthew,0,9,16,16
1745799659642,MMW 13R,A01,892727,Staff,0,4,16,16
1745799659642,MMW 13R,A02,892728,Staff,0,4,16,16
1745799659642,MMW 13R,A03,958032,Staff,0,3,16,16
1745799659642,MMW 13R,A04,958033,Staff,0,2,16,16
1745799659642,MMW 13R,A05,958034,Staff,0,3,16,16
1745799660668,SIO 295LS,A00,894015,Staff,7,0,25,18
1745799661692,SIO 295S,A00,894020,Staff,7,0,25,18
1745799662723,SIOC 290S,B01,958918,Staff,0,0,0,0
1745799663749,SIOC 291S,B01,958922,Staff,0,0,0,0
1745799664773,SOCI 117,A01,895339,Staff,4,0,5,1
1745799665801,WES 237B,A00,894149,Staff,11,0,20,9
1745799667864,AESE 279B,A00,891859,Staff,13,0,35,22
1745799668892,AIP 197,001,891854,Staff,70,0,70,0
1745799669918,ANTH 289S,A00,891856,Gagneux; Pascal,12,0,12,0
1745799670946,BENG 196,001,957946,Engler; Adam J.,9996,0,9999,3
1745799671972,CAT 124RS,A01,956906,Staff,8,0,25,17
1745799672997,CAT 125RS,A01,922013,Staff,8,0,25,17
1745799674023,CLRE 250,A00,891860,Morris; Sheldon,9995,0,9999,4
1745799676114,CLRE 251R,A00,907817,Mehta; Ravindra L.,9994,0,9999,5
1745799677142,CLRE 252,A00,891864,Cuomo; Raphael Eduardo,9993,0,9999,6
1745799678171,CLRE 253,A00,891867,Vaida; Florin,9994,0,9999,5
1745799678171,CLRE 253,B00,907819,Staff,9999,0,9999,0
1745799679199,CLRE 259,A00,891868,Patel; Hemal,9998,0,9999,1
1745799680228,CLRE 260,A00,891872,Cuomo; Raphael Eduardo,9999,0,9999,0
1745799681254,CLRE 297,001,891888,Cuomo; Raphael Eduardo,9999,0,9999,0
1745799682279,CSE 191,A00,958773,Minnes Kemp; Mor Mia,9999,0,9999,0
1745799683310,CSS 201S,A01,892054,Mignozzetti; Umberto,30,0,30,0
1745799684344,CSS 202S,A01,892056,Mignozzetti; Umberto,30,0,30,0
1745799685369,DSC 197,001,956898,Eldridge; Justin Matthew,9998,0,9999,1
1745799686398,DSC 297,001,958000,Mazumdar; Arya,9998,0,9999,1
1745799687425,EAP 100,A00,905686,Staff,9776,0,9999,223
1745799688449,ECE 45,A01,892618,Staff,0,12,50,50
1745799689476,ECE 109,A01,892620,Staff,0,43,0,0
1745799690505,ECE 111,A01,892719,Staff,0,7,50,50
1745799691533,ECE 197,001,957920,Mercier; Patrick Philip,9992,0,9999,7
1745799692562,ECON 178,A01,907814,Zhu; Ying,28,0,35,7
1745799693590,EDS 115,A00,895312,Staff,41,0,45,4
1745799694619,EDS 117,A01,895337,Staff,30,0,30,0
1745799695645,EDS 125,A00,895341,Jones; Gabrielle Anastasia,43,0,45,2
1745799696674,EDS 128A,A01,895459,Fargason; Sharon Gayle,44,0,45,1
1745799697704,EDS 128B,A01,895543,Pappas; Elizabeth,44,0,45,1
1745799698729,EDS 139,A00,897203,Pappas; Elizabeth,44,0,45,1
1745799698729,EDS 139,B00,897209,Fargason; Sharon Gayle,44,0,45,1
1745799699759,EDS 201,A00,895545,Staff,43,0,45,2
1745799700787,EDS 203,A01,895581,Halter; Christopher P.,43,0,45,2
1745799701816,EDS 204R,A01,895625,Heinzman; Erica M.,43,0,45,2
1745799701816,EDS 204R,B01,895693,Halter; Christopher P.,18,0,45,27
1745799702841,EDS 206R,A00,895694,Fargason; Sharon Gayle,9,0,30,21
1745799702841,EDS 206R,B00,895695,Choi; Bailey Miyeon,20,0,30,10
1745799703868,EDS 250,A00,895697,Hemans; Patricia Ann Benitez,43,0,45,2
1745799704894,EDS 281,A00,895701,Meyerott; Theresa Ann,15,0,15,0
1745799705919,EDS 284,A00,895736,Meyerott; Theresa Ann,15,0,15,0
1745799706946,EDS 286,A00,897210,Fine; Sarah,15,0,15,0
1745799707971,EDS 289C,A01,895770,Daly; Alan J.,15,0,15,0
1745799708997,EDS 290,A00,897211,Hofstetter; Carolyn,15,0,15,0
1745799710025,LIGM 5A,A00,896162,Fischer-Grunski; Eva K,15,0,20,5
1745799711050,LIGM 5B,A00,896260,Fischer-Grunski; Eva K,17,0,20,3
1745799712080,LIGM 5C,A00,896308,Fischer-Grunski; Eva K,18,0,20,2
1745799713110,LIIT 5AS,A00,896313,Carnelos; Chiara,18,0,20,2
1745799714135,LIIT 5BS,A00,896416,Carnelos; Chiara,20,0,20,0
1745799715161,LIIT 5CS,A00,896564,Carnelos; Chiara,20,0,20,0
1745799716186,LISP 5A,A00,896588,Munoz Sanchez; Alicia,4,0,20,16
1745799717211,LISP 5B,A00,896653,Munoz Sanchez; Alicia,10,0,20,10
1745799718237,LISP 5C,A00,896655,Munoz Sanchez; Alicia,4,0,20,16
1745799719264,MAE 197,001,957918,Kleissl; Jan,9998,0,9999,1
1745799720293,MATH 2,A01,957937,Staff,34,0,35,1
1745799721319,MATH 197,001,957876,Kedlaya; Kiran S.,9993,0,9999,6
1745799722345,MCWP 40,A00,892729,Duru; Nur,13,0,20,7
1745799722345,MCWP 40,B00,893304,Montejo; Carolina,20,0,20,0
1745799723372,MCWP 40R,A00,893757,Redela; Pamela Morgan,0,6,20,20
1745799724399,MCWP 50,A00,893758,Morshed; Michael James,2,0,20,18
1745799724399,MCWP 50,B00,893761,Bartulis; Jason Michael,17,0,20,3
1745799725428,MCWP 50R,A00,893766,Compas; Sean Matthew,0,1,20,20
1745799725428,MCWP 50R,B00,893769,Carter; Jennifer A,0,0,20,20
1745799725428,MCWP 50R,C00,893771,Krone; Jarret,0,3,20,20
1745799725428,MCWP 50R,D00,893772,Miller; Elizabeth Deen,3,0,20,17
1745799725428,MCWP 50R,E00,893775,Carter; Andrea L,0,0,20,20
1745799726455,MMW 11R,A01,892721,Herbst; Matthew,11,0,27,16
1745799726455,MMW 11R,A02,892722,Herbst; Matthew,0,0,0,3
1745799727479,MMW 12R,A01,892724,Herbst; Matthew,0,9,16,16
1745799727479,MMW 12R,A02,892725,Herbst; Matthew,0,9,16,16
1745799728505,MMW 13R,A01,892727,Staff,0,4,16,16
1745799728505,MMW 13R,A02,892728,Staff,0,4,16,16
1745799728505,MMW 13R,A03,958032,Staff,0,3,16,16
1745799728505,MMW 13R,A04,958033,Staff,0,2,16,16
1745799728505,MMW 13R,A05,958034,Staff,0,3,16,16
1745799729531,SIO 295LS,A00,894015,Staff,7,0,25,18
1745799730555,SIO 295S,A00,894020,Staff,7,0,25,18
1745799731585,SIOC 290S,B01,958918,Staff,0,0,0,0
1745799732615,SIOC 291S,B01,958922,Staff,0,0,0,0
1745799733641,SOCI 117,A01,895339,Staff,4,0,5,1
1745799734667,WES 237B,A00,894149,Staff,11,0,20,9
1745799736723,AESE 279B,A00,891859,Staff,13,0,35,22
1745799737749,AIP 197,001,891854,Staff,70,0,70,0
1745799738774,ANTH 289S,A00,891856,Gagneux; Pascal,12,0,12,0
1745799739801,BENG 196,001,957946,Engler; Adam J.,9996,0,9999,3
1745799740827,CAT 124RS,A01,956906,Staff,8,0,25,17
1745799741854,CAT 125RS,A01,922013,Staff,8,0,25,17
1745799742880,CLRE 250,A00,891860,Morris; Sheldon,9995,0,9999,4
1745799744933,CLRE 251R,A00,907817,Mehta; Ravindra L.,9994,0,9999,5
1745799745958,CLRE 252,A00,891864,Cuomo; Raphael Eduardo,9993,0,9999,6
1745799746984,CLRE 253,A00,891867,Vaida; Florin,9994,0,9999,5
1745799746984,CLRE 253,B00,907819,Staff,9999,0,9999,0
1745799748013,CLRE 259,A00,891868,Patel; Hemal,9998,0,9999,1
1745799749040,CLRE 260,A00,891872,Cuomo; Raphael Eduardo,9999,0,9999,0
1745799750071,CLRE 297,001,891888,Cuomo; Raphael Eduardo,9999,0,9999,0
1745799751097,CSE 191,A00,958773,Minnes Kemp; Mor Mia,9999,0,9999,0
1745799752124,CSS 201S,A01,892054,Mignozzetti; Umberto,30,0,30,0
1745799753153,CSS 202S,A01,892056,Mignozzetti; Umberto,30,0,30,0
1745799754177,DSC 197,001,956898,Eldridge; Justin Matthew,9998,0,9999,1
1745799755203,DSC 297,001,958000,Mazumdar; Arya,9998,0,9999,1
1745799756231,EAP 100,A00,905686,Staff,9776,0,9999,223
1745799757259,ECE 45,A01,892618,Staff,0,12,50,50
1745799758284,ECE 109,A01,892620,Staff,0,43,0,0
1745799759321,ECE 111,A01,892719,Staff,0,7,50,50
1745799760347,ECE 197,001,957920,Mercier; Patrick Philip,9992,0,9999,7
1745799761374,ECON 178,A01,907814,Zhu; Ying,28,0,35,7
1745799762398,EDS 115,A00,895312,Staff,41,0,45,4
1745799763427,EDS 117,A01,895337,Staff,30,0,30,0
1745799764455,EDS 125,A00,895341,Jones; Gabrielle Anastasia,43,0,45,2
1745799765481,EDS 128A,A01,895459,Fargason; Sharon Gayle,44,0,45,1
1745799766505,EDS 128B,A01,895543,Pappas; Elizabeth,44,0,45,1
1745799767531,EDS 139,A00,897203,Pappas; Elizabeth,44,0,45,1
1745799767531,EDS 139,B00,897209,Fargason; Sharon Gayle,44,0,45,1
1745799768559,EDS 201,A00,895545,Staff,43,0,45,2
1745799769586,EDS 203,A01,895581,Halter; Christopher P.,43,0,45,2
1745799770611,EDS 204R,A01,895625,Heinzman; Erica M.,43,0,45,2
1745799770611,EDS 204R,B01,895693,Halter; Christopher P.,18,0,45,27
1745799771638,EDS 206R,A00,895694,Fargason; Sharon Gayle,9,0,30,21
1745799771638,EDS 206R,B00,895695,Choi; Bailey Miyeon,20,0,30,10
1745799772664,EDS 250,A00,895697,Hemans; Patricia Ann Benitez,43,0,45,2
1745799773690,EDS 281,A00,895701,Meyerott; Theresa Ann,15,0,15,0
1745799774717,EDS 284,A00,895736,Meyerott; Theresa Ann,15,0,15,0
1745799775745,EDS 286,A00,897210,Fine; Sarah,15,0,15,0
1745799776774,EDS 289C,A01,895770,Daly; Alan J.,15,0,15,0
1745799777799,EDS 290,A00,897211,Hofstetter; Carolyn,15,0,15,0
1745799778824,LIGM 5A,A00,896162,Fischer-Grunski; Eva K,15,0,20,5
1745799779851,LIGM 5B,A00,896260,Fischer-Grunski; Eva K,17,0,20,3
1745799780881,LIGM 5C,A00,896308,Fischer-Grunski; Eva K,18,0,20,2
1745799781906,LIIT 5AS,A00,896313,Carnelos; Chiara,18,0,20,2
1745799782936,LIIT 5BS,A00,896416,Carnelos; Chiara,20,0,20,0
1745799783964,LIIT 5CS,A00,896564,Carnelos; Chiara,20,0,20,0
1745799784990,LISP 5A,A00,896588,Munoz Sanchez; Alicia,4,0,20,16
1745799786015,LISP 5B,A00,896653,Munoz Sanchez; Alicia,10,0,20,10
1745799787041,LISP 5C,A00,896655,Munoz Sanchez; Alicia,4,0,20,16
1745799788070,MAE 197,001,957918,Kleissl; Jan,9998,0,9999,1
1745799789095,MATH 2,A01,957937,Staff,34,0,35,1
1745799790121,MATH 197,001,957876,Kedlaya; Kiran S.,9993,0,9999,6
1745799791147,MCWP 40,A00,892729,Duru; Nur,13,0,20,7
1745799791147,MCWP 40,B00,893304,Montejo; Carolina,20,0,20,0
1745799792173,MCWP 40R,A00,893757,Redela; Pamela Morgan,0,6,20,20
1745799793198,MCWP 50,A00,893758,Morshed; Michael James,2,0,20,18
1745799793198,MCWP 50,B00,893761,Bartulis; Jason Michael,17,0,20,3
1745799794229,MCWP 50R,A00,893766,Compas; Sean Matthew,0,1,20,20
1745799794229,MCWP 50R,B00,893769,Carter; Jennifer A,0,0,20,20
1745799794229,MCWP 50R,C00,893771,Krone; Jarret,0,3,20,20
1745799794229,MCWP 50R,D00,893772,Miller; Elizabeth Deen,3,0,20,17
1745799794229,MCWP 50R,E00,893775,Carter; Andrea L,0,0,20,20
1745799795257,MMW 11R,A01,892721,Herbst; Matthew,11,0,27,16
1745799795257,MMW 11R,A02,892722,Herbst; Matthew,0,0,0,3
1745799796285,MMW 12R,A01,892724,Herbst; Matthew,0,9,16,16
1745799796285,MMW 12R,A02,892725,Herbst; Matthew,0,9,16,16
1745799797312,MMW 13R,A01,892727,Staff,0,4,16,16
1745799797312,MMW 13R,A02,892728,Staff,0,4,16,16
1745799797312,MMW 13R,A03,958032,Staff,0,3,16,16
1745799797312,MMW 13R,A04,958033,Staff,0,2,16,16
1745799797312,MMW 13R,A05,958034,Staff,0,3,16,16
1745799798341,SIO 295LS,A00,894015,Staff,7,0,25,18
1745799799369,SIO 295S,A00,894020,Staff,7,0,25,18
1745799800396,SIOC 290S,B01,958918,Staff,0,0,0,0
1745799801426,SIOC 291S,B01,958922,Staff,0,0,0,0
1745799802454,SOCI 117,A01,895339,Staff,4,0,5,1
1745799803482,WES 237B,A00,894149,Staff,11,0,20,9
1745799805547,AESE 279B,A00,891859,Staff,13,0,35,22
1745799806573,AIP 197,001,891854,Staff,70,0,70,0
1745799807600,ANTH 289S,A00,891856,Gagneux; Pascal,12,0,12,0
1745799808627,BENG 196,001,957946,Engler; Adam J.,9996,0,9999,3
1745799809654,CAT 124RS,A01,956906,Staff,8,0,25,17
1745799810679,CAT 125RS,A01,922013,Staff,8,0,25,17
1745799811705,CLRE 250,A00,891860,Morris; Sheldon,9995,0,9999,4
1745799813758,CLRE 251R,A00,907817,Mehta; Ravindra L.,9994,0,9999,5
1745799814784,CLRE 252,A00,891864,Cuomo; Raphael Eduardo,9993,0,9999,6
1745799815811,CLRE 253,A00,891867,Vaida; Florin,9994,0,9999,5
1745799815811,CLRE 253,B00,907819,Staff,9999,0,9999,0
1745799816838,CLRE 259,A00,891868,Patel; Hemal,9998,0,9999,1
1745799817863,CLRE 260,A00,891872,Cuomo; Raphael Eduardo,9999,0,9999,0
1745799818888,CLRE 297,001,891888,Cuomo; Raphael Eduardo,9999,0,9999,0
1745799819914,CSE 191,A00,958773,Minnes Kemp; Mor Mia,9999,0,9999,0
1745799820944,CSS 201S,A01,892054,Mignozzetti; Umberto,30,0,30,0
1745799821969,CSS 202S,A01,892056,Mignozzetti; Umberto,30,0,30,0
1745799822996,DSC 197,001,956898,Eldridge; Justin Matthew,9998,0,9999,1
1745799824023,DSC 297,001,958000,Mazumdar; Arya,9998,0,9999,1
1745799825049,EAP 100,A00,905686,Staff,9776,0,9999,223
1745799826077,ECE 45,A01,892618,Staff,0,12,50,50
1745799827104,ECE 109,A01,892620,Staff,0,43,0,0
1745799828133,ECE 111,A01,892719,Staff,0,7,50,50
1745799829160,ECE 197,001,957920,Mercier; Patrick Philip,9992,0,9999,7
1745799830190,ECON 178,A01,907814,Zhu; Ying,28,0,35,7
1745799831216,EDS 115,A00,895312,Staff,41,0,45,4
1745799832244,EDS 117,A01,895337,Staff,30,0,30,0
1745799833271,EDS 125,A00,895341,Jones; Gabrielle Anastasia,43,0,45,2
1745799834297,EDS 128A,A01,895459,Fargason; Sharon Gayle,44,0,45,1
1745799835323,EDS 128B,A01,895543,Pappas; Elizabeth,44,0,45,1
1745799836352,EDS 139,A00,897203,Pappas; Elizabeth,44,0,45,1
1745799836352,EDS 139,B00,897209,Fargason; Sharon Gayle,44,0,45,1
1745799837378,EDS 201,A00,895545,Staff,43,0,45,2
1745799838407,EDS 203,A01,895581,Halter; Christopher P.,43,0,45,2
1745799839433,EDS 204R,A01,895625,Heinzman; Erica M.,43,0,45,2
1745799839433,EDS 204R,B01,895693,Halter; Christopher P.,18,0,45,27
1745799840457,EDS 206R,A00,895694,Fargason; Sharon Gayle,9,0,30,21
1745799840457,EDS 206R,B00,895695,Choi; Bailey Miyeon,20,0,30,10
1745799841485,EDS 250,A00,895697,Hemans; Patricia Ann Benitez,43,0,45,2
1745799842512,EDS 281,A00,895701,Meyerott; Theresa Ann,15,0,15,0
1745799843541,EDS 284,A00,895736,Meyerott; Theresa Ann,15,0,15,0
1745799844570,EDS 286,A00,897210,Fine; Sarah,15,0,15,0
1745799845597,EDS 289C,A01,895770,Daly; Alan J.,15,0,15,0
1745799846623,EDS 290,A00,897211,Hofstetter; Carolyn,15,0,15,0
1745799847647,LIGM 5A,A00,896162,Fischer-Grunski; Eva K,15,0,20,5
1745799848675,LIGM 5B,A00,896260,Fischer-Grunski; Eva K,17,0,20,3
1745799849700,LIGM 5C,A00,896308,Fischer-Grunski; Eva K,18,0,20,2
1745799850731,LIIT 5AS,A00,896313,Carnelos; Chiara,18,0,20,2
1745799851757,LIIT 5BS,A00,896416,Carnelos; Chiara,20,0,20,0
1745799852782,LIIT 5CS,A00,896564,Carnelos; Chiara,20,0,20,0
1745799853809,LISP 5A,A00,896588,Munoz Sanchez; Alicia,4,0,20,16
1745799854839,LISP 5B,A00,896653,Munoz Sanchez; Alicia,10,0,20,10
1745799855868,LISP 5C,A00,896655,Munoz Sanchez; Alicia,4,0,20,16
1745799856895,MAE 197,001,957918,Kleissl; Jan,9998,0,9999,1
1745799857921,MATH 2,A01,957937,Staff,34,0,35,1
1745799858946,MATH 197,001,957876,Kedlaya; Kiran S.,9993,0,9999,6
1745799859976,MCWP 40,A00,892729,Duru; Nur,13,0,20,7
1745799859976,MCWP 40,B00,893304,Montejo; Carolina,20,0,20,0
1745799861003,MCWP 40R,A00,893757,Redela; Pamela Morgan,0,6,20,20
1745799862029,MCWP 50,A00,893758,Morshed; Michael James,2,0,20,18
1745799862029,MCWP 50,B00,893761,Bartulis; Jason Michael,17,0,20,3
1745799863057,MCWP 50R,A00,893766,Compas; Sean Matthew,0,1,20,20
1745799863057,MCWP 50R,B00,893769,Carter; Jennifer A,0,0,20,20
1745799863057,MCWP 50R,C00,893771,Krone; Jarret,0,3,20,20
1745799863057,MCWP 50R,D00,893772,Miller; Elizabeth Deen,3,0,20,17
1745799863057,MCWP 50R,E00,893775,Carter; Andrea L,0,0,20,20
1745799864082,MMW 11R,A01,892721,Herbst; Matthew,11,0,27,16
1745799864082,MMW 11R,A02,892722,Herbst; Matthew,0,0,0,3
1745799865109,MMW 12R,A01,892724,Herbst; Matthew,0,9,16,16
1745799865109,MMW 12R,A02,892725,Herbst; Matthew,0,9,16,16
1745799866138,MMW 13R,A01,892727,Staff,0,4,16,16
1745799866138,MMW 13R,A02,892728,Staff,0,4,16,16
1745799866138,MMW 13R,A03,958032,Staff,0,3,16,16
1745799866138,MMW 13R,A04,958033,Staff,0,2,16,16
1745799866138,MMW 13R,A05,958034,Staff,0,3,16,16
1745799867163,SIO 295LS,A00,894015,Staff,7,0,25,18
1745799868186,SIO 295S,A00,894020,Staff,7,0,25,18
1745799869217,SIOC 290S,B01,958918,Staff,0,0,0,0
1745799870248,SIOC 291S,B01,958922,Staff,0,0,0,0
1745799871276,SOCI 117,A01,895339,Staff,4,0,5,1
1745799872305,WES 237B,A00,894149,Staff,11,0,20,9
1745799874364,AESE 279B,A00,891859,Staff,13,0,35,22
1745799875390,AIP 197,001,891854,Staff,70,0,70,0
1745799876417,ANTH 289S,A00,891856,Gagneux; Pascal,12,0,12,0
1745799877440,BENG 196,001,957946,Engler; Adam J.,9996,0,9999,3
1745799878469,CAT 124RS,A01,956906,Staff,8,0,25,17
1745799879496,CAT 125RS,A01,922013,Staff,8,0,25,17
1745799880525,CLRE 250,A00,891860,Morris; Sheldon,9995,0,9999,4
1745799882578,CLRE 251R,A00,907817,Mehta; Ravindra L.,9994,0,9999,5
1745799883647,CLRE 252,A00,891864,Cuomo; Raphael Eduardo,9993,0,9999,6
1745799884673,CLRE 253,A00,891867,Vaida; Florin,9994,0,9999,5
1745799884673,CLRE 253,B00,907819,Staff,9999,0,9999,0
1745799885700,CLRE 259,A00,891868,Patel; Hemal,9998,0,9999,1
1745799886725,CLRE 260,A00,891872,Cuomo; Raphael Eduardo,9999,0,9999,0
1745799887753,CLRE 297,001,891888,Cuomo; Raphael Eduardo,9999,0,9999,0
1745799888778,CSE 191,A00,958773,Minnes Kemp; Mor Mia,9999,0,9999,0
1745799889805,CSS 201S,A01,892054,Mignozzetti; Umberto,30,0,30,0
1745799890831,CSS 202S,A01,892056,Mignozzetti; Umberto,30,0,30,0
1745799891857,DSC 197,001,956898,Eldridge; Justin Matthew,9998,0,9999,1
1745799892884,DSC 297,001,958000,Mazumdar; Arya,9998,0,9999,1
1745799893911,EAP 100,A00,905686,Staff,9776,0,9999,223
1745799894938,ECE 45,A01,892618,Staff,0,12,50,50
1745799895966,ECE 109,A01,892620,Staff,0,43,0,0
1745799896993,ECE 111,A01,892719,Staff,0,7,50,50
1745799898018,ECE 197,001,957920,Mercier; Patrick Philip,9992,0,9999,7
1745799899048,ECON 178,A01,907814,Zhu; Ying,28,0,35,7
1745799900075,EDS 115,A00,895312,Staff,41,0,45,4
1745799901113,EDS 117,A01,895337,Staff,30,0,30,0
1745799902148,EDS 125,A00,895341,Jones; Gabrielle Anastasia,43,0,45,2
1745799903175,EDS 128A,A01,895459,Fargason; Sharon Gayle,44,0,45,1
1745799904202,EDS 128B,A01,895543,Pappas; Elizabeth,44,0,45,1
1745799905229,EDS 139,A00,897203,Pappas; Elizabeth,44,0,45,1
1745799905229,EDS 139,B00,897209,Fargason; Sharon Gayle,44,0,45,1
1745799906255,EDS 201,A00,895545,Staff,43,0,45,2
1745799907282,EDS 203,A01,895581,Halter; Christopher P.,43,0,45,2
1745799908307,EDS 204R,A01,895625,Heinzman; Erica M.,43,0,45,2
1745799908307,EDS 204R,B01,895693,Halter; Christopher P.,18,0,45,27
1745799909335,EDS 206R,A00,895694,Fargason; Sharon Gayle,9,0,30,21
1745799909335,EDS 206R,B00,895695,Choi; Bailey Miyeon,20,0,30,10
1745799910361,EDS 250,A00,895697,Hemans; Patricia Ann Benitez,43,0,45,2
1745799911387,EDS 281,A00,895701,Meyerott; Theresa Ann,15,0,15,0
1745799912413,EDS 284,A00,895736,Meyerott; Theresa Ann,15,0,15,0
1745799913437,EDS 286,A00,897210,Fine; Sarah,15,0,15,0
1745799914464,EDS 289C,A01,895770,Daly; Alan J.,15,0,15,0
1745799915492,EDS 290,A00,897211,Hofstetter; Carolyn,15,0,15,0
1745799916518,LIGM 5A,A00,896162,Fischer-Grunski; Eva K,15,0,20,5
1745799917541,LIGM 5B,A00,896260,Fischer-Grunski; Eva K,17,0,20,3
1745799918570,LIGM 5C,A00,896308,Fischer-Grunski; Eva K,18,0,20,2
1745799919597,LIIT 5AS,A00,896313,Carnelos; Chiara,18,0,20,2
1745799920626,LIIT 5BS,A00,896416,Carnelos; Chiara,20,0,20,0
1745799921656,LIIT 5CS,A00,896564,Carnelos; Chiara,20,0,20,0
1745799922682,LISP 5A,A00,896588,Munoz Sanchez; Alicia,4,0,20,16
1745799923709,LISP 5B,A00,896653,Munoz Sanchez; Alicia,10,0,20,10
1745799924734,LISP 5C,A00,896655,Munoz Sanchez; Alicia,4,0,20,16
1745799925760,MAE 197,001,957918,Kleissl; Jan,9998,0,9999,1
1745799926786,MATH 2,A01,957937,Staff,34,0,35,1
1745799927811,MATH 197,001,957876,Kedlaya; Kiran S.,9993,0,9999,6
1745799928837,MCWP 40,A00,892729,Duru; Nur,13,0,20,7
1745799928837,MCWP 40,B00,893304,Montejo; Carolina,20,0,20,0
1745799929863,MCWP 40R,A00,893757,Redela; Pamela Morgan,0,6,20,20
1745799930891,MCWP 50,A00,893758,Morshed; Michael James,2,0,20,18
1745799930891,MCWP 50,B00,893761,Bartulis; Jason Michael,17,0,20,3
1745799931921,MCWP 50R,A00,893766,Compas; Sean Matthew,0,1,20,20
1745799931921,MCWP 50R,B00,893769,Carter; Jennifer A,0,0,20,20
1745799931921,MCWP 50R,C00,893771,Krone; Jarret,0,3,20,20
1745799931921,MCWP 50R,D00,893772,Miller; Elizabeth Deen,3,0,20,17
1745799931921,MCWP 50R,E00,893775,Carter; Andrea L,0,0,20,20
1745799932945,MMW 11R,A01,892721,Herbst; Matthew,11,0,27,16
1745799932945,MMW 11R,A02,892722,Herbst; Matthew,0,0,0,3
1745799933971,MMW 12R,A01,892724,Herbst; Matthew,0,9,16,16
1745799933971,MMW 12R,A02,892725,Herbst; Matthew,0,9,16,16
1745799934997,MMW 13R,A01,892727,Staff,0,4,16,16
1745799934997,MMW 13R,A02,892728,Staff,0,4,16,16
1745799934997,MMW 13R,A03,958032,Staff,0,3,16,16
1745799934997,MMW 13R,A04,958033,Staff,0,2,16,16
1745799934997,MMW 13R,A05,958034,Staff,0,3,16,16
1745799936021,SIO 295LS,A00,894015,Staff,7,0,25,18
1745799937047,SIO 295S,A00,894020,Staff,7,0,25,18
1745799938076,SIOC 290S,B01,958918,Staff,0,0,0,0
1745799939101,SIOC 291S,B01,958922,Staff,0,0,0,0
1745799940129,SOCI 117,A01,895339,Staff,4,0,5,1
1745799941155,WES 237B,A00,894149,Staff,11,0,20,9
1745799943212,AESE 279B,A00,891859,Staff,13,0,35,22
1745799944237,AIP 197,001,891854,Staff,70,0,70,0
1745799945263,ANTH 289S,A00,891856,Gagneux; Pascal,12,0,12,0
1745799946290,BENG 196,001,957946,Engler; Adam J.,9996,0,9999,3
1745799947319,CAT 124RS,A01,956906,Staff,8,0,25,17
1745799948346,CAT 125RS,A01,922013,Staff,8,0,25,17
1745799949372,CLRE 250,A00,891860,Morris; Sheldon,9995,0,9999,4
1745799951426,CLRE 251R,A00,907817,Mehta; Ravindra L.,9994,0,9999,5
1745799952451,CLRE 252,A00,891864,Cuomo; Raphael Eduardo,9993,0,9999,6
1745799953480,CLRE 253,A00,891867,Vaida; Florin,9994,0,9999,5
1745799953480,CLRE 253,B00,907819,Staff,9999,0,9999,0
1745799954504,CLRE 259,A00,891868,Patel; Hemal,9998,0,9999,1
1745799955528,CLRE 260,A00,891872,Cuomo; Raphael Eduardo,9999,0,9999,0
1745799956555,CLRE 297,001,891888,Cuomo; Raphael Eduardo,9999,0,9999,0
1745799957582,CSE 191,A00,958773,Minnes Kemp; Mor Mia,9999,0,9999,0
1745799958606,CSS 201S,A01,892054,Mignozzetti; Umberto,30,0,30,0
1745799959632,CSS 202S,A01,892056,Mignozzetti; Umberto,30,0,30,0
1745799960661,DSC 197,001,956898,Eldridge; Justin Matthew,9998,0,9999,1
1745799961687,DSC 297,001,958000,Mazumdar; Arya,9998,0,9999,1
1745799962713,EAP 100,A00,905686,Staff,9776,0,9999,223
1745799963738,ECE 45,A01,892618,Staff,0,12,50,50
1745799964766,ECE 109,A01,892620,Staff,0,43,0,0
1745799965791,ECE 111,A01,892719,Staff,0,7,50,50
1745799966817,ECE 197,001,957920,Mercier; Patrick Philip,9992,0,9999,7
1745799967843,ECON 178,A01,907814,Zhu; Ying,28,0,35,7
1745799968871,EDS 115,A00,895312,Staff,41,0,45,4
1745799969898,EDS 117,A01,895337,Staff,30,0,30,0
1745799970928,EDS 125,A00,895341,Jones; Gabrielle Anastasia,43,0,45,2
1745799971956,EDS 128A,A01,895459,Fargason; Sharon Gayle,44,0,45,1
1745799972983,EDS 128B,A01,895543,Pappas; Elizabeth,44,0,45,1
1745799974010,EDS 139,A00,897203,Pappas; Elizabeth,44,0,45,1
1745799974010,EDS 139,B00,897209,Fargason; Sharon Gayle,44,0,45,1
1745799975034,EDS 201,A00,895545,Staff,43,0,45,2
1745799976062,EDS 203,A01,895581,Halter; Christopher P.,43,0,45,2
1745799977088,EDS 204R,A01,895625,Heinzman; Erica M.,43,0,45,2
1745799977088,EDS 204R,B01,895693,Halter; Christopher P.,18,0,45,27
1745799978112,EDS 206R,A00,895694,Fargason; Sharon Gayle,9,0,30,21
1745799978112,EDS 206R,B00,895695,Choi; Bailey Miyeon,20,0,30,10
1745799979140,EDS 250,A00,895697,Hemans; Patricia Ann Benitez,43,0,45,2
1745799980167,EDS 281,A00,895701,Meyerott; Theresa Ann,15,0,15,0
1745799981196,EDS 284,A00,895736,Meyerott; Theresa Ann,15,0,15,0
1745799982221,EDS 286,A00,897210,Fine; Sarah,15,0,15,0
1745799983246,EDS 289C,A01,895770,Daly; Alan J.,15,0,15,0
1745799984274,EDS 290,A00,897211,Hofstetter; Carolyn,15,0,15,0
1745799985318,LIGM 5A,A00,896162,Fischer-Grunski; Eva K,15,0,20,5
1745799986345,LIGM 5B,A00,896260,Fischer-Grunski; Eva K,17,0,20,3
1745799987413,LIGM 5C,A00,896308,Fischer-Grunski; Eva K,18,0,20,2
1745799988441,LIIT 5AS,A00,896313,Carnelos; Chiara,18,0,20,2
1745799989468,LIIT 5BS,A00,896416,Carnelos; Chiara,20,0,20,0
1745799990498,LIIT 5CS,A00,896564,Carnelos; Chiara,20,0,20,0
1745799991525,LISP 5A,A00,896588,Munoz Sanchez; Alicia,4,0,20,16
1745799992550,LISP 5B,A00,896653,Munoz Sanchez; Alicia,10,0,20,10
1745799993579,LISP 5C,A00,896655,Munoz Sanchez; Alicia,4,0,20,16
1745799994605,MAE 197,001,957918,Kleissl; Jan,9998,0,9999,1
1745799995631,MATH 2,A01,957937,Staff,34,0,35,1
1745799996658,MATH 197,001,957876,Kedlaya; Kiran S.,9993,0,9999,6
1745799997682,MCWP 40,A00,892729,Duru; Nur,13,0,20,7
1745799997682,MCWP 40,B00,893304,Montejo; Carolina,20,0,20,0
1745799998708,MCWP 40R,A00,893757,Redela; Pamela Morgan,0,6,20,20
1745799999732,MCWP 50,A00,893758,Morshed; Michael James,2,0,20,18
1745799999732,MCWP 50,B00,893761,Bartulis; Jason Michael,17,0,20,3
1745800000759,MCWP 50R,A00,893766,Compas; Sean Matthew,0,1,20,20
1745800000759,MCWP 50R,B00,893769,Carter; Jennifer A,0,0,20,20
1745800000759,MCWP 50R,C00,893771,Krone; Jarret,0,3,20,20
1745800000759,MCWP 50R,D00,893772,Miller; Elizabeth Deen,3,0,20,17
1745800000759,MCWP 50R,E00,893775,Carter; Andrea L,0,0,20,20
1745800001784,MMW 11R,A01,892721,Herbst; Matthew,11,0,27,16
1745800001784,MMW 11R,A02,892722,Herbst; Matthew,0,0,0,3
1745800002810,MMW 12R,A01,892724,Herbst; Matthew,0,9,16,16
1745800002810,MMW 12R,A02,892725,Herbst; Matthew,0,9,16,16
1745800003837,MMW 13R,A01,892727,Staff,0,4,16,16
1745800003837,MMW 13R,A02,892728,Staff,0,4,16,16
1745800003837,MMW 13R,A03,958032,Staff,0,3,16,16
1745800003837,MMW 13R,A04,958033,Staff,0,2,16,16
1745800003837,MMW 13R,A05,958034,Staff,0,3,16,16
1745800004868,SIO 295LS,A00,894015,Staff,7,0,25,18
1745800005896,SIO 295S,A00,894020,Staff,7,0,25,18
1745800006922,SIOC 290S,B01,958918,Staff,0,0,0,0
1745800007949,SIOC 291S,B01,958922,Staff,0,0,0,0
1745800008978,SOCI 117,A01,895339,Staff,4,0,5,1
1745800010003,WES 237B,A00,894149,Staff,11,0,20,9
1745800012068,AESE 279B,A00,891859,Staff,13,0,35,22
1745800013094,AIP 197,001,891854,Staff,70,0,70,0
1745800014119,ANTH 289S,A00,891856,Gagneux; Pascal,12,0,12,0
1745800015145,BENG 196,001,957946,Engler; Adam J.,9996,0,9999,3
1745800016173,CAT 124RS,A01,956906,Staff,8,0,25,17
1745800017199,CAT 125RS,A01,922013,Staff,8,0,25,17
1745800018226,CLRE 250,A00,891860,Morris; Sheldon,9995,0,9999,4
1745800020280,CLRE 251R,A00,907817,Mehta; Ravindra L.,9994,0,9999,5
1745800021306,CLRE 252,A00,891864,Cuomo; Raphael Eduardo,9993,0,9999,6
1745800022335,CLRE 253,A00,891867,Vaida; Florin,9994,0,9999,5
1745800022335,CLRE 253,B00,907819,Staff,9999,0,9999,0
1745800023363,CLRE 259,A00,891868,Patel; Hemal,9998,0,9999,1
1745800024388,CLRE 260,A00,891872,Cuomo; Raphael Eduardo,9999,0,9999,0
1745800025413,CLRE 297,001,891888,Cuomo; Raphael Eduardo,9999,0,9999,0
1745800026439,CSE 191,A00,958773,Minnes Kemp; Mor Mia,9999,0,9999,0
1745800027465,CSS 201S,A01,892054,Mignozzetti; Umberto,30,0,30,0
1745800028494,CSS 202S,A01,892056,Mignozzetti; Umberto,30,0,30,0
1745800029518,DSC 197,001,956898,Eldridge; Justin Matthew,9998,0,9999,1
1745800030546,DSC 297,001,958000,Mazumdar; Arya,9998,0,9999,1
1745800031575,EAP 100,A00,905686,Staff,9776,0,9999,223
1745800032603,ECE 45,A01,892618,Staff,0,12,50,50
1745800033628,ECE 109,A01,892620,Staff,0,43,0,0
1745800034654,ECE 111,A01,892719,Staff,0,7,50,50
1745800035681,ECE 197,001,957920,Mercier; Patrick Philip,9992,0,9999,7
1745800036706,ECON 178,A01,907814,Zhu; Ying,28,0,35,7
1745800037732,EDS 115,A00,895312,Staff,41,0,45,4
1745800038761,EDS 117,A01,895337,Staff,30,0,30,0
1745800039790,EDS 125,A00,895341,Jones; Gabrielle Anastasia,43,0,45,2
1745800040815,EDS 128A,A01,895459,Fargason; Sharon Gayle,44,0,45,1
1745800041840,EDS 128B,A01,895543,Pappas; Elizabeth,44,0,45,1
1745800042869,EDS 139,A00,897203,Pappas; Elizabeth,44,0,45,1
1745800042869,EDS 139,B00,897209,Fargason; Sharon Gayle,44,0,45,1
1745800043895,EDS 201,A00,895545,Staff,43,0,45,2
1745800044921,EDS 203,A01,895581,Halter; Christopher P.,43,0,45,2
1745800045949,EDS 204R,A01,895625,Heinzman; Erica M.,43,0,45,2
1745800045949,EDS 204R,B01,895693,Halter; Christopher P.,18,0,45,27
1745800046976,EDS 206R,A00,895694,Fargason; Sharon Gayle,9,0,30,21
1745800046976,EDS 206R,B00,895695,Choi; Bailey Miyeon,20,0,30,10
1745800048003,EDS 250,A00,895697,Hemans; Patricia Ann Benitez,43,0,45,2
1745800049029,EDS 281,A00,895701,Meyerott; Theresa Ann,15,0,15,0
1745800050059,EDS 284,A00,895736,Meyerott; Theresa Ann,15,0,15,0
1745800051085,EDS 286,A00,897210,Fine; Sarah,15,0,15,0
1745800052111,EDS 289C,A01,895770,Daly; Alan J.,15,0,15,0
1745800053135,EDS 290,A00,897211,Hofstetter; Carolyn,15,0,15,0
1745800054161,LIGM 5A,A00,896162,Fischer-Grunski; Eva K,15,0,20,5
1745800055189,LIGM 5B,A00,896260,Fischer-Grunski; Eva K,17,0,20,3
1745800056218,LIGM 5C,A00,896308,Fischer-Grunski; Eva K,18,0,20,2
1745800057247,LIIT 5AS,A00,896313,Carnelos; Chiara,18,0,20,2
1745800058274,LIIT 5BS,A00,896416,Carnelos; Chiara,20,0,20,0
1745800059300,LIIT 5CS,A00,896564,Carnelos; Chiara,20,0,20,0
1745800060328,LISP 5A,A00,896588,Munoz Sanchez; Alicia,4,0,20,16
1745800061355,LISP 5B,A00,896653,Munoz Sanchez; Alicia,10,0,20,10
1745800062394,LISP 5C,A00,896655,Munoz Sanchez; Alicia,4,0,20,16
1745800063421,MAE 197,001,957918,Kleissl; Jan,9998,0,9999,1
1745800064450,MATH 2,A01,957937,Staff,34,0,35,1
1745800065477,MATH 197,001,957876,Kedlaya; Kiran S.,9993,0,9999,6
1745800066502,MCWP 40,A00,892729,Duru; Nur,13,0,20,7
1745800066502,MCWP 40,B00,893304,Montejo; Carolina,20,0,20,0
1745800067527,MCWP 40R,A00,893757,Redela; Pamela Morgan,0,6,20,20
1745800068552,MCWP 50,A00,893758,Morshed; Michael James,2,0,20,18
1745800068552,MCWP 50,B00,893761,Bartulis; Jason Michael,17,0,20,3
1745800069577,MCWP 50R,A00,893766,Compas; Sean Matthew,0,1,20,20
1745800069577,MCWP 50R,B00,893769,Carter; Jennifer A,0,0,20,20
1745800069577,MCWP 50R,C00,893771,Krone; Jarret,0,3,20,20
1745800069577,MCWP 50R,D00,893772,Miller; Elizabeth Deen,3,0,20,17
1745800069577,MCWP 50R,E00,893775,Carter; Andrea L,0,0,20,20
1745800070602,MMW 11R,A01,892721,Herbst; Matthew,11,0,27,16
1745800070602,MMW 11R,A02,892722,Herbst; Matthew,0,0,0,3
1745800071628,MMW 12R,A01,892724,Herbst; Matthew,0,9,16,16
1745800071628,MMW 12R,A02,892725,Herbst; Matthew,0,9,16,16
1745800072656,MMW 13R,A01,892727,Staff,0,4,16,16
1745800072656,MMW 13R,A02,892728,Staff,0,4,16,16
1745800072656,MMW 13R,A03,958032,Staff,0,3,16,16
1745800072656,MMW 13R,A04,958033,Staff,0,2,16,16
1745800072656,MMW 13R,A05,958034,Staff,0,3,16,16
1745800073681,SIO 295LS,A00,894015,Staff,7,0,25,18
1745800074711,SIO 295S,A00,894020,Staff,7,0,25,18
1745800075737,SIOC 290S,B01,958918,Staff,0,0,0,0
1745800076763,SIOC 291S,B01,958922,Staff,0,0,0,0
1745800077792,SOCI 117,A01,895339,Staff,4,0,5,1
1745800078817,WES 237B,A00,894149,Staff,11,0,20,9
1745800080876,AESE 279B,A00,891859,Staff,13,0,35,22
1745800081903,AIP 197,001,891854,Staff,70,0,70,0
1745800082929,ANTH 289S,A00,891856,Gagneux; Pascal,12,0,12,0
1745800083957,BENG 196,001,957946,Engler; Adam J.,9996,0,9999,3
1745800084986,CAT 124RS,A01,956906,Staff,8,0,25,17
1745800086012,CAT 125RS,A01,922013,Staff,8,0,25,17
1745800087037,CLRE 250,A00,891860,Morris; Sheldon,9995,0,9999,4
1745800089089,CLRE 251R,A00,907817,Mehta; Ravindra L.,9994,0,9999,5
1745800090117,CLRE 252,A00,891864,Cuomo; Raphael Eduardo,9993,0,9999,6
1745800091142,CLRE 253,A00,891867,Vaida; Florin,9994,0,9999,5
1745800091142,CLRE 253,B00,907819,Staff,9999,0,9999,0
1745800092167,CLRE 259,A00,891868,Patel; Hemal,9998,0,9999,1
1745800093193,CLRE 260,A00,891872,Cuomo; Raphael Eduardo,9999,0,9999,0
1745800094219,CLRE 297,001,891888,Cuomo; Raphael Eduardo,9999,0,9999,0
1745800095244,CSE 191,A00,958773,Minnes Kemp; Mor Mia,9999,0,9999,0
1745800096270,CSS 201S,A01,892054,Mignozzetti; Umberto,30,0,30,0
1745800097299,CSS 202S,A01,892056,Mignozzetti; Umberto,30,0,30,0
1745800098325,DSC 197,001,956898,Eldridge; Justin Matthew,9998,0,9999,1
1745800099354,DSC 297,001,958000,Mazumdar; Arya,9998,0,9999,1
1745800100381,EAP 100,A00,905686,Staff,9776,0,9999,223
1745800101409,ECE 45,A01,892618,Staff,0,12,50,50
1745800102439,ECE 109,A01,892620,Staff,0,43,0,0
1745800103467,ECE 111,A01,892719,Staff,0,7,50,50
1745800104493,ECE 197,001,957920,Mercier; Patrick Philip,9992,0,9999,7
1745800105522,ECON 178,A01,907814,Zhu; Ying,28,0,35,7
1745800106548,EDS 115,A00,895312,Staff,41,0,45,4
1745800107576,EDS 117,A01,895337,Staff,30,0,30,0
1745800108602,EDS 125,A00,895341,Jones; Gabrielle Anastasia,43,0,45,2
1745800109629,EDS 128A,A01,895459,Fargason; Sharon Gayle,44,0,45,1
1745800110659,EDS 128B,A01,895543,Pappas; Elizabeth,44,0,45,1
1745800111682,EDS 139,A00,897203,Pappas; Elizabeth,44,0,45,1
1745800111682,EDS 139,B00,897209,Fargason; Sharon Gayle,44,0,45,1
1745800112707,EDS 201,A00,895545,Staff,43,0,45,2
1745800113735,EDS 203,A01,895581,Halter; Christopher P.,43,0,45,2
1745800114764,EDS 204R,A01,895625,Heinzman; Erica M.,43,0,45,2
1745800114764,EDS 204R,B01,895693,Halter; Christopher P.,18,0,45,27
1745800115793,EDS 206R,A00,895694,Fargason; Sharon Gayle,9,0,30,21
1745800115793,EDS 206R,B00,895695,Choi; Bailey Miyeon,20,0,30,10
1745800116820,EDS 250,A00,895697,Hemans; Patricia Ann Benitez,43,0,45,2
1745800117845,EDS 281,A00,895701,Meyerott; Theresa Ann,15,0,15,0
1745800118874,EDS 284,A00,895736,Meyerott; Theresa Ann,15,0,15,0
1745800119900,EDS 286,A00,897210,Fine; Sarah,15,0,15,0
1745800120929,EDS 289C,A01,895770,Daly; Alan J.,15,0,15,0
1745800121954,EDS 290,A00,897211,Hofstetter; Carolyn,15,0,15,0
1745800122983,LIGM 5A,A00,896162,Fischer-Grunski; Eva K,15,0,20,5
1745800124012,LIGM 5B,A00,896260,Fischer-Grunski; Eva K,17,0,20,3
1745800125041,LIGM 5C,A00,896308,Fischer-Grunski; Eva K,18,0,20,2
1745800126070,LIIT 5AS,A00,896313,Carnelos; Chiara,18,0,20,2
1745800127096,LIIT 5BS,A00,896416,Carnelos; Chiara,20,0,20,0
1745800128126,LIIT 5CS,A00,896564,Carnelos; Chiara,20,0,20,0
1745800129152,LISP 5A,A00,896588,Munoz Sanchez; Alicia,4,0,20,16
1745800130177,LISP 5B,A00,896653,Munoz Sanchez; Alicia,10,0,20,10
1745800131204,LISP 5C,A00,896655,Munoz Sanchez; Alicia,4,0,20,16
1745800132231,MAE 197,001,957918,Kleissl; Jan,9998,0,9999,1
1745800133258,MATH 2,A01,957937,Staff,34,0,35,1
1745800134285,MATH 197,001,957876,Kedlaya; Kiran S.,9993,0,9999,6
1745800135310,MCWP 40,A00,892729,Duru; Nur,13,0,20,7
1745800135310,MCWP 40,B00,893304,Montejo; Carolina,20,0,20,0
1745800136339,MCWP 40R,A00,893757,Redela; Pamela Morgan,0,6,20,20
1745800137363,MCWP 50,A00,893758,Morshed; Michael James,2,0,20,18
1745800137363,MCWP 50,B00,893761,Bartulis; Jason Michael,17,0,20,3
1745800138391,MCWP 50R,A00,893766,Compas; Sean Matthew,0,1,20,20
1745800138391,MCWP 50R,B00,893769,Carter; Jennifer A,0,0,20,20
1745800138391,MCWP 50R,C00,893771,Krone; Jarret,0,3,20,20
1745800138391,MCWP 50R,D00,893772,Miller; Elizabeth Deen,3,0,20,17
1745800138391,MCWP 50R,E00,893775,Carter; Andrea L,0,0,20,20
1745800139421,MMW 11R,A01,892721,Herbst; Matthew,11,0,27,16
1745800139421,MMW 11R,A02,892722,Herbst; Matthew,0,0,0,3
1745800140450,MMW 12R,A01,892724,Herbst; Matthew,0,9,16,16
1745800140450,MMW 12R,A02,892725,Herbst; Matthew,0,9,16,16
1745800141477,MMW 13R,A01,892727,Staff,0,4,16,16
1745800141477,MMW 13R,A02,892728,Staff,0,4,16,16
1745800141477,MMW 13R,A03,958032,Staff,0,3,16,16
1745800141477,MMW 13R,A04,958033,Staff,0,2,16,16
1745800141477,MMW 13R,A05,958034,Staff,0,3,16,16
1745800142506,SIO 295LS,A00,894015,Staff,7,0,25,18
1745800143536,SIO 295S,A00,894020,Staff,7,0,25,18
1745800144564,SIOC 290S,B01,958918,Staff,0,0,0,0
1745800145594,SIOC 291S,B01,958922,Staff,0,0,0,0
1745800146624,SOCI 117,A01,895339,Staff,4,0,5,1
1745800147650,WES 237B,A00,894149,Staff,11,0,20,9
1745800149710,AESE 279B,A00,891859,Staff,13,0,35,22
1745800150735,AIP 197,001,891854,Staff,70,0,70,0
1745800151763,ANTH 289S,A00,891856,Gagneux; Pascal,12,0,12,0
1745800152790,BENG 196,001,957946,Engler; Adam J.,9996,0,9999,3
1745800153817,CAT 124RS,A01,956906,Staff,8,0,25,17
1745800154841,CAT 125RS,A01,922013,Staff,8,0,25,17
1745800155869,CLRE 250,A00,891860,Morris; Sheldon,9995,0,9999,4
1745800157919,CLRE 251R,A00,907817,Mehta; Ravindra L.,9994,0,9999,5
1745800158946,CLRE 252,A00,891864,Cuomo; Raphael Eduardo,9993,0,9999,6
1745800159974,CLRE 253,A00,891867,Vaida; Florin,9994,0,9999,5
1745800159974,CLRE 253,B00,907819,Staff,9999,0,9999,0
1745800161001,CLRE 259,A00,891868,Patel; Hemal,9998,0,9999,1
1745800162029,CLRE 260,A00,891872,Cuomo; Raphael Eduardo,9999,0,9999,0
1745800163055,CLRE 297,001,891888,Cuomo; Raphael Eduardo,9999,0,9999,0
1745800164083,CSE 191,A00,958773,Minnes Kemp; Mor Mia,9999,0,9999,0
1745800165114,CSS 201S,A01,892054,Mignozzetti; Umberto,30,0,30,0
1745800166141,CSS 202S,A01,892056,Mignozzetti; Umberto,30,0,30,0
1745800167166,DSC 197,001,956898,Eldridge; Justin Matthew,9998,0,9999,1
1745800168193,DSC 297,001,958000,Mazumdar; Arya,9998,0,9999,1
1745800169221,EAP 100,A00,905686,Staff,9776,0,9999,223
1745800170250,ECE 45,A01,892618,Staff,0,12,50,50
1745800171280,ECE 109,A01,892620,Staff,0,43,0,0
1745800172310,ECE 111,A01,892719,Staff,0,7,50,50
1745800173340,ECE 197,001,957920,Mercier; Patrick Philip,9992,0,9999,7
1745800174370,ECON 178,A01,907814,Zhu; Ying,28,0,35,7
1745800175402,EDS 115,A00,895312,Staff,41,0,45,4
1745800176427,EDS 117,A01,895337,Staff,30,0,30,0
1745800177452,EDS 125,A00,895341,Jones; Gabrielle Anastasia,43,0,45,2
1745800178476,EDS 128A,A01,895459,Fargason; Sharon Gayle,44,0,45,1
1745800179505,EDS 128B,A01,895543,Pappas; Elizabeth,44,0,45,1
1745800180531,EDS 139,A00,897203,Pappas; Elizabeth,44,0,45,1
1745800180531,EDS 139,B00,897209,Fargason; Sharon Gayle,44,0,45,1
1745800181558,EDS 201,A00,895545,Staff,43,0,45,2
1745800182586,EDS 203,A01,895581,Halter; Christopher P.,43,0,45,2
1745800183611,EDS 204R,A01,895625,Heinzman; Erica M.,43,0,45,2
1745800183611,EDS 204R,B01,895693,Halter; Christopher P.,18,0,45,27
1745800184640,EDS 206R,A00,895694,Fargason; Sharon Gayle,9,0,30,21
1745800184640,EDS 206R,B00,895695,Choi; Bailey Miyeon,20,0,30,10
1745800185666,EDS 250,A00,895697,Hemans; Patricia Ann Benitez,43,0,45,2
1745800186691,EDS 281,A00,895701,Meyerott; Theresa Ann,15,0,15,0
1745800187719,EDS 284,A00,895736,Meyerott; Theresa Ann,15,0,15,0
1745800188746,EDS 286,A00,897210,Fine; Sarah,15,0,15,0
1745800189773,EDS 289C,A01,895770,Daly; Alan J.,15,0,15,0
1745800190798,EDS 290,A00,897211,Hofstetter; Carolyn,15,0,15,0
1745800191825,LIGM 5A,A00,896162,Fischer-Grunski; Eva K,15,0,20,5
1745800192850,LIGM 5B,A00,896260,Fischer-Grunski; Eva K,17,0,20,3
1745800193877,LIGM 5C,A00,896308,Fischer-Grunski; Eva K,18,0,20,2
1745800194903,LIIT 5AS,A00,896313,Carnelos; Chiara,18,0,20,2
1745800195930,LIIT 5BS,A00,896416,Carnelos; Chiara,20,0,20,0
1745800196959,LIIT 5CS,A00,896564,Carnelos; Chiara,20,0,20,0
1745800197985,LISP 5A,A00,896588,Munoz Sanchez; Alicia,4,0,20,16
1745800199014,LISP 5B,A00,896653,Munoz Sanchez; Alicia,10,0,20,10
1745800200040,LISP 5C,A00,896655,Munoz Sanchez; Alicia,4,0,20,16
1745800201070,MAE 197,001,957918,Kleissl; Jan,9998,0,9999,1
1745800202099,MATH 2,A01,957937,Staff,34,0,35,1
1745800203133,MATH 197,001,957876,Kedlaya; Kiran S.,9993,0,9999,6
1745800204160,MCWP 40,A00,892729,Duru; Nur,13,0,20,7
1745800204160,MCWP 40,B00,893304,Montejo; Carolina,20,0,20,0
1745800205185,MCWP 40R,A00,893757,Redela; Pamela Morgan,0,6,20,20
1745800206209,MCWP 50,A00,893758,Morshed; Michael James,2,0,20,18
1745800206209,MCWP 50,B00,893761,Bartulis; Jason Michael,17,0,20,3
1745800207233,MCWP 50R,A00,893766,Compas; Sean Matthew,0,1,20,20
1745800207233,MCWP 50R,B00,893769,Carter; Jennifer A,0,0,20,20
1745800207233,MCWP 50R,C00,893771,Krone; Jarret,0,3,20,20
1745800207233,MCWP 50R,D00,893772,Miller; Elizabeth Deen,3,0,20,17
1745800207233,MCWP 50R,E00,893775,Carter; Andrea L,0,0,20,20
1745800208259,MMW 11R,A01,892721,Herbst; Matthew,11,0,27,16
1745800208259,MMW 11R,A02,892722,Herbst; Matthew,0,0,0,3
1745800209289,MMW 12R,A01,892724,Herbst; Matthew,0,9,16,16
1745800209289,MMW 12R,A02,892725,Herbst; Matthew,0,9,16,16
1745800210318,MMW 13R,A01,892727,Staff,0,4,16,16
1745800210318,MMW 13R,A02,892728,Staff,0,4,16,16
1745800210318,MMW 13R,A03,958032,Staff,0,3,16,16
1745800210318,MMW 13R,A04,958033,Staff,0,2,16,16
1745800210318,MMW 13R,A05,958034,Staff,0,3,16,16
1745800211348,SIO 295LS,A00,894015,Staff,7,0,25,18
1745800212374,SIO 295S,A00,894020,Staff,7,0,25,18
1745800213399,SIOC 290S,B01,958918,Staff,0,0,0,0
1745800214431,SIOC 291S,B01,958922,Staff,0,0,0,0
1745800215458,SOCI 117,A01,895339,Staff,4,0,5,1
1745800216518,WES 237B,A00,894149,Staff,11,0,20,9
1745800218577,AESE 279B,A00,891859,Staff,13,0,35,22
1745800219617,AIP 197,001,891854,Staff,70,0,70,0
1745800220644,ANTH 289S,A00,891856,Gagneux; Pascal,12,0,12,0
1745800221672,BENG 196,001,957946,Engler; Adam J.,9996,0,9999,3
1745800222697,CAT 124RS,A01,956906,Staff,8,0,25,17
1745800223726,CAT 125RS,A01,922013,Staff,8,0,25,17
1745800224755,CLRE 250,A00,891860,Morris; Sheldon,9995,0,9999,4
1745800226807,CLRE 251R,A00,907817,Mehta; Ravindra L.,9994,0,9999,5
1745800227834,CLRE 252,A00,891864,Cuomo; Raphael Eduardo,9993,0,9999,6
1745800228859,CLRE 253,A00,891867,Vaida; Florin,9994,0,9999,5
1745800228859,CLRE 253,B00,907819,Staff,9999,0,9999,0
1745800229888,CLRE 259,A00,891868,Patel; Hemal,9998,0,9999,1
1745800230913,CLRE 260,A00,891872,Cuomo; Raphael Eduardo,9999,0,9999,0
1745800231941,CLRE 297,001,891888,Cuomo; Raphael Eduardo,9999,0,9999,0
1745800232967,CSE 191,A00,958773,Minnes Kemp; Mor Mia,9999,0,9999,0
1745800233993,CSS 201S,A01,892054,Mignozzetti; Umberto,30,0,30,0
1745800235019,CSS 202S,A01,892056,Mignozzetti; Umberto,30,0,30,0
1745800236045,DSC 197,001,956898,Eldridge; Justin Matthew,9998,0,9999,1
1745800237070,DSC 297,001,958000,Mazumdar; Arya,9998,0,9999,1
1745800238097,EAP 100,A00,905686,Staff,9776,0,9999,223
1745800239125,ECE 45,A01,892618,Staff,0,12,50,50
1745800240151,ECE 109,A01,892620,Staff,0,43,0,0
1745800241178,ECE 111,A01,892719,Staff,0,7,50,50
1745800242206,ECE 197,001,957920,Mercier; Patrick Philip,9992,0,9999,7
1745800243232,ECON 178,A01,907814,Zhu; Ying,28,0,35,7
1745800244258,EDS 115,A00,895312,Staff,41,0,45,4
1745800245284,EDS 117,A01,895337,Staff,30,0,30,0
1745800246310,EDS 125,A00,895341,Jones; Gabrielle Anastasia,43,0,45,2
1745800247335,EDS 128A,A01,895459,Fargason; Sharon Gayle,44,0,45,1
1745800248362,EDS 128B,A01,895543,Pappas; Elizabeth,44,0,45,1
1745800249388,EDS 139,A00,897203,Pappas; Elizabeth,44,0,45,1
1745800249388,EDS 139,B00,897209,Fargason; Sharon Gayle,44,0,45,1
1745800250415,EDS 201,A00,895545,Staff,43,0,45,2
1745800251439,EDS 203,A01,895581,Halter; Christopher P.,43,0,45,2
1745800252464,EDS 204R,A01,895625,Heinzman; Erica M.,43,0,45,2
1745800252464,EDS 204R,B01,895693,Halter; Christopher P.,18,0,45,27
1745800253493,EDS 206R,A00,895694,Fargason; Sharon Gayle,9,0,30,21
1745800253493,EDS 206R,B00,895695,Choi; Bailey Miyeon,20,0,30,10
1745800254519,EDS 250,A00,895697,Hemans; Patricia Ann Benitez,43,0,45,2
1745800255545,EDS 281,A00,895701,Meyerott; Theresa Ann,15,0,15,0
1745800256572,EDS 284,A00,895736,Meyerott; Theresa Ann,15,0,15,0
1745800257601,EDS 286,A00,897210,Fine; Sarah,15,0,15,0
1745800258628,EDS 289C,A01,895770,Daly; Alan J.,15,0,15,0
1745800259656,EDS 290,A00,897211,Hofstetter; Carolyn,15,0,15,0
1745800260684,LIGM 5A,A00,896162,Fischer-Grunski; Eva K,15,0,20,5
1745800261729,LIGM 5B,A00,896260,Fischer-Grunski; Eva K,17,0,20,3
1745800262755,LIGM 5C,A00,896308,Fischer-Grunski; Eva K,18,0,20,2
1745800263781,LIIT 5AS,A00,896313,Carnelos; Chiara,18,0,20,2
1745800264807,LIIT 5BS,A00,896416,Carnelos; Chiara,20,0,20,0
1745800265832,LIIT 5CS,A00,896564,Carnelos; Chiara,20,0,20,0
1745800266861,LISP 5A,A00,896588,Munoz Sanchez; Alicia,4,0,20,16
1745800267890,LISP 5B,A00,896653,Munoz Sanchez; Alicia,10,0,20,10
1745800268916,LISP 5C,A00,896655,Munoz Sanchez; Alicia,4,0,20,16
1745800269943,MAE 197,001,957918,Kleissl; Jan,9998,0,9999,1
1745800270969,MATH 2,A01,957937,Staff,34,0,35,1
1745800271995,MATH 197,001,957876,Kedlaya; Kiran S.,9993,0,9999,6
1745800273024,MCWP 40,A00,892729,Duru; Nur,13,0,20,7
1745800273024,MCWP 40,B00,893304,Montejo; Carolina,20,0,20,0
1745800274053,MCWP 40R,A00,893757,Redela; Pamela Morgan,0,6,20,20
1745800275078,MCWP 50,A00,893758,Morshed; Michael James,2,0,20,18
1745800275078,MCWP 50,B00,893761,Bartulis; Jason Michael,17,0,20,3
1745800276105,MCWP 50R,A00,893766,Compas; Sean Matthew,0,1,20,20
1745800276105,MCWP 50R,B00,893769,Carter; Jennifer A,0,0,20,20
1745800276105,MCWP 50R,C00,893771,Krone; Jarret,0,3,20,20
1745800276105,MCWP 50R,D00,893772,Miller; Elizabeth Deen,3,0,20,17
1745800276105,MCWP 50R,E00,893775,Carter; Andrea L,0,0,20,20
1745800277130,MMW 11R,A01,892721,Herbst; Matthew,11,0,27,16
1745800277130,MMW 11R,A02,892722,Herbst; Matthew,0,0,0,3
1745800278157,MMW 12R,A01,892724,Herbst; Matthew,0,9,16,16
1745800278157,MMW 12R,A02,892725,Herbst; Matthew,0,9,16,16
1745800279183,MMW 13R,A01,892727,Staff,0,4,16,16
1745800279183,MMW 13R,A02,892728,Staff,0,4,16,16
1745800279183,MMW 13R,A03,958032,Staff,0,3,16,16
1745800279183,MMW 13R,A04,958033,Staff,0,2,16,16
1745800279183,MMW 13R,A05,958034,Staff,0,3,16,16
1745800280208,SIO 295LS,A00,894015,Staff,7,0,25,18
1745800281236,SIO 295S,A00,894020,Staff,7,0,25,18
1745800282263,SIOC 290S,B01,958918,Staff,0,0,0,0
1745800283290,SIOC 291S,B01,958922,Staff,0,0,0,0
1745800284319,SOCI 117,A01,895339,Staff,4,0,5,1
1745800285345,WES 237B,A00,894149,Staff,11,0,20,9
1745800287488,AESE 279B,A00,891859,Staff,13,0,35,22
1745800288513,AIP 197,001,891854,Staff,70,0,70,0
1745800289543,ANTH 289S,A00,891856,Gagneux; Pascal,12,0,12,0
1745800290568,BENG 196,001,957946,Engler; Adam J.,9996,0,9999,3
1745800291591,CAT 124RS,A01,956906,Staff,8,0,25,17
1745800292618,CAT 125RS,A01,922013,Staff,8,0,25,17
1745800293644,CLRE 250,A00,891860,Morris; Sheldon,9995,0,9999,4
1745800295698,CLRE 251R,A00,907817,Mehta; Ravindra L.,9994,0,9999,5
1745800296727,CLRE 252,A00,891864,Cuomo; Raphael Eduardo,9993,0,9999,6
1745800297753,CLRE 253,A00,891867,Vaida; Florin,9994,0,9999,5
1745800297753,CLRE 253,B00,907819,Staff,9999,0,9999,0
1745800298777,CLRE 259,A00,891868,Patel; Hemal,9998,0,9999,1
1745800299804,CLRE 260,A00,891872,Cuomo; Raphael Eduardo,9999,0,9999,0
1745800300833,CLRE 297,001,891888,Cuomo; Raphael Eduardo,9999,0,9999,0
1745800301858,CSE 191,A00,958773,Minnes Kemp; Mor Mia,9999,0,9999,0
1745800302885,CSS 201S,A01,892054,Mignozzetti; Umberto,30,0,30,0
1745800303914,CSS 202S,A01,892056,Mignozzetti; Umberto,30,0,30,0
1745800304939,DSC 197,001,956898,Eldridge; Justin Matthew,9998,0,9999,1
1745800305966,DSC 297,001,958000,Mazumdar; Arya,9998,0,9999,1
1745800306992,EAP 100,A00,905686,Staff,9776,0,9999,223
1745800308020,ECE 45,A01,892618,Staff,0,12,50,50
1745800309048,ECE 109,A01,892620,Staff,0,43,0,0
1745800310073,ECE 111,A01,892719,Staff,0,7,50,50
1745800311100,ECE 197,001,957920,Mercier; Patrick Philip,9992,0,9999,7
1745800312129,ECON 178,A01,907814,Zhu; Ying,28,0,35,7
1745800313155,EDS 115,A00,895312,Staff,41,0,45,4
1745800314180,EDS 117,A01,895337,Staff,30,0,30,0
1745800315209,EDS 125,A00,895341,Jones; Gabrielle Anastasia,43,0,45,2
1745800316234,EDS 128A,A01,895459,Fargason; Sharon Gayle,44,0,45,1
1745800317262,EDS 128B,A01,895543,Pappas; Elizabeth,44,0,45,1
1745800318288,EDS 139,A00,897203,Pappas; Elizabeth,44,0,45,1
1745800318288,EDS 139,B00,897209,Fargason; Sharon Gayle,44,0,45,1
1745800319319,EDS 201,A00,895545,Staff,43,0,45,2
1745800320344,EDS 203,A01,895581,Halter; Christopher P.,43,0,45,2
1745800321370,EDS 204R,A01,895625,Heinzman; Erica M.,43,0,45,2
1745800321370,EDS 204R,B01,895693,Halter; Christopher P.,18,0,45,27
1745800322394,EDS 206R,A00,895694,Fargason; Sharon Gayle,9,0,30,21
1745800322394,EDS 206R,B00,895695,Choi; Bailey Miyeon,20,0,30,10
1745800323421,EDS 250,A00,895697,Hemans; Patricia Ann Benitez,43,0,45,2
1745800324444,EDS 281,A00,895701,Meyerott; Theresa Ann,15,0,15,0
1745800325472,EDS 284,A00,895736,Meyerott; Theresa Ann,15,0,15,0
1745800326496,EDS 286,A00,897210,Fine; Sarah,15,0,15,0
1745800327521,EDS 289C,A01,895770,Daly; Alan J.,15,0,15,0
1745800328547,EDS 290,A00,897211,Hofstetter; Carolyn,15,0,15,0
1745800329574,LIGM 5A,A00,896162,Fischer-Grunski; Eva K,15,0,20,5
1745800330599,LIGM 5B,A00,896260,Fischer-Grunski; Eva K,17,0,20,3
1745800331625,LIGM 5C,A00,896308,Fischer-Grunski; Eva K,18,0,20,2
1745800332654,LIIT 5AS,A00,896313,Carnelos; Chiara,18,0,20,2
1745800333681,LIIT 5BS,A00,896416,Carnelos; Chiara,20,0,20,0
1745800334710,LIIT 5CS,A00,896564,Carnelos; Chiara,20,0,20,0
1745800335736,LISP 5A,A00,896588,Munoz Sanchez; Alicia,4,0,20,16
1745800336763,LISP 5B,A00,896653,Munoz Sanchez; Alicia,10,0,20,10
1745800337792,LISP 5C,A00,896655,Munoz Sanchez; Alicia,4,0,20,16
1745800338817,MAE 197,001,957918,Kleissl; Jan,9998,0,9999,1
1745800339845,MATH 2,A01,957937,Staff,34,0,35,1
1745800340873,MATH 197,001,957876,Kedlaya; Kiran S.,9993,0,9999,6
1745800341900,MCWP 40,A00,892729,Duru; Nur,13,0,20,7
1745800341900,MCWP 40,B00,893304,Montejo; Carolina,20,0,20,0
1745800342927,MCWP 40R,A00,893757,Redela; Pamela Morgan,0,6,20,20
1745800343952,MCWP 50,A00,893758,Morshed; Michael James,2,0,20,18
1745800343952,MCWP 50,B00,893761,Bartulis; Jason Michael,17,0,20,3
1745800344982,MCWP 50R,A00,893766,Compas; Sean Matthew,0,1,20,20
1745800344982,MCWP 50R,B00,893769,Carter; Jennifer A,0,0,20,20
1745800344982,MCWP 50R,C00,893771,Krone; Jarret,0,3,20,20
1745800344982,MCWP 50R,D00,893772,Miller; Elizabeth Deen,3,0,20,17
1745800344982,MCWP 50R,E00,893775,Carter; Andrea L,0,0,20,20
1745800346008,MMW 11R,A01,892721,Herbst; Matthew,11,0,27,16
1745800346008,MMW 11R,A02,892722,Herbst; Matthew,0,0,0,3
1745800347035,MMW 12R,A01,892724,Herbst; Matthew,0,9,16,16
1745800347035,MMW 12R,A02,892725,Herbst; Matthew,0,9,16,16
1745800348062,MMW 13R,A01,892727,Staff,0,4,16,16
1745800348062,MMW 13R,A02,892728,Staff,0,4,16,16
1745800348062,MMW 13R,A03,958032,Staff,0,3,16,16
1745800348062,MMW 13R,A04,958033,Staff,0,2,16,16
1745800348062,MMW 13R,A05,958034,Staff,0,3,16,16
1745800349086,SIO 295LS,A00,894015,Staff,7,0,25,18
1745800350115,SIO 295S,A00,894020,Staff,7,0,25,18
1745800351145,SIOC 290S,B01,958918,Staff,0,0,0,0
1745800352172,SIOC 291S,B01,958922,Staff,0,0,0,0
1745800353198,SOCI 117,A01,895339,Staff,4,0,5,1
1745800354228,WES 237B,A00,894149,Staff,11,0,20,9
1745800356297,AESE 279B,A00,891859,Staff,13,0,35,22
1745800357325,AIP 197,001,891854,Staff,70,0,70,0
1745800358353,ANTH 289S,A00,891856,Gagneux; Pascal,12,0,12,0
1745800359379,BENG 196,001,957946,Engler; Adam J.,9996,0,9999,3
1745800360407,CAT 124RS,A01,956906,Staff,8,0,25,17
1745800361435,CAT 125RS,A01,922013,Staff,8,0,25,17
1745800362460,CLRE 250,A00,891860,Morris; Sheldon,9995,0,9999,4
1745800364510,CLRE 251R,A00,907817,Mehta; Ravindra L.,9994,0,9999,5
1745800365537,CLRE 252,A00,891864,Cuomo; Raphael Eduardo,9993,0,9999,6
1745800366562,CLRE 253,A00,891867,Vaida; Florin,9994,0,9999,5
1745800366562,CLRE 253,B00,907819,Staff,9999,0,9999,0
1745800367591,CLRE 259,A00,891868,Patel; Hemal,9998,0,9999,1
1745800368619,CLRE 260,A00,891872,Cuomo; Raphael Eduardo,9999,0,9999,0
1745800369647,CLRE 297,001,891888,Cuomo; Raphael Eduardo,9999,0,9999,0
1745800370676,CSE 191,A00,958773,Minnes Kemp; Mor Mia,9999,0,9999,0
1745800371706,CSS 201S,A01,892054,Mignozzetti; Umberto,30,0,30,0
1745800372732,CSS 202S,A01,892056,Mignozzetti; Umberto,30,0,30,0
1745800373758,DSC 197,001,956898,Eldridge; Justin Matthew,9998,0,9999,1
1745800374784,DSC 297,001,958000,Mazumdar; Arya,9998,0,9999,1
1745800375811,EAP 100,A00,905686,Staff,9776,0,9999,223
1745800376838,ECE 45,A01,892618,Staff,0,12,50,50
1745800377864,ECE 109,A01,892620,Staff,0,43,0,0
1745800378890,ECE 111,A01,892719,Staff,0,7,50,50
1745800379917,ECE 197,001,957920,Mercier; Patrick Philip,9992,0,9999,7
1745800380944,ECON 178,A01,907814,Zhu; Ying,28,0,35,7
1745800381972,EDS 115,A00,895312,Staff,41,0,45,4
1745800382999,EDS 117,A01,895337,Staff,30,0,30,0
1745800384028,EDS 125,A00,895341,Jones; Gabrielle Anastasia,43,0,45,2
1745800385058,EDS 128A,A01,895459,Fargason; Sharon Gayle,44,0,45,1
1745800386086,EDS 128B,A01,895543,Pappas; Elizabeth,44,0,45,1
1745800387112,EDS 139,A00,897203,Pappas; Elizabeth,44,0,45,1
1745800387112,EDS 139,B00,897209,Fargason; Sharon Gayle,44,0,45,1
1745800388138,EDS 201,A00,895545,Staff,43,0,45,2
1745800389166,EDS 203,A01,895581,Halter; Christopher P.,43,0,45,2
1745800390195,EDS 204R,A01,895625,Heinzman; Erica M.,43,0,45,2
1745800390195,EDS 204R,B01,895693,Halter; Christopher P.,18,0,45,27
1745800391224,EDS 206R,A00,895694,Fargason; Sharon Gayle,9,0,30,21
1745800391224,EDS 206R,B00,895695,Choi; Bailey Miyeon,20,0,30,10
1745800392253,EDS 250,A00,895697,Hemans; Patricia Ann Benitez,43,0,45,2
1745800393280,EDS 281,A00,895701,Meyerott; Theresa Ann,15,0,15,0
1745800394308,EDS 284,A00,895736,Meyerott; Theresa Ann,15,0,15,0
1745800395333,EDS 286,A00,897210,Fine; Sarah,15,0,15,0
1745800396362,EDS 289C,A01,895770,Daly; Alan J.,15,0,15,0
1745800397390,EDS 290,A00,897211,Hofstetter; Carolyn,15,0,15,0
1745800398418,LIGM 5A,A00,896162,Fischer-Grunski; Eva K,15,0,20,5
1745800399443,LIGM 5B,A00,896260,Fischer-Grunski; Eva K,17,0,20,3
1745800400472,LIGM 5C,A00,896308,Fischer-Grunski; Eva K,18,0,20,2
1745800401502,LIIT 5AS,A00,896313,Carnelos; Chiara,18,0,20,2
1745800402532,LIIT 5BS,A00,896416,Carnelos; Chiara,20,0,20,0
1745800403557,LIIT 5CS,A00,896564,Carnelos; Chiara,20,0,20,0
1745800404582,LISP 5A,A00,896588,Munoz Sanchez; Alicia,4,0,20,16
1745800405610,LISP 5B,A00,896653,Munoz Sanchez; Alicia,10,0,20,10
1745800406639,LISP 5C,A00,896655,Munoz Sanchez; Alicia,4,0,20,16
1745800407664,MAE 197,001,957918,Kleissl; Jan,9998,0,9999,1
1745800408688,MATH 2,A01,957937,Staff,34,0,35,1
1745800409714,MATH 197,001,957876,Kedlaya; Kiran S.,9993,0,9999,6
1745800410742,MCWP 40,A00,892729,Duru; Nur,13,0,20,7
1745800410742,MCWP 40,B00,893304,Montejo; Carolina,20,0,20,0
1745800411769,MCWP 40R,A00,893757,Redela; Pamela Morgan,0,6,20,20
1745800412798,MCWP 50,A00,893758,Morshed; Michael James,2,0,20,18
1745800412798,MCWP 50,B00,893761,Bartulis; Jason Michael,17,0,20,3
1745800413828,MCWP 50R,A00,893766,Compas; Sean Matthew,0,1,20,20
1745800413828,MCWP 50R,B00,893769,Carter; Jennifer A,0,0,20,20
1745800413828,MCWP 50R,C00,893771,Krone; Jarret,0,3,20,20
1745800413828,MCWP 50R,D00,893772,Miller; Elizabeth Deen,3,0,20,17
1745800413828,MCWP 50R,E00,893775,Carter; Andrea L,0,0,20,20
1745800414858,MMW 11R,A01,892721,Herbst; Matthew,11,0,27,16
1745800414858,MMW 11R,A02,892722,Herbst; Matthew,0,0,0,3
1745800415885,MMW 12R,A01,892724,Herbst; Matthew,0,9,16,16
1745800415885,MMW 12R,A02,892725,Herbst; Matthew,0,9,16,16
1745800416919,MMW 13R,A01,892727,Staff,0,4,16,16
1745800416919,MMW 13R,A02,892728,Staff,0,4,16,16
1745800416919,MMW 13R,A03,958032,Staff,0,3,16,16
1745800416919,MMW 13R,A04,958033,Staff,0,2,16,16
1745800416919,MMW 13R,A05,958034,Staff,0,3,16,16
1745800417943,SIO 295LS,A00,894015,Staff,7,0,25,18
1745800418968,SIO 295S,A00,894020,Staff,7,0,25,18
1745800419995,SIOC 290S,B01,958918,Staff,0,0,0,0
1745800421024,SIOC 291S,B01,958922,Staff,0,0,0,0
1745800422048,SOCI 117,A01,895339,Staff,4,0,5,1
1745800423073,WES 237B,A00,894149,Staff,11,0,20,9
1745800425131,AESE 279B,A00,891859,Staff,13,0,35,22
1745800426157,AIP 197,001,891854,Staff,70,0,70,0
1745800427185,ANTH 289S,A00,891856,Gagneux; Pascal,12,0,12,0
1745800428213,BENG 196,001,957946,Engler; Adam J.,9996,0,9999,3
1745800429240,CAT 124RS,A01,956906,Staff,8,0,25,17
1745800430265,CAT 125RS,A01,922013,Staff,8,0,25,17
1745800431290,CLRE 250,A00,891860,Morris; Sheldon,9995,0,9999,4
1745800433341,CLRE 251R,A00,907817,Mehta; Ravindra L.,9994,0,9999,5
1745800434369,CLRE 252,A00,891864,Cuomo; Raphael Eduardo,9993,0,9999,6
1745800435397,CLRE 253,A00,891867,Vaida; Florin,9994,0,9999,5
1745800435397,CLRE 253,B00,907819,Staff,9999,0,9999,0
1745800436423,CLRE 259,A00,891868,Patel; Hemal,9998,0,9999,1
1745800437449,CLRE 260,A00,891872,Cuomo; Raphael Eduardo,9999,0,9999,0
1745800438475,CLRE 297,001,891888,Cuomo; Raphael Eduardo,9999,0,9999,0
1745800439502,CSE 191,A00,958773,Minnes Kemp; Mor Mia,9999,0,9999,0
1745800440529,CSS 201S,A01,892054,Mignozzetti; Umberto,30,0,30,0
1745800441556,CSS 202S,A01,892056,Mignozzetti; Umberto,30,0,30,0
1745800442582,DSC 197,001,956898,Eldridge; Justin Matthew,9998,0,9999,1
1745800443610,DSC 297,001,958000,Mazumdar; Arya,9998,0,9999,1
1745800444637,EAP 100,A00,905686,Staff,9776,0,9999,223
1745800445666,ECE 45,A01,892618,Staff,0,12,50,50
1745800446693,ECE 109,A01,892620,Staff,0,43,0,0
1745800447718,ECE 111,A01,892719,Staff,0,7,50,50
1745800448745,ECE 197,001,957920,Mercier; Patrick Philip,9992,0,9999,7
1745800449776,ECON 178,A01,907814,Zhu; Ying,28,0,35,7
1745800450803,EDS 115,A00,895312,Staff,41,0,45,4
1745800451833,EDS 117,A01,895337,Staff,30,0,30,0
1745800452860,EDS 125,A00,895341,Jones; Gabrielle Anastasia,43,0,45,2
1745800453886,EDS 128A,A01,895459,Fargason; Sharon Gayle,44,0,45,1
1745800454913,EDS 128B,A01,895543,Pappas; Elizabeth,44,0,45,1
1745800455941,EDS 139,A00,897203,Pappas; Elizabeth,44,0,45,1
1745800455941,EDS 139,B00,897209,Fargason; Sharon Gayle,44,0,45,1
1745800456967,EDS 201,A00,895545,Staff,43,0,45,2
1745800457992,EDS 203,A01,895581,Halter; Christopher P.,43,0,45,2
1745800459018,EDS 204R,A01,895625,Heinzman; Erica M.,43,0,45,2
1745800459018,EDS 204R,B01,895693,Halter; Christopher P.,18,0,45,27
1745800460043,EDS 206R,A00,895694,Fargason; Sharon Gayle,9,0,30,21
1745800460043,EDS 206R,B00,895695,Choi; Bailey Miyeon,20,0,30,10
1745800461071,EDS 250,A00,895697,Hemans; Patricia Ann Benitez,43,0,45,2
1745800462097,EDS 281,A00,895701,Meyerott; Theresa Ann,15,0,15,0
1745800463122,EDS 284,A00,895736,Meyerott; Theresa Ann,15,0,15,0
1745800464146,EDS 286,A00,897210,Fine; Sarah,15,0,15,0
1745800465173,EDS 289C,A01,895770,Daly; Alan J.,15,0,15,0
1745800466198,EDS 290,A00,897211,Hofstetter; Carolyn,15,0,15,0
1745800467228,LIGM 5A,A00,896162,Fischer-Grunski; Eva K,15,0,20,5
1745800468254,LIGM 5B,A00,896260,Fischer-Grunski; Eva K,17,0,20,3
1745800469284,LIGM 5C,A00,896308,Fischer-Grunski; Eva K,18,0,20,2
1745800470310,LIIT 5AS,A00,896313,Carnelos; Chiara,18,0,20,2
1745800471339,LIIT 5BS,A00,896416,Carnelos; Chiara,20,0,20,0
1745800472369,LIIT 5CS,A00,896564,Carnelos; Chiara,20,0,20,0
1745800473396,LISP 5A,A00,896588,Munoz Sanchez; Alicia,4,0,20,16
1745800474428,LISP 5B,A00,896653,Munoz Sanchez; Alicia,10,0,20,10
1745800475457,LISP 5C,A00,896655,Munoz Sanchez; Alicia,4,0,20,16
1745800476486,MAE 197,001,957918,Kleissl; Jan,9998,0,9999,1
1745800477513,MATH 2,A01,957937,Staff,34,0,35,1
1745800478540,MATH 197,001,957876,Kedlaya; Kiran S.,9993,0,9999,6
1745800479570,MCWP 40,A00,892729,Duru; Nur,13,0,20,7
1745800479570,MCWP 40,B00,893304,Montejo; Carolina,20,0,20,0
1745800480595,MCWP 40R,A00,893757,Redela; Pamela Morgan,0,6,20,20
1745800481623,MCWP 50,A00,893758,Morshed; Michael James,2,0,20,18
1745800481623,MCWP 50,B00,893761,Bartulis; Jason Michael,17,0,20,3
1745800482652,MCWP 50R,A00,893766,Compas; Sean Matthew,0,1,20,20
1745800482652,MCWP 50R,B00,893769,Carter; Jennifer A,0,0,20,20
1745800482652,MCWP 50R,C00,893771,Krone; Jarret,0,3,20,20
1745800482652,MCWP 50R,D00,893772,Miller; Elizabeth Deen,3,0,20,17
1745800482652,MCWP 50R,E00,893775,Carter; Andrea L,0,0,20,20
1745800483681,MMW 11R,A01,892721,Herbst; Matthew,11,0,27,16
1745800483681,MMW 11R,A02,892722,Herbst; Matthew,0,0,0,3
1745800484706,MMW 12R,A01,892724,Herbst; Matthew,0,9,16,16
1745800484706,MMW 12R,A02,892725,Herbst; Matthew,0,9,16,16
1745800485736,MMW 13R,A01,892727,Staff,0,4,16,16
1745800485736,MMW 13R,A02,892728,Staff,0,4,16,16
1745800485736,MMW 13R,A03,958032,Staff,0,3,16,16
1745800485736,MMW 13R,A04,958033,Staff,0,2,16,16
1745800485736,MMW 13R,A05,958034,Staff,0,3,16,16
1745800486763,SIO 295LS,A00,894015,Staff,7,0,25,18
1745800487790,SIO 295S,A00,894020,Staff,7,0,25,18
1745800488816,SIOC 290S,B01,958918,Staff,0,0,0,0
1745800489858,SIOC 291S,B01,958922,Staff,0,0,0,0
1745800490887,SOCI 117,A01,895339,Staff,4,0,5,1
1745800491917,WES 237B,A00,894149,Staff,11,0,20,9
1745800493975,AESE 279B,A00,891859,Staff,13,0,35,22
1745800495001,AIP 197,001,891854,Staff,70,0,70,0
1745800496031,ANTH 289S,A00,891856,Gagneux; Pascal,12,0,12,0
1745800497059,BENG 196,001,957946,Engler; Adam J.,9996,0,9999,3
1745800498085,CAT 124RS,A01,956906,Staff,8,0,25,17
1745800499112,CAT 125RS,A01,922013,Staff,8,0,25,17
1745800500137,CLRE 250,A00,891860,Morris; Sheldon,9995,0,9999,4
1745800502188,CLRE 251R,A00,907817,Mehta; Ravindra L.,9994,0,9999,5
1745800503219,CLRE 252,A00,891864,Cuomo; Raphael Eduardo,9993,0,9999,6
1745800504251,CLRE 253,A00,891867,Vaida; Florin,9994,0,9999,5
1745800504251,CLRE 253,B00,907819,Staff,9999,0,9999,0
1745800505278,CLRE 259,A00,891868,Patel; Hemal,9998,0,9999,1
1745800506303,CLRE 260,A00,891872,Cuomo; Raphael Eduardo,9999,0,9999,0
1745800507328,CLRE 297,001,891888,Cuomo; Raphael Eduardo,9999,0,9999,0
1745800508355,CSE 191,A00,958773,Minnes Kemp; Mor Mia,9999,0,9999,0
1745800509382,CSS 201S,A01,892054,Mignozzetti; Umberto,30,0,30,0
1745800510408,CSS 202S,A01,892056,Mignozzetti; Umberto,30,0,30,0
1745800511434,DSC 197,001,956898,Eldridge; Justin Matthew,9998,0,9999,1
1745800512459,DSC 297,001,958000,Mazumdar; Arya,9998,0,9999,1
1745800513483,EAP 100,A00,905686,Staff,9776,0,9999,223
1745800514508,ECE 45,A01,892618,Staff,0,12,50,50
1745800515536,ECE 109,A01,892620,Staff,0,43,0,0
1745800516564,ECE 111,A01,892719,Staff,0,7,50,50
1745800517592,ECE 197,001,957920,Mercier; Patrick Philip,9992,0,9999,7
1745800518617,ECON 178,A01,907814,Zhu; Ying,28,0,35,7
1745800519644,EDS 115,A00,895312,Staff,41,0,45,4
1745800520670,EDS 117,A01,895337,Staff,30,0,30,0
1745800521696,EDS 125,A00,895341,Jones; Gabrielle Anastasia,43,0,45,2
1745800522722,EDS 128A,A01,895459,Fargason; Sharon Gayle,44,0,45,1
1745800523747,EDS 128B,A01,895543,Pappas; Elizabeth,44,0,45,1
1745800524774,EDS 139,A00,897203,Pappas; Elizabeth,44,0,45,1
1745800524774,EDS 139,B00,897209,Fargason; Sharon Gayle,44,0,45,1
1745800525803,EDS 201,A00,895545,Staff,43,0,45,2
1745800526828,EDS 203,A01,895581,Halter; Christopher P.,43,0,45,2
1745800527854,EDS 204R,A01,895625,Heinzman; Erica M.,43,0,45,2
1745800527854,EDS 204R,B01,895693,Halter; Christopher P.,18,0,45,27
1745800528880,EDS 206R,A00,895694,Fargason; Sharon Gayle,9,0,30,21
1745800528880,EDS 206R,B00,895695,Choi; Bailey Miyeon,20,0,30,10
1745800529905,EDS 250,A00,895697,Hemans; Patricia Ann Benitez,43,0,45,2
1745800530932,EDS 281,A00,895701,Meyerott; Theresa Ann,15,0,15,0
1745800531957,EDS 284,A00,895736,Meyerott; Theresa Ann,15,0,15,0
1745800532983,EDS 286,A00,897210,Fine; Sarah,15,0,15,0
1745800534011,EDS 289C,A01,895770,Daly; Alan J.,15,0,15,0
1745800535036,EDS 290,A00,897211,Hofstetter; Carolyn,15,0,15,0
1745800536062,LIGM 5A,A00,896162,Fischer-Grunski; Eva K,15,0,20,5
1745800537090,LIGM 5B,A00,896260,Fischer-Grunski; Eva K,17,0,20,3
1745800538118,LIGM 5C,A00,896308,Fischer-Grunski; Eva K,18,0,20,2
1745800539149,LIIT 5AS,A00,896313,Carnelos; Chiara,18,0,20,2
1745800540178,LIIT 5BS,A00,896416,Carnelos; Chiara,20,0,20,0
1745800541203,LIIT 5CS,A00,896564,Carnelos; Chiara,20,0,20,0
1745800542229,LISP 5A,A00,896588,Munoz Sanchez; Alicia,4,0,20,16
1745800543255,LISP 5B,A00,896653,Munoz Sanchez; Alicia,10,0,20,10
1745800544284,LISP 5C,A00,896655,Munoz Sanchez; Alicia,4,0,20,16
1745800545309,MAE 197,001,957918,Kleissl; Jan,9998,0,9999,1
1745800546335,MATH 2,A01,957937,Staff,34,0,35,1
1745800547361,MATH 197,001,957876,Kedlaya; Kiran S.,9993,0,9999,6
1745800548386,MCWP 40,A00,892729,Duru; Nur,13,0,20,7
1745800548386,MCWP 40,B00,893304,Montejo; Carolina,20,0,20,0
1745800549413,MCWP 40R,A00,893757,Redela; Pamela Morgan,0,6,20,20
1745800550440,MCWP 50,A00,893758,Morshed; Michael James,2,0,20,18
1745800550440,MCWP 50,B00,893761,Bartulis; Jason Michael,17,0,20,3
1745800551464,MCWP 50R,A00,893766,Compas; Sean Matthew,0,1,20,20
1745800551464,MCWP 50R,B00,893769,Carter; Jennifer A,0,0,20,20
1745800551464,MCWP 50R,C00,893771,Krone; Jarret,0,3,20,20
1745800551464,MCWP 50R,D00,893772,Miller; Elizabeth Deen,3,0,20,17
1745800551464,MCWP 50R,E00,893775,Carter; Andrea L,0,0,20,20
1745800552493,MMW 11R,A01,892721,Herbst; Matthew,11,0,27,16
1745800552493,MMW 11R,A02,892722,Herbst; Matthew,0,0,0,3
1745800553522,MMW 12R,A01,892724,Herbst; Matthew,0,9,16,16
1745800553522,MMW 12R,A02,892725,Herbst; Matthew,0,9,16,16
1745800554548,MMW 13R,A01,892727,Staff,0,4,16,16
1745800554548,MMW 13R,A02,892728,Staff,0,4,16,16
1745800554548,MMW 13R,A03,958032,Staff,0,3,16,16
1745800554548,MMW 13R,A04,958033,Staff,0,2,16,16
1745800554548,MMW 13R,A05,958034,Staff,0,3,16,16
1745800555572,SIO 295LS,A00,894015,Staff,7,0,25,18
1745800556598,SIO 295S,A00,894020,Staff,7,0,25,18
1745800557627,SIOC 290S,B01,958918,Staff,0,0,0,0
1745800558651,SIOC 291S,B01,958922,Staff,0,0,0,0
1745800559681,SOCI 117,A01,895339,Staff,4,0,5,1
1745800560710,WES 237B,A00,894149,Staff,11,0,20,9
1745800562778,AESE 279B,A00,891859,Staff,13,0,35,22
1745800563808,AIP 197,001,891854,Staff,70,0,70,0
1745800564834,ANTH 289S,A00,891856,Gagneux; Pascal,12,0,12,0
1745800565862,BENG 196,001,957946,Engler; Adam J.,9996,0,9999,3
1745800566889,CAT 124RS,A01,956906,Staff,8,0,25,17
1745800567918,CAT 125RS,A01,922013,Staff,8,0,25,17
1745800568945,CLRE 250,A00,891860,Morris; Sheldon,9995,0,9999,4
1745800571004,CLRE 251R,A00,907817,Mehta; Ravindra L.,9994,0,9999,5
1745800572035,CLRE 252,A00,891864,Cuomo; Raphael Eduardo,9993,0,9999,6
1745800573064,CLRE 253,A00,891867,Vaida; Florin,9994,0,9999,5
1745800573064,CLRE 253,B00,907819,Staff,9999,0,9999,0
1745800574088,CLRE 259,A00,891868,Patel; Hemal,9998,0,9999,1
1745800575117,CLRE 260,A00,891872,Cuomo; Raphael Eduardo,9999,0,9999,0
1745800576143,CLRE 297,001,891888,Cuomo; Raphael Eduardo,9999,0,9999,0
1745800577170,CSE 191,A00,958773,Minnes Kemp; Mor Mia,9999,0,9999,0
1745800578197,CSS 201S,A01,892054,Mignozzetti; Umberto,30,0,30,0
1745800579222,CSS 202S,A01,892056,Mignozzetti; Umberto,30,0,30,0
1745800580249,DSC 197,001,956898,Eldridge; Justin Matthew,9998,0,9999,1
1745800581274,DSC 297,001,958000,Mazumdar; Arya,9998,0,9999,1
1745800582301,EAP 100,A00,905686,Staff,9776,0,9999,223
1745800583331,ECE 45,A01,892618,Staff,0,12,50,50
1745800584360,ECE 109,A01,892620,Staff,0,43,0,0
1745800585391,ECE 111,A01,892719,Staff,0,7,50,50
1745800586418,ECE 197,001,957920,Mercier; Patrick Philip,9992,0,9999,7
1745800587444,ECON 178,A01,907814,Zhu; Ying,28,0,35,7
1745800588471,EDS 115,A00,895312,Staff,41,0,45,4
1745800589497,EDS 117,A01,895337,Staff,30,0,30,0
1745800590525,EDS 125,A00,895341,Jones; Gabrielle Anastasia,43,0,45,2
1745800591550,EDS 128A,A01,895459,Fargason; Sharon Gayle,44,0,45,1
1745800592578,EDS 128B,A01,895543,Pappas; Elizabeth,44,0,45,1
1745800593606,EDS 139,A00,897203,Pappas; Elizabeth,44,0,45,1
1745800593606,EDS 139,B00,897209,Fargason; Sharon Gayle,44,0,45,1
1745800594632,EDS 201,A00,895545,Staff,43,0,45,2
1745800595658,EDS 203,A01,895581,Halter; Christopher P.,43,0,45,2
1745800596684,EDS 204R,A01,895625,Heinzman; Erica M.,43,0,45,2
1745800596684,EDS 204R,B01,895693,Halter; Christopher P.,18,0,45,27
1745800597709,EDS 206R,A00,895694,Fargason; Sharon Gayle,9,0,30,21
1745800597709,EDS 206R,B00,895695,Choi; Bailey Miyeon,20,0,30,10
1745800598734,EDS 250,A00,895697,Hemans; Patricia Ann Benitez,43,0,45,2
1745800599763,EDS 281,A00,895701,Meyerott; Theresa Ann,15,0,15,0
1745800600792,EDS 284,A00,895736,Meyerott; Theresa Ann,15,0,15,0
1745800601818,EDS 286,A00,897210,Fine; Sarah,15,0,15,0
1745800602845,EDS 289C,A01,895770,Daly; Alan J.,15,0,15,0
1745800603874,EDS 290,A00,897211,Hofstetter; Carolyn,15,0,15,0
1745800604900,LIGM 5A,A00,896162,Fischer-Grunski; Eva K,15,0,20,5
1745800605926,LIGM 5B,A00,896260,Fischer-Grunski; Eva K,17,0,20,3
1745800606952,LIGM 5C,A00,896308,Fischer-Grunski; Eva K,18,0,20,2
1745800607981,LIIT 5AS,A00,896313,Carnelos; Chiara,18,0,20,2
1745800609011,LIIT 5BS,A00,896416,Carnelos; Chiara,20,0,20,0
1745800610036,LIIT 5CS,A00,896564,Carnelos; Chiara,20,0,20,0
1745800611064,LISP 5A,A00,896588,Munoz Sanchez; Alicia,4,0,20,16
1745800612093,LISP 5B,A00,896653,Munoz Sanchez; Alicia,10,0,20,10
1745800613122,LISP 5C,A00,896655,Munoz Sanchez; Alicia,4,0,20,16
1745800614149,MAE 197,001,957918,Kleissl; Jan,9998,0,9999,1
1745800615177,MATH 2,A01,957937,Staff,34,0,35,1
1745800616206,MATH 197,001,957876,Kedlaya; Kiran S.,9993,0,9999,6
1745800617232,MCWP 40,A00,892729,Duru; Nur,13,0,20,7
1745800617232,MCWP 40,B00,893304,Montejo; Carolina,20,0,20,0
1745800618258,MCWP 40R,A00,893757,Redela; Pamela Morgan,0,6,20,20
1745800619283,MCWP 50,A00,893758,Morshed; Michael James,2,0,20,18
1745800619283,MCWP 50,B00,893761,Bartulis; Jason Michael,17,0,20,3
1745800620309,MCWP 50R,A00,893766,Compas; Sean Matthew,0,1,20,20
1745800620309,MCWP 50R,B00,893769,Carter; Jennifer A,0,0,20,20
1745800620309,MCWP 50R,C00,893771,Krone; Jarret,0,3,20,20
1745800620309,MCWP 50R,D00,893772,Miller; Elizabeth Deen,3,0,20,17
1745800620309,MCWP 50R,E00,893775,Carter; Andrea L,0,0,20,20
1745800621336,MMW 11R,A01,892721,Herbst; Matthew,11,0,27,16
1745800621336,MMW 11R,A02,892722,Herbst; Matthew,0,0,0,3
1745800622364,MMW 12R,A01,892724,Herbst; Matthew,0,9,16,16
1745800622364,MMW 12R,A02,892725,Herbst; Matthew,0,9,16,16
1745800623394,MMW 13R,A01,892727,Staff,0,4,16,16
1745800623394,MMW 13R,A02,892728,Staff,0,4,16,16
1745800623394,MMW 13R,A03,958032,Staff,0,3,16,16
1745800623394,MMW 13R,A04,958033,Staff,0,2,16,16
1745800623394,MMW 13R,A05,958034,Staff,0,3,16,16
1745800624422,SIO 295LS,A00,894015,Staff,7,0,25,18
1745800625450,SIO 295S,A00,894020,Staff,7,0,25,18
1745800626480,SIOC 290S,B01,958918,Staff,0,0,0,0
1745800627507,SIOC 291S,B01,958922,Staff,0,0,0,0
1745800628532,SOCI 117,A01,895339,Staff,4,0,5,1
1745800629560,WES 237B,A00,894149,Staff,11,0,20,9
1745800631626,AESE 279B,A00,891859,Staff,13,0,35,22
1745800632654,AIP 197,001,891854,Staff,70,0,70,0
1745800633682,ANTH 289S,A00,891856,Gagneux; Pascal,12,0,12,0
1745800634706,BENG 196,001,957946,Engler; Adam J.,9996,0,9999,3
1745800635734,CAT 124RS,A01,956906,Staff,8,0,25,17
1745800636762,CAT 125RS,A01,922013,Staff,8,0,25,17
1745800637787,CLRE 250,A00,891860,Morris; Sheldon,9995,0,9999,4
1745800639839,CLRE 251R,A00,907817,Mehta; Ravindra L.,9994,0,9999,5
1745800640868,CLRE 252,A00,891864,Cuomo; Raphael Eduardo,9993,0,9999,6
1745800641894,CLRE 253,A00,891867,Vaida; Florin,9994,0,9999,5
1745800641894,CLRE 253,B00,907819,Staff,9999,0,9999,0
1745800642922,CLRE 259,A00,891868,Patel; Hemal,9998,0,9999,1
1745800643947,CLRE 260,A00,891872,Cuomo; Raphael Eduardo,9999,0,9999,0
1745800644973,CLRE 297,001,891888,Cuomo; Raphael Eduardo,9999,0,9999,0
1745800646001,CSE 191,A00,958773,Minnes Kemp; Mor Mia,9999,0,9999,0
1745800647029,CSS 201S,A01,892054,Mignozzetti; Umberto,30,0,30,0
1745800648055,CSS 202S,A01,892056,Mignozzetti; Umberto,30,0,30,0
1745800649082,DSC 197,001,956898,Eldridge; Justin Matthew,9998,0,9999,1
1745800650108,DSC 297,001,958000,Mazumdar; Arya,9998,0,9999,1
1745800651138,EAP 100,A00,905686,Staff,9776,0,9999,223
1745800652189,ECE 45,A01,892618,Staff,0,12,50,50
1745800653218,ECE 109,A01,892620,Staff,0,43,0,0
1745800654247,ECE 111,A01,892719,Staff,0,7,50,50
1745800655276,ECE 197,001,957920,Mercier; Patrick Philip,9992,0,9999,7
1745800656305,ECON 178,A01,907814,Zhu; Ying,28,0,35,7
1745800657331,EDS 115,A00,895312,Staff,41,0,45,4
1745800658359,EDS 117,A01,895337,Staff,30,0,30,0
1745800659386,EDS 125,A00,895341,Jones; Gabrielle Anastasia,43,0,45,2
1745800660415,EDS 128A,A01,895459,Fargason; Sharon Gayle,44,0,45,1
1745800661441,EDS 128B,A01,895543,Pappas; Elizabeth,44,0,45,1
1745800662469,EDS 139,A00,897203,Pappas; Elizabeth,44,0,45,1
1745800662469,EDS 139,B00,897209,Fargason; Sharon Gayle,44,0,45,1
1745800663494,EDS 201,A00,895545,Staff,43,0,45,2
1745800664519,EDS 203,A01,895581,Halter; Christopher P.,43,0,45,2
1745800665546,EDS 204R,A01,895625,Heinzman; Erica M.,43,0,45,2
1745800665546,EDS 204R,B01,895693,Halter; Christopher P.,18,0,45,27
1745800666574,EDS 206R,A00,895694,Fargason; Sharon Gayle,9,0,30,21
1745800666574,EDS 206R,B00,895695,Choi; Bailey Miyeon,20,0,30,10
1745800667602,EDS 250,A00,895697,Hemans; Patricia Ann Benitez,43,0,45,2
1745800668629,EDS 281,A00,895701,Meyerott; Theresa Ann,15,0,15,0
1745800669653,EDS 284,A00,895736,Meyerott; Theresa Ann,15,0,15,0
1745800670680,EDS 286,A00,897210,Fine; Sarah,15,0,15,0
1745800671706,EDS 289C,A01,895770,Daly; Alan J.,15,0,15,0
1745800672731,EDS 290,A00,897211,Hofstetter; Carolyn,15,0,15,0
1745800673760,LIGM 5A,A00,896162,Fischer-Grunski; Eva K,15,0,20,5
1745800674785,LIGM 5B,A00,896260,Fischer-Grunski; Eva K,17,0,20,3
1745800675811,LIGM 5C,A00,896308,Fischer-Grunski; Eva K,18,0,20,2
1745800676835,LIIT 5AS,A00,896313,Carnelos; Chiara,18,0,20,2
1745800677860,LIIT 5BS,A00,896416,Carnelos; Chiara,20,0,20,0
1745800678885,LIIT 5CS,A00,896564,Carnelos; Chiara,20,0,20,0
1745800679913,LISP 5A,A00,896588,Munoz Sanchez; Alicia,4,0,20,16
1745800680939,LISP 5B,A00,896653,Munoz Sanchez; Alicia,10,0,20,10
1745800681964,LISP 5C,A00,896655,Munoz Sanchez; Alicia,4,0,20,16
1745800682992,MAE 197,001,957918,Kleissl; Jan,9998,0,9999,1
1745800684020,MATH 2,A01,957937,Staff,34,0,35,1
1745800685048,MATH 197,001,957876,Kedlaya; Kiran S.,9993,0,9999,6
1745800686073,MCWP 40,A00,892729,Duru; Nur,13,0,20,7
1745800686073,MCWP 40,B00,893304,Montejo; Carolina,20,0,20,0
1745800687099,MCWP 40R,A00,893757,Redela; Pamela Morgan,0,6,20,20
1745800688124,MCWP 50,A00,893758,Morshed; Michael James,2,0,20,18
1745800688124,MCWP 50,B00,893761,Bartulis; Jason Michael,17,0,20,3
1745800689151,MCWP 50R,A00,893766,Compas; Sean Matthew,0,1,20,20
1745800689151,MCWP 50R,B00,893769,Carter; Jennifer A,0,0,20,20
1745800689151,MCWP 50R,C00,893771,Krone; Jarret,0,3,20,20
1745800689151,MCWP 50R,D00,893772,Miller; Elizabeth Deen,3,0,20,17
1745800689151,MCWP 50R,E00,893775,Carter; Andrea L,0,0,20,20
1745800690180,MMW 11R,A01,892721,Herbst; Matthew,11,0,27,16
1745800690180,MMW 11R,A02,892722,Herbst; Matthew,0,0,0,3
1745800691209,MMW 12R,A01,892724,Herbst; Matthew,0,9,16,16
1745800691209,MMW 12R,A02,892725,Herbst; Matthew,0,9,16,16
1745800692235,MMW 13R,A01,892727,Staff,0,4,16,16
1745800692235,MMW 13R,A02,892728,Staff,0,4,16,16
1745800692235,MMW 13R,A03,958032,Staff,0,3,16,16
1745800692235,MMW 13R,A04,958033,Staff,0,2,16,16
1745800692235,MMW 13R,A05,958034,Staff,0,3,16,16
1745800693261,SIO 295LS,A00,894015,Staff,7,0,25,18
1745800694289,SIO 295S,A00,894020,Staff,7,0,25,18
1745800695324,SIOC 290S,B01,958918,Staff,0,0,0,0
1745800696353,SIOC 291S,B01,958922,Staff,0,0,0,0
1745800697378,SOCI 117,A01,895339,Staff,4,0,5,1
1745800698402,WES 237B,A00,894149,Staff,11,0,20,9
1745800700473,AESE 279B,A00,891859,Staff,13,0,35,22
1745800701501,AIP 197,001,891854,Staff,70,0,70,0
1745800702528,ANTH 289S,A00,891856,Gagneux; Pascal,12,0,12,0
1745800703556,BENG 196,001,957946,Engler; Adam J.,9996,0,9999,3
1745800704585,CAT 124RS,A01,956906,Staff,8,0,25,17
1745800705609,CAT 125RS,A01,922013,Staff,8,0,25,17
1745800706637,CLRE 250,A00,891860,Morris; Sheldon,9995,0,9999,4
1745800708692,CLRE 251R,A00,907817,Mehta; Ravindra L.,9994,0,9999,5
1745800709721,CLRE 252,A00,891864,Cuomo; Raphael Eduardo,9993,0,9999,6
1745800710750,CLRE 253,A00,891867,Vaida; Florin,9994,0,9999,5
1745800710750,CLRE 253,B00,907819,Staff,9999,0,9999,0
1745800711777,CLRE 259,A00,891868,Patel; Hemal,9998,0,9999,1
1745800712806,CLRE 260,A00,891872,Cuomo; Raphael Eduardo,9999,0,9999,0
1745800713835,CLRE 297,001,891888,Cuomo; Raphael Eduardo,9999,0,9999,0
1745800714859,CSE 191,A00,958773,Minnes Kemp; Mor Mia,9999,0,9999,0
1745800715885,CSS 201S,A01,892054,Mignozzetti; Umberto,30,0,30,0
1745800716911,CSS 202S,A01,892056,Mignozzetti; Umberto,30,0,30,0
1745800717938,DSC 197,001,956898,Eldridge; Justin Matthew,9998,0,9999,1
1745800718965,DSC 297,001,958000,Mazumdar; Arya,9998,0,9999,1
1745800720019,EAP 100,A00,905686,Staff,9776,0,9999,223
1745800721045,ECE 45,A01,892618,Staff,0,12,50,50
1745800722070,ECE 109,A01,892620,Staff,0,43,0,0
1745800723095,ECE 111,A01,892719,Staff,0,7,50,50
1745800724124,ECE 197,001,957920,Mercier; Patrick Philip,9992,0,9999,7
1745800725154,ECON 178,A01,907814,Zhu; Ying,28,0,35,7
1745800726178,EDS 115,A00,895312,Staff,41,0,45,4
1745800727204,EDS 117,A01,895337,Staff,30,0,30,0
1745800728231,EDS 125,A00,895341,Jones; Gabrielle Anastasia,43,0,45,2
1745800729257,EDS 128A,A01,895459,Fargason; Sharon Gayle,44,0,45,1
1745800730283,EDS 128B,A01,895543,Pappas; Elizabeth,44,0,45,1
1745800731310,EDS 139,A00,897203,Pappas; Elizabeth,44,0,45,1
1745800731310,EDS 139,B00,897209,Fargason; Sharon Gayle,44,0,45,1
1745800732336,EDS 201,A00,895545,Staff,43,0,45,2
1745800733364,EDS 203,A01,895581,Halter; Christopher P.,43,0,45,2
1745800734391,EDS 204R,A01,895625,Heinzman; Erica M.,43,0,45,2
1745800734391,EDS 204R,B01,895693,Halter; Christopher P.,18,0,45,27
1745800735421,EDS 206R,A00,895694,Fargason; Sharon Gayle,9,0,30,21
1745800735421,EDS 206R,B00,895695,Choi; Bailey Miyeon,20,0,30,10
1745800736446,EDS 250,A00,895697,Hemans; Patricia Ann Benitez,43,0,45,2
1745800737472,EDS 281,A00,895701,Meyerott; Theresa Ann,15,0,15,0
1745800738498,EDS 284,A00,895736,Meyerott; Theresa Ann,15,0,15,0
1745800739527,EDS 286,A00,897210,Fine; Sarah,15,0,15,0
1745800740557,EDS 289C,A01,895770,Daly; Alan J.,15,0,15,0
1745800741587,EDS 290,A00,897211,Hofstetter; Carolyn,15,0,15,0
1745800742614,LIGM 5A,A00,896162,Fischer-Grunski; Eva K,15,0,20,5
1745800743644,LIGM 5B,A00,896260,Fischer-Grunski; Eva K,17,0,20,3
1745800744668,LIGM 5C,A00,896308,Fischer-Grunski; Eva K,18,0,20,2
1745800745693,LIIT 5AS,A00,896313,Carnelos; Chiara,18,0,20,2
1745800746720,LIIT 5BS,A00,896416,Carnelos; Chiara,20,0,20,0
1745800747748,LIIT 5CS,A00,896564,Carnelos; Chiara,20,0,20,0
1745800748774,LISP 5A,A00,896588,Munoz Sanchez; Alicia,4,0,20,16
1745800749800,LISP 5B,A00,896653,Munoz Sanchez; Alicia,10,0,20,10
1745800750826,LISP 5C,A00,896655,Munoz Sanchez; Alicia,4,0,20,16
1745800751853,MAE 197,001,957918,Kleissl; Jan,9998,0,9999,1
1745800752881,MATH 2,A01,957937,Staff,34,0,35,1
1745800753906,MATH 197,001,957876,Kedlaya; Kiran S.,9993,0,9999,6
1745800754935,MCWP 40,A00,892729,Duru; Nur,13,0,20,7
1745800754935,MCWP 40,B00,893304,Montejo; Carolina,20,0,20,0
1745800755960,MCWP 40R,A00,893757,Redela; Pamela Morgan,0,6,20,20
1745800756985,MCWP 50,A00,893758,Morshed; Michael James,2,0,20,18
1745800756985,MCWP 50,B00,893761,Bartulis; Jason Michael,17,0,20,3
1745800758015,MCWP 50R,A00,893766,Compas; Sean Matthew,0,1,20,20
1745800758015,MCWP 50R,B00,893769,Carter; Jennifer A,0,0,20,20
1745800758015,MCWP 50R,C00,893771,Krone; Jarret,0,3,20,20
1745800758015,MCWP 50R,D00,893772,Miller; Elizabeth Deen,3,0,20,17
1745800758015,MCWP 50R,E00,893775,Carter; Andrea L,0,0,20,20
1745800759045,MMW 11R,A01,892721,Herbst; Matthew,11,0,27,16
1745800759045,MMW 11R,A02,892722,Herbst; Matthew,0,0,0,3
1745800760071,MMW 12R,A01,892724,Herbst; Matthew,0,9,16,16
1745800760071,MMW 12R,A02,892725,Herbst; Matthew,0,9,16,16
1745800761101,MMW 13R,A01,892727,Staff,0,4,16,16
1745800761101,MMW 13R,A02,892728,Staff,0,4,16,16
1745800761101,MMW 13R,A03,958032,Staff,0,3,16,16
1745800761101,MMW 13R,A04,958033,Staff,0,2,16,16
1745800761101,MMW 13R,A05,958034,Staff,0,3,16,16
1745800762131,SIO 295LS,A00,894015,Staff,7,0,25,18
1745800763158,SIO 295S,A00,894020,Staff,7,0,25,18
1745800764186,SIOC 290S,B01,958918,Staff,0,0,0,0
1745800765217,SIOC 291S,B01,958922,Staff,0,0,0,0
1745800766243,SOCI 117,A01,895339,Staff,4,0,5,1
1745800767269,WES 237B,A00,894149,Staff,11,0,20,9
1745800769327,AESE 279B,A00,891859,Staff,13,0,35,22
1745800770352,AIP 197,001,891854,Staff,70,0,70,0
1745800771380,ANTH 289S,A00,891856,Gagneux; Pascal,12,0,12,0
1745800772405,BENG 196,001,957946,Engler; Adam J.,9996,0,9999,3
1745800773432,CAT 124RS,A01,956906,Staff,8,0,25,17
1745800774457,CAT 125RS,A01,922013,Staff,8,0,25,17
1745800775485,CLRE 250,A00,891860,Morris; Sheldon,9995,0,9999,4
1745800777537,CLRE 251R,A00,907817,Mehta; Ravindra L.,9994,0,9999,5
1745800778564,CLRE 252,A00,891864,Cuomo; Raphael Eduardo,9993,0,9999,6
1745800779591,CLRE 253,A00,891867,Vaida; Florin,9994,0,9999,5
1745800779591,CLRE 253,B00,907819,Staff,9999,0,9999,0
1745800780616,CLRE 259,A00,891868,Patel; Hemal,9998,0,9999,1
1745800781645,CLRE 260,A00,891872,Cuomo; Raphael Eduardo,9999,0,9999,0
1745800782670,CLRE 297,001,891888,Cuomo; Raphael Eduardo,9999,0,9999,0
1745800783695,CSE 191,A00,958773,Minnes Kemp; Mor Mia,9999,0,9999,0
1745800784720,CSS 201S,A01,892054,Mignozzetti; Umberto,30,0,30,0
1745800785749,CSS 202S,A01,892056,Mignozzetti; Umberto,30,0,30,0
1745800786778,DSC 197,001,956898,Eldridge; Justin Matthew,9998,0,9999,1
1745800787803,DSC 297,001,958000,Mazumdar; Arya,9998,0,9999,1
1745800788831,EAP 100,A00,905686,Staff,9776,0,9999,223
1745800789857,ECE 45,A01,892618,Staff,0,12,50,50
1745800790886,ECE 109,A01,892620,Staff,0,43,0,0
1745800791912,ECE 111,A01,892719,Staff,0,7,50,50
1745800792941,ECE 197,001,957920,Mercier; Patrick Philip,9992,0,9999,7
1745800793969,ECON 178,A01,907814,Zhu; Ying,28,0,35,7
1745800794995,EDS 115,A00,895312,Staff,41,0,45,4
1745800796024,EDS 117,A01,895337,Staff,30,0,30,0
1745800797054,EDS 125,A00,895341,Jones; Gabrielle Anastasia,43,0,45,2
1745800798082,EDS 128A,A01,895459,Fargason; Sharon Gayle,44,0,45,1
1745800799109,EDS 128B,A01,895543,Pappas; Elizabeth,44,0,45,1
1745800800133,EDS 139,A00,897203,Pappas; Elizabeth,44,0,45,1
1745800800133,EDS 139,B00,897209,Fargason; Sharon Gayle,44,0,45,1
1745800801160,EDS 201,A00,895545,Staff,43,0,45,2
1745800802188,EDS 203,A01,895581,Halter; Christopher P.,43,0,45,2
1745800803217,EDS 204R,A01,895625,Heinzman; Erica M.,43,0,45,2
1745800803217,EDS 204R,B01,895693,Halter; Christopher P.,18,0,45,27
1745800804245,EDS 206R,A00,895694,Fargason; Sharon Gayle,9,0,30,21
1745800804245,EDS 206R,B00,895695,Choi; Bailey Miyeon,20,0,30,10
1745800805273,EDS 250,A00,895697,Hemans; Patricia Ann Benitez,43,0,45,2
1745800806299,EDS 281,A00,895701,Meyerott; Theresa Ann,15,0,15,0
1745800807329,EDS 284,A00,895736,Meyerott; Theresa Ann,15,0,15,0
1745800808355,EDS 286,A00,897210,Fine; Sarah,15,0,15,0
1745800809383,EDS 289C,A01,895770,Daly; Alan J.,15,0,15,0
1745800810407,EDS 290,A00,897211,Hofstetter; Carolyn,15,0,15,0
1745800811433,LIGM 5A,A00,896162,Fischer-Grunski; Eva K,15,0,20,5
1745800812462,LIGM 5B,A00,896260,Fischer-Grunski; Eva K,17,0,20,3
1745800813486,LIGM 5C,A00,896308,Fischer-Grunski; Eva K,18,0,20,2
1745800814514,LIIT 5AS,A00,896313,Carnelos; Chiara,18,0,20,2
1745800815544,LIIT 5BS,A00,896416,Carnelos; Chiara,20,0,20,0
1745800816570,LIIT 5CS,A00,896564,Carnelos; Chiara,20,0,20,0
1745800817598,LISP 5A,A00,896588,Munoz Sanchez; Alicia,4,0,20,16
1745800818624,LISP 5B,A00,896653,Munoz Sanchez; Alicia,10,0,20,10
1745800819651,LISP 5C,A00,896655,Munoz Sanchez; Alicia,4,0,20,16
1745800820677,MAE 197,001,957918,Kleissl; Jan,9998,0,9999,1
1745800821702,MATH 2,A01,957937,Staff,34,0,35,1
1745800822731,MATH 197,001,957876,Kedlaya; Kiran S.,9993,0,9999,6
1745800823756,MCWP 40,A00,892729,Duru; Nur,13,0,20,7
1745800823756,MCWP 40,B00,893304,Montejo; Carolina,20,0,20,0
1745800824785,MCWP 40R,A00,893757,Redela; Pamela Morgan,0,6,20,20
1745800825812,MCWP 50,A00,893758,Morshed; Michael James,2,0,20,18
1745800825812,MCWP 50,B00,893761,Bartulis; Jason Michael,17,0,20,3
1745800826839,MCWP 50R,A00,893766,Compas; Sean Matthew,0,1,20,20
1745800826839,MCWP 50R,B00,893769,Carter; Jennifer A,0,0,20,20
1745800826839,MCWP 50R,C00,893771,Krone; Jarret,0,3,20,20
1745800826839,MCWP 50R,D00,893772,Miller; Elizabeth Deen,3,0,20,17
1745800826839,MCWP 50R,E00,893775,Carter; Andrea L,0,0,20,20
1745800827867,MMW 11R,A01,892721,Herbst; Matthew,11,0,27,16
1745800827867,MMW 11R,A02,892722,Herbst; Matthew,0,0,0,3
1745800828894,MMW 12R,A01,892724,Herbst; Matthew,0,9,16,16
1745800828894,MMW 12R,A02,892725,Herbst; Matthew,0,9,16,16
1745800829920,MMW 13R,A01,892727,Staff,0,4,16,16
1745800829920,MMW 13R,A02,892728,Staff,0,4,16,16
1745800829920,MMW 13R,A03,958032,Staff,0,3,16,16
1745800829920,MMW 13R,A04,958033,Staff,0,2,16,16
1745800829920,MMW 13R,A05,958034,Staff,0,3,16,16
1745800830950,SIO 295LS,A00,894015,Staff,7,0,25,18
1745800831977,SIO 295S,A00,894020,Staff,7,0,25,18
1745800833004,SIOC 290S,B01,958918,Staff,0,0,0,0
1745800834035,SIOC 291S,B01,958922,Staff,0,0,0,0
1745800835061,SOCI 117,A01,895339,Staff,4,0,5,1
1745800836090,WES 237B,A00,894149,Staff,11,0,20,9
1745800838145,AESE 279B,A00,891859,Staff,13,0,35,22
1745800839170,AIP 197,001,891854,Staff,70,0,70,0
1745800840196,ANTH 289S,A00,891856,Gagneux; Pascal,12,0,12,0
1745800841223,BENG 196,001,957946,Engler; Adam J.,9996,0,9999,3
1745800842251,CAT 124RS,A01,956906,Staff,8,0,25,17
1745800843276,CAT 125RS,A01,922013,Staff,8,0,25,17
1745800844303,CLRE 250,A00,891860,Morris; Sheldon,9995,0,9999,4
1745800846356,CLRE 251R,A00,907817,Mehta; Ravindra L.,9994,0,9999,5
1745800847381,CLRE 252,A00,891864,Cuomo; Raphael Eduardo,9993,0,9999,6
1745800848407,CLRE 253,A00,891867,Vaida; Florin,9994,0,9999,5
1745800848407,CLRE 253,B00,907819,Staff,9999,0,9999,0
1745800849434,CLRE 259,A00,891868,Patel; Hemal,9998,0,9999,1
1745800850463,CLRE 260,A00,891872,Cuomo; Raphael Eduardo,9999,0,9999,0
1745800851490,CLRE 297,001,891888,Cuomo; Raphael Eduardo,9999,0,9999,0
1745800852513,CSE 191,A00,958773,Minnes Kemp; Mor Mia,9999,0,9999,0
1745800853543,CSS 201S,A01,892054,Mignozzetti; Umberto,30,0,30,0
1745800854570,CSS 202S,A01,892056,Mignozzetti; Umberto,30,0,30,0
1745800855595,DSC 197,001,956898,Eldridge; Justin Matthew,9998,0,9999,1
1745800856623,DSC 297,001,958000,Mazumdar; Arya,9998,0,9999,1
1745800857648,EAP 100,A00,905686,Staff,9776,0,9999,223
1745800858672,ECE 45,A01,892618,Staff,0,12,50,50
1745800859699,ECE 109,A01,892620,Staff,0,43,0,0
1745800860727,ECE 111,A01,892719,Staff,0,7,50,50
1745800861755,ECE 197,001,957920,Mercier; Patrick Philip,9992,0,9999,7
1745800862780,ECON 178,A01,907814,Zhu; Ying,28,0,35,7
1745800863808,EDS 115,A00,895312,Staff,41,0,45,4
1745800864837,EDS 117,A01,895337,Staff,30,0,30,0
1745800865865,EDS 125,A00,895341,Jones; Gabrielle Anastasia,43,0,45,2
1745800866893,EDS 128A,A01,895459,Fargason; Sharon Gayle,44,0,45,1
1745800867919,EDS 128B,A01,895543,Pappas; Elizabeth,44,0,45,1
1745800868946,EDS 139,A00,897203,Pappas; Elizabeth,44,0,45,1
1745800868946,EDS 139,B00,897209,Fargason; Sharon Gayle,44,0,45,1
1745800869975,EDS 201,A00,895545,Staff,43,0,45,2
1745800871001,EDS 203,A01,895581,Halter; Christopher P.,43,0,45,2
1745800872026,EDS 204R,A01,895625,Heinzman; Erica M.,43,0,45,2
1745800872026,EDS 204R,B01,895693,Halter; Christopher P.,18,0,45,27
1745800873052,EDS 206R,A00,895694,Fargason; Sharon Gayle,9,0,30,21
1745800873052,EDS 206R,B00,895695,Choi; Bailey Miyeon,20,0,30,10
1745800874077,EDS 250,A00,895697,Hemans; Patricia Ann Benitez,43,0,45,2
1745800875105,EDS 281,A00,895701,Meyerott; Theresa Ann,15,0,15,0
1745800876133,EDS 284,A00,895736,Meyerott; Theresa Ann,15,0,15,0
1745800877166,EDS 286,A00,897210,Fine; Sarah,15,0,15,0
1745800878191,EDS 289C,A01,895770,Daly; Alan J.,15,0,15,0
1745800879215,EDS 290,A00,897211,Hofstetter; Carolyn,15,0,15,0
1745800880241,LIGM 5A,A00,896162,Fischer-Grunski; Eva K,15,0,20,5
1745800881268,LIGM 5B,A00,896260,Fischer-Grunski; Eva K,17,0,20,3
1745800882298,LIGM 5C,A00,896308,Fischer-Grunski; Eva K,18,0,20,2
1745800883325,LIIT 5AS,A00,896313,Carnelos; Chiara,18,0,20,2
1745800884353,LIIT 5BS,A00,896416,Carnelos; Chiara,20,0,20,0
1745800885379,LIIT 5CS,A00,896564,Carnelos; Chiara,20,0,20,0
1745800886406,LISP 5A,A00,896588,Munoz Sanchez; Alicia,4,0,20,16
1745800887431,LISP 5B,A00,896653,Munoz Sanchez; Alicia,10,0,20,10
1745800888459,LISP 5C,A00,896655,Munoz Sanchez; Alicia,4,0,20,16
1745800889487,MAE 197,001,957918,Kleissl; Jan,9998,0,9999,1
1745800890515,MATH 2,A01,957937,Staff,34,0,35,1
1745800891544,MATH 197,001,957876,Kedlaya; Kiran S.,9993,0,9999,6
1745800892570,MCWP 40,A00,892729,Duru; Nur,13,0,20,7
1745800892570,MCWP 40,B00,893304,Montejo; Carolina,20,0,20,0
1745800893597,MCWP 40R,A00,893757,Redela; Pamela Morgan,0,6,20,20
1745800894622,MCWP 50,A00,893758,Morshed; Michael James,2,0,20,18
1745800894622,MCWP 50,B00,893761,Bartulis; Jason Michael,17,0,20,3
1745800895651,MCWP 50R,A00,893766,Compas; Sean Matthew,0,1,20,20
1745800895651,MCWP 50R,B00,893769,Carter; Jennifer A,0,0,20,20
1745800895651,MCWP 50R,C00,893771,Krone; Jarret,0,3,20,20
1745800895651,MCWP 50R,D00,893772,Miller; Elizabeth Deen,3,0,20,17
1745800895651,MCWP 50R,E00,893775,Carter; Andrea L,0,0,20,20
1745800896678,MMW 11R,A01,892721,Herbst; Matthew,11,0,27,16
1745800896678,MMW 11R,A02,892722,Herbst; Matthew,0,0,0,3
1745800897704,MMW 12R,A01,892724,Herbst; Matthew,0,9,16,16
1745800897704,MMW 12R,A02,892725,Herbst; Matthew,0,9,16,16
1745800898730,MMW 13R,A01,892727,Staff,0,4,16,16
1745800898730,MMW 13R,A02,892728,Staff,0,4,16,16
1745800898730,MMW 13R,A03,958032,Staff,0,3,16,16
1745800898730,MMW 13R,A04,958033,Staff,0,2,16,16
1745800898730,MMW 13R,A05,958034,Staff,0,3,16,16
1745800899756,SIO 295LS,A00,894015,Staff,7,0,25,18
1745800900785,SIO 295S,A00,894020,Staff,7,0,25,18
1745800901811,SIOC 290S,B01,958918,Staff,0,0,0,0
1745800902841,SIOC 291S,B01,958922,Staff,0,0,0,0
1745800903870,SOCI 117,A01,895339,Staff,4,0,5,1
1745800904897,WES 237B,A00,894149,Staff,11,0,20,9
1745800906955,AESE 279B,A00,891859,Staff,13,0,35,22
1745800907979,AIP 197,001,891854,Staff,70,0,70,0
1745800909007,ANTH 289S,A00,891856,Gagneux; Pascal,12,0,12,0
1745800910042,BENG 196,001,957946,Engler; Adam J.,9996,0,9999,3
1745800911071,CAT 124RS,A01,956906,Staff,8,0,25,17
1745800912099,CAT 125RS,A01,922013,Staff,8,0,25,17
1745800913126,CLRE 250,A00,891860,Morris; Sheldon,9995,0,9999,4
1745800915183,CLRE 251R,A00,907817,Mehta; Ravindra L.,9994,0,9999,5
1745800916207,CLRE 252,A00,891864,Cuomo; Raphael Eduardo,9993,0,9999,6
1745800917233,CLRE 253,A00,891867,Vaida; Florin,9994,0,9999,5
1745800917233,CLRE 253,B00,907819,Staff,9999,0,9999,0
1745800918257,CLRE 259,A00,891868,Patel; Hemal,9998,0,9999,1
1745800919283,CLRE 260,A00,891872,Cuomo; Raphael Eduardo,9999,0,9999,0
1745800920310,CLRE 297,001,891888,Cuomo; Raphael Eduardo,9999,0,9999,0
1745800921338,CSE 191,A00,958773,Minnes Kemp; Mor Mia,9999,0,9999,0
1745800922365,CSS 201S,A01,892054,Mignozzetti; Umberto,30,0,30,0
1745800923392,CSS 202S,A01,892056,Mignozzetti; Umberto,30,0,30,0
1745800924420,DSC 197,001,956898,Eldridge; Justin Matthew,9998,0,9999,1
1745800925446,DSC 297,001,958000,Mazumdar; Arya,9998,0,9999,1
1745800926472,EAP 100,A00,905686,Staff,9776,0,9999,223
1745800927500,ECE 45,A01,892618,Staff,0,12,50,50
1745800928527,ECE 109,A01,892620,Staff,0,43,0,0
1745800929557,ECE 111,A01,892719,Staff,0,7,50,50
1745800930583,ECE 197,001,957920,Mercier; Patrick Philip,9992,0,9999,7
1745800931610,ECON 178,A01,907814,Zhu; Ying,28,0,35,7
1745800932636,EDS 115,A00,895312,Staff,41,0,45,4
1745800933661,EDS 117,A01,895337,Staff,30,0,30,0
1745800934690,EDS 125,A00,895341,Jones; Gabrielle Anastasia,43,0,45,2
1745800935715,EDS 128A,A01,895459,Fargason; Sharon Gayle,44,0,45,1
1745800936740,EDS 128B,A01,895543,Pappas; Elizabeth,44,0,45,1
1745800937766,EDS 139,A00,897203,Pappas; Elizabeth,44,0,45,1
1745800937766,EDS 139,B00,897209,Fargason; Sharon Gayle,44,0,45,1
1745800938793,EDS 201,A00,895545,Staff,43,0,45,2
1745800939819,EDS 203,A01,895581,Halter; Christopher P.,43,0,45,2
1745800940847,EDS 204R,A01,895625,Heinzman; Erica M.,43,0,45,2
1745800940847,EDS 204R,B01,895693,Halter; Christopher P.,18,0,45,27
1745800941873,EDS 206R,A00,895694,Fargason; Sharon Gayle,9,0,30,21
1745800941873,EDS 206R,B00,895695,Choi; Bailey Miyeon,20,0,30,10
1745800942899,EDS 250,A00,895697,Hemans; Patricia Ann Benitez,43,0,45,2
1745800943926,EDS 281,A00,895701,Meyerott; Theresa Ann,15,0,15,0
1745800944956,EDS 284,A00,895736,Meyerott; Theresa Ann,15,0,15,0
1745800945981,EDS 286,A00,897210,Fine; Sarah,15,0,15,0
1745800947006,EDS 289C,A01,895770,Daly; Alan J.,15,0,15,0
1745800948032,EDS 290,A00,897211,Hofstetter; Carolyn,15,0,15,0
1745800949057,LIGM 5A,A00,896162,Fischer-Grunski; Eva K,15,0,20,5
1745800950082,LIGM 5B,A00,896260,Fischer-Grunski; Eva K,17,0,20,3
1745800951110,LIGM 5C,A00,896308,Fischer-Grunski; Eva K,18,0,20,2
1745800952136,LIIT 5AS,A00,896313,Carnelos; Chiara,18,0,20,2
1745800953166,LIIT 5BS,A00,896416,Carnelos; Chiara,20,0,20,0
1745800954192,LIIT 5CS,A00,896564,Carnelos; Chiara,20,0,20,0
1745800955218,LISP 5A,A00,896588,Munoz Sanchez; Alicia,4,0,20,16
1745800956242,LISP 5B,A00,896653,Munoz Sanchez; Alicia,10,0,20,10
1745800957269,LISP 5C,A00,896655,Munoz Sanchez; Alicia,4,0,20,16
1745800958294,MAE 197,001,957918,Kleissl; Jan,9998,0,9999,1
1745800959324,MATH 2,A01,957937,Staff,34,0,35,1
1745800960349,MATH 197,001,957876,Kedlaya; Kiran S.,9993,0,9999,6
1745800961378,MCWP 40,A00,892729,Duru; Nur,13,0,20,7
1745800961378,MCWP 40,B00,893304,Montejo; Carolina,20,0,20,0
1745800962404,MCWP 40R,A00,893757,Redela; Pamela Morgan,0,6,20,20
1745800963433,MCWP 50,A00,893758,Morshed; Michael James,2,0,20,18
1745800963433,MCWP 50,B00,893761,Bartulis; Jason Michael,17,0,20,3
1745800964459,MCWP 50R,A00,893766,Compas; Sean Matthew,0,1,20,20
1745800964459,MCWP 50R,B00,893769,Carter; Jennifer A,0,0,20,20
1745800964459,MCWP 50R,C00,893771,Krone; Jarret,0,3,20,20
1745800964459,MCWP 50R,D00,893772,Miller; Elizabeth Deen,3,0,20,17
1745800964459,MCWP 50R,E00,893775,Carter; Andrea L,0,0,20,20
1745800965488,MMW 11R,A01,892721,Herbst; Matthew,11,0,27,16
1745800965488,MMW 11R,A02,892722,Herbst; Matthew,0,0,0,3
1745800966516,MMW 12R,A01,892724,Herbst; Matthew,0,9,16,16
1745800966516,MMW 12R,A02,892725,Herbst; Matthew,0,9,16,16
1745800967545,MMW 13R,A01,892727,Staff,0,4,16,16
1745800967545,MMW 13R,A02,892728,Staff,0,4,16,16
1745800967545,MMW 13R,A03,958032,Staff,0,3,16,16
1745800967545,MMW 13R,A04,958033,Staff,0,2,16,16
1745800967545,MMW 13R,A05,958034,Staff,0,3,16,16
1745800968570,SIO 295LS,A00,894015,Staff,7,0,25,18
1745800969598,SIO 295S,A00,894020,Staff,7,0,25,18
1745800970625,SIOC 290S,B01,958918,Staff,0,0,0,0
1745800971654,SIOC 291S,B01,958922,Staff,0,0,0,0
1745800972678,SOCI 117,A01,895339,Staff,4,0,5,1
1745800973704,WES 237B,A00,894149,Staff,11,0,20,9
1745800975758,AESE 279B,A00,891859,Staff,13,0,35,22
1745800976786,AIP 197,001,891854,Staff,70,0,70,0
1745800977811,ANTH 289S,A00,891856,Gagneux; Pascal,12,0,12,0
1745800978837,BENG 196,001,957946,Engler; Adam J.,9996,0,9999,3
1745800979862,CAT 124RS,A01,956906,Staff,8,0,25,17
1745800980887,CAT 125RS,A01,922013,Staff,8,0,25,17
1745800981915,CLRE 250,A00,891860,Morris; Sheldon,9995,0,9999,4
1745800983970,CLRE 251R,A00,907817,Mehta; Ravindra L.,9994,0,9999,5
1745800984999,CLRE 252,A00,891864,Cuomo; Raphael Eduardo,9993,0,9999,6
1745800986028,CLRE 253,A00,891867,Vaida; Florin,9994,0,9999,5
1745800986028,CLRE 253,B00,907819,Staff,9999,0,9999,0
1745800987053,CLRE 259,A00,891868,Patel; Hemal,9998,0,9999,1
1745800988081,CLRE 260,A00,891872,Cuomo; Raphael Eduardo,9999,0,9999,0
1745800989106,CLRE 297,001,891888,Cuomo; Raphael Eduardo,9999,0,9999,0
1745800990133,CSE 191,A00,958773,Minnes Kemp; Mor Mia,9999,0,9999,0
1745800991157,CSS 201S,A01,892054,Mignozzetti; Umberto,30,0,30,0
1745800992184,CSS 202S,A01,892056,Mignozzetti; Umberto,30,0,30,0
1745800993212,DSC 197,001,956898,Eldridge; Justin Matthew,9998,0,9999,1
1745800994238,DSC 297,001,958000,Mazumdar; Arya,9998,0,9999,1
1745800995266,EAP 100,A00,905686,Staff,9776,0,9999,223
1745800996291,ECE 45,A01,892618,Staff,0,12,50,50
1745800997321,ECE 109,A01,892620,Staff,0,43,0,0
1745800998350,ECE 111,A01,892719,Staff,0,7,50,50
1745800999377,ECE 197,001,957920,Mercier; Patrick Philip,9992,0,9999,7
1745801000405,ECON 178,A01,907814,Zhu; Ying,28,0,35,7
1745801001432,EDS 115,A00,895312,Staff,41,0,45,4
1745801002457,EDS 117,A01,895337,Staff,30,0,30,0
1745801003485,EDS 125,A00,895341,Jones; Gabrielle Anastasia,43,0,45,2
1745801004511,EDS 128A,A01,895459,Fargason; Sharon Gayle,44,0,45,1
1745801005536,EDS 128B,A01,895543,Pappas; Elizabeth,44,0,45,1
1745801006562,EDS 139,A00,897203,Pappas; Elizabeth,44,0,45,1
1745801006562,EDS 139,B00,897209,Fargason; Sharon Gayle,44,0,45,1
1745801007589,EDS 201,A00,895545,Staff,43,0,45,2
1745801008614,EDS 203,A01,895581,Halter; Christopher P.,43,0,45,2
1745801009645,EDS 204R,A01,895625,Heinzman; Erica M.,43,0,45,2
1745801009645,EDS 204R,B01,895693,Halter; Christopher P.,18,0,45,27
1745801010671,EDS 206R,A00,895694,Fargason; Sharon Gayle,9,0,30,21
1745801010671,EDS 206R,B00,895695,Choi; Bailey Miyeon,20,0,30,10
1745801011697,EDS 250,A00,895697,Hemans; Patricia Ann Benitez,43,0,45,2
1745801012724,EDS 281,A00,895701,Meyerott; Theresa Ann,15,0,15,0
1745801013754,EDS 284,A00,895736,Meyerott; Theresa Ann,15,0,15,0
1745801014783,EDS 286,A00,897210,Fine; Sarah,15,0,15,0
1745801015811,EDS 289C,A01,895770,Daly; Alan J.,15,0,15,0
1745801016836,EDS 290,A00,897211,Hofstetter; Carolyn,15,0,15,0
1745801017865,LIGM 5A,A00,896162,Fischer-Grunski; Eva K,15,0,20,5
1745801018891,LIGM 5B,A00,896260,Fischer-Grunski; Eva K,17,0,20,3
1745801019917,LIGM 5C,A00,896308,Fischer-Grunski; Eva K,18,0,20,2
1745801020943,LIIT 5AS,A00,896313,Carnelos; Chiara,18,0,20,2
1745801021970,LIIT 5BS,A00,896416,Carnelos; Chiara,20,0,20,0
1745801022999,LIIT 5CS,A00,896564,Carnelos; Chiara,20,0,20,0
1745801024024,LISP 5A,A00,896588,Munoz Sanchez; Alicia,4,0,20,16
1745801025056,LISP 5B,A00,896653,Munoz Sanchez; Alicia,10,0,20,10
1745801026084,LISP 5C,A00,896655,Munoz Sanchez; Alicia,4,0,20,16
1745801027113,MAE 197,001,957918,Kleissl; Jan,9998,0,9999,1
1745801028140,MATH 2,A01,957937,Staff,34,0,35,1
1745801029168,MATH 197,001,957876,Kedlaya; Kiran S.,9993,0,9999,6
1745801030194,MCWP 40,A00,892729,Duru; Nur,13,0,20,7
1745801030194,MCWP 40,B00,893304,Montejo; Carolina,20,0,20,0
1745801031221,MCWP 40R,A00,893757,Redela; Pamela Morgan,0,6,20,20
1745801032246,MCWP 50,A00,893758,Morshed; Michael James,2,0,20,18
1745801032246,MCWP 50,B00,893761,Bartulis; Jason Michael,17,0,20,3
1745801033274,MCWP 50R,A00,893766,Compas; Sean Matthew,0,1,20,20
1745801033274,MCWP 50R,B00,893769,Carter; Jennifer A,0,0,20,20
1745801033274,MCWP 50R,C00,893771,Krone; Jarret,0,3,20,20
1745801033274,MCWP 50R,D00,893772,Miller; Elizabeth Deen,3,0,20,17
1745801033274,MCWP 50R,E00,893775,Carter; Andrea L,0,0,20,20
1745801034301,MMW 11R,A01,892721,Herbst; Matthew,11,0,27,16
1745801034301,MMW 11R,A02,892722,Herbst; Matthew,0,0,0,3
1745801035329,MMW 12R,A01,892724,Herbst; Matthew,0,9,16,16
1745801035329,MMW 12R,A02,892725,Herbst; Matthew,0,9,16,16
1745801036362,MMW 13R,A01,892727,Staff,0,4,16,16
1745801036362,MMW 13R,A02,892728,Staff,0,4,16,16
1745801036362,MMW 13R,A03,958032,Staff,0,3,16,16
1745801036362,MMW 13R,A04,958033,Staff,0,2,16,16
1745801036362,MMW 13R,A05,958034,Staff,0,3,16,16
1745801037391,SIO 295LS,A00,894015,Staff,7,0,25,18
1745801038417,SIO 295S,A00,894020,Staff,7,0,25,18
1745801039448,SIOC 290S,B01,958918,Staff,0,0,0,0
1745801040477,SIOC 291S,B01,958922,Staff,0,0,0,0
1745801041503,SOCI 117,A01,895339,Staff,4,0,5,1
1745801042530,WES 237B,A00,894149,Staff,11,0,20,9
1745801044594,AESE 279B,A00,891859,Staff,13,0,35,22
1745801045622,AIP 197,001,891854,Staff,70,0,70,0
1745801046649,ANTH 289S,A00,891856,Gagneux; Pascal,12,0,12,0
1745801047676,BENG 196,001,957946,Engler; Adam J.,9996,0,9999,3
1745801048706,CAT 124RS,A01,956906,Staff,8,0,25,17
1745801049733,CAT 125RS,A01,922013,Staff,8,0,25,17
1745801050759,CLRE 250,A00,891860,Morris; Sheldon,9995,0,9999,4
1745801052815,CLRE 251R,A00,907817,Mehta; Ravindra L.,9994,0,9999,5
1745801053839,CLRE 252,A00,891864,Cuomo; Raphael Eduardo,9993,0,9999,6
1745801054869,CLRE 253,A00,891867,Vaida; Florin,9994,0,9999,5
1745801054869,CLRE 253,B00,907819,Staff,9999,0,9999,0
1745801055895,CLRE 259,A00,891868,Patel; Hemal,9998,0,9999,1
1745801056921,CLRE 260,A00,891872,Cuomo; Raphael Eduardo,9999,0,9999,0
1745801057946,CLRE 297,001,891888,Cuomo; Raphael Eduardo,9999,0,9999,0
1745801058973,CSE 191,A00,958773,Minnes Kemp; Mor Mia,9999,0,9999,0
1745801060001,CSS 201S,A01,892054,Mignozzetti; Umberto,30,0,30,0
1745801061031,CSS 202S,A01,892056,Mignozzetti; Umberto,30,0,30,0
1745801062059,DSC 197,001,956898,Eldridge; Justin Matthew,9998,0,9999,1
1745801063085,DSC 297,001,958000,Mazumdar; Arya,9998,0,9999,1
1745801064110,EAP 100,A00,905686,Staff,9776,0,9999,223
1745801065134,ECE 45,A01,892618,Staff,0,12,50,50
1745801066160,ECE 109,A01,892620,Staff,0,43,0,0
1745801067187,ECE 111,A01,892719,Staff,0,7,50,50
1745801068213,ECE 197,001,957920,Mercier; Patrick Philip,9992,0,9999,7
1745801069240,ECON 178,A01,907814,Zhu; Ying,28,0,35,7
1745801070276,EDS 115,A00,895312,Staff,41,0,45,4
1745801071304,EDS 117,A01,895337,Staff,30,0,30,0
1745801072334,EDS 125,A00,895341,Jones; Gabrielle Anastasia,43,0,45,2
1745801073360,EDS 128A,A01,895459,Fargason; Sharon Gayle,44,0,45,1
1745801074390,EDS 128B,A01,895543,Pappas; Elizabeth,44,0,45,1
1745801075416,EDS 139,A00,897203,Pappas; Elizabeth,44,0,45,1
1745801075416,EDS 139,B00,897209,Fargason; Sharon Gayle,44,0,45,1
1745801076442,EDS 201,A00,895545,Staff,43,0,45,2
1745801077469,EDS 203,A01,895581,Halter; Christopher P.,43,0,45,2
1745801078494,EDS 204R,A01,895625,Heinzman; Erica M.,43,0,45,2
1745801078494,EDS 204R,B01,895693,Halter; Christopher P.,18,0,45,27
1745801079522,EDS 206R,A00,895694,Fargason; Sharon Gayle,9,0,30,21
1745801079522,EDS 206R,B00,895695,Choi; Bailey Miyeon,20,0,30,10
1745801080589,EDS 250,A00,895697,Hemans; Patricia Ann Benitez,43,0,45,2
1745801081616,EDS 281,A00,895701,Meyerott; Theresa Ann,15,0,15,0
1745801082643,EDS 284,A00,895736,Meyerott; Theresa Ann,15,0,15,0
1745801083670,EDS 286,A00,897210,Fine; Sarah,15,0,15,0
1745801084699,EDS 289C,A01,895770,Daly; Alan J.,15,0,15,0
1745801085724,EDS 290,A00,897211,Hofstetter; Carolyn,15,0,15,0
1745801086754,LIGM 5A,A00,896162,Fischer-Grunski; Eva K,15,0,20,5
1745801087783,LIGM 5B,A00,896260,Fischer-Grunski; Eva K,17,0,20,3
1745801088813,LIGM 5C,A00,896308,Fischer-Grunski; Eva K,18,0,20,2
1745801089838,LIIT 5AS,A00,896313,Carnelos; Chiara,18,0,20,2
1745801090869,LIIT 5BS,A00,896416,Carnelos; Chiara,20,0,20,0
1745801091896,LIIT 5CS,A00,896564,Carnelos; Chiara,20,0,20,0
1745801092922,LISP 5A,A00,896588,Munoz Sanchez; Alicia,4,0,20,16
1745801093947,LISP 5B,A00,896653,Munoz Sanchez; Alicia,10,0,20,10
1745801094978,LISP 5C,A00,896655,Munoz Sanchez; Alicia,4,0,20,16
1745801096005,MAE 197,001,957918,Kleissl; Jan,9998,0,9999,1
1745801097031,MATH 2,A01,957937,Staff,34,0,35,1
1745801098058,MATH 197,001,957876,Kedlaya; Kiran S.,9993,0,9999,6
1745801099086,MCWP 40,A00,892729,Duru; Nur,13,0,20,7
1745801099086,MCWP 40,B00,893304,Montejo; Carolina,20,0,20,0
1745801100112,MCWP 40R,A00,893757,Redela; Pamela Morgan,0,6,20,20
1745801101139,MCWP 50,A00,893758,Morshed; Michael James,2,0,20,18
1745801101139,MCWP 50,B00,893761,Bartulis; Jason Michael,17,0,20,3
1745801102171,MCWP 50R,A00,893766,Compas; Sean Matthew,0,1,20,20
1745801102171,MCWP 50R,B00,893769,Carter; Jennifer A,0,0,20,20
1745801102171,MCWP 50R,C00,893771,Krone; Jarret,0,3,20,20
1745801102171,MCWP 50R,D00,893772,Miller; Elizabeth Deen,3,0,20,17
1745801102171,MCWP 50R,E00,893775,Carter; Andrea L,0,0,20,20
1745801103197,MMW 11R,A01,892721,Herbst; Matthew,11,0,27,16
1745801103197,MMW 11R,A02,892722,Herbst; Matthew,0,0,0,3
1745801104226,MMW 12R,A01,892724,Herbst; Matthew,0,9,16,16
1745801104226,MMW 12R,A02,892725,Herbst; Matthew,0,9,16,16
1745801105254,MMW 13R,A01,892727,Staff,0,4,16,16
1745801105254,MMW 13R,A02,892728,Staff,0,4,16,16
1745801105254,MMW 13R,A03,958032,Staff,0,3,16,16
1745801105254,MMW 13R,A04,958033,Staff,0,2,16,16
1745801105254,MMW 13R,A05,958034,Staff,0,3,16,16
1745801106280,SIO 295LS,A00,894015,Staff,7,0,25,18
1745801107308,SIO 295S,A00,894020,Staff,7,0,25,18
1745801108336,SIOC 290S,B01,958918,Staff,0,0,0,0
1745801109367,SIOC 291S,B01,958922,Staff,0,0,0,0
1745801110394,SOCI 117,A01,895339,Staff,4,0,5,1
1745801111421,WES 237B,A00,894149,Staff,11,0,20,9
1745801113489,AESE 279B,A00,891859,Staff,13,0,35,22
1745801114514,AIP 197,001,891854,Staff,70,0,70,0
1745801115540,ANTH 289S,A00,891856,Gagneux; Pascal,12,0,12,0
1745801116569,BENG 196,001,957946,Engler; Adam J.,9996,0,9999,3
1745801117602,CAT 124RS,A01,956906,Staff,8,0,25,17
1745801118629,CAT 125RS,A01,922013,Staff,8,0,25,17
1745801119654,CLRE 250,A00,891860,Morris; Sheldon,9995,0,9999,4
1745801121709,CLRE 251R,A00,907817,Mehta; Ravindra L.,9994,0,9999,5
1745801122735,CLRE 252,A00,891864,Cuomo; Raphael Eduardo,9993,0,9999,6
1745801123764,CLRE 253,A00,891867,Vaida; Florin,9994,0,9999,5
1745801123764,CLRE 253,B00,907819,Staff,9999,0,9999,0
1745801124790,CLRE 259,A00,891868,Patel; Hemal,9998,0,9999,1
1745801125814,CLRE 260,A00,891872,Cuomo; Raphael Eduardo,9999,0,9999,0
1745801126842,CLRE 297,001,891888,Cuomo; Raphael Eduardo,9999,0,9999,0
1745801127867,CSE 191,A00,958773,Minnes Kemp; Mor Mia,9999,0,9999,0
1745801128894,CSS 201S,A01,892054,Mignozzetti; Umberto,30,0,30,0
1745801129920,CSS 202S,A01,892056,Mignozzetti; Umberto,30,0,30,0
1745801130947,DSC 197,001,956898,Eldridge; Justin Matthew,9998,0,9999,1
1745801131973,DSC 297,001,958000,Mazumdar; Arya,9998,0,9999,1
1745801133003,EAP 100,A00,905686,Staff,9776,0,9999,223
1745801134029,ECE 45,A01,892618,Staff,0,12,50,50
1745801135054,ECE 109,A01,892620,Staff,0,43,0,0
1745801136083,ECE 111,A01,892719,Staff,0,7,50,50
1745801137111,ECE 197,001,957920,Mercier; Patrick Philip,9992,0,9999,7
1745801138137,ECON 178,A01,907814,Zhu; Ying,28,0,35,7
1745801139163,EDS 115,A00,895312,Staff,41,0,45,4
1745801140188,EDS 117,A01,895337,Staff,30,0,30,0
1745801141214,EDS 125,A00,895341,Jones; Gabrielle Anastasia,43,0,45,2
1745801142242,EDS 128A,A01,895459,Fargason; Sharon Gayle,44,0,45,1
1745801143267,EDS 128B,A01,895543,Pappas; Elizabeth,44,0,45,1
1745801144291,EDS 139,A00,897203,Pappas; Elizabeth,44,0,45,1
1745801144291,EDS 139,B00,897209,Fargason; Sharon Gayle,44,0,45,1
1745801145322,EDS 201,A00,895545,Staff,43,0,45,2
1745801146348,EDS 203,A01,895581,Halter; Christopher P.,43,0,45,2
1745801147373,EDS 204R,A01,895625,Heinzman; Erica M.,43,0,45,2
1745801147373,EDS 204R,B01,895693,Halter; Christopher P.,18,0,45,27
1745801148401,EDS 206R,A00,895694,Fargason; Sharon Gayle,9,0,30,21
1745801148401,EDS 206R,B00,895695,Choi; Bailey Miyeon,20,0,30,10
1745801149429,EDS 250,A00,895697,Hemans; Patricia Ann Benitez,43,0,45,2
1745801150455,EDS 281,A00,895701,Meyerott; Theresa Ann,15,0,15,0
1745801151479,EDS 284,A00,895736,Meyerott; Theresa Ann,15,0,15,0
1745801152506,EDS 286,A00,897210,Fine; Sarah,15,0,15,0
1745801153534,EDS 289C,A01,895770,Daly; Alan J.,15,0,15,0
1745801154559,EDS 290,A00,897211,Hofstetter; Carolyn,15,0,15,0
1745801155588,LIGM 5A,A00,896162,Fischer-Grunski; Eva K,15,0,20,5
1745801156617,LIGM 5B,A00,896260,Fischer-Grunski; Eva K,17,0,20,3
1745801157645,LIGM 5C,A00,896308,Fischer-Grunski; Eva K,18,0,20,2
1745801158669,LIIT 5AS,A00,896313,Carnelos; Chiara,18,0,20,2
1745801159694,LIIT 5BS,A00,896416,Carnelos; Chiara,20,0,20,0
1745801160720,LIIT 5CS,A00,896564,Carnelos; Chiara,20,0,20,0
1745801161748,LISP 5A,A00,896588,Munoz Sanchez; Alicia,4,0,20,16
1745801162775,LISP 5B,A00,896653,Munoz Sanchez; Alicia,10,0,20,10
1745801163803,LISP 5C,A00,896655,Munoz Sanchez; Alicia,4,0,20,16
1745801164832,MAE 197,001,957918,Kleissl; Jan,9998,0,9999,1
1745801165858,MATH 2,A01,957937,Staff,34,0,35,1
1745801166882,MATH 197,001,957876,Kedlaya; Kiran S.,9993,0,9999,6
1745801167909,MCWP 40,A00,892729,Duru; Nur,13,0,20,7
1745801167909,MCWP 40,B00,893304,Montejo; Carolina,20,0,20,0
1745801168933,MCWP 40R,A00,893757,Redela; Pamela Morgan,0,6,20,20
1745801169959,MCWP 50,A00,893758,Morshed; Michael James,2,0,20,18
1745801169959,MCWP 50,B00,893761,Bartulis; Jason Michael,17,0,20,3
1745801170985,MCWP 50R,A00,893766,Compas; Sean Matthew,0,1,20,20
1745801170985,MCWP 50R,B00,893769,Carter; Jennifer A,0,0,20,20
1745801170985,MCWP 50R,C00,893771,Krone; Jarret,0,3,20,20
1745801170985,MCWP 50R,D00,893772,Miller; Elizabeth Deen,3,0,20,17
1745801170985,MCWP 50R,E00,893775,Carter; Andrea L,0,0,20,20
1745801172013,MMW 11R,A01,892721,Herbst; Matthew,11,0,27,16
1745801172013,MMW 11R,A02,892722,Herbst; Matthew,0,0,0,3
1745801173038,MMW 12R,A01,892724,Herbst; Matthew,0,9,16,16
1745801173038,MMW 12R,A02,892725,Herbst; Matthew,0,9,16,16
1745801174067,MMW 13R,A01,892727,Staff,0,4,16,16
1745801174067,MMW 13R,A02,892728,Staff,0,4,16,16
1745801174067,MMW 13R,A03,958032,Staff,0,3,16,16
1745801174067,MMW 13R,A04,958033,Staff,0,2,16,16
1745801174067,MMW 13R,A05,958034,Staff,0,3,16,16
1745801175091,SIO 295LS,A00,894015,Staff,7,0,25,18
1745801176116,SIO 295S,A00,894020,Staff,7,0,25,18
1745801177146,SIOC 290S,B01,958918,Staff,0,0,0,0
1745801178174,SIOC 291S,B01,958922,Staff,0,0,0,0
1745801179200,SOCI 117,A01,895339,Staff,4,0,5,1
1745801180224,WES 237B,A00,894149,Staff,11,0,20,9
1745801182348,AESE 279B,A00,891859,Staff,13,0,35,22
1745801183373,AIP 197,001,891854,Staff,70,0,70,0
1745801184441,ANTH 289S,A00,891856,Gagneux; Pascal,12,0,12,0
1745801185466,BENG 196,001,957946,Engler; Adam J.,9996,0,9999,3
1745801186494,CAT 124RS,A01,956906,Staff,8,0,25,17
1745801187521,CAT 125RS,A01,922013,Staff,8,0,25,17
1745801188548,CLRE 250,A00,891860,Morris; Sheldon,9995,0,9999,4
1745801190598,CLRE 251R,A00,907817,Mehta; Ravindra L.,9994,0,9999,5
1745801191624,CLRE 252,A00,891864,Cuomo; Raphael Eduardo,9993,0,9999,6
1745801192651,CLRE 253,A00,891867,Vaida; Florin,9994,0,9999,5
1745801192651,CLRE 253,B00,907819,Staff,9999,0,9999,0
1745801193676,CLRE 259,A00,891868,Patel; Hemal,9998,0,9999,1
1745801194704,CLRE 260,A00,891872,Cuomo; Raphael Eduardo,9999,0,9999,0
1745801195729,CLRE 297,001,891888,Cuomo; Raphael Eduardo,9999,0,9999,0
1745801196759,CSE 191,A00,958773,Minnes Kemp; Mor Mia,9999,0,9999,0
1745801197788,CSS 201S,A01,892054,Mignozzetti; Umberto,30,0,30,0
1745801198814,CSS 202S,A01,892056,Mignozzetti; Umberto,30,0,30,0
1745801199840,DSC 197,001,956898,Eldridge; Justin Matthew,9998,0,9999,1
1745801200869,DSC 297,001,958000,Mazumdar; Arya,9998,0,9999,1
1745801201893,EAP 100,A00,905686,Staff,9776,0,9999,223
1745801202919,ECE 45,A01,892618,Staff,0,12,50,50
1745801203943,ECE 109,A01,892620,Staff,0,43,0,0
1745801204969,ECE 111,A01,892719,Staff,0,7,50,50
1745801205995,ECE 197,001,957920,Mercier; Patrick Philip,9992,0,9999,7
1745801207020,ECON 178,A01,907814,Zhu; Ying,28,0,35,7
1745801208048,EDS 115,A00,895312,Staff,41,0,45,4
1745801209073,EDS 117,A01,895337,Staff,30,0,30,0
1745801210100,EDS 125,A00,895341,Jones; Gabrielle Anastasia,43,0,45,2
1745801211126,EDS 128A,A01,895459,Fargason; Sharon Gayle,44,0,45,1
1745801212150,EDS 128B,A01,895543,Pappas; Elizabeth,44,0,45,1
1745801213178,EDS 139,A00,897203,Pappas; Elizabeth,44,0,45,1
1745801213178,EDS 139,B00,897209,Fargason; Sharon Gayle,44,0,45,1
1745801214205,EDS 201,A00,895545,Staff,43,0,45,2
1745801215230,EDS 203,A01,895581,Halter; Christopher P.,43,0,45,2
1745801216256,EDS 204R,A01,895625,Heinzman; Erica M.,43,0,45,2
1745801216256,EDS 204R,B01,895693,Halter; Christopher P.,18,0,45,27
1745801217282,EDS 206R,A00,895694,Fargason; Sharon Gayle,9,0,30,21
1745801217282,EDS 206R,B00,895695,Choi; Bailey Miyeon,20,0,30,10
1745801218308,EDS 250,A00,895697,Hemans; Patricia Ann Benitez,43,0,45,2
1745801219335,EDS 281,A00,895701,Meyerott; Theresa Ann,15,0,15,0
1745801220362,EDS 284,A00,895736,Meyerott; Theresa Ann,15,0,15,0
1745801221387,EDS 286,A00,897210,Fine; Sarah,15,0,15,0
1745801222416,EDS 289C,A01,895770,Daly; Alan J.,15,0,15,0
1745801223442,EDS 290,A00,897211,Hofstetter; Carolyn,15,0,15,0
1745801224467,LIGM 5A,A00,896162,Fischer-Grunski; Eva K,15,0,20,5
1745801225492,LIGM 5B,A00,896260,Fischer-Grunski; Eva K,17,0,20,3
1745801226517,LIGM 5C,A00,896308,Fischer-Grunski; Eva K,18,0,20,2
1745801227545,LIIT 5AS,A00,896313,Carnelos; Chiara,18,0,20,2
1745801228572,LIIT 5BS,A00,896416,Carnelos; Chiara,20,0,20,0
1745801229601,LIIT 5CS,A00,896564,Carnelos; Chiara,20,0,20,0
1745801230626,LISP 5A,A00,896588,Munoz Sanchez; Alicia,4,0,20,16
1745801231655,LISP 5B,A00,896653,Munoz Sanchez; Alicia,10,0,20,10
1745801232684,LISP 5C,A00,896655,Munoz Sanchez; Alicia,4,0,20,16
1745801233711,MAE 197,001,957918,Kleissl; Jan,9998,0,9999,1
1745801234737,MATH 2,A01,957937,Staff,34,0,35,1
1745801235763,MATH 197,001,957876,Kedlaya; Kiran S.,9993,0,9999,6
1745801236789,MCWP 40,A00,892729,Duru; Nur,13,0,20,7
1745801236789,MCWP 40,B00,893304,Montejo; Carolina,20,0,20,0
1745801237820,MCWP 40R,A00,893757,Redela; Pamela Morgan,0,6,20,20
1745801238846,MCWP 50,A00,893758,Morshed; Michael James,2,0,20,18
1745801238846,MCWP 50,B00,893761,Bartulis; Jason Michael,17,0,20,3
1745801239873,MCWP 50R,A00,893766,Compas; Sean Matthew,0,1,20,20
1745801239873,MCWP 50R,B00,893769,Carter; Jennifer A,0,0,20,20
1745801239873,MCWP 50R,C00,893771,Krone; Jarret,0,3,20,20
1745801239873,MCWP 50R,D00,893772,Miller; Elizabeth Deen,3,0,20,17
1745801239873,MCWP 50R,E00,893775,Carter; Andrea L,0,0,20,20
1745801240902,MMW 11R,A01,892721,Herbst; Matthew,11,0,27,16
1745801240902,MMW 11R,A02,892722,Herbst; Matthew,0,0,0,3
1745801241929,MMW 12R,A01,892724,Herbst; Matthew,0,9,16,16
1745801241929,MMW 12R,A02,892725,Herbst; Matthew,0,9,16,16
1745801242955,MMW 13R,A01,892727,Staff,0,4,16,16
1745801242955,MMW 13R,A02,892728,Staff,0,4,16,16
1745801242955,MMW 13R,A03,958032,Staff,0,3,16,16
1745801242955,MMW 13R,A04,958033,Staff,0,2,16,16
1745801242955,MMW 13R,A05,958034,Staff,0,3,16,16
1745801243983,SIO 295LS,A00,894015,Staff,7,0,25,18
1745801245010,SIO 295S,A00,894020,Staff,7,0,25,18
1745801246038,SIOC 290S,B01,958918,Staff,0,0,0,0
1745801247067,SIOC 291S,B01,958922,Staff,0,0,0,0
1745801248093,SOCI 117,A01,895339,Staff,4,0,5,1
1745801249119,WES 237B,A00,894149,Staff,11,0,20,9
1745801251179,AESE 279B,A00,891859,Staff,13,0,35,22
1745801252202,AIP 197,001,891854,Staff,70,0,70,0
1745801253227,ANTH 289S,A00,891856,Gagneux; Pascal,12,0,12,0
1745801254253,BENG 196,001,957946,Engler; Adam J.,9996,0,9999,3
1745801255280,CAT 124RS,A01,956906,Staff,8,0,25,17
1745801256303,CAT 125RS,A01,922013,Staff,8,0,25,17
1745801257331,CLRE 250,A00,891860,Morris; Sheldon,9995,0,9999,4
1745801259382,CLRE 251R,A00,907817,Mehta; Ravindra L.,9994,0,9999,5
1745801260409,CLRE 252,A00,891864,Cuomo; Raphael Eduardo,9993,0,9999,6
1745801261434,CLRE 253,A00,891867,Vaida; Florin,9994,0,9999,5
1745801261434,CLRE 253,B00,907819,Staff,9999,0,9999,0
1745801262460,CLRE 259,A00,891868,Patel; Hemal,9998,0,9999,1
1745801263485,CLRE 260,A00,891872,Cuomo; Raphael Eduardo,9999,0,9999,0
1745801264511,CLRE 297,001,891888,Cuomo; Raphael Eduardo,9999,0,9999,0
1745801265540,CSE 191,A00,958773,Minnes Kemp; Mor Mia,9999,0,9999,0
1745801266566,CSS 201S,A01,892054,Mignozzetti; Umberto,30,0,30,0
1745801267591,CSS 202S,A01,892056,Mignozzetti; Umberto,30,0,30,0
1745801268617,DSC 197,001,956898,Eldridge; Justin Matthew,9998,0,9999,1
1745801269645,DSC 297,001,958000,Mazumdar; Arya,9998,0,9999,1
1745801270673,EAP 100,A00,905686,Staff,9776,0,9999,223
1745801271702,ECE 45,A01,892618,Staff,0,12,50,50
1745801272729,ECE 109,A01,892620,Staff,0,43,0,0
1745801273755,ECE 111,A01,892719,Staff,0,7,50,50
1745801274780,ECE 197,001,957920,Mercier; Patrick Philip,9992,0,9999,7
1745801275806,ECON 178,A01,907814,Zhu; Ying,28,0,35,7
1745801276831,EDS 115,A00,895312,Staff,41,0,45,4
1745801277856,EDS 117,A01,895337,Staff,30,0,30,0
1745801278883,EDS 125,A00,895341,Jones; Gabrielle Anastasia,43,0,45,2
1745801279910,EDS 128A,A01,895459,Fargason; Sharon Gayle,44,0,45,1
1745801280948,EDS 128B,A01,895543,Pappas; Elizabeth,44,0,45,1
1745801281975,EDS 139,A00,897203,Pappas; Elizabeth,44,0,45,1
1745801281975,EDS 139,B00,897209,Fargason; Sharon Gayle,44,0,45,1
1745801283003,EDS 201,A00,895545,Staff,43,0,45,2
1745801284028,EDS 203,A01,895581,Halter; Christopher P.,43,0,45,2
1745801285054,EDS 204R,A01,895625,Heinzman; Erica M.,43,0,45,2
1745801285054,EDS 204R,B01,895693,Halter; Christopher P.,18,0,45,27
1745801286080,EDS 206R,A00,895694,Fargason; Sharon Gayle,9,0,30,21
1745801286080,EDS 206R,B00,895695,Choi; Bailey Miyeon,20,0,30,10
1745801287105,EDS 250,A00,895697,Hemans; Patricia Ann Benitez,43,0,45,2
1745801288134,EDS 281,A00,895701,Meyerott; Theresa Ann,15,0,15,0
1745801289158,EDS 284,A00,895736,Meyerott; Theresa Ann,15,0,15,0
1745801290184,EDS 286,A00,897210,Fine; Sarah,15,0,15,0
1745801291211,EDS 289C,A01,895770,Daly; Alan J.,15,0,15,0
1745801292236,EDS 290,A00,897211,Hofstetter; Carolyn,15,0,15,0
1745801293261,LIGM 5A,A00,896162,Fischer-Grunski; Eva K,15,0,20,5
1745801294290,LIGM 5B,A00,896260,Fischer-Grunski; Eva K,17,0,20,3
1745801295315,LIGM 5C,A00,896308,Fischer-Grunski; Eva K,18,0,20,2
1745801296343,LIIT 5AS,A00,896313,Carnelos; Chiara,18,0,20,2
1745801297374,LIIT 5BS,A00,896416,Carnelos; Chiara,20,0,20,0
1745801298403,LIIT 5CS,A00,896564,Carnelos; Chiara,20,0,20,0
1745801299428,LISP 5A,A00,896588,Munoz Sanchez; Alicia,4,0,20,16
1745801300455,LISP 5B,A00,896653,Munoz Sanchez; Alicia,10,0,20,10
1745801301485,LISP 5C,A00,896655,Munoz Sanchez; Alicia,4,0,20,16
1745801302512,MAE 197,001,957918,Kleissl; Jan,9998,0,9999,1
1745801303539,MATH 2,A01,957937,Staff,34,0,35,1
1745801304568,MATH 197,001,957876,Kedlaya; Kiran S.,9993,0,9999,6
1745801305593,MCWP 40,A00,892729,Duru; Nur,13,0,20,7
1745801305593,MCWP 40,B00,893304,Montejo; Carolina,20,0,20,0
1745801306621,MCWP 40R,A00,893757,Redela; Pamela Morgan,0,6,20,20
1745801307647,MCWP 50,A00,893758,Morshed; Michael James,2,0,20,18
1745801307647,MCWP 50,B00,893761,Bartulis; Jason Michael,17,0,20,3
1745801308675,MCWP 50R,A00,893766,Compas; Sean Matthew,0,1,20,20
1745801308675,MCWP 50R,B00,893769,Carter; Jennifer A,0,0,20,20
1745801308675,MCWP 50R,C00,893771,Krone; Jarret,0,3,20,20
1745801308675,MCWP 50R,D00,893772,Miller; Elizabeth Deen,3,0,20,17
1745801308675,MCWP 50R,E00,893775,Carter; Andrea L,0,0,20,20
1745801309703,MMW 11R,A01,892721,Herbst; Matthew,11,0,27,16
1745801309703,MMW 11R,A02,892722,Herbst; Matthew,0,0,0,3
1745801310731,MMW 12R,A01,892724,Herbst; Matthew,0,9,16,16
1745801310731,MMW 12R,A02,892725,Herbst; Matthew,0,9,16,16
1745801311759,MMW 13R,A01,892727,Staff,0,4,16,16
1745801311759,MMW 13R,A02,892728,Staff,0,4,16,16
1745801311759,MMW 13R,A03,958032,Staff,0,3,16,16
1745801311759,MMW 13R,A04,958033,Staff,0,2,16,16
1745801311759,MMW 13R,A05,958034,Staff,0,3,16,16
1745801312788,SIO 295LS,A00,894015,Staff,7,0,25,18
1745801313817,SIO 295S,A00,894020,Staff,7,0,25,18
1745801314846,SIOC 290S,B01,958918,Staff,0,0,0,0
1745801315873,SIOC 291S,B01,958922,Staff,0,0,0,0
1745801316900,SOCI 117,A01,895339,Staff,4,0,5,1
1745801317926,WES 237B,A00,894149,Staff,11,0,20,9
1745801319995,AESE 279B,A00,891859,Staff,13,0,35,22
1745801321024,AIP 197,001,891854,Staff,70,0,70,0
1745801322054,ANTH 289S,A00,891856,Gagneux; Pascal,12,0,12,0
1745801323082,BENG 196,001,957946,Engler; Adam J.,9996,0,9999,3
1745801324107,CAT 124RS,A01,956906,Staff,8,0,25,17
1745801325132,CAT 125RS,A01,922013,Staff,8,0,25,17
1745801326158,CLRE 250,A00,891860,Morris; Sheldon,9995,0,9999,4
1745801328213,CLRE 251R,A00,907817,Mehta; Ravindra L.,9994,0,9999,5
1745801329243,CLRE 252,A00,891864,Cuomo; Raphael Eduardo,9993,0,9999,6
1745801330273,CLRE 253,A00,891867,Vaida; Florin,9994,0,9999,5
1745801330273,CLRE 253,B00,907819,Staff,9999,0,9999,0
1745801331300,CLRE 259,A00,891868,Patel; Hemal,9998,0,9999,1
1745801332329,CLRE 260,A00,891872,Cuomo; Raphael Eduardo,9999,0,9999,0
1745801333354,CLRE 297,001,891888,Cuomo; Raphael Eduardo,9999,0,9999,0
1745801334382,CSE 191,A00,958773,Minnes Kemp; Mor Mia,9999,0,9999,0
1745801335409,CSS 201S,A01,892054,Mignozzetti; Umberto,30,0,30,0
1745801336434,CSS 202S,A01,892056,Mignozzetti; Umberto,30,0,30,0
1745801337460,DSC 197,001,956898,Eldridge; Justin Matthew,9998,0,9999,1
1745801338485,DSC 297,001,958000,Mazumdar; Arya,9998,0,9999,1
1745801339511,EAP 100,A00,905686,Staff,9776,0,9999,223
1745801340538,ECE 45,A01,892618,Staff,0,12,50,50
1745801341565,ECE 109,A01,892620,Staff,0,43,0,0
1745801342597,ECE 111,A01,892719,Staff,0,7,50,50
1745801343625,ECE 197,001,957920,Mercier; Patrick Philip,9992,0,9999,7
1745801344654,ECON 178,A01,907814,Zhu; Ying,28,0,35,7
1745801345680,EDS 115,A00,895312,Staff,41,0,45,4
1745801346708,EDS 117,A01,895337,Staff,30,0,30,0
1745801347733,EDS 125,A00,895341,Jones; Gabrielle Anastasia,43,0,45,2
1745801348760,EDS 128A,A01,895459,Fargason; Sharon Gayle,44,0,45,1
1745801349785,EDS 128B,A01,895543,Pappas; Elizabeth,44,0,45,1
1745801350811,EDS 139,A00,897203,Pappas; Elizabeth,44,0,45,1
1745801350811,EDS 139,B00,897209,Fargason; Sharon Gayle,44,0,45,1
1745801351840,EDS 201,A00,895545,Staff,43,0,45,2
1745801352871,EDS 203,A01,895581,Halter; Christopher P.,43,0,45,2
1745801353895,EDS 204R,A01,895625,Heinzman; Erica M.,43,0,45,2
1745801353895,EDS 204R,B01,895693,Halter; Christopher P.,18,0,45,27
1745801354926,EDS 206R,A00,895694,Fargason; Sharon Gayle,9,0,30,21
1745801354926,EDS 206R,B00,895695,Choi; Bailey Miyeon,20,0,30,10
1745801355950,EDS 250,A00,895697,Hemans; Patricia Ann Benitez,43,0,45,2
1745801356977,EDS 281,A00,895701,Meyerott; Theresa Ann,15,0,15,0
1745801358004,EDS 284,A00,895736,Meyerott; Theresa Ann,15,0,15,0
1745801359033,EDS 286,A00,897210,Fine; Sarah,15,0,15,0
1745801360057,EDS 289C,A01,895770,Daly; Alan J.,15,0,15,0
1745801361082,EDS 290,A00,897211,Hofstetter; Carolyn,15,0,15,0
1745801362109,LIGM 5A,A00,896162,Fischer-Grunski; Eva K,15,0,20,5
1745801363135,LIGM 5B,A00,896260,Fischer-Grunski; Eva K,17,0,20,3
1745801364164,LIGM 5C,A00,896308,Fischer-Grunski; Eva K,18,0,20,2
1745801365190,LIIT 5AS,A00,896313,Carnelos; Chiara,18,0,20,2
1745801366216,LIIT 5BS,A00,896416,Carnelos; Chiara,20,0,20,0
1745801367242,LIIT 5CS,A00,896564,Carnelos; Chiara,20,0,20,0
1745801368273,LISP 5A,A00,896588,Munoz Sanchez; Alicia,4,0,20,16
1745801369300,LISP 5B,A00,896653,Munoz Sanchez; Alicia,10,0,20,10
1745801370326,LISP 5C,A00,896655,Munoz Sanchez; Alicia,4,0,20,16
1745801371352,MAE 197,001,957918,Kleissl; Jan,9998,0,9999,1
1745801372391,MATH 2,A01,957937,Staff,34,0,35,1
1745801373418,MATH 197,001,957876,Kedlaya; Kiran S.,9993,0,9999,6
1745801374446,MCWP 40,A00,892729,Duru; Nur,13,0,20,7
1745801374446,MCWP 40,B00,893304,Montejo; Carolina,20,0,20,0
1745801375475,MCWP 40R,A00,893757,Redela; Pamela Morgan,0,6,20,20
1745801376500,MCWP 50,A00,893758,Morshed; Michael James,2,0,20,18
1745801376500,MCWP 50,B00,893761,Bartulis; Jason Michael,17,0,20,3
1745801377527,MCWP 50R,A00,893766,Compas; Sean Matthew,0,1,20,20
1745801377527,MCWP 50R,B00,893769,Carter; Jennifer A,0,0,20,20
1745801377527,MCWP 50R,C00,893771,Krone; Jarret,0,3,20,20
1745801377527,MCWP 50R,D00,893772,Miller; Elizabeth Deen,3,0,20,17
1745801377527,MCWP 50R,E00,893775,Carter; Andrea L,0,0,20,20
1745801378555,MMW 11R,A01,892721,Herbst; Matthew,11,0,27,16
1745801378555,MMW 11R,A02,892722,Herbst; Matthew,0,0,0,3
1745801379580,MMW 12R,A01,892724,Herbst; Matthew,0,9,16,16
1745801379580,MMW 12R,A02,892725,Herbst; Matthew,0,9,16,16
1745801380607,MMW 13R,A01,892727,Staff,0,4,16,16
1745801380607,MMW 13R,A02,892728,Staff,0,4,16,16
1745801380607,MMW 13R,A03,958032,Staff,0,3,16,16
1745801380607,MMW 13R,A04,958033,Staff,0,2,16,16
1745801380607,MMW 13R,A05,958034,Staff,0,3,16,16
1745801381633,SIO 295LS,A00,894015,Staff,7,0,25,18
1745801382658,SIO 295S,A00,894020,Staff,7,0,25,18
1745801383684,SIOC 290S,B01,958918,Staff,0,0,0,0
1745801384713,SIOC 291S,B01,958922,Staff,0,0,0,0
1745801385740,SOCI 117,A01,895339,Staff,4,0,5,1
1745801386766,WES 237B,A00,894149,Staff,11,0,20,9
1745801388826,AESE 279B,A00,891859,Staff,13,0,35,22
1745801389855,AIP 197,001,891854,Staff,70,0,70,0
1745801390884,ANTH 289S,A00,891856,Gagneux; Pascal,12,0,12,0
1745801391912,BENG 196,001,957946,Engler; Adam J.,9996,0,9999,3
1745801392938,CAT 124RS,A01,956906,Staff,8,0,25,17
1745801393966,CAT 125RS,A01,922013,Staff,8,0,25,17
1745801394992,CLRE 250,A00,891860,Morris; Sheldon,9995,0,9999,4
1745801397045,CLRE 251R,A00,907817,Mehta; Ravindra L.,9994,0,9999,5
1745801398071,CLRE 252,A00,891864,Cuomo; Raphael Eduardo,9993,0,9999,6
1745801399101,CLRE 253,A00,891867,Vaida; Florin,9994,0,9999,5
1745801399101,CLRE 253,B00,907819,Staff,9999,0,9999,0
1745801400129,CLRE 259,A00,891868,Patel; Hemal,9998,0,9999,1
1745801401159,CLRE 260,A00,891872,Cuomo; Raphael Eduardo,9999,0,9999,0
1745801402186,CLRE 297,001,891888,Cuomo; Raphael Eduardo,9999,0,9999,0
1745801403215,CSE 191,A00,958773,Minnes Kemp; Mor Mia,9999,0,9999,0
1745801404246,CSS 201S,A01,892054,Mignozzetti; Umberto,30,0,30,0
1745801405276,CSS 202S,A01,892056,Mignozzetti; Umberto,30,0,30,0
1745801406304,DSC 197,001,956898,Eldridge; Justin Matthew,9998,0,9999,1
1745801407332,DSC 297,001,958000,Mazumdar; Arya,9998,0,9999,1
1745801408356,EAP 100,A00,905686,Staff,9776,0,9999,223
1745801409383,ECE 45,A01,892618,Staff,0,12,50,50
1745801410411,ECE 109,A01,892620,Staff,0,43,0,0
1745801411439,ECE 111,A01,892719,Staff,0,7,50,50
1745801412464,ECE 197,001,957920,Mercier; Patrick Philip,9992,0,9999,7
1745801413490,ECON 178,A01,907814,Zhu; Ying,28,0,35,7
1745801414515,EDS 115,A00,895312,Staff,41,0,45,4
1745801415544,EDS 117,A01,895337,Staff,30,0,30,0
1745801416571,EDS 125,A00,895341,Jones; Gabrielle Anastasia,43,0,45,2
1745801417600,EDS 128A,A01,895459,Fargason; Sharon Gayle,44,0,45,1
1745801418628,EDS 128B,A01,895543,Pappas; Elizabeth,44,0,45,1
1745801419654,EDS 139,A00,897203,Pappas; Elizabeth,44,0,45,1
1745801419654,EDS 139,B00,897209,Fargason; Sharon Gayle,44,0,45,1
1745801420681,EDS 201,A00,895545,Staff,43,0,45,2
1745801421709,EDS 203,A01,895581,Halter; Christopher P.,43,0,45,2
1745801422738,EDS 204R,A01,895625,Heinzman; Erica M.,43,0,45,2
1745801422738,EDS 204R,B01,895693,Halter; Christopher P.,18,0,45,27
1745801423765,EDS 206R,A00,895694,Fargason; Sharon Gayle,9,0,30,21
1745801423765,EDS 206R,B00,895695,Choi; Bailey Miyeon,20,0,30,10
1745801424791,EDS 250,A00,895697,Hemans; Patricia Ann Benitez,43,0,45,2
1745801425816,EDS 281,A00,895701,Meyerott; Theresa Ann,15,0,15,0
1745801426841,EDS 284,A00,895736,Meyerott; Theresa Ann,15,0,15,0
1745801427866,EDS 286,A00,897210,Fine; Sarah,15,0,15,0
1745801428890,EDS 289C,A01,895770,Daly; Alan J.,15,0,15,0
1745801429916,EDS 290,A00,897211,Hofstetter; Carolyn,15,0,15,0
1745801430942,LIGM 5A,A00,896162,Fischer-Grunski; Eva K,15,0,20,5
1745801431972,LIGM 5B,A00,896260,Fischer-Grunski; Eva K,17,0,20,3
1745801432999,LIGM 5C,A00,896308,Fischer-Grunski; Eva K,18,0,20,2
1745801434034,LIIT 5AS,A00,896313,Carnelos; Chiara,18,0,20,2
1745801435058,LIIT 5BS,A00,896416,Carnelos; Chiara,20,0,20,0
1745801436084,LIIT 5CS,A00,896564,Carnelos; Chiara,20,0,20,0
1745801437112,LISP 5A,A00,896588,Munoz Sanchez; Alicia,4,0,20,16
1745801438140,LISP 5B,A00,896653,Munoz Sanchez; Alicia,10,0,20,10
1745801439168,LISP 5C,A00,896655,Munoz Sanchez; Alicia,4,0,20,16
1745801440197,MAE 197,001,957918,Kleissl; Jan,9998,0,9999,1
1745801441225,MATH 2,A01,957937,Staff,34,0,35,1
1745801442253,MATH 197,001,957876,Kedlaya; Kiran S.,9993,0,9999,6
1745801443279,MCWP 40,A00,892729,Duru; Nur,13,0,20,7
1745801443279,MCWP 40,B00,893304,Montejo; Carolina,20,0,20,0
1745801444307,MCWP 40R,A00,893757,Redela; Pamela Morgan,0,6,20,20
1745801445335,MCWP 50,A00,893758,Morshed; Michael James,2,0,20,18
1745801445335,MCWP 50,B00,893761,Bartulis; Jason Michael,17,0,20,3
1745801446361,MCWP 50R,A00,893766,Compas; Sean Matthew,0,1,20,20
1745801446361,MCWP 50R,B00,893769,Carter; Jennifer A,0,0,20,20
1745801446361,MCWP 50R,C00,893771,Krone; Jarret,0,3,20,20
1745801446361,MCWP 50R,D00,893772,Miller; Elizabeth Deen,3,0,20,17
1745801446361,MCWP 50R,E00,893775,Carter; Andrea L,0,0,20,20
1745801447387,MMW 11R,A01,892721,Herbst; Matthew,11,0,27,16
1745801447387,MMW 11R,A02,892722,Herbst; Matthew,0,0,0,3
1745801448411,MMW 12R,A01,892724,Herbst; Matthew,0,9,16,16
1745801448411,MMW 12R,A02,892725,Herbst; Matthew,0,9,16,16
1745801449440,MMW 13R,A01,892727,Staff,0,4,16,16
1745801449440,MMW 13R,A02,892728,Staff,0,4,16,16
1745801449440,MMW 13R,A03,958032,Staff,0,3,16,16
1745801449440,MMW 13R,A04,958033,Staff,0,2,16,16
1745801449440,MMW 13R,A05,958034,Staff,0,3,16,16
1745801450468,SIO 295LS,A00,894015,Staff,7,0,25,18
1745801451494,SIO 295S,A00,894020,Staff,7,0,25,18
1745801452520,SIOC 290S,B01,958918,Staff,0,0,0,0
1745801453547,SIOC 291S,B01,958922,Staff,0,0,0,0
1745801454572,SOCI 117,A01,895339,Staff,4,0,5,1
1745801455596,WES 237B,A00,894149,Staff,11,0,20,9
1745801457663,AESE 279B,A00,891859,Staff,13,0,35,22
1745801458687,AIP 197,001,891854,Staff,70,0,70,0
1745801459712,ANTH 289S,A00,891856,Gagneux; Pascal,12,0,12,0
1745801460739,BENG 196,001,957946,Engler; Adam J.,9996,0,9999,3
1745801461763,CAT 124RS,A01,956906,Staff,8,0,25,17
1745801462788,CAT 125RS,A01,922013,Staff,8,0,25,17
1745801463816,CLRE 250,A00,891860,Morris; Sheldon,9995,0,9999,4
1745801465870,CLRE 251R,A00,907817,Mehta; Ravindra L.,9994,0,9999,5
1745801466895,CLRE 252,A00,891864,Cuomo; Raphael Eduardo,9993,0,9999,6
1745801467921,CLRE 253,A00,891867,Vaida; Florin,9994,0,9999,5
1745801467921,CLRE 253,B00,907819,Staff,9999,0,9999,0
1745801468949,CLRE 259,A00,891868,Patel; Hemal,9998,0,9999,1
1745801469976,CLRE 260,A00,891872,Cuomo; Raphael Eduardo,9999,0,9999,0
1745801471002,CLRE 297,001,891888,Cuomo; Raphael Eduardo,9999,0,9999,0
1745801472029,CSE 191,A00,958773,Minnes Kemp; Mor Mia,9999,0,9999,0
1745801473060,CSS 201S,A01,892054,Mignozzetti; Umberto,30,0,30,0
1745801474090,CSS 202S,A01,892056,Mignozzetti; Umberto,30,0,30,0
1745801475116,DSC 197,001,956898,Eldridge; Justin Matthew,9998,0,9999,1
1745801476143,DSC 297,001,958000,Mazumdar; Arya,9998,0,9999,1
1745801477168,EAP 100,A00,905686,Staff,9776,0,9999,223
1745801478195,ECE 45,A01,892618,Staff,0,12,50,50
1745801479221,ECE 109,A01,892620,Staff,0,43,0,0
1745801480248,ECE 111,A01,892719,Staff,0,7,50,50
1745801481276,ECE 197,001,957920,Mercier; Patrick Philip,9992,0,9999,7
1745801482303,ECON 178,A01,907814,Zhu; Ying,28,0,35,7
1745801483332,EDS 115,A00,895312,Staff,41,0,45,4
1745801484360,EDS 117,A01,895337,Staff,30,0,30,0
1745801485387,EDS 125,A00,895341,Jones; Gabrielle Anastasia,43,0,45,2
1745801486413,EDS 128A,A01,895459,Fargason; Sharon Gayle,44,0,45,1
1745801487442,EDS 128B,A01,895543,Pappas; Elizabeth,44,0,45,1
1745801488468,EDS 139,A00,897203,Pappas; Elizabeth,44,0,45,1
1745801488468,EDS 139,B00,897209,Fargason; Sharon Gayle,44,0,45,1
1745801489492,EDS 201,A00,895545,Staff,43,0,45,2
1745801490522,EDS 203,A01,895581,Halter; Christopher P.,43,0,45,2
1745801491547,EDS 204R,A01,895625,Heinzman; Erica M.,43,0,45,2
1745801491547,EDS 204R,B01,895693,Halter; Christopher P.,18,0,45,27
1745801492574,EDS 206R,A00,895694,Fargason; Sharon Gayle,9,0,30,21
1745801492574,EDS 206R,B00,895695,Choi; Bailey Miyeon,20,0,30,10
1745801493600,EDS 250,A00,895697,Hemans; Patricia Ann Benitez,43,0,45,2
1745801494627,EDS 281,A00,895701,Meyerott; Theresa Ann,15,0,15,0
1745801495653,EDS 284,A00,895736,Meyerott; Theresa Ann,15,0,15,0
1745801496678,EDS 286,A00,897210,Fine; Sarah,15,0,15,0
1745801497703,EDS 289C,A01,895770,Daly; Alan J.,15,0,15,0
1745801498730,EDS 290,A00,897211,Hofstetter; Carolyn,15,0,15,0
1745801499755,LIGM 5A,A00,896162,Fischer-Grunski; Eva K,15,0,20,5
1745801500782,LIGM 5B,A00,896260,Fischer-Grunski; Eva K,17,0,20,3
1745801501809,LIGM 5C,A00,896308,Fischer-Grunski; Eva K,18,0,20,2
1745801502835,LIIT 5AS,A00,896313,Carnelos; Chiara,18,0,20,2
1745801503863,LIIT 5BS,A00,896416,Carnelos; Chiara,20,0,20,0
1745801504891,LIIT 5CS,A00,896564,Carnelos; Chiara,20,0,20,0
1745801505918,LISP 5A,A00,896588,Munoz Sanchez; Alicia,4,0,20,16
1745801506946,LISP 5B,A00,896653,Munoz Sanchez; Alicia,10,0,20,10
1745801507976,LISP 5C,A00,896655,Munoz Sanchez; Alicia,4,0,20,16
1745801509000,MAE 197,001,957918,Kleissl; Jan,9998,0,9999,1
1745801510026,MATH 2,A01,957937,Staff,34,0,35,1
1745801511053,MATH 197,001,957876,Kedlaya; Kiran S.,9993,0,9999,6
1745801512082,MCWP 40,A00,892729,Duru; Nur,13,0,20,7
1745801512082,MCWP 40,B00,893304,Montejo; Carolina,20,0,20,0
1745801513111,MCWP 40R,A00,893757,Redela; Pamela Morgan,0,6,20,20
1745801514137,MCWP 50,A00,893758,Morshed; Michael James,2,0,20,18
1745801514137,MCWP 50,B00,893761,Bartulis; Jason Michael,17,0,20,3
1745801515162,MCWP 50R,A00,893766,Compas; Sean Matthew,0,1,20,20
1745801515162,MCWP 50R,B00,893769,Carter; Jennifer A,0,0,20,20
1745801515162,MCWP 50R,C00,893771,Krone; Jarret,0,3,20,20
1745801515162,MCWP 50R,D00,893772,Miller; Elizabeth Deen,3,0,20,17
1745801515162,MCWP 50R,E00,893775,Carter; Andrea L,0,0,20,20
1745801516188,MMW 11R,A01,892721,Herbst; Matthew,11,0,27,16
1745801516188,MMW 11R,A02,892722,Herbst; Matthew,0,0,0,3
1745801517212,MMW 12R,A01,892724,Herbst; Matthew,0,9,16,16
1745801517212,MMW 12R,A02,892725,Herbst; Matthew,0,9,16,16
1745801518238,MMW 13R,A01,892727,Staff,0,4,16,16
1745801518238,MMW 13R,A02,892728,Staff,0,4,16,16
1745801518238,MMW 13R,A03,958032,Staff,0,3,16,16
1745801518238,MMW 13R,A04,958033,Staff,0,2,16,16
1745801518238,MMW 13R,A05,958034,Staff,0,3,16,16
1745801519265,SIO 295LS,A00,894015,Staff,7,0,25,18
1745801520291,SIO 295S,A00,894020,Staff,7,0,25,18
1745801521320,SIOC 290S,B01,958918,Staff,0,0,0,0
1745801522345,SIOC 291S,B01,958922,Staff,0,0,0,0
1745801523370,SOCI 117,A01,895339,Staff,4,0,5,1
1745801524396,WES 237B,A00,894149,Staff,11,0,20,9
1745801526459,AESE 279B,A00,891859,Staff,13,0,35,22
1745801527483,AIP 197,001,891854,Staff,70,0,70,0
1745801528512,ANTH 289S,A00,891856,Gagneux; Pascal,12,0,12,0
1745801529539,BENG 196,001,957946,Engler; Adam J.,9996,0,9999,3
1745801530566,CAT 124RS,A01,956906,Staff,8,0,25,17
1745801531591,CAT 125RS,A01,922013,Staff,8,0,25,17
1745801532620,CLRE 250,A00,891860,Morris; Sheldon,9995,0,9999,4
1745801534668,CLRE 251R,A00,907817,Mehta; Ravindra L.,9994,0,9999,5
1745801535697,CLRE 252,A00,891864,Cuomo; Raphael Eduardo,9993,0,9999,6
1745801536727,CLRE 253,A00,891867,Vaida; Florin,9994,0,9999,5
1745801536727,CLRE 253,B00,907819,Staff,9999,0,9999,0
1745801537755,CLRE 259,A00,891868,Patel; Hemal,9998,0,9999,1
1745801538782,CLRE 260,A00,891872,Cuomo; Raphael Eduardo,9999,0,9999,0
1745801539809,CLRE 297,001,891888,Cuomo; Raphael Eduardo,9999,0,9999,0
1745801540834,CSE 191,A00,958773,Minnes Kemp; Mor Mia,9999,0,9999,0
1745801541865,CSS 201S,A01,892054,Mignozzetti; Umberto,30,0,30,0
1745801542892,CSS 202S,A01,892056,Mignozzetti; Umberto,30,0,30,0
1745801543918,DSC 197,001,956898,Eldridge; Justin Matthew,9998,0,9999,1
1745801544944,DSC 297,001,958000,Mazumdar; Arya,9998,0,9999,1
1745801545971,EAP 100,A00,905686,Staff,9776,0,9999,223
1745801546997,ECE 45,A01,892618,Staff,0,12,50,50
1745801548027,ECE 109,A01,892620,Staff,0,43,0,0
1745801549052,ECE 111,A01,892719,Staff,0,7,50,50
1745801550078,ECE 197,001,957920,Mercier; Patrick Philip,9992,0,9999,7
1745801551104,ECON 178,A01,907814,Zhu; Ying,28,0,35,7
1745801552132,EDS 115,A00,895312,Staff,41,0,45,4
1745801553158,EDS 117,A01,895337,Staff,30,0,30,0
1745801554184,EDS 125,A00,895341,Jones; Gabrielle Anastasia,43,0,45,2
1745801555208,EDS 128A,A01,895459,Fargason; Sharon Gayle,44,0,45,1
1745801556238,EDS 128B,A01,895543,Pappas; Elizabeth,44,0,45,1
1745801557262,EDS 139,A00,897203,Pappas; Elizabeth,44,0,45,1
1745801557262,EDS 139,B00,897209,Fargason; Sharon Gayle,44,0,45,1
1745801558289,EDS 201,A00,895545,Staff,43,0,45,2
1745801559316,EDS 203,A01,895581,Halter; Christopher P.,43,0,45,2
1745801560342,EDS 204R,A01,895625,Heinzman; Erica M.,43,0,45,2
1745801560342,EDS 204R,B01,895693,Halter; Christopher P.,18,0,45,27
1745801561366,EDS 206R,A00,895694,Fargason; Sharon Gayle,9,0,30,21
1745801561366,EDS 206R,B00,895695,Choi; Bailey Miyeon,20,0,30,10
1745801562405,EDS 250,A00,895697,Hemans; Patricia Ann Benitez,43,0,45,2
1745801563432,EDS 281,A00,895701,Meyerott; Theresa Ann,15,0,15,0
1745801564458,EDS 284,A00,895736,Meyerott; Theresa Ann,15,0,15,0
1745801565481,EDS 286,A00,897210,Fine; Sarah,15,0,15,0
1745801566509,EDS 289C,A01,895770,Daly; Alan J.,15,0,15,0
1745801567533,EDS 290,A00,897211,Hofstetter; Carolyn,15,0,15,0
1745801568560,LIGM 5A,A00,896162,Fischer-Grunski; Eva K,15,0,20,5
1745801569584,LIGM 5B,A00,896260,Fischer-Grunski; Eva K,17,0,20,3
1745801570611,LIGM 5C,A00,896308,Fischer-Grunski; Eva K,18,0,20,2
1745801571635,LIIT 5AS,A00,896313,Carnelos; Chiara,18,0,20,2
1745801572663,LIIT 5BS,A00,896416,Carnelos; Chiara,20,0,20,0
1745801573688,LIIT 5CS,A00,896564,Carnelos; Chiara,20,0,20,0
1745801574717,LISP 5A,A00,896588,Munoz Sanchez; Alicia,4,0,20,16
1745801575743,LISP 5B,A00,896653,Munoz Sanchez; Alicia,10,0,20,10
1745801576769,LISP 5C,A00,896655,Munoz Sanchez; Alicia,4,0,20,16
1745801577796,MAE 197,001,957918,Kleissl; Jan,9998,0,9999,1
1745801578820,MATH 2,A01,957937,Staff,34,0,35,1
1745801579846,MATH 197,001,957876,Kedlaya; Kiran S.,9993,0,9999,6
1745801580873,MCWP 40,A00,892729,Duru; Nur,13,0,20,7
1745801580873,MCWP 40,B00,893304,Montejo; Carolina,20,0,20,0
1745801581898,MCWP 40R,A00,893757,Redela; Pamela Morgan,0,6,20,20
1745801582926,MCWP 50,A00,893758,Morshed; Michael James,2,0,20,18
1745801582926,MCWP 50,B00,893761,Bartulis; Jason Michael,17,0,20,3
1745801583952,MCWP 50R,A00,893766,Compas; Sean Matthew,0,1,20,20
1745801583952,MCWP 50R,B00,893769,Carter; Jennifer A,0,0,20,20
1745801583952,MCWP 50R,C00,893771,Krone; Jarret,0,3,20,20
1745801583952,MCWP 50R,D00,893772,Miller; Elizabeth Deen,3,0,20,17
1745801583952,MCWP 50R,E00,893775,Carter; Andrea L,0,0,20,20
1745801584979,MMW 11R,A01,892721,Herbst; Matthew,11,0,27,16
1745801584979,MMW 11R,A02,892722,Herbst; Matthew,0,0,0,3
1745801586006,MMW 12R,A01,892724,Herbst; Matthew,0,9,16,16
1745801586006,MMW 12R,A02,892725,Herbst; Matthew,0,9,16,16
1745801587033,MMW 13R,A01,892727,Staff,0,4,16,16
1745801587033,MMW 13R,A02,892728,Staff,0,4,16,16
1745801587033,MMW 13R,A03,958032,Staff,0,3,16,16
1745801587033,MMW 13R,A04,958033,Staff,0,2,16,16
1745801587033,MMW 13R,A05,958034,Staff,0,3,16,16
1745801588061,SIO 295LS,A00,894015,Staff,7,0,25,18
1745801589090,SIO 295S,A00,894020,Staff,7,0,25,18
1745801590117,SIOC 290S,B01,958918,Staff,0,0,0,0
1745801591140,SIOC 291S,B01,958922,Staff,0,0,0,0
1745801592168,SOCI 117,A01,895339,Staff,4,0,5,1
1745801593196,WES 237B,A00,894149,Staff,11,0,20,9
1745801595254,AESE 279B,A00,891859,Staff,13,0,35,22
1745801596282,AIP 197,001,891854,Staff,70,0,70,0
1745801597307,ANTH 289S,A00,891856,Gagneux; Pascal,12,0,12,0
1745801598333,BENG 196,001,957946,Engler; Adam J.,9996,0,9999,3
1745801599361,CAT 124RS,A01,956906,Staff,8,0,25,17
1745801600386,CAT 125RS,A01,922013,Staff,8,0,25,17
1745801601415,CLRE 250,A00,891860,Morris; Sheldon,9995,0,9999,4
1745801603468,CLRE 251R,A00,907817,Mehta; Ravindra L.,9994,0,9999,5
1745801604496,CLRE 252,A00,891864,Cuomo; Raphael Eduardo,9993,0,9999,6
1745801605524,CLRE 253,A00,891867,Vaida; Florin,9994,0,9999,5
1745801605524,CLRE 253,B00,907819,Staff,9999,0,9999,0
1745801606550,CLRE 259,A00,891868,Patel; Hemal,9998,0,9999,1
1745801607578,CLRE 260,A00,891872,Cuomo; Raphael Eduardo,9999,0,9999,0
1745801608601,CLRE 297,001,891888,Cuomo; Raphael Eduardo,9999,0,9999,0
1745801609628,CSE 191,A00,958773,Minnes Kemp; Mor Mia,9999,0,9999,0
1745801610654,CSS 201S,A01,892054,Mignozzetti; Umberto,30,0,30,0
1745801611683,CSS 202S,A01,892056,Mignozzetti; Umberto,30,0,30,0
1745801612709,DSC 197,001,956898,Eldridge; Justin Matthew,9998,0,9999,1
1745801613735,DSC 297,001,958000,Mazumdar; Arya,9998,0,9999,1
1745801614763,EAP 100,A00,905686,Staff,9776,0,9999,223
1745801615789,ECE 45,A01,892618,Staff,0,12,50,50
1745801616814,ECE 109,A01,892620,Staff,0,43,0,0
1745801617842,ECE 111,A01,892719,Staff,0,7,50,50
1745801618869,ECE 197,001,957920,Mercier; Patrick Philip,9992,0,9999,7
1745801619896,ECON 178,A01,907814,Zhu; Ying,28,0,35,7
1745801620922,EDS 115,A00,895312,Staff,41,0,45,4
1745801621947,EDS 117,A01,895337,Staff,30,0,30,0
1745801622976,EDS 125,A00,895341,Jones; Gabrielle Anastasia,43,0,45,2
1745801624000,EDS 128A,A01,895459,Fargason; Sharon Gayle,44,0,45,1
1745801625029,EDS 128B,A01,895543,Pappas; Elizabeth,44,0,45,1
1745801626054,EDS 139,A00,897203,Pappas; Elizabeth,44,0,45,1
1745801626054,EDS 139,B00,897209,Fargason; Sharon Gayle,44,0,45,1
1745801627079,EDS 201,A00,895545,Staff,43,0,45,2
1745801628106,EDS 203,A01,895581,Halter; Christopher P.,43,0,45,2
1745801629131,EDS 204R,A01,895625,Heinzman; Erica M.,43,0,45,2
1745801629131,EDS 204R,B01,895693,Halter; Christopher P.,18,0,45,27
1745801630154,EDS 206R,A00,895694,Fargason; Sharon Gayle,9,0,30,21
1745801630154,EDS 206R,B00,895695,Choi; Bailey Miyeon,20,0,30,10
1745801631181,EDS 250,A00,895697,Hemans; Patricia Ann Benitez,43,0,45,2
1745801632206,EDS 281,A00,895701,Meyerott; Theresa Ann,15,0,15,0
1745801633234,EDS 284,A00,895736,Meyerott; Theresa Ann,15,0,15,0
1745801634259,EDS 286,A00,897210,Fine; Sarah,15,0,15,0
1745801635289,EDS 289C,A01,895770,Daly; Alan J.,15,0,15,0
1745801636317,EDS 290,A00,897211,Hofstetter; Carolyn,15,0,15,0
1745801637346,LIGM 5A,A00,896162,Fischer-Grunski; Eva K,15,0,20,5
1745801638373,LIGM 5B,A00,896260,Fischer-Grunski; Eva K,17,0,20,3
1745801639400,LIGM 5C,A00,896308,Fischer-Grunski; Eva K,18,0,20,2
1745801640427,LIIT 5AS,A00,896313,Carnelos; Chiara,18,0,20,2
1745801641454,LIIT 5BS,A00,896416,Carnelos; Chiara,20,0,20,0
1745801642483,LIIT 5CS,A00,896564,Carnelos; Chiara,20,0,20,0
1745801643513,LISP 5A,A00,896588,Munoz Sanchez; Alicia,4,0,20,16
1745801644539,LISP 5B,A00,896653,Munoz Sanchez; Alicia,10,0,20,10
1745801645564,LISP 5C,A00,896655,Munoz Sanchez; Alicia,4,0,20,16
1745801646593,MAE 197,001,957918,Kleissl; Jan,9998,0,9999,1
1745801647618,MATH 2,A01,957937,Staff,34,0,35,1
1745801648644,MATH 197,001,957876,Kedlaya; Kiran S.,9993,0,9999,6
1745801649670,MCWP 40,A00,892729,Duru; Nur,13,0,20,7
1745801649670,MCWP 40,B00,893304,Montejo; Carolina,20,0,20,0
1745801650697,MCWP 40R,A00,893757,Redela; Pamela Morgan,0,6,20,20
1745801651726,MCWP 50,A00,893758,Morshed; Michael James,2,0,20,18
1745801651726,MCWP 50,B00,893761,Bartulis; Jason Michael,17,0,20,3
1745801652750,MCWP 50R,A00,893766,Compas; Sean Matthew,0,1,20,20
1745801652750,MCWP 50R,B00,893769,Carter; Jennifer A,0,0,20,20
1745801652750,MCWP 50R,C00,893771,Krone; Jarret,0,3,20,20
1745801652750,MCWP 50R,D00,893772,Miller; Elizabeth Deen,3,0,20,17
1745801652750,MCWP 50R,E00,893775,Carter; Andrea L,0,0,20,20
1745801653778,MMW 11R,A01,892721,Herbst; Matthew,11,0,27,16
1745801653778,MMW 11R,A02,892722,Herbst; Matthew,0,0,0,3
1745801654803,MMW 12R,A01,892724,Herbst; Matthew,0,9,16,16
1745801654803,MMW 12R,A02,892725,Herbst; Matthew,0,9,16,16
1745801655830,MMW 13R,A01,892727,Staff,0,4,16,16
1745801655830,MMW 13R,A02,892728,Staff,0,4,16,16
1745801655830,MMW 13R,A03,958032,Staff,0,3,16,16
1745801655830,MMW 13R,A04,958033,Staff,0,2,16,16
1745801655830,MMW 13R,A05,958034,Staff,0,3,16,16
1745801656855,SIO 295LS,A00,894015,Staff,7,0,25,18
1745801657883,SIO 295S,A00,894020,Staff,7,0,25,18
1745801658908,SIOC 290S,B01,958918,Staff,0,0,0,0
1745801659937,SIOC 291S,B01,958922,Staff,0,0,0,0
1745801660964,SOCI 117,A01,895339,Staff,4,0,5,1
1745801661992,WES 237B,A00,894149,Staff,11,0,20,9
1745801664062,AESE 279B,A00,891859,Staff,13,0,35,22
1745801665089,AIP 197,001,891854,Staff,70,0,70,0
1745801666119,ANTH 289S,A00,891856,Gagneux; Pascal,12,0,12,0
1745801667144,BENG 196,001,957946,Engler; Adam J.,9996,0,9999,3
1745801668170,CAT 124RS,A01,956906,Staff,8,0,25,17
1745801669195,CAT 125RS,A01,922013,Staff,8,0,25,17
1745801670220,CLRE 250,A00,891860,Morris; Sheldon,9995,0,9999,4
1745801672275,CLRE 251R,A00,907817,Mehta; Ravindra L.,9994,0,9999,5
1745801673302,CLRE 252,A00,891864,Cuomo; Raphael Eduardo,9993,0,9999,6
1745801674328,CLRE 253,A00,891867,Vaida; Florin,9994,0,9999,5
1745801674328,CLRE 253,B00,907819,Staff,9999,0,9999,0
1745801675353,CLRE 259,A00,891868,Patel; Hemal,9998,0,9999,1
1745801676379,CLRE 260,A00,891872,Cuomo; Raphael Eduardo,9999,0,9999,0
1745801677407,CLRE 297,001,891888,Cuomo; Raphael Eduardo,9999,0,9999,0
1745801678433,CSE 191,A00,958773,Minnes Kemp; Mor Mia,9999,0,9999,0
1745801679973,CSS 201S,A01,892054,Mignozzetti; Umberto,30,0,30,0
1745801681004,CSS 202S,A01,892056,Mignozzetti; Umberto,30,0,30,0
1745801682032,DSC 197,001,956898,Eldridge; Justin Matthew,9998,0,9999,1
1745801683059,DSC 297,001,958000,Mazumdar; Arya,9998,0,9999,1
1745801684083,EAP 100,A00,905686,Staff,9776,0,9999,223
1745801685112,ECE 45,A01,892618,Staff,0,12,50,50
1745801686142,ECE 109,A01,892620,Staff,0,43,0,0
1745801687170,ECE 111,A01,892719,Staff,0,7,50,50
1745801688198,ECE 197,001,957920,Mercier; Patrick Philip,9992,0,9999,7
1745801689227,ECON 178,A01,907814,Zhu; Ying,28,0,35,7
1745801690250,EDS 115,A00,895312,Staff,41,0,45,4
1745801691276,EDS 117,A01,895337,Staff,30,0,30,0
1745801692301,EDS 125,A00,895341,Jones; Gabrielle Anastasia,43,0,45,2
1745801693328,EDS 128A,A01,895459,Fargason; Sharon Gayle,44,0,45,1
1745801694358,EDS 128B,A01,895543,Pappas; Elizabeth,44,0,45,1
1745801695382,EDS 139,A00,897203,Pappas; Elizabeth,44,0,45,1
1745801695382,EDS 139,B00,897209,Fargason; Sharon Gayle,44,0,45,1
1745801696407,EDS 201,A00,895545,Staff,43,0,45,2
1745801697433,EDS 203,A01,895581,Halter; Christopher P.,43,0,45,2
1745801698459,EDS 204R,A01,895625,Heinzman; Erica M.,43,0,45,2
1745801698459,EDS 204R,B01,895693,Halter; Christopher P.,18,0,45,27
1745801699485,EDS 206R,A00,895694,Fargason; Sharon Gayle,9,0,30,21
1745801699485,EDS 206R,B00,895695,Choi; Bailey Miyeon,20,0,30,10
1745801700512,EDS 250,A00,895697,Hemans; Patricia Ann Benitez,43,0,45,2
1745801701546,EDS 281,A00,895701,Meyerott; Theresa Ann,15,0,15,0
1745801702572,EDS 284,A00,895736,Meyerott; Theresa Ann,15,0,15,0
1745801703598,EDS 286,A00,897210,Fine; Sarah,15,0,15,0
1745801704635,EDS 289C,A01,895770,Daly; Alan J.,15,0,15,0
1745801705661,EDS 290,A00,897211,Hofstetter; Carolyn,15,0,15,0
1745801706688,LIGM 5A,A00,896162,Fischer-Grunski; Eva K,15,0,20,5
1745801707717,LIGM 5B,A00,896260,Fischer-Grunski; Eva K,17,0,20,3
1745801708747,LIGM 5C,A00,896308,Fischer-Grunski; Eva K,18,0,20,2
1745801709780,LIIT 5AS,A00,896313,Carnelos; Chiara,18,0,20,2
1745801710811,LIIT 5BS,A00,896416,Carnelos; Chiara,20,0,20,0
1745801711837,LIIT 5CS,A00,896564,Carnelos; Chiara,20,0,20,0
1745801712864,LISP 5A,A00,896588,Munoz Sanchez; Alicia,4,0,20,16
1745801713895,LISP 5B,A00,896653,Munoz Sanchez; Alicia,10,0,20,10
1745801714925,LISP 5C,A00,896655,Munoz Sanchez; Alicia,4,0,20,16
1745801715952,MAE 197,001,957918,Kleissl; Jan,9998,0,9999,1
1745801716978,MATH 2,A01,957937,Staff,34,0,35,1
1745801718006,MATH 197,001,957876,Kedlaya; Kiran S.,9993,0,9999,6
1745801719037,MCWP 40,A00,892729,Duru; Nur,13,0,20,7
1745801719037,MCWP 40,B00,893304,Montejo; Carolina,20,0,20,0
1745801720065,MCWP 40R,A00,893757,Redela; Pamela Morgan,0,6,20,20
1745801721092,MCWP 50,A00,893758,Morshed; Michael James,2,0,20,18
1745801721092,MCWP 50,B00,893761,Bartulis; Jason Michael,17,0,20,3
1745801722117,MCWP 50R,A00,893766,Compas; Sean Matthew,0,1,20,20
1745801722117,MCWP 50R,B00,893769,Carter; Jennifer A,0,0,20,20
1745801722117,MCWP 50R,C00,893771,Krone; Jarret,0,3,20,20
1745801722117,MCWP 50R,D00,893772,Miller; Elizabeth Deen,3,0,20,17
1745801722117,MCWP 50R,E00,893775,Carter; Andrea L,0,0,20,20
1745801723146,MMW 11R,A01,892721,Herbst; Matthew,11,0,27,16
1745801723146,MMW 11R,A02,892722,Herbst; Matthew,0,0,0,3
1745801724171,MMW 12R,A01,892724,Herbst; Matthew,0,9,16,16
1745801724171,MMW 12R,A02,892725,Herbst; Matthew,0,9,16,16
1745801725197,MMW 13R,A01,892727,Staff,0,4,16,16
1745801725197,MMW 13R,A02,892728,Staff,0,4,16,16
1745801725197,MMW 13R,A03,958032,Staff,0,3,16,16
1745801725197,MMW 13R,A04,958033,Staff,0,2,16,16
1745801725197,MMW 13R,A05,958034,Staff,0,3,16,16
1745801726223,SIO 295LS,A00,894015,Staff,7,0,25,18
1745801727247,SIO 295S,A00,894020,Staff,7,0,25,18
1745801728274,SIOC 290S,B01,958918,Staff,0,0,0,0
1745801729304,SIOC 291S,B01,958922,Staff,0,0,0,0
1745801730332,SOCI 117,A01,895339,Staff,4,0,5,1
1745801731357,WES 237B,A00,894149,Staff,11,0,20,9
1745801733424,AESE 279B,A00,891859,Staff,13,0,35,22
1745801734449,AIP 197,001,891854,Staff,70,0,70,0
1745801735481,ANTH 289S,A00,891856,Gagneux; Pascal,12,0,12,0
1745801736508,BENG 196,001,957946,Engler; Adam J.,9996,0,9999,3
1745801737559,CAT 124RS,A01,956906,Staff,8,0,25,17
1745801738585,CAT 125RS,A01,922013,Staff,8,0,25,17
1745801739611,CLRE 250,A00,891860,Morris; Sheldon,9995,0,9999,4
1745801741665,CLRE 251R,A00,907817,Mehta; Ravindra L.,9994,0,9999,5
1745801742691,CLRE 252,A00,891864,Cuomo; Raphael Eduardo,9993,0,9999,6
1745801743719,CLRE 253,A00,891867,Vaida; Florin,9994,0,9999,5
1745801743719,CLRE 253,B00,907819,Staff,9999,0,9999,0
1745801744748,CLRE 259,A00,891868,Patel; Hemal,9998,0,9999,1
1745801745774,CLRE 260,A00,891872,Cuomo; Raphael Eduardo,9999,0,9999,0
1745801746799,CLRE 297,001,891888,Cuomo; Raphael Eduardo,9999,0,9999,0
1745801747824,CSE 191,A00,958773,Minnes Kemp; Mor Mia,9999,0,9999,0
1745801748853,CSS 201S,A01,892054,Mignozzetti; Umberto,30,0,30,0
1745801749883,CSS 202S,A01,892056,Mignozzetti; Umberto,30,0,30,0
1745801750909,DSC 197,001,956898,Eldridge; Justin Matthew,9998,0,9999,1
1745801751936,DSC 297,001,958000,Mazumdar; Arya,9998,0,9999,1
1745801752961,EAP 100,A00,905686,Staff,9776,0,9999,223
1745801753988,ECE 45,A01,892618,Staff,0,12,50,50
1745801755014,ECE 109,A01,892620,Staff,0,43,0,0
1745801756039,ECE 111,A01,892719,Staff,0,7,50,50
1745801757066,ECE 197,001,957920,Mercier; Patrick Philip,9992,0,9999,7
1745801758092,ECON 178,A01,907814,Zhu; Ying,28,0,35,7
1745801759117,EDS 115,A00,895312,Staff,41,0,45,4
1745801760149,EDS 117,A01,895337,Staff,30,0,30,0
1745801761178,EDS 125,A00,895341,Jones; Gabrielle Anastasia,43,0,45,2
1745801762205,EDS 128A,A01,895459,Fargason; Sharon Gayle,44,0,45,1
1745801763233,EDS 128B,A01,895543,Pappas; Elizabeth,44,0,45,1
1745801764262,EDS 139,A00,897203,Pappas; Elizabeth,44,0,45,1
1745801764262,EDS 139,B00,897209,Fargason; Sharon Gayle,44,0,45,1
1745801765290,EDS 201,A00,895545,Staff,43,0,45,2
1745801766318,EDS 203,A01,895581,Halter; Christopher P.,43,0,45,2
1745801767344,EDS 204R,A01,895625,Heinzman; Erica M.,43,0,45,2
1745801767344,EDS 204R,B01,895693,Halter; Christopher P.,18,0,45,27
1745801768373,EDS 206R,A00,895694,Fargason; Sharon Gayle,9,0,30,21
1745801768373,EDS 206R,B00,895695,Choi; Bailey Miyeon,20,0,30,10
1745801769402,EDS 250,A00,895697,Hemans; Patricia Ann Benitez,43,0,45,2
1745801770427,EDS 281,A00,895701,Meyerott; Theresa Ann,15,0,15,0
1745801771454,EDS 284,A00,895736,Meyerott; Theresa Ann,15,0,15,0
1745801772481,EDS 286,A00,897210,Fine; Sarah,15,0,15,0
1745801773508,EDS 289C,A01,895770,Daly; Alan J.,15,0,15,0
1745801774535,EDS 290,A00,897211,Hofstetter; Carolyn,15,0,15,0
1745801775561,LIGM 5A,A00,896162,Fischer-Grunski; Eva K,15,0,20,5
1745801776585,LIGM 5B,A00,896260,Fischer-Grunski; Eva K,17,0,20,3
1745801777611,LIGM 5C,A00,896308,Fischer-Grunski; Eva K,18,0,20,2
1745801778640,LIIT 5AS,A00,896313,Carnelos; Chiara,18,0,20,2
1745801779670,LIIT 5BS,A00,896416,Carnelos; Chiara,20,0,20,0
1745801780695,LIIT 5CS,A00,896564,Carnelos; Chiara,20,0,20,0
1745801781720,LISP 5A,A00,896588,Munoz Sanchez; Alicia,4,0,20,16
1745801782746,LISP 5B,A00,896653,Munoz Sanchez; Alicia,10,0,20,10
1745801783772,LISP 5C,A00,896655,Munoz Sanchez; Alicia,4,0,20,16
1745801784799,MAE 197,001,957918,Kleissl; Jan,9998,0,9999,1
1745801785825,MATH 2,A01,957937,Staff,34,0,35,1
1745801786854,MATH 197,001,957876,Kedlaya; Kiran S.,9993,0,9999,6
1745801787881,MCWP 40,A00,892729,Duru; Nur,13,0,20,7
1745801787881,MCWP 40,B00,893304,Montejo; Carolina,20,0,20,0
1745801788911,MCWP 40R,A00,893757,Redela; Pamela Morgan,0,6,20,20
1745801789940,MCWP 50,A00,893758,Morshed; Michael James,2,0,20,18
1745801789940,MCWP 50,B00,893761,Bartulis; Jason Michael,17,0,20,3
1745801790966,MCWP 50R,A00,893766,Compas; Sean Matthew,0,1,20,20
1745801790966,MCWP 50R,B00,893769,Carter; Jennifer A,0,0,20,20
1745801790966,MCWP 50R,C00,893771,Krone; Jarret,0,3,20,20
1745801790966,MCWP 50R,D00,893772,Miller; Elizabeth Deen,3,0,20,17
1745801790966,MCWP 50R,E00,893775,Carter; Andrea L,0,0,20,20
1745801791992,MMW 11R,A01,892721,Herbst; Matthew,11,0,27,16
1745801791992,MMW 11R,A02,892722,Herbst; Matthew,0,0,0,3
1745801793020,MMW 12R,A01,892724,Herbst; Matthew,0,9,16,16
1745801793020,MMW 12R,A02,892725,Herbst; Matthew,0,9,16,16
1745801794044,MMW 13R,A01,892727,Staff,0,4,16,16
1745801794044,MMW 13R,A02,892728,Staff,0,4,16,16
1745801794044,MMW 13R,A03,958032,Staff,0,3,16,16
1745801794044,MMW 13R,A04,958033,Staff,0,2,16,16
1745801794044,MMW 13R,A05,958034,Staff,0,3,16,16
1745801795073,SIO 295LS,A00,894015,Staff,7,0,25,18
1745801796101,SIO 295S,A00,894020,Staff,7,0,25,18
1745801797128,SIOC 290S,B01,958918,Staff,0,0,0,0
1745801798154,SIOC 291S,B01,958922,Staff,0,0,0,0
1745801799183,SOCI 117,A01,895339,Staff,4,0,5,1
1745801800210,WES 237B,A00,894149,Staff,11,0,20,9
1745801802269,AESE 279B,A00,891859,Staff,13,0,35,22
1745801803298,AIP 197,001,891854,Staff,70,0,70,0
1745801804327,ANTH 289S,A00,891856,Gagneux; Pascal,12,0,12,0
1745801805354,BENG 196,001,957946,Engler; Adam J.,9996,0,9999,3
1745801806382,CAT 124RS,A01,956906,Staff,8,0,25,17
1745801807408,CAT 125RS,A01,922013,Staff,8,0,25,17
1745801808437,CLRE 250,A00,891860,Morris; Sheldon,9995,0,9999,4
1745801810489,CLRE 251R,A00,907817,Mehta; Ravindra L.,9994,0,9999,5
1745801811519,CLRE 252,A00,891864,Cuomo; Raphael Eduardo,9993,0,9999,6
1745801812548,CLRE 253,A00,891867,Vaida; Florin,9994,0,9999,5
1745801812548,CLRE 253,B00,907819,Staff,9999,0,9999,0
1745801813578,CLRE 259,A00,891868,Patel; Hemal,9998,0,9999,1
1745801814607,CLRE 260,A00,891872,Cuomo; Raphael Eduardo,9999,0,9999,0
1745801815632,CLRE 297,001,891888,Cuomo; Raphael Eduardo,9999,0,9999,0
1745801816661,CSE 191,A00,958773,Minnes Kemp; Mor Mia,9999,0,9999,0
1745801817686,CSS 201S,A01,892054,Mignozzetti; Umberto,30,0,30,0
1745801818714,CSS 202S,A01,892056,Mignozzetti; Umberto,30,0,30,0
1745801819742,DSC 197,001,956898,Eldridge; Justin Matthew,9998,0,9999,1
1745801820768,DSC 297,001,958000,Mazumdar; Arya,9998,0,9999,1
1745801821796,EAP 100,A00,905686,Staff,9776,0,9999,223
1745801822822,ECE 45,A01,892618,Staff,0,12,50,50
1745801823849,ECE 109,A01,892620,Staff,0,43,0,0
1745801824877,ECE 111,A01,892719,Staff,0,7,50,50
1745801825902,ECE 197,001,957920,Mercier; Patrick Philip,9992,0,9999,7
1745801826928,ECON 178,A01,907814,Zhu; Ying,28,0,35,7
1745801827954,EDS 115,A00,895312,Staff,41,0,45,4
1745801828984,EDS 117,A01,895337,Staff,30,0,30,0
1745801830010,EDS 125,A00,895341,Jones; Gabrielle Anastasia,43,0,45,2
1745801831039,EDS 128A,A01,895459,Fargason; Sharon Gayle,44,0,45,1
1745801832065,EDS 128B,A01,895543,Pappas; Elizabeth,44,0,45,1
1745801833092,EDS 139,A00,897203,Pappas; Elizabeth,44,0,45,1
1745801833092,EDS 139,B00,897209,Fargason; Sharon Gayle,44,0,45,1
1745801834115,EDS 201,A00,895545,Staff,43,0,45,2
1745801835141,EDS 203,A01,895581,Halter; Christopher P.,43,0,45,2
1745801836170,EDS 204R,A01,895625,Heinzman; Erica M.,43,0,45,2
1745801836170,EDS 204R,B01,895693,Halter; Christopher P.,18,0,45,27
1745801837197,EDS 206R,A00,895694,Fargason; Sharon Gayle,9,0,30,21
1745801837197,EDS 206R,B00,895695,Choi; Bailey Miyeon,20,0,30,10
1745801838222,EDS 250,A00,895697,Hemans; Patricia Ann Benitez,43,0,45,2
1745801839248,EDS 281,A00,895701,Meyerott; Theresa Ann,15,0,15,0
1745801840274,EDS 284,A00,895736,Meyerott; Theresa Ann,15,0,15,0
1745801841306,EDS 286,A00,897210,Fine; Sarah,15,0,15,0
1745801842331,EDS 289C,A01,895770,Daly; Alan J.,15,0,15,0
1745801843357,EDS 290,A00,897211,Hofstetter; Carolyn,15,0,15,0
1745801844384,LIGM 5A,A00,896162,Fischer-Grunski; Eva K,15,0,20,5
1745801845410,LIGM 5B,A00,896260,Fischer-Grunski; Eva K,17,0,20,3
1745801846435,LIGM 5C,A00,896308,Fischer-Grunski; Eva K,18,0,20,2
1745801847461,LIIT 5AS,A00,896313,Carnelos; Chiara,18,0,20,2
1745801848487,LIIT 5BS,A00,896416,Carnelos; Chiara,20,0,20,0
1745801849512,LIIT 5CS,A00,896564,Carnelos; Chiara,20,0,20,0
1745801850537,LISP 5A,A00,896588,Munoz Sanchez; Alicia,4,0,20,16
1745801851564,LISP 5B,A00,896653,Munoz Sanchez; Alicia,10,0,20,10
1745801852595,LISP 5C,A00,896655,Munoz Sanchez; Alicia,4,0,20,16
1745801853621,MAE 197,001,957918,Kleissl; Jan,9998,0,9999,1
1745801854647,MATH 2,A01,957937,Staff,34,0,35,1
1745801855672,MATH 197,001,957876,Kedlaya; Kiran S.,9993,0,9999,6
1745801856697,MCWP 40,A00,892729,Duru; Nur,13,0,20,7
1745801856697,MCWP 40,B00,893304,Montejo; Carolina,20,0,20,0
1745801857723,MCWP 40R,A00,893757,Redela; Pamela Morgan,0,6,20,20
1745801858752,MCWP 50,A00,893758,Morshed; Michael James,2,0,20,18
1745801858752,MCWP 50,B00,893761,Bartulis; Jason Michael,17,0,20,3
1745801859779,MCWP 50R,A00,893766,Compas; Sean Matthew,0,1,20,20
1745801859779,MCWP 50R,B00,893769,Carter; Jennifer A,0,0,20,20
1745801859779,MCWP 50R,C00,893771,Krone; Jarret,0,3,20,20
1745801859779,MCWP 50R,D00,893772,Miller; Elizabeth Deen,3,0,20,17
1745801859779,MCWP 50R,E00,893775,Carter; Andrea L,0,0,20,20
1745801860808,MMW 11R,A01,892721,Herbst; Matthew,11,0,27,16
1745801860808,MMW 11R,A02,892722,Herbst; Matthew,0,0,0,3
1745801861833,MMW 12R,A01,892724,Herbst; Matthew,0,9,16,16
1745801861833,MMW 12R,A02,892725,Herbst; Matthew,0,9,16,16
1745801862860,MMW 13R,A01,892727,Staff,0,4,16,16
1745801862860,MMW 13R,A02,892728,Staff,0,4,16,16
1745801862860,MMW 13R,A03,958032,Staff,0,3,16,16
1745801862860,MMW 13R,A04,958033,Staff,0,2,16,16
1745801862860,MMW 13R,A05,958034,Staff,0,3,16,16
1745801863887,SIO 295LS,A00,894015,Staff,7,0,25,18
1745801864913,SIO 295S,A00,894020,Staff,7,0,25,18
1745801865940,SIOC 290S,B01,958918,Staff,0,0,0,0
1745801866966,SIOC 291S,B01,958922,Staff,0,0,0,0
1745801867991,SOCI 117,A01,895339,Staff,4,0,5,1
1745801869019,WES 237B,A00,894149,Staff,11,0,20,9
1745801871076,AESE 279B,A00,891859,Staff,13,0,35,22
1745801872104,AIP 197,001,891854,Staff,70,0,70,0
1745801873129,ANTH 289S,A00,891856,Gagneux; Pascal,12,0,12,0
1745801874156,BENG 196,001,957946,Engler; Adam J.,9996,0,9999,3
1745801875182,CAT 124RS,A01,956906,Staff,8,0,25,17
1745801876209,CAT 125RS,A01,922013,Staff,8,0,25,17
1745801877235,CLRE 250,A00,891860,Morris; Sheldon,9995,0,9999,4
1745801879285,CLRE 251R,A00,907817,Mehta; Ravindra L.,9994,0,9999,5
1745801880314,CLRE 252,A00,891864,Cuomo; Raphael Eduardo,9993,0,9999,6
1745801881339,CLRE 253,A00,891867,Vaida; Florin,9994,0,9999,5
1745801881339,CLRE 253,B00,907819,Staff,9999,0,9999,0
1745801882369,CLRE 259,A00,891868,Patel; Hemal,9998,0,9999,1
1745801883399,CLRE 260,A00,891872,Cuomo; Raphael Eduardo,9999,0,9999,0
1745801884426,CLRE 297,001,891888,Cuomo; Raphael Eduardo,9999,0,9999,0
1745801885452,CSE 191,A00,958773,Minnes Kemp; Mor Mia,9999,0,9999,0
1745801886482,CSS 201S,A01,892054,Mignozzetti; Umberto,30,0,30,0
1745801887508,CSS 202S,A01,892056,Mignozzetti; Umberto,30,0,30,0
1745801888537,DSC 197,001,956898,Eldridge; Justin Matthew,9998,0,9999,1
1745801889563,DSC 297,001,958000,Mazumdar; Arya,9998,0,9999,1
1745801890587,EAP 100,A00,905686,Staff,9776,0,9999,223
1745801891611,ECE 45,A01,892618,Staff,0,12,50,50
1745801892642,ECE 109,A01,892620,Staff,0,43,0,0
1745801893670,ECE 111,A01,892719,Staff,0,7,50,50
1745801894697,ECE 197,001,957920,Mercier; Patrick Philip,9992,0,9999,7
1745801895728,ECON 178,A01,907814,Zhu; Ying,28,0,35,7
1745801896752,EDS 115,A00,895312,Staff,41,0,45,4
1745801897780,EDS 117,A01,895337,Staff,30,0,30,0
1745801898805,EDS 125,A00,895341,Jones; Gabrielle Anastasia,43,0,45,2
1745801899831,EDS 128A,A01,895459,Fargason; Sharon Gayle,44,0,45,1
1745801900855,EDS 128B,A01,895543,Pappas; Elizabeth,44,0,45,1
1745801901880,EDS 139,A00,897203,Pappas; Elizabeth,44,0,45,1
1745801901880,EDS 139,B00,897209,Fargason; Sharon Gayle,44,0,45,1
1745801902906,EDS 201,A00,895545,Staff,43,0,45,2
1745801903935,EDS 203,A01,895581,Halter; Christopher P.,43,0,45,2
1745801904960,EDS 204R,A01,895625,Heinzman; Erica M.,43,0,45,2
1745801904960,EDS 204R,B01,895693,Halter; Christopher P.,18,0,45,27
1745801905989,EDS 206R,A00,895694,Fargason; Sharon Gayle,9,0,30,21
1745801905989,EDS 206R,B00,895695,Choi; Bailey Miyeon,20,0,30,10
1745801907017,EDS 250,A00,895697,Hemans; Patricia Ann Benitez,43,0,45,2
1745801908042,EDS 281,A00,895701,Meyerott; Theresa Ann,15,0,15,0
1745801909066,EDS 284,A00,895736,Meyerott; Theresa Ann,15,0,15,0
1745801910091,EDS 286,A00,897210,Fine; Sarah,15,0,15,0
1745801911116,EDS 289C,A01,895770,Daly; Alan J.,15,0,15,0
1745801912144,EDS 290,A00,897211,Hofstetter; Carolyn,15,0,15,0
1745801913172,LIGM 5A,A00,896162,Fischer-Grunski; Eva K,15,0,20,5
1745801914198,LIGM 5B,A00,896260,Fischer-Grunski; Eva K,17,0,20,3
1745801915225,LIGM 5C,A00,896308,Fischer-Grunski; Eva K,18,0,20,2
1745801916250,LIIT 5AS,A00,896313,Carnelos; Chiara,18,0,20,2
1745801917276,LIIT 5BS,A00,896416,Carnelos; Chiara,20,0,20,0
1745801918305,LIIT 5CS,A00,896564,Carnelos; Chiara,20,0,20,0
1745801919333,LISP 5A,A00,896588,Munoz Sanchez; Alicia,4,0,20,16
1745801920361,LISP 5B,A00,896653,Munoz Sanchez; Alicia,10,0,20,10
1745801921386,LISP 5C,A00,896655,Munoz Sanchez; Alicia,4,0,20,16
1745801922413,MAE 197,001,957918,Kleissl; Jan,9998,0,9999,1
1745801923440,MATH 2,A01,957937,Staff,34,0,35,1
1745801924468,MATH 197,001,957876,Kedlaya; Kiran S.,9993,0,9999,6
1745801925497,MCWP 40,A00,892729,Duru; Nur,13,0,20,7
1745801925497,MCWP 40,B00,893304,Montejo; Carolina,20,0,20,0
1745801926523,MCWP 40R,A00,893757,Redela; Pamela Morgan,0,6,20,20
1745801927548,MCWP 50,A00,893758,Morshed; Michael James,2,0,20,18
1745801927548,MCWP 50,B00,893761,Bartulis; Jason Michael,17,0,20,3
1745801928575,MCWP 50R,A00,893766,Compas; Sean Matthew,0,1,20,20
1745801928575,MCWP 50R,B00,893769,Carter; Jennifer A,0,0,20,20
1745801928575,MCWP 50R,C00,893771,Krone; Jarret,0,3,20,20
1745801928575,MCWP 50R,D00,893772,Miller; Elizabeth Deen,3,0,20,17
1745801928575,MCWP 50R,E00,893775,Carter; Andrea L,0,0,20,20
1745801929599,MMW 11R,A01,892721,Herbst; Matthew,11,0,27,16
1745801929599,MMW 11R,A02,892722,Herbst; Matthew,0,0,0,3
1745801930624,MMW 12R,A01,892724,Herbst; Matthew,0,9,16,16
1745801930624,MMW 12R,A02,892725,Herbst; Matthew,0,9,16,16
1745801931653,MMW 13R,A01,892727,Staff,0,4,16,16
1745801931653,MMW 13R,A02,892728,Staff,0,4,16,16
1745801931653,MMW 13R,A03,958032,Staff,0,3,16,16
1745801931653,MMW 13R,A04,958033,Staff,0,2,16,16
1745801931653,MMW 13R,A05,958034,Staff,0,3,16,16
1745801932680,SIO 295LS,A00,894015,Staff,7,0,25,18
1745801933705,SIO 295S,A00,894020,Staff,7,0,25,18
1745801934734,SIOC 290S,B01,958918,Staff,0,0,0,0
1745801935764,SIOC 291S,B01,958922,Staff,0,0,0,0
1745801936791,SOCI 117,A01,895339,Staff,4,0,5,1
1745801937818,WES 237B,A00,894149,Staff,11,0,20,9
1745801939903,AESE 279B,A00,891859,Staff,13,0,35,22
1745801940930,AIP 197,001,891854,Staff,70,0,70,0
1745801941964,ANTH 289S,A00,891856,Gagneux; Pascal,12,0,12,0
1745801942991,BENG 196,001,957946,Engler; Adam J.,9996,0,9999,3
1745801944022,CAT 124RS,A01,956906,Staff,8,0,25,17
1745801945050,CAT 125RS,A01,922013,Staff,8,0,25,17
1745801946076,CLRE 250,A00,891860,Morris; Sheldon,9995,0,9999,4
1745801948130,CLRE 251R,A00,907817,Mehta; Ravindra L.,9994,0,9999,5
1745801949157,CLRE 252,A00,891864,Cuomo; Raphael Eduardo,9993,0,9999,6
1745801950184,CLRE 253,A00,891867,Vaida; Florin,9994,0,9999,5
1745801950184,CLRE 253,B00,907819,Staff,9999,0,9999,0
1745801951211,CLRE 259,A00,891868,Patel; Hemal,9998,0,9999,1
1745801952237,CLRE 260,A00,891872,Cuomo; Raphael Eduardo,9999,0,9999,0
1745801953263,CLRE 297,001,891888,Cuomo; Raphael Eduardo,9999,0,9999,0
1745801954289,CSE 191,A00,958773,Minnes Kemp; Mor Mia,9999,0,9999,0
1745801955321,CSS 201S,A01,892054,Mignozzetti; Umberto,30,0,30,0
1745801956351,CSS 202S,A01,892056,Mignozzetti; Umberto,30,0,30,0
1745801957375,DSC 197,001,956898,Eldridge; Justin Matthew,9998,0,9999,1
1745801958400,DSC 297,001,958000,Mazumdar; Arya,9998,0,9999,1
1745801959428,EAP 100,A00,905686,Staff,9776,0,9999,223
1745801960453,ECE 45,A01,892618,Staff,0,12,50,50
1745801961480,ECE 109,A01,892620,Staff,0,43,0,0
1745801962508,ECE 111,A01,892719,Staff,0,7,50,50
1745801963535,ECE 197,001,957920,Mercier; Patrick Philip,9992,0,9999,7
1745801964566,ECON 178,A01,907814,Zhu; Ying,28,0,35,7
1745801965593,EDS 115,A00,895312,Staff,41,0,45,4
1745801966620,EDS 117,A01,895337,Staff,30,0,30,0
1745801967649,EDS 125,A00,895341,Jones; Gabrielle Anastasia,43,0,45,2
1745801968675,EDS 128A,A01,895459,Fargason; Sharon Gayle,44,0,45,1
1745801969701,EDS 128B,A01,895543,Pappas; Elizabeth,44,0,45,1
1745801970727,EDS 139,A00,897203,Pappas; Elizabeth,44,0,45,1
1745801970727,EDS 139,B00,897209,Fargason; Sharon Gayle,44,0,45,1
1745801971755,EDS 201,A00,895545,Staff,43,0,45,2
1745801972780,EDS 203,A01,895581,Halter; Christopher P.,43,0,45,2
1745801973807,EDS 204R,A01,895625,Heinzman; Erica M.,43,0,45,2
1745801973807,EDS 204R,B01,895693,Halter; Christopher P.,18,0,45,27
1745801974833,EDS 206R,A00,895694,Fargason; Sharon Gayle,9,0,30,21
1745801974833,EDS 206R,B00,895695,Choi; Bailey Miyeon,20,0,30,10
1745801975860,EDS 250,A00,895697,Hemans; Patricia Ann Benitez,43,0,45,2
1745801976888,EDS 281,A00,895701,Meyerott; Theresa Ann,15,0,15,0
1745801977915,EDS 284,A00,895736,Meyerott; Theresa Ann,15,0,15,0
1745801978941,EDS 286,A00,897210,Fine; Sarah,15,0,15,0
1745801979968,EDS 289C,A01,895770,Daly; Alan J.,15,0,15,0
1745801980994,EDS 290,A00,897211,Hofstetter; Carolyn,15,0,15,0
1745801982022,LIGM 5A,A00,896162,Fischer-Grunski; Eva K,15,0,20,5
1745801983047,LIGM 5B,A00,896260,Fischer-Grunski; Eva K,17,0,20,3
1745801984077,LIGM 5C,A00,896308,Fischer-Grunski; Eva K,18,0,20,2
1745801985103,LIIT 5AS,A00,896313,Carnelos; Chiara,18,0,20,2
1745801986130,LIIT 5BS,A00,896416,Carnelos; Chiara,20,0,20,0
1745801987158,LIIT 5CS,A00,896564,Carnelos; Chiara,20,0,20,0
1745801988184,LISP 5A,A00,896588,Munoz Sanchez; Alicia,4,0,20,16
1745801989210,LISP 5B,A00,896653,Munoz Sanchez; Alicia,10,0,20,10
1745801990235,LISP 5C,A00,896655,Munoz Sanchez; Alicia,4,0,20,16
1745801991265,MAE 197,001,957918,Kleissl; Jan,9998,0,9999,1
1745801992291,MATH 2,A01,957937,Staff,34,0,35,1
1745801993316,MATH 197,001,957876,Kedlaya; Kiran S.,9993,0,9999,6
1745801994341,MCWP 40,A00,892729,Duru; Nur,13,0,20,7
1745801994341,MCWP 40,B00,893304,Montejo; Carolina,20,0,20,0
1745801995366,MCWP 40R,A00,893757,Redela; Pamela Morgan,0,6,20,20
1745801996394,MCWP 50,A00,893758,Morshed; Michael James,2,0,20,18
1745801996394,MCWP 50,B00,893761,Bartulis; Jason Michael,17,0,20,3
1745801997421,MCWP 50R,A00,893766,Compas; Sean Matthew,0,1,20,20
1745801997421,MCWP 50R,B00,893769,Carter; Jennifer A,0,0,20,20
1745801997421,MCWP 50R,C00,893771,Krone; Jarret,0,3,20,20
1745801997421,MCWP 50R,D00,893772,Miller; Elizabeth Deen,3,0,20,17
1745801997421,MCWP 50R,E00,893775,Carter; Andrea L,0,0,20,20
1745801998445,MMW 11R,A01,892721,Herbst; Matthew,11,0,27,16
1745801998445,MMW 11R,A02,892722,Herbst; Matthew,0,0,0,3
1745801999470,MMW 12R,A01,892724,Herbst; Matthew,0,9,16,16
1745801999470,MMW 12R,A02,892725,Herbst; Matthew,0,9,16,16
1745802000499,MMW 13R,A01,892727,Staff,0,4,16,16
1745802000499,MMW 13R,A02,892728,Staff,0,4,16,16
1745802000499,MMW 13R,A03,958032,Staff,0,3,16,16
1745802000499,MMW 13R,A04,958033,Staff,0,2,16,16
1745802000499,MMW 13R,A05,958034,Staff,0,3,16,16
1745802001525,SIO 295LS,A00,894015,Staff,7,0,25,18
1745802002552,SIO 295S,A00,894020,Staff,7,0,25,18
1745802003583,SIOC 290S,B01,958918,Staff,0,0,0,0
1745802004607,SIOC 291S,B01,958922,Staff,0,0,0,0
1745802005635,SOCI 117,A01,895339,Staff,4,0,5,1
1745802006663,WES 237B,A00,894149,Staff,11,0,20,9
1745802008726,AESE 279B,A00,891859,Staff,13,0,35,22
1745802009753,AIP 197,001,891854,Staff,70,0,70,0
1745802010781,ANTH 289S,A00,891856,Gagneux; Pascal,12,0,12,0
1745802011808,BENG 196,001,957946,Engler; Adam J.,9996,0,9999,3
1745802012837,CAT 124RS,A01,956906,Staff,8,0,25,17
1745802013863,CAT 125RS,A01,922013,Staff,8,0,25,17
1745802014889,CLRE 250,A00,891860,Morris; Sheldon,9995,0,9999,4
1745802016944,CLRE 251R,A00,907817,Mehta; Ravindra L.,9994,0,9999,5
1745802017969,CLRE 252,A00,891864,Cuomo; Raphael Eduardo,9993,0,9999,6
1745802018998,CLRE 253,A00,891867,Vaida; Florin,9994,0,9999,5
1745802018998,CLRE 253,B00,907819,Staff,9999,0,9999,0
1745802020029,CLRE 259,A00,891868,Patel; Hemal,9998,0,9999,1
1745802021054,CLRE 260,A00,891872,Cuomo; Raphael Eduardo,9999,0,9999,0
1745802022083,CLRE 297,001,891888,Cuomo; Raphael Eduardo,9999,0,9999,0
1745802023111,CSE 191,A00,958773,Minnes Kemp; Mor Mia,9999,0,9999,0
1745802024137,CSS 201S,A01,892054,Mignozzetti; Umberto,30,0,30,0
1745802025168,CSS 202S,A01,892056,Mignozzetti; Umberto,30,0,30,0
1745802026193,DSC 197,001,956898,Eldridge; Justin Matthew,9998,0,9999,1
1745802027221,DSC 297,001,958000,Mazumdar; Arya,9998,0,9999,1
1745802028246,EAP 100,A00,905686,Staff,9776,0,9999,223
1745802029274,ECE 45,A01,892618,Staff,0,12,50,50
1745802030339,ECE 109,A01,892620,Staff,0,43,0,0
1745802031366,ECE 111,A01,892719,Staff,0,7,50,50
1745802032404,ECE 197,001,957920,Mercier; Patrick Philip,9992,0,9999,7
1745802033431,ECON 178,A01,907814,Zhu; Ying,28,0,35,7
1745802034461,EDS 115,A00,895312,Staff,41,0,45,4
1745802035485,EDS 117,A01,895337,Staff,30,0,30,0
1745802036511,EDS 125,A00,895341,Jones; Gabrielle Anastasia,43,0,45,2
1745802037538,EDS 128A,A01,895459,Fargason; Sharon Gayle,44,0,45,1
1745802038566,EDS 128B,A01,895543,Pappas; Elizabeth,44,0,45,1
1745802039590,EDS 139,A00,897203,Pappas; Elizabeth,44,0,45,1
1745802039590,EDS 139,B00,897209,Fargason; Sharon Gayle,44,0,45,1
1745802040618,EDS 201,A00,895545,Staff,43,0,45,2
1745802041643,EDS 203,A01,895581,Halter; Christopher P.,43,0,45,2
1745802042672,EDS 204R,A01,895625,Heinzman; Erica M.,43,0,45,2
1745802042672,EDS 204R,B01,895693,Halter; Christopher P.,18,0,45,27
1745802043696,EDS 206R,A00,895694,Fargason; Sharon Gayle,9,0,30,21
1745802043696,EDS 206R,B00,895695,Choi; Bailey Miyeon,20,0,30,10
1745802044722,EDS 250,A00,895697,Hemans; Patricia Ann Benitez,43,0,45,2
1745802045750,EDS 281,A00,895701,Meyerott; Theresa Ann,15,0,15,0
1745802046775,EDS 284,A00,895736,Meyerott; Theresa Ann,15,0,15,0
1745802047803,EDS 286,A00,897210,Fine; Sarah,15,0,15,0
1745802048831,EDS 289C,A01,895770,Daly; Alan J.,15,0,15,0
1745802049858,EDS 290,A00,897211,Hofstetter; Carolyn,15,0,15,0
1745802050884,LIGM 5A,A00,896162,Fischer-Grunski; Eva K,15,0,20,5
1745802051910,LIGM 5B,A00,896260,Fischer-Grunski; Eva K,17,0,20,3
1745802052935,LIGM 5C,A00,896308,Fischer-Grunski; Eva K,18,0,20,2
1745802053961,LIIT 5AS,A00,896313,Carnelos; Chiara,18,0,20,2
1745802054990,LIIT 5BS,A00,896416,Carnelos; Chiara,20,0,20,0
1745802056018,LIIT 5CS,A00,896564,Carnelos; Chiara,20,0,20,0
1745802057047,LISP 5A,A00,896588,Munoz Sanchez; Alicia,4,0,20,16
1745802058071,LISP 5B,A00,896653,Munoz Sanchez; Alicia,10,0,20,10
1745802059100,LISP 5C,A00,896655,Munoz Sanchez; Alicia,4,0,20,16
1745802060126,MAE 197,001,957918,Kleissl; Jan,9998,0,9999,1
1745802061155,MATH 2,A01,957937,Staff,34,0,35,1
1745802062182,MATH 197,001,957876,Kedlaya; Kiran S.,9993,0,9999,6
1745802063209,MCWP 40,A00,892729,Duru; Nur,13,0,20,7
1745802063209,MCWP 40,B00,893304,Montejo; Carolina,20,0,20,0
1745802064238,MCWP 40R,A00,893757,Redela; Pamela Morgan,0,6,20,20
1745802065264,MCWP 50,A00,893758,Morshed; Michael James,2,0,20,18
1745802065264,MCWP 50,B00,893761,Bartulis; Jason Michael,17,0,20,3
1745802066293,MCWP 50R,A00,893766,Compas; Sean Matthew,0,1,20,20
1745802066293,MCWP 50R,B00,893769,Carter; Jennifer A,0,0,20,20
1745802066293,MCWP 50R,C00,893771,Krone; Jarret,0,3,20,20
1745802066293,MCWP 50R,D00,893772,Miller; Elizabeth Deen,3,0,20,17
1745802066293,MCWP 50R,E00,893775,Carter; Andrea L,0,0,20,20
1745802067321,MMW 11R,A01,892721,Herbst; Matthew,11,0,27,16
1745802067321,MMW 11R,A02,892722,Herbst; Matthew,0,0,0,3
1745802068350,MMW 12R,A01,892724,Herbst; Matthew,0,9,16,16
1745802068350,MMW 12R,A02,892725,Herbst; Matthew,0,9,16,16
1745802069380,MMW 13R,A01,892727,Staff,0,4,16,16
1745802069380,MMW 13R,A02,892728,Staff,0,4,16,16
1745802069380,MMW 13R,A03,958032,Staff,0,3,16,16
1745802069380,MMW 13R,A04,958033,Staff,0,2,16,16
1745802069380,MMW 13R,A05,958034,Staff,0,3,16,16
1745802070406,SIO 295LS,A00,894015,Staff,7,0,25,18
1745802071434,SIO 295S,A00,894020,Staff,7,0,25,18
1745802072461,SIOC 290S,B01,958918,Staff,0,0,0,0
1745802073488,SIOC 291S,B01,958922,Staff,0,0,0,0
1745802074716,SOCI 117,A01,895339,Staff,4,0,5,1
1745802075741,WES 237B,A00,894149,Staff,11,0,20,9
1745802077804,AESE 279B,A00,891859,Staff,13,0,35,22
1745802078831,AIP 197,001,891854,Staff,70,0,70,0
1745802079860,ANTH 289S,A00,891856,Gagneux; Pascal,12,0,12,0
1745802080886,BENG 196,001,957946,Engler; Adam J.,9996,0,9999,3
1745802081912,CAT 124RS,A01,956906,Staff,8,0,25,17
1745802082940,CAT 125RS,A01,922013,Staff,8,0,25,17
1745802083966,CLRE 250,A00,891860,Morris; Sheldon,9995,0,9999,4
1745802086024,CLRE 251R,A00,907817,Mehta; Ravindra L.,9994,0,9999,5
1745802087051,CLRE 252,A00,891864,Cuomo; Raphael Eduardo,9993,0,9999,6
1745802088080,CLRE 253,A00,891867,Vaida; Florin,9994,0,9999,5
1745802088080,CLRE 253,B00,907819,Staff,9999,0,9999,0
1745802089105,CLRE 259,A00,891868,Patel; Hemal,9998,0,9999,1
1745802090131,CLRE 260,A00,891872,Cuomo; Raphael Eduardo,9999,0,9999,0
1745802091158,CLRE 297,001,891888,Cuomo; Raphael Eduardo,9999,0,9999,0
1745802092184,CSE 191,A00,958773,Minnes Kemp; Mor Mia,9999,0,9999,0
1745802093209,CSS 201S,A01,892054,Mignozzetti; Umberto,30,0,30,0
1745802094239,CSS 202S,A01,892056,Mignozzetti; Umberto,30,0,30,0
1745802095267,DSC 197,001,956898,Eldridge; Justin Matthew,9998,0,9999,1
1745802096294,DSC 297,001,958000,Mazumdar; Arya,9998,0,9999,1
1745802097319,EAP 100,A00,905686,Staff,9776,0,9999,223
1745802098354,ECE 45,A01,892618,Staff,0,12,50,50
1745802099382,ECE 109,A01,892620,Staff,0,43,0,0
1745802100407,ECE 111,A01,892719,Staff,0,7,50,50
1745802101435,ECE 197,001,957920,Mercier; Patrick Philip,9992,0,9999,7
1745802102462,ECON 178,A01,907814,Zhu; Ying,28,0,35,7
1745802103487,EDS 115,A00,895312,Staff,41,0,45,4
1745802104514,EDS 117,A01,895337,Staff,30,0,30,0
1745802105543,EDS 125,A00,895341,Jones; Gabrielle Anastasia,43,0,45,2
1745802106567,EDS 128A,A01,895459,Fargason; Sharon Gayle,44,0,45,1
1745802107593,EDS 128B,A01,895543,Pappas; Elizabeth,44,0,45,1
1745802108620,EDS 139,A00,897203,Pappas; Elizabeth,44,0,45,1
1745802108620,EDS 139,B00,897209,Fargason; Sharon Gayle,44,0,45,1
1745802109646,EDS 201,A00,895545,Staff,43,0,45,2
1745802110674,EDS 203,A01,895581,Halter; Christopher P.,43,0,45,2
1745802111700,EDS 204R,A01,895625,Heinzman; Erica M.,43,0,45,2
1745802111700,EDS 204R,B01,895693,Halter; Christopher P.,18,0,45,27
1745802112725,EDS 206R,A00,895694,Fargason; Sharon Gayle,9,0,30,21
1745802112725,EDS 206R,B00,895695,Choi; Bailey Miyeon,20,0,30,10
1745802113750,EDS 250,A00,895697,Hemans; Patricia Ann Benitez,43,0,45,2
1745802114775,EDS 281,A00,895701,Meyerott; Theresa Ann,15,0,15,0
1745802115801,EDS 284,A00,895736,Meyerott; Theresa Ann,15,0,15,0
1745802116827,EDS 286,A00,897210,Fine; Sarah,15,0,15,0
1745802117854,EDS 289C,A01,895770,Daly; Alan J.,15,0,15,0
1745802118883,EDS 290,A00,897211,Hofstetter; Carolyn,15,0,15,0
1745802119912,LIGM 5A,A00,896162,Fischer-Grunski; Eva K,15,0,20,5
1745802120938,LIGM 5B,A00,896260,Fischer-Grunski; Eva K,17,0,20,3
1745802121968,LIGM 5C,A00,896308,Fischer-Grunski; Eva K,18,0,20,2
1745802122999,LIIT 5AS,A00,896313,Carnelos; Chiara,18,0,20,2
1745802124025,LIIT 5BS,A00,896416,Carnelos; Chiara,20,0,20,0
1745802125053,LIIT 5CS,A00,896564,Carnelos; Chiara,20,0,20,0
1745802126082,LISP 5A,A00,896588,Munoz Sanchez; Alicia,4,0,20,16
1745802127111,LISP 5B,A00,896653,Munoz Sanchez; Alicia,10,0,20,10
1745802128138,LISP 5C,A00,896655,Munoz Sanchez; Alicia,4,0,20,16
1745802129163,MAE 197,001,957918,Kleissl; Jan,9998,0,9999,1
1745802130191,MATH 2,A01,957937,Staff,34,0,35,1
1745802131220,MATH 197,001,957876,Kedlaya; Kiran S.,9993,0,9999,6
1745802132244,MCWP 40,A00,892729,Duru; Nur,13,0,20,7
1745802132244,MCWP 40,B00,893304,Montejo; Carolina,20,0,20,0
1745802133270,MCWP 40R,A00,893757,Redela; Pamela Morgan,0,6,20,20
1745802134336,MCWP 50,A00,893758,Morshed; Michael James,2,0,20,18
1745802134336,MCWP 50,B00,893761,Bartulis; Jason Michael,17,0,20,3
1745802135362,MCWP 50R,A00,893766,Compas; Sean Matthew,0,1,20,20
1745802135362,MCWP 50R,B00,893769,Carter; Jennifer A,0,0,20,20
1745802135362,MCWP 50R,C00,893771,Krone; Jarret,0,3,20,20
1745802135362,MCWP 50R,D00,893772,Miller; Elizabeth Deen,3,0,20,17
1745802135362,MCWP 50R,E00,893775,Carter; Andrea L,0,0,20,20
1745802136390,MMW 11R,A01,892721,Herbst; Matthew,11,0,27,16
1745802136390,MMW 11R,A02,892722,Herbst; Matthew,0,0,0,3
1745802137417,MMW 12R,A01,892724,Herbst; Matthew,0,9,16,16
1745802137417,MMW 12R,A02,892725,Herbst; Matthew,0,9,16,16
1745802138443,MMW 13R,A01,892727,Staff,0,4,16,16
1745802138443,MMW 13R,A02,892728,Staff,0,4,16,16
1745802138443,MMW 13R,A03,958032,Staff,0,3,16,16
1745802138443,MMW 13R,A04,958033,Staff,0,2,16,16
1745802138443,MMW 13R,A05,958034,Staff,0,3,16,16
1745802139472,SIO 295LS,A00,894015,Staff,7,0,25,18
1745802140497,SIO 295S,A00,894020,Staff,7,0,25,18
1745802141524,SIOC 290S,B01,958918,Staff,0,0,0,0
1745802142549,SIOC 291S,B01,958922,Staff,0,0,0,0
1745802143577,SOCI 117,A01,895339,Staff,4,0,5,1
1745802144602,WES 237B,A00,894149,Staff,11,0,20,9
1745802146655,AESE 279B,A00,891859,Staff,13,0,35,22
1745802147682,AIP 197,001,891854,Staff,70,0,70,0
1745802148706,ANTH 289S,A00,891856,Gagneux; Pascal,12,0,12,0
1745802149733,BENG 196,001,957946,Engler; Adam J.,9996,0,9999,3
1745802150758,CAT 124RS,A01,956906,Staff,8,0,25,17
1745802151784,CAT 125RS,A01,922013,Staff,8,0,25,17
1745802152812,CLRE 250,A00,891860,Morris; Sheldon,9995,0,9999,4
1745802154863,CLRE 251R,A00,907817,Mehta; Ravindra L.,9994,0,9999,5
1745802155891,CLRE 252,A00,891864,Cuomo; Raphael Eduardo,9993,0,9999,6
1745802156921,CLRE 253,A00,891867,Vaida; Florin,9994,0,9999,5
1745802156921,CLRE 253,B00,907819,Staff,9999,0,9999,0
1745802157946,CLRE 259,A00,891868,Patel; Hemal,9998,0,9999,1
1745802158976,CLRE 260,A00,891872,Cuomo; Raphael Eduardo,9999,0,9999,0
1745802160002,CLRE 297,001,891888,Cuomo; Raphael Eduardo,9999,0,9999,0
1745802161028,CSE 191,A00,958773,Minnes Kemp; Mor Mia,9999,0,9999,0
1745802162057,CSS 201S,A01,892054,Mignozzetti; Umberto,30,0,30,0
1745802163087,CSS 202S,A01,892056,Mignozzetti; Umberto,30,0,30,0
1745802164114,DSC 197,001,956898,Eldridge; Justin Matthew,9998,0,9999,1
1745802165140,DSC 297,001,958000,Mazumdar; Arya,9998,0,9999,1
1745802166166,EAP 100,A00,905686,Staff,9776,0,9999,223
1745802167194,ECE 45,A01,892618,Staff,0,12,50,50
1745802168221,ECE 109,A01,892620,Staff,0,43,0,0
1745802169246,ECE 111,A01,892719,Staff,0,7,50,50
1745802170274,ECE 197,001,957920,Mercier; Patrick Philip,9992,0,9999,7
1745802171303,ECON 178,A01,907814,Zhu; Ying,28,0,35,7
1745802172331,EDS 115,A00,895312,Staff,41,0,45,4
1745802173359,EDS 117,A01,895337,Staff,30,0,30,0
1745802174385,EDS 125,A00,895341,Jones; Gabrielle Anastasia,43,0,45,2
1745802175413,EDS 128A,A01,895459,Fargason; Sharon Gayle,44,0,45,1
1745802176440,EDS 128B,A01,895543,Pappas; Elizabeth,44,0,45,1
1745802177466,EDS 139,A00,897203,Pappas; Elizabeth,44,0,45,1
1745802177466,EDS 139,B00,897209,Fargason; Sharon Gayle,44,0,45,1
1745802178489,EDS 201,A00,895545,Staff,43,0,45,2
1745802179515,EDS 203,A01,895581,Halter; Christopher P.,43,0,45,2
1745802180540,EDS 204R,A01,895625,Heinzman; Erica M.,43,0,45,2
1745802180540,EDS 204R,B01,895693,Halter; Christopher P.,18,0,45,27
1745802181567,EDS 206R,A00,895694,Fargason; Sharon Gayle,9,0,30,21
1745802181567,EDS 206R,B00,895695,Choi; Bailey Miyeon,20,0,30,10
1745802182595,EDS 250,A00,895697,Hemans; Patricia Ann Benitez,43,0,45,2
1745802183626,EDS 281,A00,895701,Meyerott; Theresa Ann,15,0,15,0
1745802184650,EDS 284,A00,895736,Meyerott; Theresa Ann,15,0,15,0
1745802185678,EDS 286,A00,897210,Fine; Sarah,15,0,15,0
1745802186706,EDS 289C,A01,895770,Daly; Alan J.,15,0,15,0
1745802187734,EDS 290,A00,897211,Hofstetter; Carolyn,15,0,15,0
1745802188761,LIGM 5A,A00,896162,Fischer-Grunski; Eva K,15,0,20,5
1745802189787,LIGM 5B,A00,896260,Fischer-Grunski; Eva K,17,0,20,3
1745802190816,LIGM 5C,A00,896308,Fischer-Grunski; Eva K,18,0,20,2
1745802191845,LIIT 5AS,A00,896313,Carnelos; Chiara,18,0,20,2
1745802192873,LIIT 5BS,A00,896416,Carnelos; Chiara,20,0,20,0
1745802193899,LIIT 5CS,A00,896564,Carnelos; Chiara,20,0,20,0
1745802194926,LISP 5A,A00,896588,Munoz Sanchez; Alicia,4,0,20,16
1745802195952,LISP 5B,A00,896653,Munoz Sanchez; Alicia,10,0,20,10
1745802196978,LISP 5C,A00,896655,Munoz Sanchez; Alicia,4,0,20,16
1745802198005,MAE 197,001,957918,Kleissl; Jan,9998,0,9999,1
1745802199033,MATH 2,A01,957937,Staff,34,0,35,1
1745802200059,MATH 197,001,957876,Kedlaya; Kiran S.,9993,0,9999,6
1745802201087,MCWP 40,A00,892729,Duru; Nur,13,0,20,7
1745802201087,MCWP 40,B00,893304,Montejo; Carolina,20,0,20,0
1745802202114,MCWP 40R,A00,893757,Redela; Pamela Morgan,0,6,20,20
1745802203140,MCWP 50,A00,893758,Morshed; Michael James,2,0,20,18
1745802203140,MCWP 50,B00,893761,Bartulis; Jason Michael,17,0,20,3
1745802204171,MCWP 50R,A00,893766,Compas; Sean Matthew,0,1,20,20
1745802204171,MCWP 50R,B00,893769,Carter; Jennifer A,0,0,20,20
1745802204171,MCWP 50R,C00,893771,Krone; Jarret,0,3,20,20
1745802204171,MCWP 50R,D00,893772,Miller; Elizabeth Deen,3,0,20,17
1745802204171,MCWP 50R,E00,893775,Carter; Andrea L,0,0,20,20
1745802205197,MMW 11R,A01,892721,Herbst; Matthew,11,0,27,16
1745802205197,MMW 11R,A02,892722,Herbst; Matthew,0,0,0,3
1745802206226,MMW 12R,A01,892724,Herbst; Matthew,0,9,16,16
1745802206226,MMW 12R,A02,892725,Herbst; Matthew,0,9,16,16
1745802207252,MMW 13R,A01,892727,Staff,0,4,16,16
1745802207252,MMW 13R,A02,892728,Staff,0,4,16,16
1745802207252,MMW 13R,A03,958032,Staff,0,3,16,16
1745802207252,MMW 13R,A04,958033,Staff,0,2,16,16
1745802207252,MMW 13R,A05,958034,Staff,0,3,16,16
1745802208279,SIO 295LS,A00,894015,Staff,7,0,25,18
1745802209308,SIO 295S,A00,894020,Staff,7,0,25,18
1745802210335,SIOC 290S,B01,958918,Staff,0,0,0,0
1745802211365,SIOC 291S,B01,958922,Staff,0,0,0,0
1745802212394,SOCI 117,A01,895339,Staff,4,0,5,1
1745802213421,WES 237B,A00,894149,Staff,11,0,20,9
1745802215477,AESE 279B,A00,891859,Staff,13,0,35,22
1745802216504,AIP 197,001,891854,Staff,70,0,70,0
1745802217529,ANTH 289S,A00,891856,Gagneux; Pascal,12,0,12,0
1745802218557,BENG 196,001,957946,Engler; Adam J.,9996,0,9999,3
1745802219585,CAT 124RS,A01,956906,Staff,8,0,25,17
1745802220608,CAT 125RS,A01,922013,Staff,8,0,25,17
1745802221634,CLRE 250,A00,891860,Morris; Sheldon,9995,0,9999,4
1745802223689,CLRE 251R,A00,907817,Mehta; Ravindra L.,9994,0,9999,5
1745802224717,CLRE 252,A00,891864,Cuomo; Raphael Eduardo,9993,0,9999,6
1745802225742,CLRE 253,A00,891867,Vaida; Florin,9994,0,9999,5
1745802225742,CLRE 253,B00,907819,Staff,9999,0,9999,0
1745802226770,CLRE 259,A00,891868,Patel; Hemal,9998,0,9999,1
1745802227797,CLRE 260,A00,891872,Cuomo; Raphael Eduardo,9999,0,9999,0
1745802228823,CLRE 297,001,891888,Cuomo; Raphael Eduardo,9999,0,9999,0
1745802229848,CSE 191,A00,958773,Minnes Kemp; Mor Mia,9999,0,9999,0
1745802230874,CSS 201S,A01,892054,Mignozzetti; Umberto,30,0,30,0
1745802231901,CSS 202S,A01,892056,Mignozzetti; Umberto,30,0,30,0
1745802232928,DSC 197,001,956898,Eldridge; Justin Matthew,9998,0,9999,1
1745802233955,DSC 297,001,958000,Mazumdar; Arya,9998,0,9999,1
1745802234981,EAP 100,A00,905686,Staff,9776,0,9999,223
1745802236007,ECE 45,A01,892618,Staff,0,12,50,50
1745802237034,ECE 109,A01,892620,Staff,0,43,0,0
1745802238123,ECE 111,A01,892719,Staff,0,7,50,50
1745802239150,ECE 197,001,957920,Mercier; Patrick Philip,9992,0,9999,7
1745802240177,ECON 178,A01,907814,Zhu; Ying,28,0,35,7
1745802241203,EDS 115,A00,895312,Staff,41,0,45,4
1745802242229,EDS 117,A01,895337,Staff,30,0,30,0
1745802243255,EDS 125,A00,895341,Jones; Gabrielle Anastasia,43,0,45,2
1745802244283,EDS 128A,A01,895459,Fargason; Sharon Gayle,44,0,45,1
1745802245312,EDS 128B,A01,895543,Pappas; Elizabeth,44,0,45,1
1745802246340,EDS 139,A00,897203,Pappas; Elizabeth,44,0,45,1
1745802246340,EDS 139,B00,897209,Fargason; Sharon Gayle,44,0,45,1
1745802247366,EDS 201,A00,895545,Staff,43,0,45,2
1745802248392,EDS 203,A01,895581,Halter; Christopher P.,43,0,45,2
1745802249419,EDS 204R,A01,895625,Heinzman; Erica M.,43,0,45,2
1745802249419,EDS 204R,B01,895693,Halter; Christopher P.,18,0,45,27
1745802250444,EDS 206R,A00,895694,Fargason; Sharon Gayle,9,0,30,21
1745802250444,EDS 206R,B00,895695,Choi; Bailey Miyeon,20,0,30,10
1745802251470,EDS 250,A00,895697,Hemans; Patricia Ann Benitez,43,0,45,2
1745802252495,EDS 281,A00,895701,Meyerott; Theresa Ann,15,0,15,0
1745802253520,EDS 284,A00,895736,Meyerott; Theresa Ann,15,0,15,0
1745802254549,EDS 286,A00,897210,Fine; Sarah,15,0,15,0
1745802255573,EDS 289C,A01,895770,Daly; Alan J.,15,0,15,0
1745802256602,EDS 290,A00,897211,Hofstetter; Carolyn,15,0,15,0
1745802257627,LIGM 5A,A00,896162,Fischer-Grunski; Eva K,15,0,20,5
1745802258656,LIGM 5B,A00,896260,Fischer-Grunski; Eva K,17,0,20,3
1745802259686,LIGM 5C,A00,896308,Fischer-Grunski; Eva K,18,0,20,2
1745802260712,LIIT 5AS,A00,896313,Carnelos; Chiara,18,0,20,2
1745802261739,LIIT 5BS,A00,896416,Carnelos; Chiara,20,0,20,0
1745802262766,LIIT 5CS,A00,896564,Carnelos; Chiara,20,0,20,0
1745802263795,LISP 5A,A00,896588,Munoz Sanchez; Alicia,4,0,20,16
1745802264825,LISP 5B,A00,896653,Munoz Sanchez; Alicia,10,0,20,10
1745802265852,LISP 5C,A00,896655,Munoz Sanchez; Alicia,4,0,20,16
1745802266877,MAE 197,001,957918,Kleissl; Jan,9998,0,9999,1
1745802267902,MATH 2,A01,957937,Staff,34,0,35,1
1745802269189,MATH 197,001,957876,Kedlaya; Kiran S.,9993,0,9999,6
1745802270217,MCWP 40,A00,892729,Duru; Nur,13,0,20,7
1745802270217,MCWP 40,B00,893304,Montejo; Carolina,20,0,20,0
1745802271244,MCWP 40R,A00,893757,Redela; Pamela Morgan,0,6,20,20
1745802272270,MCWP 50,A00,893758,Morshed; Michael James,2,0,20,18
1745802272270,MCWP 50,B00,893761,Bartulis; Jason Michael,17,0,20,3
1745802273299,MCWP 50R,A00,893766,Compas; Sean Matthew,0,1,20,20
1745802273299,MCWP 50R,B00,893769,Carter; Jennifer A,0,0,20,20
1745802273299,MCWP 50R,C00,893771,Krone; Jarret,0,3,20,20
1745802273299,MCWP 50R,D00,893772,Miller; Elizabeth Deen,3,0,20,17
1745802273299,MCWP 50R,E00,893775,Carter; Andrea L,0,0,20,20
1745802274329,MMW 11R,A01,892721,Herbst; Matthew,11,0,27,16
1745802274329,MMW 11R,A02,892722,Herbst; Matthew,0,0,0,3
1745802275358,MMW 12R,A01,892724,Herbst; Matthew,0,9,16,16
1745802275358,MMW 12R,A02,892725,Herbst; Matthew,0,9,16,16
1745802276388,MMW 13R,A01,892727,Staff,0,4,16,16
1745802276388,MMW 13R,A02,892728,Staff,0,4,16,16
1745802276388,MMW 13R,A03,958032,Staff,0,3,16,16
1745802276388,MMW 13R,A04,958033,Staff,0,2,16,16
1745802276388,MMW 13R,A05,958034,Staff,0,3,16,16
1745802277416,SIO 295LS,A00,894015,Staff,7,0,25,18
1745802278444,SIO 295S,A00,894020,Staff,7,0,25,18
1745802279473,SIOC 290S,B01,958918,Staff,0,0,0,0
1745802280500,SIOC 291S,B01,958922,Staff,0,0,0,0
1745802281528,SOCI 117,A01,895339,Staff,4,0,5,1
1745802282554,WES 237B,A00,894149,Staff,11,0,20,9
1745802284613,AESE 279B,A00,891859,Staff,13,0,35,22
1745802285639,AIP 197,001,891854,Staff,70,0,70,0
1745802286667,ANTH 289S,A00,891856,Gagneux; Pascal,12,0,12,0
1745802287692,BENG 196,001,957946,Engler; Adam J.,9996,0,9999,3
1745802288720,CAT 124RS,A01,956906,Staff,8,0,25,17
1745802289748,CAT 125RS,A01,922013,Staff,8,0,25,17
1745802290773,CLRE 250,A00,891860,Morris; Sheldon,9995,0,9999,4
1745802292825,CLRE 251R,A00,907817,Mehta; Ravindra L.,9994,0,9999,5
1745802293857,CLRE 252,A00,891864,Cuomo; Raphael Eduardo,9993,0,9999,6
1745802294887,CLRE 253,A00,891867,Vaida; Florin,9994,0,9999,5
1745802294887,CLRE 253,B00,907819,Staff,9999,0,9999,0
1745802295912,CLRE 259,A00,891868,Patel; Hemal,9998,0,9999,1
1745802296939,CLRE 260,A00,891872,Cuomo; Raphael Eduardo,9999,0,9999,0
1745802297965,CLRE 297,001,891888,Cuomo; Raphael Eduardo,9999,0,9999,0
1745802298991,CSE 191,A00,958773,Minnes Kemp; Mor Mia,9999,0,9999,0
1745802300019,CSS 201S,A01,892054,Mignozzetti; Umberto,30,0,30,0
1745802301046,CSS 202S,A01,892056,Mignozzetti; Umberto,30,0,30,0
1745802302073,DSC 197,001,956898,Eldridge; Justin Matthew,9998,0,9999,1
1745802303099,DSC 297,001,958000,Mazumdar; Arya,9998,0,9999,1
1745802304126,EAP 100,A00,905686,Staff,9776,0,9999,223
1745802305153,ECE 45,A01,892618,Staff,0,12,50,50
1745802306180,ECE 109,A01,892620,Staff,0,43,0,0
1745802307212,ECE 111,A01,892719,Staff,0,7,50,50
1745802308237,ECE 197,001,957920,Mercier; Patrick Philip,9992,0,9999,7
1745802309266,ECON 178,A01,907814,Zhu; Ying,28,0,35,7
1745802310293,EDS 115,A00,895312,Staff,41,0,45,4
1745802311319,EDS 117,A01,895337,Staff,30,0,30,0
1745802312348,EDS 125,A00,895341,Jones; Gabrielle Anastasia,43,0,45,2
1745802313378,EDS 128A,A01,895459,Fargason; Sharon Gayle,44,0,45,1
1745802314403,EDS 128B,A01,895543,Pappas; Elizabeth,44,0,45,1
1745802315430,EDS 139,A00,897203,Pappas; Elizabeth,44,0,45,1
1745802315430,EDS 139,B00,897209,Fargason; Sharon Gayle,44,0,45,1
1745802316454,EDS 201,A00,895545,Staff,43,0,45,2
1745802317480,EDS 203,A01,895581,Halter; Christopher P.,43,0,45,2
1745802318519,EDS 204R,A01,895625,Heinzman; Erica M.,43,0,45,2
1745802318519,EDS 204R,B01,895693,Halter; Christopher P.,18,0,45,27
1745802319544,EDS 206R,A00,895694,Fargason; Sharon Gayle,9,0,30,21
1745802319544,EDS 206R,B00,895695,Choi; Bailey Miyeon,20,0,30,10
1745802320571,EDS 250,A00,895697,Hemans; Patricia Ann Benitez,43,0,45,2
1745802321598,EDS 281,A00,895701,Meyerott; Theresa Ann,15,0,15,0
1745802322624,EDS 284,A00,895736,Meyerott; Theresa Ann,15,0,15,0
1745802323652,EDS 286,A00,897210,Fine; Sarah,15,0,15,0
1745802324680,EDS 289C,A01,895770,Daly; Alan J.,15,0,15,0
1745802325706,EDS 290,A00,897211,Hofstetter; Carolyn,15,0,15,0
1745802326732,LIGM 5A,A00,896162,Fischer-Grunski; Eva K,15,0,20,5
1745802327760,LIGM 5B,A00,896260,Fischer-Grunski; Eva K,17,0,20,3
1745802328786,LIGM 5C,A00,896308,Fischer-Grunski; Eva K,18,0,20,2
1745802329812,LIIT 5AS,A00,896313,Carnelos; Chiara,18,0,20,2
1745802330839,LIIT 5BS,A00,896416,Carnelos; Chiara,20,0,20,0
1745802331868,LIIT 5CS,A00,896564,Carnelos; Chiara,20,0,20,0
1745802332899,LISP 5A,A00,896588,Munoz Sanchez; Alicia,4,0,20,16
1745802333927,LISP 5B,A00,896653,Munoz Sanchez; Alicia,10,0,20,10
1745802334953,LISP 5C,A00,896655,Munoz Sanchez; Alicia,4,0,20,16
1745802335981,MAE 197,001,957918,Kleissl; Jan,9998,0,9999,1
1745802337006,MATH 2,A01,957937,Staff,34,0,35,1
1745802338034,MATH 197,001,957876,Kedlaya; Kiran S.,9993,0,9999,6
1745802339062,MCWP 40,A00,892729,Duru; Nur,13,0,20,7
1745802339062,MCWP 40,B00,893304,Montejo; Carolina,20,0,20,0
1745802340088,MCWP 40R,A00,893757,Redela; Pamela Morgan,0,6,20,20
1745802341115,MCWP 50,A00,893758,Morshed; Michael James,2,0,20,18
1745802341115,MCWP 50,B00,893761,Bartulis; Jason Michael,17,0,20,3
1745802342181,MCWP 50R,A00,893766,Compas; Sean Matthew,0,1,20,20
1745802342181,MCWP 50R,B00,893769,Carter; Jennifer A,0,0,20,20
1745802342181,MCWP 50R,C00,893771,Krone; Jarret,0,3,20,20
1745802342181,MCWP 50R,D00,893772,Miller; Elizabeth Deen,3,0,20,17
1745802342181,MCWP 50R,E00,893775,Carter; Andrea L,0,0,20,20
1745802343210,MMW 11R,A01,892721,Herbst; Matthew,11,0,27,16
1745802343210,MMW 11R,A02,892722,Herbst; Matthew,0,0,0,3
1745802344236,MMW 12R,A01,892724,Herbst; Matthew,0,9,16,16
1745802344236,MMW 12R,A02,892725,Herbst; Matthew,0,9,16,16
1745802345260,MMW 13R,A01,892727,Staff,0,4,16,16
1745802345260,MMW 13R,A02,892728,Staff,0,4,16,16
1745802345260,MMW 13R,A03,958032,Staff,0,3,16,16
1745802345260,MMW 13R,A04,958033,Staff,0,2,16,16
1745802345260,MMW 13R,A05,958034,Staff,0,3,16,16
1745802346286,SIO 295LS,A00,894015,Staff,7,0,25,18
1745802347312,SIO 295S,A00,894020,Staff,7,0,25,18
1745802348337,SIOC 290S,B01,958918,Staff,0,0,0,0
1745802349363,SIOC 291S,B01,958922,Staff,0,0,0,0
1745802350391,SOCI 117,A01,895339,Staff,4,0,5,1
1745802351417,WES 237B,A00,894149,Staff,11,0,20,9
1745802353480,AESE 279B,A00,891859,Staff,13,0,35,22
1745802354506,AIP 197,001,891854,Staff,70,0,70,0
1745802355529,ANTH 289S,A00,891856,Gagneux; Pascal,12,0,12,0
1745802356556,BENG 196,001,957946,Engler; Adam J.,9996,0,9999,3
1745802357584,CAT 124RS,A01,956906,Staff,8,0,25,17
1745802358609,CAT 125RS,A01,922013,Staff,8,0,25,17
1745802359635,CLRE 250,A00,891860,Morris; Sheldon,9995,0,9999,4
1745802361693,CLRE 251R,A00,907817,Mehta; Ravindra L.,9994,0,9999,5
1745802362720,CLRE 252,A00,891864,Cuomo; Raphael Eduardo,9993,0,9999,6
1745802363748,CLRE 253,A00,891867,Vaida; Florin,9994,0,9999,5
1745802363748,CLRE 253,B00,907819,Staff,9999,0,9999,0
1745802364776,CLRE 259,A00,891868,Patel; Hemal,9998,0,9999,1
1745802365804,CLRE 260,A00,891872,Cuomo; Raphael Eduardo,9999,0,9999,0
1745802366830,CLRE 297,001,891888,Cuomo; Raphael Eduardo,9999,0,9999,0
1745802367859,CSE 191,A00,958773,Minnes Kemp; Mor Mia,9999,0,9999,0
1745802368885,CSS 201S,A01,892054,Mignozzetti; Umberto,30,0,30,0
1745802369914,CSS 202S,A01,892056,Mignozzetti; Umberto,30,0,30,0
1745802370942,DSC 197,001,956898,Eldridge; Justin Matthew,9998,0,9999,1
1745802371968,DSC 297,001,958000,Mazumdar; Arya,9998,0,9999,1
1745802372994,EAP 100,A00,905686,Staff,9776,0,9999,223
1745802374021,ECE 45,A01,892618,Staff,0,12,50,50
1745802375048,ECE 109,A01,892620,Staff,0,43,0,0
1745802376076,ECE 111,A01,892719,Staff,0,7,50,50
1745802377105,ECE 197,001,957920,Mercier; Patrick Philip,9992,0,9999,7
1745802378135,ECON 178,A01,907814,Zhu; Ying,28,0,35,7
1745802379162,EDS 115,A00,895312,Staff,41,0,45,4
1745802380189,EDS 117,A01,895337,Staff,30,0,30,0
1745802381215,EDS 125,A00,895341,Jones; Gabrielle Anastasia,43,0,45,2
1745802382244,EDS 128A,A01,895459,Fargason; Sharon Gayle,44,0,45,1
1745802383272,EDS 128B,A01,895543,Pappas; Elizabeth,44,0,45,1
1745802384300,EDS 139,A00,897203,Pappas; Elizabeth,44,0,45,1
1745802384300,EDS 139,B00,897209,Fargason; Sharon Gayle,44,0,45,1
1745802385329,EDS 201,A00,895545,Staff,43,0,45,2
1745802386355,EDS 203,A01,895581,Halter; Christopher P.,43,0,45,2
1745802387386,EDS 204R,A01,895625,Heinzman; Erica M.,43,0,45,2
1745802387386,EDS 204R,B01,895693,Halter; Christopher P.,18,0,45,27
1745802388414,EDS 206R,A00,895694,Fargason; Sharon Gayle,9,0,30,21
1745802388414,EDS 206R,B00,895695,Choi; Bailey Miyeon,20,0,30,10
1745802389439,EDS 250,A00,895697,Hemans; Patricia Ann Benitez,43,0,45,2
1745802390470,EDS 281,A00,895701,Meyerott; Theresa Ann,15,0,15,0
1745802391496,EDS 284,A00,895736,Meyerott; Theresa Ann,15,0,15,0
1745802392522,EDS 286,A00,897210,Fine; Sarah,15,0,15,0
1745802393549,EDS 289C,A01,895770,Daly; Alan J.,15,0,15,0
1745802394577,EDS 290,A00,897211,Hofstetter; Carolyn,15,0,15,0
1745802395601,LIGM 5A,A00,896162,Fischer-Grunski; Eva K,15,0,20,5
1745802396632,LIGM 5B,A00,896260,Fischer-Grunski; Eva K,17,0,20,3
1745802397660,LIGM 5C,A00,896308,Fischer-Grunski; Eva K,18,0,20,2
1745802398688,LIIT 5AS,A00,896313,Carnelos; Chiara,18,0,20,2
1745802399716,LIIT 5BS,A00,896416,Carnelos; Chiara,20,0,20,0
1745802400745,LIIT 5CS,A00,896564,Carnelos; Chiara,20,0,20,0
1745802401775,LISP 5A,A00,896588,Munoz Sanchez; Alicia,4,0,20,16
1745802402800,LISP 5B,A00,896653,Munoz Sanchez; Alicia,10,0,20,10
1745802403830,LISP 5C,A00,896655,Munoz Sanchez; Alicia,4,0,20,16
1745802404857,MAE 197,001,957918,Kleissl; Jan,9998,0,9999,1
1745802405882,MATH 2,A01,957937,Staff,34,0,35,1
1745802406909,MATH 197,001,957876,Kedlaya; Kiran S.,9993,0,9999,6
1745802407938,MCWP 40,A00,892729,Duru; Nur,13,0,20,7
1745802407938,MCWP 40,B00,893304,Montejo; Carolina,20,0,20,0
1745802408967,MCWP 40R,A00,893757,Redela; Pamela Morgan,0,6,20,20
1745802409993,MCWP 50,A00,893758,Morshed; Michael James,2,0,20,18
1745802409993,MCWP 50,B00,893761,Bartulis; Jason Michael,17,0,20,3
1745802411022,MCWP 50R,A00,893766,Compas; Sean Matthew,0,1,20,20
1745802411022,MCWP 50R,B00,893769,Carter; Jennifer A,0,0,20,20
1745802411022,MCWP 50R,C00,893771,Krone; Jarret,0,3,20,20
1745802411022,MCWP 50R,D00,893772,Miller; Elizabeth Deen,3,0,20,17
1745802411022,MCWP 50R,E00,893775,Carter; Andrea L,0,0,20,20
1745802412047,MMW 11R,A01,892721,Herbst; Matthew,11,0,27,16
1745802412047,MMW 11R,A02,892722,Herbst; Matthew,0,0,0,3
1745802413076,MMW 12R,A01,892724,Herbst; Matthew,0,9,16,16
1745802413076,MMW 12R,A02,892725,Herbst; Matthew,0,9,16,16
1745802414103,MMW 13R,A01,892727,Staff,0,4,16,16
1745802414103,MMW 13R,A02,892728,Staff,0,4,16,16
1745802414103,MMW 13R,A03,958032,Staff,0,3,16,16
1745802414103,MMW 13R,A04,958033,Staff,0,2,16,16
1745802414103,MMW 13R,A05,958034,Staff,0,3,16,16
1745802415130,SIO 295LS,A00,894015,Staff,7,0,25,18
1745802416156,SIO 295S,A00,894020,Staff,7,0,25,18
1745802417186,SIOC 290S,B01,958918,Staff,0,0,0,0
1745802418212,SIOC 291S,B01,958922,Staff,0,0,0,0
1745802419237,SOCI 117,A01,895339,Staff,4,0,5,1
1745802420263,WES 237B,A00,894149,Staff,11,0,20,9
1745802422322,AESE 279B,A00,891859,Staff,13,0,35,22
1745802423349,AIP 197,001,891854,Staff,70,0,70,0
1745802424378,ANTH 289S,A00,891856,Gagneux; Pascal,12,0,12,0
1745802425404,BENG 196,001,957946,Engler; Adam J.,9996,0,9999,3
1745802426432,CAT 124RS,A01,956906,Staff,8,0,25,17
1745802427458,CAT 125RS,A01,922013,Staff,8,0,25,17
1745802428484,CLRE 250,A00,891860,Morris; Sheldon,9995,0,9999,4
1745802430537,CLRE 251R,A00,907817,Mehta; Ravindra L.,9994,0,9999,5
1745802431562,CLRE 252,A00,891864,Cuomo; Raphael Eduardo,9993,0,9999,6
1745802432592,CLRE 253,A00,891867,Vaida; Florin,9994,0,9999,5
1745802432592,CLRE 253,B00,907819,Staff,9999,0,9999,0
1745802433620,CLRE 259,A00,891868,Patel; Hemal,9998,0,9999,1
1745802434649,CLRE 260,A00,891872,Cuomo; Raphael Eduardo,9999,0,9999,0
1745802435675,CLRE 297,001,891888,Cuomo; Raphael Eduardo,9999,0,9999,0
1745802436703,CSE 191,A00,958773,Minnes Kemp; Mor Mia,9999,0,9999,0
1745802437729,CSS 201S,A01,892054,Mignozzetti; Umberto,30,0,30,0
1745802438755,CSS 202S,A01,892056,Mignozzetti; Umberto,30,0,30,0
1745802439780,DSC 197,001,956898,Eldridge; Justin Matthew,9998,0,9999,1
1745802440810,DSC 297,001,958000,Mazumdar; Arya,9998,0,9999,1
1745802441838,EAP 100,A00,905686,Staff,9776,0,9999,223
1745802442867,ECE 45,A01,892618,Staff,0,12,50,50
1745802443894,ECE 109,A01,892620,Staff,0,43,0,0
1745802444922,ECE 111,A01,892719,Staff,0,7,50,50
1745802445986,ECE 197,001,957920,Mercier; Patrick Philip,9992,0,9999,7
1745802447011,ECON 178,A01,907814,Zhu; Ying,28,0,35,7
1745802448060,EDS 115,A00,895312,Staff,41,0,45,4
1745802449085,EDS 117,A01,895337,Staff,30,0,30,0
1745802450115,EDS 125,A00,895341,Jones; Gabrielle Anastasia,43,0,45,2
1745802451141,EDS 128A,A01,895459,Fargason; Sharon Gayle,44,0,45,1
1745802452166,EDS 128B,A01,895543,Pappas; Elizabeth,44,0,45,1
1745802453194,EDS 139,A00,897203,Pappas; Elizabeth,44,0,45,1
1745802453194,EDS 139,B00,897209,Fargason; Sharon Gayle,44,0,45,1
1745802454218,EDS 201,A00,895545,Staff,43,0,45,2
1745802455244,EDS 203,A01,895581,Halter; Christopher P.,43,0,45,2
1745802456272,EDS 204R,A01,895625,Heinzman; Erica M.,43,0,45,2
1745802456272,EDS 204R,B01,895693,Halter; Christopher P.,18,0,45,27
1745802457303,EDS 206R,A00,895694,Fargason; Sharon Gayle,9,0,30,21
1745802457303,EDS 206R,B00,895695,Choi; Bailey Miyeon,20,0,30,10
1745802458328,EDS 250,A00,895697,Hemans; Patricia Ann Benitez,43,0,45,2
1745802459352,EDS 281,A00,895701,Meyerott; Theresa Ann,15,0,15,0
1745802460379,EDS 284,A00,895736,Meyerott; Theresa Ann,15,0,15,0
1745802461405,EDS 286,A00,897210,Fine; Sarah,15,0,15,0
1745802462430,EDS 289C,A01,895770,Daly; Alan J.,15,0,15,0
1745802463455,EDS 290,A00,897211,Hofstetter; Carolyn,15,0,15,0
1745802464485,LIGM 5A,A00,896162,Fischer-Grunski; Eva K,15,0,20,5
1745802465511,LIGM 5B,A00,896260,Fischer-Grunski; Eva K,17,0,20,3
1745802466538,LIGM 5C,A00,896308,Fischer-Grunski; Eva K,18,0,20,2
1745802467561,LIIT 5AS,A00,896313,Carnelos; Chiara,18,0,20,2
1745802468588,LIIT 5BS,A00,896416,Carnelos; Chiara,20,0,20,0
1745802469615,LIIT 5CS,A00,896564,Carnelos; Chiara,20,0,20,0
1745802470642,LISP 5A,A00,896588,Munoz Sanchez; Alicia,4,0,20,16
1745802471667,LISP 5B,A00,896653,Munoz Sanchez; Alicia,10,0,20,10
1745802472696,LISP 5C,A00,896655,Munoz Sanchez; Alicia,4,0,20,16
1745802473724,MAE 197,001,957918,Kleissl; Jan,9998,0,9999,1
1745802474749,MATH 2,A01,957937,Staff,34,0,35,1
1745802475775,MATH 197,001,957876,Kedlaya; Kiran S.,9993,0,9999,6
1745802476804,MCWP 40,A00,892729,Duru; Nur,13,0,20,7
1745802476804,MCWP 40,B00,893304,Montejo; Carolina,20,0,20,0
1745802477830,MCWP 40R,A00,893757,Redela; Pamela Morgan,0,6,20,20
1745802478864,MCWP 50,A00,893758,Morshed; Michael James,2,0,20,18
1745802478864,MCWP 50,B00,893761,Bartulis; Jason Michael,17,0,20,3
1745802479890,MCWP 50R,A00,893766,Compas; Sean Matthew,0,1,20,20
1745802479890,MCWP 50R,B00,893769,Carter; Jennifer A,0,0,20,20
1745802479890,MCWP 50R,C00,893771,Krone; Jarret,0,3,20,20
1745802479890,MCWP 50R,D00,893772,Miller; Elizabeth Deen,3,0,20,17
1745802479890,MCWP 50R,E00,893775,Carter; Andrea L,0,0,20,20
1745802480918,MMW 11R,A01,892721,Herbst; Matthew,11,0,27,16
1745802480918,MMW 11R,A02,892722,Herbst; Matthew,0,0,0,3
1745802481943,MMW 12R,A01,892724,Herbst; Matthew,0,9,16,16
1745802481943,MMW 12R,A02,892725,Herbst; Matthew,0,9,16,16
1745802482969,MMW 13R,A01,892727,Staff,0,4,16,16
1745802482969,MMW 13R,A02,892728,Staff,0,4,16,16
1745802482969,MMW 13R,A03,958032,Staff,0,3,16,16
1745802482969,MMW 13R,A04,958033,Staff,0,2,16,16
1745802482969,MMW 13R,A05,958034,Staff,0,3,16,16
1745802483995,SIO 295LS,A00,894015,Staff,7,0,25,18
1745802485021,SIO 295S,A00,894020,Staff,7,0,25,18
1745802486047,SIOC 290S,B01,958918,Staff,0,0,0,0
1745802487077,SIOC 291S,B01,958922,Staff,0,0,0,0
1745802488103,SOCI 117,A01,895339,Staff,4,0,5,1
1745802489129,WES 237B,A00,894149,Staff,11,0,20,9
1745802491188,AESE 279B,A00,891859,Staff,13,0,35,22
1745802492213,AIP 197,001,891854,Staff,70,0,70,0
1745802493241,ANTH 289S,A00,891856,Gagneux; Pascal,12,0,12,0
1745802494268,BENG 196,001,957946,Engler; Adam J.,9996,0,9999,3
1745802495295,CAT 124RS,A01,956906,Staff,8,0,25,17
1745802496320,CAT 125RS,A01,922013,Staff,8,0,25,17
1745802497345,CLRE 250,A00,891860,Morris; Sheldon,9995,0,9999,4
1745802499396,CLRE 251R,A00,907817,Mehta; Ravindra L.,9994,0,9999,5
1745802500424,CLRE 252,A00,891864,Cuomo; Raphael Eduardo,9993,0,9999,6
1745802501451,CLRE 253,A00,891867,Vaida; Florin,9994,0,9999,5
1745802501451,CLRE 253,B00,907819,Staff,9999,0,9999,0
1745802502479,CLRE 259,A00,891868,Patel; Hemal,9998,0,9999,1
1745802503505,CLRE 260,A00,891872,Cuomo; Raphael Eduardo,9999,0,9999,0
1745802504530,CLRE 297,001,891888,Cuomo; Raphael Eduardo,9999,0,9999,0
1745802505557,CSE 191,A00,958773,Minnes Kemp; Mor Mia,9999,0,9999,0
1745802506581,CSS 201S,A01,892054,Mignozzetti; Umberto,30,0,30,0
1745802507608,CSS 202S,A01,892056,Mignozzetti; Umberto,30,0,30,0
1745802508636,DSC 197,001,956898,Eldridge; Justin Matthew,9998,0,9999,1
1745802509660,DSC 297,001,958000,Mazumdar; Arya,9998,0,9999,1
1745802510686,EAP 100,A00,905686,Staff,9776,0,9999,223
1745802511710,ECE 45,A01,892618,Staff,0,12,50,50
1745802512736,ECE 109,A01,892620,Staff,0,43,0,0
1745802513765,ECE 111,A01,892719,Staff,0,7,50,50
1745802514792,ECE 197,001,957920,Mercier; Patrick Philip,9992,0,9999,7
1745802515819,ECON 178,A01,907814,Zhu; Ying,28,0,35,7
1745802516847,EDS 115,A00,895312,Staff,41,0,45,4
1745802517875,EDS 117,A01,895337,Staff,30,0,30,0
1745802518903,EDS 125,A00,895341,Jones; Gabrielle Anastasia,43,0,45,2
1745802519931,EDS 128A,A01,895459,Fargason; Sharon Gayle,44,0,45,1
1745802520957,EDS 128B,A01,895543,Pappas; Elizabeth,44,0,45,1
1745802521986,EDS 139,A00,897203,Pappas; Elizabeth,44,0,45,1
1745802521986,EDS 139,B00,897209,Fargason; Sharon Gayle,44,0,45,1
1745802523016,EDS 201,A00,895545,Staff,43,0,45,2
1745802524043,EDS 203,A01,895581,Halter; Christopher P.,43,0,45,2
1745802525069,EDS 204R,A01,895625,Heinzman; Erica M.,43,0,45,2
1745802525069,EDS 204R,B01,895693,Halter; Christopher P.,18,0,45,27
1745802526099,EDS 206R,A00,895694,Fargason; Sharon Gayle,9,0,30,21
1745802526099,EDS 206R,B00,895695,Choi; Bailey Miyeon,20,0,30,10
1745802527125,EDS 250,A00,895697,Hemans; Patricia Ann Benitez,43,0,45,2
1745802528150,EDS 281,A00,895701,Meyerott; Theresa Ann,15,0,15,0
1745802529176,EDS 284,A00,895736,Meyerott; Theresa Ann,15,0,15,0
1745802530202,EDS 286,A00,897210,Fine; Sarah,15,0,15,0
1745802531228,EDS 289C,A01,895770,Daly; Alan J.,15,0,15,0
1745802532256,EDS 290,A00,897211,Hofstetter; Carolyn,15,0,15,0
1745802533283,LIGM 5A,A00,896162,Fischer-Grunski; Eva K,15,0,20,5
1745802534310,LIGM 5B,A00,896260,Fischer-Grunski; Eva K,17,0,20,3
1745802535340,LIGM 5C,A00,896308,Fischer-Grunski; Eva K,18,0,20,2
1745802536366,LIIT 5AS,A00,896313,Carnelos; Chiara,18,0,20,2
1745802537395,LIIT 5BS,A00,896416,Carnelos; Chiara,20,0,20,0
1745802538422,LIIT 5CS,A00,896564,Carnelos; Chiara,20,0,20,0
1745802539448,LISP 5A,A00,896588,Munoz Sanchez; Alicia,4,0,20,16
1745802540475,LISP 5B,A00,896653,Munoz Sanchez; Alicia,10,0,20,10
1745802541505,LISP 5C,A00,896655,Munoz Sanchez; Alicia,4,0,20,16
1745802542531,MAE 197,001,957918,Kleissl; Jan,9998,0,9999,1
1745802543557,MATH 2,A01,957937,Staff,34,0,35,1
1745802544581,MATH 197,001,957876,Kedlaya; Kiran S.,9993,0,9999,6
1745802545608,MCWP 40,A00,892729,Duru; Nur,13,0,20,7
1745802545608,MCWP 40,B00,893304,Montejo; Carolina,20,0,20,0
1745802546635,MCWP 40R,A00,893757,Redela; Pamela Morgan,0,6,20,20
1745802547660,MCWP 50,A00,893758,Morshed; Michael James,2,0,20,18
1745802547660,MCWP 50,B00,893761,Bartulis; Jason Michael,17,0,20,3
1745802548688,MCWP 50R,A00,893766,Compas; Sean Matthew,0,1,20,20
1745802548688,MCWP 50R,B00,893769,Carter; Jennifer A,0,0,20,20
1745802548688,MCWP 50R,C00,893771,Krone; Jarret,0,3,20,20
1745802548688,MCWP 50R,D00,893772,Miller; Elizabeth Deen,3,0,20,17
1745802548688,MCWP 50R,E00,893775,Carter; Andrea L,0,0,20,20
1745802549769,MMW 11R,A01,892721,Herbst; Matthew,11,0,27,16
1745802549769,MMW 11R,A02,892722,Herbst; Matthew,0,0,0,3
1745802550793,MMW 12R,A01,892724,Herbst; Matthew,0,9,16,16
1745802550793,MMW 12R,A02,892725,Herbst; Matthew,0,9,16,16
1745802551823,MMW 13R,A01,892727,Staff,0,4,16,16
1745802551823,MMW 13R,A02,892728,Staff,0,4,16,16
1745802551823,MMW 13R,A03,958032,Staff,0,3,16,16
1745802551823,MMW 13R,A04,958033,Staff,0,2,16,16
1745802551823,MMW 13R,A05,958034,Staff,0,3,16,16
1745802552853,SIO 295LS,A00,894015,Staff,7,0,25,18
1745802553879,SIO 295S,A00,894020,Staff,7,0,25,18
1745802554909,SIOC 290S,B01,958918,Staff,0,0,0,0
1745802555939,SIOC 291S,B01,958922,Staff,0,0,0,0
1745802556966,SOCI 117,A01,895339,Staff,4,0,5,1
1745802557994,WES 237B,A00,894149,Staff,11,0,20,9
1745802560049,AESE 279B,A00,891859,Staff,13,0,35,22
1745802561074,AIP 197,001,891854,Staff,70,0,70,0
1745802562104,ANTH 289S,A00,891856,Gagneux; Pascal,12,0,12,0
1745802563131,BENG 196,001,957946,Engler; Adam J.,9996,0,9999,3
1745802564160,CAT 124RS,A01,956906,Staff,8,0,25,17
1745802565185,CAT 125RS,A01,922013,Staff,8,0,25,17
1745802566212,CLRE 250,A00,891860,Morris; Sheldon,9995,0,9999,4
1745802568265,CLRE 251R,A00,907817,Mehta; Ravindra L.,9994,0,9999,5
1745802569290,CLRE 252,A00,891864,Cuomo; Raphael Eduardo,9993,0,9999,6
1745802570316,CLRE 253,A00,891867,Vaida; Florin,9994,0,9999,5
1745802570316,CLRE 253,B00,907819,Staff,9999,0,9999,0
1745802571343,CLRE 259,A00,891868,Patel; Hemal,9998,0,9999,1
1745802572372,CLRE 260,A00,891872,Cuomo; Raphael Eduardo,9999,0,9999,0
1745802573401,CLRE 297,001,891888,Cuomo; Raphael Eduardo,9999,0,9999,0
1745802574430,CSE 191,A00,958773,Minnes Kemp; Mor Mia,9999,0,9999,0
1745802575458,CSS 201S,A01,892054,Mignozzetti; Umberto,30,0,30,0
1745802576484,CSS 202S,A01,892056,Mignozzetti; Umberto,30,0,30,0
1745802577514,DSC 197,001,956898,Eldridge; Justin Matthew,9998,0,9999,1
1745802578540,DSC 297,001,958000,Mazumdar; Arya,9998,0,9999,1
1745802579567,EAP 100,A00,905686,Staff,9776,0,9999,223
1745802580591,ECE 45,A01,892618,Staff,0,12,50,50
1745802581618,ECE 109,A01,892620,Staff,0,43,0,0
1745802582644,ECE 111,A01,892719,Staff,0,7,50,50
1745802583668,ECE 197,001,957920,Mercier; Patrick Philip,9992,0,9999,7
1745802584695,ECON 178,A01,907814,Zhu; Ying,28,0,35,7
1745802585721,EDS 115,A00,895312,Staff,41,0,45,4
1745802586747,EDS 117,A01,895337,Staff,30,0,30,0
1745802587773,EDS 125,A00,895341,Jones; Gabrielle Anastasia,43,0,45,2
1745802588802,EDS 128A,A01,895459,Fargason; Sharon Gayle,44,0,45,1
1745802589828,EDS 128B,A01,895543,Pappas; Elizabeth,44,0,45,1
1745802590856,EDS 139,A00,897203,Pappas; Elizabeth,44,0,45,1
1745802590856,EDS 139,B00,897209,Fargason; Sharon Gayle,44,0,45,1
1745802591885,EDS 201,A00,895545,Staff,43,0,45,2
1745802592914,EDS 203,A01,895581,Halter; Christopher P.,43,0,45,2
1745802593940,EDS 204R,A01,895625,Heinzman; Erica M.,43,0,45,2
1745802593940,EDS 204R,B01,895693,Halter; Christopher P.,18,0,45,27
1745802594970,EDS 206R,A00,895694,Fargason; Sharon Gayle,9,0,30,21
1745802594970,EDS 206R,B00,895695,Choi; Bailey Miyeon,20,0,30,10
1745802595998,EDS 250,A00,895697,Hemans; Patricia Ann Benitez,43,0,45,2
1745802597027,EDS 281,A00,895701,Meyerott; Theresa Ann,15,0,15,0
1745802598056,EDS 284,A00,895736,Meyerott; Theresa Ann,15,0,15,0
1745802599081,EDS 286,A00,897210,Fine; Sarah,15,0,15,0
1745802600110,EDS 289C,A01,895770,Daly; Alan J.,15,0,15,0
1745802601137,EDS 290,A00,897211,Hofstetter; Carolyn,15,0,15,0
1745802602164,LIGM 5A,A00,896162,Fischer-Grunski; Eva K,15,0,20,5
1745802603191,LIGM 5B,A00,896260,Fischer-Grunski; Eva K,17,0,20,3
1745802604218,LIGM 5C,A00,896308,Fischer-Grunski; Eva K,18,0,20,2
1745802605246,LIIT 5AS,A00,896313,Carnelos; Chiara,18,0,20,2
1745802606277,LIIT 5BS,A00,896416,Carnelos; Chiara,20,0,20,0
1745802607302,LIIT 5CS,A00,896564,Carnelos; Chiara,20,0,20,0
1745802608328,LISP 5A,A00,896588,Munoz Sanchez; Alicia,4,0,20,16
1745802609358,LISP 5B,A00,896653,Munoz Sanchez; Alicia,10,0,20,10
1745802610384,LISP 5C,A00,896655,Munoz Sanchez; Alicia,4,0,20,16
1745802611410,MAE 197,001,957918,Kleissl; Jan,9998,0,9999,1
1745802612436,MATH 2,A01,957937,Staff,34,0,35,1
1745802613464,MATH 197,001,957876,Kedlaya; Kiran S.,9993,0,9999,6
1745802614493,MCWP 40,A00,892729,Duru; Nur,13,0,20,7
1745802614493,MCWP 40,B00,893304,Montejo; Carolina,20,0,20,0
1745802615520,MCWP 40R,A00,893757,Redela; Pamela Morgan,0,6,20,20
1745802616547,MCWP 50,A00,893758,Morshed; Michael James,2,0,20,18
1745802616547,MCWP 50,B00,893761,Bartulis; Jason Michael,17,0,20,3
1745802617577,MCWP 50R,A00,893766,Compas; Sean Matthew,0,1,20,20
1745802617577,MCWP 50R,B00,893769,Carter; Jennifer A,0,0,20,20
1745802617577,MCWP 50R,C00,893771,Krone; Jarret,0,3,20,20
1745802617577,MCWP 50R,D00,893772,Miller; Elizabeth Deen,3,0,20,17
1745802617577,MCWP 50R,E00,893775,Carter; Andrea L,0,0,20,20
1745802618603,MMW 11R,A01,892721,Herbst; Matthew,11,0,27,16
1745802618603,MMW 11R,A02,892722,Herbst; Matthew,0,0,0,3
1745802619629,MMW 12R,A01,892724,Herbst; Matthew,0,9,16,16
1745802619629,MMW 12R,A02,892725,Herbst; Matthew,0,9,16,16
1745802620655,MMW 13R,A01,892727,Staff,0,4,16,16
1745802620655,MMW 13R,A02,892728,Staff,0,4,16,16
1745802620655,MMW 13R,A03,958032,Staff,0,3,16,16
1745802620655,MMW 13R,A04,958033,Staff,0,2,16,16
1745802620655,MMW 13R,A05,958034,Staff,0,3,16,16
1745802621681,SIO 295LS,A00,894015,Staff,7,0,25,18
1745802622707,SIO 295S,A00,894020,Staff,7,0,25,18
1745802623739,SIOC 290S,B01,958918,Staff,0,0,0,0
1745802624766,SIOC 291S,B01,958922,Staff,0,0,0,0
1745802625794,SOCI 117,A01,895339,Staff,4,0,5,1
1745802626822,WES 237B,A00,894149,Staff,11,0,20,9
1745802628878,AESE 279B,A00,891859,Staff,13,0,35,22
1745802629903,AIP 197,001,891854,Staff,70,0,70,0
1745802630930,ANTH 289S,A00,891856,Gagneux; Pascal,12,0,12,0
1745802631958,BENG 196,001,957946,Engler; Adam J.,9996,0,9999,3
1745802632985,CAT 124RS,A01,956906,Staff,8,0,25,17
1745802634010,CAT 125RS,A01,922013,Staff,8,0,25,17
1745802635037,CLRE 250,A00,891860,Morris; Sheldon,9995,0,9999,4
1745802637091,CLRE 251R,A00,907817,Mehta; Ravindra L.,9994,0,9999,5
1745802638121,CLRE 252,A00,891864,Cuomo; Raphael Eduardo,9993,0,9999,6
1745802639145,CLRE 253,A00,891867,Vaida; Florin,9994,0,9999,5
1745802639145,CLRE 253,B00,907819,Staff,9999,0,9999,0
1745802640174,CLRE 259,A00,891868,Patel; Hemal,9998,0,9999,1
1745802641203,CLRE 260,A00,891872,Cuomo; Raphael Eduardo,9999,0,9999,0
1745802642232,CLRE 297,001,891888,Cuomo; Raphael Eduardo,9999,0,9999,0
1745802643259,CSE 191,A00,958773,Minnes Kemp; Mor Mia,9999,0,9999,0
1745802644286,CSS 201S,A01,892054,Mignozzetti; Umberto,30,0,30,0
1745802645314,CSS 202S,A01,892056,Mignozzetti; Umberto,30,0,30,0
1745802646340,DSC 197,001,956898,Eldridge; Justin Matthew,9998,0,9999,1
1745802647369,DSC 297,001,958000,Mazumdar; Arya,9998,0,9999,1
1745802648395,EAP 100,A00,905686,Staff,9776,0,9999,223
1745802649423,ECE 45,A01,892618,Staff,0,12,50,50
1745802650449,ECE 109,A01,892620,Staff,0,43,0,0
1745802651477,ECE 111,A01,892719,Staff,0,7,50,50
1745802652504,ECE 197,001,957920,Mercier; Patrick Philip,9992,0,9999,7
1745802653589,ECON 178,A01,907814,Zhu; Ying,28,0,35,7
1745802654617,EDS 115,A00,895312,Staff,41,0,45,4
1745802655641,EDS 117,A01,895337,Staff,30,0,30,0
1745802656667,EDS 125,A00,895341,Jones; Gabrielle Anastasia,43,0,45,2
1745802657691,EDS 128A,A01,895459,Fargason; Sharon Gayle,44,0,45,1
1745802658715,EDS 128B,A01,895543,Pappas; Elizabeth,44,0,45,1
1745802659740,EDS 139,A00,897203,Pappas; Elizabeth,44,0,45,1
1745802659740,EDS 139,B00,897209,Fargason; Sharon Gayle,44,0,45,1
1745802660766,EDS 201,A00,895545,Staff,43,0,45,2
1745802661795,EDS 203,A01,895581,Halter; Christopher P.,43,0,45,2
1745802662820,EDS 204R,A01,895625,Heinzman; Erica M.,43,0,45,2
1745802662820,EDS 204R,B01,895693,Halter; Christopher P.,18,0,45,27
1745802663848,EDS 206R,A00,895694,Fargason; Sharon Gayle,9,0,30,21
1745802663848,EDS 206R,B00,895695,Choi; Bailey Miyeon,20,0,30,10
1745802664873,EDS 250,A00,895697,Hemans; Patricia Ann Benitez,43,0,45,2
1745802665902,EDS 281,A00,895701,Meyerott; Theresa Ann,15,0,15,0
1745802666926,EDS 284,A00,895736,Meyerott; Theresa Ann,15,0,15,0
1745802667952,EDS 286,A00,897210,Fine; Sarah,15,0,15,0
1745802668977,EDS 289C,A01,895770,Daly; Alan J.,15,0,15,0
1745802670004,EDS 290,A00,897211,Hofstetter; Carolyn,15,0,15,0
1745802671032,LIGM 5A,A00,896162,Fischer-Grunski; Eva K,15,0,20,5
1745802672061,LIGM 5B,A00,896260,Fischer-Grunski; Eva K,17,0,20,3
1745802673087,LIGM 5C,A00,896308,Fischer-Grunski; Eva K,18,0,20,2
1745802674113,LIIT 5AS,A00,896313,Carnelos; Chiara,18,0,20,2
1745802675142,LIIT 5BS,A00,896416,Carnelos; Chiara,20,0,20,0
1745802676169,LIIT 5CS,A00,896564,Carnelos; Chiara,20,0,20,0
1745802677198,LISP 5A,A00,896588,Munoz Sanchez; Alicia,4,0,20,16
1745802678224,LISP 5B,A00,896653,Munoz Sanchez; Alicia,10,0,20,10
1745802679254,LISP 5C,A00,896655,Munoz Sanchez; Alicia,4,0,20,16
1745802680278,MAE 197,001,957918,Kleissl; Jan,9998,0,9999,1
1745802681305,MATH 2,A01,957937,Staff,34,0,35,1
1745802682332,MATH 197,001,957876,Kedlaya; Kiran S.,9993,0,9999,6
1745802683358,MCWP 40,A00,892729,Duru; Nur,13,0,20,7
1745802683358,MCWP 40,B00,893304,Montejo; Carolina,20,0,20,0
1745802684384,MCWP 40R,A00,893757,Redela; Pamela Morgan,0,6,20,20
1745802685414,MCWP 50,A00,893758,Morshed; Michael James,2,0,20,18
1745802685414,MCWP 50,B00,893761,Bartulis; Jason Michael,17,0,20,3
1745802686442,MCWP 50R,A00,893766,Compas; Sean Matthew,0,1,20,20
1745802686442,MCWP 50R,B00,893769,Carter; Jennifer A,0,0,20,20
1745802686442,MCWP 50R,C00,893771,Krone; Jarret,0,3,20,20
1745802686442,MCWP 50R,D00,893772,Miller; Elizabeth Deen,3,0,20,17
1745802686442,MCWP 50R,E00,893775,Carter; Andrea L,0,0,20,20
1745802687468,MMW 11R,A01,892721,Herbst; Matthew,11,0,27,16
1745802687468,MMW 11R,A02,892722,Herbst; Matthew,0,0,0,3
1745802688491,MMW 12R,A01,892724,Herbst; Matthew,0,9,16,16
1745802688491,MMW 12R,A02,892725,Herbst; Matthew,0,9,16,16
1745802689518,MMW 13R,A01,892727,Staff,0,4,16,16
1745802689518,MMW 13R,A02,892728,Staff,0,4,16,16
1745802689518,MMW 13R,A03,958032,Staff,0,3,16,16
1745802689518,MMW 13R,A04,958033,Staff,0,2,16,16
1745802689518,MMW 13R,A05,958034,Staff,0,3,16,16
1745802690547,SIO 295LS,A00,894015,Staff,7,0,25,18
1745802691576,SIO 295S,A00,894020,Staff,7,0,25,18
1745802692602,SIOC 290S,B01,958918,Staff,0,0,0,0
1745802693632,SIOC 291S,B01,958922,Staff,0,0,0,0
1745802694657,SOCI 117,A01,895339,Staff,4,0,5,1
1745802695683,WES 237B,A00,894149,Staff,11,0,20,9
1745802697747,AESE 279B,A00,891859,Staff,13,0,35,22
1745802698776,AIP 197,001,891854,Staff,70,0,70,0
1745802699805,ANTH 289S,A00,891856,Gagneux; Pascal,12,0,12,0
1745802700833,BENG 196,001,957946,Engler; Adam J.,9996,0,9999,3
1745802701857,CAT 124RS,A01,956906,Staff,8,0,25,17
1745802702883,CAT 125RS,A01,922013,Staff,8,0,25,17
1745802703908,CLRE 250,A00,891860,Morris; Sheldon,9995,0,9999,4
1745802705963,CLRE 251R,A00,907817,Mehta; Ravindra L.,9994,0,9999,5
1745802706991,CLRE 252,A00,891864,Cuomo; Raphael Eduardo,9993,0,9999,6
1745802708017,CLRE 253,A00,891867,Vaida; Florin,9994,0,9999,5
1745802708017,CLRE 253,B00,907819,Staff,9999,0,9999,0
1745802709045,CLRE 259,A00,891868,Patel; Hemal,9998,0,9999,1
1745802710072,CLRE 260,A00,891872,Cuomo; Raphael Eduardo,9999,0,9999,0
1745802711097,CLRE 297,001,891888,Cuomo; Raphael Eduardo,9999,0,9999,0
1745802712125,CSE 191,A00,958773,Minnes Kemp; Mor Mia,9999,0,9999,0
1745802713156,CSS 201S,A01,892054,Mignozzetti; Umberto,30,0,30,0
1745802714183,CSS 202S,A01,892056,Mignozzetti; Umberto,30,0,30,0
1745802715211,DSC 197,001,956898,Eldridge; Justin Matthew,9998,0,9999,1
1745802716236,DSC 297,001,958000,Mazumdar; Arya,9998,0,9999,1
1745802717261,EAP 100,A00,905686,Staff,9776,0,9999,223
1745802718288,ECE 45,A01,892618,Staff,0,12,50,50
1745802719314,ECE 109,A01,892620,Staff,0,43,0,0
1745802720340,ECE 111,A01,892719,Staff,0,7,50,50
1745802721367,ECE 197,001,957920,Mercier; Patrick Philip,9992,0,9999,7
1745802722395,ECON 178,A01,907814,Zhu; Ying,28,0,35,7
1745802723424,EDS 115,A00,895312,Staff,41,0,45,4
1745802724449,EDS 117,A01,895337,Staff,30,0,30,0
1745802725476,EDS 125,A00,895341,Jones; Gabrielle Anastasia,43,0,45,2
1745802726502,EDS 128A,A01,895459,Fargason; Sharon Gayle,44,0,45,1
1745802727527,EDS 128B,A01,895543,Pappas; Elizabeth,44,0,45,1
1745802728553,EDS 139,A00,897203,Pappas; Elizabeth,44,0,45,1
1745802728553,EDS 139,B00,897209,Fargason; Sharon Gayle,44,0,45,1
1745802729581,EDS 201,A00,895545,Staff,43,0,45,2
1745802730605,EDS 203,A01,895581,Halter; Christopher P.,43,0,45,2
1745802731630,EDS 204R,A01,895625,Heinzman; Erica M.,43,0,45,2
1745802731630,EDS 204R,B01,895693,Halter; Christopher P.,18,0,45,27
1745802732656,EDS 206R,A00,895694,Fargason; Sharon Gayle,9,0,30,21
1745802732656,EDS 206R,B00,895695,Choi; Bailey Miyeon,20,0,30,10
1745802733681,EDS 250,A00,895697,Hemans; Patricia Ann Benitez,43,0,45,2
1745802734708,EDS 281,A00,895701,Meyerott; Theresa Ann,15,0,15,0
1745802735733,EDS 284,A00,895736,Meyerott; Theresa Ann,15,0,15,0
1745802736758,EDS 286,A00,897210,Fine; Sarah,15,0,15,0
1745802737783,EDS 289C,A01,895770,Daly; Alan J.,15,0,15,0
1745802738807,EDS 290,A00,897211,Hofstetter; Carolyn,15,0,15,0
1745802739837,LIGM 5A,A00,896162,Fischer-Grunski; Eva K,15,0,20,5
1745802740863,LIGM 5B,A00,896260,Fischer-Grunski; Eva K,17,0,20,3
1745802741888,LIGM 5C,A00,896308,Fischer-Grunski; Eva K,18,0,20,2
1745802742948,LIIT 5AS,A00,896313,Carnelos; Chiara,18,0,20,2
1745802743974,LIIT 5BS,A00,896416,Carnelos; Chiara,20,0,20,0
1745802745000,LIIT 5CS,A00,896564,Carnelos; Chiara,20,0,20,0
1745802746028,LISP 5A,A00,896588,Munoz Sanchez; Alicia,4,0,20,16
1745802747054,LISP 5B,A00,896653,Munoz Sanchez; Alicia,10,0,20,10
1745802748079,LISP 5C,A00,896655,Munoz Sanchez; Alicia,4,0,20,16
1745802749108,MAE 197,001,957918,Kleissl; Jan,9998,0,9999,1
1745802750132,MATH 2,A01,957937,Staff,34,0,35,1
1745802751159,MATH 197,001,957876,Kedlaya; Kiran S.,9993,0,9999,6
1745802752190,MCWP 40,A00,892729,Duru; Nur,13,0,20,7
1745802752190,MCWP 40,B00,893304,Montejo; Carolina,20,0,20,0
1745802753218,MCWP 40R,A00,893757,Redela; Pamela Morgan,0,6,20,20
1745802754244,MCWP 50,A00,893758,Morshed; Michael James,2,0,20,18
1745802754244,MCWP 50,B00,893761,Bartulis; Jason Michael,17,0,20,3
1745802755273,MCWP 50R,A00,893766,Compas; Sean Matthew,0,1,20,20
1745802755273,MCWP 50R,B00,893769,Carter; Jennifer A,0,0,20,20
1745802755273,MCWP 50R,C00,893771,Krone; Jarret,0,3,20,20
1745802755273,MCWP 50R,D00,893772,Miller; Elizabeth Deen,3,0,20,17
1745802755273,MCWP 50R,E00,893775,Carter; Andrea L,0,0,20,20
1745802756299,MMW 11R,A01,892721,Herbst; Matthew,11,0,27,16
1745802756299,MMW 11R,A02,892722,Herbst; Matthew,0,0,0,3
1745802757366,MMW 12R,A01,892724,Herbst; Matthew,0,9,16,16
1745802757366,MMW 12R,A02,892725,Herbst; Matthew,0,9,16,16
1745802758397,MMW 13R,A01,892727,Staff,0,4,16,16
1745802758397,MMW 13R,A02,892728,Staff,0,4,16,16
1745802758397,MMW 13R,A03,958032,Staff,0,3,16,16
1745802758397,MMW 13R,A04,958033,Staff,0,2,16,16
1745802758397,MMW 13R,A05,958034,Staff,0,3,16,16
1745802759422,SIO 295LS,A00,894015,Staff,7,0,25,18
1745802760450,SIO 295S,A00,894020,Staff,7,0,25,18
1745802761476,SIOC 290S,B01,958918,Staff,0,0,0,0
1745802762503,SIOC 291S,B01,958922,Staff,0,0,0,0
1745802763528,SOCI 117,A01,895339,Staff,4,0,5,1
1745802764558,WES 237B,A00,894149,Staff,11,0,20,9
1745802766615,AESE 279B,A00,891859,Staff,13,0,35,22
1745802767641,AIP 197,001,891854,Staff,70,0,70,0
1745802768670,ANTH 289S,A00,891856,Gagneux; Pascal,12,0,12,0
1745802769698,BENG 196,001,957946,Engler; Adam J.,9996,0,9999,3
1745802770728,CAT 124RS,A01,956906,Staff,8,0,25,17
1745802771753,CAT 125RS,A01,922013,Staff,8,0,25,17
1745802772779,CLRE 250,A00,891860,Morris; Sheldon,9995,0,9999,4
1745802774831,CLRE 251R,A00,907817,Mehta; Ravindra L.,9994,0,9999,5
1745802775858,CLRE 252,A00,891864,Cuomo; Raphael Eduardo,9993,0,9999,6
1745802776883,CLRE 253,A00,891867,Vaida; Florin,9994,0,9999,5
1745802776883,CLRE 253,B00,907819,Staff,9999,0,9999,0
1745802777909,CLRE 259,A00,891868,Patel; Hemal,9998,0,9999,1
1745802778937,CLRE 260,A00,891872,Cuomo; Raphael Eduardo,9999,0,9999,0
1745802779964,CLRE 297,001,891888,Cuomo; Raphael Eduardo,9999,0,9999,0
1745802780991,CSE 191,A00,958773,Minnes Kemp; Mor Mia,9999,0,9999,0
1745802782018,CSS 201S,A01,892054,Mignozzetti; Umberto,30,0,30,0
1745802783043,CSS 202S,A01,892056,Mignozzetti; Umberto,30,0,30,0
1745802784072,DSC 197,001,956898,Eldridge; Justin Matthew,9998,0,9999,1
1745802785098,DSC 297,001,958000,Mazumdar; Arya,9998,0,9999,1
1745802786123,EAP 100,A00,905686,Staff,9776,0,9999,223
1745802787151,ECE 45,A01,892618,Staff,0,12,50,50
1745802788179,ECE 109,A01,892620,Staff,0,43,0,0
1745802789207,ECE 111,A01,892719,Staff,0,7,50,50
1745802790233,ECE 197,001,957920,Mercier; Patrick Philip,9992,0,9999,7
1745802791261,ECON 178,A01,907814,Zhu; Ying,28,0,35,7
1745802792290,EDS 115,A00,895312,Staff,41,0,45,4
1745802793315,EDS 117,A01,895337,Staff,30,0,30,0
1745802794343,EDS 125,A00,895341,Jones; Gabrielle Anastasia,43,0,45,2
1745802795369,EDS 128A,A01,895459,Fargason; Sharon Gayle,44,0,45,1
1745802796396,EDS 128B,A01,895543,Pappas; Elizabeth,44,0,45,1
1745802797425,EDS 139,A00,897203,Pappas; Elizabeth,44,0,45,1
1745802797425,EDS 139,B00,897209,Fargason; Sharon Gayle,44,0,45,1
1745802798450,EDS 201,A00,895545,Staff,43,0,45,2
1745802799478,EDS 203,A01,895581,Halter; Christopher P.,43,0,45,2
1745802800506,EDS 204R,A01,895625,Heinzman; Erica M.,43,0,45,2
1745802800506,EDS 204R,B01,895693,Halter; Christopher P.,18,0,45,27
1745802801531,EDS 206R,A00,895694,Fargason; Sharon Gayle,9,0,30,21
1745802801531,EDS 206R,B00,895695,Choi; Bailey Miyeon,20,0,30,10
1745802802555,EDS 250,A00,895697,Hemans; Patricia Ann Benitez,43,0,45,2
1745802803580,EDS 281,A00,895701,Meyerott; Theresa Ann,15,0,15,0
1745802804606,EDS 284,A00,895736,Meyerott; Theresa Ann,15,0,15,0
1745802805630,EDS 286,A00,897210,Fine; Sarah,15,0,15,0
1745802806654,EDS 289C,A01,895770,Daly; Alan J.,15,0,15,0
1745802807679,EDS 290,A00,897211,Hofstetter; Carolyn,15,0,15,0
1745802808706,LIGM 5A,A00,896162,Fischer-Grunski; Eva K,15,0,20,5
1745802809731,LIGM 5B,A00,896260,Fischer-Grunski; Eva K,17,0,20,3
1745802810759,LIGM 5C,A00,896308,Fischer-Grunski; Eva K,18,0,20,2
1745802811788,LIIT 5AS,A00,896313,Carnelos; Chiara,18,0,20,2
1745802812812,LIIT 5BS,A00,896416,Carnelos; Chiara,20,0,20,0
1745802813838,LIIT 5CS,A00,896564,Carnelos; Chiara,20,0,20,0
1745802814867,LISP 5A,A00,896588,Munoz Sanchez; Alicia,4,0,20,16
1745802815893,LISP 5B,A00,896653,Munoz Sanchez; Alicia,10,0,20,10
1745802816919,LISP 5C,A00,896655,Munoz Sanchez; Alicia,4,0,20,16
1745802817947,MAE 197,001,957918,Kleissl; Jan,9998,0,9999,1
1745802818974,MATH 2,A01,957937,Staff,34,0,35,1
1745802820004,MATH 197,001,957876,Kedlaya; Kiran S.,9993,0,9999,6
1745802821030,MCWP 40,A00,892729,Duru; Nur,13,0,20,7
1745802821030,MCWP 40,B00,893304,Montejo; Carolina,20,0,20,0
1745802822060,MCWP 40R,A00,893757,Redela; Pamela Morgan,0,6,20,20
1745802823088,MCWP 50,A00,893758,Morshed; Michael James,2,0,20,18
1745802823088,MCWP 50,B00,893761,Bartulis; Jason Michael,17,0,20,3
1745802824113,MCWP 50R,A00,893766,Compas; Sean Matthew,0,1,20,20
1745802824113,MCWP 50R,B00,893769,Carter; Jennifer A,0,0,20,20
1745802824113,MCWP 50R,C00,893771,Krone; Jarret,0,3,20,20
1745802824113,MCWP 50R,D00,893772,Miller; Elizabeth Deen,3,0,20,17
1745802824113,MCWP 50R,E00,893775,Carter; Andrea L,0,0,20,20
1745802825140,MMW 11R,A01,892721,Herbst; Matthew,11,0,27,16
1745802825140,MMW 11R,A02,892722,Herbst; Matthew,0,0,0,3
1745802826167,MMW 12R,A01,892724,Herbst; Matthew,0,9,16,16
1745802826167,MMW 12R,A02,892725,Herbst; Matthew,0,9,16,16
1745802827227,MMW 13R,A01,892727,Staff,0,4,16,16
1745802827227,MMW 13R,A02,892728,Staff,0,4,16,16
1745802827227,MMW 13R,A03,958032,Staff,0,3,16,16
1745802827227,MMW 13R,A04,958033,Staff,0,2,16,16
1745802827227,MMW 13R,A05,958034,Staff,0,3,16,16
1745802828255,SIO 295LS,A00,894015,Staff,7,0,25,18
1745802829284,SIO 295S,A00,894020,Staff,7,0,25,18
1745802830310,SIOC 290S,B01,958918,Staff,0,0,0,0
1745802831340,SIOC 291S,B01,958922,Staff,0,0,0,0
1745802832367,SOCI 117,A01,895339,Staff,4,0,5,1
1745802833393,WES 237B,A00,894149,Staff,11,0,20,9
1745802835447,AESE 279B,A00,891859,Staff,13,0,35,22
1745802836475,AIP 197,001,891854,Staff,70,0,70,0
1745802837504,ANTH 289S,A00,891856,Gagneux; Pascal,12,0,12,0
1745802838529,BENG 196,001,957946,Engler; Adam J.,9996,0,9999,3
1745802839554,CAT 124RS,A01,956906,Staff,8,0,25,17
1745802840580,CAT 125RS,A01,922013,Staff,8,0,25,17
1745802841607,CLRE 250,A00,891860,Morris; Sheldon,9995,0,9999,4
1745802843660,CLRE 251R,A00,907817,Mehta; Ravindra L.,9994,0,9999,5
1745802844689,CLRE 252,A00,891864,Cuomo; Raphael Eduardo,9993,0,9999,6
1745802845715,CLRE 253,A00,891867,Vaida; Florin,9994,0,9999,5
1745802845715,CLRE 253,B00,907819,Staff,9999,0,9999,0
1745802846739,CLRE 259,A00,891868,Patel; Hemal,9998,0,9999,1
1745802847762,CLRE 260,A00,891872,Cuomo; Raphael Eduardo,9999,0,9999,0
1745802848786,CLRE 297,001,891888,Cuomo; Raphael Eduardo,9999,0,9999,0
1745802849813,CSE 191,A00,958773,Minnes Kemp; Mor Mia,9999,0,9999,0
1745802850838,CSS 201S,A01,892054,Mignozzetti; Umberto,30,0,30,0
1745802851865,CSS 202S,A01,892056,Mignozzetti; Umberto,30,0,30,0
1745802852894,DSC 197,001,956898,Eldridge; Justin Matthew,9998,0,9999,1
1745802853921,DSC 297,001,958000,Mazumdar; Arya,9998,0,9999,1
1745802854945,EAP 100,A00,905686,Staff,9776,0,9999,223
1745802855971,ECE 45,A01,892618,Staff,0,12,50,50
1745802856999,ECE 109,A01,892620,Staff,0,43,0,0
1745802858027,ECE 111,A01,892719,Staff,0,7,50,50
1745802859057,ECE 197,001,957920,Mercier; Patrick Philip,9992,0,9999,7
1745802860083,ECON 178,A01,907814,Zhu; Ying,28,0,35,7
1745802861109,EDS 115,A00,895312,Staff,41,0,45,4
1745802862137,EDS 117,A01,895337,Staff,30,0,30,0
1745802863166,EDS 125,A00,895341,Jones; Gabrielle Anastasia,43,0,45,2
1745802864193,EDS 128A,A01,895459,Fargason; Sharon Gayle,44,0,45,1
1745802865218,EDS 128B,A01,895543,Pappas; Elizabeth,44,0,45,1
1745802866248,EDS 139,A00,897203,Pappas; Elizabeth,44,0,45,1
1745802866248,EDS 139,B00,897209,Fargason; Sharon Gayle,44,0,45,1
1745802867275,EDS 201,A00,895545,Staff,43,0,45,2
1745802868300,EDS 203,A01,895581,Halter; Christopher P.,43,0,45,2
1745802869327,EDS 204R,A01,895625,Heinzman; Erica M.,43,0,45,2
1745802869327,EDS 204R,B01,895693,Halter; Christopher P.,18,0,45,27
1745802870353,EDS 206R,A00,895694,Fargason; Sharon Gayle,9,0,30,21
1745802870353,EDS 206R,B00,895695,Choi; Bailey Miyeon,20,0,30,10
1745802871379,EDS 250,A00,895697,Hemans; Patricia Ann Benitez,43,0,45,2
1745802872406,EDS 281,A00,895701,Meyerott; Theresa Ann,15,0,15,0
1745802873432,EDS 284,A00,895736,Meyerott; Theresa Ann,15,0,15,0
1745802874455,EDS 286,A00,897210,Fine; Sarah,15,0,15,0
1745802875484,EDS 289C,A01,895770,Daly; Alan J.,15,0,15,0
1745802876510,EDS 290,A00,897211,Hofstetter; Carolyn,15,0,15,0
1745802877537,LIGM 5A,A00,896162,Fischer-Grunski; Eva K,15,0,20,5
1745802878621,LIGM 5B,A00,896260,Fischer-Grunski; Eva K,17,0,20,3
1745802879649,LIGM 5C,A00,896308,Fischer-Grunski; Eva K,18,0,20,2
1745802880677,LIIT 5AS,A00,896313,Carnelos; Chiara,18,0,20,2
1745802881702,LIIT 5BS,A00,896416,Carnelos; Chiara,20,0,20,0
1745802882732,LIIT 5CS,A00,896564,Carnelos; Chiara,20,0,20,0
1745802883758,LISP 5A,A00,896588,Munoz Sanchez; Alicia,4,0,20,16
1745802884784,LISP 5B,A00,896653,Munoz Sanchez; Alicia,10,0,20,10
1745802885812,LISP 5C,A00,896655,Munoz Sanchez; Alicia,4,0,20,16
1745802886842,MAE 197,001,957918,Kleissl; Jan,9998,0,9999,1
1745802887870,MATH 2,A01,957937,Staff,34,0,35,1
1745802888896,MATH 197,001,957876,Kedlaya; Kiran S.,9993,0,9999,6
1745802889921,MCWP 40,A00,892729,Duru; Nur,13,0,20,7
1745802889921,MCWP 40,B00,893304,Montejo; Carolina,20,0,20,0
1745802890947,MCWP 40R,A00,893757,Redela; Pamela Morgan,0,6,20,20
1745802891975,MCWP 50,A00,893758,Morshed; Michael James,2,0,20,18
1745802891975,MCWP 50,B00,893761,Bartulis; Jason Michael,17,0,20,3
1745802893002,MCWP 50R,A00,893766,Compas; Sean Matthew,0,1,20,20
1745802893002,MCWP 50R,B00,893769,Carter; Jennifer A,0,0,20,20
1745802893002,MCWP 50R,C00,893771,Krone; Jarret,0,3,20,20
1745802893002,MCWP 50R,D00,893772,Miller; Elizabeth Deen,3,0,20,17
1745802893002,MCWP 50R,E00,893775,Carter; Andrea L,0,0,20,20
1745802894027,MMW 11R,A01,892721,Herbst; Matthew,11,0,27,16
1745802894027,MMW 11R,A02,892722,Herbst; Matthew,0,0,0,3
1745802895056,MMW 12R,A01,892724,Herbst; Matthew,0,9,16,16
1745802895056,MMW 12R,A02,892725,Herbst; Matthew,0,9,16,16
1745802896083,MMW 13R,A01,892727,Staff,0,4,16,16
1745802896083,MMW 13R,A02,892728,Staff,0,4,16,16
1745802896083,MMW 13R,A03,958032,Staff,0,3,16,16
1745802896083,MMW 13R,A04,958033,Staff,0,2,16,16
1745802896083,MMW 13R,A05,958034,Staff,0,3,16,16
1745802897112,SIO 295LS,A00,894015,Staff,7,0,25,18
1745802898139,SIO 295S,A00,894020,Staff,7,0,25,18
1745802899165,SIOC 290S,B01,958918,Staff,0,0,0,0
1745802900195,SIOC 291S,B01,958922,Staff,0,0,0,0
1745802901225,SOCI 117,A01,895339,Staff,4,0,5,1
1745802902250,WES 237B,A00,894149,Staff,11,0,20,9
1745802904318,AESE 279B,A00,891859,Staff,13,0,35,22
1745802905344,AIP 197,001,891854,Staff,70,0,70,0
1745802906370,ANTH 289S,A00,891856,Gagneux; Pascal,12,0,12,0
1745802907396,BENG 196,001,957946,Engler; Adam J.,9996,0,9999,3
1745802908426,CAT 124RS,A01,956906,Staff,8,0,25,17
1745802909451,CAT 125RS,A01,922013,Staff,8,0,25,17
1745802910480,CLRE 250,A00,891860,Morris; Sheldon,9995,0,9999,4
1745802912535,CLRE 251R,A00,907817,Mehta; Ravindra L.,9994,0,9999,5
1745802913562,CLRE 252,A00,891864,Cuomo; Raphael Eduardo,9993,0,9999,6
1745802914589,CLRE 253,A00,891867,Vaida; Florin,9994,0,9999,5
1745802914589,CLRE 253,B00,907819,Staff,9999,0,9999,0
1745802915616,CLRE 259,A00,891868,Patel; Hemal,9998,0,9999,1
1745802916641,CLRE 260,A00,891872,Cuomo; Raphael Eduardo,9999,0,9999,0
1745802917668,CLRE 297,001,891888,Cuomo; Raphael Eduardo,9999,0,9999,0
1745802918696,CSE 191,A00,958773,Minnes Kemp; Mor Mia,9999,0,9999,0
1745802919724,CSS 201S,A01,892054,Mignozzetti; Umberto,30,0,30,0
1745802920751,CSS 202S,A01,892056,Mignozzetti; Umberto,30,0,30,0
1745802921780,DSC 197,001,956898,Eldridge; Justin Matthew,9998,0,9999,1
1745802922805,DSC 297,001,958000,Mazumdar; Arya,9998,0,9999,1
1745802923834,EAP 100,A00,905686,Staff,9776,0,9999,223
1745802924859,ECE 45,A01,892618,Staff,0,12,50,50
1745802925884,ECE 109,A01,892620,Staff,0,43,0,0
1745802926915,ECE 111,A01,892719,Staff,0,7,50,50
1745802927942,ECE 197,001,957920,Mercier; Patrick Philip,9992,0,9999,7
1745802928969,ECON 178,A01,907814,Zhu; Ying,28,0,35,7
1745802929997,EDS 115,A00,895312,Staff,41,0,45,4
1745802931024,EDS 117,A01,895337,Staff,30,0,30,0
1745802932049,EDS 125,A00,895341,Jones; Gabrielle Anastasia,43,0,45,2
1745802933075,EDS 128A,A01,895459,Fargason; Sharon Gayle,44,0,45,1
1745802934099,EDS 128B,A01,895543,Pappas; Elizabeth,44,0,45,1
1745802935125,EDS 139,A00,897203,Pappas; Elizabeth,44,0,45,1
1745802935125,EDS 139,B00,897209,Fargason; Sharon Gayle,44,0,45,1
1745802936150,EDS 201,A00,895545,Staff,43,0,45,2
1745802937178,EDS 203,A01,895581,Halter; Christopher P.,43,0,45,2
1745802938205,EDS 204R,A01,895625,Heinzman; Erica M.,43,0,45,2
1745802938205,EDS 204R,B01,895693,Halter; Christopher P.,18,0,45,27
1745802939233,EDS 206R,A00,895694,Fargason; Sharon Gayle,9,0,30,21
1745802939233,EDS 206R,B00,895695,Choi; Bailey Miyeon,20,0,30,10
1745802940259,EDS 250,A00,895697,Hemans; Patricia Ann Benitez,43,0,45,2
1745802941287,EDS 281,A00,895701,Meyerott; Theresa Ann,15,0,15,0
1745802942315,EDS 284,A00,895736,Meyerott; Theresa Ann,15,0,15,0
1745802943340,EDS 286,A00,897210,Fine; Sarah,15,0,15,0
1745802944367,EDS 289C,A01,895770,Daly; Alan J.,15,0,15,0
1745802945393,EDS 290,A00,897211,Hofstetter; Carolyn,15,0,15,0
1745802946419,LIGM 5A,A00,896162,Fischer-Grunski; Eva K,15,0,20,5
1745802947446,LIGM 5B,A00,896260,Fischer-Grunski; Eva K,17,0,20,3
1745802948473,LIGM 5C,A00,896308,Fischer-Grunski; Eva K,18,0,20,2
1745802949500,LIIT 5AS,A00,896313,Carnelos; Chiara,18,0,20,2
1745802950528,LIIT 5BS,A00,896416,Carnelos; Chiara,20,0,20,0
1745802951553,LIIT 5CS,A00,896564,Carnelos; Chiara,20,0,20,0
1745802952577,LISP 5A,A00,896588,Munoz Sanchez; Alicia,4,0,20,16
1745802953603,LISP 5B,A00,896653,Munoz Sanchez; Alicia,10,0,20,10
1745802954629,LISP 5C,A00,896655,Munoz Sanchez; Alicia,4,0,20,16
1745802955656,MAE 197,001,957918,Kleissl; Jan,9998,0,9999,1
1745802956682,MATH 2,A01,957937,Staff,34,0,35,1
1745802957707,MATH 197,001,957876,Kedlaya; Kiran S.,9993,0,9999,6
1745802958735,MCWP 40,A00,892729,Duru; Nur,13,0,20,7
1745802958735,MCWP 40,B00,893304,Montejo; Carolina,20,0,20,0
1745802959762,MCWP 40R,A00,893757,Redela; Pamela Morgan,0,6,20,20
1745802960788,MCWP 50,A00,893758,Morshed; Michael James,2,0,20,18
1745802960788,MCWP 50,B00,893761,Bartulis; Jason Michael,17,0,20,3
1745802961816,MCWP 50R,A00,893766,Compas; Sean Matthew,0,1,20,20
1745802961816,MCWP 50R,B00,893769,Carter; Jennifer A,0,0,20,20
1745802961816,MCWP 50R,C00,893771,Krone; Jarret,0,3,20,20
1745802961816,MCWP 50R,D00,893772,Miller; Elizabeth Deen,3,0,20,17
1745802961816,MCWP 50R,E00,893775,Carter; Andrea L,0,0,20,20
1745802962845,MMW 11R,A01,892721,Herbst; Matthew,11,0,27,16
1745802962845,MMW 11R,A02,892722,Herbst; Matthew,0,0,0,3
1745802963871,MMW 12R,A01,892724,Herbst; Matthew,0,9,16,16
1745802963871,MMW 12R,A02,892725,Herbst; Matthew,0,9,16,16
1745802964901,MMW 13R,A01,892727,Staff,0,4,16,16
1745802964901,MMW 13R,A02,892728,Staff,0,4,16,16
1745802964901,MMW 13R,A03,958032,Staff,0,3,16,16
1745802964901,MMW 13R,A04,958033,Staff,0,2,16,16
1745802964901,MMW 13R,A05,958034,Staff,0,3,16,16
1745802965929,SIO 295LS,A00,894015,Staff,7,0,25,18
1745802966954,SIO 295S,A00,894020,Staff,7,0,25,18
1745802967981,SIOC 290S,B01,958918,Staff,0,0,0,0
1745802969010,SIOC 291S,B01,958922,Staff,0,0,0,0
1745802970041,SOCI 117,A01,895339,Staff,4,0,5,1
1745802971066,WES 237B,A00,894149,Staff,11,0,20,9
1745802973130,AESE 279B,A00,891859,Staff,13,0,35,22
1745802974156,AIP 197,001,891854,Staff,70,0,70,0
1745802975183,ANTH 289S,A00,891856,Gagneux; Pascal,12,0,12,0
1745802976207,BENG 196,001,957946,Engler; Adam J.,9996,0,9999,3
1745802977234,CAT 124RS,A01,956906,Staff,8,0,25,17
1745802978260,CAT 125RS,A01,922013,Staff,8,0,25,17
1745802979288,CLRE 250,A00,891860,Morris; Sheldon,9995,0,9999,4
1745802981344,CLRE 251R,A00,907817,Mehta; Ravindra L.,9994,0,9999,5
1745802982409,CLRE 252,A00,891864,Cuomo; Raphael Eduardo,9993,0,9999,6
1745802983434,CLRE 253,A00,891867,Vaida; Florin,9994,0,9999,5
1745802983434,CLRE 253,B00,907819,Staff,9999,0,9999,0
1745802984460,CLRE 259,A00,891868,Patel; Hemal,9998,0,9999,1
1745802985483,CLRE 260,A00,891872,Cuomo; Raphael Eduardo,9999,0,9999,0
1745802986509,CLRE 297,001,891888,Cuomo; Raphael Eduardo,9999,0,9999,0
1745802987537,CSE 191,A00,958773,Minnes Kemp; Mor Mia,9999,0,9999,0
1745802988561,CSS 201S,A01,892054,Mignozzetti; Umberto,30,0,30,0
1745802989588,CSS 202S,A01,892056,Mignozzetti; Umberto,30,0,30,0
1745802990614,DSC 197,001,956898,Eldridge; Justin Matthew,9998,0,9999,1
1745802991642,DSC 297,001,958000,Mazumdar; Arya,9998,0,9999,1
1745802992667,EAP 100,A00,905686,Staff,9776,0,9999,223
1745802993691,ECE 45,A01,892618,Staff,0,12,50,50
1745802994718,ECE 109,A01,892620,Staff,0,43,0,0
1745802995745,ECE 111,A01,892719,Staff,0,7,50,50
1745802996771,ECE 197,001,957920,Mercier; Patrick Philip,9992,0,9999,7
1745802997796,ECON 178,A01,907814,Zhu; Ying,28,0,35,7
1745802998825,EDS 115,A00,895312,Staff,41,0,45,4
1745802999853,EDS 117,A01,895337,Staff,30,0,30,0
1745803000879,EDS 125,A00,895341,Jones; Gabrielle Anastasia,43,0,45,2
1745803001907,EDS 128A,A01,895459,Fargason; Sharon Gayle,44,0,45,1
1745803002934,EDS 128B,A01,895543,Pappas; Elizabeth,44,0,45,1
1745803003959,EDS 139,A00,897203,Pappas; Elizabeth,44,0,45,1
1745803003959,EDS 139,B00,897209,Fargason; Sharon Gayle,44,0,45,1
1745803004985,EDS 201,A00,895545,Staff,43,0,45,2
1745803006010,EDS 203,A01,895581,Halter; Christopher P.,43,0,45,2
1745803007037,EDS 204R,A01,895625,Heinzman; Erica M.,43,0,45,2
1745803007037,EDS 204R,B01,895693,Halter; Christopher P.,18,0,45,27
1745803008065,EDS 206R,A00,895694,Fargason; Sharon Gayle,9,0,30,21
1745803008065,EDS 206R,B00,895695,Choi; Bailey Miyeon,20,0,30,10
1745803009092,EDS 250,A00,895697,Hemans; Patricia Ann Benitez,43,0,45,2
1745803010118,EDS 281,A00,895701,Meyerott; Theresa Ann,15,0,15,0
1745803011143,EDS 284,A00,895736,Meyerott; Theresa Ann,15,0,15,0
1745803012169,EDS 286,A00,897210,Fine; Sarah,15,0,15,0
1745803013195,EDS 289C,A01,895770,Daly; Alan J.,15,0,15,0
1745803014220,EDS 290,A00,897211,Hofstetter; Carolyn,15,0,15,0
1745803015250,LIGM 5A,A00,896162,Fischer-Grunski; Eva K,15,0,20,5
1745803016275,LIGM 5B,A00,896260,Fischer-Grunski; Eva K,17,0,20,3
1745803017300,LIGM 5C,A00,896308,Fischer-Grunski; Eva K,18,0,20,2
1745803018326,LIIT 5AS,A00,896313,Carnelos; Chiara,18,0,20,2
1745803019352,LIIT 5BS,A00,896416,Carnelos; Chiara,20,0,20,0
1745803020378,LIIT 5CS,A00,896564,Carnelos; Chiara,20,0,20,0
1745803021407,LISP 5A,A00,896588,Munoz Sanchez; Alicia,4,0,20,16
1745803022433,LISP 5B,A00,896653,Munoz Sanchez; Alicia,10,0,20,10
1745803023458,LISP 5C,A00,896655,Munoz Sanchez; Alicia,4,0,20,16
1745803024482,MAE 197,001,957918,Kleissl; Jan,9998,0,9999,1
1745803025507,MATH 2,A01,957937,Staff,34,0,35,1
1745803026533,MATH 197,001,957876,Kedlaya; Kiran S.,9993,0,9999,6
1745803027558,MCWP 40,A00,892729,Duru; Nur,13,0,20,7
1745803027558,MCWP 40,B00,893304,Montejo; Carolina,20,0,20,0
1745803028585,MCWP 40R,A00,893757,Redela; Pamela Morgan,0,6,20,20
1745803029612,MCWP 50,A00,893758,Morshed; Michael James,2,0,20,18
1745803029612,MCWP 50,B00,893761,Bartulis; Jason Michael,17,0,20,3
1745803030639,MCWP 50R,A00,893766,Compas; Sean Matthew,0,1,20,20
1745803030639,MCWP 50R,B00,893769,Carter; Jennifer A,0,0,20,20
1745803030639,MCWP 50R,C00,893771,Krone; Jarret,0,3,20,20
1745803030639,MCWP 50R,D00,893772,Miller; Elizabeth Deen,3,0,20,17
1745803030639,MCWP 50R,E00,893775,Carter; Andrea L,0,0,20,20
1745803031668,MMW 11R,A01,892721,Herbst; Matthew,11,0,27,16
1745803031668,MMW 11R,A02,892722,Herbst; Matthew,0,0,0,3
1745803032694,MMW 12R,A01,892724,Herbst; Matthew,0,9,16,16
1745803032694,MMW 12R,A02,892725,Herbst; Matthew,0,9,16,16
1745803033723,MMW 13R,A01,892727,Staff,0,4,16,16
1745803033723,MMW 13R,A02,892728,Staff,0,4,16,16
1745803033723,MMW 13R,A03,958032,Staff,0,3,16,16
1745803033723,MMW 13R,A04,958033,Staff,0,2,16,16
1745803033723,MMW 13R,A05,958034,Staff,0,3,16,16
1745803034753,SIO 295LS,A00,894015,Staff,7,0,25,18
1745803035778,SIO 295S,A00,894020,Staff,7,0,25,18
1745803036807,SIOC 290S,B01,958918,Staff,0,0,0,0
1745803037837,SIOC 291S,B01,958922,Staff,0,0,0,0
1745803038863,SOCI 117,A01,895339,Staff,4,0,5,1
1745803039889,WES 237B,A00,894149,Staff,11,0,20,9
1745803041962,AESE 279B,A00,891859,Staff,13,0,35,22
1745803042990,AIP 197,001,891854,Staff,70,0,70,0
1745803044016,ANTH 289S,A00,891856,Gagneux; Pascal,12,0,12,0
1745803045045,BENG 196,001,957946,Engler; Adam J.,9996,0,9999,3
1745803046072,CAT 124RS,A01,956906,Staff,8,0,25,17
1745803047098,CAT 125RS,A01,922013,Staff,8,0,25,17
1745803048124,CLRE 250,A00,891860,Morris; Sheldon,9995,0,9999,4
1745803050175,CLRE 251R,A00,907817,Mehta; Ravindra L.,9994,0,9999,5
1745803051203,CLRE 252,A00,891864,Cuomo; Raphael Eduardo,9993,0,9999,6
1745803052232,CLRE 253,A00,891867,Vaida; Florin,9994,0,9999,5
1745803052232,CLRE 253,B00,907819,Staff,9999,0,9999,0
1745803053257,CLRE 259,A00,891868,Patel; Hemal,9998,0,9999,1
1745803054282,CLRE 260,A00,891872,Cuomo; Raphael Eduardo,9999,0,9999,0
1745803055308,CLRE 297,001,891888,Cuomo; Raphael Eduardo,9999,0,9999,0
1745803056335,CSE 191,A00,958773,Minnes Kemp; Mor Mia,9999,0,9999,0
1745803057360,CSS 201S,A01,892054,Mignozzetti; Umberto,30,0,30,0
1745803058389,CSS 202S,A01,892056,Mignozzetti; Umberto,30,0,30,0
1745803059416,DSC 197,001,956898,Eldridge; Justin Matthew,9998,0,9999,1
1745803060441,DSC 297,001,958000,Mazumdar; Arya,9998,0,9999,1
1745803061467,EAP 100,A00,905686,Staff,9776,0,9999,223
1745803062495,ECE 45,A01,892618,Staff,0,12,50,50
1745803063521,ECE 109,A01,892620,Staff,0,43,0,0
1745803064549,ECE 111,A01,892719,Staff,0,7,50,50
1745803065579,ECE 197,001,957920,Mercier; Patrick Philip,9992,0,9999,7
1745803066606,ECON 178,A01,907814,Zhu; Ying,28,0,35,7
1745803067631,EDS 115,A00,895312,Staff,41,0,45,4
1745803068659,EDS 117,A01,895337,Staff,30,0,30,0
1745803069685,EDS 125,A00,895341,Jones; Gabrielle Anastasia,43,0,45,2
1745803070711,EDS 128A,A01,895459,Fargason; Sharon Gayle,44,0,45,1
1745803071739,EDS 128B,A01,895543,Pappas; Elizabeth,44,0,45,1
1745803072767,EDS 139,A00,897203,Pappas; Elizabeth,44,0,45,1
1745803072767,EDS 139,B00,897209,Fargason; Sharon Gayle,44,0,45,1
1745803073793,EDS 201,A00,895545,Staff,43,0,45,2
1745803074822,EDS 203,A01,895581,Halter; Christopher P.,43,0,45,2
1745803075851,EDS 204R,A01,895625,Heinzman; Erica M.,43,0,45,2
1745803075851,EDS 204R,B01,895693,Halter; Christopher P.,18,0,45,27
1745803076877,EDS 206R,A00,895694,Fargason; Sharon Gayle,9,0,30,21
1745803076877,EDS 206R,B00,895695,Choi; Bailey Miyeon,20,0,30,10
1745803077903,EDS 250,A00,895697,Hemans; Patricia Ann Benitez,43,0,45,2
1745803078931,EDS 281,A00,895701,Meyerott; Theresa Ann,15,0,15,0
1745803079958,EDS 284,A00,895736,Meyerott; Theresa Ann,15,0,15,0
1745803080987,EDS 286,A00,897210,Fine; Sarah,15,0,15,0
1745803082016,EDS 289C,A01,895770,Daly; Alan J.,15,0,15,0
1745803083044,EDS 290,A00,897211,Hofstetter; Carolyn,15,0,15,0
1745803084073,LIGM 5A,A00,896162,Fischer-Grunski; Eva K,15,0,20,5
1745803085102,LIGM 5B,A00,896260,Fischer-Grunski; Eva K,17,0,20,3
1745803086186,LIGM 5C,A00,896308,Fischer-Grunski; Eva K,18,0,20,2
1745803087214,LIIT 5AS,A00,896313,Carnelos; Chiara,18,0,20,2
1745803088241,LIIT 5BS,A00,896416,Carnelos; Chiara,20,0,20,0
1745803089267,LIIT 5CS,A00,896564,Carnelos; Chiara,20,0,20,0
1745803090296,LISP 5A,A00,896588,Munoz Sanchez; Alicia,4,0,20,16
1745803091325,LISP 5B,A00,896653,Munoz Sanchez; Alicia,10,0,20,10
1745803092352,LISP 5C,A00,896655,Munoz Sanchez; Alicia,4,0,20,16
1745803093379,MAE 197,001,957918,Kleissl; Jan,9998,0,9999,1
1745803094405,MATH 2,A01,957937,Staff,34,0,35,1
1745803095433,MATH 197,001,957876,Kedlaya; Kiran S.,9993,0,9999,6
1745803096463,MCWP 40,A00,892729,Duru; Nur,13,0,20,7
1745803096463,MCWP 40,B00,893304,Montejo; Carolina,20,0,20,0
1745803097491,MCWP 40R,A00,893757,Redela; Pamela Morgan,0,6,20,20
1745803098520,MCWP 50,A00,893758,Morshed; Michael James,2,0,20,18
1745803098520,MCWP 50,B00,893761,Bartulis; Jason Michael,17,0,20,3
1745803099549,MCWP 50R,A00,893766,Compas; Sean Matthew,0,1,20,20
1745803099549,MCWP 50R,B00,893769,Carter; Jennifer A,0,0,20,20
1745803099549,MCWP 50R,C00,893771,Krone; Jarret,0,3,20,20
1745803099549,MCWP 50R,D00,893772,Miller; Elizabeth Deen,3,0,20,17
1745803099549,MCWP 50R,E00,893775,Carter; Andrea L,0,0,20,20
1745803100579,MMW 11R,A01,892721,Herbst; Matthew,11,0,27,16
1745803100579,MMW 11R,A02,892722,Herbst; Matthew,0,0,0,3
1745803101604,MMW 12R,A01,892724,Herbst; Matthew,0,9,16,16
1745803101604,MMW 12R,A02,892725,Herbst; Matthew,0,9,16,16
1745803102630,MMW 13R,A01,892727,Staff,0,4,16,16
1745803102630,MMW 13R,A02,892728,Staff,0,4,16,16
1745803102630,MMW 13R,A03,958032,Staff,0,3,16,16
1745803102630,MMW 13R,A04,958033,Staff,0,2,16,16
1745803102630,MMW 13R,A05,958034,Staff,0,3,16,16
1745803103655,SIO 295LS,A00,894015,Staff,7,0,25,18
1745803104684,SIO 295S,A00,894020,Staff,7,0,25,18
1745803105710,SIOC 290S,B01,958918,Staff,0,0,0,0
1745803106741,SIOC 291S,B01,958922,Staff,0,0,0,0
1745803107767,SOCI 117,A01,895339,Staff,4,0,5,1
1745803108793,WES 237B,A00,894149,Staff,11,0,20,9
1745803110861,AESE 279B,A00,891859,Staff,13,0,35,22
1745803111887,AIP 197,001,891854,Staff,70,0,70,0
1745803112914,ANTH 289S,A00,891856,Gagneux; Pascal,12,0,12,0
1745803113940,BENG 196,001,957946,Engler; Adam J.,9996,0,9999,3
1745803114968,CAT 124RS,A01,956906,Staff,8,0,25,17
1745803115997,CAT 125RS,A01,922013,Staff,8,0,25,17
1745803117025,CLRE 250,A00,891860,Morris; Sheldon,9995,0,9999,4
1745803119079,CLRE 251R,A00,907817,Mehta; Ravindra L.,9994,0,9999,5
1745803120105,CLRE 252,A00,891864,Cuomo; Raphael Eduardo,9993,0,9999,6
1745803121132,CLRE 253,A00,891867,Vaida; Florin,9994,0,9999,5
1745803121132,CLRE 253,B00,907819,Staff,9999,0,9999,0
1745803122161,CLRE 259,A00,891868,Patel; Hemal,9998,0,9999,1
1745803123191,CLRE 260,A00,891872,Cuomo; Raphael Eduardo,9999,0,9999,0
1745803124217,CLRE 297,001,891888,Cuomo; Raphael Eduardo,9999,0,9999,0
1745803125247,CSE 191,A00,958773,Minnes Kemp; Mor Mia,9999,0,9999,0
1745803126273,CSS 201S,A01,892054,Mignozzetti; Umberto,30,0,30,0
1745803127299,CSS 202S,A01,892056,Mignozzetti; Umberto,30,0,30,0
1745803128339,DSC 197,001,956898,Eldridge; Justin Matthew,9998,0,9999,1
1745803129364,DSC 297,001,958000,Mazumdar; Arya,9998,0,9999,1
1745803130391,EAP 100,A00,905686,Staff,9776,0,9999,223
1745803131418,ECE 45,A01,892618,Staff,0,12,50,50
1745803132443,ECE 109,A01,892620,Staff,0,43,0,0
1745803133470,ECE 111,A01,892719,Staff,0,7,50,50
1745803134497,ECE 197,001,957920,Mercier; Patrick Philip,9992,0,9999,7
1745803135524,ECON 178,A01,907814,Zhu; Ying,28,0,35,7
1745803136551,EDS 115,A00,895312,Staff,41,0,45,4
1745803137577,EDS 117,A01,895337,Staff,30,0,30,0
1745803138602,EDS 125,A00,895341,Jones; Gabrielle Anastasia,43,0,45,2
1745803139630,EDS 128A,A01,895459,Fargason; Sharon Gayle,44,0,45,1
1745803140657,EDS 128B,A01,895543,Pappas; Elizabeth,44,0,45,1
1745803141685,EDS 139,A00,897203,Pappas; Elizabeth,44,0,45,1
1745803141685,EDS 139,B00,897209,Fargason; Sharon Gayle,44,0,45,1
1745803142712,EDS 201,A00,895545,Staff,43,0,45,2
1745803143741,EDS 203,A01,895581,Halter; Christopher P.,43,0,45,2
1745803144767,EDS 204R,A01,895625,Heinzman; Erica M.,43,0,45,2
1745803144767,EDS 204R,B01,895693,Halter; Christopher P.,18,0,45,27
1745803145797,EDS 206R,A00,895694,Fargason; Sharon Gayle,9,0,30,21
1745803145797,EDS 206R,B00,895695,Choi; Bailey Miyeon,20,0,30,10
1745803146826,EDS 250,A00,895697,Hemans; Patricia Ann Benitez,43,0,45,2
1745803147851,EDS 281,A00,895701,Meyerott; Theresa Ann,15,0,15,0
1745803148877,EDS 284,A00,895736,Meyerott; Theresa Ann,15,0,15,0
1745803149906,EDS 286,A00,897210,Fine; Sarah,15,0,15,0
1745803150934,EDS 289C,A01,895770,Daly; Alan J.,15,0,15,0
1745803151961,EDS 290,A00,897211,Hofstetter; Carolyn,15,0,15,0
1745803152990,LIGM 5A,A00,896162,Fischer-Grunski; Eva K,15,0,20,5
1745803154016,LIGM 5B,A00,896260,Fischer-Grunski; Eva K,17,0,20,3
1745803155044,LIGM 5C,A00,896308,Fischer-Grunski; Eva K,18,0,20,2
1745803156071,LIIT 5AS,A00,896313,Carnelos; Chiara,18,0,20,2
1745803157100,LIIT 5BS,A00,896416,Carnelos; Chiara,20,0,20,0
1745803158130,LIIT 5CS,A00,896564,Carnelos; Chiara,20,0,20,0
1745803159157,LISP 5A,A00,896588,Munoz Sanchez; Alicia,4,0,20,16
1745803160182,LISP 5B,A00,896653,Munoz Sanchez; Alicia,10,0,20,10
1745803161210,LISP 5C,A00,896655,Munoz Sanchez; Alicia,4,0,20,16
1745803162235,MAE 197,001,957918,Kleissl; Jan,9998,0,9999,1
1745803163263,MATH 2,A01,957937,Staff,34,0,35,1
1745803164292,MATH 197,001,957876,Kedlaya; Kiran S.,9993,0,9999,6
1745803165318,MCWP 40,A00,892729,Duru; Nur,13,0,20,7
1745803165318,MCWP 40,B00,893304,Montejo; Carolina,20,0,20,0
1745803166347,MCWP 40R,A00,893757,Redela; Pamela Morgan,0,6,20,20
1745803167371,MCWP 50,A00,893758,Morshed; Michael James,2,0,20,18
1745803167371,MCWP 50,B00,893761,Bartulis; Jason Michael,17,0,20,3
1745803168402,MCWP 50R,A00,893766,Compas; Sean Matthew,0,1,20,20
1745803168402,MCWP 50R,B00,893769,Carter; Jennifer A,0,0,20,20
1745803168402,MCWP 50R,C00,893771,Krone; Jarret,0,3,20,20
1745803168402,MCWP 50R,D00,893772,Miller; Elizabeth Deen,3,0,20,17
1745803168402,MCWP 50R,E00,893775,Carter; Andrea L,0,0,20,20
1745803169428,MMW 11R,A01,892721,Herbst; Matthew,11,0,27,16
1745803169428,MMW 11R,A02,892722,Herbst; Matthew,0,0,0,3
1745803170455,MMW 12R,A01,892724,Herbst; Matthew,0,9,16,16
1745803170455,MMW 12R,A02,892725,Herbst; Matthew,0,9,16,16
1745803171481,MMW 13R,A01,892727,Staff,0,4,16,16
1745803171481,MMW 13R,A02,892728,Staff,0,4,16,16
1745803171481,MMW 13R,A03,958032,Staff,0,3,16,16
1745803171481,MMW 13R,A04,958033,Staff,0,2,16,16
1745803171481,MMW 13R,A05,958034,Staff,0,3,16,16
1745803172507,SIO 295LS,A00,894015,Staff,7,0,25,18
1745803173533,SIO 295S,A00,894020,Staff,7,0,25,18
1745803174558,SIOC 290S,B01,958918,Staff,0,0,0,0
1745803175585,SIOC 291S,B01,958922,Staff,0,0,0,0
1745803176613,SOCI 117,A01,895339,Staff,4,0,5,1
1745803177640,WES 237B,A00,894149,Staff,11,0,20,9
1745803179703,AESE 279B,A00,891859,Staff,13,0,35,22
1745803180728,AIP 197,001,891854,Staff,70,0,70,0
1745803181755,ANTH 289S,A00,891856,Gagneux; Pascal,12,0,12,0
1745803182782,BENG 196,001,957946,Engler; Adam J.,9996,0,9999,3
1745803183808,CAT 124RS,A01,956906,Staff,8,0,25,17
1745803184837,CAT 125RS,A01,922013,Staff,8,0,25,17
1745803185865,CLRE 250,A00,891860,Morris; Sheldon,9995,0,9999,4
1745803187917,CLRE 251R,A00,907817,Mehta; Ravindra L.,9994,0,9999,5
1745803188943,CLRE 252,A00,891864,Cuomo; Raphael Eduardo,9993,0,9999,6
1745803190010,CLRE 253,A00,891867,Vaida; Florin,9994,0,9999,5
1745803190010,CLRE 253,B00,907819,Staff,9999,0,9999,0
1745803191037,CLRE 259,A00,891868,Patel; Hemal,9998,0,9999,1
1745803192064,CLRE 260,A00,891872,Cuomo; Raphael Eduardo,9999,0,9999,0
1745803193090,CLRE 297,001,891888,Cuomo; Raphael Eduardo,9999,0,9999,0
1745803194117,CSE 191,A00,958773,Minnes Kemp; Mor Mia,9999,0,9999,0
1745803195143,CSS 201S,A01,892054,Mignozzetti; Umberto,30,0,30,0
1745803196170,CSS 202S,A01,892056,Mignozzetti; Umberto,30,0,30,0
1745803197198,DSC 197,001,956898,Eldridge; Justin Matthew,9998,0,9999,1
1745803198226,DSC 297,001,958000,Mazumdar; Arya,9998,0,9999,1
1745803199256,EAP 100,A00,905686,Staff,9776,0,9999,223
1745803200282,ECE 45,A01,892618,Staff,0,12,50,50
1745803201310,ECE 109,A01,892620,Staff,0,43,0,0
1745803202337,ECE 111,A01,892719,Staff,0,7,50,50
1745803203364,ECE 197,001,957920,Mercier; Patrick Philip,9992,0,9999,7
1745803204399,ECON 178,A01,907814,Zhu; Ying,28,0,35,7
1745803205427,EDS 115,A00,895312,Staff,41,0,45,4
1745803206455,EDS 117,A01,895337,Staff,30,0,30,0
1745803207482,EDS 125,A00,895341,Jones; Gabrielle Anastasia,43,0,45,2
1745803208509,EDS 128A,A01,895459,Fargason; Sharon Gayle,44,0,45,1
1745803209535,EDS 128B,A01,895543,Pappas; Elizabeth,44,0,45,1
1745803210559,EDS 139,A00,897203,Pappas; Elizabeth,44,0,45,1
1745803210559,EDS 139,B00,897209,Fargason; Sharon Gayle,44,0,45,1
1745803211587,EDS 201,A00,895545,Staff,43,0,45,2
1745803212611,EDS 203,A01,895581,Halter; Christopher P.,43,0,45,2
1745803213638,EDS 204R,A01,895625,Heinzman; Erica M.,43,0,45,2
1745803213638,EDS 204R,B01,895693,Halter; Christopher P.,18,0,45,27
1745803214665,EDS 206R,A00,895694,Fargason; Sharon Gayle,9,0,30,21
1745803214665,EDS 206R,B00,895695,Choi; Bailey Miyeon,20,0,30,10
1745803215694,EDS 250,A00,895697,Hemans; Patricia Ann Benitez,43,0,45,2
1745803216719,EDS 281,A00,895701,Meyerott; Theresa Ann,15,0,15,0
1745803217745,EDS 284,A00,895736,Meyerott; Theresa Ann,15,0,15,0
1745803218774,EDS 286,A00,897210,Fine; Sarah,15,0,15,0
1745803219799,EDS 289C,A01,895770,Daly; Alan J.,15,0,15,0
1745803220825,EDS 290,A00,897211,Hofstetter; Carolyn,15,0,15,0
1745803221851,LIGM 5A,A00,896162,Fischer-Grunski; Eva K,15,0,20,5
1745803222876,LIGM 5B,A00,896260,Fischer-Grunski; Eva K,17,0,20,3
1745803223903,LIGM 5C,A00,896308,Fischer-Grunski; Eva K,18,0,20,2
1745803224929,LIIT 5AS,A00,896313,Carnelos; Chiara,18,0,20,2
1745803225955,LIIT 5BS,A00,896416,Carnelos; Chiara,20,0,20,0
1745803226982,LIIT 5CS,A00,896564,Carnelos; Chiara,20,0,20,0
1745803228009,LISP 5A,A00,896588,Munoz Sanchez; Alicia,4,0,20,16
1745803229037,LISP 5B,A00,896653,Munoz Sanchez; Alicia,10,0,20,10
1745803230062,LISP 5C,A00,896655,Munoz Sanchez; Alicia,4,0,20,16
1745803231146,MAE 197,001,957918,Kleissl; Jan,9998,0,9999,1
1745803232171,MATH 2,A01,957937,Staff,34,0,35,1
1745803233197,MATH 197,001,957876,Kedlaya; Kiran S.,9993,0,9999,6
1745803234226,MCWP 40,A00,892729,Duru; Nur,13,0,20,7
1745803234226,MCWP 40,B00,893304,Montejo; Carolina,20,0,20,0
1745803235255,MCWP 40R,A00,893757,Redela; Pamela Morgan,0,6,20,20
1745803236281,MCWP 50,A00,893758,Morshed; Michael James,2,0,20,18
1745803236281,MCWP 50,B00,893761,Bartulis; Jason Michael,17,0,20,3
1745803237307,MCWP 50R,A00,893766,Compas; Sean Matthew,0,1,20,20
1745803237307,MCWP 50R,B00,893769,Carter; Jennifer A,0,0,20,20
1745803237307,MCWP 50R,C00,893771,Krone; Jarret,0,3,20,20
1745803237307,MCWP 50R,D00,893772,Miller; Elizabeth Deen,3,0,20,17
1745803237307,MCWP 50R,E00,893775,Carter; Andrea L,0,0,20,20
1745803238333,MMW 11R,A01,892721,Herbst; Matthew,11,0,27,16
1745803238333,MMW 11R,A02,892722,Herbst; Matthew,0,0,0,3
1745803239357,MMW 12R,A01,892724,Herbst; Matthew,0,9,16,16
1745803239357,MMW 12R,A02,892725,Herbst; Matthew,0,9,16,16
1745803240387,MMW 13R,A01,892727,Staff,0,4,16,16
1745803240387,MMW 13R,A02,892728,Staff,0,4,16,16
1745803240387,MMW 13R,A03,958032,Staff,0,3,16,16
1745803240387,MMW 13R,A04,958033,Staff,0,2,16,16
1745803240387,MMW 13R,A05,958034,Staff,0,3,16,16
1745803241413,SIO 295LS,A00,894015,Staff,7,0,25,18
1745803242440,SIO 295S,A00,894020,Staff,7,0,25,18
1745803243465,SIOC 290S,B01,958918,Staff,0,0,0,0
1745803244491,SIOC 291S,B01,958922,Staff,0,0,0,0
1745803245517,SOCI 117,A01,895339,Staff,4,0,5,1
1745803246541,WES 237B,A00,894149,Staff,11,0,20,9
1745803248600,AESE 279B,A00,891859,Staff,13,0,35,22
1745803249625,AIP 197,001,891854,Staff,70,0,70,0
1745803250651,ANTH 289S,A00,891856,Gagneux; Pascal,12,0,12,0
1745803251678,BENG 196,001,957946,Engler; Adam J.,9996,0,9999,3
1745803252705,CAT 124RS,A01,956906,Staff,8,0,25,17
1745803253731,CAT 125RS,A01,922013,Staff,8,0,25,17
1745803254757,CLRE 250,A00,891860,Morris; Sheldon,9995,0,9999,4
1745803256808,CLRE 251R,A00,907817,Mehta; Ravindra L.,9994,0,9999,5
1745803257832,CLRE 252,A00,891864,Cuomo; Raphael Eduardo,9993,0,9999,6
1745803258860,CLRE 253,A00,891867,Vaida; Florin,9994,0,9999,5
1745803258860,CLRE 253,B00,907819,Staff,9999,0,9999,0
1745803259889,CLRE 259,A00,891868,Patel; Hemal,9998,0,9999,1
1745803260916,CLRE 260,A00,891872,Cuomo; Raphael Eduardo,9999,0,9999,0
1745803261944,CLRE 297,001,891888,Cuomo; Raphael Eduardo,9999,0,9999,0
1745803262974,CSE 191,A00,958773,Minnes Kemp; Mor Mia,9999,0,9999,0
1745803264005,CSS 201S,A01,892054,Mignozzetti; Umberto,30,0,30,0
1745803265035,CSS 202S,A01,892056,Mignozzetti; Umberto,30,0,30,0
1745803266061,DSC 197,001,956898,Eldridge; Justin Matthew,9998,0,9999,1
1745803267089,DSC 297,001,958000,Mazumdar; Arya,9998,0,9999,1
1745803268115,EAP 100,A00,905686,Staff,9776,0,9999,223
1745803269144,ECE 45,A01,892618,Staff,0,12,50,50
1745803270175,ECE 109,A01,892620,Staff,0,43,0,0
1745803271203,ECE 111,A01,892719,Staff,0,7,50,50
1745803272229,ECE 197,001,957920,Mercier; Patrick Philip,9992,0,9999,7
1745803273257,ECON 178,A01,907814,Zhu; Ying,28,0,35,7
1745803274284,EDS 115,A00,895312,Staff,41,0,45,4
1745803275310,EDS 117,A01,895337,Staff,30,0,30,0
1745803276337,EDS 125,A00,895341,Jones; Gabrielle Anastasia,43,0,45,2
1745803277362,EDS 128A,A01,895459,Fargason; Sharon Gayle,44,0,45,1
1745803278391,EDS 128B,A01,895543,Pappas; Elizabeth,44,0,45,1
1745803279417,EDS 139,A00,897203,Pappas; Elizabeth,44,0,45,1
1745803279417,EDS 139,B00,897209,Fargason; Sharon Gayle,44,0,45,1
1745803280444,EDS 201,A00,895545,Staff,43,0,45,2
1745803281471,EDS 203,A01,895581,Halter; Christopher P.,43,0,45,2
1745803282495,EDS 204R,A01,895625,Heinzman; Erica M.,43,0,45,2
1745803282495,EDS 204R,B01,895693,Halter; Christopher P.,18,0,45,27
1745803283521,EDS 206R,A00,895694,Fargason; Sharon Gayle,9,0,30,21
1745803283521,EDS 206R,B00,895695,Choi; Bailey Miyeon,20,0,30,10
1745803284548,EDS 250,A00,895697,Hemans; Patricia Ann Benitez,43,0,45,2
1745803285575,EDS 281,A00,895701,Meyerott; Theresa Ann,15,0,15,0
1745803286602,EDS 284,A00,895736,Meyerott; Theresa Ann,15,0,15,0
1745803287627,EDS 286,A00,897210,Fine; Sarah,15,0,15,0
1745803288651,EDS 289C,A01,895770,Daly; Alan J.,15,0,15,0
1745803289678,EDS 290,A00,897211,Hofstetter; Carolyn,15,0,15,0
1745803290704,LIGM 5A,A00,896162,Fischer-Grunski; Eva K,15,0,20,5
1745803291732,LIGM 5B,A00,896260,Fischer-Grunski; Eva K,17,0,20,3
1745803292758,LIGM 5C,A00,896308,Fischer-Grunski; Eva K,18,0,20,2
1745803293841,LIIT 5AS,A00,896313,Carnelos; Chiara,18,0,20,2
1745803294872,LIIT 5BS,A00,896416,Carnelos; Chiara,20,0,20,0
1745803295897,LIIT 5CS,A00,896564,Carnelos; Chiara,20,0,20,0
1745803296927,LISP 5A,A00,896588,Munoz Sanchez; Alicia,4,0,20,16
1745803297957,LISP 5B,A00,896653,Munoz Sanchez; Alicia,10,0,20,10
1745803299004,LISP 5C,A00,896655,Munoz Sanchez; Alicia,4,0,20,16
1745803300030,MAE 197,001,957918,Kleissl; Jan,9998,0,9999,1
1745803301055,MATH 2,A01,957937,Staff,34,0,35,1
1745803302081,MATH 197,001,957876,Kedlaya; Kiran S.,9993,0,9999,6
1745803303107,MCWP 40,A00,892729,Duru; Nur,13,0,20,7
1745803303107,MCWP 40,B00,893304,Montejo; Carolina,20,0,20,0
1745803304135,MCWP 40R,A00,893757,Redela; Pamela Morgan,0,6,20,20
1745803305163,MCWP 50,A00,893758,Morshed; Michael James,2,0,20,18
1745803305163,MCWP 50,B00,893761,Bartulis; Jason Michael,17,0,20,3
1745803306188,MCWP 50R,A00,893766,Compas; Sean Matthew,0,1,20,20
1745803306188,MCWP 50R,B00,893769,Carter; Jennifer A,0,0,20,20
1745803306188,MCWP 50R,C00,893771,Krone; Jarret,0,3,20,20
1745803306188,MCWP 50R,D00,893772,Miller; Elizabeth Deen,3,0,20,17
1745803306188,MCWP 50R,E00,893775,Carter; Andrea L,0,0,20,20
1745803307214,MMW 11R,A01,892721,Herbst; Matthew,11,0,27,16
1745803307214,MMW 11R,A02,892722,Herbst; Matthew,0,0,0,3
1745803308237,MMW 12R,A01,892724,Herbst; Matthew,0,9,16,16
1745803308237,MMW 12R,A02,892725,Herbst; Matthew,0,9,16,16
1745803309266,MMW 13R,A01,892727,Staff,0,4,16,16
1745803309266,MMW 13R,A02,892728,Staff,0,4,16,16
1745803309266,MMW 13R,A03,958032,Staff,0,3,16,16
1745803309266,MMW 13R,A04,958033,Staff,0,2,16,16
1745803309266,MMW 13R,A05,958034,Staff,0,3,16,16
1745803310291,SIO 295LS,A00,894015,Staff,7,0,25,18
1745803311317,SIO 295S,A00,894020,Staff,7,0,25,18
1745803312347,SIOC 290S,B01,958918,Staff,0,0,0,0
1745803313372,SIOC 291S,B01,958922,Staff,0,0,0,0
1745803314398,SOCI 117,A01,895339,Staff,4,0,5,1
1745803315422,WES 237B,A00,894149,Staff,11,0,20,9
1745803317477,AESE 279B,A00,891859,Staff,13,0,35,22
1745803318501,AIP 197,001,891854,Staff,70,0,70,0
1745803319529,ANTH 289S,A00,891856,Gagneux; Pascal,12,0,12,0
1745803320558,BENG 196,001,957946,Engler; Adam J.,9996,0,9999,3
1745803321585,CAT 124RS,A01,956906,Staff,8,0,25,17
1745803322611,CAT 125RS,A01,922013,Staff,8,0,25,17
1745803323636,CLRE 250,A00,891860,Morris; Sheldon,9995,0,9999,4
1745803325693,CLRE 251R,A00,907817,Mehta; Ravindra L.,9994,0,9999,5
1745803326722,CLRE 252,A00,891864,Cuomo; Raphael Eduardo,9993,0,9999,6
1745803327747,CLRE 253,A00,891867,Vaida; Florin,9994,0,9999,5
1745803327747,CLRE 253,B00,907819,Staff,9999,0,9999,0
1745803328779,CLRE 259,A00,891868,Patel; Hemal,9998,0,9999,1
1745803329803,CLRE 260,A00,891872,Cuomo; Raphael Eduardo,9999,0,9999,0
1745803330827,CLRE 297,001,891888,Cuomo; Raphael Eduardo,9999,0,9999,0
1745803331853,CSE 191,A00,958773,Minnes Kemp; Mor Mia,9999,0,9999,0
1745803332884,CSS 201S,A01,892054,Mignozzetti; Umberto,30,0,30,0
1745803333912,CSS 202S,A01,892056,Mignozzetti; Umberto,30,0,30,0
1745803334941,DSC 197,001,956898,Eldridge; Justin Matthew,9998,0,9999,1
1745803335965,DSC 297,001,958000,Mazumdar; Arya,9998,0,9999,1
1745803336994,EAP 100,A00,905686,Staff,9776,0,9999,223
1745803338019,ECE 45,A01,892618,Staff,0,12,50,50
1745803339046,ECE 109,A01,892620,Staff,0,43,0,0
1745803340070,ECE 111,A01,892719,Staff,0,7,50,50
1745803341096,ECE 197,001,957920,Mercier; Patrick Philip,9992,0,9999,7
1745803342127,ECON 178,A01,907814,Zhu; Ying,28,0,35,7
1745803343152,EDS 115,A00,895312,Staff,41,0,45,4
1745803344177,EDS 117,A01,895337,Staff,30,0,30,0
1745803345204,EDS 125,A00,895341,Jones; Gabrielle Anastasia,43,0,45,2
1745803346231,EDS 128A,A01,895459,Fargason; Sharon Gayle,44,0,45,1
1745803347259,EDS 128B,A01,895543,Pappas; Elizabeth,44,0,45,1
1745803348285,EDS 139,A00,897203,Pappas; Elizabeth,44,0,45,1
1745803348285,EDS 139,B00,897209,Fargason; Sharon Gayle,44,0,45,1
1745803349311,EDS 201,A00,895545,Staff,43,0,45,2
1745803350339,EDS 203,A01,895581,Halter; Christopher P.,43,0,45,2
1745803351371,EDS 204R,A01,895625,Heinzman; Erica M.,43,0,45,2
1745803351371,EDS 204R,B01,895693,Halter; Christopher P.,18,0,45,27
1745803352399,EDS 206R,A00,895694,Fargason; Sharon Gayle,9,0,30,21
1745803352399,EDS 206R,B00,895695,Choi; Bailey Miyeon,20,0,30,10
1745803353427,EDS 250,A00,895697,Hemans; Patricia Ann Benitez,43,0,45,2
1745803354452,EDS 281,A00,895701,Meyerott; Theresa Ann,15,0,15,0
1745803355476,EDS 284,A00,895736,Meyerott; Theresa Ann,15,0,15,0
1745803356504,EDS 286,A00,897210,Fine; Sarah,15,0,15,0
1745803357528,EDS 289C,A01,895770,Daly; Alan J.,15,0,15,0
1745803358553,EDS 290,A00,897211,Hofstetter; Carolyn,15,0,15,0
1745803359578,LIGM 5A,A00,896162,Fischer-Grunski; Eva K,15,0,20,5
1745803360606,LIGM 5B,A00,896260,Fischer-Grunski; Eva K,17,0,20,3
1745803361635,LIGM 5C,A00,896308,Fischer-Grunski; Eva K,18,0,20,2
1745803362665,LIIT 5AS,A00,896313,Carnelos; Chiara,18,0,20,2
1745803363693,LIIT 5BS,A00,896416,Carnelos; Chiara,20,0,20,0
1745803364720,LIIT 5CS,A00,896564,Carnelos; Chiara,20,0,20,0
1745803365746,LISP 5A,A00,896588,Munoz Sanchez; Alicia,4,0,20,16
1745803366772,LISP 5B,A00,896653,Munoz Sanchez; Alicia,10,0,20,10
1745803367798,LISP 5C,A00,896655,Munoz Sanchez; Alicia,4,0,20,16
1745803368823,MAE 197,001,957918,Kleissl; Jan,9998,0,9999,1
1745803369847,MATH 2,A01,957937,Staff,34,0,35,1
1745803370872,MATH 197,001,957876,Kedlaya; Kiran S.,9993,0,9999,6
1745803371898,MCWP 40,A00,892729,Duru; Nur,13,0,20,7
1745803371898,MCWP 40,B00,893304,Montejo; Carolina,20,0,20,0
1745803372928,MCWP 40R,A00,893757,Redela; Pamela Morgan,0,6,20,20
1745803373954,MCWP 50,A00,893758,Morshed; Michael James,2,0,20,18
1745803373954,MCWP 50,B00,893761,Bartulis; Jason Michael,17,0,20,3
1745803375008,MCWP 50R,A00,893766,Compas; Sean Matthew,0,1,20,20
1745803375008,MCWP 50R,B00,893769,Carter; Jennifer A,0,0,20,20
1745803375008,MCWP 50R,C00,893771,Krone; Jarret,0,3,20,20
1745803375008,MCWP 50R,D00,893772,Miller; Elizabeth Deen,3,0,20,17
1745803375008,MCWP 50R,E00,893775,Carter; Andrea L,0,0,20,20
1745803376036,MMW 11R,A01,892721,Herbst; Matthew,11,0,27,16
1745803376036,MMW 11R,A02,892722,Herbst; Matthew,0,0,0,3
1745803377061,MMW 12R,A01,892724,Herbst; Matthew,0,9,16,16
1745803377061,MMW 12R,A02,892725,Herbst; Matthew,0,9,16,16
1745803378088,MMW 13R,A01,892727,Staff,0,4,16,16
1745803378088,MMW 13R,A02,892728,Staff,0,4,16,16
1745803378088,MMW 13R,A03,958032,Staff,0,3,16,16
1745803378088,MMW 13R,A04,958033,Staff,0,2,16,16
1745803378088,MMW 13R,A05,958034,Staff,0,3,16,16
1745803379117,SIO 295LS,A00,894015,Staff,7,0,25,18
1745803380146,SIO 295S,A00,894020,Staff,7,0,25,18
1745803381171,SIOC 290S,B01,958918,Staff,0,0,0,0
1745803382197,SIOC 291S,B01,958922,Staff,0,0,0,0
1745803383225,SOCI 117,A01,895339,Staff,4,0,5,1
1745803384252,WES 237B,A00,894149,Staff,11,0,20,9
1745803386318,AESE 279B,A00,891859,Staff,13,0,35,22
1745803387344,AIP 197,001,891854,Staff,70,0,70,0
1745803388369,ANTH 289S,A00,891856,Gagneux; Pascal,12,0,12,0
1745803389394,BENG 196,001,957946,Engler; Adam J.,9996,0,9999,3
1745803390423,CAT 124RS,A01,956906,Staff,8,0,25,17
1745803391449,CAT 125RS,A01,922013,Staff,8,0,25,17
1745803392476,CLRE 250,A00,891860,Morris; Sheldon,9995,0,9999,4
1745803394525,CLRE 251R,A00,907817,Mehta; Ravindra L.,9994,0,9999,5
1745803395549,CLRE 252,A00,891864,Cuomo; Raphael Eduardo,9993,0,9999,6
1745803396575,CLRE 253,A00,891867,Vaida; Florin,9994,0,9999,5
1745803396575,CLRE 253,B00,907819,Staff,9999,0,9999,0
1745803397659,CLRE 259,A00,891868,Patel; Hemal,9998,0,9999,1
1745803398685,CLRE 260,A00,891872,Cuomo; Raphael Eduardo,9999,0,9999,0
1745803399709,CLRE 297,001,891888,Cuomo; Raphael Eduardo,9999,0,9999,0
1745803400736,CSE 191,A00,958773,Minnes Kemp; Mor Mia,9999,0,9999,0
1745803401762,CSS 201S,A01,892054,Mignozzetti; Umberto,30,0,30,0
1745803402789,CSS 202S,A01,892056,Mignozzetti; Umberto,30,0,30,0
1745803403816,DSC 197,001,956898,Eldridge; Justin Matthew,9998,0,9999,1
1745803404842,DSC 297,001,958000,Mazumdar; Arya,9998,0,9999,1
1745803405868,EAP 100,A00,905686,Staff,9776,0,9999,223
1745803406893,ECE 45,A01,892618,Staff,0,12,50,50
1745803407922,ECE 109,A01,892620,Staff,0,43,0,0
1745803408953,ECE 111,A01,892719,Staff,0,7,50,50
1745803409979,ECE 197,001,957920,Mercier; Patrick Philip,9992,0,9999,7
1745803411004,ECON 178,A01,907814,Zhu; Ying,28,0,35,7
1745803412029,EDS 115,A00,895312,Staff,41,0,45,4
1745803413054,EDS 117,A01,895337,Staff,30,0,30,0
1745803414080,EDS 125,A00,895341,Jones; Gabrielle Anastasia,43,0,45,2
1745803415108,EDS 128A,A01,895459,Fargason; Sharon Gayle,44,0,45,1
1745803416134,EDS 128B,A01,895543,Pappas; Elizabeth,44,0,45,1
1745803417163,EDS 139,A00,897203,Pappas; Elizabeth,44,0,45,1
1745803417163,EDS 139,B00,897209,Fargason; Sharon Gayle,44,0,45,1
1745803418190,EDS 201,A00,895545,Staff,43,0,45,2
1745803419222,EDS 203,A01,895581,Halter; Christopher P.,43,0,45,2
1745803420251,EDS 204R,A01,895625,Heinzman; Erica M.,43,0,45,2
1745803420251,EDS 204R,B01,895693,Halter; Christopher P.,18,0,45,27
1745803421289,EDS 206R,A00,895694,Fargason; Sharon Gayle,9,0,30,21
1745803421289,EDS 206R,B00,895695,Choi; Bailey Miyeon,20,0,30,10
1745803422316,EDS 250,A00,895697,Hemans; Patricia Ann Benitez,43,0,45,2
1745803423342,EDS 281,A00,895701,Meyerott; Theresa Ann,15,0,15,0
1745803424371,EDS 284,A00,895736,Meyerott; Theresa Ann,15,0,15,0
1745803425397,EDS 286,A00,897210,Fine; Sarah,15,0,15,0
1745803426421,EDS 289C,A01,895770,Daly; Alan J.,15,0,15,0
1745803427449,EDS 290,A00,897211,Hofstetter; Carolyn,15,0,15,0
1745803428476,LIGM 5A,A00,896162,Fischer-Grunski; Eva K,15,0,20,5
1745803429506,LIGM 5B,A00,896260,Fischer-Grunski; Eva K,17,0,20,3
1745803430532,LIGM 5C,A00,896308,Fischer-Grunski; Eva K,18,0,20,2
1745803431558,LIIT 5AS,A00,896313,Carnelos; Chiara,18,0,20,2
1745803432585,LIIT 5BS,A00,896416,Carnelos; Chiara,20,0,20,0
1745803433612,LIIT 5CS,A00,896564,Carnelos; Chiara,20,0,20,0
1745803434640,LISP 5A,A00,896588,Munoz Sanchez; Alicia,4,0,20,16
1745803435665,LISP 5B,A00,896653,Munoz Sanchez; Alicia,10,0,20,10
1745803436695,LISP 5C,A00,896655,Munoz Sanchez; Alicia,4,0,20,16
1745803437721,MAE 197,001,957918,Kleissl; Jan,9998,0,9999,1
1745803438748,MATH 2,A01,957937,Staff,34,0,35,1
1745803439774,MATH 197,001,957876,Kedlaya; Kiran S.,9993,0,9999,6
1745803440803,MCWP 40,A00,892729,Duru; Nur,13,0,20,7
1745803440803,MCWP 40,B00,893304,Montejo; Carolina,20,0,20,0
1745803441830,MCWP 40R,A00,893757,Redela; Pamela Morgan,0,6,20,20
1745803442871,MCWP 50,A00,893758,Morshed; Michael James,2,0,20,18
1745803442871,MCWP 50,B00,893761,Bartulis; Jason Michael,17,0,20,3
1745803443898,MCWP 50R,A00,893766,Compas; Sean Matthew,0,1,20,20
1745803443898,MCWP 50R,B00,893769,Carter; Jennifer A,0,0,20,20
1745803443898,MCWP 50R,C00,893771,Krone; Jarret,0,3,20,20
1745803443898,MCWP 50R,D00,893772,Miller; Elizabeth Deen,3,0,20,17
1745803443898,MCWP 50R,E00,893775,Carter; Andrea L,0,0,20,20
1745803444931,MMW 11R,A01,892721,Herbst; Matthew,11,0,27,16
1745803444931,MMW 11R,A02,892722,Herbst; Matthew,0,0,0,3
1745803445958,MMW 12R,A01,892724,Herbst; Matthew,0,9,16,16
1745803445958,MMW 12R,A02,892725,Herbst; Matthew,0,9,16,16
1745803446987,MMW 13R,A01,892727,Staff,0,4,16,16
1745803446987,MMW 13R,A02,892728,Staff,0,4,16,16
1745803446987,MMW 13R,A03,958032,Staff,0,3,16,16
1745803446987,MMW 13R,A04,958033,Staff,0,2,16,16
1745803446987,MMW 13R,A05,958034,Staff,0,3,16,16
1745803448015,SIO 295LS,A00,894015,Staff,7,0,25,18
1745803449041,SIO 295S,A00,894020,Staff,7,0,25,18
1745803450067,SIOC 290S,B01,958918,Staff,0,0,0,0
1745803451098,SIOC 291S,B01,958922,Staff,0,0,0,0
1745803452127,SOCI 117,A01,895339,Staff,4,0,5,1
1745803453156,WES 237B,A00,894149,Staff,11,0,20,9
1745803455218,AESE 279B,A00,891859,Staff,13,0,35,22
1745803456247,AIP 197,001,891854,Staff,70,0,70,0
1745803457275,ANTH 289S,A00,891856,Gagneux; Pascal,12,0,12,0
1745803458304,BENG 196,001,957946,Engler; Adam J.,9996,0,9999,3
1745803459332,CAT 124RS,A01,956906,Staff,8,0,25,17
1745803460360,CAT 125RS,A01,922013,Staff,8,0,25,17
1745803461386,CLRE 250,A00,891860,Morris; Sheldon,9995,0,9999,4
1745803463445,CLRE 251R,A00,907817,Mehta; Ravindra L.,9994,0,9999,5
1745803464471,CLRE 252,A00,891864,Cuomo; Raphael Eduardo,9993,0,9999,6
1745803465495,CLRE 253,A00,891867,Vaida; Florin,9994,0,9999,5
1745803465495,CLRE 253,B00,907819,Staff,9999,0,9999,0
1745803466522,CLRE 259,A00,891868,Patel; Hemal,9998,0,9999,1
1745803467551,CLRE 260,A00,891872,Cuomo; Raphael Eduardo,9999,0,9999,0
1745803468577,CLRE 297,001,891888,Cuomo; Raphael Eduardo,9999,0,9999,0
1745803469604,CSE 191,A00,958773,Minnes Kemp; Mor Mia,9999,0,9999,0
1745803470634,CSS 201S,A01,892054,Mignozzetti; Umberto,30,0,30,0
1745803471659,CSS 202S,A01,892056,Mignozzetti; Umberto,30,0,30,0
1745803472685,DSC 197,001,956898,Eldridge; Justin Matthew,9998,0,9999,1
1745803473714,DSC 297,001,958000,Mazumdar; Arya,9998,0,9999,1
1745803474739,EAP 100,A00,905686,Staff,9776,0,9999,223
1745803475765,ECE 45,A01,892618,Staff,0,12,50,50
1745803476790,ECE 109,A01,892620,Staff,0,43,0,0
1745803477817,ECE 111,A01,892719,Staff,0,7,50,50
1745803478841,ECE 197,001,957920,Mercier; Patrick Philip,9992,0,9999,7
1745803479868,ECON 178,A01,907814,Zhu; Ying,28,0,35,7
1745803480897,EDS 115,A00,895312,Staff,41,0,45,4
1745803481923,EDS 117,A01,895337,Staff,30,0,30,0
1745803482952,EDS 125,A00,895341,Jones; Gabrielle Anastasia,43,0,45,2
1745803483976,EDS 128A,A01,895459,Fargason; Sharon Gayle,44,0,45,1
1745803485003,EDS 128B,A01,895543,Pappas; Elizabeth,44,0,45,1
1745803486031,EDS 139,A00,897203,Pappas; Elizabeth,44,0,45,1
1745803486031,EDS 139,B00,897209,Fargason; Sharon Gayle,44,0,45,1
1745803487060,EDS 201,A00,895545,Staff,43,0,45,2
1745803488087,EDS 203,A01,895581,Halter; Christopher P.,43,0,45,2
1745803489116,EDS 204R,A01,895625,Heinzman; Erica M.,43,0,45,2
1745803489116,EDS 204R,B01,895693,Halter; Christopher P.,18,0,45,27
1745803490146,EDS 206R,A00,895694,Fargason; Sharon Gayle,9,0,30,21
1745803490146,EDS 206R,B00,895695,Choi; Bailey Miyeon,20,0,30,10
1745803491171,EDS 250,A00,895697,Hemans; Patricia Ann Benitez,43,0,45,2
1745803492201,EDS 281,A00,895701,Meyerott; Theresa Ann,15,0,15,0
1745803493228,EDS 284,A00,895736,Meyerott; Theresa Ann,15,0,15,0
1745803494255,EDS 286,A00,897210,Fine; Sarah,15,0,15,0
1745803495281,EDS 289C,A01,895770,Daly; Alan J.,15,0,15,0
1745803496306,EDS 290,A00,897211,Hofstetter; Carolyn,15,0,15,0
1745803497333,LIGM 5A,A00,896162,Fischer-Grunski; Eva K,15,0,20,5
1745803498361,LIGM 5B,A00,896260,Fischer-Grunski; Eva K,17,0,20,3
1745803499386,LIGM 5C,A00,896308,Fischer-Grunski; Eva K,18,0,20,2
1745803500413,LIIT 5AS,A00,896313,Carnelos; Chiara,18,0,20,2
1745803501485,LIIT 5BS,A00,896416,Carnelos; Chiara,20,0,20,0
1745803502512,LIIT 5CS,A00,896564,Carnelos; Chiara,20,0,20,0
1745803503537,LISP 5A,A00,896588,Munoz Sanchez; Alicia,4,0,20,16
1745803504564,LISP 5B,A00,896653,Munoz Sanchez; Alicia,10,0,20,10
1745803505590,LISP 5C,A00,896655,Munoz Sanchez; Alicia,4,0,20,16
1745803506618,MAE 197,001,957918,Kleissl; Jan,9998,0,9999,1
1745803507645,MATH 2,A01,957937,Staff,34,0,35,1
1745803508673,MATH 197,001,957876,Kedlaya; Kiran S.,9993,0,9999,6
1745803509699,MCWP 40,A00,892729,Duru; Nur,13,0,20,7
1745803509699,MCWP 40,B00,893304,Montejo; Carolina,20,0,20,0
1745803510726,MCWP 40R,A00,893757,Redela; Pamela Morgan,0,6,20,20
1745803511753,MCWP 50,A00,893758,Morshed; Michael James,2,0,20,18
1745803511753,MCWP 50,B00,893761,Bartulis; Jason Michael,17,0,20,3
1745803512782,MCWP 50R,A00,893766,Compas; Sean Matthew,0,1,20,20
1745803512782,MCWP 50R,B00,893769,Carter; Jennifer A,0,0,20,20
1745803512782,MCWP 50R,C00,893771,Krone; Jarret,0,3,20,20
1745803512782,MCWP 50R,D00,893772,Miller; Elizabeth Deen,3,0,20,17
1745803512782,MCWP 50R,E00,893775,Carter; Andrea L,0,0,20,20
1745803513809,MMW 11R,A01,892721,Herbst; Matthew,11,0,27,16
1745803513809,MMW 11R,A02,892722,Herbst; Matthew,0,0,0,3
1745803514838,MMW 12R,A01,892724,Herbst; Matthew,0,9,16,16
1745803514838,MMW 12R,A02,892725,Herbst; Matthew,0,9,16,16
1745803515868,MMW 13R,A01,892727,Staff,0,4,16,16
1745803515868,MMW 13R,A02,892728,Staff,0,4,16,16
1745803515868,MMW 13R,A03,958032,Staff,0,3,16,16
1745803515868,MMW 13R,A04,958033,Staff,0,2,16,16
1745803515868,MMW 13R,A05,958034,Staff,0,3,16,16
1745803516895,SIO 295LS,A00,894015,Staff,7,0,25,18
1745803517922,SIO 295S,A00,894020,Staff,7,0,25,18
1745803518952,SIOC 290S,B01,958918,Staff,0,0,0,0
1745803519980,SIOC 291S,B01,958922,Staff,0,0,0,0
1745803521008,SOCI 117,A01,895339,Staff,4,0,5,1
1745803522037,WES 237B,A00,894149,Staff,11,0,20,9
1745803524103,AESE 279B,A00,891859,Staff,13,0,35,22
1745803525131,AIP 197,001,891854,Staff,70,0,70,0
1745803526158,ANTH 289S,A00,891856,Gagneux; Pascal,12,0,12,0
1745803527184,BENG 196,001,957946,Engler; Adam J.,9996,0,9999,3
1745803528211,CAT 124RS,A01,956906,Staff,8,0,25,17
1745803529241,CAT 125RS,A01,922013,Staff,8,0,25,17
1745803530266,CLRE 250,A00,891860,Morris; Sheldon,9995,0,9999,4
1745803532317,CLRE 251R,A00,907817,Mehta; Ravindra L.,9994,0,9999,5
1745803533347,CLRE 252,A00,891864,Cuomo; Raphael Eduardo,9993,0,9999,6
1745803534373,CLRE 253,A00,891867,Vaida; Florin,9994,0,9999,5
1745803534373,CLRE 253,B00,907819,Staff,9999,0,9999,0
1745803535397,CLRE 259,A00,891868,Patel; Hemal,9998,0,9999,1
1745803536422,CLRE 260,A00,891872,Cuomo; Raphael Eduardo,9999,0,9999,0
1745803537448,CLRE 297,001,891888,Cuomo; Raphael Eduardo,9999,0,9999,0
1745803538474,CSE 191,A00,958773,Minnes Kemp; Mor Mia,9999,0,9999,0
1745803539500,CSS 201S,A01,892054,Mignozzetti; Umberto,30,0,30,0
1745803540529,CSS 202S,A01,892056,Mignozzetti; Umberto,30,0,30,0
1745803541554,DSC 197,001,956898,Eldridge; Justin Matthew,9998,0,9999,1
1745803542582,DSC 297,001,958000,Mazumdar; Arya,9998,0,9999,1
1745803543608,EAP 100,A00,905686,Staff,9776,0,9999,223
1745803544634,ECE 45,A01,892618,Staff,0,12,50,50
1745803545661,ECE 109,A01,892620,Staff,0,43,0,0
1745803546686,ECE 111,A01,892719,Staff,0,7,50,50
1745803547714,ECE 197,001,957920,Mercier; Patrick Philip,9992,0,9999,7
1745803548739,ECON 178,A01,907814,Zhu; Ying,28,0,35,7
1745803549767,EDS 115,A00,895312,Staff,41,0,45,4
1745803550796,EDS 117,A01,895337,Staff,30,0,30,0
1745803551825,EDS 125,A00,895341,Jones; Gabrielle Anastasia,43,0,45,2
1745803552850,EDS 128A,A01,895459,Fargason; Sharon Gayle,44,0,45,1
1745803553878,EDS 128B,A01,895543,Pappas; Elizabeth,44,0,45,1
1745803554904,EDS 139,A00,897203,Pappas; Elizabeth,44,0,45,1
1745803554904,EDS 139,B00,897209,Fargason; Sharon Gayle,44,0,45,1
1745803555932,EDS 201,A00,895545,Staff,43,0,45,2
1745803556961,EDS 203,A01,895581,Halter; Christopher P.,43,0,45,2
1745803557989,EDS 204R,A01,895625,Heinzman; Erica M.,43,0,45,2
1745803557989,EDS 204R,B01,895693,Halter; Christopher P.,18,0,45,27
1745803559014,EDS 206R,A00,895694,Fargason; Sharon Gayle,9,0,30,21
1745803559014,EDS 206R,B00,895695,Choi; Bailey Miyeon,20,0,30,10
1745803560039,EDS 250,A00,895697,Hemans; Patricia Ann Benitez,43,0,45,2
1745803561063,EDS 281,A00,895701,Meyerott; Theresa Ann,15,0,15,0
1745803562087,EDS 284,A00,895736,Meyerott; Theresa Ann,15,0,15,0
1745803563113,EDS 286,A00,897210,Fine; Sarah,15,0,15,0
1745803564137,EDS 289C,A01,895770,Daly; Alan J.,15,0,15,0
1745803565165,EDS 290,A00,897211,Hofstetter; Carolyn,15,0,15,0
1745803566194,LIGM 5A,A00,896162,Fischer-Grunski; Eva K,15,0,20,5
1745803567220,LIGM 5B,A00,896260,Fischer-Grunski; Eva K,17,0,20,3
1745803568248,LIGM 5C,A00,896308,Fischer-Grunski; Eva K,18,0,20,2
1745803569272,LIIT 5AS,A00,896313,Carnelos; Chiara,18,0,20,2
1745803570302,LIIT 5BS,A00,896416,Carnelos; Chiara,20,0,20,0
1745803571328,LIIT 5CS,A00,896564,Carnelos; Chiara,20,0,20,0
1745803572358,LISP 5A,A00,896588,Munoz Sanchez; Alicia,4,0,20,16
1745803573383,LISP 5B,A00,896653,Munoz Sanchez; Alicia,10,0,20,10
1745803574413,LISP 5C,A00,896655,Munoz Sanchez; Alicia,4,0,20,16
1745803575438,MAE 197,001,957918,Kleissl; Jan,9998,0,9999,1
1745803576465,MATH 2,A01,957937,Staff,34,0,35,1
1745803577492,MATH 197,001,957876,Kedlaya; Kiran S.,9993,0,9999,6
1745803578516,MCWP 40,A00,892729,Duru; Nur,13,0,20,7
1745803578516,MCWP 40,B00,893304,Montejo; Carolina,20,0,20,0
1745803579540,MCWP 40R,A00,893757,Redela; Pamela Morgan,0,6,20,20
1745803580567,MCWP 50,A00,893758,Morshed; Michael James,2,0,20,18
1745803580567,MCWP 50,B00,893761,Bartulis; Jason Michael,17,0,20,3
1745803581597,MCWP 50R,A00,893766,Compas; Sean Matthew,0,1,20,20
1745803581597,MCWP 50R,B00,893769,Carter; Jennifer A,0,0,20,20
1745803581597,MCWP 50R,C00,893771,Krone; Jarret,0,3,20,20
1745803581597,MCWP 50R,D00,893772,Miller; Elizabeth Deen,3,0,20,17
1745803581597,MCWP 50R,E00,893775,Carter; Andrea L,0,0,20,20
1745803582622,MMW 11R,A01,892721,Herbst; Matthew,11,0,27,16
1745803582622,MMW 11R,A02,892722,Herbst; Matthew,0,0,0,3
1745803583650,MMW 12R,A01,892724,Herbst; Matthew,0,9,16,16
1745803583650,MMW 12R,A02,892725,Herbst; Matthew,0,9,16,16
1745803584676,MMW 13R,A01,892727,Staff,0,4,16,16
1745803584676,MMW 13R,A02,892728,Staff,0,4,16,16
1745803584676,MMW 13R,A03,958032,Staff,0,3,16,16
1745803584676,MMW 13R,A04,958033,Staff,0,2,16,16
1745803584676,MMW 13R,A05,958034,Staff,0,3,16,16
1745803585704,SIO 295LS,A00,894015,Staff,7,0,25,18
1745803586730,SIO 295S,A00,894020,Staff,7,0,25,18
1745803587755,SIOC 290S,B01,958918,Staff,0,0,0,0
1745803588781,SIOC 291S,B01,958922,Staff,0,0,0,0
1745803589808,SOCI 117,A01,895339,Staff,4,0,5,1
1745803590836,WES 237B,A00,894149,Staff,11,0,20,9
1745803592903,AESE 279B,A00,891859,Staff,13,0,35,22
1745803593929,AIP 197,001,891854,Staff,70,0,70,0
1745803594957,ANTH 289S,A00,891856,Gagneux; Pascal,12,0,12,0
1745803595985,BENG 196,001,957946,Engler; Adam J.,9996,0,9999,3
1745803597009,CAT 124RS,A01,956906,Staff,8,0,25,17
1745803598034,CAT 125RS,A01,922013,Staff,8,0,25,17
1745803599060,CLRE 250,A00,891860,Morris; Sheldon,9995,0,9999,4
1745803601116,CLRE 251R,A00,907817,Mehta; Ravindra L.,9994,0,9999,5
1745803602144,CLRE 252,A00,891864,Cuomo; Raphael Eduardo,9993,0,9999,6
1745803603171,CLRE 253,A00,891867,Vaida; Florin,9994,0,9999,5
1745803603171,CLRE 253,B00,907819,Staff,9999,0,9999,0
1745803604196,CLRE 259,A00,891868,Patel; Hemal,9998,0,9999,1
1745803605264,CLRE 260,A00,891872,Cuomo; Raphael Eduardo,9999,0,9999,0
1745803606291,CLRE 297,001,891888,Cuomo; Raphael Eduardo,9999,0,9999,0
1745803607318,CSE 191,A00,958773,Minnes Kemp; Mor Mia,9999,0,9999,0
1745803608348,CSS 201S,A01,892054,Mignozzetti; Umberto,30,0,30,0
1745803609379,CSS 202S,A01,892056,Mignozzetti; Umberto,30,0,30,0
1745803610405,DSC 197,001,956898,Eldridge; Justin Matthew,9998,0,9999,1
1745803611434,DSC 297,001,958000,Mazumdar; Arya,9998,0,9999,1
1745803612460,EAP 100,A00,905686,Staff,9776,0,9999,223
1745803613489,ECE 45,A01,892618,Staff,0,12,50,50
1745803614515,ECE 109,A01,892620,Staff,0,43,0,0
1745803615542,ECE 111,A01,892719,Staff,0,7,50,50
1745803616568,ECE 197,001,957920,Mercier; Patrick Philip,9992,0,9999,7
1745803617598,ECON 178,A01,907814,Zhu; Ying,28,0,35,7
1745803618623,EDS 115,A00,895312,Staff,41,0,45,4
1745803619648,EDS 117,A01,895337,Staff,30,0,30,0
1745803620674,EDS 125,A00,895341,Jones; Gabrielle Anastasia,43,0,45,2
1745803621702,EDS 128A,A01,895459,Fargason; Sharon Gayle,44,0,45,1
1745803622727,EDS 128B,A01,895543,Pappas; Elizabeth,44,0,45,1
1745803623752,EDS 139,A00,897203,Pappas; Elizabeth,44,0,45,1
1745803623752,EDS 139,B00,897209,Fargason; Sharon Gayle,44,0,45,1
1745803624779,EDS 201,A00,895545,Staff,43,0,45,2
1745803625806,EDS 203,A01,895581,Halter; Christopher P.,43,0,45,2
1745803626835,EDS 204R,A01,895625,Heinzman; Erica M.,43,0,45,2
1745803626835,EDS 204R,B01,895693,Halter; Christopher P.,18,0,45,27
1745803627860,EDS 206R,A00,895694,Fargason; Sharon Gayle,9,0,30,21
1745803627860,EDS 206R,B00,895695,Choi; Bailey Miyeon,20,0,30,10
1745803628889,EDS 250,A00,895697,Hemans; Patricia Ann Benitez,43,0,45,2
1745803629914,EDS 281,A00,895701,Meyerott; Theresa Ann,15,0,15,0
1745803630940,EDS 284,A00,895736,Meyerott; Theresa Ann,15,0,15,0
1745803631968,EDS 286,A00,897210,Fine; Sarah,15,0,15,0
1745803632995,EDS 289C,A01,895770,Daly; Alan J.,15,0,15,0
1745803634021,EDS 290,A00,897211,Hofstetter; Carolyn,15,0,15,0
1745803635046,LIGM 5A,A00,896162,Fischer-Grunski; Eva K,15,0,20,5
1745803636072,LIGM 5B,A00,896260,Fischer-Grunski; Eva K,17,0,20,3
1745803637097,LIGM 5C,A00,896308,Fischer-Grunski; Eva K,18,0,20,2
1745803638123,LIIT 5AS,A00,896313,Carnelos; Chiara,18,0,20,2
1745803639149,LIIT 5BS,A00,896416,Carnelos; Chiara,20,0,20,0
1745803640174,LIIT 5CS,A00,896564,Carnelos; Chiara,20,0,20,0
1745803641202,LISP 5A,A00,896588,Munoz Sanchez; Alicia,4,0,20,16
1745803642230,LISP 5B,A00,896653,Munoz Sanchez; Alicia,10,0,20,10
1745803643259,LISP 5C,A00,896655,Munoz Sanchez; Alicia,4,0,20,16
1745803644283,MAE 197,001,957918,Kleissl; Jan,9998,0,9999,1
1745803645309,MATH 2,A01,957937,Staff,34,0,35,1
1745803646333,MATH 197,001,957876,Kedlaya; Kiran S.,9993,0,9999,6
1745803647359,MCWP 40,A00,892729,Duru; Nur,13,0,20,7
1745803647359,MCWP 40,B00,893304,Montejo; Carolina,20,0,20,0
1745803648384,MCWP 40R,A00,893757,Redela; Pamela Morgan,0,6,20,20
1745803649411,MCWP 50,A00,893758,Morshed; Michael James,2,0,20,18
1745803649411,MCWP 50,B00,893761,Bartulis; Jason Michael,17,0,20,3
1745803650441,MCWP 50R,A00,893766,Compas; Sean Matthew,0,1,20,20
1745803650441,MCWP 50R,B00,893769,Carter; Jennifer A,0,0,20,20
1745803650441,MCWP 50R,C00,893771,Krone; Jarret,0,3,20,20
1745803650441,MCWP 50R,D00,893772,Miller; Elizabeth Deen,3,0,20,17
1745803650441,MCWP 50R,E00,893775,Carter; Andrea L,0,0,20,20
1745803651466,MMW 11R,A01,892721,Herbst; Matthew,11,0,27,16
1745803651466,MMW 11R,A02,892722,Herbst; Matthew,0,0,0,3
1745803652494,MMW 12R,A01,892724,Herbst; Matthew,0,9,16,16
1745803652494,MMW 12R,A02,892725,Herbst; Matthew,0,9,16,16
1745803653520,MMW 13R,A01,892727,Staff,0,4,16,16
1745803653520,MMW 13R,A02,892728,Staff,0,4,16,16
1745803653520,MMW 13R,A03,958032,Staff,0,3,16,16
1745803653520,MMW 13R,A04,958033,Staff,0,2,16,16
1745803653520,MMW 13R,A05,958034,Staff,0,3,16,16
1745803654547,SIO 295LS,A00,894015,Staff,7,0,25,18
1745803655572,SIO 295S,A00,894020,Staff,7,0,25,18
1745803656601,SIOC 290S,B01,958918,Staff,0,0,0,0
1745803657625,SIOC 291S,B01,958922,Staff,0,0,0,0
1745803658651,SOCI 117,A01,895339,Staff,4,0,5,1
1745803659675,WES 237B,A00,894149,Staff,11,0,20,9
1745803661738,AESE 279B,A00,891859,Staff,13,0,35,22
1745803662763,AIP 197,001,891854,Staff,70,0,70,0
1745803663792,ANTH 289S,A00,891856,Gagneux; Pascal,12,0,12,0
1745803664816,BENG 196,001,957946,Engler; Adam J.,9996,0,9999,3
1745803665843,CAT 124RS,A01,956906,Staff,8,0,25,17
1745803666870,CAT 125RS,A01,922013,Staff,8,0,25,17
1745803667899,CLRE 250,A00,891860,Morris; Sheldon,9995,0,9999,4
1745803669949,CLRE 251R,A00,907817,Mehta; Ravindra L.,9994,0,9999,5
1745803670975,CLRE 252,A00,891864,Cuomo; Raphael Eduardo,9993,0,9999,6
1745803672002,CLRE 253,A00,891867,Vaida; Florin,9994,0,9999,5
1745803672002,CLRE 253,B00,907819,Staff,9999,0,9999,0
1745803673027,CLRE 259,A00,891868,Patel; Hemal,9998,0,9999,1
1745803674055,CLRE 260,A00,891872,Cuomo; Raphael Eduardo,9999,0,9999,0
1745803675083,CLRE 297,001,891888,Cuomo; Raphael Eduardo,9999,0,9999,0
1745803676110,CSE 191,A00,958773,Minnes Kemp; Mor Mia,9999,0,9999,0
1745803677140,CSS 201S,A01,892054,Mignozzetti; Umberto,30,0,30,0
1745803678166,CSS 202S,A01,892056,Mignozzetti; Umberto,30,0,30,0
1745803679194,DSC 197,001,956898,Eldridge; Justin Matthew,9998,0,9999,1
1745803680221,DSC 297,001,958000,Mazumdar; Arya,9998,0,9999,1
1745803681247,EAP 100,A00,905686,Staff,9776,0,9999,223
1745803682273,ECE 45,A01,892618,Staff,0,12,50,50
1745803683299,ECE 109,A01,892620,Staff,0,43,0,0
1745803684324,ECE 111,A01,892719,Staff,0,7,50,50
1745803685348,ECE 197,001,957920,Mercier; Patrick Philip,9992,0,9999,7
1745803686376,ECON 178,A01,907814,Zhu; Ying,28,0,35,7
1745803687401,EDS 115,A00,895312,Staff,41,0,45,4
1745803688428,EDS 117,A01,895337,Staff,30,0,30,0
1745803689457,EDS 125,A00,895341,Jones; Gabrielle Anastasia,43,0,45,2
1745803690481,EDS 128A,A01,895459,Fargason; Sharon Gayle,44,0,45,1
1745803691507,EDS 128B,A01,895543,Pappas; Elizabeth,44,0,45,1
1745803692531,EDS 139,A00,897203,Pappas; Elizabeth,44,0,45,1
1745803692531,EDS 139,B00,897209,Fargason; Sharon Gayle,44,0,45,1
1745803693558,EDS 201,A00,895545,Staff,43,0,45,2
1745803694583,EDS 203,A01,895581,Halter; Christopher P.,43,0,45,2
1745803695608,EDS 204R,A01,895625,Heinzman; Erica M.,43,0,45,2
1745803695608,EDS 204R,B01,895693,Halter; Christopher P.,18,0,45,27
1745803696637,EDS 206R,A00,895694,Fargason; Sharon Gayle,9,0,30,21
1745803696637,EDS 206R,B00,895695,Choi; Bailey Miyeon,20,0,30,10
1745803697665,EDS 250,A00,895697,Hemans; Patricia Ann Benitez,43,0,45,2
1745803698692,EDS 281,A00,895701,Meyerott; Theresa Ann,15,0,15,0
1745803699720,EDS 284,A00,895736,Meyerott; Theresa Ann,15,0,15,0
1745803700745,EDS 286,A00,897210,Fine; Sarah,15,0,15,0
1745803701773,EDS 289C,A01,895770,Daly; Alan J.,15,0,15,0
1745803702798,EDS 290,A00,897211,Hofstetter; Carolyn,15,0,15,0
1745803703824,LIGM 5A,A00,896162,Fischer-Grunski; Eva K,15,0,20,5
1745803704852,LIGM 5B,A00,896260,Fischer-Grunski; Eva K,17,0,20,3
1745803705878,LIGM 5C,A00,896308,Fischer-Grunski; Eva K,18,0,20,2
1745803706908,LIIT 5AS,A00,896313,Carnelos; Chiara,18,0,20,2
1745803707935,LIIT 5BS,A00,896416,Carnelos; Chiara,20,0,20,0
1745803709002,LIIT 5CS,A00,896564,Carnelos; Chiara,20,0,20,0
1745803710031,LISP 5A,A00,896588,Munoz Sanchez; Alicia,4,0,20,16
1745803711056,LISP 5B,A00,896653,Munoz Sanchez; Alicia,10,0,20,10
1745803712083,LISP 5C,A00,896655,Munoz Sanchez; Alicia,4,0,20,16
1745803713110,MAE 197,001,957918,Kleissl; Jan,9998,0,9999,1
1745803714137,MATH 2,A01,957937,Staff,34,0,35,1
1745803715162,MATH 197,001,957876,Kedlaya; Kiran S.,9993,0,9999,6
1745803716187,MCWP 40,A00,892729,Duru; Nur,13,0,20,7
1745803716187,MCWP 40,B00,893304,Montejo; Carolina,20,0,20,0
1745803717215,MCWP 40R,A00,893757,Redela; Pamela Morgan,0,6,20,20
1745803718239,MCWP 50,A00,893758,Morshed; Michael James,2,0,20,18
1745803718239,MCWP 50,B00,893761,Bartulis; Jason Michael,17,0,20,3
1745803719267,MCWP 50R,A00,893766,Compas; Sean Matthew,0,1,20,20
1745803719267,MCWP 50R,B00,893769,Carter; Jennifer A,0,0,20,20
1745803719267,MCWP 50R,C00,893771,Krone; Jarret,0,3,20,20
1745803719267,MCWP 50R,D00,893772,Miller; Elizabeth Deen,3,0,20,17
1745803719267,MCWP 50R,E00,893775,Carter; Andrea L,0,0,20,20
1745803720296,MMW 11R,A01,892721,Herbst; Matthew,11,0,27,16
1745803720296,MMW 11R,A02,892722,Herbst; Matthew,0,0,0,3
1745803721322,MMW 12R,A01,892724,Herbst; Matthew,0,9,16,16
1745803721322,MMW 12R,A02,892725,Herbst; Matthew,0,9,16,16
1745803722350,MMW 13R,A01,892727,Staff,0,4,16,16
1745803722350,MMW 13R,A02,892728,Staff,0,4,16,16
1745803722350,MMW 13R,A03,958032,Staff,0,3,16,16
1745803722350,MMW 13R,A04,958033,Staff,0,2,16,16
1745803722350,MMW 13R,A05,958034,Staff,0,3,16,16
1745803723378,SIO 295LS,A00,894015,Staff,7,0,25,18
1745803724406,SIO 295S,A00,894020,Staff,7,0,25,18
1745803725432,SIOC 290S,B01,958918,Staff,0,0,0,0
1745803726460,SIOC 291S,B01,958922,Staff,0,0,0,0
1745803727485,SOCI 117,A01,895339,Staff,4,0,5,1
1745803728511,WES 237B,A00,894149,Staff,11,0,20,9
1745803730568,AESE 279B,A00,891859,Staff,13,0,35,22
1745803731595,AIP 197,001,891854,Staff,70,0,70,0
1745803732620,ANTH 289S,A00,891856,Gagneux; Pascal,12,0,12,0
1745803733645,BENG 196,001,957946,Engler; Adam J.,9996,0,9999,3
1745803734678,CAT 124RS,A01,956906,Staff,8,0,25,17
1745803735703,CAT 125RS,A01,922013,Staff,8,0,25,17
1745803736731,CLRE 250,A00,891860,Morris; Sheldon,9995,0,9999,4
1745803738788,CLRE 251R,A00,907817,Mehta; Ravindra L.,9994,0,9999,5
1745803739815,CLRE 252,A00,891864,Cuomo; Raphael Eduardo,9993,0,9999,6
1745803740841,CLRE 253,A00,891867,Vaida; Florin,9994,0,9999,5
1745803740841,CLRE 253,B00,907819,Staff,9999,0,9999,0
1745803741871,CLRE 259,A00,891868,Patel; Hemal,9998,0,9999,1
1745803742901,CLRE 260,A00,891872,Cuomo; Raphael Eduardo,9999,0,9999,0
1745803743930,CLRE 297,001,891888,Cuomo; Raphael Eduardo,9999,0,9999,0
1745803744957,CSE 191,A00,958773,Minnes Kemp; Mor Mia,9999,0,9999,0
1745803745984,CSS 201S,A01,892054,Mignozzetti; Umberto,30,0,30,0
1745803747012,CSS 202S,A01,892056,Mignozzetti; Umberto,30,0,30,0
1745803748037,DSC 197,001,956898,Eldridge; Justin Matthew,9998,0,9999,1
1745803749063,DSC 297,001,958000,Mazumdar; Arya,9998,0,9999,1
1745803750087,EAP 100,A00,905686,Staff,9776,0,9999,223
1745803751114,ECE 45,A01,892618,Staff,0,12,50,50
1745803752142,ECE 109,A01,892620,Staff,0,43,0,0
1745803753168,ECE 111,A01,892719,Staff,0,7,50,50
1745803754192,ECE 197,001,957920,Mercier; Patrick Philip,9992,0,9999,7
1745803755216,ECON 178,A01,907814,Zhu; Ying,28,0,35,7
1745803756245,EDS 115,A00,895312,Staff,41,0,45,4
1745803757273,EDS 117,A01,895337,Staff,30,0,30,0
1745803758300,EDS 125,A00,895341,Jones; Gabrielle Anastasia,43,0,45,2
1745803759326,EDS 128A,A01,895459,Fargason; Sharon Gayle,44,0,45,1
1745803760353,EDS 128B,A01,895543,Pappas; Elizabeth,44,0,45,1
1745803761381,EDS 139,A00,897203,Pappas; Elizabeth,44,0,45,1
1745803761381,EDS 139,B00,897209,Fargason; Sharon Gayle,44,0,45,1
1745803762408,EDS 201,A00,895545,Staff,43,0,45,2
1745803763435,EDS 203,A01,895581,Halter; Christopher P.,43,0,45,2
1745803764464,EDS 204R,A01,895625,Heinzman; Erica M.,43,0,45,2
1745803764464,EDS 204R,B01,895693,Halter; Christopher P.,18,0,45,27
1745803765490,EDS 206R,A00,895694,Fargason; Sharon Gayle,9,0,30,21
1745803765490,EDS 206R,B00,895695,Choi; Bailey Miyeon,20,0,30,10
1745803766519,EDS 250,A00,895697,Hemans; Patricia Ann Benitez,43,0,45,2
1745803767545,EDS 281,A00,895701,Meyerott; Theresa Ann,15,0,15,0
1745803768573,EDS 284,A00,895736,Meyerott; Theresa Ann,15,0,15,0
1745803769600,EDS 286,A00,897210,Fine; Sarah,15,0,15,0
1745803770626,EDS 289C,A01,895770,Daly; Alan J.,15,0,15,0
1745803771655,EDS 290,A00,897211,Hofstetter; Carolyn,15,0,15,0
1745803772682,LIGM 5A,A00,896162,Fischer-Grunski; Eva K,15,0,20,5
1745803773708,LIGM 5B,A00,896260,Fischer-Grunski; Eva K,17,0,20,3
1745803774735,LIGM 5C,A00,896308,Fischer-Grunski; Eva K,18,0,20,2
1745803775761,LIIT 5AS,A00,896313,Carnelos; Chiara,18,0,20,2
1745803776788,LIIT 5BS,A00,896416,Carnelos; Chiara,20,0,20,0
1745803777819,LIIT 5CS,A00,896564,Carnelos; Chiara,20,0,20,0
1745803778844,LISP 5A,A00,896588,Munoz Sanchez; Alicia,4,0,20,16
1745803779871,LISP 5B,A00,896653,Munoz Sanchez; Alicia,10,0,20,10
1745803780900,LISP 5C,A00,896655,Munoz Sanchez; Alicia,4,0,20,16
1745803781925,MAE 197,001,957918,Kleissl; Jan,9998,0,9999,1
1745803782949,MATH 2,A01,957937,Staff,34,0,35,1
1745803783973,MATH 197,001,957876,Kedlaya; Kiran S.,9993,0,9999,6
1745803785002,MCWP 40,A00,892729,Duru; Nur,13,0,20,7
1745803785002,MCWP 40,B00,893304,Montejo; Carolina,20,0,20,0
1745803786032,MCWP 40R,A00,893757,Redela; Pamela Morgan,0,6,20,20
1745803787058,MCWP 50,A00,893758,Morshed; Michael James,2,0,20,18
1745803787058,MCWP 50,B00,893761,Bartulis; Jason Michael,17,0,20,3
1745803788132,MCWP 50R,A00,893766,Compas; Sean Matthew,0,1,20,20
1745803788132,MCWP 50R,B00,893769,Carter; Jennifer A,0,0,20,20
1745803788132,MCWP 50R,C00,893771,Krone; Jarret,0,3,20,20
1745803788132,MCWP 50R,D00,893772,Miller; Elizabeth Deen,3,0,20,17
1745803788132,MCWP 50R,E00,893775,Carter; Andrea L,0,0,20,20
1745803789159,MMW 11R,A01,892721,Herbst; Matthew,11,0,27,16
1745803789159,MMW 11R,A02,892722,Herbst; Matthew,0,0,0,3
1745803790185,MMW 12R,A01,892724,Herbst; Matthew,0,9,16,16
1745803790185,MMW 12R,A02,892725,Herbst; Matthew,0,9,16,16
1745803791212,MMW 13R,A01,892727,Staff,0,4,16,16
1745803791212,MMW 13R,A02,892728,Staff,0,4,16,16
1745803791212,MMW 13R,A03,958032,Staff,0,3,16,16
1745803791212,MMW 13R,A04,958033,Staff,0,2,16,16
1745803791212,MMW 13R,A05,958034,Staff,0,3,16,16
1745803792238,SIO 295LS,A00,894015,Staff,7,0,25,18
1745803793268,SIO 295S,A00,894020,Staff,7,0,25,18
1745803794303,SIOC 290S,B01,958918,Staff,0,0,0,0
1745803795330,SIOC 291S,B01,958922,Staff,0,0,0,0
1745803796358,SOCI 117,A01,895339,Staff,4,0,5,1
1745803797382,WES 237B,A00,894149,Staff,11,0,20,9
1745803799471,AESE 279B,A00,891859,Staff,13,0,35,22
1745803800498,AIP 197,001,891854,Staff,70,0,70,0
1745803801525,ANTH 289S,A00,891856,Gagneux; Pascal,12,0,12,0
1745803802565,BENG 196,001,957946,Engler; Adam J.,9996,0,9999,3
1745803803592,CAT 124RS,A01,956906,Staff,8,0,25,17
1745803804623,CAT 125RS,A01,922013,Staff,8,0,25,17
1745803805649,CLRE 250,A00,891860,Morris; Sheldon,9995,0,9999,4
1745803807700,CLRE 251R,A00,907817,Mehta; Ravindra L.,9994,0,9999,5
1745803808726,CLRE 252,A00,891864,Cuomo; Raphael Eduardo,9993,0,9999,6
1745803809752,CLRE 253,A00,891867,Vaida; Florin,9994,0,9999,5
1745803809752,CLRE 253,B00,907819,Staff,9999,0,9999,0
1745803810779,CLRE 259,A00,891868,Patel; Hemal,9998,0,9999,1
1745803811807,CLRE 260,A00,891872,Cuomo; Raphael Eduardo,9999,0,9999,0
1745803812892,CLRE 297,001,891888,Cuomo; Raphael Eduardo,9999,0,9999,0
1745803813917,CSE 191,A00,958773,Minnes Kemp; Mor Mia,9999,0,9999,0
1745803814948,CSS 201S,A01,892054,Mignozzetti; Umberto,30,0,30,0
1745803815973,CSS 202S,A01,892056,Mignozzetti; Umberto,30,0,30,0
1745803817000,DSC 197,001,956898,Eldridge; Justin Matthew,9998,0,9999,1
1745803818028,DSC 297,001,958000,Mazumdar; Arya,9998,0,9999,1
1745803819055,EAP 100,A00,905686,Staff,9776,0,9999,223
1745803820080,ECE 45,A01,892618,Staff,0,12,50,50
1745803821107,ECE 109,A01,892620,Staff,0,43,0,0
1745803822133,ECE 111,A01,892719,Staff,0,7,50,50
1745803823157,ECE 197,001,957920,Mercier; Patrick Philip,9992,0,9999,7
1745803824185,ECON 178,A01,907814,Zhu; Ying,28,0,35,7
1745803825210,EDS 115,A00,895312,Staff,41,0,45,4
1745803826235,EDS 117,A01,895337,Staff,30,0,30,0
1745803827262,EDS 125,A00,895341,Jones; Gabrielle Anastasia,43,0,45,2
1745803828288,EDS 128A,A01,895459,Fargason; Sharon Gayle,44,0,45,1
1745803829314,EDS 128B,A01,895543,Pappas; Elizabeth,44,0,45,1
1745803830343,EDS 139,A00,897203,Pappas; Elizabeth,44,0,45,1
1745803830343,EDS 139,B00,897209,Fargason; Sharon Gayle,44,0,45,1
1745803831373,EDS 201,A00,895545,Staff,43,0,45,2
1745803832402,EDS 203,A01,895581,Halter; Christopher P.,43,0,45,2
1745803833431,EDS 204R,A01,895625,Heinzman; Erica M.,43,0,45,2
1745803833431,EDS 204R,B01,895693,Halter; Christopher P.,18,0,45,27
1745803834454,EDS 206R,A00,895694,Fargason; Sharon Gayle,9,0,30,21
1745803834454,EDS 206R,B00,895695,Choi; Bailey Miyeon,20,0,30,10
1745803835481,EDS 250,A00,895697,Hemans; Patricia Ann Benitez,43,0,45,2
1745803836506,EDS 281,A00,895701,Meyerott; Theresa Ann,15,0,15,0
1745803837531,EDS 284,A00,895736,Meyerott; Theresa Ann,15,0,15,0
1745803838555,EDS 286,A00,897210,Fine; Sarah,15,0,15,0
1745803839584,EDS 289C,A01,895770,Daly; Alan J.,15,0,15,0
1745803840608,EDS 290,A00,897211,Hofstetter; Carolyn,15,0,15,0
1745803841634,LIGM 5A,A00,896162,Fischer-Grunski; Eva K,15,0,20,5
1745803842660,LIGM 5B,A00,896260,Fischer-Grunski; Eva K,17,0,20,3
1745803843684,LIGM 5C,A00,896308,Fischer-Grunski; Eva K,18,0,20,2
1745803844709,LIIT 5AS,A00,896313,Carnelos; Chiara,18,0,20,2
1745803845738,LIIT 5BS,A00,896416,Carnelos; Chiara,20,0,20,0
1745803846766,LIIT 5CS,A00,896564,Carnelos; Chiara,20,0,20,0
1745803847791,LISP 5A,A00,896588,Munoz Sanchez; Alicia,4,0,20,16
1745803848816,LISP 5B,A00,896653,Munoz Sanchez; Alicia,10,0,20,10
1745803849841,LISP 5C,A00,896655,Munoz Sanchez; Alicia,4,0,20,16
1745803850867,MAE 197,001,957918,Kleissl; Jan,9998,0,9999,1
1745803851895,MATH 2,A01,957937,Staff,34,0,35,1
1745803852921,MATH 197,001,957876,Kedlaya; Kiran S.,9993,0,9999,6
1745803853949,MCWP 40,A00,892729,Duru; Nur,13,0,20,7
1745803853949,MCWP 40,B00,893304,Montejo; Carolina,20,0,20,0
1745803854982,MCWP 40R,A00,893757,Redela; Pamela Morgan,0,6,20,20
1745803856009,MCWP 50,A00,893758,Morshed; Michael James,2,0,20,18
1745803856009,MCWP 50,B00,893761,Bartulis; Jason Michael,17,0,20,3
1745803857034,MCWP 50R,A00,893766,Compas; Sean Matthew,0,1,20,20
1745803857034,MCWP 50R,B00,893769,Carter; Jennifer A,0,0,20,20
1745803857034,MCWP 50R,C00,893771,Krone; Jarret,0,3,20,20
1745803857034,MCWP 50R,D00,893772,Miller; Elizabeth Deen,3,0,20,17
1745803857034,MCWP 50R,E00,893775,Carter; Andrea L,0,0,20,20
1745803858059,MMW 11R,A01,892721,Herbst; Matthew,11,0,27,16
1745803858059,MMW 11R,A02,892722,Herbst; Matthew,0,0,0,3
1745803859083,MMW 12R,A01,892724,Herbst; Matthew,0,9,16,16
1745803859083,MMW 12R,A02,892725,Herbst; Matthew,0,9,16,16
1745803860107,MMW 13R,A01,892727,Staff,0,4,16,16
1745803860107,MMW 13R,A02,892728,Staff,0,4,16,16
1745803860107,MMW 13R,A03,958032,Staff,0,3,16,16
1745803860107,MMW 13R,A04,958033,Staff,0,2,16,16
1745803860107,MMW 13R,A05,958034,Staff,0,3,16,16
1745803861132,SIO 295LS,A00,894015,Staff,7,0,25,18
1745803862160,SIO 295S,A00,894020,Staff,7,0,25,18
1745803863186,SIOC 290S,B01,958918,Staff,0,0,0,0
1745803864214,SIOC 291S,B01,958922,Staff,0,0,0,0
1745803865242,SOCI 117,A01,895339,Staff,4,0,5,1
1745803866266,WES 237B,A00,894149,Staff,11,0,20,9
1745803868370,AESE 279B,A00,891859,Staff,13,0,35,22
1745803869396,AIP 197,001,891854,Staff,70,0,70,0
1745803870420,ANTH 289S,A00,891856,Gagneux; Pascal,12,0,12,0
1745803871447,BENG 196,001,957946,Engler; Adam J.,9996,0,9999,3
1745803872473,CAT 124RS,A01,956906,Staff,8,0,25,17
1745803873499,CAT 125RS,A01,922013,Staff,8,0,25,17
1745803874524,CLRE 250,A00,891860,Morris; Sheldon,9995,0,9999,4
1745803876577,CLRE 251R,A00,907817,Mehta; Ravindra L.,9994,0,9999,5
1745803877602,CLRE 252,A00,891864,Cuomo; Raphael Eduardo,9993,0,9999,6
1745803878631,CLRE 253,A00,891867,Vaida; Florin,9994,0,9999,5
1745803878631,CLRE 253,B00,907819,Staff,9999,0,9999,0
1745803879659,CLRE 259,A00,891868,Patel; Hemal,9998,0,9999,1
1745803880684,CLRE 260,A00,891872,Cuomo; Raphael Eduardo,9999,0,9999,0
1745803881709,CLRE 297,001,891888,Cuomo; Raphael Eduardo,9999,0,9999,0
1745803882734,CSE 191,A00,958773,Minnes Kemp; Mor Mia,9999,0,9999,0
1745803883764,CSS 201S,A01,892054,Mignozzetti; Umberto,30,0,30,0
1745803884789,CSS 202S,A01,892056,Mignozzetti; Umberto,30,0,30,0
1745803885817,DSC 197,001,956898,Eldridge; Justin Matthew,9998,0,9999,1
1745803886899,DSC 297,001,958000,Mazumdar; Arya,9998,0,9999,1
1745803887924,EAP 100,A00,905686,Staff,9776,0,9999,223
1745803888953,ECE 45,A01,892618,Staff,0,12,50,50
1745803889979,ECE 109,A01,892620,Staff,0,43,0,0
1745803891004,ECE 111,A01,892719,Staff,0,7,50,50
1745803892030,ECE 197,001,957920,Mercier; Patrick Philip,9992,0,9999,7
1745803893057,ECON 178,A01,907814,Zhu; Ying,28,0,35,7
1745803894081,EDS 115,A00,895312,Staff,41,0,45,4
1745803895107,EDS 117,A01,895337,Staff,30,0,30,0
1745803896132,EDS 125,A00,895341,Jones; Gabrielle Anastasia,43,0,45,2
1745803897162,EDS 128A,A01,895459,Fargason; Sharon Gayle,44,0,45,1
1745803898189,EDS 128B,A01,895543,Pappas; Elizabeth,44,0,45,1
1745803899213,EDS 139,A00,897203,Pappas; Elizabeth,44,0,45,1
1745803899213,EDS 139,B00,897209,Fargason; Sharon Gayle,44,0,45,1
1745803900242,EDS 201,A00,895545,Staff,43,0,45,2
1745803901268,EDS 203,A01,895581,Halter; Christopher P.,43,0,45,2
1745803902296,EDS 204R,A01,895625,Heinzman; Erica M.,43,0,45,2
1745803902296,EDS 204R,B01,895693,Halter; Christopher P.,18,0,45,27
1745803903321,EDS 206R,A00,895694,Fargason; Sharon Gayle,9,0,30,21
1745803903321,EDS 206R,B00,895695,Choi; Bailey Miyeon,20,0,30,10
1745803904347,EDS 250,A00,895697,Hemans; Patricia Ann Benitez,43,0,45,2
1745803905374,EDS 281,A00,895701,Meyerott; Theresa Ann,15,0,15,0
1745803906398,EDS 284,A00,895736,Meyerott; Theresa Ann,15,0,15,0
1745803907423,EDS 286,A00,897210,Fine; Sarah,15,0,15,0
1745803908448,EDS 289C,A01,895770,Daly; Alan J.,15,0,15,0
1745803909473,EDS 290,A00,897211,Hofstetter; Carolyn,15,0,15,0
1745803910502,LIGM 5A,A00,896162,Fischer-Grunski; Eva K,15,0,20,5
1745803911528,LIGM 5B,A00,896260,Fischer-Grunski; Eva K,17,0,20,3
1745803912554,LIGM 5C,A00,896308,Fischer-Grunski; Eva K,18,0,20,2
1745803913580,LIIT 5AS,A00,896313,Carnelos; Chiara,18,0,20,2
1745803914610,LIIT 5BS,A00,896416,Carnelos; Chiara,20,0,20,0
1745803915639,LIIT 5CS,A00,896564,Carnelos; Chiara,20,0,20,0
1745803916667,LISP 5A,A00,896588,Munoz Sanchez; Alicia,4,0,20,16
1745803917697,LISP 5B,A00,896653,Munoz Sanchez; Alicia,10,0,20,10
1745803918720,LISP 5C,A00,896655,Munoz Sanchez; Alicia,4,0,20,16
1745803919747,MAE 197,001,957918,Kleissl; Jan,9998,0,9999,1
1745803920775,MATH 2,A01,957937,Staff,34,0,35,1
1745803921799,MATH 197,001,957876,Kedlaya; Kiran S.,9993,0,9999,6
1745803922828,MCWP 40,A00,892729,Duru; Nur,13,0,20,7
1745803922828,MCWP 40,B00,893304,Montejo; Carolina,20,0,20,0
1745803923855,MCWP 40R,A00,893757,Redela; Pamela Morgan,0,6,20,20
1745803924880,MCWP 50,A00,893758,Morshed; Michael James,2,0,20,18
1745803924880,MCWP 50,B00,893761,Bartulis; Jason Michael,17,0,20,3
1745803925912,MCWP 50R,A00,893766,Compas; Sean Matthew,0,1,20,20
1745803925912,MCWP 50R,B00,893769,Carter; Jennifer A,0,0,20,20
1745803925912,MCWP 50R,C00,893771,Krone; Jarret,0,3,20,20
1745803925912,MCWP 50R,D00,893772,Miller; Elizabeth Deen,3,0,20,17
1745803925912,MCWP 50R,E00,893775,Carter; Andrea L,0,0,20,20
1745803926939,MMW 11R,A01,892721,Herbst; Matthew,11,0,27,16
1745803926939,MMW 11R,A02,892722,Herbst; Matthew,0,0,0,3
1745803927964,MMW 12R,A01,892724,Herbst; Matthew,0,9,16,16
1745803927964,MMW 12R,A02,892725,Herbst; Matthew,0,9,16,16
1745803928989,MMW 13R,A01,892727,Staff,0,4,16,16
1745803928989,MMW 13R,A02,892728,Staff,0,4,16,16
1745803928989,MMW 13R,A03,958032,Staff,0,3,16,16
1745803928989,MMW 13R,A04,958033,Staff,0,2,16,16
1745803928989,MMW 13R,A05,958034,Staff,0,3,16,16
1745803930015,SIO 295LS,A00,894015,Staff,7,0,25,18
1745803931044,SIO 295S,A00,894020,Staff,7,0,25,18
1745803932071,SIOC 290S,B01,958918,Staff,0,0,0,0
1745803933100,SIOC 291S,B01,958922,Staff,0,0,0,0
1745803934125,SOCI 117,A01,895339,Staff,4,0,5,1
1745803935149,WES 237B,A00,894149,Staff,11,0,20,9
1745803937209,AESE 279B,A00,891859,Staff,13,0,35,22
1745803938235,AIP 197,001,891854,Staff,70,0,70,0
1745803939262,ANTH 289S,A00,891856,Gagneux; Pascal,12,0,12,0
1745803940288,BENG 196,001,957946,Engler; Adam J.,9996,0,9999,3
1745803941317,CAT 124RS,A01,956906,Staff,8,0,25,17
1745803942341,CAT 125RS,A01,922013,Staff,8,0,25,17
1745803943368,CLRE 250,A00,891860,Morris; Sheldon,9995,0,9999,4
1745803945421,CLRE 251R,A00,907817,Mehta; Ravindra L.,9994,0,9999,5
1745803946449,CLRE 252,A00,891864,Cuomo; Raphael Eduardo,9993,0,9999,6
1745803947474,CLRE 253,A00,891867,Vaida; Florin,9994,0,9999,5
1745803947474,CLRE 253,B00,907819,Staff,9999,0,9999,0
1745803948501,CLRE 259,A00,891868,Patel; Hemal,9998,0,9999,1
1745803949527,CLRE 260,A00,891872,Cuomo; Raphael Eduardo,9999,0,9999,0
1745803950553,CLRE 297,001,891888,Cuomo; Raphael Eduardo,9999,0,9999,0
1745803951580,CSE 191,A00,958773,Minnes Kemp; Mor Mia,9999,0,9999,0
1745803952606,CSS 201S,A01,892054,Mignozzetti; Umberto,30,0,30,0
1745803953634,CSS 202S,A01,892056,Mignozzetti; Umberto,30,0,30,0
1745803954658,DSC 197,001,956898,Eldridge; Justin Matthew,9998,0,9999,1
1745803955684,DSC 297,001,958000,Mazumdar; Arya,9998,0,9999,1
1745803956710,EAP 100,A00,905686,Staff,9776,0,9999,223
1745803957734,ECE 45,A01,892618,Staff,0,12,50,50
1745803958759,ECE 109,A01,892620,Staff,0,43,0,0
1745803959785,ECE 111,A01,892719,Staff,0,7,50,50
1745803960814,ECE 197,001,957920,Mercier; Patrick Philip,9992,0,9999,7
1745803961843,ECON 178,A01,907814,Zhu; Ying,28,0,35,7
1745803962871,EDS 115,A00,895312,Staff,41,0,45,4
1745803963897,EDS 117,A01,895337,Staff,30,0,30,0
1745803964927,EDS 125,A00,895341,Jones; Gabrielle Anastasia,43,0,45,2
1745803965958,EDS 128A,A01,895459,Fargason; Sharon Gayle,44,0,45,1
1745803966983,EDS 128B,A01,895543,Pappas; Elizabeth,44,0,45,1
1745803968009,EDS 139,A00,897203,Pappas; Elizabeth,44,0,45,1
1745803968009,EDS 139,B00,897209,Fargason; Sharon Gayle,44,0,45,1
1745803969037,EDS 201,A00,895545,Staff,43,0,45,2
1745803970062,EDS 203,A01,895581,Halter; Christopher P.,43,0,45,2
1745803971087,EDS 204R,A01,895625,Heinzman; Erica M.,43,0,45,2
1745803971087,EDS 204R,B01,895693,Halter; Christopher P.,18,0,45,27
1745803972113,EDS 206R,A00,895694,Fargason; Sharon Gayle,9,0,30,21
1745803972113,EDS 206R,B00,895695,Choi; Bailey Miyeon,20,0,30,10
1745803973141,EDS 250,A00,895697,Hemans; Patricia Ann Benitez,43,0,45,2
1745803974172,EDS 281,A00,895701,Meyerott; Theresa Ann,15,0,15,0
1745803975255,EDS 284,A00,895736,Meyerott; Theresa Ann,15,0,15,0
1745803976278,EDS 286,A00,897210,Fine; Sarah,15,0,15,0
1745803977304,EDS 289C,A01,895770,Daly; Alan J.,15,0,15,0
1745803978330,EDS 290,A00,897211,Hofstetter; Carolyn,15,0,15,0
1745803979360,LIGM 5A,A00,896162,Fischer-Grunski; Eva K,15,0,20,5
1745803980383,LIGM 5B,A00,896260,Fischer-Grunski; Eva K,17,0,20,3
1745803981410,LIGM 5C,A00,896308,Fischer-Grunski; Eva K,18,0,20,2
1745803982436,LIIT 5AS,A00,896313,Carnelos; Chiara,18,0,20,2
1745803983485,LIIT 5BS,A00,896416,Carnelos; Chiara,20,0,20,0
1745803984511,LIIT 5CS,A00,896564,Carnelos; Chiara,20,0,20,0
1745803985537,LISP 5A,A00,896588,Munoz Sanchez; Alicia,4,0,20,16
1745803986588,LISP 5B,A00,896653,Munoz Sanchez; Alicia,10,0,20,10
1745803987616,LISP 5C,A00,896655,Munoz Sanchez; Alicia,4,0,20,16
1745803988646,MAE 197,001,957918,Kleissl; Jan,9998,0,9999,1
1745803989673,MATH 2,A01,957937,Staff,34,0,35,1
1745803990698,MATH 197,001,957876,Kedlaya; Kiran S.,9993,0,9999,6
1745803991723,MCWP 40,A00,892729,Duru; Nur,13,0,20,7
1745803991723,MCWP 40,B00,893304,Montejo; Carolina,20,0,20,0
1745803992749,MCWP 40R,A00,893757,Redela; Pamela Morgan,0,6,20,20
1745803993778,MCWP 50,A00,893758,Morshed; Michael James,2,0,20,18
1745803993778,MCWP 50,B00,893761,Bartulis; Jason Michael,17,0,20,3
1745803994807,MCWP 50R,A00,893766,Compas; Sean Matthew,0,1,20,20
1745803994807,MCWP 50R,B00,893769,Carter; Jennifer A,0,0,20,20
1745803994807,MCWP 50R,C00,893771,Krone; Jarret,0,3,20,20
1745803994807,MCWP 50R,D00,893772,Miller; Elizabeth Deen,3,0,20,17
1745803994807,MCWP 50R,E00,893775,Carter; Andrea L,0,0,20,20
1745803995832,MMW 11R,A01,892721,Herbst; Matthew,11,0,27,16
1745803995832,MMW 11R,A02,892722,Herbst; Matthew,0,0,0,3
1745803996858,MMW 12R,A01,892724,Herbst; Matthew,0,9,16,16
1745803996858,MMW 12R,A02,892725,Herbst; Matthew,0,9,16,16
1745803997886,MMW 13R,A01,892727,Staff,0,4,16,16
1745803997886,MMW 13R,A02,892728,Staff,0,4,16,16
1745803997886,MMW 13R,A03,958032,Staff,0,3,16,16
1745803997886,MMW 13R,A04,958033,Staff,0,2,16,16
1745803997886,MMW 13R,A05,958034,Staff,0,3,16,16
1745803998910,SIO 295LS,A00,894015,Staff,7,0,25,18
1745803999943,SIO 295S,A00,894020,Staff,7,0,25,18
1745804000973,SIOC 290S,B01,958918,Staff,0,0,0,0
1745804002002,SIOC 291S,B01,958922,Staff,0,0,0,0
1745804003029,SOCI 117,A01,895339,Staff,4,0,5,1
1745804004054,WES 237B,A00,894149,Staff,11,0,20,9
1745804006120,AESE 279B,A00,891859,Staff,13,0,35,22
1745804007148,AIP 197,001,891854,Staff,70,0,70,0
1745804008175,ANTH 289S,A00,891856,Gagneux; Pascal,12,0,12,0
1745804009199,BENG 196,001,957946,Engler; Adam J.,9996,0,9999,3
1745804010227,CAT 124RS,A01,956906,Staff,8,0,25,17
1745804011255,CAT 125RS,A01,922013,Staff,8,0,25,17
1745804012281,CLRE 250,A00,891860,Morris; Sheldon,9995,0,9999,4
1745804014329,CLRE 251R,A00,907817,Mehta; Ravindra L.,9994,0,9999,5
1745804015354,CLRE 252,A00,891864,Cuomo; Raphael Eduardo,9993,0,9999,6
1745804016380,CLRE 253,A00,891867,Vaida; Florin,9994,0,9999,5
1745804016380,CLRE 253,B00,907819,Staff,9999,0,9999,0
1745804017406,CLRE 259,A00,891868,Patel; Hemal,9998,0,9999,1
1745804018430,CLRE 260,A00,891872,Cuomo; Raphael Eduardo,9999,0,9999,0
1745804019457,CLRE 297,001,891888,Cuomo; Raphael Eduardo,9999,0,9999,0
1745804020480,CSE 191,A00,958773,Minnes Kemp; Mor Mia,9999,0,9999,0
1745804021509,CSS 201S,A01,892054,Mignozzetti; Umberto,30,0,30,0
1745804022538,CSS 202S,A01,892056,Mignozzetti; Umberto,30,0,30,0
1745804023563,DSC 197,001,956898,Eldridge; Justin Matthew,9998,0,9999,1
1745804024589,DSC 297,001,958000,Mazumdar; Arya,9998,0,9999,1
1745804025614,EAP 100,A00,905686,Staff,9776,0,9999,223
1745804026637,ECE 45,A01,892618,Staff,0,12,50,50
1745804027665,ECE 109,A01,892620,Staff,0,43,0,0
1745804028692,ECE 111,A01,892719,Staff,0,7,50,50
1745804029716,ECE 197,001,957920,Mercier; Patrick Philip,9992,0,9999,7
1745804030742,ECON 178,A01,907814,Zhu; Ying,28,0,35,7
1745804031770,EDS 115,A00,895312,Staff,41,0,45,4
1745804032795,EDS 117,A01,895337,Staff,30,0,30,0
1745804033820,EDS 125,A00,895341,Jones; Gabrielle Anastasia,43,0,45,2
1745804034887,EDS 128A,A01,895459,Fargason; Sharon Gayle,44,0,45,1
1745804035915,EDS 128B,A01,895543,Pappas; Elizabeth,44,0,45,1
1745804036940,EDS 139,A00,897203,Pappas; Elizabeth,44,0,45,1
1745804036940,EDS 139,B00,897209,Fargason; Sharon Gayle,44,0,45,1
1745804037965,EDS 201,A00,895545,Staff,43,0,45,2
1745804039000,EDS 203,A01,895581,Halter; Christopher P.,43,0,45,2
1745804040029,EDS 204R,A01,895625,Heinzman; Erica M.,43,0,45,2
1745804040029,EDS 204R,B01,895693,Halter; Christopher P.,18,0,45,27
1745804041058,EDS 206R,A00,895694,Fargason; Sharon Gayle,9,0,30,21
1745804041058,EDS 206R,B00,895695,Choi; Bailey Miyeon,20,0,30,10
1745804042087,EDS 250,A00,895697,Hemans; Patricia Ann Benitez,43,0,45,2
1745804043116,EDS 281,A00,895701,Meyerott; Theresa Ann,15,0,15,0
1745804044141,EDS 284,A00,895736,Meyerott; Theresa Ann,15,0,15,0
1745804045170,EDS 286,A00,897210,Fine; Sarah,15,0,15,0
1745804046197,EDS 289C,A01,895770,Daly; Alan J.,15,0,15,0
1745804047222,EDS 290,A00,897211,Hofstetter; Carolyn,15,0,15,0
1745804048249,LIGM 5A,A00,896162,Fischer-Grunski; Eva K,15,0,20,5
1745804049278,LIGM 5B,A00,896260,Fischer-Grunski; Eva K,17,0,20,3
1745804050305,LIGM 5C,A00,896308,Fischer-Grunski; Eva K,18,0,20,2
1745804051331,LIIT 5AS,A00,896313,Carnelos; Chiara,18,0,20,2
1745804052360,LIIT 5BS,A00,896416,Carnelos; Chiara,20,0,20,0
1745804053389,LIIT 5CS,A00,896564,Carnelos; Chiara,20,0,20,0
1745804054416,LISP 5A,A00,896588,Munoz Sanchez; Alicia,4,0,20,16
1745804055441,LISP 5B,A00,896653,Munoz Sanchez; Alicia,10,0,20,10
1745804056466,LISP 5C,A00,896655,Munoz Sanchez; Alicia,4,0,20,16
1745804057492,MAE 197,001,957918,Kleissl; Jan,9998,0,9999,1
1745804058516,MATH 2,A01,957937,Staff,34,0,35,1
1745804059542,MATH 197,001,957876,Kedlaya; Kiran S.,9993,0,9999,6
1745804060566,MCWP 40,A00,892729,Duru; Nur,13,0,20,7
1745804060566,MCWP 40,B00,893304,Montejo; Carolina,20,0,20,0
1745804061592,MCWP 40R,A00,893757,Redela; Pamela Morgan,0,6,20,20
1745804062616,MCWP 50,A00,893758,Morshed; Michael James,2,0,20,18
1745804062616,MCWP 50,B00,893761,Bartulis; Jason Michael,17,0,20,3
1745804063646,MCWP 50R,A00,893766,Compas; Sean Matthew,0,1,20,20
1745804063646,MCWP 50R,B00,893769,Carter; Jennifer A,0,0,20,20
1745804063646,MCWP 50R,C00,893771,Krone; Jarret,0,3,20,20
1745804063646,MCWP 50R,D00,893772,Miller; Elizabeth Deen,3,0,20,17
1745804063646,MCWP 50R,E00,893775,Carter; Andrea L,0,0,20,20
1745804064676,MMW 11R,A01,892721,Herbst; Matthew,11,0,27,16
1745804064676,MMW 11R,A02,892722,Herbst; Matthew,0,0,0,3
1745804065699,MMW 12R,A01,892724,Herbst; Matthew,0,9,16,16
1745804065699,MMW 12R,A02,892725,Herbst; Matthew,0,9,16,16
1745804066731,MMW 13R,A01,892727,Staff,0,4,16,16
1745804066731,MMW 13R,A02,892728,Staff,0,4,16,16
1745804066731,MMW 13R,A03,958032,Staff,0,3,16,16
1745804066731,MMW 13R,A04,958033,Staff,0,2,16,16
1745804066731,MMW 13R,A05,958034,Staff,0,3,16,16
1745804067757,SIO 295LS,A00,894015,Staff,7,0,25,18
1745804068784,SIO 295S,A00,894020,Staff,7,0,25,18
1745804069813,SIOC 290S,B01,958918,Staff,0,0,0,0
1745804070838,SIOC 291S,B01,958922,Staff,0,0,0,0
1745804071865,SOCI 117,A01,895339,Staff,4,0,5,1
1745804072892,WES 237B,A00,894149,Staff,11,0,20,9
1745804074947,AESE 279B,A00,891859,Staff,13,0,35,22
1745804075974,AIP 197,001,891854,Staff,70,0,70,0
1745804077001,ANTH 289S,A00,891856,Gagneux; Pascal,12,0,12,0
1745804078025,BENG 196,001,957946,Engler; Adam J.,9996,0,9999,3
1745804079051,CAT 124RS,A01,956906,Staff,8,0,25,17
1745804080075,CAT 125RS,A01,922013,Staff,8,0,25,17
1745804081100,CLRE 250,A00,891860,Morris; Sheldon,9995,0,9999,4
1745804083149,CLRE 251R,A00,907817,Mehta; Ravindra L.,9994,0,9999,5
1745804084175,CLRE 252,A00,891864,Cuomo; Raphael Eduardo,9993,0,9999,6
1745804085202,CLRE 253,A00,891867,Vaida; Florin,9994,0,9999,5
1745804085202,CLRE 253,B00,907819,Staff,9999,0,9999,0
1745804086230,CLRE 259,A00,891868,Patel; Hemal,9998,0,9999,1
1745804087256,CLRE 260,A00,891872,Cuomo; Raphael Eduardo,9999,0,9999,0
1745804088279,CLRE 297,001,891888,Cuomo; Raphael Eduardo,9999,0,9999,0
1745804089304,CSE 191,A00,958773,Minnes Kemp; Mor Mia,9999,0,9999,0
1745804090333,CSS 201S,A01,892054,Mignozzetti; Umberto,30,0,30,0
1745804091360,CSS 202S,A01,892056,Mignozzetti; Umberto,30,0,30,0
1745804092393,DSC 197,001,956898,Eldridge; Justin Matthew,9998,0,9999,1
1745804093419,DSC 297,001,958000,Mazumdar; Arya,9998,0,9999,1
1745804094447,EAP 100,A00,905686,Staff,9776,0,9999,223
1745804095474,ECE 45,A01,892618,Staff,0,12,50,50
1745804096499,ECE 109,A01,892620,Staff,0,43,0,0
1745804097527,ECE 111,A01,892719,Staff,0,7,50,50
1745804098552,ECE 197,001,957920,Mercier; Patrick Philip,9992,0,9999,7
1745804099578,ECON 178,A01,907814,Zhu; Ying,28,0,35,7
1745804100606,EDS 115,A00,895312,Staff,41,0,45,4
1745804101631,EDS 117,A01,895337,Staff,30,0,30,0
1745804102662,EDS 125,A00,895341,Jones; Gabrielle Anastasia,43,0,45,2
1745804103693,EDS 128A,A01,895459,Fargason; Sharon Gayle,44,0,45,1
1745804104723,EDS 128B,A01,895543,Pappas; Elizabeth,44,0,45,1
1745804105750,EDS 139,A00,897203,Pappas; Elizabeth,44,0,45,1
1745804105750,EDS 139,B00,897209,Fargason; Sharon Gayle,44,0,45,1
1745804106779,EDS 201,A00,895545,Staff,43,0,45,2
1745804107808,EDS 203,A01,895581,Halter; Christopher P.,43,0,45,2
1745804108838,EDS 204R,A01,895625,Heinzman; Erica M.,43,0,45,2
1745804108838,EDS 204R,B01,895693,Halter; Christopher P.,18,0,45,27
1745804109863,EDS 206R,A00,895694,Fargason; Sharon Gayle,9,0,30,21
1745804109863,EDS 206R,B00,895695,Choi; Bailey Miyeon,20,0,30,10
1745804110890,EDS 250,A00,895697,Hemans; Patricia Ann Benitez,43,0,45,2
1745804111918,EDS 281,A00,895701,Meyerott; Theresa Ann,15,0,15,0
1745804112947,EDS 284,A00,895736,Meyerott; Theresa Ann,15,0,15,0
1745804113974,EDS 286,A00,897210,Fine; Sarah,15,0,15,0
1745804115001,EDS 289C,A01,895770,Daly; Alan J.,15,0,15,0
1745804116030,EDS 290,A00,897211,Hofstetter; Carolyn,15,0,15,0
1745804117056,LIGM 5A,A00,896162,Fischer-Grunski; Eva K,15,0,20,5
1745804118081,LIGM 5B,A00,896260,Fischer-Grunski; Eva K,17,0,20,3
1745804119108,LIGM 5C,A00,896308,Fischer-Grunski; Eva K,18,0,20,2
1745804120133,LIIT 5AS,A00,896313,Carnelos; Chiara,18,0,20,2
1745804121164,LIIT 5BS,A00,896416,Carnelos; Chiara,20,0,20,0
1745804122194,LIIT 5CS,A00,896564,Carnelos; Chiara,20,0,20,0
1745804123226,LISP 5A,A00,896588,Munoz Sanchez; Alicia,4,0,20,16
1745804124254,LISP 5B,A00,896653,Munoz Sanchez; Alicia,10,0,20,10
1745804125279,LISP 5C,A00,896655,Munoz Sanchez; Alicia,4,0,20,16
1745804126307,MAE 197,001,957918,Kleissl; Jan,9998,0,9999,1
1745804127335,MATH 2,A01,957937,Staff,34,0,35,1
1745804128362,MATH 197,001,957876,Kedlaya; Kiran S.,9993,0,9999,6
1745804129389,MCWP 40,A00,892729,Duru; Nur,13,0,20,7
1745804129389,MCWP 40,B00,893304,Montejo; Carolina,20,0,20,0
1745804130416,MCWP 40R,A00,893757,Redela; Pamela Morgan,0,6,20,20
1745804131442,MCWP 50,A00,893758,Morshed; Michael James,2,0,20,18
1745804131442,MCWP 50,B00,893761,Bartulis; Jason Michael,17,0,20,3
1745804132470,MCWP 50R,A00,893766,Compas; Sean Matthew,0,1,20,20
1745804132470,MCWP 50R,B00,893769,Carter; Jennifer A,0,0,20,20
1745804132470,MCWP 50R,C00,893771,Krone; Jarret,0,3,20,20
1745804132470,MCWP 50R,D00,893772,Miller; Elizabeth Deen,3,0,20,17
1745804132470,MCWP 50R,E00,893775,Carter; Andrea L,0,0,20,20
1745804133498,MMW 11R,A01,892721,Herbst; Matthew,11,0,27,16
1745804133498,MMW 11R,A02,892722,Herbst; Matthew,0,0,0,3
1745804134523,MMW 12R,A01,892724,Herbst; Matthew,0,9,16,16
1745804134523,MMW 12R,A02,892725,Herbst; Matthew,0,9,16,16
1745804135550,MMW 13R,A01,892727,Staff,0,4,16,16
1745804135550,MMW 13R,A02,892728,Staff,0,4,16,16
1745804135550,MMW 13R,A03,958032,Staff,0,3,16,16
1745804135550,MMW 13R,A04,958033,Staff,0,2,16,16
1745804135550,MMW 13R,A05,958034,Staff,0,3,16,16
1745804136579,SIO 295LS,A00,894015,Staff,7,0,25,18
1745804137605,SIO 295S,A00,894020,Staff,7,0,25,18
1745804138635,SIOC 290S,B01,958918,Staff,0,0,0,0
1745804139665,SIOC 291S,B01,958922,Staff,0,0,0,0
1745804140691,SOCI 117,A01,895339,Staff,4,0,5,1
1745804141717,WES 237B,A00,894149,Staff,11,0,20,9
1745804143782,AESE 279B,A00,891859,Staff,13,0,35,22
1745804144808,AIP 197,001,891854,Staff,70,0,70,0
1745804145834,ANTH 289S,A00,891856,Gagneux; Pascal,12,0,12,0
1745804146859,BENG 196,001,957946,Engler; Adam J.,9996,0,9999,3
1745804147886,CAT 124RS,A01,956906,Staff,8,0,25,17
1745804148913,CAT 125RS,A01,922013,Staff,8,0,25,17
1745804149938,CLRE 250,A00,891860,Morris; Sheldon,9995,0,9999,4
1745804151990,CLRE 251R,A00,907817,Mehta; Ravindra L.,9994,0,9999,5
1745804153016,CLRE 252,A00,891864,Cuomo; Raphael Eduardo,9993,0,9999,6
1745804154042,CLRE 253,A00,891867,Vaida; Florin,9994,0,9999,5
1745804154042,CLRE 253,B00,907819,Staff,9999,0,9999,0
1745804155068,CLRE 259,A00,891868,Patel; Hemal,9998,0,9999,1
1745804156096,CLRE 260,A00,891872,Cuomo; Raphael Eduardo,9999,0,9999,0
1745804157123,CLRE 297,001,891888,Cuomo; Raphael Eduardo,9999,0,9999,0
1745804158151,CSE 191,A00,958773,Minnes Kemp; Mor Mia,9999,0,9999,0
1745804159177,CSS 201S,A01,892054,Mignozzetti; Umberto,30,0,30,0
1745804160204,CSS 202S,A01,892056,Mignozzetti; Umberto,30,0,30,0
1745804161231,DSC 197,001,956898,Eldridge; Justin Matthew,9998,0,9999,1
1745804162258,DSC 297,001,958000,Mazumdar; Arya,9998,0,9999,1
1745804163287,EAP 100,A00,905686,Staff,9776,0,9999,223
1745804164318,ECE 45,A01,892618,Staff,0,12,50,50
1745804165345,ECE 109,A01,892620,Staff,0,43,0,0
1745804166370,ECE 111,A01,892719,Staff,0,7,50,50
1745804167398,ECE 197,001,957920,Mercier; Patrick Philip,9992,0,9999,7
1745804168423,ECON 178,A01,907814,Zhu; Ying,28,0,35,7
1745804169452,EDS 115,A00,895312,Staff,41,0,45,4
1745804170479,EDS 117,A01,895337,Staff,30,0,30,0
1745804171512,EDS 125,A00,895341,Jones; Gabrielle Anastasia,43,0,45,2
1745804172538,EDS 128A,A01,895459,Fargason; Sharon Gayle,44,0,45,1
1745804173565,EDS 128B,A01,895543,Pappas; Elizabeth,44,0,45,1
1745804174591,EDS 139,A00,897203,Pappas; Elizabeth,44,0,45,1
1745804174591,EDS 139,B00,897209,Fargason; Sharon Gayle,44,0,45,1
1745804175620,EDS 201,A00,895545,Staff,43,0,45,2
1745804176646,EDS 203,A01,895581,Halter; Christopher P.,43,0,45,2
1745804177672,EDS 204R,A01,895625,Heinzman; Erica M.,43,0,45,2
1745804177672,EDS 204R,B01,895693,Halter; Christopher P.,18,0,45,27
1745804178698,EDS 206R,A00,895694,Fargason; Sharon Gayle,9,0,30,21
1745804178698,EDS 206R,B00,895695,Choi; Bailey Miyeon,20,0,30,10
1745804179726,EDS 250,A00,895697,Hemans; Patricia Ann Benitez,43,0,45,2
1745804180754,EDS 281,A00,895701,Meyerott; Theresa Ann,15,0,15,0
1745804181782,EDS 284,A00,895736,Meyerott; Theresa Ann,15,0,15,0
1745804182808,EDS 286,A00,897210,Fine; Sarah,15,0,15,0
1745804183835,EDS 289C,A01,895770,Daly; Alan J.,15,0,15,0
1745804184863,EDS 290,A00,897211,Hofstetter; Carolyn,15,0,15,0
1745804185893,LIGM 5A,A00,896162,Fischer-Grunski; Eva K,15,0,20,5
1745804186918,LIGM 5B,A00,896260,Fischer-Grunski; Eva K,17,0,20,3
1745804187947,LIGM 5C,A00,896308,Fischer-Grunski; Eva K,18,0,20,2
1745804188974,LIIT 5AS,A00,896313,Carnelos; Chiara,18,0,20,2
1745804190000,LIIT 5BS,A00,896416,Carnelos; Chiara,20,0,20,0
1745804191026,LIIT 5CS,A00,896564,Carnelos; Chiara,20,0,20,0
1745804192052,LISP 5A,A00,896588,Munoz Sanchez; Alicia,4,0,20,16
1745804193078,LISP 5B,A00,896653,Munoz Sanchez; Alicia,10,0,20,10
1745804194107,LISP 5C,A00,896655,Munoz Sanchez; Alicia,4,0,20,16
1745804195132,MAE 197,001,957918,Kleissl; Jan,9998,0,9999,1
1745804196159,MATH 2,A01,957937,Staff,34,0,35,1
1745804197184,MATH 197,001,957876,Kedlaya; Kiran S.,9993,0,9999,6
1745804198213,MCWP 40,A00,892729,Duru; Nur,13,0,20,7
1745804198213,MCWP 40,B00,893304,Montejo; Carolina,20,0,20,0
1745804199239,MCWP 40R,A00,893757,Redela; Pamela Morgan,0,6,20,20
1745804200265,MCWP 50,A00,893758,Morshed; Michael James,2,0,20,18
1745804200265,MCWP 50,B00,893761,Bartulis; Jason Michael,17,0,20,3
1745804201295,MCWP 50R,A00,893766,Compas; Sean Matthew,0,1,20,20
1745804201295,MCWP 50R,B00,893769,Carter; Jennifer A,0,0,20,20
1745804201295,MCWP 50R,C00,893771,Krone; Jarret,0,3,20,20
1745804201295,MCWP 50R,D00,893772,Miller; Elizabeth Deen,3,0,20,17
1745804201295,MCWP 50R,E00,893775,Carter; Andrea L,0,0,20,20
1745804202320,MMW 11R,A01,892721,Herbst; Matthew,11,0,27,16
1745804202320,MMW 11R,A02,892722,Herbst; Matthew,0,0,0,3
1745804203344,MMW 12R,A01,892724,Herbst; Matthew,0,9,16,16
1745804203344,MMW 12R,A02,892725,Herbst; Matthew,0,9,16,16
1745804204373,MMW 13R,A01,892727,Staff,0,4,16,16
1745804204373,MMW 13R,A02,892728,Staff,0,4,16,16
1745804204373,MMW 13R,A03,958032,Staff,0,3,16,16
1745804204373,MMW 13R,A04,958033,Staff,0,2,16,16
1745804204373,MMW 13R,A05,958034,Staff,0,3,16,16
1745804205399,SIO 295LS,A00,894015,Staff,7,0,25,18
1745804206427,SIO 295S,A00,894020,Staff,7,0,25,18
1745804207452,SIOC 290S,B01,958918,Staff,0,0,0,0
1745804208479,SIOC 291S,B01,958922,Staff,0,0,0,0
1745804209504,SOCI 117,A01,895339,Staff,4,0,5,1
1745804210531,WES 237B,A00,894149,Staff,11,0,20,9
1745804212591,AESE 279B,A00,891859,Staff,13,0,35,22
1745804213618,AIP 197,001,891854,Staff,70,0,70,0
1745804214645,ANTH 289S,A00,891856,Gagneux; Pascal,12,0,12,0
1745804215670,BENG 196,001,957946,Engler; Adam J.,9996,0,9999,3
1745804216699,CAT 124RS,A01,956906,Staff,8,0,25,17
1745804217725,CAT 125RS,A01,922013,Staff,8,0,25,17
1745804218750,CLRE 250,A00,891860,Morris; Sheldon,9995,0,9999,4
1745804220805,CLRE 251R,A00,907817,Mehta; Ravindra L.,9994,0,9999,5
1745804221831,CLRE 252,A00,891864,Cuomo; Raphael Eduardo,9993,0,9999,6
1745804222856,CLRE 253,A00,891867,Vaida; Florin,9994,0,9999,5
1745804222856,CLRE 253,B00,907819,Staff,9999,0,9999,0
1745804223886,CLRE 259,A00,891868,Patel; Hemal,9998,0,9999,1
1745804224914,CLRE 260,A00,891872,Cuomo; Raphael Eduardo,9999,0,9999,0
1745804225940,CLRE 297,001,891888,Cuomo; Raphael Eduardo,9999,0,9999,0
1745804226966,CSE 191,A00,958773,Minnes Kemp; Mor Mia,9999,0,9999,0
1745804227993,CSS 201S,A01,892054,Mignozzetti; Umberto,30,0,30,0
1745804229023,CSS 202S,A01,892056,Mignozzetti; Umberto,30,0,30,0
1745804230050,DSC 197,001,956898,Eldridge; Justin Matthew,9998,0,9999,1
1745804231076,DSC 297,001,958000,Mazumdar; Arya,9998,0,9999,1
1745804232103,EAP 100,A00,905686,Staff,9776,0,9999,223
1745804233132,ECE 45,A01,892618,Staff,0,12,50,50
1745804234159,ECE 109,A01,892620,Staff,0,43,0,0
1745804235189,ECE 111,A01,892719,Staff,0,7,50,50
1745804236227,ECE 197,001,957920,Mercier; Patrick Philip,9992,0,9999,7
1745804237252,ECON 178,A01,907814,Zhu; Ying,28,0,35,7
1745804238278,EDS 115,A00,895312,Staff,41,0,45,4
1745804239308,EDS 117,A01,895337,Staff,30,0,30,0
1745804240334,EDS 125,A00,895341,Jones; Gabrielle Anastasia,43,0,45,2
1745804241360,EDS 128A,A01,895459,Fargason; Sharon Gayle,44,0,45,1
1745804242395,EDS 128B,A01,895543,Pappas; Elizabeth,44,0,45,1
1745804243422,EDS 139,A00,897203,Pappas; Elizabeth,44,0,45,1
1745804243422,EDS 139,B00,897209,Fargason; Sharon Gayle,44,0,45,1
1745804244451,EDS 201,A00,895545,Staff,43,0,45,2
1745804245476,EDS 203,A01,895581,Halter; Christopher P.,43,0,45,2
1745804246505,EDS 204R,A01,895625,Heinzman; Erica M.,43,0,45,2
1745804246505,EDS 204R,B01,895693,Halter; Christopher P.,18,0,45,27
1745804247535,EDS 206R,A00,895694,Fargason; Sharon Gayle,9,0,30,21
1745804247535,EDS 206R,B00,895695,Choi; Bailey Miyeon,20,0,30,10
1745804248560,EDS 250,A00,895697,Hemans; Patricia Ann Benitez,43,0,45,2
1745804249587,EDS 281,A00,895701,Meyerott; Theresa Ann,15,0,15,0
1745804250612,EDS 284,A00,895736,Meyerott; Theresa Ann,15,0,15,0
1745804251639,EDS 286,A00,897210,Fine; Sarah,15,0,15,0
1745804252666,EDS 289C,A01,895770,Daly; Alan J.,15,0,15,0
1745804253691,EDS 290,A00,897211,Hofstetter; Carolyn,15,0,15,0
1745804254720,LIGM 5A,A00,896162,Fischer-Grunski; Eva K,15,0,20,5
1745804255744,LIGM 5B,A00,896260,Fischer-Grunski; Eva K,17,0,20,3
1745804256772,LIGM 5C,A00,896308,Fischer-Grunski; Eva K,18,0,20,2
1745804257799,LIIT 5AS,A00,896313,Carnelos; Chiara,18,0,20,2
1745804258824,LIIT 5BS,A00,896416,Carnelos; Chiara,20,0,20,0
1745804259853,LIIT 5CS,A00,896564,Carnelos; Chiara,20,0,20,0
1745804260882,LISP 5A,A00,896588,Munoz Sanchez; Alicia,4,0,20,16
1745804261907,LISP 5B,A00,896653,Munoz Sanchez; Alicia,10,0,20,10
1745804262934,LISP 5C,A00,896655,Munoz Sanchez; Alicia,4,0,20,16
1745804263959,MAE 197,001,957918,Kleissl; Jan,9998,0,9999,1
1745804264985,MATH 2,A01,957937,Staff,34,0,35,1
1745804266012,MATH 197,001,957876,Kedlaya; Kiran S.,9993,0,9999,6
1745804267038,MCWP 40,A00,892729,Duru; Nur,13,0,20,7
1745804267038,MCWP 40,B00,893304,Montejo; Carolina,20,0,20,0
1745804268067,MCWP 40R,A00,893757,Redela; Pamela Morgan,0,6,20,20
1745804269093,MCWP 50,A00,893758,Morshed; Michael James,2,0,20,18
1745804269093,MCWP 50,B00,893761,Bartulis; Jason Michael,17,0,20,3
1745804270121,MCWP 50R,A00,893766,Compas; Sean Matthew,0,1,20,20
1745804270121,MCWP 50R,B00,893769,Carter; Jennifer A,0,0,20,20
1745804270121,MCWP 50R,C00,893771,Krone; Jarret,0,3,20,20
1745804270121,MCWP 50R,D00,893772,Miller; Elizabeth Deen,3,0,20,17
1745804270121,MCWP 50R,E00,893775,Carter; Andrea L,0,0,20,20
1745804271148,MMW 11R,A01,892721,Herbst; Matthew,11,0,27,16
1745804271148,MMW 11R,A02,892722,Herbst; Matthew,0,0,0,3
1745804272177,MMW 12R,A01,892724,Herbst; Matthew,0,9,16,16
1745804272177,MMW 12R,A02,892725,Herbst; Matthew,0,9,16,16
1745804273206,MMW 13R,A01,892727,Staff,0,4,16,16
1745804273206,MMW 13R,A02,892728,Staff,0,4,16,16
1745804273206,MMW 13R,A03,958032,Staff,0,3,16,16
1745804273206,MMW 13R,A04,958033,Staff,0,2,16,16
1745804273206,MMW 13R,A05,958034,Staff,0,3,16,16
1745804274232,SIO 295LS,A00,894015,Staff,7,0,25,18
1745804275258,SIO 295S,A00,894020,Staff,7,0,25,18
1745804276285,SIOC 290S,B01,958918,Staff,0,0,0,0
1745804277311,SIOC 291S,B01,958922,Staff,0,0,0,0
1745804278339,SOCI 117,A01,895339,Staff,4,0,5,1
1745804279365,WES 237B,A00,894149,Staff,11,0,20,9
1745804281429,AESE 279B,A00,891859,Staff,13,0,35,22
1745804282457,AIP 197,001,891854,Staff,70,0,70,0
1745804283483,ANTH 289S,A00,891856,Gagneux; Pascal,12,0,12,0
1745804284507,BENG 196,001,957946,Engler; Adam J.,9996,0,9999,3
1745804285540,CAT 124RS,A01,956906,Staff,8,0,25,17
1745804286568,CAT 125RS,A01,922013,Staff,8,0,25,17
1745804287597,CLRE 250,A00,891860,Morris; Sheldon,9995,0,9999,4
1745804289651,CLRE 251R,A00,907817,Mehta; Ravindra L.,9994,0,9999,5
1745804290681,CLRE 252,A00,891864,Cuomo; Raphael Eduardo,9993,0,9999,6
1745804291706,CLRE 253,A00,891867,Vaida; Florin,9994,0,9999,5
1745804291706,CLRE 253,B00,907819,Staff,9999,0,9999,0
1745804292734,CLRE 259,A00,891868,Patel; Hemal,9998,0,9999,1
1745804293783,CLRE 260,A00,891872,Cuomo; Raphael Eduardo,9999,0,9999,0
1745804294808,CLRE 297,001,891888,Cuomo; Raphael Eduardo,9999,0,9999,0
1745804295835,CSE 191,A00,958773,Minnes Kemp; Mor Mia,9999,0,9999,0
1745804296859,CSS 201S,A01,892054,Mignozzetti; Umberto,30,0,30,0
1745804297888,CSS 202S,A01,892056,Mignozzetti; Umberto,30,0,30,0
1745804298913,DSC 197,001,956898,Eldridge; Justin Matthew,9998,0,9999,1
1745804299940,DSC 297,001,958000,Mazumdar; Arya,9998,0,9999,1
1745804300967,EAP 100,A00,905686,Staff,9776,0,9999,223
1745804301997,ECE 45,A01,892618,Staff,0,12,50,50
1745804303022,ECE 109,A01,892620,Staff,0,43,0,0
1745804304048,ECE 111,A01,892719,Staff,0,7,50,50
1745804305076,ECE 197,001,957920,Mercier; Patrick Philip,9992,0,9999,7
1745804306104,ECON 178,A01,907814,Zhu; Ying,28,0,35,7
1745804307129,EDS 115,A00,895312,Staff,41,0,45,4
1745804308154,EDS 117,A01,895337,Staff,30,0,30,0
1745804309181,EDS 125,A00,895341,Jones; Gabrielle Anastasia,43,0,45,2
1745804310207,EDS 128A,A01,895459,Fargason; Sharon Gayle,44,0,45,1
1745804311233,EDS 128B,A01,895543,Pappas; Elizabeth,44,0,45,1
1745804312259,EDS 139,A00,897203,Pappas; Elizabeth,44,0,45,1
1745804312259,EDS 139,B00,897209,Fargason; Sharon Gayle,44,0,45,1
1745804313285,EDS 201,A00,895545,Staff,43,0,45,2
1745804314309,EDS 203,A01,895581,Halter; Christopher P.,43,0,45,2
1745804315336,EDS 204R,A01,895625,Heinzman; Erica M.,43,0,45,2
1745804315336,EDS 204R,B01,895693,Halter; Christopher P.,18,0,45,27
1745804316362,EDS 206R,A00,895694,Fargason; Sharon Gayle,9,0,30,21
1745804316362,EDS 206R,B00,895695,Choi; Bailey Miyeon,20,0,30,10
1745804317387,EDS 250,A00,895697,Hemans; Patricia Ann Benitez,43,0,45,2
1745804318412,EDS 281,A00,895701,Meyerott; Theresa Ann,15,0,15,0
1745804319440,EDS 284,A00,895736,Meyerott; Theresa Ann,15,0,15,0
1745804320465,EDS 286,A00,897210,Fine; Sarah,15,0,15,0
1745804321492,EDS 289C,A01,895770,Daly; Alan J.,15,0,15,0
1745804322520,EDS 290,A00,897211,Hofstetter; Carolyn,15,0,15,0
1745804323548,LIGM 5A,A00,896162,Fischer-Grunski; Eva K,15,0,20,5
1745804324575,LIGM 5B,A00,896260,Fischer-Grunski; Eva K,17,0,20,3
1745804325604,LIGM 5C,A00,896308,Fischer-Grunski; Eva K,18,0,20,2
1745804326628,LIIT 5AS,A00,896313,Carnelos; Chiara,18,0,20,2
1745804327652,LIIT 5BS,A00,896416,Carnelos; Chiara,20,0,20,0
1745804328677,LIIT 5CS,A00,896564,Carnelos; Chiara,20,0,20,0
1745804329702,LISP 5A,A00,896588,Munoz Sanchez; Alicia,4,0,20,16
1745804330747,LISP 5B,A00,896653,Munoz Sanchez; Alicia,10,0,20,10
1745804331773,LISP 5C,A00,896655,Munoz Sanchez; Alicia,4,0,20,16
1745804332798,MAE 197,001,957918,Kleissl; Jan,9998,0,9999,1
1745804333824,MATH 2,A01,957937,Staff,34,0,35,1
1745804334850,MATH 197,001,957876,Kedlaya; Kiran S.,9993,0,9999,6
1745804335877,MCWP 40,A00,892729,Duru; Nur,13,0,20,7
1745804335877,MCWP 40,B00,893304,Montejo; Carolina,20,0,20,0
1745804336903,MCWP 40R,A00,893757,Redela; Pamela Morgan,0,6,20,20
1745804337932,MCWP 50,A00,893758,Morshed; Michael James,2,0,20,18
1745804337932,MCWP 50,B00,893761,Bartulis; Jason Michael,17,0,20,3
1745804338960,MCWP 50R,A00,893766,Compas; Sean Matthew,0,1,20,20
1745804338960,MCWP 50R,B00,893769,Carter; Jennifer A,0,0,20,20
1745804338960,MCWP 50R,C00,893771,Krone; Jarret,0,3,20,20
1745804338960,MCWP 50R,D00,893772,Miller; Elizabeth Deen,3,0,20,17
1745804338960,MCWP 50R,E00,893775,Carter; Andrea L,0,0,20,20
1745804339985,MMW 11R,A01,892721,Herbst; Matthew,11,0,27,16
1745804339985,MMW 11R,A02,892722,Herbst; Matthew,0,0,0,3
1745804341015,MMW 12R,A01,892724,Herbst; Matthew,0,9,16,16
1745804341015,MMW 12R,A02,892725,Herbst; Matthew,0,9,16,16
1745804342041,MMW 13R,A01,892727,Staff,0,4,16,16
1745804342041,MMW 13R,A02,892728,Staff,0,4,16,16
1745804342041,MMW 13R,A03,958032,Staff,0,3,16,16
1745804342041,MMW 13R,A04,958033,Staff,0,2,16,16
1745804342041,MMW 13R,A05,958034,Staff,0,3,16,16
1745804343067,SIO 295LS,A00,894015,Staff,7,0,25,18
1745804344093,SIO 295S,A00,894020,Staff,7,0,25,18
1745804345125,SIOC 290S,B01,958918,Staff,0,0,0,0
1745804346154,SIOC 291S,B01,958922,Staff,0,0,0,0
1745804347182,SOCI 117,A01,895339,Staff,4,0,5,1
1745804348208,WES 237B,A00,894149,Staff,11,0,20,9
1745804350323,AESE 279B,A00,891859,Staff,13,0,35,22
1745804351351,AIP 197,001,891854,Staff,70,0,70,0
1745804352395,ANTH 289S,A00,891856,Gagneux; Pascal,12,0,12,0
1745804353420,BENG 196,001,957946,Engler; Adam J.,9996,0,9999,3
1745804354448,CAT 124RS,A01,956906,Staff,8,0,25,17
1745804355474,CAT 125RS,A01,922013,Staff,8,0,25,17
1745804356501,CLRE 250,A00,891860,Morris; Sheldon,9995,0,9999,4
1745804358555,CLRE 251R,A00,907817,Mehta; Ravindra L.,9994,0,9999,5
1745804359582,CLRE 252,A00,891864,Cuomo; Raphael Eduardo,9993,0,9999,6
1745804360607,CLRE 253,A00,891867,Vaida; Florin,9994,0,9999,5
1745804360607,CLRE 253,B00,907819,Staff,9999,0,9999,0
1745804361636,CLRE 259,A00,891868,Patel; Hemal,9998,0,9999,1
1745804362660,CLRE 260,A00,891872,Cuomo; Raphael Eduardo,9999,0,9999,0
1745804363686,CLRE 297,001,891888,Cuomo; Raphael Eduardo,9999,0,9999,0
1745804364712,CSE 191,A00,958773,Minnes Kemp; Mor Mia,9999,0,9999,0
1745804365742,CSS 201S,A01,892054,Mignozzetti; Umberto,30,0,30,0
1745804366767,CSS 202S,A01,892056,Mignozzetti; Umberto,30,0,30,0
1745804367793,DSC 197,001,956898,Eldridge; Justin Matthew,9998,0,9999,1
1745804368821,DSC 297,001,958000,Mazumdar; Arya,9998,0,9999,1
1745804369846,EAP 100,A00,905686,Staff,9776,0,9999,223
1745804370874,ECE 45,A01,892618,Staff,0,12,50,50
1745804371899,ECE 109,A01,892620,Staff,0,43,0,0
1745804372924,ECE 111,A01,892719,Staff,0,7,50,50
1745804373950,ECE 197,001,957920,Mercier; Patrick Philip,9992,0,9999,7
1745804374979,ECON 178,A01,907814,Zhu; Ying,28,0,35,7
1745804376004,EDS 115,A00,895312,Staff,41,0,45,4
1745804377033,EDS 117,A01,895337,Staff,30,0,30,0
1745804378058,EDS 125,A00,895341,Jones; Gabrielle Anastasia,43,0,45,2
1745804379086,EDS 128A,A01,895459,Fargason; Sharon Gayle,44,0,45,1
1745804380113,EDS 128B,A01,895543,Pappas; Elizabeth,44,0,45,1
1745804381137,EDS 139,A00,897203,Pappas; Elizabeth,44,0,45,1
1745804381137,EDS 139,B00,897209,Fargason; Sharon Gayle,44,0,45,1
1745804382164,EDS 201,A00,895545,Staff,43,0,45,2
1745804383189,EDS 203,A01,895581,Halter; Christopher P.,43,0,45,2
1745804384213,EDS 204R,A01,895625,Heinzman; Erica M.,43,0,45,2
1745804384213,EDS 204R,B01,895693,Halter; Christopher P.,18,0,45,27
1745804385238,EDS 206R,A00,895694,Fargason; Sharon Gayle,9,0,30,21
1745804385238,EDS 206R,B00,895695,Choi; Bailey Miyeon,20,0,30,10
1745804386267,EDS 250,A00,895697,Hemans; Patricia Ann Benitez,43,0,45,2
1745804387295,EDS 281,A00,895701,Meyerott; Theresa Ann,15,0,15,0
1745804388319,EDS 284,A00,895736,Meyerott; Theresa Ann,15,0,15,0
1745804389347,EDS 286,A00,897210,Fine; Sarah,15,0,15,0
1745804390374,EDS 289C,A01,895770,Daly; Alan J.,15,0,15,0
1745804391398,EDS 290,A00,897211,Hofstetter; Carolyn,15,0,15,0
1745804392424,LIGM 5A,A00,896162,Fischer-Grunski; Eva K,15,0,20,5
1745804393450,LIGM 5B,A00,896260,Fischer-Grunski; Eva K,17,0,20,3
1745804394474,LIGM 5C,A00,896308,Fischer-Grunski; Eva K,18,0,20,2
1745804395498,LIIT 5AS,A00,896313,Carnelos; Chiara,18,0,20,2
1745804396526,LIIT 5BS,A00,896416,Carnelos; Chiara,20,0,20,0
1745804397553,LIIT 5CS,A00,896564,Carnelos; Chiara,20,0,20,0
1745804398583,LISP 5A,A00,896588,Munoz Sanchez; Alicia,4,0,20,16
1745804399608,LISP 5B,A00,896653,Munoz Sanchez; Alicia,10,0,20,10
1745804400636,LISP 5C,A00,896655,Munoz Sanchez; Alicia,4,0,20,16
1745804401663,MAE 197,001,957918,Kleissl; Jan,9998,0,9999,1
1745804402692,MATH 2,A01,957937,Staff,34,0,35,1
1745804403724,MATH 197,001,957876,Kedlaya; Kiran S.,9993,0,9999,6
1745804404750,MCWP 40,A00,892729,Duru; Nur,13,0,20,7
1745804404750,MCWP 40,B00,893304,Montejo; Carolina,20,0,20,0
1745804405780,MCWP 40R,A00,893757,Redela; Pamela Morgan,0,6,20,20
1745804406808,MCWP 50,A00,893758,Morshed; Michael James,2,0,20,18
1745804406808,MCWP 50,B00,893761,Bartulis; Jason Michael,17,0,20,3
1745804407839,MCWP 50R,A00,893766,Compas; Sean Matthew,0,1,20,20
1745804407839,MCWP 50R,B00,893769,Carter; Jennifer A,0,0,20,20
1745804407839,MCWP 50R,C00,893771,Krone; Jarret,0,3,20,20
1745804407839,MCWP 50R,D00,893772,Miller; Elizabeth Deen,3,0,20,17
1745804407839,MCWP 50R,E00,893775,Carter; Andrea L,0,0,20,20
1745804408867,MMW 11R,A01,892721,Herbst; Matthew,11,0,27,16
1745804408867,MMW 11R,A02,892722,Herbst; Matthew,0,0,0,3
1745804409897,MMW 12R,A01,892724,Herbst; Matthew,0,9,16,16
1745804409897,MMW 12R,A02,892725,Herbst; Matthew,0,9,16,16
1745804410924,MMW 13R,A01,892727,Staff,0,4,16,16
1745804410924,MMW 13R,A02,892728,Staff,0,4,16,16
1745804410924,MMW 13R,A03,958032,Staff,0,3,16,16
1745804410924,MMW 13R,A04,958033,Staff,0,2,16,16
1745804410924,MMW 13R,A05,958034,Staff,0,3,16,16
1745804411949,SIO 295LS,A00,894015,Staff,7,0,25,18
1745804412975,SIO 295S,A00,894020,Staff,7,0,25,18
1745804414005,SIOC 290S,B01,958918,Staff,0,0,0,0
1745804415040,SIOC 291S,B01,958922,Staff,0,0,0,0
1745804416064,SOCI 117,A01,895339,Staff,4,0,5,1
1745804417092,WES 237B,A00,894149,Staff,11,0,20,9
1745804419156,AESE 279B,A00,891859,Staff,13,0,35,22
1745804420182,AIP 197,001,891854,Staff,70,0,70,0
1745804421208,ANTH 289S,A00,891856,Gagneux; Pascal,12,0,12,0
1745804422235,BENG 196,001,957946,Engler; Adam J.,9996,0,9999,3
1745804423266,CAT 124RS,A01,956906,Staff,8,0,25,17
1745804424294,CAT 125RS,A01,922013,Staff,8,0,25,17
1745804425321,CLRE 250,A00,891860,Morris; Sheldon,9995,0,9999,4
1745804427377,CLRE 251R,A00,907817,Mehta; Ravindra L.,9994,0,9999,5
1745804428402,CLRE 252,A00,891864,Cuomo; Raphael Eduardo,9993,0,9999,6
1745804429430,CLRE 253,A00,891867,Vaida; Florin,9994,0,9999,5
1745804429430,CLRE 253,B00,907819,Staff,9999,0,9999,0
1745804430457,CLRE 259,A00,891868,Patel; Hemal,9998,0,9999,1
1745804431482,CLRE 260,A00,891872,Cuomo; Raphael Eduardo,9999,0,9999,0
1745804432511,CLRE 297,001,891888,Cuomo; Raphael Eduardo,9999,0,9999,0
1745804433538,CSE 191,A00,958773,Minnes Kemp; Mor Mia,9999,0,9999,0
1745804434563,CSS 201S,A01,892054,Mignozzetti; Umberto,30,0,30,0
1745804435625,CSS 202S,A01,892056,Mignozzetti; Umberto,30,0,30,0
1745804436651,DSC 197,001,956898,Eldridge; Justin Matthew,9998,0,9999,1
1745804437679,DSC 297,001,958000,Mazumdar; Arya,9998,0,9999,1
1745804438705,EAP 100,A00,905686,Staff,9776,0,9999,223
1745804439731,ECE 45,A01,892618,Staff,0,12,50,50
1745804440756,ECE 109,A01,892620,Staff,0,43,0,0
1745804441784,ECE 111,A01,892719,Staff,0,7,50,50
1745804442811,ECE 197,001,957920,Mercier; Patrick Philip,9992,0,9999,7
1745804443839,ECON 178,A01,907814,Zhu; Ying,28,0,35,7
1745804444863,EDS 115,A00,895312,Staff,41,0,45,4
1745804445889,EDS 117,A01,895337,Staff,30,0,30,0
1745804446918,EDS 125,A00,895341,Jones; Gabrielle Anastasia,43,0,45,2
1745804447949,EDS 128A,A01,895459,Fargason; Sharon Gayle,44,0,45,1
1745804448977,EDS 128B,A01,895543,Pappas; Elizabeth,44,0,45,1
1745804450008,EDS 139,A00,897203,Pappas; Elizabeth,44,0,45,1
1745804450008,EDS 139,B00,897209,Fargason; Sharon Gayle,44,0,45,1
1745804451035,EDS 201,A00,895545,Staff,43,0,45,2
1745804452064,EDS 203,A01,895581,Halter; Christopher P.,43,0,45,2
1745804453091,EDS 204R,A01,895625,Heinzman; Erica M.,43,0,45,2
1745804453091,EDS 204R,B01,895693,Halter; Christopher P.,18,0,45,27
1745804454117,EDS 206R,A00,895694,Fargason; Sharon Gayle,9,0,30,21
1745804454117,EDS 206R,B00,895695,Choi; Bailey Miyeon,20,0,30,10
1745804455144,EDS 250,A00,895697,Hemans; Patricia Ann Benitez,43,0,45,2
1745804456171,EDS 281,A00,895701,Meyerott; Theresa Ann,15,0,15,0
1745804457199,EDS 284,A00,895736,Meyerott; Theresa Ann,15,0,15,0
1745804458226,EDS 286,A00,897210,Fine; Sarah,15,0,15,0
1745804459252,EDS 289C,A01,895770,Daly; Alan J.,15,0,15,0
1745804460277,EDS 290,A00,897211,Hofstetter; Carolyn,15,0,15,0
1745804461302,LIGM 5A,A00,896162,Fischer-Grunski; Eva K,15,0,20,5
1745804462327,LIGM 5B,A00,896260,Fischer-Grunski; Eva K,17,0,20,3
1745804463368,LIGM 5C,A00,896308,Fischer-Grunski; Eva K,18,0,20,2
1745804464397,LIIT 5AS,A00,896313,Carnelos; Chiara,18,0,20,2
1745804465426,LIIT 5BS,A00,896416,Carnelos; Chiara,20,0,20,0
1745804466451,LIIT 5CS,A00,896564,Carnelos; Chiara,20,0,20,0
1745804467477,LISP 5A,A00,896588,Munoz Sanchez; Alicia,4,0,20,16
1745804468507,LISP 5B,A00,896653,Munoz Sanchez; Alicia,10,0,20,10
1745804469536,LISP 5C,A00,896655,Munoz Sanchez; Alicia,4,0,20,16
1745804470564,MAE 197,001,957918,Kleissl; Jan,9998,0,9999,1
1745804471588,MATH 2,A01,957937,Staff,34,0,35,1
1745804472613,MATH 197,001,957876,Kedlaya; Kiran S.,9993,0,9999,6
1745804473640,MCWP 40,A00,892729,Duru; Nur,13,0,20,7
1745804473640,MCWP 40,B00,893304,Montejo; Carolina,20,0,20,0
1745804474669,MCWP 40R,A00,893757,Redela; Pamela Morgan,0,6,20,20
1745804475700,MCWP 50,A00,893758,Morshed; Michael James,2,0,20,18
1745804475700,MCWP 50,B00,893761,Bartulis; Jason Michael,17,0,20,3
1745804476725,MCWP 50R,A00,893766,Compas; Sean Matthew,0,1,20,20
1745804476725,MCWP 50R,B00,893769,Carter; Jennifer A,0,0,20,20
1745804476725,MCWP 50R,C00,893771,Krone; Jarret,0,3,20,20
1745804476725,MCWP 50R,D00,893772,Miller; Elizabeth Deen,3,0,20,17
1745804476725,MCWP 50R,E00,893775,Carter; Andrea L,0,0,20,20
1745804477750,MMW 11R,A01,892721,Herbst; Matthew,11,0,27,16
1745804477750,MMW 11R,A02,892722,Herbst; Matthew,0,0,0,3
1745804478776,MMW 12R,A01,892724,Herbst; Matthew,0,9,16,16
1745804478776,MMW 12R,A02,892725,Herbst; Matthew,0,9,16,16
1745804479805,MMW 13R,A01,892727,Staff,0,4,16,16
1745804479805,MMW 13R,A02,892728,Staff,0,4,16,16
1745804479805,MMW 13R,A03,958032,Staff,0,3,16,16
1745804479805,MMW 13R,A04,958033,Staff,0,2,16,16
1745804479805,MMW 13R,A05,958034,Staff,0,3,16,16
1745804480831,SIO 295LS,A00,894015,Staff,7,0,25,18
1745804481857,SIO 295S,A00,894020,Staff,7,0,25,18
1745804482888,SIOC 290S,B01,958918,Staff,0,0,0,0
1745804483917,SIOC 291S,B01,958922,Staff,0,0,0,0
1745804484947,SOCI 117,A01,895339,Staff,4,0,5,1
1745804485974,WES 237B,A00,894149,Staff,11,0,20,9
1745804488035,AESE 279B,A00,891859,Staff,13,0,35,22
1745804489059,AIP 197,001,891854,Staff,70,0,70,0
1745804490084,ANTH 289S,A00,891856,Gagneux; Pascal,12,0,12,0
1745804491114,BENG 196,001,957946,Engler; Adam J.,9996,0,9999,3
1745804492138,CAT 124RS,A01,956906,Staff,8,0,25,17
1745804493165,CAT 125RS,A01,922013,Staff,8,0,25,17
1745804494190,CLRE 250,A00,891860,Morris; Sheldon,9995,0,9999,4
1745804496245,CLRE 251R,A00,907817,Mehta; Ravindra L.,9994,0,9999,5
1745804497271,CLRE 252,A00,891864,Cuomo; Raphael Eduardo,9993,0,9999,6
1745804498298,CLRE 253,A00,891867,Vaida; Florin,9994,0,9999,5
1745804498298,CLRE 253,B00,907819,Staff,9999,0,9999,0
1745804499327,CLRE 259,A00,891868,Patel; Hemal,9998,0,9999,1
1745804500355,CLRE 260,A00,891872,Cuomo; Raphael Eduardo,9999,0,9999,0
1745804501381,CLRE 297,001,891888,Cuomo; Raphael Eduardo,9999,0,9999,0
1745804502405,CSE 191,A00,958773,Minnes Kemp; Mor Mia,9999,0,9999,0
1745804503435,CSS 201S,A01,892054,Mignozzetti; Umberto,30,0,30,0
1745804504461,CSS 202S,A01,892056,Mignozzetti; Umberto,30,0,30,0
1745804505512,DSC 197,001,956898,Eldridge; Justin Matthew,9998,0,9999,1
1745804506537,DSC 297,001,958000,Mazumdar; Arya,9998,0,9999,1
1745804507563,EAP 100,A00,905686,Staff,9776,0,9999,223
1745804508591,ECE 45,A01,892618,Staff,0,12,50,50
1745804509615,ECE 109,A01,892620,Staff,0,43,0,0
1745804510640,ECE 111,A01,892719,Staff,0,7,50,50
1745804511665,ECE 197,001,957920,Mercier; Patrick Philip,9992,0,9999,7
1745804512694,ECON 178,A01,907814,Zhu; Ying,28,0,35,7
1745804513721,EDS 115,A00,895312,Staff,41,0,45,4
1745804514748,EDS 117,A01,895337,Staff,30,0,30,0
1745804515774,EDS 125,A00,895341,Jones; Gabrielle Anastasia,43,0,45,2
1745804516799,EDS 128A,A01,895459,Fargason; Sharon Gayle,44,0,45,1
1745804517823,EDS 128B,A01,895543,Pappas; Elizabeth,44,0,45,1
1745804518847,EDS 139,A00,897203,Pappas; Elizabeth,44,0,45,1
1745804518847,EDS 139,B00,897209,Fargason; Sharon Gayle,44,0,45,1
1745804519871,EDS 201,A00,895545,Staff,43,0,45,2
1745804520896,EDS 203,A01,895581,Halter; Christopher P.,43,0,45,2
1745804521925,EDS 204R,A01,895625,Heinzman; Erica M.,43,0,45,2
1745804521925,EDS 204R,B01,895693,Halter; Christopher P.,18,0,45,27
1745804522950,EDS 206R,A00,895694,Fargason; Sharon Gayle,9,0,30,21
1745804522950,EDS 206R,B00,895695,Choi; Bailey Miyeon,20,0,30,10
1745804523975,EDS 250,A00,895697,Hemans; Patricia Ann Benitez,43,0,45,2
1745804525000,EDS 281,A00,895701,Meyerott; Theresa Ann,15,0,15,0
1745804526036,EDS 284,A00,895736,Meyerott; Theresa Ann,15,0,15,0
1745804527062,EDS 286,A00,897210,Fine; Sarah,15,0,15,0
1745804528085,EDS 289C,A01,895770,Daly; Alan J.,15,0,15,0
1745804529113,EDS 290,A00,897211,Hofstetter; Carolyn,15,0,15,0
1745804530138,LIGM 5A,A00,896162,Fischer-Grunski; Eva K,15,0,20,5
1745804531164,LIGM 5B,A00,896260,Fischer-Grunski; Eva K,17,0,20,3
1745804532189,LIGM 5C,A00,896308,Fischer-Grunski; Eva K,18,0,20,2
1745804533213,LIIT 5AS,A00,896313,Carnelos; Chiara,18,0,20,2
1745804534240,LIIT 5BS,A00,896416,Carnelos; Chiara,20,0,20,0
1745804535269,LIIT 5CS,A00,896564,Carnelos; Chiara,20,0,20,0
1745804536297,LISP 5A,A00,896588,Munoz Sanchez; Alicia,4,0,20,16
1745804537324,LISP 5B,A00,896653,Munoz Sanchez; Alicia,10,0,20,10
1745804538349,LISP 5C,A00,896655,Munoz Sanchez; Alicia,4,0,20,16
1745804539378,MAE 197,001,957918,Kleissl; Jan,9998,0,9999,1
1745804540407,MATH 2,A01,957937,Staff,34,0,35,1
1745804541433,MATH 197,001,957876,Kedlaya; Kiran S.,9993,0,9999,6
1745804542462,MCWP 40,A00,892729,Duru; Nur,13,0,20,7
1745804542462,MCWP 40,B00,893304,Montejo; Carolina,20,0,20,0
1745804543490,MCWP 40R,A00,893757,Redela; Pamela Morgan,0,6,20,20
1745804544516,MCWP 50,A00,893758,Morshed; Michael James,2,0,20,18
1745804544516,MCWP 50,B00,893761,Bartulis; Jason Michael,17,0,20,3
1745804545541,MCWP 50R,A00,893766,Compas; Sean Matthew,0,1,20,20
1745804545541,MCWP 50R,B00,893769,Carter; Jennifer A,0,0,20,20
1745804545541,MCWP 50R,C00,893771,Krone; Jarret,0,3,20,20
1745804545541,MCWP 50R,D00,893772,Miller; Elizabeth Deen,3,0,20,17
1745804545541,MCWP 50R,E00,893775,Carter; Andrea L,0,0,20,20
1745804546567,MMW 11R,A01,892721,Herbst; Matthew,11,0,27,16
1745804546567,MMW 11R,A02,892722,Herbst; Matthew,0,0,0,3
1745804547597,MMW 12R,A01,892724,Herbst; Matthew,0,9,16,16
1745804547597,MMW 12R,A02,892725,Herbst; Matthew,0,9,16,16
1745804548622,MMW 13R,A01,892727,Staff,0,4,16,16
1745804548622,MMW 13R,A02,892728,Staff,0,4,16,16
1745804548622,MMW 13R,A03,958032,Staff,0,3,16,16
1745804548622,MMW 13R,A04,958033,Staff,0,2,16,16
1745804548622,MMW 13R,A05,958034,Staff,0,3,16,16
1745804549651,SIO 295LS,A00,894015,Staff,7,0,25,18
1745804550676,SIO 295S,A00,894020,Staff,7,0,25,18
1745804551704,SIOC 290S,B01,958918,Staff,0,0,0,0
1745804552734,SIOC 291S,B01,958922,Staff,0,0,0,0
1745804553759,SOCI 117,A01,895339,Staff,4,0,5,1
1745804554784,WES 237B,A00,894149,Staff,11,0,20,9
1745804556847,AESE 279B,A00,891859,Staff,13,0,35,22
1745804557872,AIP 197,001,891854,Staff,70,0,70,0
1745804558899,ANTH 289S,A00,891856,Gagneux; Pascal,12,0,12,0
1745804559924,BENG 196,001,957946,Engler; Adam J.,9996,0,9999,3
1745804560951,CAT 124RS,A01,956906,Staff,8,0,25,17
1745804561976,CAT 125RS,A01,922013,Staff,8,0,25,17
1745804563004,CLRE 250,A00,891860,Morris; Sheldon,9995,0,9999,4
1745804565054,CLRE 251R,A00,907817,Mehta; Ravindra L.,9994,0,9999,5
1745804566078,CLRE 252,A00,891864,Cuomo; Raphael Eduardo,9993,0,9999,6
1745804567103,CLRE 253,A00,891867,Vaida; Florin,9994,0,9999,5
1745804567103,CLRE 253,B00,907819,Staff,9999,0,9999,0
1745804568129,CLRE 259,A00,891868,Patel; Hemal,9998,0,9999,1
1745804569156,CLRE 260,A00,891872,Cuomo; Raphael Eduardo,9999,0,9999,0
1745804570182,CLRE 297,001,891888,Cuomo; Raphael Eduardo,9999,0,9999,0
1745804571236,CSE 191,A00,958773,Minnes Kemp; Mor Mia,9999,0,9999,0
1745804572262,CSS 201S,A01,892054,Mignozzetti; Umberto,30,0,30,0
1745804573288,CSS 202S,A01,892056,Mignozzetti; Umberto,30,0,30,0
1745804574313,DSC 197,001,956898,Eldridge; Justin Matthew,9998,0,9999,1
1745804575340,DSC 297,001,958000,Mazumdar; Arya,9998,0,9999,1
1745804576368,EAP 100,A00,905686,Staff,9776,0,9999,223
1745804577394,ECE 45,A01,892618,Staff,0,12,50,50
1745804578421,ECE 109,A01,892620,Staff,0,43,0,0
1745804579449,ECE 111,A01,892719,Staff,0,7,50,50
1745804580477,ECE 197,001,957920,Mercier; Patrick Philip,9992,0,9999,7
1745804581503,ECON 178,A01,907814,Zhu; Ying,28,0,35,7
1745804582531,EDS 115,A00,895312,Staff,41,0,45,4
1745804583559,EDS 117,A01,895337,Staff,30,0,30,0
1745804584587,EDS 125,A00,895341,Jones; Gabrielle Anastasia,43,0,45,2
1745804585614,EDS 128A,A01,895459,Fargason; Sharon Gayle,44,0,45,1
1745804586638,EDS 128B,A01,895543,Pappas; Elizabeth,44,0,45,1
1745804587662,EDS 139,A00,897203,Pappas; Elizabeth,44,0,45,1
1745804587662,EDS 139,B00,897209,Fargason; Sharon Gayle,44,0,45,1
1745804588690,EDS 201,A00,895545,Staff,43,0,45,2
1745804589714,EDS 203,A01,895581,Halter; Christopher P.,43,0,45,2
1745804590739,EDS 204R,A01,895625,Heinzman; Erica M.,43,0,45,2
1745804590739,EDS 204R,B01,895693,Halter; Christopher P.,18,0,45,27
1745804591763,EDS 206R,A00,895694,Fargason; Sharon Gayle,9,0,30,21
1745804591763,EDS 206R,B00,895695,Choi; Bailey Miyeon,20,0,30,10
1745804592788,EDS 250,A00,895697,Hemans; Patricia Ann Benitez,43,0,45,2
1745804593812,EDS 281,A00,895701,Meyerott; Theresa Ann,15,0,15,0
1745804594839,EDS 284,A00,895736,Meyerott; Theresa Ann,15,0,15,0
1745804595863,EDS 286,A00,897210,Fine; Sarah,15,0,15,0
1745804596888,EDS 289C,A01,895770,Daly; Alan J.,15,0,15,0
1745804597914,EDS 290,A00,897211,Hofstetter; Carolyn,15,0,15,0
1745804598941,LIGM 5A,A00,896162,Fischer-Grunski; Eva K,15,0,20,5
1745804599970,LIGM 5B,A00,896260,Fischer-Grunski; Eva K,17,0,20,3
1745804600995,LIGM 5C,A00,896308,Fischer-Grunski; Eva K,18,0,20,2
1745804602024,LIIT 5AS,A00,896313,Carnelos; Chiara,18,0,20,2
1745804603051,LIIT 5BS,A00,896416,Carnelos; Chiara,20,0,20,0
1745804604077,LIIT 5CS,A00,896564,Carnelos; Chiara,20,0,20,0
1745804605105,LISP 5A,A00,896588,Munoz Sanchez; Alicia,4,0,20,16
1745804606135,LISP 5B,A00,896653,Munoz Sanchez; Alicia,10,0,20,10
1745804607161,LISP 5C,A00,896655,Munoz Sanchez; Alicia,4,0,20,16
1745804608189,MAE 197,001,957918,Kleissl; Jan,9998,0,9999,1
1745804609222,MATH 2,A01,957937,Staff,34,0,35,1
1745804610249,MATH 197,001,957876,Kedlaya; Kiran S.,9993,0,9999,6
1745804611278,MCWP 40,A00,892729,Duru; Nur,13,0,20,7
1745804611278,MCWP 40,B00,893304,Montejo; Carolina,20,0,20,0
1745804612304,MCWP 40R,A00,893757,Redela; Pamela Morgan,0,6,20,20
1745804613332,MCWP 50,A00,893758,Morshed; Michael James,2,0,20,18
1745804613332,MCWP 50,B00,893761,Bartulis; Jason Michael,17,0,20,3
1745804614358,MCWP 50R,A00,893766,Compas; Sean Matthew,0,1,20,20
1745804614358,MCWP 50R,B00,893769,Carter; Jennifer A,0,0,20,20
1745804614358,MCWP 50R,C00,893771,Krone; Jarret,0,3,20,20
1745804614358,MCWP 50R,D00,893772,Miller; Elizabeth Deen,3,0,20,17
1745804614358,MCWP 50R,E00,893775,Carter; Andrea L,0,0,20,20
1745804615383,MMW 11R,A01,892721,Herbst; Matthew,11,0,27,16
1745804615383,MMW 11R,A02,892722,Herbst; Matthew,0,0,0,3
1745804616411,MMW 12R,A01,892724,Herbst; Matthew,0,9,16,16
1745804616411,MMW 12R,A02,892725,Herbst; Matthew,0,9,16,16
1745804617438,MMW 13R,A01,892727,Staff,0,4,16,16
1745804617438,MMW 13R,A02,892728,Staff,0,4,16,16
1745804617438,MMW 13R,A03,958032,Staff,0,3,16,16
1745804617438,MMW 13R,A04,958033,Staff,0,2,16,16
1745804617438,MMW 13R,A05,958034,Staff,0,3,16,16
1745804618464,SIO 295LS,A00,894015,Staff,7,0,25,18
1745804619490,SIO 295S,A00,894020,Staff,7,0,25,18
1745804620519,SIOC 290S,B01,958918,Staff,0,0,0,0
1745804621545,SIOC 291S,B01,958922,Staff,0,0,0,0
1745804622574,SOCI 117,A01,895339,Staff,4,0,5,1
1745804623604,WES 237B,A00,894149,Staff,11,0,20,9
1745804625664,AESE 279B,A00,891859,Staff,13,0,35,22
1745804626689,AIP 197,001,891854,Staff,70,0,70,0
1745804627717,ANTH 289S,A00,891856,Gagneux; Pascal,12,0,12,0
1745804628744,BENG 196,001,957946,Engler; Adam J.,9996,0,9999,3
1745804629773,CAT 124RS,A01,956906,Staff,8,0,25,17
1745804630798,CAT 125RS,A01,922013,Staff,8,0,25,17
1745804631825,CLRE 250,A00,891860,Morris; Sheldon,9995,0,9999,4
1745804633877,CLRE 251R,A00,907817,Mehta; Ravindra L.,9994,0,9999,5
1745804634905,CLRE 252,A00,891864,Cuomo; Raphael Eduardo,9993,0,9999,6
1745804635934,CLRE 253,A00,891867,Vaida; Florin,9994,0,9999,5
1745804635934,CLRE 253,B00,907819,Staff,9999,0,9999,0
1745804636959,CLRE 259,A00,891868,Patel; Hemal,9998,0,9999,1
1745804637984,CLRE 260,A00,891872,Cuomo; Raphael Eduardo,9999,0,9999,0
1745804639013,CLRE 297,001,891888,Cuomo; Raphael Eduardo,9999,0,9999,0
1745804640042,CSE 191,A00,958773,Minnes Kemp; Mor Mia,9999,0,9999,0
1745804641071,CSS 201S,A01,892054,Mignozzetti; Umberto,30,0,30,0
1745804642108,CSS 202S,A01,892056,Mignozzetti; Umberto,30,0,30,0
1745804643137,DSC 197,001,956898,Eldridge; Justin Matthew,9998,0,9999,1
1745804644163,DSC 297,001,958000,Mazumdar; Arya,9998,0,9999,1
1745804645190,EAP 100,A00,905686,Staff,9776,0,9999,223
1745804646216,ECE 45,A01,892618,Staff,0,12,50,50
1745804647246,ECE 109,A01,892620,Staff,0,43,0,0
1745804648273,ECE 111,A01,892719,Staff,0,7,50,50
1745804649298,ECE 197,001,957920,Mercier; Patrick Philip,9992,0,9999,7
1745804650326,ECON 178,A01,907814,Zhu; Ying,28,0,35,7
1745804651353,EDS 115,A00,895312,Staff,41,0,45,4
1745804652391,EDS 117,A01,895337,Staff,30,0,30,0
1745804653418,EDS 125,A00,895341,Jones; Gabrielle Anastasia,43,0,45,2
1745804654442,EDS 128A,A01,895459,Fargason; Sharon Gayle,44,0,45,1
1745804655469,EDS 128B,A01,895543,Pappas; Elizabeth,44,0,45,1
1745804656497,EDS 139,A00,897203,Pappas; Elizabeth,44,0,45,1
1745804656497,EDS 139,B00,897209,Fargason; Sharon Gayle,44,0,45,1
1745804657525,EDS 201,A00,895545,Staff,43,0,45,2
1745804658553,EDS 203,A01,895581,Halter; Christopher P.,43,0,45,2
1745804659578,EDS 204R,A01,895625,Heinzman; Erica M.,43,0,45,2
1745804659578,EDS 204R,B01,895693,Halter; Christopher P.,18,0,45,27
1745804660608,EDS 206R,A00,895694,Fargason; Sharon Gayle,9,0,30,21
1745804660608,EDS 206R,B00,895695,Choi; Bailey Miyeon,20,0,30,10
1745804661634,EDS 250,A00,895697,Hemans; Patricia Ann Benitez,43,0,45,2
1745804662660,EDS 281,A00,895701,Meyerott; Theresa Ann,15,0,15,0
1745804663686,EDS 284,A00,895736,Meyerott; Theresa Ann,15,0,15,0
1745804664712,EDS 286,A00,897210,Fine; Sarah,15,0,15,0
1745804665737,EDS 289C,A01,895770,Daly; Alan J.,15,0,15,0
1745804666764,EDS 290,A00,897211,Hofstetter; Carolyn,15,0,15,0
1745804667791,LIGM 5A,A00,896162,Fischer-Grunski; Eva K,15,0,20,5
1745804668820,LIGM 5B,A00,896260,Fischer-Grunski; Eva K,17,0,20,3
1745804669849,LIGM 5C,A00,896308,Fischer-Grunski; Eva K,18,0,20,2
1745804670875,LIIT 5AS,A00,896313,Carnelos; Chiara,18,0,20,2
1745804671905,LIIT 5BS,A00,896416,Carnelos; Chiara,20,0,20,0
1745804672931,LIIT 5CS,A00,896564,Carnelos; Chiara,20,0,20,0
1745804673957,LISP 5A,A00,896588,Munoz Sanchez; Alicia,4,0,20,16
1745804674983,LISP 5B,A00,896653,Munoz Sanchez; Alicia,10,0,20,10
1745804676010,LISP 5C,A00,896655,Munoz Sanchez; Alicia,4,0,20,16
1745804677037,MAE 197,001,957918,Kleissl; Jan,9998,0,9999,1
1745804678062,MATH 2,A01,957937,Staff,34,0,35,1
1745804679088,MATH 197,001,957876,Kedlaya; Kiran S.,9993,0,9999,6
1745804680119,MCWP 40,A00,892729,Duru; Nur,13,0,20,7
1745804680119,MCWP 40,B00,893304,Montejo; Carolina,20,0,20,0
1745804681148,MCWP 40R,A00,893757,Redela; Pamela Morgan,0,6,20,20
1745804682176,MCWP 50,A00,893758,Morshed; Michael James,2,0,20,18
1745804682176,MCWP 50,B00,893761,Bartulis; Jason Michael,17,0,20,3
1745804683207,MCWP 50R,A00,893766,Compas; Sean Matthew,0,1,20,20
1745804683207,MCWP 50R,B00,893769,Carter; Jennifer A,0,0,20,20
1745804683207,MCWP 50R,C00,893771,Krone; Jarret,0,3,20,20
1745804683207,MCWP 50R,D00,893772,Miller; Elizabeth Deen,3,0,20,17
1745804683207,MCWP 50R,E00,893775,Carter; Andrea L,0,0,20,20
1745804684234,MMW 11R,A01,892721,Herbst; Matthew,11,0,27,16
1745804684234,MMW 11R,A02,892722,Herbst; Matthew,0,0,0,3
1745804685263,MMW 12R,A01,892724,Herbst; Matthew,0,9,16,16
1745804685263,MMW 12R,A02,892725,Herbst; Matthew,0,9,16,16
1745804686290,MMW 13R,A01,892727,Staff,0,4,16,16
1745804686290,MMW 13R,A02,892728,Staff,0,4,16,16
1745804686290,MMW 13R,A03,958032,Staff,0,3,16,16
1745804686290,MMW 13R,A04,958033,Staff,0,2,16,16
1745804686290,MMW 13R,A05,958034,Staff,0,3,16,16
1745804687316,SIO 295LS,A00,894015,Staff,7,0,25,18
1745804688343,SIO 295S,A00,894020,Staff,7,0,25,18
1745804689375,SIOC 290S,B01,958918,Staff,0,0,0,0
1745804690401,SIOC 291S,B01,958922,Staff,0,0,0,0
1745804691433,SOCI 117,A01,895339,Staff,4,0,5,1
1745804692462,WES 237B,A00,894149,Staff,11,0,20,9
1745804694518,AESE 279B,A00,891859,Staff,13,0,35,22
1745804695549,AIP 197,001,891854,Staff,70,0,70,0
1745804696576,ANTH 289S,A00,891856,Gagneux; Pascal,12,0,12,0
1745804697603,BENG 196,001,957946,Engler; Adam J.,9996,0,9999,3
1745804698626,CAT 124RS,A01,956906,Staff,8,0,25,17
1745804699654,CAT 125RS,A01,922013,Staff,8,0,25,17
1745804700681,CLRE 250,A00,891860,Morris; Sheldon,9995,0,9999,4
1745804702733,CLRE 251R,A00,907817,Mehta; Ravindra L.,9994,0,9999,5
1745804703760,CLRE 252,A00,891864,Cuomo; Raphael Eduardo,9993,0,9999,6
1745804704786,CLRE 253,A00,891867,Vaida; Florin,9994,0,9999,5
1745804704786,CLRE 253,B00,907819,Staff,9999,0,9999,0
1745804705812,CLRE 259,A00,891868,Patel; Hemal,9998,0,9999,1
1745804706836,CLRE 260,A00,891872,Cuomo; Raphael Eduardo,9999,0,9999,0
1745804707861,CLRE 297,001,891888,Cuomo; Raphael Eduardo,9999,0,9999,0
1745804708884,CSE 191,A00,958773,Minnes Kemp; Mor Mia,9999,0,9999,0
1745804709911,CSS 201S,A01,892054,Mignozzetti; Umberto,30,0,30,0
1745804710940,CSS 202S,A01,892056,Mignozzetti; Umberto,30,0,30,0
1745804711966,DSC 197,001,956898,Eldridge; Justin Matthew,9998,0,9999,1
1745804712991,DSC 297,001,958000,Mazumdar; Arya,9998,0,9999,1
1745804714019,EAP 100,A00,905686,Staff,9776,0,9999,223
1745804715047,ECE 45,A01,892618,Staff,0,12,50,50
1745804716075,ECE 109,A01,892620,Staff,0,43,0,0
1745804717103,ECE 111,A01,892719,Staff,0,7,50,50
1745804718130,ECE 197,001,957920,Mercier; Patrick Philip,9992,0,9999,7
1745804719156,ECON 178,A01,907814,Zhu; Ying,28,0,35,7
1745804720181,EDS 115,A00,895312,Staff,41,0,45,4
1745804721207,EDS 117,A01,895337,Staff,30,0,30,0
1745804722234,EDS 125,A00,895341,Jones; Gabrielle Anastasia,43,0,45,2
1745804723269,EDS 128A,A01,895459,Fargason; Sharon Gayle,44,0,45,1
1745804724294,EDS 128B,A01,895543,Pappas; Elizabeth,44,0,45,1
1745804725319,EDS 139,A00,897203,Pappas; Elizabeth,44,0,45,1
1745804725319,EDS 139,B00,897209,Fargason; Sharon Gayle,44,0,45,1
1745804726346,EDS 201,A00,895545,Staff,43,0,45,2
1745804727374,EDS 203,A01,895581,Halter; Christopher P.,43,0,45,2
1745804728402,EDS 204R,A01,895625,Heinzman; Erica M.,43,0,45,2
1745804728402,EDS 204R,B01,895693,Halter; Christopher P.,18,0,45,27
1745804729431,EDS 206R,A00,895694,Fargason; Sharon Gayle,9,0,30,21
1745804729431,EDS 206R,B00,895695,Choi; Bailey Miyeon,20,0,30,10
1745804730457,EDS 250,A00,895697,Hemans; Patricia Ann Benitez,43,0,45,2
1745804731484,EDS 281,A00,895701,Meyerott; Theresa Ann,15,0,15,0
1745804732513,EDS 284,A00,895736,Meyerott; Theresa Ann,15,0,15,0
1745804733538,EDS 286,A00,897210,Fine; Sarah,15,0,15,0
1745804734567,EDS 289C,A01,895770,Daly; Alan J.,15,0,15,0
1745804735594,EDS 290,A00,897211,Hofstetter; Carolyn,15,0,15,0
1745804736623,LIGM 5A,A00,896162,Fischer-Grunski; Eva K,15,0,20,5
1745804737652,LIGM 5B,A00,896260,Fischer-Grunski; Eva K,17,0,20,3
1745804738677,LIGM 5C,A00,896308,Fischer-Grunski; Eva K,18,0,20,2
1745804739705,LIIT 5AS,A00,896313,Carnelos; Chiara,18,0,20,2
1745804740733,LIIT 5BS,A00,896416,Carnelos; Chiara,20,0,20,0
1745804741761,LIIT 5CS,A00,896564,Carnelos; Chiara,20,0,20,0
1745804742786,LISP 5A,A00,896588,Munoz Sanchez; Alicia,4,0,20,16
1745804743814,LISP 5B,A00,896653,Munoz Sanchez; Alicia,10,0,20,10
1745804744839,LISP 5C,A00,896655,Munoz Sanchez; Alicia,4,0,20,16
1745804745863,MAE 197,001,957918,Kleissl; Jan,9998,0,9999,1
1745804746889,MATH 2,A01,957937,Staff,34,0,35,1
1745804747917,MATH 197,001,957876,Kedlaya; Kiran S.,9993,0,9999,6
1745804748943,MCWP 40,A00,892729,Duru; Nur,13,0,20,7
1745804748943,MCWP 40,B00,893304,Montejo; Carolina,20,0,20,0
1745804749971,MCWP 40R,A00,893757,Redela; Pamela Morgan,0,6,20,20
1745804750999,MCWP 50,A00,893758,Morshed; Michael James,2,0,20,18
1745804750999,MCWP 50,B00,893761,Bartulis; Jason Michael,17,0,20,3
1745804752025,MCWP 50R,A00,893766,Compas; Sean Matthew,0,1,20,20
1745804752025,MCWP 50R,B00,893769,Carter; Jennifer A,0,0,20,20
1745804752025,MCWP 50R,C00,893771,Krone; Jarret,0,3,20,20
1745804752025,MCWP 50R,D00,893772,Miller; Elizabeth Deen,3,0,20,17
1745804752025,MCWP 50R,E00,893775,Carter; Andrea L,0,0,20,20
1745804753051,MMW 11R,A01,892721,Herbst; Matthew,11,0,27,16
1745804753051,MMW 11R,A02,892722,Herbst; Matthew,0,0,0,3
1745804754080,MMW 12R,A01,892724,Herbst; Matthew,0,9,16,16
1745804754080,MMW 12R,A02,892725,Herbst; Matthew,0,9,16,16
1745804755107,MMW 13R,A01,892727,Staff,0,4,16,16
1745804755107,MMW 13R,A02,892728,Staff,0,4,16,16
1745804755107,MMW 13R,A03,958032,Staff,0,3,16,16
1745804755107,MMW 13R,A04,958033,Staff,0,2,16,16
1745804755107,MMW 13R,A05,958034,Staff,0,3,16,16
1745804756134,SIO 295LS,A00,894015,Staff,7,0,25,18
1745804757160,SIO 295S,A00,894020,Staff,7,0,25,18
1745804758187,SIOC 290S,B01,958918,Staff,0,0,0,0
1745804759214,SIOC 291S,B01,958922,Staff,0,0,0,0
1745804760243,SOCI 117,A01,895339,Staff,4,0,5,1
1745804761273,WES 237B,A00,894149,Staff,11,0,20,9
1745804763346,AESE 279B,A00,891859,Staff,13,0,35,22
1745804764377,AIP 197,001,891854,Staff,70,0,70,0
1745804765405,ANTH 289S,A00,891856,Gagneux; Pascal,12,0,12,0
1745804766433,BENG 196,001,957946,Engler; Adam J.,9996,0,9999,3
1745804767457,CAT 124RS,A01,956906,Staff,8,0,25,17
1745804768484,CAT 125RS,A01,922013,Staff,8,0,25,17
1745804769511,CLRE 250,A00,891860,Morris; Sheldon,9995,0,9999,4
1745804771566,CLRE 251R,A00,907817,Mehta; Ravindra L.,9994,0,9999,5
1745804772592,CLRE 252,A00,891864,Cuomo; Raphael Eduardo,9993,0,9999,6
1745804773619,CLRE 253,A00,891867,Vaida; Florin,9994,0,9999,5
1745804773619,CLRE 253,B00,907819,Staff,9999,0,9999,0
1745804774648,CLRE 259,A00,891868,Patel; Hemal,9998,0,9999,1
1745804775678,CLRE 260,A00,891872,Cuomo; Raphael Eduardo,9999,0,9999,0
1745804776706,CLRE 297,001,891888,Cuomo; Raphael Eduardo,9999,0,9999,0
1745804777733,CSE 191,A00,958773,Minnes Kemp; Mor Mia,9999,0,9999,0
1745804778759,CSS 201S,A01,892054,Mignozzetti; Umberto,30,0,30,0
1745804779786,CSS 202S,A01,892056,Mignozzetti; Umberto,30,0,30,0
1745804780815,DSC 197,001,956898,Eldridge; Justin Matthew,9998,0,9999,1
1745804781842,DSC 297,001,958000,Mazumdar; Arya,9998,0,9999,1
1745804782868,EAP 100,A00,905686,Staff,9776,0,9999,223
1745804783895,ECE 45,A01,892618,Staff,0,12,50,50
1745804784924,ECE 109,A01,892620,Staff,0,43,0,0
1745804785955,ECE 111,A01,892719,Staff,0,7,50,50
1745804786981,ECE 197,001,957920,Mercier; Patrick Philip,9992,0,9999,7
1745804788008,ECON 178,A01,907814,Zhu; Ying,28,0,35,7
1745804789033,EDS 115,A00,895312,Staff,41,0,45,4
1745804790059,EDS 117,A01,895337,Staff,30,0,30,0
1745804791124,EDS 125,A00,895341,Jones; Gabrielle Anastasia,43,0,45,2
1745804792151,EDS 128A,A01,895459,Fargason; Sharon Gayle,44,0,45,1
1745804793177,EDS 128B,A01,895543,Pappas; Elizabeth,44,0,45,1
1745804794203,EDS 139,A00,897203,Pappas; Elizabeth,44,0,45,1
1745804794203,EDS 139,B00,897209,Fargason; Sharon Gayle,44,0,45,1
1745804795232,EDS 201,A00,895545,Staff,43,0,45,2
1745804796258,EDS 203,A01,895581,Halter; Christopher P.,43,0,45,2
1745804797283,EDS 204R,A01,895625,Heinzman; Erica M.,43,0,45,2
1745804797283,EDS 204R,B01,895693,Halter; Christopher P.,18,0,45,27
1745804798309,EDS 206R,A00,895694,Fargason; Sharon Gayle,9,0,30,21
1745804798309,EDS 206R,B00,895695,Choi; Bailey Miyeon,20,0,30,10
1745804799335,EDS 250,A00,895697,Hemans; Patricia Ann Benitez,43,0,45,2
1745804800363,EDS 281,A00,895701,Meyerott; Theresa Ann,15,0,15,0
1745804801388,EDS 284,A00,895736,Meyerott; Theresa Ann,15,0,15,0
1745804802417,EDS 286,A00,897210,Fine; Sarah,15,0,15,0
1745804803446,EDS 289C,A01,895770,Daly; Alan J.,15,0,15,0
1745804804473,EDS 290,A00,897211,Hofstetter; Carolyn,15,0,15,0
1745804805502,LIGM 5A,A00,896162,Fischer-Grunski; Eva K,15,0,20,5
1745804806529,LIGM 5B,A00,896260,Fischer-Grunski; Eva K,17,0,20,3
1745804807556,LIGM 5C,A00,896308,Fischer-Grunski; Eva K,18,0,20,2
1745804808583,LIIT 5AS,A00,896313,Carnelos; Chiara,18,0,20,2
1745804809608,LIIT 5BS,A00,896416,Carnelos; Chiara,20,0,20,0
1745804810637,LIIT 5CS,A00,896564,Carnelos; Chiara,20,0,20,0
1745804811666,LISP 5A,A00,896588,Munoz Sanchez; Alicia,4,0,20,16
1745804812691,LISP 5B,A00,896653,Munoz Sanchez; Alicia,10,0,20,10
1745804813717,LISP 5C,A00,896655,Munoz Sanchez; Alicia,4,0,20,16
1745804814742,MAE 197,001,957918,Kleissl; Jan,9998,0,9999,1
1745804815770,MATH 2,A01,957937,Staff,34,0,35,1
1745804816795,MATH 197,001,957876,Kedlaya; Kiran S.,9993,0,9999,6
1745804817822,MCWP 40,A00,892729,Duru; Nur,13,0,20,7
1745804817822,MCWP 40,B00,893304,Montejo; Carolina,20,0,20,0
1745804818852,MCWP 40R,A00,893757,Redela; Pamela Morgan,0,6,20,20
1745804819878,MCWP 50,A00,893758,Morshed; Michael James,2,0,20,18
1745804819878,MCWP 50,B00,893761,Bartulis; Jason Michael,17,0,20,3
1745804820905,MCWP 50R,A00,893766,Compas; Sean Matthew,0,1,20,20
1745804820905,MCWP 50R,B00,893769,Carter; Jennifer A,0,0,20,20
1745804820905,MCWP 50R,C00,893771,Krone; Jarret,0,3,20,20
1745804820905,MCWP 50R,D00,893772,Miller; Elizabeth Deen,3,0,20,17
1745804820905,MCWP 50R,E00,893775,Carter; Andrea L,0,0,20,20
1745804821932,MMW 11R,A01,892721,Herbst; Matthew,11,0,27,16
1745804821932,MMW 11R,A02,892722,Herbst; Matthew,0,0,0,3
1745804822957,MMW 12R,A01,892724,Herbst; Matthew,0,9,16,16
1745804822957,MMW 12R,A02,892725,Herbst; Matthew,0,9,16,16
1745804823983,MMW 13R,A01,892727,Staff,0,4,16,16
1745804823983,MMW 13R,A02,892728,Staff,0,4,16,16
1745804823983,MMW 13R,A03,958032,Staff,0,3,16,16
1745804823983,MMW 13R,A04,958033,Staff,0,2,16,16
1745804823983,MMW 13R,A05,958034,Staff,0,3,16,16
1745804825010,SIO 295LS,A00,894015,Staff,7,0,25,18
1745804826042,SIO 295S,A00,894020,Staff,7,0,25,18
1745804827071,SIOC 290S,B01,958918,Staff,0,0,0,0
1745804828096,SIOC 291S,B01,958922,Staff,0,0,0,0
1745804829122,SOCI 117,A01,895339,Staff,4,0,5,1
1745804830148,WES 237B,A00,894149,Staff,11,0,20,9
1745804832211,AESE 279B,A00,891859,Staff,13,0,35,22
1745804833240,AIP 197,001,891854,Staff,70,0,70,0
1745804834266,ANTH 289S,A00,891856,Gagneux; Pascal,12,0,12,0
1745804835293,BENG 196,001,957946,Engler; Adam J.,9996,0,9999,3
1745804836318,CAT 124RS,A01,956906,Staff,8,0,25,17
1745804837344,CAT 125RS,A01,922013,Staff,8,0,25,17
1745804838370,CLRE 250,A00,891860,Morris; Sheldon,9995,0,9999,4
1745804840419,CLRE 251R,A00,907817,Mehta; Ravindra L.,9994,0,9999,5
1745804841449,CLRE 252,A00,891864,Cuomo; Raphael Eduardo,9993,0,9999,6
1745804842477,CLRE 253,A00,891867,Vaida; Florin,9994,0,9999,5
1745804842477,CLRE 253,B00,907819,Staff,9999,0,9999,0
1745804843502,CLRE 259,A00,891868,Patel; Hemal,9998,0,9999,1
1745804844530,CLRE 260,A00,891872,Cuomo; Raphael Eduardo,9999,0,9999,0
1745804845556,CLRE 297,001,891888,Cuomo; Raphael Eduardo,9999,0,9999,0
1745804846582,CSE 191,A00,958773,Minnes Kemp; Mor Mia,9999,0,9999,0
1745804847611,CSS 201S,A01,892054,Mignozzetti; Umberto,30,0,30,0
1745804848636,CSS 202S,A01,892056,Mignozzetti; Umberto,30,0,30,0
1745804849661,DSC 197,001,956898,Eldridge; Justin Matthew,9998,0,9999,1
1745804850688,DSC 297,001,958000,Mazumdar; Arya,9998,0,9999,1
1745804851713,EAP 100,A00,905686,Staff,9776,0,9999,223
1745804852739,ECE 45,A01,892618,Staff,0,12,50,50
1745804853767,ECE 109,A01,892620,Staff,0,43,0,0
1745804854794,ECE 111,A01,892719,Staff,0,7,50,50
1745804855820,ECE 197,001,957920,Mercier; Patrick Philip,9992,0,9999,7
1745804856845,ECON 178,A01,907814,Zhu; Ying,28,0,35,7
1745804857873,EDS 115,A00,895312,Staff,41,0,45,4
1745804858899,EDS 117,A01,895337,Staff,30,0,30,0
1745804859927,EDS 125,A00,895341,Jones; Gabrielle Anastasia,43,0,45,2
1745804860953,EDS 128A,A01,895459,Fargason; Sharon Gayle,44,0,45,1
1745804861982,EDS 128B,A01,895543,Pappas; Elizabeth,44,0,45,1
1745804863008,EDS 139,A00,897203,Pappas; Elizabeth,44,0,45,1
1745804863008,EDS 139,B00,897209,Fargason; Sharon Gayle,44,0,45,1
1745804864035,EDS 201,A00,895545,Staff,43,0,45,2
1745804865060,EDS 203,A01,895581,Halter; Christopher P.,43,0,45,2
1745804866086,EDS 204R,A01,895625,Heinzman; Erica M.,43,0,45,2
1745804866086,EDS 204R,B01,895693,Halter; Christopher P.,18,0,45,27
1745804867113,EDS 206R,A00,895694,Fargason; Sharon Gayle,9,0,30,21
1745804867113,EDS 206R,B00,895695,Choi; Bailey Miyeon,20,0,30,10
1745804868138,EDS 250,A00,895697,Hemans; Patricia Ann Benitez,43,0,45,2
1745804869168,EDS 281,A00,895701,Meyerott; Theresa Ann,15,0,15,0
1745804870193,EDS 284,A00,895736,Meyerott; Theresa Ann,15,0,15,0
1745804871222,EDS 286,A00,897210,Fine; Sarah,15,0,15,0
1745804872249,EDS 289C,A01,895770,Daly; Alan J.,15,0,15,0
1745804873277,EDS 290,A00,897211,Hofstetter; Carolyn,15,0,15,0
1745804874306,LIGM 5A,A00,896162,Fischer-Grunski; Eva K,15,0,20,5
1745804875332,LIGM 5B,A00,896260,Fischer-Grunski; Eva K,17,0,20,3
1745804876360,LIGM 5C,A00,896308,Fischer-Grunski; Eva K,18,0,20,2
1745804877390,LIIT 5AS,A00,896313,Carnelos; Chiara,18,0,20,2
1745804878418,LIIT 5BS,A00,896416,Carnelos; Chiara,20,0,20,0
1745804879447,LIIT 5CS,A00,896564,Carnelos; Chiara,20,0,20,0
1745804880474,LISP 5A,A00,896588,Munoz Sanchez; Alicia,4,0,20,16
1745804881501,LISP 5B,A00,896653,Munoz Sanchez; Alicia,10,0,20,10
1745804882531,LISP 5C,A00,896655,Munoz Sanchez; Alicia,4,0,20,16
1745804883558,MAE 197,001,957918,Kleissl; Jan,9998,0,9999,1
1745804884583,MATH 2,A01,957937,Staff,34,0,35,1
1745804885608,MATH 197,001,957876,Kedlaya; Kiran S.,9993,0,9999,6
1745804886634,MCWP 40,A00,892729,Duru; Nur,13,0,20,7
1745804886634,MCWP 40,B00,893304,Montejo; Carolina,20,0,20,0
1745804887660,MCWP 40R,A00,893757,Redela; Pamela Morgan,0,6,20,20
1745804888689,MCWP 50,A00,893758,Morshed; Michael James,2,0,20,18
1745804888689,MCWP 50,B00,893761,Bartulis; Jason Michael,17,0,20,3
1745804889718,MCWP 50R,A00,893766,Compas; Sean Matthew,0,1,20,20
1745804889718,MCWP 50R,B00,893769,Carter; Jennifer A,0,0,20,20
1745804889718,MCWP 50R,C00,893771,Krone; Jarret,0,3,20,20
1745804889718,MCWP 50R,D00,893772,Miller; Elizabeth Deen,3,0,20,17
1745804889718,MCWP 50R,E00,893775,Carter; Andrea L,0,0,20,20
1745804890746,MMW 11R,A01,892721,Herbst; Matthew,11,0,27,16
1745804890746,MMW 11R,A02,892722,Herbst; Matthew,0,0,0,3
1745804891770,MMW 12R,A01,892724,Herbst; Matthew,0,9,16,16
1745804891770,MMW 12R,A02,892725,Herbst; Matthew,0,9,16,16
1745804892797,MMW 13R,A01,892727,Staff,0,4,16,16
1745804892797,MMW 13R,A02,892728,Staff,0,4,16,16
1745804892797,MMW 13R,A03,958032,Staff,0,3,16,16
1745804892797,MMW 13R,A04,958033,Staff,0,2,16,16
1745804892797,MMW 13R,A05,958034,Staff,0,3,16,16
1745804893822,SIO 295LS,A00,894015,Staff,7,0,25,18
1745804894887,SIO 295S,A00,894020,Staff,7,0,25,18
1745804895916,SIOC 290S,B01,958918,Staff,0,0,0,0
1745804896946,SIOC 291S,B01,958922,Staff,0,0,0,0
1745804897974,SOCI 117,A01,895339,Staff,4,0,5,1
1745804899003,WES 237B,A00,894149,Staff,11,0,20,9
1745804901064,AESE 279B,A00,891859,Staff,13,0,35,22
1745804902089,AIP 197,001,891854,Staff,70,0,70,0
1745804903115,ANTH 289S,A00,891856,Gagneux; Pascal,12,0,12,0
1745804904141,BENG 196,001,957946,Engler; Adam J.,9996,0,9999,3
1745804905167,CAT 124RS,A01,956906,Staff,8,0,25,17
1745804906192,CAT 125RS,A01,922013,Staff,8,0,25,17
1745804907220,CLRE 250,A00,891860,Morris; Sheldon,9995,0,9999,4
1745804909280,CLRE 251R,A00,907817,Mehta; Ravindra L.,9994,0,9999,5
1745804910307,CLRE 252,A00,891864,Cuomo; Raphael Eduardo,9993,0,9999,6
1745804911333,CLRE 253,A00,891867,Vaida; Florin,9994,0,9999,5
1745804911333,CLRE 253,B00,907819,Staff,9999,0,9999,0
1745804912361,CLRE 259,A00,891868,Patel; Hemal,9998,0,9999,1
1745804913427,CLRE 260,A00,891872,Cuomo; Raphael Eduardo,9999,0,9999,0
1745804914456,CLRE 297,001,891888,Cuomo; Raphael Eduardo,9999,0,9999,0
1745804915483,CSE 191,A00,958773,Minnes Kemp; Mor Mia,9999,0,9999,0
1745804916510,CSS 201S,A01,892054,Mignozzetti; Umberto,30,0,30,0
1745804917539,CSS 202S,A01,892056,Mignozzetti; Umberto,30,0,30,0
1745804918563,DSC 197,001,956898,Eldridge; Justin Matthew,9998,0,9999,1
1745804919592,DSC 297,001,958000,Mazumdar; Arya,9998,0,9999,1
1745804920618,EAP 100,A00,905686,Staff,9776,0,9999,223
1745804921646,ECE 45,A01,892618,Staff,0,12,50,50
1745804922676,ECE 109,A01,892620,Staff,0,43,0,0
1745804923704,ECE 111,A01,892719,Staff,0,7,50,50
1745804924731,ECE 197,001,957920,Mercier; Patrick Philip,9992,0,9999,7
1745804925757,ECON 178,A01,907814,Zhu; Ying,28,0,35,7
1745804926786,EDS 115,A00,895312,Staff,41,0,45,4
1745804927815,EDS 117,A01,895337,Staff,30,0,30,0
1745804928840,EDS 125,A00,895341,Jones; Gabrielle Anastasia,43,0,45,2
1745804929868,EDS 128A,A01,895459,Fargason; Sharon Gayle,44,0,45,1
1745804930898,EDS 128B,A01,895543,Pappas; Elizabeth,44,0,45,1
1745804931925,EDS 139,A00,897203,Pappas; Elizabeth,44,0,45,1
1745804931925,EDS 139,B00,897209,Fargason; Sharon Gayle,44,0,45,1
1745804932952,EDS 201,A00,895545,Staff,43,0,45,2
1745804933981,EDS 203,A01,895581,Halter; Christopher P.,43,0,45,2
1745804935008,EDS 204R,A01,895625,Heinzman; Erica M.,43,0,45,2
1745804935008,EDS 204R,B01,895693,Halter; Christopher P.,18,0,45,27
1745804936035,EDS 206R,A00,895694,Fargason; Sharon Gayle,9,0,30,21
1745804936035,EDS 206R,B00,895695,Choi; Bailey Miyeon,20,0,30,10
1745804937061,EDS 250,A00,895697,Hemans; Patricia Ann Benitez,43,0,45,2
1745804938087,EDS 281,A00,895701,Meyerott; Theresa Ann,15,0,15,0
1745804939115,EDS 284,A00,895736,Meyerott; Theresa Ann,15,0,15,0
1745804940141,EDS 286,A00,897210,Fine; Sarah,15,0,15,0
1745804941168,EDS 289C,A01,895770,Daly; Alan J.,15,0,15,0
1745804942196,EDS 290,A00,897211,Hofstetter; Carolyn,15,0,15,0
1745804943226,LIGM 5A,A00,896162,Fischer-Grunski; Eva K,15,0,20,5
1745804944253,LIGM 5B,A00,896260,Fischer-Grunski; Eva K,17,0,20,3
1745804945279,LIGM 5C,A00,896308,Fischer-Grunski; Eva K,18,0,20,2
1745804946304,LIIT 5AS,A00,896313,Carnelos; Chiara,18,0,20,2
1745804947353,LIIT 5BS,A00,896416,Carnelos; Chiara,20,0,20,0
1745804948379,LIIT 5CS,A00,896564,Carnelos; Chiara,20,0,20,0
1745804949403,LISP 5A,A00,896588,Munoz Sanchez; Alicia,4,0,20,16
1745804950433,LISP 5B,A00,896653,Munoz Sanchez; Alicia,10,0,20,10
1745804951458,LISP 5C,A00,896655,Munoz Sanchez; Alicia,4,0,20,16
1745804952487,MAE 197,001,957918,Kleissl; Jan,9998,0,9999,1
1745804953513,MATH 2,A01,957937,Staff,34,0,35,1
1745804954539,MATH 197,001,957876,Kedlaya; Kiran S.,9993,0,9999,6
1745804955572,MCWP 40,A00,892729,Duru; Nur,13,0,20,7
1745804955572,MCWP 40,B00,893304,Montejo; Carolina,20,0,20,0
1745804956597,MCWP 40R,A00,893757,Redela; Pamela Morgan,0,6,20,20
1745804957622,MCWP 50,A00,893758,Morshed; Michael James,2,0,20,18
1745804957622,MCWP 50,B00,893761,Bartulis; Jason Michael,17,0,20,3
1745804958649,MCWP 50R,A00,893766,Compas; Sean Matthew,0,1,20,20
1745804958649,MCWP 50R,B00,893769,Carter; Jennifer A,0,0,20,20
1745804958649,MCWP 50R,C00,893771,Krone; Jarret,0,3,20,20
1745804958649,MCWP 50R,D00,893772,Miller; Elizabeth Deen,3,0,20,17
1745804958649,MCWP 50R,E00,893775,Carter; Andrea L,0,0,20,20
1745804959674,MMW 11R,A01,892721,Herbst; Matthew,11,0,27,16
1745804959674,MMW 11R,A02,892722,Herbst; Matthew,0,0,0,3
1745804960704,MMW 12R,A01,892724,Herbst; Matthew,0,9,16,16
1745804960704,MMW 12R,A02,892725,Herbst; Matthew,0,9,16,16
1745804961731,MMW 13R,A01,892727,Staff,0,4,16,16
1745804961731,MMW 13R,A02,892728,Staff,0,4,16,16
1745804961731,MMW 13R,A03,958032,Staff,0,3,16,16
1745804961731,MMW 13R,A04,958033,Staff,0,2,16,16
1745804961731,MMW 13R,A05,958034,Staff,0,3,16,16
1745804962758,SIO 295LS,A00,894015,Staff,7,0,25,18
1745804963786,SIO 295S,A00,894020,Staff,7,0,25,18
1745804964817,SIOC 290S,B01,958918,Staff,0,0,0,0
1745804965841,SIOC 291S,B01,958922,Staff,0,0,0,0
1745804966867,SOCI 117,A01,895339,Staff,4,0,5,1
1745804967894,WES 237B,A00,894149,Staff,11,0,20,9
1745804969962,AESE 279B,A00,891859,Staff,13,0,35,22
1745804970988,AIP 197,001,891854,Staff,70,0,70,0
1745804972017,ANTH 289S,A00,891856,Gagneux; Pascal,12,0,12,0
1745804973041,BENG 196,001,957946,Engler; Adam J.,9996,0,9999,3
1745804974066,CAT 124RS,A01,956906,Staff,8,0,25,17
1745804975092,CAT 125RS,A01,922013,Staff,8,0,25,17
1745804986959,CLRE 250,A00,891860,Morris; Sheldon,9995,0,9999,4
1745804989014,CLRE 251R,A00,907817,Mehta; Ravindra L.,9994,0,9999,5
1745804990041,CLRE 252,A00,891864,Cuomo; Raphael Eduardo,9993,0,9999,6
1745804991067,CLRE 253,A00,891867,Vaida; Florin,9994,0,9999,5
1745804991067,CLRE 253,B00,907819,Staff,9999,0,9999,0
1745804992096,CLRE 259,A00,891868,Patel; Hemal,9998,0,9999,1
1745804993123,CLRE 260,A00,891872,Cuomo; Raphael Eduardo,9999,0,9999,0
1745804994149,CLRE 297,001,891888,Cuomo; Raphael Eduardo,9999,0,9999,0
1745804995174,CSE 191,A00,958773,Minnes Kemp; Mor Mia,9999,0,9999,0
1745804996202,CSS 201S,A01,892054,Mignozzetti; Umberto,30,0,30,0
1745804997226,CSS 202S,A01,892056,Mignozzetti; Umberto,30,0,30,0
1745804998256,DSC 197,001,956898,Eldridge; Justin Matthew,9998,0,9999,1
1745804999287,DSC 297,001,958000,Mazumdar; Arya,9998,0,9999,1
1745805000312,EAP 100,A00,905686,Staff,9776,0,9999,223
1745805001341,ECE 45,A01,892618,Staff,0,12,50,50
1745805002370,ECE 109,A01,892620,Staff,0,43,0,0
1745805003396,ECE 111,A01,892719,Staff,0,7,50,50
1745805004426,ECE 197,001,957920,Mercier; Patrick Philip,9992,0,9999,7
1745805005453,ECON 178,A01,907814,Zhu; Ying,28,0,35,7
1745805006480,EDS 115,A00,895312,Staff,41,0,45,4
1745805007505,EDS 117,A01,895337,Staff,30,0,30,0
1745805008532,EDS 125,A00,895341,Jones; Gabrielle Anastasia,43,0,45,2
1745805009560,EDS 128A,A01,895459,Fargason; Sharon Gayle,44,0,45,1
1745805010589,EDS 128B,A01,895543,Pappas; Elizabeth,44,0,45,1
1745805011617,EDS 139,A00,897203,Pappas; Elizabeth,44,0,45,1
1745805011617,EDS 139,B00,897209,Fargason; Sharon Gayle,44,0,45,1
1745805012644,EDS 201,A00,895545,Staff,43,0,45,2
1745805013672,EDS 203,A01,895581,Halter; Christopher P.,43,0,45,2
1745805014704,EDS 204R,A01,895625,Heinzman; Erica M.,43,0,45,2
1745805014704,EDS 204R,B01,895693,Halter; Christopher P.,18,0,45,27
1745805015733,EDS 206R,A00,895694,Fargason; Sharon Gayle,9,0,30,21
1745805015733,EDS 206R,B00,895695,Choi; Bailey Miyeon,20,0,30,10
1745805016761,EDS 250,A00,895697,Hemans; Patricia Ann Benitez,43,0,45,2
1745805017790,EDS 281,A00,895701,Meyerott; Theresa Ann,15,0,15,0
1745805018820,EDS 284,A00,895736,Meyerott; Theresa Ann,15,0,15,0
1745805019849,EDS 286,A00,897210,Fine; Sarah,15,0,15,0
1745805020877,EDS 289C,A01,895770,Daly; Alan J.,15,0,15,0
1745805021906,EDS 290,A00,897211,Hofstetter; Carolyn,15,0,15,0
1745805022935,LIGM 5A,A00,896162,Fischer-Grunski; Eva K,15,0,20,5
1745805023962,LIGM 5B,A00,896260,Fischer-Grunski; Eva K,17,0,20,3
1745805024989,LIGM 5C,A00,896308,Fischer-Grunski; Eva K,18,0,20,2
1745805026015,LIIT 5AS,A00,896313,Carnelos; Chiara,18,0,20,2
1745805027045,LIIT 5BS,A00,896416,Carnelos; Chiara,20,0,20,0
1745805028069,LIIT 5CS,A00,896564,Carnelos; Chiara,20,0,20,0
1745805029097,LISP 5A,A00,896588,Munoz Sanchez; Alicia,4,0,20,16
1745805030122,LISP 5B,A00,896653,Munoz Sanchez; Alicia,10,0,20,10
1745805031150,LISP 5C,A00,896655,Munoz Sanchez; Alicia,4,0,20,16
1745805032174,MAE 197,001,957918,Kleissl; Jan,9998,0,9999,1
1745805033201,MATH 2,A01,957937,Staff,34,0,35,1
1745805034229,MATH 197,001,957876,Kedlaya; Kiran S.,9993,0,9999,6
1745805035256,MCWP 40,A00,892729,Duru; Nur,13,0,20,7
1745805035256,MCWP 40,B00,893304,Montejo; Carolina,20,0,20,0
1745805036286,MCWP 40R,A00,893757,Redela; Pamela Morgan,0,6,20,20
1745805037314,MCWP 50,A00,893758,Morshed; Michael James,2,0,20,18
1745805037314,MCWP 50,B00,893761,Bartulis; Jason Michael,17,0,20,3
1745805038344,MCWP 50R,A00,893766,Compas; Sean Matthew,0,1,20,20
1745805038344,MCWP 50R,B00,893769,Carter; Jennifer A,0,0,20,20
1745805038344,MCWP 50R,C00,893771,Krone; Jarret,0,3,20,20
1745805038344,MCWP 50R,D00,893772,Miller; Elizabeth Deen,3,0,20,17
1745805038344,MCWP 50R,E00,893775,Carter; Andrea L,0,0,20,20
1745805039369,MMW 11R,A01,892721,Herbst; Matthew,11,0,27,16
1745805039369,MMW 11R,A02,892722,Herbst; Matthew,0,0,0,3
1745805040397,MMW 12R,A01,892724,Herbst; Matthew,0,9,16,16
1745805040397,MMW 12R,A02,892725,Herbst; Matthew,0,9,16,16
1745805041424,MMW 13R,A01,892727,Staff,0,4,16,16
1745805041424,MMW 13R,A02,892728,Staff,0,4,16,16
1745805041424,MMW 13R,A03,958032,Staff,0,3,16,16
1745805041424,MMW 13R,A04,958033,Staff,0,2,16,16
1745805041424,MMW 13R,A05,958034,Staff,0,3,16,16
1745805042451,SIO 295LS,A00,894015,Staff,7,0,25,18
1745805043479,SIO 295S,A00,894020,Staff,7,0,25,18
1745805044506,SIOC 290S,B01,958918,Staff,0,0,0,0
1745805045534,SIOC 291S,B01,958922,Staff,0,0,0,0
1745805046563,SOCI 117,A01,895339,Staff,4,0,5,1
1745805047588,WES 237B,A00,894149,Staff,11,0,20,9
1745805049645,AESE 279B,A00,891859,Staff,13,0,35,22
1745805050671,AIP 197,001,891854,Staff,70,0,70,0
1745805051700,ANTH 289S,A00,891856,Gagneux; Pascal,12,0,12,0
1745805052726,BENG 196,001,957946,Engler; Adam J.,9996,0,9999,3
1745805053754,CAT 124RS,A01,956906,Staff,8,0,25,17
1745805054808,CAT 125RS,A01,922013,Staff,8,0,25,17
1745805055835,CLRE 250,A00,891860,Morris; Sheldon,9995,0,9999,4
1745805057888,CLRE 251R,A00,907817,Mehta; Ravindra L.,9994,0,9999,5
1745805058913,CLRE 252,A00,891864,Cuomo; Raphael Eduardo,9993,0,9999,6
1745805059937,CLRE 253,A00,891867,Vaida; Florin,9994,0,9999,5
1745805059937,CLRE 253,B00,907819,Staff,9999,0,9999,0
1745805060965,CLRE 259,A00,891868,Patel; Hemal,9998,0,9999,1
1745805061992,CLRE 260,A00,891872,Cuomo; Raphael Eduardo,9999,0,9999,0
1745805063017,CLRE 297,001,891888,Cuomo; Raphael Eduardo,9999,0,9999,0
1745805064043,CSE 191,A00,958773,Minnes Kemp; Mor Mia,9999,0,9999,0
1745805065070,CSS 201S,A01,892054,Mignozzetti; Umberto,30,0,30,0
1745805066096,CSS 202S,A01,892056,Mignozzetti; Umberto,30,0,30,0
1745805067120,DSC 197,001,956898,Eldridge; Justin Matthew,9998,0,9999,1
1745805068145,DSC 297,001,958000,Mazumdar; Arya,9998,0,9999,1
1745805069176,EAP 100,A00,905686,Staff,9776,0,9999,223
1745805070202,ECE 45,A01,892618,Staff,0,12,50,50
1745805071228,ECE 109,A01,892620,Staff,0,43,0,0
1745805072255,ECE 111,A01,892719,Staff,0,7,50,50
1745805073282,ECE 197,001,957920,Mercier; Patrick Philip,9992,0,9999,7
1745805074314,ECON 178,A01,907814,Zhu; Ying,28,0,35,7
1745805075341,EDS 115,A00,895312,Staff,41,0,45,4
1745805076374,EDS 117,A01,895337,Staff,30,0,30,0
1745805077404,EDS 125,A00,895341,Jones; Gabrielle Anastasia,43,0,45,2
1745805078428,EDS 128A,A01,895459,Fargason; Sharon Gayle,44,0,45,1
1745805079454,EDS 128B,A01,895543,Pappas; Elizabeth,44,0,45,1
1745805080480,EDS 139,A00,897203,Pappas; Elizabeth,44,0,45,1
1745805080480,EDS 139,B00,897209,Fargason; Sharon Gayle,44,0,45,1
1745805081506,EDS 201,A00,895545,Staff,43,0,45,2
1745805082532,EDS 203,A01,895581,Halter; Christopher P.,43,0,45,2
1745805083559,EDS 204R,A01,895625,Heinzman; Erica M.,43,0,45,2
1745805083559,EDS 204R,B01,895693,Halter; Christopher P.,18,0,45,27
1745805084586,EDS 206R,A00,895694,Fargason; Sharon Gayle,9,0,30,21
1745805084586,EDS 206R,B00,895695,Choi; Bailey Miyeon,20,0,30,10
1745805085613,EDS 250,A00,895697,Hemans; Patricia Ann Benitez,43,0,45,2
1745805086640,EDS 281,A00,895701,Meyerott; Theresa Ann,15,0,15,0
1745805087666,EDS 284,A00,895736,Meyerott; Theresa Ann,15,0,15,0
1745805088691,EDS 286,A00,897210,Fine; Sarah,15,0,15,0
1745805089718,EDS 289C,A01,895770,Daly; Alan J.,15,0,15,0
1745805090747,EDS 290,A00,897211,Hofstetter; Carolyn,15,0,15,0
1745805091777,LIGM 5A,A00,896162,Fischer-Grunski; Eva K,15,0,20,5
1745805092802,LIGM 5B,A00,896260,Fischer-Grunski; Eva K,17,0,20,3
1745805093831,LIGM 5C,A00,896308,Fischer-Grunski; Eva K,18,0,20,2
1745805094859,LIIT 5AS,A00,896313,Carnelos; Chiara,18,0,20,2
1745805095889,LIIT 5BS,A00,896416,Carnelos; Chiara,20,0,20,0
1745805096918,LIIT 5CS,A00,896564,Carnelos; Chiara,20,0,20,0
1745805097943,LISP 5A,A00,896588,Munoz Sanchez; Alicia,4,0,20,16
1745805098972,LISP 5B,A00,896653,Munoz Sanchez; Alicia,10,0,20,10
1745805100005,LISP 5C,A00,896655,Munoz Sanchez; Alicia,4,0,20,16
1745805101032,MAE 197,001,957918,Kleissl; Jan,9998,0,9999,1
1745805102064,MATH 2,A01,957937,Staff,34,0,35,1
1745805103092,MATH 197,001,957876,Kedlaya; Kiran S.,9993,0,9999,6
1745805104122,MCWP 40,A00,892729,Duru; Nur,13,0,20,7
1745805104122,MCWP 40,B00,893304,Montejo; Carolina,20,0,20,0
1745805105147,MCWP 40R,A00,893757,Redela; Pamela Morgan,0,6,20,20
1745805106173,MCWP 50,A00,893758,Morshed; Michael James,2,0,20,18
1745805106173,MCWP 50,B00,893761,Bartulis; Jason Michael,17,0,20,3
1745805107202,MCWP 50R,A00,893766,Compas; Sean Matthew,0,1,20,20
1745805107202,MCWP 50R,B00,893769,Carter; Jennifer A,0,0,20,20
1745805107202,MCWP 50R,C00,893771,Krone; Jarret,0,3,20,20
1745805107202,MCWP 50R,D00,893772,Miller; Elizabeth Deen,3,0,20,17
1745805107202,MCWP 50R,E00,893775,Carter; Andrea L,0,0,20,20
1745805108227,MMW 11R,A01,892721,Herbst; Matthew,11,0,27,16
1745805108227,MMW 11R,A02,892722,Herbst; Matthew,0,0,0,3
1745805109255,MMW 12R,A01,892724,Herbst; Matthew,0,9,16,16
1745805109255,MMW 12R,A02,892725,Herbst; Matthew,0,9,16,16
1745805110280,MMW 13R,A01,892727,Staff,0,4,16,16
1745805110280,MMW 13R,A02,892728,Staff,0,4,16,16
1745805110280,MMW 13R,A03,958032,Staff,0,3,16,16
1745805110280,MMW 13R,A04,958033,Staff,0,2,16,16
1745805110280,MMW 13R,A05,958034,Staff,0,3,16,16
1745805111305,SIO 295LS,A00,894015,Staff,7,0,25,18
1745805112332,SIO 295S,A00,894020,Staff,7,0,25,18
1745805113358,SIOC 290S,B01,958918,Staff,0,0,0,0
1745805114385,SIOC 291S,B01,958922,Staff,0,0,0,0
1745805115414,SOCI 117,A01,895339,Staff,4,0,5,1
1745805116439,WES 237B,A00,894149,Staff,11,0,20,9
1745805118504,AESE 279B,A00,891859,Staff,13,0,35,22
1745805119530,AIP 197,001,891854,Staff,70,0,70,0
1745805120555,ANTH 289S,A00,891856,Gagneux; Pascal,12,0,12,0
1745805121582,BENG 196,001,957946,Engler; Adam J.,9996,0,9999,3
1745805122607,CAT 124RS,A01,956906,Staff,8,0,25,17
1745805123633,CAT 125RS,A01,922013,Staff,8,0,25,17
1745805124660,CLRE 250,A00,891860,Morris; Sheldon,9995,0,9999,4
1745805126714,CLRE 251R,A00,907817,Mehta; Ravindra L.,9994,0,9999,5
1745805127742,CLRE 252,A00,891864,Cuomo; Raphael Eduardo,9993,0,9999,6
1745805128768,CLRE 253,A00,891867,Vaida; Florin,9994,0,9999,5
1745805128768,CLRE 253,B00,907819,Staff,9999,0,9999,0
1745805129799,CLRE 259,A00,891868,Patel; Hemal,9998,0,9999,1
1745805130827,CLRE 260,A00,891872,Cuomo; Raphael Eduardo,9999,0,9999,0
1745805131853,CLRE 297,001,891888,Cuomo; Raphael Eduardo,9999,0,9999,0
1745805132879,CSE 191,A00,958773,Minnes Kemp; Mor Mia,9999,0,9999,0
1745805133907,CSS 201S,A01,892054,Mignozzetti; Umberto,30,0,30,0
1745805134942,CSS 202S,A01,892056,Mignozzetti; Umberto,30,0,30,0
1745805135968,DSC 197,001,956898,Eldridge; Justin Matthew,9998,0,9999,1
1745805136994,DSC 297,001,958000,Mazumdar; Arya,9998,0,9999,1
1745805138021,EAP 100,A00,905686,Staff,9776,0,9999,223
1745805139051,ECE 45,A01,892618,Staff,0,12,50,50
1745805140079,ECE 109,A01,892620,Staff,0,43,0,0
1745805141104,ECE 111,A01,892719,Staff,0,7,50,50
1745805142132,ECE 197,001,957920,Mercier; Patrick Philip,9992,0,9999,7
1745805143161,ECON 178,A01,907814,Zhu; Ying,28,0,35,7
1745805144195,EDS 115,A00,895312,Staff,41,0,45,4
1745805145224,EDS 117,A01,895337,Staff,30,0,30,0
1745805146251,EDS 125,A00,895341,Jones; Gabrielle Anastasia,43,0,45,2
1745805147275,EDS 128A,A01,895459,Fargason; Sharon Gayle,44,0,45,1
1745805148301,EDS 128B,A01,895543,Pappas; Elizabeth,44,0,45,1
1745805149327,EDS 139,A00,897203,Pappas; Elizabeth,44,0,45,1
1745805149327,EDS 139,B00,897209,Fargason; Sharon Gayle,44,0,45,1
1745805150355,EDS 201,A00,895545,Staff,43,0,45,2
1745805151382,EDS 203,A01,895581,Halter; Christopher P.,43,0,45,2
1745805152414,EDS 204R,A01,895625,Heinzman; Erica M.,43,0,45,2
1745805152414,EDS 204R,B01,895693,Halter; Christopher P.,18,0,45,27
1745805153438,EDS 206R,A00,895694,Fargason; Sharon Gayle,9,0,30,21
1745805153438,EDS 206R,B00,895695,Choi; Bailey Miyeon,20,0,30,10
1745805154464,EDS 250,A00,895697,Hemans; Patricia Ann Benitez,43,0,45,2
1745805155492,EDS 281,A00,895701,Meyerott; Theresa Ann,15,0,15,0
1745805156534,EDS 284,A00,895736,Meyerott; Theresa Ann,15,0,15,0
1745805157558,EDS 286,A00,897210,Fine; Sarah,15,0,15,0
1745805158585,EDS 289C,A01,895770,Daly; Alan J.,15,0,15,0
1745805159611,EDS 290,A00,897211,Hofstetter; Carolyn,15,0,15,0
1745805160641,LIGM 5A,A00,896162,Fischer-Grunski; Eva K,15,0,20,5
1745805161668,LIGM 5B,A00,896260,Fischer-Grunski; Eva K,17,0,20,3
1745805162694,LIGM 5C,A00,896308,Fischer-Grunski; Eva K,18,0,20,2
1745805163719,LIIT 5AS,A00,896313,Carnelos; Chiara,18,0,20,2
1745805164747,LIIT 5BS,A00,896416,Carnelos; Chiara,20,0,20,0
1745805165774,LIIT 5CS,A00,896564,Carnelos; Chiara,20,0,20,0
1745805166802,LISP 5A,A00,896588,Munoz Sanchez; Alicia,4,0,20,16
1745805167827,LISP 5B,A00,896653,Munoz Sanchez; Alicia,10,0,20,10
1745805168857,LISP 5C,A00,896655,Munoz Sanchez; Alicia,4,0,20,16
1745805169883,MAE 197,001,957918,Kleissl; Jan,9998,0,9999,1
1745805170912,MATH 2,A01,957937,Staff,34,0,35,1
1745805171939,MATH 197,001,957876,Kedlaya; Kiran S.,9993,0,9999,6
1745805172965,MCWP 40,A00,892729,Duru; Nur,13,0,20,7
1745805172965,MCWP 40,B00,893304,Montejo; Carolina,20,0,20,0
1745805173994,MCWP 40R,A00,893757,Redela; Pamela Morgan,0,6,20,20
1745805175021,MCWP 50,A00,893758,Morshed; Michael James,2,0,20,18
1745805175021,MCWP 50,B00,893761,Bartulis; Jason Michael,17,0,20,3
1745805176049,MCWP 50R,A00,893766,Compas; Sean Matthew,0,1,20,20
1745805176049,MCWP 50R,B00,893769,Carter; Jennifer A,0,0,20,20
1745805176049,MCWP 50R,C00,893771,Krone; Jarret,0,3,20,20
1745805176049,MCWP 50R,D00,893772,Miller; Elizabeth Deen,3,0,20,17
1745805176049,MCWP 50R,E00,893775,Carter; Andrea L,0,0,20,20
1745805177073,MMW 11R,A01,892721,Herbst; Matthew,11,0,27,16
1745805177073,MMW 11R,A02,892722,Herbst; Matthew,0,0,0,3
1745805178099,MMW 12R,A01,892724,Herbst; Matthew,0,9,16,16
1745805178099,MMW 12R,A02,892725,Herbst; Matthew,0,9,16,16
1745805179127,MMW 13R,A01,892727,Staff,0,4,16,16
1745805179127,MMW 13R,A02,892728,Staff,0,4,16,16
1745805179127,MMW 13R,A03,958032,Staff,0,3,16,16
1745805179127,MMW 13R,A04,958033,Staff,0,2,16,16
1745805179127,MMW 13R,A05,958034,Staff,0,3,16,16
1745805180159,SIO 295LS,A00,894015,Staff,7,0,25,18
1745805181185,SIO 295S,A00,894020,Staff,7,0,25,18
1745805182213,SIOC 290S,B01,958918,Staff,0,0,0,0
1745805183246,SIOC 291S,B01,958922,Staff,0,0,0,0
1745805184272,SOCI 117,A01,895339,Staff,4,0,5,1
1745805185296,WES 237B,A00,894149,Staff,11,0,20,9
1745805187353,AESE 279B,A00,891859,Staff,13,0,35,22
1745805188381,AIP 197,001,891854,Staff,70,0,70,0
1745805189410,ANTH 289S,A00,891856,Gagneux; Pascal,12,0,12,0
1745805190433,BENG 196,001,957946,Engler; Adam J.,9996,0,9999,3
1745805191458,CAT 124RS,A01,956906,Staff,8,0,25,17
1745805192487,CAT 125RS,A01,922013,Staff,8,0,25,17
1745805193513,CLRE 250,A00,891860,Morris; Sheldon,9995,0,9999,4
1745805195563,CLRE 251R,A00,907817,Mehta; Ravindra L.,9994,0,9999,5
1745805196590,CLRE 252,A00,891864,Cuomo; Raphael Eduardo,9993,0,9999,6
1745805197621,CLRE 253,A00,891867,Vaida; Florin,9994,0,9999,5
1745805197621,CLRE 253,B00,907819,Staff,9999,0,9999,0
1745805198650,CLRE 259,A00,891868,Patel; Hemal,9998,0,9999,1
1745805199677,CLRE 260,A00,891872,Cuomo; Raphael Eduardo,9999,0,9999,0
1745805200703,CLRE 297,001,891888,Cuomo; Raphael Eduardo,9999,0,9999,0
1745805201731,CSE 191,A00,958773,Minnes Kemp; Mor Mia,9999,0,9999,0
1745805202761,CSS 201S,A01,892054,Mignozzetti; Umberto,30,0,30,0
1745805203787,CSS 202S,A01,892056,Mignozzetti; Umberto,30,0,30,0
1745805204814,DSC 197,001,956898,Eldridge; Justin Matthew,9998,0,9999,1
1745805205840,DSC 297,001,958000,Mazumdar; Arya,9998,0,9999,1
1745805206868,EAP 100,A00,905686,Staff,9776,0,9999,223
1745805207894,ECE 45,A01,892618,Staff,0,12,50,50
1745805208921,ECE 109,A01,892620,Staff,0,43,0,0
1745805209949,ECE 111,A01,892719,Staff,0,7,50,50
1745805210974,ECE 197,001,957920,Mercier; Patrick Philip,9992,0,9999,7
1745805212006,ECON 178,A01,907814,Zhu; Ying,28,0,35,7
1745805213033,EDS 115,A00,895312,Staff,41,0,45,4
1745805214060,EDS 117,A01,895337,Staff,30,0,30,0
1745805215089,EDS 125,A00,895341,Jones; Gabrielle Anastasia,43,0,45,2
1745805216119,EDS 128A,A01,895459,Fargason; Sharon Gayle,44,0,45,1
1745805217146,EDS 128B,A01,895543,Pappas; Elizabeth,44,0,45,1
1745805218175,EDS 139,A00,897203,Pappas; Elizabeth,44,0,45,1
1745805218175,EDS 139,B00,897209,Fargason; Sharon Gayle,44,0,45,1
1745805219203,EDS 201,A00,895545,Staff,43,0,45,2
1745805220229,EDS 203,A01,895581,Halter; Christopher P.,43,0,45,2
1745805221255,EDS 204R,A01,895625,Heinzman; Erica M.,43,0,45,2
1745805221255,EDS 204R,B01,895693,Halter; Christopher P.,18,0,45,27
1745805222283,EDS 206R,A00,895694,Fargason; Sharon Gayle,9,0,30,21
1745805222283,EDS 206R,B00,895695,Choi; Bailey Miyeon,20,0,30,10
1745805223311,EDS 250,A00,895697,Hemans; Patricia Ann Benitez,43,0,45,2
1745805224337,EDS 281,A00,895701,Meyerott; Theresa Ann,15,0,15,0
1745805225361,EDS 284,A00,895736,Meyerott; Theresa Ann,15,0,15,0
1745805226388,EDS 286,A00,897210,Fine; Sarah,15,0,15,0
1745805227415,EDS 289C,A01,895770,Daly; Alan J.,15,0,15,0
1745805228440,EDS 290,A00,897211,Hofstetter; Carolyn,15,0,15,0
1745805229471,LIGM 5A,A00,896162,Fischer-Grunski; Eva K,15,0,20,5
1745805230496,LIGM 5B,A00,896260,Fischer-Grunski; Eva K,17,0,20,3
1745805231521,LIGM 5C,A00,896308,Fischer-Grunski; Eva K,18,0,20,2
1745805232546,LIIT 5AS,A00,896313,Carnelos; Chiara,18,0,20,2
1745805233571,LIIT 5BS,A00,896416,Carnelos; Chiara,20,0,20,0
1745805234601,LIIT 5CS,A00,896564,Carnelos; Chiara,20,0,20,0
1745805235627,LISP 5A,A00,896588,Munoz Sanchez; Alicia,4,0,20,16
1745805236658,LISP 5B,A00,896653,Munoz Sanchez; Alicia,10,0,20,10
1745805237686,LISP 5C,A00,896655,Munoz Sanchez; Alicia,4,0,20,16
1745805238710,MAE 197,001,957918,Kleissl; Jan,9998,0,9999,1
1745805239739,MATH 2,A01,957937,Staff,34,0,35,1
1745805240764,MATH 197,001,957876,Kedlaya; Kiran S.,9993,0,9999,6
1745805241794,MCWP 40,A00,892729,Duru; Nur,13,0,20,7
1745805241794,MCWP 40,B00,893304,Montejo; Carolina,20,0,20,0
1745805242821,MCWP 40R,A00,893757,Redela; Pamela Morgan,0,6,20,20
1745805243849,MCWP 50,A00,893758,Morshed; Michael James,2,0,20,18
1745805243849,MCWP 50,B00,893761,Bartulis; Jason Michael,17,0,20,3
1745805244877,MCWP 50R,A00,893766,Compas; Sean Matthew,0,1,20,20
1745805244877,MCWP 50R,B00,893769,Carter; Jennifer A,0,0,20,20
1745805244877,MCWP 50R,C00,893771,Krone; Jarret,0,3,20,20
1745805244877,MCWP 50R,D00,893772,Miller; Elizabeth Deen,3,0,20,17
1745805244877,MCWP 50R,E00,893775,Carter; Andrea L,0,0,20,20
1745805245902,MMW 11R,A01,892721,Herbst; Matthew,11,0,27,16
1745805245902,MMW 11R,A02,892722,Herbst; Matthew,0,0,0,3
1745805246929,MMW 12R,A01,892724,Herbst; Matthew,0,9,16,16
1745805246929,MMW 12R,A02,892725,Herbst; Matthew,0,9,16,16
1745805247954,MMW 13R,A01,892727,Staff,0,4,16,16
1745805247954,MMW 13R,A02,892728,Staff,0,4,16,16
1745805247954,MMW 13R,A03,958032,Staff,0,3,16,16
1745805247954,MMW 13R,A04,958033,Staff,0,2,16,16
1745805247954,MMW 13R,A05,958034,Staff,0,3,16,16
1745805248981,SIO 295LS,A00,894015,Staff,7,0,25,18
1745805250008,SIO 295S,A00,894020,Staff,7,0,25,18
1745805251038,SIOC 290S,B01,958918,Staff,0,0,0,0
1745805252066,SIOC 291S,B01,958922,Staff,0,0,0,0
1745805253092,SOCI 117,A01,895339,Staff,4,0,5,1
1745805254122,WES 237B,A00,894149,Staff,11,0,20,9
1745805256181,AESE 279B,A00,891859,Staff,13,0,35,22
1745805257206,AIP 197,001,891854,Staff,70,0,70,0
1745805258232,ANTH 289S,A00,891856,Gagneux; Pascal,12,0,12,0
1745805259263,BENG 196,001,957946,Engler; Adam J.,9996,0,9999,3
1745805260291,CAT 124RS,A01,956906,Staff,8,0,25,17
1745805261323,CAT 125RS,A01,922013,Staff,8,0,25,17
1745805262349,CLRE 250,A00,891860,Morris; Sheldon,9995,0,9999,4
1745805264402,CLRE 251R,A00,907817,Mehta; Ravindra L.,9994,0,9999,5
1745805265430,CLRE 252,A00,891864,Cuomo; Raphael Eduardo,9993,0,9999,6
1745805266459,CLRE 253,A00,891867,Vaida; Florin,9994,0,9999,5
1745805266459,CLRE 253,B00,907819,Staff,9999,0,9999,0
1745805267488,CLRE 259,A00,891868,Patel; Hemal,9998,0,9999,1
1745805268517,CLRE 260,A00,891872,Cuomo; Raphael Eduardo,9999,0,9999,0
1745805269542,CLRE 297,001,891888,Cuomo; Raphael Eduardo,9999,0,9999,0
1745805270568,CSE 191,A00,958773,Minnes Kemp; Mor Mia,9999,0,9999,0
1745805271596,CSS 201S,A01,892054,Mignozzetti; Umberto,30,0,30,0
1745805272627,CSS 202S,A01,892056,Mignozzetti; Umberto,30,0,30,0
1745805273653,DSC 197,001,956898,Eldridge; Justin Matthew,9998,0,9999,1
1745805274677,DSC 297,001,958000,Mazumdar; Arya,9998,0,9999,1
1745805275703,EAP 100,A00,905686,Staff,9776,0,9999,223
1745805276733,ECE 45,A01,892618,Staff,0,12,50,50
1745805277757,ECE 109,A01,892620,Staff,0,43,0,0
1745805278786,ECE 111,A01,892719,Staff,0,7,50,50
1745805279819,ECE 197,001,957920,Mercier; Patrick Philip,9992,0,9999,7
1745805280845,ECON 178,A01,907814,Zhu; Ying,28,0,35,7
1745805281872,EDS 115,A00,895312,Staff,41,0,45,4
1745805282899,EDS 117,A01,895337,Staff,30,0,30,0
1745805283928,EDS 125,A00,895341,Jones; Gabrielle Anastasia,43,0,45,2
1745805284958,EDS 128A,A01,895459,Fargason; Sharon Gayle,44,0,45,1
1745805285984,EDS 128B,A01,895543,Pappas; Elizabeth,44,0,45,1
1745805287013,EDS 139,A00,897203,Pappas; Elizabeth,44,0,45,1
1745805287013,EDS 139,B00,897209,Fargason; Sharon Gayle,44,0,45,1
1745805288041,EDS 201,A00,895545,Staff,43,0,45,2
1745805289068,EDS 203,A01,895581,Halter; Christopher P.,43,0,45,2
1745805290095,EDS 204R,A01,895625,Heinzman; Erica M.,43,0,45,2
1745805290095,EDS 204R,B01,895693,Halter; Christopher P.,18,0,45,27
1745805291122,EDS 206R,A00,895694,Fargason; Sharon Gayle,9,0,30,21
1745805291122,EDS 206R,B00,895695,Choi; Bailey Miyeon,20,0,30,10
1745805292147,EDS 250,A00,895697,Hemans; Patricia Ann Benitez,43,0,45,2
1745805293172,EDS 281,A00,895701,Meyerott; Theresa Ann,15,0,15,0
1745805294199,EDS 284,A00,895736,Meyerott; Theresa Ann,15,0,15,0
1745805295226,EDS 286,A00,897210,Fine; Sarah,15,0,15,0
1745805296252,EDS 289C,A01,895770,Daly; Alan J.,15,0,15,0
1745805297278,EDS 290,A00,897211,Hofstetter; Carolyn,15,0,15,0
1745805298302,LIGM 5A,A00,896162,Fischer-Grunski; Eva K,15,0,20,5
1745805299332,LIGM 5B,A00,896260,Fischer-Grunski; Eva K,17,0,20,3
1745805300377,LIGM 5C,A00,896308,Fischer-Grunski; Eva K,18,0,20,2
1745805301404,LIIT 5AS,A00,896313,Carnelos; Chiara,18,0,20,2
1745805302449,LIIT 5BS,A00,896416,Carnelos; Chiara,20,0,20,0
1745805303477,LIIT 5CS,A00,896564,Carnelos; Chiara,20,0,20,0
1745805304506,LISP 5A,A00,896588,Munoz Sanchez; Alicia,4,0,20,16
1745805305534,LISP 5B,A00,896653,Munoz Sanchez; Alicia,10,0,20,10
1745805306565,LISP 5C,A00,896655,Munoz Sanchez; Alicia,4,0,20,16
1745805307592,MAE 197,001,957918,Kleissl; Jan,9998,0,9999,1
1745805308618,MATH 2,A01,957937,Staff,34,0,35,1
1745805309646,MATH 197,001,957876,Kedlaya; Kiran S.,9993,0,9999,6
1745805310673,MCWP 40,A00,892729,Duru; Nur,13,0,20,7
1745805310673,MCWP 40,B00,893304,Montejo; Carolina,20,0,20,0
1745805311701,MCWP 40R,A00,893757,Redela; Pamela Morgan,0,6,20,20
1745805312727,MCWP 50,A00,893758,Morshed; Michael James,2,0,20,18
1745805312727,MCWP 50,B00,893761,Bartulis; Jason Michael,17,0,20,3
1745805313756,MCWP 50R,A00,893766,Compas; Sean Matthew,0,1,20,20
1745805313756,MCWP 50R,B00,893769,Carter; Jennifer A,0,0,20,20
1745805313756,MCWP 50R,C00,893771,Krone; Jarret,0,3,20,20
1745805313756,MCWP 50R,D00,893772,Miller; Elizabeth Deen,3,0,20,17
1745805313756,MCWP 50R,E00,893775,Carter; Andrea L,0,0,20,20
1745805314781,MMW 11R,A01,892721,Herbst; Matthew,11,0,27,16
1745805314781,MMW 11R,A02,892722,Herbst; Matthew,0,0,0,3
1745805315812,MMW 12R,A01,892724,Herbst; Matthew,0,9,16,16
1745805315812,MMW 12R,A02,892725,Herbst; Matthew,0,9,16,16
1745805316837,MMW 13R,A01,892727,Staff,0,4,16,16
1745805316837,MMW 13R,A02,892728,Staff,0,4,16,16
1745805316837,MMW 13R,A03,958032,Staff,0,3,16,16
1745805316837,MMW 13R,A04,958033,Staff,0,2,16,16
1745805316837,MMW 13R,A05,958034,Staff,0,3,16,16
1745805317866,SIO 295LS,A00,894015,Staff,7,0,25,18
1745805318891,SIO 295S,A00,894020,Staff,7,0,25,18
1745805319918,SIOC 290S,B01,958918,Staff,0,0,0,0
1745805320944,SIOC 291S,B01,958922,Staff,0,0,0,0
1745805321973,SOCI 117,A01,895339,Staff,4,0,5,1
1745805323000,WES 237B,A00,894149,Staff,11,0,20,9
1745805325065,AESE 279B,A00,891859,Staff,13,0,35,22
1745805326092,AIP 197,001,891854,Staff,70,0,70,0
1745805327119,ANTH 289S,A00,891856,Gagneux; Pascal,12,0,12,0
1745805328143,BENG 196,001,957946,Engler; Adam J.,9996,0,9999,3
1745805329168,CAT 124RS,A01,956906,Staff,8,0,25,17
1745805330195,CAT 125RS,A01,922013,Staff,8,0,25,17
1745805331225,CLRE 250,A00,891860,Morris; Sheldon,9995,0,9999,4
1745805333278,CLRE 251R,A00,907817,Mehta; Ravindra L.,9994,0,9999,5
1745805334306,CLRE 252,A00,891864,Cuomo; Raphael Eduardo,9993,0,9999,6
1745805335334,CLRE 253,A00,891867,Vaida; Florin,9994,0,9999,5
1745805335334,CLRE 253,B00,907819,Staff,9999,0,9999,0
1745805336360,CLRE 259,A00,891868,Patel; Hemal,9998,0,9999,1
1745805337386,CLRE 260,A00,891872,Cuomo; Raphael Eduardo,9999,0,9999,0
1745805338413,CLRE 297,001,891888,Cuomo; Raphael Eduardo,9999,0,9999,0
1745805339440,CSE 191,A00,958773,Minnes Kemp; Mor Mia,9999,0,9999,0
1745805340463,CSS 201S,A01,892054,Mignozzetti; Umberto,30,0,30,0
1745805341487,CSS 202S,A01,892056,Mignozzetti; Umberto,30,0,30,0
1745805342516,DSC 197,001,956898,Eldridge; Justin Matthew,9998,0,9999,1
1745805343538,DSC 297,001,958000,Mazumdar; Arya,9998,0,9999,1
1745805344563,EAP 100,A00,905686,Staff,9776,0,9999,223
1745805345586,ECE 45,A01,892618,Staff,0,12,50,50
1745805346613,ECE 109,A01,892620,Staff,0,43,0,0
1745805347640,ECE 111,A01,892719,Staff,0,7,50,50
1745805348666,ECE 197,001,957920,Mercier; Patrick Philip,9992,0,9999,7
1745805349695,ECON 178,A01,907814,Zhu; Ying,28,0,35,7
1745805350723,EDS 115,A00,895312,Staff,41,0,45,4
1745805351747,EDS 117,A01,895337,Staff,30,0,30,0
1745805352771,EDS 125,A00,895341,Jones; Gabrielle Anastasia,43,0,45,2
1745805353794,EDS 128A,A01,895459,Fargason; Sharon Gayle,44,0,45,1
1745805354822,EDS 128B,A01,895543,Pappas; Elizabeth,44,0,45,1
1745805355845,EDS 139,A00,897203,Pappas; Elizabeth,44,0,45,1
1745805355845,EDS 139,B00,897209,Fargason; Sharon Gayle,44,0,45,1
1745805356870,EDS 201,A00,895545,Staff,43,0,45,2
1745805357897,EDS 203,A01,895581,Halter; Christopher P.,43,0,45,2
1745805358925,EDS 204R,A01,895625,Heinzman; Erica M.,43,0,45,2
1745805358925,EDS 204R,B01,895693,Halter; Christopher P.,18,0,45,27
1745805359953,EDS 206R,A00,895694,Fargason; Sharon Gayle,9,0,30,21
1745805359953,EDS 206R,B00,895695,Choi; Bailey Miyeon,20,0,30,10
1745805360981,EDS 250,A00,895697,Hemans; Patricia Ann Benitez,43,0,45,2
1745805362010,EDS 281,A00,895701,Meyerott; Theresa Ann,15,0,15,0
1745805363036,EDS 284,A00,895736,Meyerott; Theresa Ann,15,0,15,0
1745805364060,EDS 286,A00,897210,Fine; Sarah,15,0,15,0
1745805365084,EDS 289C,A01,895770,Daly; Alan J.,15,0,15,0
1745805366109,EDS 290,A00,897211,Hofstetter; Carolyn,15,0,15,0
1745805367134,LIGM 5A,A00,896162,Fischer-Grunski; Eva K,15,0,20,5
1745805368162,LIGM 5B,A00,896260,Fischer-Grunski; Eva K,17,0,20,3
1745805369190,LIGM 5C,A00,896308,Fischer-Grunski; Eva K,18,0,20,2
1745805370215,LIIT 5AS,A00,896313,Carnelos; Chiara,18,0,20,2
1745805371240,LIIT 5BS,A00,896416,Carnelos; Chiara,20,0,20,0
1745805372267,LIIT 5CS,A00,896564,Carnelos; Chiara,20,0,20,0
1745805373291,LISP 5A,A00,896588,Munoz Sanchez; Alicia,4,0,20,16
1745805374318,LISP 5B,A00,896653,Munoz Sanchez; Alicia,10,0,20,10
1745805375345,LISP 5C,A00,896655,Munoz Sanchez; Alicia,4,0,20,16
1745805376369,MAE 197,001,957918,Kleissl; Jan,9998,0,9999,1
1745805377395,MATH 2,A01,957937,Staff,34,0,35,1
1745805378419,MATH 197,001,957876,Kedlaya; Kiran S.,9993,0,9999,6
1745805379445,MCWP 40,A00,892729,Duru; Nur,13,0,20,7
1745805379445,MCWP 40,B00,893304,Montejo; Carolina,20,0,20,0
1745805380474,MCWP 40R,A00,893757,Redela; Pamela Morgan,0,6,20,20
1745805381502,MCWP 50,A00,893758,Morshed; Michael James,2,0,20,18
1745805381502,MCWP 50,B00,893761,Bartulis; Jason Michael,17,0,20,3
1745805382528,MCWP 50R,A00,893766,Compas; Sean Matthew,0,1,20,20
1745805382528,MCWP 50R,B00,893769,Carter; Jennifer A,0,0,20,20
1745805382528,MCWP 50R,C00,893771,Krone; Jarret,0,3,20,20
1745805382528,MCWP 50R,D00,893772,Miller; Elizabeth Deen,3,0,20,17
1745805382528,MCWP 50R,E00,893775,Carter; Andrea L,0,0,20,20
1745805383553,MMW 11R,A01,892721,Herbst; Matthew,11,0,27,16
1745805383553,MMW 11R,A02,892722,Herbst; Matthew,0,0,0,3
1745805384612,MMW 12R,A01,892724,Herbst; Matthew,0,9,16,16
1745805384612,MMW 12R,A02,892725,Herbst; Matthew,0,9,16,16
1745805385636,MMW 13R,A01,892727,Staff,0,4,16,16
1745805385636,MMW 13R,A02,892728,Staff,0,4,16,16
1745805385636,MMW 13R,A03,958032,Staff,0,3,16,16
1745805385636,MMW 13R,A04,958033,Staff,0,2,16,16
1745805385636,MMW 13R,A05,958034,Staff,0,3,16,16
1745805386661,SIO 295LS,A00,894015,Staff,7,0,25,18
1745805387688,SIO 295S,A00,894020,Staff,7,0,25,18
1745805388711,SIOC 290S,B01,958918,Staff,0,0,0,0
1745805389745,SIOC 291S,B01,958922,Staff,0,0,0,0
1745805390771,SOCI 117,A01,895339,Staff,4,0,5,1
1745805391798,WES 237B,A00,894149,Staff,11,0,20,9
1745805393864,AESE 279B,A00,891859,Staff,13,0,35,22
1745805394890,AIP 197,001,891854,Staff,70,0,70,0
1745805395917,ANTH 289S,A00,891856,Gagneux; Pascal,12,0,12,0
1745805396941,BENG 196,001,957946,Engler; Adam J.,9996,0,9999,3
1745805397965,CAT 124RS,A01,956906,Staff,8,0,25,17
1745805398992,CAT 125RS,A01,922013,Staff,8,0,25,17
1745805400018,CLRE 250,A00,891860,Morris; Sheldon,9995,0,9999,4
1745805402071,CLRE 251R,A00,907817,Mehta; Ravindra L.,9994,0,9999,5
1745805403097,CLRE 252,A00,891864,Cuomo; Raphael Eduardo,9993,0,9999,6
1745805404124,CLRE 253,A00,891867,Vaida; Florin,9994,0,9999,5
1745805404124,CLRE 253,B00,907819,Staff,9999,0,9999,0
1745805405149,CLRE 259,A00,891868,Patel; Hemal,9998,0,9999,1
1745805406174,CLRE 260,A00,891872,Cuomo; Raphael Eduardo,9999,0,9999,0
1745805407200,CLRE 297,001,891888,Cuomo; Raphael Eduardo,9999,0,9999,0
1745805408228,CSE 191,A00,958773,Minnes Kemp; Mor Mia,9999,0,9999,0
1745805409254,CSS 201S,A01,892054,Mignozzetti; Umberto,30,0,30,0
1745805410278,CSS 202S,A01,892056,Mignozzetti; Umberto,30,0,30,0
1745805411301,DSC 197,001,956898,Eldridge; Justin Matthew,9998,0,9999,1
1745805412325,DSC 297,001,958000,Mazumdar; Arya,9998,0,9999,1
1745805413348,EAP 100,A00,905686,Staff,9776,0,9999,223
1745805414372,ECE 45,A01,892618,Staff,0,12,50,50
1745805415398,ECE 109,A01,892620,Staff,0,43,0,0
1745805416424,ECE 111,A01,892719,Staff,0,7,50,50
1745805417450,ECE 197,001,957920,Mercier; Patrick Philip,9992,0,9999,7
1745805418477,ECON 178,A01,907814,Zhu; Ying,28,0,35,7
1745805419501,EDS 115,A00,895312,Staff,41,0,45,4
1745805420526,EDS 117,A01,895337,Staff,30,0,30,0
1745805421548,EDS 125,A00,895341,Jones; Gabrielle Anastasia,43,0,45,2
1745805422572,EDS 128A,A01,895459,Fargason; Sharon Gayle,44,0,45,1
1745805423599,EDS 128B,A01,895543,Pappas; Elizabeth,44,0,45,1
1745805424623,EDS 139,A00,897203,Pappas; Elizabeth,44,0,45,1
1745805424623,EDS 139,B00,897209,Fargason; Sharon Gayle,44,0,45,1
1745805425646,EDS 201,A00,895545,Staff,43,0,45,2
1745805426673,EDS 203,A01,895581,Halter; Christopher P.,43,0,45,2
1745805427696,EDS 204R,A01,895625,Heinzman; Erica M.,43,0,45,2
1745805427696,EDS 204R,B01,895693,Halter; Christopher P.,18,0,45,27
1745805428722,EDS 206R,A00,895694,Fargason; Sharon Gayle,9,0,30,21
1745805428722,EDS 206R,B00,895695,Choi; Bailey Miyeon,20,0,30,10
1745805429748,EDS 250,A00,895697,Hemans; Patricia Ann Benitez,43,0,45,2
1745805430775,EDS 281,A00,895701,Meyerott; Theresa Ann,15,0,15,0
1745805431799,EDS 284,A00,895736,Meyerott; Theresa Ann,15,0,15,0
1745805432824,EDS 286,A00,897210,Fine; Sarah,15,0,15,0
1745805433850,EDS 289C,A01,895770,Daly; Alan J.,15,0,15,0
1745805434875,EDS 290,A00,897211,Hofstetter; Carolyn,15,0,15,0
1745805435898,LIGM 5A,A00,896162,Fischer-Grunski; Eva K,15,0,20,5
1745805436920,LIGM 5B,A00,896260,Fischer-Grunski; Eva K,17,0,20,3
1745805437945,LIGM 5C,A00,896308,Fischer-Grunski; Eva K,18,0,20,2
1745805438969,LIIT 5AS,A00,896313,Carnelos; Chiara,18,0,20,2
1745805439995,LIIT 5BS,A00,896416,Carnelos; Chiara,20,0,20,0
1745805441019,LIIT 5CS,A00,896564,Carnelos; Chiara,20,0,20,0
1745805442046,LISP 5A,A00,896588,Munoz Sanchez; Alicia,4,0,20,16
1745805443072,LISP 5B,A00,896653,Munoz Sanchez; Alicia,10,0,20,10
1745805444098,LISP 5C,A00,896655,Munoz Sanchez; Alicia,4,0,20,16
1745805445121,MAE 197,001,957918,Kleissl; Jan,9998,0,9999,1
1745805446146,MATH 2,A01,957937,Staff,34,0,35,1
1745805447172,MATH 197,001,957876,Kedlaya; Kiran S.,9993,0,9999,6
1745805448197,MCWP 40,A00,892729,Duru; Nur,13,0,20,7
1745805448197,MCWP 40,B00,893304,Montejo; Carolina,20,0,20,0
1745805449220,MCWP 40R,A00,893757,Redela; Pamela Morgan,0,6,20,20
1745805450245,MCWP 50,A00,893758,Morshed; Michael James,2,0,20,18
1745805450245,MCWP 50,B00,893761,Bartulis; Jason Michael,17,0,20,3
1745805451270,MCWP 50R,A00,893766,Compas; Sean Matthew,0,1,20,20
1745805451270,MCWP 50R,B00,893769,Carter; Jennifer A,0,0,20,20
1745805451270,MCWP 50R,C00,893771,Krone; Jarret,0,3,20,20
1745805451270,MCWP 50R,D00,893772,Miller; Elizabeth Deen,3,0,20,17
1745805451270,MCWP 50R,E00,893775,Carter; Andrea L,0,0,20,20
1745805452304,MMW 11R,A01,892721,Herbst; Matthew,11,0,27,16
1745805452304,MMW 11R,A02,892722,Herbst; Matthew,0,0,0,3
1745805453329,MMW 12R,A01,892724,Herbst; Matthew,0,9,16,16
1745805453329,MMW 12R,A02,892725,Herbst; Matthew,0,9,16,16
1745805454361,MMW 13R,A01,892727,Staff,0,4,16,16
1745805454361,MMW 13R,A02,892728,Staff,0,4,16,16
1745805454361,MMW 13R,A03,958032,Staff,0,3,16,16
1745805454361,MMW 13R,A04,958033,Staff,0,2,16,16
1745805454361,MMW 13R,A05,958034,Staff,0,3,16,16
1745805455387,SIO 295LS,A00,894015,Staff,7,0,25,18
1745805456410,SIO 295S,A00,894020,Staff,7,0,25,18
1745805457434,SIOC 290S,B01,958918,Staff,0,0,0,0
1745805458462,SIOC 291S,B01,958922,Staff,0,0,0,0
1745805459487,SOCI 117,A01,895339,Staff,4,0,5,1
1745805460510,WES 237B,A00,894149,Staff,11,0,20,9
1745805462588,AESE 279B,A00,891859,Staff,13,0,35,22
1745805463613,AIP 197,001,891854,Staff,70,0,70,0
1745805464637,ANTH 289S,A00,891856,Gagneux; Pascal,12,0,12,0
1745805465662,BENG 196,001,957946,Engler; Adam J.,9996,0,9999,3
1745805466689,CAT 124RS,A01,956906,Staff,8,0,25,17
1745805467713,CAT 125RS,A01,922013,Staff,8,0,25,17
1745805468739,CLRE 250,A00,891860,Morris; Sheldon,9995,0,9999,4
1745805470789,CLRE 251R,A00,907817,Mehta; Ravindra L.,9994,0,9999,5
1745805471818,CLRE 252,A00,891864,Cuomo; Raphael Eduardo,9993,0,9999,6
1745805472842,CLRE 253,A00,891867,Vaida; Florin,9994,0,9999,5
1745805472842,CLRE 253,B00,907819,Staff,9999,0,9999,0
1745805473879,CLRE 259,A00,891868,Patel; Hemal,9998,0,9999,1
1745805474904,CLRE 260,A00,891872,Cuomo; Raphael Eduardo,9999,0,9999,0
1745805475933,CLRE 297,001,891888,Cuomo; Raphael Eduardo,9999,0,9999,0
1745805476958,CSE 191,A00,958773,Minnes Kemp; Mor Mia,9999,0,9999,0
1745805477987,CSS 201S,A01,892054,Mignozzetti; Umberto,30,0,30,0
1745805479012,CSS 202S,A01,892056,Mignozzetti; Umberto,30,0,30,0
1745805480076,DSC 197,001,956898,Eldridge; Justin Matthew,9998,0,9999,1
1745805481105,DSC 297,001,958000,Mazumdar; Arya,9998,0,9999,1
1745805482131,EAP 100,A00,905686,Staff,9776,0,9999,223
1745805483158,ECE 45,A01,892618,Staff,0,12,50,50
1745805484184,ECE 109,A01,892620,Staff,0,43,0,0
1745805485211,ECE 111,A01,892719,Staff,0,7,50,50
1745805486238,ECE 197,001,957920,Mercier; Patrick Philip,9992,0,9999,7
1745805487268,ECON 178,A01,907814,Zhu; Ying,28,0,35,7
1745805488294,EDS 115,A00,895312,Staff,41,0,45,4
1745805489322,EDS 117,A01,895337,Staff,30,0,30,0
1745805490347,EDS 125,A00,895341,Jones; Gabrielle Anastasia,43,0,45,2
1745805491376,EDS 128A,A01,895459,Fargason; Sharon Gayle,44,0,45,1
1745805492400,EDS 128B,A01,895543,Pappas; Elizabeth,44,0,45,1
1745805493425,EDS 139,A00,897203,Pappas; Elizabeth,44,0,45,1
1745805493425,EDS 139,B00,897209,Fargason; Sharon Gayle,44,0,45,1
1745805494451,EDS 201,A00,895545,Staff,43,0,45,2
1745805495477,EDS 203,A01,895581,Halter; Christopher P.,43,0,45,2
1745805496502,EDS 204R,A01,895625,Heinzman; Erica M.,43,0,45,2
1745805496502,EDS 204R,B01,895693,Halter; Christopher P.,18,0,45,27
1745805497530,EDS 206R,A00,895694,Fargason; Sharon Gayle,9,0,30,21
1745805497530,EDS 206R,B00,895695,Choi; Bailey Miyeon,20,0,30,10
1745805498556,EDS 250,A00,895697,Hemans; Patricia Ann Benitez,43,0,45,2
1745805499580,EDS 281,A00,895701,Meyerott; Theresa Ann,15,0,15,0
1745805500609,EDS 284,A00,895736,Meyerott; Theresa Ann,15,0,15,0
1745805501636,EDS 286,A00,897210,Fine; Sarah,15,0,15,0
1745805502662,EDS 289C,A01,895770,Daly; Alan J.,15,0,15,0
1745805503692,EDS 290,A00,897211,Hofstetter; Carolyn,15,0,15,0
1745805504718,LIGM 5A,A00,896162,Fischer-Grunski; Eva K,15,0,20,5
1745805505745,LIGM 5B,A00,896260,Fischer-Grunski; Eva K,17,0,20,3
1745805506771,LIGM 5C,A00,896308,Fischer-Grunski; Eva K,18,0,20,2
1745805507801,LIIT 5AS,A00,896313,Carnelos; Chiara,18,0,20,2
1745805508826,LIIT 5BS,A00,896416,Carnelos; Chiara,20,0,20,0
1745805509851,LIIT 5CS,A00,896564,Carnelos; Chiara,20,0,20,0
1745805510882,LISP 5A,A00,896588,Munoz Sanchez; Alicia,4,0,20,16
1745805511908,LISP 5B,A00,896653,Munoz Sanchez; Alicia,10,0,20,10
1745805512933,LISP 5C,A00,896655,Munoz Sanchez; Alicia,4,0,20,16
1745805513963,MAE 197,001,957918,Kleissl; Jan,9998,0,9999,1
1745805514989,MATH 2,A01,957937,Staff,34,0,35,1
1745805516015,MATH 197,001,957876,Kedlaya; Kiran S.,9993,0,9999,6
1745805517043,MCWP 40,A00,892729,Duru; Nur,13,0,20,7
1745805517043,MCWP 40,B00,893304,Montejo; Carolina,20,0,20,0
1745805518069,MCWP 40R,A00,893757,Redela; Pamela Morgan,0,6,20,20
1745805519097,MCWP 50,A00,893758,Morshed; Michael James,2,0,20,18
1745805519097,MCWP 50,B00,893761,Bartulis; Jason Michael,17,0,20,3
1745805520128,MCWP 50R,A00,893766,Compas; Sean Matthew,0,1,20,20
1745805520128,MCWP 50R,B00,893769,Carter; Jennifer A,0,0,20,20
1745805520128,MCWP 50R,C00,893771,Krone; Jarret,0,3,20,20
1745805520128,MCWP 50R,D00,893772,Miller; Elizabeth Deen,3,0,20,17
1745805520128,MCWP 50R,E00,893775,Carter; Andrea L,0,0,20,20
1745805521160,MMW 11R,A01,892721,Herbst; Matthew,11,0,27,16
1745805521160,MMW 11R,A02,892722,Herbst; Matthew,0,0,0,3
1745805522188,MMW 12R,A01,892724,Herbst; Matthew,0,9,16,16
1745805522188,MMW 12R,A02,892725,Herbst; Matthew,0,9,16,16
1745805523214,MMW 13R,A01,892727,Staff,0,4,16,16
1745805523214,MMW 13R,A02,892728,Staff,0,4,16,16
1745805523214,MMW 13R,A03,958032,Staff,0,3,16,16
1745805523214,MMW 13R,A04,958033,Staff,0,2,16,16
1745805523214,MMW 13R,A05,958034,Staff,0,3,16,16
1745805524246,SIO 295LS,A00,894015,Staff,7,0,25,18
1745805525275,SIO 295S,A00,894020,Staff,7,0,25,18
1745805526302,SIOC 290S,B01,958918,Staff,0,0,0,0
1745805527329,SIOC 291S,B01,958922,Staff,0,0,0,0
1745805528358,SOCI 117,A01,895339,Staff,4,0,5,1
1745805529385,WES 237B,A00,894149,Staff,11,0,20,9
1745805531451,AESE 279B,A00,891859,Staff,13,0,35,22
1745805532477,AIP 197,001,891854,Staff,70,0,70,0
1745805533502,ANTH 289S,A00,891856,Gagneux; Pascal,12,0,12,0
1745805534526,BENG 196,001,957946,Engler; Adam J.,9996,0,9999,3
1745805535551,CAT 124RS,A01,956906,Staff,8,0,25,17
1745805536577,CAT 125RS,A01,922013,Staff,8,0,25,17
1745805537605,CLRE 250,A00,891860,Morris; Sheldon,9995,0,9999,4
1745805539656,CLRE 251R,A00,907817,Mehta; Ravindra L.,9994,0,9999,5
1745805540683,CLRE 252,A00,891864,Cuomo; Raphael Eduardo,9993,0,9999,6
1745805541711,CLRE 253,A00,891867,Vaida; Florin,9994,0,9999,5
1745805541711,CLRE 253,B00,907819,Staff,9999,0,9999,0
1745805542738,CLRE 259,A00,891868,Patel; Hemal,9998,0,9999,1
1745805543764,CLRE 260,A00,891872,Cuomo; Raphael Eduardo,9999,0,9999,0
1745805544793,CLRE 297,001,891888,Cuomo; Raphael Eduardo,9999,0,9999,0
1745805545818,CSE 191,A00,958773,Minnes Kemp; Mor Mia,9999,0,9999,0
1745805546844,CSS 201S,A01,892054,Mignozzetti; Umberto,30,0,30,0
1745805547871,CSS 202S,A01,892056,Mignozzetti; Umberto,30,0,30,0
1745805548897,DSC 197,001,956898,Eldridge; Justin Matthew,9998,0,9999,1
1745805549923,DSC 297,001,958000,Mazumdar; Arya,9998,0,9999,1
1745805550947,EAP 100,A00,905686,Staff,9776,0,9999,223
1745805551973,ECE 45,A01,892618,Staff,0,12,50,50
1745805553000,ECE 109,A01,892620,Staff,0,43,0,0
1745805554027,ECE 111,A01,892719,Staff,0,7,50,50
1745805555055,ECE 197,001,957920,Mercier; Patrick Philip,9992,0,9999,7
1745805556082,ECON 178,A01,907814,Zhu; Ying,28,0,35,7
1745805557108,EDS 115,A00,895312,Staff,41,0,45,4
1745805558137,EDS 117,A01,895337,Staff,30,0,30,0
1745805559165,EDS 125,A00,895341,Jones; Gabrielle Anastasia,43,0,45,2
1745805560194,EDS 128A,A01,895459,Fargason; Sharon Gayle,44,0,45,1
1745805561218,EDS 128B,A01,895543,Pappas; Elizabeth,44,0,45,1
1745805562245,EDS 139,A00,897203,Pappas; Elizabeth,44,0,45,1
1745805562245,EDS 139,B00,897209,Fargason; Sharon Gayle,44,0,45,1
1745805563274,EDS 201,A00,895545,Staff,43,0,45,2
1745805564303,EDS 203,A01,895581,Halter; Christopher P.,43,0,45,2
1745805565332,EDS 204R,A01,895625,Heinzman; Erica M.,43,0,45,2
1745805565332,EDS 204R,B01,895693,Halter; Christopher P.,18,0,45,27
1745805566361,EDS 206R,A00,895694,Fargason; Sharon Gayle,9,0,30,21
1745805566361,EDS 206R,B00,895695,Choi; Bailey Miyeon,20,0,30,10
1745805567391,EDS 250,A00,895697,Hemans; Patricia Ann Benitez,43,0,45,2
1745805568418,EDS 281,A00,895701,Meyerott; Theresa Ann,15,0,15,0
1745805569448,EDS 284,A00,895736,Meyerott; Theresa Ann,15,0,15,0
1745805570483,EDS 286,A00,897210,Fine; Sarah,15,0,15,0
1745805571508,EDS 289C,A01,895770,Daly; Alan J.,15,0,15,0
1745805572535,EDS 290,A00,897211,Hofstetter; Carolyn,15,0,15,0
1745805573565,LIGM 5A,A00,896162,Fischer-Grunski; Eva K,15,0,20,5
1745805574591,LIGM 5B,A00,896260,Fischer-Grunski; Eva K,17,0,20,3
1745805575624,LIGM 5C,A00,896308,Fischer-Grunski; Eva K,18,0,20,2
1745805576670,LIIT 5AS,A00,896313,Carnelos; Chiara,18,0,20,2
1745805577696,LIIT 5BS,A00,896416,Carnelos; Chiara,20,0,20,0
1745805578722,LIIT 5CS,A00,896564,Carnelos; Chiara,20,0,20,0
1745805579750,LISP 5A,A00,896588,Munoz Sanchez; Alicia,4,0,20,16
1745805580778,LISP 5B,A00,896653,Munoz Sanchez; Alicia,10,0,20,10
1745805581803,LISP 5C,A00,896655,Munoz Sanchez; Alicia,4,0,20,16
1745805582834,MAE 197,001,957918,Kleissl; Jan,9998,0,9999,1
1745805583859,MATH 2,A01,957937,Staff,34,0,35,1
1745805584887,MATH 197,001,957876,Kedlaya; Kiran S.,9993,0,9999,6
1745805585912,MCWP 40,A00,892729,Duru; Nur,13,0,20,7
1745805585912,MCWP 40,B00,893304,Montejo; Carolina,20,0,20,0
1745805586936,MCWP 40R,A00,893757,Redela; Pamela Morgan,0,7,20,20
1745805587965,MCWP 50,A00,893758,Morshed; Michael James,2,0,20,18
1745805587965,MCWP 50,B00,893761,Bartulis; Jason Michael,17,0,20,3
1745805588991,MCWP 50R,A00,893766,Compas; Sean Matthew,0,1,20,20
1745805588991,MCWP 50R,B00,893769,Carter; Jennifer A,0,0,20,20
1745805588991,MCWP 50R,C00,893771,Krone; Jarret,0,3,20,20
1745805588991,MCWP 50R,D00,893772,Miller; Elizabeth Deen,3,0,20,17
1745805588991,MCWP 50R,E00,893775,Carter; Andrea L,0,0,20,20
1745805590018,MMW 11R,A01,892721,Herbst; Matthew,11,0,27,16
1745805590018,MMW 11R,A02,892722,Herbst; Matthew,0,0,0,3
1745805591046,MMW 12R,A01,892724,Herbst; Matthew,0,9,16,16
1745805591046,MMW 12R,A02,892725,Herbst; Matthew,0,9,16,16
1745805592070,MMW 13R,A01,892727,Staff,0,4,16,16
1745805592070,MMW 13R,A02,892728,Staff,0,4,16,16
1745805592070,MMW 13R,A03,958032,Staff,0,3,16,16
1745805592070,MMW 13R,A04,958033,Staff,0,2,16,16
1745805592070,MMW 13R,A05,958034,Staff,0,3,16,16
1745805593096,SIO 295LS,A00,894015,Staff,7,0,25,18
1745805594124,SIO 295S,A00,894020,Staff,7,0,25,18
1745805595150,SIOC 290S,B01,958918,Staff,0,0,0,0
1745805596177,SIOC 291S,B01,958922,Staff,0,0,0,0
1745805597202,SOCI 117,A01,895339,Staff,4,0,5,1
1745805598229,WES 237B,A00,894149,Staff,11,0,20,9
1745805600290,AESE 279B,A00,891859,Staff,13,0,35,22
1745805601315,AIP 197,001,891854,Staff,70,0,70,0
1745805602345,ANTH 289S,A00,891856,Gagneux; Pascal,12,0,12,0
1745805603369,BENG 196,001,957946,Engler; Adam J.,9996,0,9999,3
1745805604397,CAT 124RS,A01,956906,Staff,8,0,25,17
1745805605425,CAT 125RS,A01,922013,Staff,8,0,25,17
1745805606452,CLRE 250,A00,891860,Morris; Sheldon,9995,0,9999,4
1745805608505,CLRE 251R,A00,907817,Mehta; Ravindra L.,9994,0,9999,5
1745805609532,CLRE 252,A00,891864,Cuomo; Raphael Eduardo,9993,0,9999,6
1745805610564,CLRE 253,A00,891867,Vaida; Florin,9994,0,9999,5
1745805610564,CLRE 253,B00,907819,Staff,9999,0,9999,0
1745805611591,CLRE 259,A00,891868,Patel; Hemal,9998,0,9999,1
1745805612620,CLRE 260,A00,891872,Cuomo; Raphael Eduardo,9999,0,9999,0
1745805613646,CLRE 297,001,891888,Cuomo; Raphael Eduardo,9999,0,9999,0
1745805614673,CSE 191,A00,958773,Minnes Kemp; Mor Mia,9999,0,9999,0
1745805615703,CSS 201S,A01,892054,Mignozzetti; Umberto,30,0,30,0
1745805616739,CSS 202S,A01,892056,Mignozzetti; Umberto,30,0,30,0
1745805617767,DSC 197,001,956898,Eldridge; Justin Matthew,9998,0,9999,1
1745805618793,DSC 297,001,958000,Mazumdar; Arya,9998,0,9999,1
1745805619822,EAP 100,A00,905686,Staff,9776,0,9999,223
1745805620849,ECE 45,A01,892618,Staff,0,12,50,50
1745805621874,ECE 109,A01,892620,Staff,0,43,0,0
1745805622903,ECE 111,A01,892719,Staff,0,7,50,50
1745805623927,ECE 197,001,957920,Mercier; Patrick Philip,9992,0,9999,7
1745805624956,ECON 178,A01,907814,Zhu; Ying,28,0,35,7
1745805625981,EDS 115,A00,895312,Staff,41,0,45,4
1745805627007,EDS 117,A01,895337,Staff,30,0,30,0
1745805628032,EDS 125,A00,895341,Jones; Gabrielle Anastasia,43,0,45,2
1745805629060,EDS 128A,A01,895459,Fargason; Sharon Gayle,44,0,45,1
1745805630085,EDS 128B,A01,895543,Pappas; Elizabeth,44,0,45,1
1745805631133,EDS 139,A00,897203,Pappas; Elizabeth,44,0,45,1
1745805631133,EDS 139,B00,897209,Fargason; Sharon Gayle,44,0,45,1
1745805632160,EDS 201,A00,895545,Staff,43,0,45,2
1745805633188,EDS 203,A01,895581,Halter; Christopher P.,43,0,45,2
1745805634213,EDS 204R,A01,895625,Heinzman; Erica M.,43,0,45,2
1745805634213,EDS 204R,B01,895693,Halter; Christopher P.,18,0,45,27
1745805635238,EDS 206R,A00,895694,Fargason; Sharon Gayle,9,0,30,21
1745805635238,EDS 206R,B00,895695,Choi; Bailey Miyeon,20,0,30,10
1745805636267,EDS 250,A00,895697,Hemans; Patricia Ann Benitez,43,0,45,2
1745805637297,EDS 281,A00,895701,Meyerott; Theresa Ann,15,0,15,0
1745805638325,EDS 284,A00,895736,Meyerott; Theresa Ann,15,0,15,0
1745805639349,EDS 286,A00,897210,Fine; Sarah,15,0,15,0
1745805640375,EDS 289C,A01,895770,Daly; Alan J.,15,0,15,0
1745805641400,EDS 290,A00,897211,Hofstetter; Carolyn,15,0,15,0
1745805642430,LIGM 5A,A00,896162,Fischer-Grunski; Eva K,15,0,20,5
1745805643454,LIGM 5B,A00,896260,Fischer-Grunski; Eva K,17,0,20,3
1745805644478,LIGM 5C,A00,896308,Fischer-Grunski; Eva K,18,0,20,2
1745805645506,LIIT 5AS,A00,896313,Carnelos; Chiara,18,0,20,2
1745805646531,LIIT 5BS,A00,896416,Carnelos; Chiara,20,0,20,0
1745805647560,LIIT 5CS,A00,896564,Carnelos; Chiara,20,0,20,0
1745805648585,LISP 5A,A00,896588,Munoz Sanchez; Alicia,4,0,20,16
1745805649611,LISP 5B,A00,896653,Munoz Sanchez; Alicia,10,0,20,10
1745805650640,LISP 5C,A00,896655,Munoz Sanchez; Alicia,4,0,20,16
1745805651666,MAE 197,001,957918,Kleissl; Jan,9998,0,9999,1
1745805652693,MATH 2,A01,957937,Staff,34,0,35,1
1745805653719,MATH 197,001,957876,Kedlaya; Kiran S.,9993,0,9999,6
1745805654747,MCWP 40,A00,892729,Duru; Nur,13,0,20,7
1745805654747,MCWP 40,B00,893304,Montejo; Carolina,20,0,20,0
1745805655774,MCWP 40R,A00,893757,Redela; Pamela Morgan,0,7,20,20
1745805656803,MCWP 50,A00,893758,Morshed; Michael James,2,0,20,18
1745805656803,MCWP 50,B00,893761,Bartulis; Jason Michael,17,0,20,3
1745805657832,MCWP 50R,A00,893766,Compas; Sean Matthew,0,1,20,20
1745805657832,MCWP 50R,B00,893769,Carter; Jennifer A,0,0,20,20
1745805657832,MCWP 50R,C00,893771,Krone; Jarret,0,3,20,20
1745805657832,MCWP 50R,D00,893772,Miller; Elizabeth Deen,3,0,20,17
1745805657832,MCWP 50R,E00,893775,Carter; Andrea L,0,0,20,20
1745805658855,MMW 11R,A01,892721,Herbst; Matthew,11,0,27,16
1745805658855,MMW 11R,A02,892722,Herbst; Matthew,0,0,0,3
1745805659880,MMW 12R,A01,892724,Herbst; Matthew,0,9,16,16
1745805659880,MMW 12R,A02,892725,Herbst; Matthew,0,9,16,16
1745805660906,MMW 13R,A01,892727,Staff,0,4,16,16
1745805660906,MMW 13R,A02,892728,Staff,0,4,16,16
1745805660906,MMW 13R,A03,958032,Staff,0,3,16,16
1745805660906,MMW 13R,A04,958033,Staff,0,2,16,16
1745805660906,MMW 13R,A05,958034,Staff,0,3,16,16
1745805661931,SIO 295LS,A00,894015,Staff,7,0,25,18
1745805662958,SIO 295S,A00,894020,Staff,7,0,25,18
1745805663988,SIOC 290S,B01,958918,Staff,0,0,0,0
1745805665013,SIOC 291S,B01,958922,Staff,0,0,0,0
1745805666042,SOCI 117,A01,895339,Staff,4,0,5,1
1745805667068,WES 237B,A00,894149,Staff,11,0,20,9
1745805669134,AESE 279B,A00,891859,Staff,13,0,35,22
1745805670159,AIP 197,001,891854,Staff,70,0,70,0
1745805671197,ANTH 289S,A00,891856,Gagneux; Pascal,12,0,12,0
1745805672225,BENG 196,001,957946,Engler; Adam J.,9996,0,9999,3
1745805673253,CAT 124RS,A01,956906,Staff,8,0,25,17
1745805674280,CAT 125RS,A01,922013,Staff,8,0,25,17
1745805675305,CLRE 250,A00,891860,Morris; Sheldon,9995,0,9999,4
1745805677358,CLRE 251R,A00,907817,Mehta; Ravindra L.,9994,0,9999,5
1745805678385,CLRE 252,A00,891864,Cuomo; Raphael Eduardo,9993,0,9999,6
1745805679411,CLRE 253,A00,891867,Vaida; Florin,9994,0,9999,5
1745805679411,CLRE 253,B00,907819,Staff,9999,0,9999,0
1745805680438,CLRE 259,A00,891868,Patel; Hemal,9998,0,9999,1
1745805681466,CLRE 260,A00,891872,Cuomo; Raphael Eduardo,9999,0,9999,0
1745805682492,CLRE 297,001,891888,Cuomo; Raphael Eduardo,9999,0,9999,0
1745805683519,CSE 191,A00,958773,Minnes Kemp; Mor Mia,9999,0,9999,0
1745805684547,CSS 201S,A01,892054,Mignozzetti; Umberto,30,0,30,0
1745805685572,CSS 202S,A01,892056,Mignozzetti; Umberto,30,0,30,0
1745805686599,DSC 197,001,956898,Eldridge; Justin Matthew,9998,0,9999,1
1745805687623,DSC 297,001,958000,Mazumdar; Arya,9998,0,9999,1
1745805688648,EAP 100,A00,905686,Staff,9776,0,9999,223
1745805689674,ECE 45,A01,892618,Staff,0,12,50,50
1745805690702,ECE 109,A01,892620,Staff,0,43,0,0
1745805691730,ECE 111,A01,892719,Staff,0,7,50,50
1745805692756,ECE 197,001,957920,Mercier; Patrick Philip,9992,0,9999,7
1745805693782,ECON 178,A01,907814,Zhu; Ying,28,0,35,7
1745805694808,EDS 115,A00,895312,Staff,41,0,45,4
1745805695836,EDS 117,A01,895337,Staff,30,0,30,0
1745805696863,EDS 125,A00,895341,Jones; Gabrielle Anastasia,43,0,45,2
1745805697887,EDS 128A,A01,895459,Fargason; Sharon Gayle,44,0,45,1
1745805698914,EDS 128B,A01,895543,Pappas; Elizabeth,44,0,45,1
1745805699939,EDS 139,A00,897203,Pappas; Elizabeth,44,0,45,1
1745805699939,EDS 139,B00,897209,Fargason; Sharon Gayle,44,0,45,1
1745805700965,EDS 201,A00,895545,Staff,43,0,45,2
1745805701990,EDS 203,A01,895581,Halter; Christopher P.,43,0,45,2
1745805703021,EDS 204R,A01,895625,Heinzman; Erica M.,43,0,45,2
1745805703021,EDS 204R,B01,895693,Halter; Christopher P.,18,0,45,27
1745805704046,EDS 206R,A00,895694,Fargason; Sharon Gayle,9,0,30,21
1745805704046,EDS 206R,B00,895695,Choi; Bailey Miyeon,20,0,30,10
1745805705071,EDS 250,A00,895697,Hemans; Patricia Ann Benitez,43,0,45,2
1745805706100,EDS 281,A00,895701,Meyerott; Theresa Ann,15,0,15,0
1745805707129,EDS 284,A00,895736,Meyerott; Theresa Ann,15,0,15,0
1745805708159,EDS 286,A00,897210,Fine; Sarah,15,0,15,0
1745805709188,EDS 289C,A01,895770,Daly; Alan J.,15,0,15,0
1745805710212,EDS 290,A00,897211,Hofstetter; Carolyn,15,0,15,0
1745805711238,LIGM 5A,A00,896162,Fischer-Grunski; Eva K,15,0,20,5
1745805712267,LIGM 5B,A00,896260,Fischer-Grunski; Eva K,17,0,20,3
1745805713296,LIGM 5C,A00,896308,Fischer-Grunski; Eva K,18,0,20,2
1745805714326,LIIT 5AS,A00,896313,Carnelos; Chiara,18,0,20,2
1745805715352,LIIT 5BS,A00,896416,Carnelos; Chiara,20,0,20,0
1745805716379,LIIT 5CS,A00,896564,Carnelos; Chiara,20,0,20,0
1745805717404,LISP 5A,A00,896588,Munoz Sanchez; Alicia,4,0,20,16
1745805718437,LISP 5B,A00,896653,Munoz Sanchez; Alicia,10,0,20,10
1745805719463,LISP 5C,A00,896655,Munoz Sanchez; Alicia,4,0,20,16
1745805720490,MAE 197,001,957918,Kleissl; Jan,9998,0,9999,1
1745805721517,MATH 2,A01,957937,Staff,34,0,35,1
1745805722547,MATH 197,001,957876,Kedlaya; Kiran S.,9993,0,9999,6
1745805723578,MCWP 40,A00,892729,Duru; Nur,13,0,20,7
1745805723578,MCWP 40,B00,893304,Montejo; Carolina,20,0,20,0
1745805724605,MCWP 40R,A00,893757,Redela; Pamela Morgan,0,7,20,20
1745805725631,MCWP 50,A00,893758,Morshed; Michael James,2,0,20,18
1745805725631,MCWP 50,B00,893761,Bartulis; Jason Michael,17,0,20,3
1745805726662,MCWP 50R,A00,893766,Compas; Sean Matthew,0,1,20,20
1745805726662,MCWP 50R,B00,893769,Carter; Jennifer A,0,0,20,20
1745805726662,MCWP 50R,C00,893771,Krone; Jarret,0,3,20,20
1745805726662,MCWP 50R,D00,893772,Miller; Elizabeth Deen,3,0,20,17
1745805726662,MCWP 50R,E00,893775,Carter; Andrea L,0,0,20,20
1745805727689,MMW 11R,A01,892721,Herbst; Matthew,11,0,27,16
1745805727689,MMW 11R,A02,892722,Herbst; Matthew,0,0,0,3
1745805728718,MMW 12R,A01,892724,Herbst; Matthew,0,9,16,16
1745805728718,MMW 12R,A02,892725,Herbst; Matthew,0,9,16,16
1745805729744,MMW 13R,A01,892727,Staff,0,4,16,16
1745805729744,MMW 13R,A02,892728,Staff,0,4,16,16
1745805729744,MMW 13R,A03,958032,Staff,0,3,16,16
1745805729744,MMW 13R,A04,958033,Staff,0,2,16,16
1745805729744,MMW 13R,A05,958034,Staff,0,3,16,16
1745805730774,SIO 295LS,A00,894015,Staff,7,0,25,18
1745805731799,SIO 295S,A00,894020,Staff,7,0,25,18
1745805732826,SIOC 290S,B01,958918,Staff,0,0,0,0
1745805733854,SIOC 291S,B01,958922,Staff,0,0,0,0
1745805734880,SOCI 117,A01,895339,Staff,4,0,5,1
1745805735905,WES 237B,A00,894149,Staff,11,0,20,9
1745805738004,AESE 279B,A00,891859,Staff,13,0,35,22
1745805739028,AIP 197,001,891854,Staff,70,0,70,0
1745805740056,ANTH 289S,A00,891856,Gagneux; Pascal,12,0,12,0
1745805741084,BENG 196,001,957946,Engler; Adam J.,9996,0,9999,3
1745805742110,CAT 124RS,A01,956906,Staff,8,0,25,17
1745805743135,CAT 125RS,A01,922013,Staff,8,0,25,17
1745805744161,CLRE 250,A00,891860,Morris; Sheldon,9995,0,9999,4
1745805746214,CLRE 251R,A00,907817,Mehta; Ravindra L.,9994,0,9999,5
1745805747237,CLRE 252,A00,891864,Cuomo; Raphael Eduardo,9993,0,9999,6
1745805748264,CLRE 253,A00,891867,Vaida; Florin,9994,0,9999,5
1745805748264,CLRE 253,B00,907819,Staff,9999,0,9999,0
1745805749289,CLRE 259,A00,891868,Patel; Hemal,9998,0,9999,1
1745805750317,CLRE 260,A00,891872,Cuomo; Raphael Eduardo,9999,0,9999,0
1745805751346,CLRE 297,001,891888,Cuomo; Raphael Eduardo,9999,0,9999,0
1745805752385,CSE 191,A00,958773,Minnes Kemp; Mor Mia,9999,0,9999,0
1745805753411,CSS 201S,A01,892054,Mignozzetti; Umberto,30,0,30,0
1745805754437,CSS 202S,A01,892056,Mignozzetti; Umberto,30,0,30,0
1745805755465,DSC 197,001,956898,Eldridge; Justin Matthew,9998,0,9999,1
1745805756492,DSC 297,001,958000,Mazumdar; Arya,9998,0,9999,1
1745805757518,EAP 100,A00,905686,Staff,9776,0,9999,223
1745805758542,ECE 45,A01,892618,Staff,0,12,50,50
1745805759567,ECE 109,A01,892620,Staff,0,43,0,0
1745805760596,ECE 111,A01,892719,Staff,0,7,50,50
1745805761625,ECE 197,001,957920,Mercier; Patrick Philip,9992,0,9999,7
1745805762655,ECON 178,A01,907814,Zhu; Ying,28,0,35,7
1745805763681,EDS 115,A00,895312,Staff,41,0,45,4
1745805764710,EDS 117,A01,895337,Staff,30,0,30,0
1745805765736,EDS 125,A00,895341,Jones; Gabrielle Anastasia,43,0,45,2
1745805766764,EDS 128A,A01,895459,Fargason; Sharon Gayle,44,0,45,1
1745805767793,EDS 128B,A01,895543,Pappas; Elizabeth,44,0,45,1
1745805768820,EDS 139,A00,897203,Pappas; Elizabeth,44,0,45,1
1745805768820,EDS 139,B00,897209,Fargason; Sharon Gayle,44,0,45,1
1745805769849,EDS 201,A00,895545,Staff,43,0,45,2
1745805770875,EDS 203,A01,895581,Halter; Christopher P.,43,0,45,2
1745805771899,EDS 204R,A01,895625,Heinzman; Erica M.,43,0,45,2
1745805771899,EDS 204R,B01,895693,Halter; Christopher P.,18,0,45,27
1745805772925,EDS 206R,A00,895694,Fargason; Sharon Gayle,9,0,30,21
1745805772925,EDS 206R,B00,895695,Choi; Bailey Miyeon,20,0,30,10
1745805773950,EDS 250,A00,895697,Hemans; Patricia Ann Benitez,43,0,45,2
1745805774976,EDS 281,A00,895701,Meyerott; Theresa Ann,15,0,15,0
1745805776001,EDS 284,A00,895736,Meyerott; Theresa Ann,15,0,15,0
1745805777029,EDS 286,A00,897210,Fine; Sarah,15,0,15,0
1745805778055,EDS 289C,A01,895770,Daly; Alan J.,15,0,15,0
1745805779082,EDS 290,A00,897211,Hofstetter; Carolyn,15,0,15,0
1745805780107,LIGM 5A,A00,896162,Fischer-Grunski; Eva K,15,0,20,5
1745805781136,LIGM 5B,A00,896260,Fischer-Grunski; Eva K,17,0,20,3
1745805782163,LIGM 5C,A00,896308,Fischer-Grunski; Eva K,18,0,20,2
1745805783194,LIIT 5AS,A00,896313,Carnelos; Chiara,18,0,20,2
1745805784219,LIIT 5BS,A00,896416,Carnelos; Chiara,20,0,20,0
1745805785246,LIIT 5CS,A00,896564,Carnelos; Chiara,20,0,20,0
1745805786271,LISP 5A,A00,896588,Munoz Sanchez; Alicia,4,0,20,16
1745805787298,LISP 5B,A00,896653,Munoz Sanchez; Alicia,10,0,20,10
1745805788323,LISP 5C,A00,896655,Munoz Sanchez; Alicia,4,0,20,16
1745805789350,MAE 197,001,957918,Kleissl; Jan,9998,0,9999,1
1745805790375,MATH 2,A01,957937,Staff,34,0,35,1
1745805791404,MATH 197,001,957876,Kedlaya; Kiran S.,9993,0,9999,6
1745805792433,MCWP 40,A00,892729,Duru; Nur,13,0,20,7
1745805792433,MCWP 40,B00,893304,Montejo; Carolina,20,0,20,0
1745805793457,MCWP 40R,A00,893757,Redela; Pamela Morgan,0,7,20,20
1745805794487,MCWP 50,A00,893758,Morshed; Michael James,2,0,20,18
1745805794487,MCWP 50,B00,893761,Bartulis; Jason Michael,17,0,20,3
1745805795512,MCWP 50R,A00,893766,Compas; Sean Matthew,0,1,20,20
1745805795512,MCWP 50R,B00,893769,Carter; Jennifer A,0,0,20,20
1745805795512,MCWP 50R,C00,893771,Krone; Jarret,0,3,20,20
1745805795512,MCWP 50R,D00,893772,Miller; Elizabeth Deen,3,0,20,17
1745805795512,MCWP 50R,E00,893775,Carter; Andrea L,0,0,20,20
1745805796538,MMW 11R,A01,892721,Herbst; Matthew,11,0,27,16
1745805796538,MMW 11R,A02,892722,Herbst; Matthew,0,0,0,3
1745805797566,MMW 12R,A01,892724,Herbst; Matthew,0,9,16,16
1745805797566,MMW 12R,A02,892725,Herbst; Matthew,0,9,16,16
1745805798591,MMW 13R,A01,892727,Staff,0,4,16,16
1745805798591,MMW 13R,A02,892728,Staff,0,4,16,16
1745805798591,MMW 13R,A03,958032,Staff,0,3,16,16
1745805798591,MMW 13R,A04,958033,Staff,0,2,16,16
1745805798591,MMW 13R,A05,958034,Staff,0,3,16,16
1745805799617,SIO 295LS,A00,894015,Staff,7,0,25,18
1745805800646,SIO 295S,A00,894020,Staff,7,0,25,18
1745805801674,SIOC 290S,B01,958918,Staff,0,0,0,0
1745805802701,SIOC 291S,B01,958922,Staff,0,0,0,0
1745805803728,SOCI 117,A01,895339,Staff,4,0,5,1
1745805804754,WES 237B,A00,894149,Staff,11,0,20,9
1745805806816,AESE 279B,A00,891859,Staff,13,0,35,22
1745805807844,AIP 197,001,891854,Staff,70,0,70,0
1745805808872,ANTH 289S,A00,891856,Gagneux; Pascal,12,0,12,0
1745805809898,BENG 196,001,957946,Engler; Adam J.,9996,0,9999,3
1745805810923,CAT 124RS,A01,956906,Staff,8,0,25,17
1745805811948,CAT 125RS,A01,922013,Staff,8,0,25,17
1745805812971,CLRE 250,A00,891860,Morris; Sheldon,9995,0,9999,4
1745805815026,CLRE 251R,A00,907817,Mehta; Ravindra L.,9994,0,9999,5
1745805816051,CLRE 252,A00,891864,Cuomo; Raphael Eduardo,9993,0,9999,6
1745805817076,CLRE 253,A00,891867,Vaida; Florin,9994,0,9999,5
1745805817076,CLRE 253,B00,907819,Staff,9999,0,9999,0
1745805818101,CLRE 259,A00,891868,Patel; Hemal,9998,0,9999,1
1745805819130,CLRE 260,A00,891872,Cuomo; Raphael Eduardo,9999,0,9999,0
1745805820156,CLRE 297,001,891888,Cuomo; Raphael Eduardo,9999,0,9999,0
1745805821182,CSE 191,A00,958773,Minnes Kemp; Mor Mia,9999,0,9999,0
1745805822212,CSS 201S,A01,892054,Mignozzetti; Umberto,30,0,30,0
1745805823238,CSS 202S,A01,892056,Mignozzetti; Umberto,30,0,30,0
1745805824265,DSC 197,001,956898,Eldridge; Justin Matthew,9998,0,9999,1
1745805825292,DSC 297,001,958000,Mazumdar; Arya,9998,0,9999,1
1745805826320,EAP 100,A00,905686,Staff,9776,0,9999,223
1745805827346,ECE 45,A01,892618,Staff,0,12,50,50
1745805828373,ECE 109,A01,892620,Staff,0,43,0,0
1745805829402,ECE 111,A01,892719,Staff,0,7,50,50
1745805830427,ECE 197,001,957920,Mercier; Patrick Philip,9992,0,9999,7
1745805831454,ECON 178,A01,907814,Zhu; Ying,28,0,35,7
1745805832481,EDS 115,A00,895312,Staff,41,0,45,4
1745805833507,EDS 117,A01,895337,Staff,30,0,30,0
1745805834534,EDS 125,A00,895341,Jones; Gabrielle Anastasia,43,0,45,2
1745805835563,EDS 128A,A01,895459,Fargason; Sharon Gayle,44,0,45,1
1745805836589,EDS 128B,A01,895543,Pappas; Elizabeth,44,0,45,1
1745805837616,EDS 139,A00,897203,Pappas; Elizabeth,44,0,45,1
1745805837616,EDS 139,B00,897209,Fargason; Sharon Gayle,44,0,45,1
1745805838643,EDS 201,A00,895545,Staff,43,0,45,2
1745805839667,EDS 203,A01,895581,Halter; Christopher P.,43,0,45,2
1745805840755,EDS 204R,A01,895625,Heinzman; Erica M.,43,0,45,2
1745805840755,EDS 204R,B01,895693,Halter; Christopher P.,18,0,45,27
1745805841792,EDS 206R,A00,895694,Fargason; Sharon Gayle,9,0,30,21
1745805841792,EDS 206R,B00,895695,Choi; Bailey Miyeon,20,0,30,10
1745805842818,EDS 250,A00,895697,Hemans; Patricia Ann Benitez,43,0,45,2
1745805843846,EDS 281,A00,895701,Meyerott; Theresa Ann,15,0,15,0
1745805844901,EDS 284,A00,895736,Meyerott; Theresa Ann,15,0,15,0
1745805845930,EDS 286,A00,897210,Fine; Sarah,15,0,15,0
1745805846956,EDS 289C,A01,895770,Daly; Alan J.,15,0,15,0
1745805847982,EDS 290,A00,897211,Hofstetter; Carolyn,15,0,15,0
1745805849010,LIGM 5A,A00,896162,Fischer-Grunski; Eva K,15,0,20,5
1745805850035,LIGM 5B,A00,896260,Fischer-Grunski; Eva K,17,0,20,3
1745805851061,LIGM 5C,A00,896308,Fischer-Grunski; Eva K,18,0,20,2
1745805852088,LIIT 5AS,A00,896313,Carnelos; Chiara,18,0,20,2
1745805853115,LIIT 5BS,A00,896416,Carnelos; Chiara,20,0,20,0
1745805854143,LIIT 5CS,A00,896564,Carnelos; Chiara,20,0,20,0
1745805855168,LISP 5A,A00,896588,Munoz Sanchez; Alicia,4,0,20,16
1745805856194,LISP 5B,A00,896653,Munoz Sanchez; Alicia,10,0,20,10
1745805857219,LISP 5C,A00,896655,Munoz Sanchez; Alicia,4,0,20,16
1745805858242,MAE 197,001,957918,Kleissl; Jan,9998,0,9999,1
1745805859268,MATH 2,A01,957937,Staff,34,0,35,1
1745805860295,MATH 197,001,957876,Kedlaya; Kiran S.,9993,0,9999,6
1745805861321,MCWP 40,A00,892729,Duru; Nur,13,0,20,7
1745805861321,MCWP 40,B00,893304,Montejo; Carolina,20,0,20,0
1745805862350,MCWP 40R,A00,893757,Redela; Pamela Morgan,0,7,20,20
1745805863378,MCWP 50,A00,893758,Morshed; Michael James,2,0,20,18
1745805863378,MCWP 50,B00,893761,Bartulis; Jason Michael,17,0,20,3
1745805864409,MCWP 50R,A00,893766,Compas; Sean Matthew,0,1,20,20
1745805864409,MCWP 50R,B00,893769,Carter; Jennifer A,0,0,20,20
1745805864409,MCWP 50R,C00,893771,Krone; Jarret,0,3,20,20
1745805864409,MCWP 50R,D00,893772,Miller; Elizabeth Deen,3,0,20,17
1745805864409,MCWP 50R,E00,893775,Carter; Andrea L,0,0,20,20
1745805865435,MMW 11R,A01,892721,Herbst; Matthew,11,0,27,16
1745805865435,MMW 11R,A02,892722,Herbst; Matthew,0,0,0,3
1745805866464,MMW 12R,A01,892724,Herbst; Matthew,0,9,16,16
1745805866464,MMW 12R,A02,892725,Herbst; Matthew,0,9,16,16
1745805867490,MMW 13R,A01,892727,Staff,0,4,16,16
1745805867490,MMW 13R,A02,892728,Staff,0,4,16,16
1745805867490,MMW 13R,A03,958032,Staff,0,3,16,16
1745805867490,MMW 13R,A04,958033,Staff,0,2,16,16
1745805867490,MMW 13R,A05,958034,Staff,0,3,16,16
1745805868519,SIO 295LS,A00,894015,Staff,7,0,25,18
1745805869548,SIO 295S,A00,894020,Staff,7,0,25,18
1745805870575,SIOC 290S,B01,958918,Staff,0,0,0,0
1745805871601,SIOC 291S,B01,958922,Staff,0,0,0,0
1745805872626,SOCI 117,A01,895339,Staff,4,0,5,1
1745805873654,WES 237B,A00,894149,Staff,11,0,20,9
1745805875718,AESE 279B,A00,891859,Staff,13,0,35,22
1745805876747,AIP 197,001,891854,Staff,70,0,70,0
1745805877773,ANTH 289S,A00,891856,Gagneux; Pascal,12,0,12,0
1745805878798,BENG 196,001,957946,Engler; Adam J.,9996,0,9999,3
1745805879826,CAT 124RS,A01,956906,Staff,8,0,25,17
1745805880851,CAT 125RS,A01,922013,Staff,8,0,25,17
1745805881879,CLRE 250,A00,891860,Morris; Sheldon,9995,0,9999,4
1745805883932,CLRE 251R,A00,907817,Mehta; Ravindra L.,9994,0,9999,5
1745805884959,CLRE 252,A00,891864,Cuomo; Raphael Eduardo,9993,0,9999,6
1745805885988,CLRE 253,A00,891867,Vaida; Florin,9994,0,9999,5
1745805885988,CLRE 253,B00,907819,Staff,9999,0,9999,0
1745805887016,CLRE 259,A00,891868,Patel; Hemal,9998,0,9999,1
1745805888044,CLRE 260,A00,891872,Cuomo; Raphael Eduardo,9999,0,9999,0
1745805889069,CLRE 297,001,891888,Cuomo; Raphael Eduardo,9999,0,9999,0
1745805890095,CSE 191,A00,958773,Minnes Kemp; Mor Mia,9999,0,9999,0
1745805891121,CSS 201S,A01,892054,Mignozzetti; Umberto,30,0,30,0
1745805892151,CSS 202S,A01,892056,Mignozzetti; Umberto,30,0,30,0
1745805893177,DSC 197,001,956898,Eldridge; Justin Matthew,9998,0,9999,1
1745805894205,DSC 297,001,958000,Mazumdar; Arya,9998,0,9999,1
1745805895230,EAP 100,A00,905686,Staff,9776,0,9999,223
1745805896256,ECE 45,A01,892618,Staff,0,12,50,50
1745805897282,ECE 109,A01,892620,Staff,0,43,0,0
1745805898307,ECE 111,A01,892719,Staff,0,7,50,50
1745805899338,ECE 197,001,957920,Mercier; Patrick Philip,9992,0,9999,7
1745805900363,ECON 178,A01,907814,Zhu; Ying,28,0,35,7
1745805901390,EDS 115,A00,895312,Staff,41,0,45,4
1745805902415,EDS 117,A01,895337,Staff,30,0,30,0
1745805903441,EDS 125,A00,895341,Jones; Gabrielle Anastasia,43,0,45,2
1745805904472,EDS 128A,A01,895459,Fargason; Sharon Gayle,44,0,45,1
1745805905498,EDS 128B,A01,895543,Pappas; Elizabeth,44,0,45,1
1745805906523,EDS 139,A00,897203,Pappas; Elizabeth,44,0,45,1
1745805906523,EDS 139,B00,897209,Fargason; Sharon Gayle,44,0,45,1
1745805907550,EDS 201,A00,895545,Staff,43,0,45,2
1745805908580,EDS 203,A01,895581,Halter; Christopher P.,43,0,45,2
1745805909612,EDS 204R,A01,895625,Heinzman; Erica M.,43,0,45,2
1745805909612,EDS 204R,B01,895693,Halter; Christopher P.,18,0,45,27
1745805910641,EDS 206R,A00,895694,Fargason; Sharon Gayle,9,0,30,21
1745805910641,EDS 206R,B00,895695,Choi; Bailey Miyeon,20,0,30,10
1745805911668,EDS 250,A00,895697,Hemans; Patricia Ann Benitez,43,0,45,2
1745805912697,EDS 281,A00,895701,Meyerott; Theresa Ann,15,0,15,0
1745805913722,EDS 284,A00,895736,Meyerott; Theresa Ann,15,0,15,0
1745805914749,EDS 286,A00,897210,Fine; Sarah,15,0,15,0
1745805915775,EDS 289C,A01,895770,Daly; Alan J.,15,0,15,0
1745805916802,EDS 290,A00,897211,Hofstetter; Carolyn,15,0,15,0
1745805917829,LIGM 5A,A00,896162,Fischer-Grunski; Eva K,15,0,20,5
1745805918855,LIGM 5B,A00,896260,Fischer-Grunski; Eva K,17,0,20,3
1745805919881,LIGM 5C,A00,896308,Fischer-Grunski; Eva K,18,0,20,2
1745805920910,LIIT 5AS,A00,896313,Carnelos; Chiara,18,0,20,2
1745805921941,LIIT 5BS,A00,896416,Carnelos; Chiara,20,0,20,0
1745805922971,LIIT 5CS,A00,896564,Carnelos; Chiara,20,0,20,0
1745805923997,LISP 5A,A00,896588,Munoz Sanchez; Alicia,4,0,20,16
1745805925024,LISP 5B,A00,896653,Munoz Sanchez; Alicia,10,0,20,10
1745805926049,LISP 5C,A00,896655,Munoz Sanchez; Alicia,4,0,20,16
1745805927075,MAE 197,001,957918,Kleissl; Jan,9998,0,9999,1
1745805928100,MATH 2,A01,957937,Staff,34,0,35,1
1745805929128,MATH 197,001,957876,Kedlaya; Kiran S.,9993,0,9999,6
1745805930156,MCWP 40,A00,892729,Duru; Nur,13,0,20,7
1745805930156,MCWP 40,B00,893304,Montejo; Carolina,20,0,20,0
1745805931180,MCWP 40R,A00,893757,Redela; Pamela Morgan,0,7,20,20
1745805932208,MCWP 50,A00,893758,Morshed; Michael James,2,0,20,18
1745805932208,MCWP 50,B00,893761,Bartulis; Jason Michael,17,0,20,3
1745805933235,MCWP 50R,A00,893766,Compas; Sean Matthew,0,1,20,20
1745805933235,MCWP 50R,B00,893769,Carter; Jennifer A,0,0,20,20
1745805933235,MCWP 50R,C00,893771,Krone; Jarret,0,3,20,20
1745805933235,MCWP 50R,D00,893772,Miller; Elizabeth Deen,3,0,20,17
1745805933235,MCWP 50R,E00,893775,Carter; Andrea L,0,0,20,20
1745805934307,MMW 11R,A01,892721,Herbst; Matthew,11,0,27,16
1745805934307,MMW 11R,A02,892722,Herbst; Matthew,0,0,0,3
1745805935336,MMW 12R,A01,892724,Herbst; Matthew,0,9,16,16
1745805935336,MMW 12R,A02,892725,Herbst; Matthew,0,9,16,16
1745805936362,MMW 13R,A01,892727,Staff,0,4,16,16
1745805936362,MMW 13R,A02,892728,Staff,0,4,16,16
1745805936362,MMW 13R,A03,958032,Staff,0,3,16,16
1745805936362,MMW 13R,A04,958033,Staff,0,2,16,16
1745805936362,MMW 13R,A05,958034,Staff,0,3,16,16
1745805937388,SIO 295LS,A00,894015,Staff,7,0,25,18
1745805938418,SIO 295S,A00,894020,Staff,7,0,25,18
1745805939445,SIOC 290S,B01,958918,Staff,0,0,0,0
1745805940477,SIOC 291S,B01,958922,Staff,0,0,0,0
1745805941502,SOCI 117,A01,895339,Staff,4,0,5,1
1745805942527,WES 237B,A00,894149,Staff,11,0,20,9
1745805944582,AESE 279B,A00,891859,Staff,13,0,35,22
1745805945610,AIP 197,001,891854,Staff,70,0,70,0
1745805946635,ANTH 289S,A00,891856,Gagneux; Pascal,12,0,12,0
1745805947663,BENG 196,001,957946,Engler; Adam J.,9996,0,9999,3
1745805948689,CAT 124RS,A01,956906,Staff,8,0,25,17
1745805949718,CAT 125RS,A01,922013,Staff,8,0,25,17
1745805950742,CLRE 250,A00,891860,Morris; Sheldon,9995,0,9999,4
1745805952797,CLRE 251R,A00,907817,Mehta; Ravindra L.,9994,0,9999,5
1745805953825,CLRE 252,A00,891864,Cuomo; Raphael Eduardo,9993,0,9999,6
1745805954850,CLRE 253,A00,891867,Vaida; Florin,9994,0,9999,5
1745805954850,CLRE 253,B00,907819,Staff,9999,0,9999,0
1745805955876,CLRE 259,A00,891868,Patel; Hemal,9998,0,9999,1
1745805956901,CLRE 260,A00,891872,Cuomo; Raphael Eduardo,9999,0,9999,0
1745805957926,CLRE 297,001,891888,Cuomo; Raphael Eduardo,9999,0,9999,0
1745805958954,CSE 191,A00,958773,Minnes Kemp; Mor Mia,9999,0,9999,0
1745805959983,CSS 201S,A01,892054,Mignozzetti; Umberto,30,0,30,0
1745805961011,CSS 202S,A01,892056,Mignozzetti; Umberto,30,0,30,0
1745805962037,DSC 197,001,956898,Eldridge; Justin Matthew,9998,0,9999,1
1745805963067,DSC 297,001,958000,Mazumdar; Arya,9998,0,9999,1
1745805964095,EAP 100,A00,905686,Staff,9776,0,9999,223
1745805965125,ECE 45,A01,892618,Staff,0,12,50,50
1745805966153,ECE 109,A01,892620,Staff,0,43,0,0
1745805967180,ECE 111,A01,892719,Staff,0,7,50,50
1745805968209,ECE 197,001,957920,Mercier; Patrick Philip,9992,0,9999,7
1745805969235,ECON 178,A01,907814,Zhu; Ying,28,0,35,7
1745805970261,EDS 115,A00,895312,Staff,41,0,45,4
1745805971287,EDS 117,A01,895337,Staff,30,0,30,0
1745805972315,EDS 125,A00,895341,Jones; Gabrielle Anastasia,43,0,45,2
1745805973339,EDS 128A,A01,895459,Fargason; Sharon Gayle,44,0,45,1
1745805974365,EDS 128B,A01,895543,Pappas; Elizabeth,44,0,45,1
1745805975390,EDS 139,A00,897203,Pappas; Elizabeth,44,0,45,1
1745805975390,EDS 139,B00,897209,Fargason; Sharon Gayle,44,0,45,1
1745805976419,EDS 201,A00,895545,Staff,43,0,45,2
1745805977444,EDS 203,A01,895581,Halter; Christopher P.,43,0,45,2
1745805978469,EDS 204R,A01,895625,Heinzman; Erica M.,43,0,45,2
1745805978469,EDS 204R,B01,895693,Halter; Christopher P.,18,0,45,27
1745805979493,EDS 206R,A00,895694,Fargason; Sharon Gayle,9,0,30,21
1745805979493,EDS 206R,B00,895695,Choi; Bailey Miyeon,20,0,30,10
1745805980518,EDS 250,A00,895697,Hemans; Patricia Ann Benitez,43,0,45,2
1745805981544,EDS 281,A00,895701,Meyerott; Theresa Ann,15,0,15,0
1745805982570,EDS 284,A00,895736,Meyerott; Theresa Ann,15,0,15,0
1745805983599,EDS 286,A00,897210,Fine; Sarah,15,0,15,0
1745805984624,EDS 289C,A01,895770,Daly; Alan J.,15,0,15,0
1745805985653,EDS 290,A00,897211,Hofstetter; Carolyn,15,0,15,0
1745805986682,LIGM 5A,A00,896162,Fischer-Grunski; Eva K,15,0,20,5
1745805987708,LIGM 5B,A00,896260,Fischer-Grunski; Eva K,17,0,20,3
1745805988732,LIGM 5C,A00,896308,Fischer-Grunski; Eva K,18,0,20,2
1745805989763,LIIT 5AS,A00,896313,Carnelos; Chiara,18,0,20,2
1745805990791,LIIT 5BS,A00,896416,Carnelos; Chiara,20,0,20,0
1745805991816,LIIT 5CS,A00,896564,Carnelos; Chiara,20,0,20,0
1745805992843,LISP 5A,A00,896588,Munoz Sanchez; Alicia,4,0,20,16
1745805993870,LISP 5B,A00,896653,Munoz Sanchez; Alicia,10,0,20,10
1745805994900,LISP 5C,A00,896655,Munoz Sanchez; Alicia,4,0,20,16
1745805995927,MAE 197,001,957918,Kleissl; Jan,9998,0,9999,1
1745805996953,MATH 2,A01,957937,Staff,34,0,35,1
1745805997980,MATH 197,001,957876,Kedlaya; Kiran S.,9993,0,9999,6
1745805999009,MCWP 40,A00,892729,Duru; Nur,13,0,20,7
1745805999009,MCWP 40,B00,893304,Montejo; Carolina,20,0,20,0
1745806000039,MCWP 40R,A00,893757,Redela; Pamela Morgan,0,7,20,20
1745806001066,MCWP 50,A00,893758,Morshed; Michael James,2,0,20,18
1745806001066,MCWP 50,B00,893761,Bartulis; Jason Michael,17,0,20,3
1745806002094,MCWP 50R,A00,893766,Compas; Sean Matthew,0,1,20,20
1745806002094,MCWP 50R,B00,893769,Carter; Jennifer A,0,0,20,20
1745806002094,MCWP 50R,C00,893771,Krone; Jarret,0,3,20,20
1745806002094,MCWP 50R,D00,893772,Miller; Elizabeth Deen,3,0,20,17
1745806002094,MCWP 50R,E00,893775,Carter; Andrea L,0,0,20,20
1745806003121,MMW 11R,A01,892721,Herbst; Matthew,11,0,27,16
1745806003121,MMW 11R,A02,892722,Herbst; Matthew,0,0,0,3
1745806004145,MMW 12R,A01,892724,Herbst; Matthew,0,9,16,16
1745806004145,MMW 12R,A02,892725,Herbst; Matthew,0,9,16,16
1745806005174,MMW 13R,A01,892727,Staff,0,4,16,16
1745806005174,MMW 13R,A02,892728,Staff,0,4,16,16
1745806005174,MMW 13R,A03,958032,Staff,0,3,16,16
1745806005174,MMW 13R,A04,958033,Staff,0,2,16,16
1745806005174,MMW 13R,A05,958034,Staff,0,3,16,16
1745806006199,SIO 295LS,A00,894015,Staff,7,0,25,18
1745806007224,SIO 295S,A00,894020,Staff,7,0,25,18
1745806008253,SIOC 290S,B01,958918,Staff,0,0,0,0
1745806009280,SIOC 291S,B01,958922,Staff,0,0,0,0
1745806010306,SOCI 117,A01,895339,Staff,4,0,5,1
1745806011332,WES 237B,A00,894149,Staff,11,0,20,9
1745806013400,AESE 279B,A00,891859,Staff,13,0,35,22
1745806014425,AIP 197,001,891854,Staff,70,0,70,0
1745806015451,ANTH 289S,A00,891856,Gagneux; Pascal,12,0,12,0
1745806016478,BENG 196,001,957946,Engler; Adam J.,9996,0,9999,3
1745806017505,CAT 124RS,A01,956906,Staff,8,0,25,17
1745806018531,CAT 125RS,A01,922013,Staff,8,0,25,17
1745806019557,CLRE 250,A00,891860,Morris; Sheldon,9995,0,9999,4
1745806021610,CLRE 251R,A00,907817,Mehta; Ravindra L.,9994,0,9999,5
1745806022636,CLRE 252,A00,891864,Cuomo; Raphael Eduardo,9993,0,9999,6
1745806023663,CLRE 253,A00,891867,Vaida; Florin,9994,0,9999,5
1745806023663,CLRE 253,B00,907819,Staff,9999,0,9999,0
1745806024689,CLRE 259,A00,891868,Patel; Hemal,9998,0,9999,1
1745806025717,CLRE 260,A00,891872,Cuomo; Raphael Eduardo,9999,0,9999,0
1745806026744,CLRE 297,001,891888,Cuomo; Raphael Eduardo,9999,0,9999,0
1745806027767,CSE 191,A00,958773,Minnes Kemp; Mor Mia,9999,0,9999,0
1745806028793,CSS 201S,A01,892054,Mignozzetti; Umberto,30,0,30,0
1745806029820,CSS 202S,A01,892056,Mignozzetti; Umberto,30,0,30,0
1745806030847,DSC 197,001,956898,Eldridge; Justin Matthew,9998,0,9999,1
1745806031873,DSC 297,001,958000,Mazumdar; Arya,9998,0,9999,1
1745806032899,EAP 100,A00,905686,Staff,9776,0,9999,223
1745806033924,ECE 45,A01,892618,Staff,0,12,50,50
1745806034951,ECE 109,A01,892620,Staff,0,43,0,0
1745806035980,ECE 111,A01,892719,Staff,0,7,50,50
1745806037006,ECE 197,001,957920,Mercier; Patrick Philip,9992,0,9999,7
1745806038031,ECON 178,A01,907814,Zhu; Ying,28,0,35,7
1745806039056,EDS 115,A00,895312,Staff,41,0,45,4
1745806040080,EDS 117,A01,895337,Staff,30,0,30,0
1745806041106,EDS 125,A00,895341,Jones; Gabrielle Anastasia,43,0,45,2
1745806042133,EDS 128A,A01,895459,Fargason; Sharon Gayle,44,0,45,1
1745806043159,EDS 128B,A01,895543,Pappas; Elizabeth,44,0,45,1
1745806044184,EDS 139,A00,897203,Pappas; Elizabeth,44,0,45,1
1745806044184,EDS 139,B00,897209,Fargason; Sharon Gayle,44,0,45,1
1745806045209,EDS 201,A00,895545,Staff,43,0,45,2
1745806046238,EDS 203,A01,895581,Halter; Christopher P.,43,0,45,2
1745806047265,EDS 204R,A01,895625,Heinzman; Erica M.,43,0,45,2
1745806047265,EDS 204R,B01,895693,Halter; Christopher P.,18,0,45,27
1745806048294,EDS 206R,A00,895694,Fargason; Sharon Gayle,9,0,30,21
1745806048294,EDS 206R,B00,895695,Choi; Bailey Miyeon,20,0,30,10
1745806049360,EDS 250,A00,895697,Hemans; Patricia Ann Benitez,43,0,45,2
1745806050386,EDS 281,A00,895701,Meyerott; Theresa Ann,15,0,15,0
1745806051414,EDS 284,A00,895736,Meyerott; Theresa Ann,15,0,15,0
1745806052439,EDS 286,A00,897210,Fine; Sarah,15,0,15,0
1745806053464,EDS 289C,A01,895770,Daly; Alan J.,15,0,15,0
1745806054491,EDS 290,A00,897211,Hofstetter; Carolyn,15,0,15,0
1745806055516,LIGM 5A,A00,896162,Fischer-Grunski; Eva K,15,0,20,5
1745806056540,LIGM 5B,A00,896260,Fischer-Grunski; Eva K,17,0,20,3
1745806057564,LIGM 5C,A00,896308,Fischer-Grunski; Eva K,18,0,20,2
1745806058594,LIIT 5AS,A00,896313,Carnelos; Chiara,18,0,20,2
1745806059623,LIIT 5BS,A00,896416,Carnelos; Chiara,20,0,20,0
1745806060648,LIIT 5CS,A00,896564,Carnelos; Chiara,20,0,20,0
1745806061674,LISP 5A,A00,896588,Munoz Sanchez; Alicia,4,0,20,16
1745806062699,LISP 5B,A00,896653,Munoz Sanchez; Alicia,10,0,20,10
1745806063724,LISP 5C,A00,896655,Munoz Sanchez; Alicia,4,0,20,16
1745806064749,MAE 197,001,957918,Kleissl; Jan,9998,0,9999,1
1745806065774,MATH 2,A01,957937,Staff,34,0,35,1
1745806066802,MATH 197,001,957876,Kedlaya; Kiran S.,9993,0,9999,6
1745806067828,MCWP 40,A00,892729,Duru; Nur,13,0,20,7
1745806067828,MCWP 40,B00,893304,Montejo; Carolina,20,0,20,0
1745806068856,MCWP 40R,A00,893757,Redela; Pamela Morgan,0,7,20,20
1745806069882,MCWP 50,A00,893758,Morshed; Michael James,2,0,20,18
1745806069882,MCWP 50,B00,893761,Bartulis; Jason Michael,17,0,20,3
1745806070912,MCWP 50R,A00,893766,Compas; Sean Matthew,0,1,20,20
1745806070912,MCWP 50R,B00,893769,Carter; Jennifer A,0,0,20,20
1745806070912,MCWP 50R,C00,893771,Krone; Jarret,0,3,20,20
1745806070912,MCWP 50R,D00,893772,Miller; Elizabeth Deen,3,0,20,17
1745806070912,MCWP 50R,E00,893775,Carter; Andrea L,0,0,20,20
1745806071940,MMW 11R,A01,892721,Herbst; Matthew,11,0,27,16
1745806071940,MMW 11R,A02,892722,Herbst; Matthew,0,0,0,3
1745806072965,MMW 12R,A01,892724,Herbst; Matthew,0,9,16,16
1745806072965,MMW 12R,A02,892725,Herbst; Matthew,0,9,16,16
1745806073995,MMW 13R,A01,892727,Staff,0,4,16,16
1745806073995,MMW 13R,A02,892728,Staff,0,4,16,16
1745806073995,MMW 13R,A03,958032,Staff,0,3,16,16
1745806073995,MMW 13R,A04,958033,Staff,0,2,16,16
1745806073995,MMW 13R,A05,958034,Staff,0,3,16,16
1745806075029,SIO 295LS,A00,894015,Staff,7,0,25,18
1745806076054,SIO 295S,A00,894020,Staff,7,0,25,18
1745806077080,SIOC 290S,B01,958918,Staff,0,0,0,0
1745806078106,SIOC 291S,B01,958922,Staff,0,0,0,0
1745806079132,SOCI 117,A01,895339,Staff,4,0,5,1
1745806080157,WES 237B,A00,894149,Staff,11,0,20,9
1745806082216,AESE 279B,A00,891859,Staff,13,0,35,22
1745806083251,AIP 197,001,891854,Staff,70,0,70,0
1745806084279,ANTH 289S,A00,891856,Gagneux; Pascal,12,0,12,0
1745806085306,BENG 196,001,957946,Engler; Adam J.,9996,0,9999,3
1745806086334,CAT 124RS,A01,956906,Staff,8,0,25,17
1745806087362,CAT 125RS,A01,922013,Staff,8,0,25,17
1745806088387,CLRE 250,A00,891860,Morris; Sheldon,9995,0,9999,4
1745806090441,CLRE 251R,A00,907817,Mehta; Ravindra L.,9994,0,9999,5
1745806091467,CLRE 252,A00,891864,Cuomo; Raphael Eduardo,9993,0,9999,6
1745806092499,CLRE 253,A00,891867,Vaida; Florin,9994,0,9999,5
1745806092499,CLRE 253,B00,907819,Staff,9999,0,9999,0
1745806093525,CLRE 259,A00,891868,Patel; Hemal,9998,0,9999,1
1745806094550,CLRE 260,A00,891872,Cuomo; Raphael Eduardo,9999,0,9999,0
1745806095573,CLRE 297,001,891888,Cuomo; Raphael Eduardo,9999,0,9999,0
1745806096601,CSE 191,A00,958773,Minnes Kemp; Mor Mia,9999,0,9999,0
1745806097626,CSS 201S,A01,892054,Mignozzetti; Umberto,30,0,30,0
1745806098655,CSS 202S,A01,892056,Mignozzetti; Umberto,30,0,30,0
1745806099680,DSC 197,001,956898,Eldridge; Justin Matthew,9998,0,9999,1
1745806100704,DSC 297,001,958000,Mazumdar; Arya,9998,0,9999,1
1745806101729,EAP 100,A00,905686,Staff,9776,0,9999,223
1745806102755,ECE 45,A01,892618,Staff,0,12,50,50
1745806103782,ECE 109,A01,892620,Staff,0,43,0,0
1745806104807,ECE 111,A01,892719,Staff,0,7,50,50
1745806105835,ECE 197,001,957920,Mercier; Patrick Philip,9992,0,9999,7
1745806106865,ECON 178,A01,907814,Zhu; Ying,28,0,35,7
1745806107891,EDS 115,A00,895312,Staff,41,0,45,4
1745806108916,EDS 117,A01,895337,Staff,30,0,30,0
1745806109941,EDS 125,A00,895341,Jones; Gabrielle Anastasia,43,0,45,2
1745806110967,EDS 128A,A01,895459,Fargason; Sharon Gayle,44,0,45,1
1745806111995,EDS 128B,A01,895543,Pappas; Elizabeth,44,0,45,1
1745806113021,EDS 139,A00,897203,Pappas; Elizabeth,44,0,45,1
1745806113021,EDS 139,B00,897209,Fargason; Sharon Gayle,44,0,45,1
1745806114046,EDS 201,A00,895545,Staff,43,0,45,2
1745806115074,EDS 203,A01,895581,Halter; Christopher P.,43,0,45,2
1745806116103,EDS 204R,A01,895625,Heinzman; Erica M.,43,0,45,2
1745806116103,EDS 204R,B01,895693,Halter; Christopher P.,18,0,45,27
1745806117130,EDS 206R,A00,895694,Fargason; Sharon Gayle,9,0,30,21
1745806117130,EDS 206R,B00,895695,Choi; Bailey Miyeon,20,0,30,10
1745806118156,EDS 250,A00,895697,Hemans; Patricia Ann Benitez,43,0,45,2
1745806119184,EDS 281,A00,895701,Meyerott; Theresa Ann,15,0,15,0
1745806120213,EDS 284,A00,895736,Meyerott; Theresa Ann,15,0,15,0
1745806121242,EDS 286,A00,897210,Fine; Sarah,15,0,15,0
1745806122267,EDS 289C,A01,895770,Daly; Alan J.,15,0,15,0
1745806123293,EDS 290,A00,897211,Hofstetter; Carolyn,15,0,15,0
1745806124322,LIGM 5A,A00,896162,Fischer-Grunski; Eva K,15,0,20,5
1745806125348,LIGM 5B,A00,896260,Fischer-Grunski; Eva K,17,0,20,3
1745806126374,LIGM 5C,A00,896308,Fischer-Grunski; Eva K,18,0,20,2
1745806127400,LIIT 5AS,A00,896313,Carnelos; Chiara,18,0,20,2
1745806128428,LIIT 5BS,A00,896416,Carnelos; Chiara,20,0,20,0
1745806129454,LIIT 5CS,A00,896564,Carnelos; Chiara,20,0,20,0
1745806130484,LISP 5A,A00,896588,Munoz Sanchez; Alicia,4,0,20,16
1745806131511,LISP 5B,A00,896653,Munoz Sanchez; Alicia,10,0,20,10
1745806132541,LISP 5C,A00,896655,Munoz Sanchez; Alicia,4,0,20,16
1745806133569,MAE 197,001,957918,Kleissl; Jan,9998,0,9999,1
1745806134596,MATH 2,A01,957937,Staff,34,0,35,1
1745806135620,MATH 197,001,957876,Kedlaya; Kiran S.,9993,0,9999,6
1745806136649,MCWP 40,A00,892729,Duru; Nur,13,0,20,7
1745806136649,MCWP 40,B00,893304,Montejo; Carolina,20,0,20,0
1745806137675,MCWP 40R,A00,893757,Redela; Pamela Morgan,0,7,20,20
1745806138700,MCWP 50,A00,893758,Morshed; Michael James,2,0,20,18
1745806138700,MCWP 50,B00,893761,Bartulis; Jason Michael,17,0,20,3
1745806139726,MCWP 50R,A00,893766,Compas; Sean Matthew,0,1,20,20
1745806139726,MCWP 50R,B00,893769,Carter; Jennifer A,0,0,20,20
1745806139726,MCWP 50R,C00,893771,Krone; Jarret,0,3,20,20
1745806139726,MCWP 50R,D00,893772,Miller; Elizabeth Deen,3,0,20,17
1745806139726,MCWP 50R,E00,893775,Carter; Andrea L,0,0,20,20
1745806140754,MMW 11R,A01,892721,Herbst; Matthew,11,0,27,16
1745806140754,MMW 11R,A02,892722,Herbst; Matthew,0,0,0,3
1745806141781,MMW 12R,A01,892724,Herbst; Matthew,0,9,16,16
1745806141781,MMW 12R,A02,892725,Herbst; Matthew,0,9,16,16
1745806142814,MMW 13R,A01,892727,Staff,0,4,16,16
1745806142814,MMW 13R,A02,892728,Staff,0,4,16,16
1745806142814,MMW 13R,A03,958032,Staff,0,3,16,16
1745806142814,MMW 13R,A04,958033,Staff,0,2,16,16
1745806142814,MMW 13R,A05,958034,Staff,0,3,16,16
1745806143842,SIO 295LS,A00,894015,Staff,7,0,25,18
1745806144873,SIO 295S,A00,894020,Staff,7,0,25,18
1745806145901,SIOC 290S,B01,958918,Staff,0,0,0,0
1745806146930,SIOC 291S,B01,958922,Staff,0,0,0,0
1745806147958,SOCI 117,A01,895339,Staff,4,0,5,1
1745806148984,WES 237B,A00,894149,Staff,11,0,20,9
1745806151044,AESE 279B,A00,891859,Staff,13,0,35,22
1745806152070,AIP 197,001,891854,Staff,70,0,70,0
1745806153096,ANTH 289S,A00,891856,Gagneux; Pascal,12,0,12,0
1745806154122,BENG 196,001,957946,Engler; Adam J.,9996,0,9999,3
1745806155149,CAT 124RS,A01,956906,Staff,8,0,25,17
1745806156215,CAT 125RS,A01,922013,Staff,8,0,25,17
1745806157243,CLRE 250,A00,891860,Morris; Sheldon,9995,0,9999,4
1745806159298,CLRE 251R,A00,907817,Mehta; Ravindra L.,9994,0,9999,5
1745806160327,CLRE 252,A00,891864,Cuomo; Raphael Eduardo,9993,0,9999,6
1745806161355,CLRE 253,A00,891867,Vaida; Florin,9994,0,9999,5
1745806161355,CLRE 253,B00,907819,Staff,9999,0,9999,0
1745806162391,CLRE 259,A00,891868,Patel; Hemal,9998,0,9999,1
1745806163416,CLRE 260,A00,891872,Cuomo; Raphael Eduardo,9999,0,9999,0
1745806164443,CLRE 297,001,891888,Cuomo; Raphael Eduardo,9999,0,9999,0
1745806165472,CSE 191,A00,958773,Minnes Kemp; Mor Mia,9999,0,9999,0
1745806166501,CSS 201S,A01,892054,Mignozzetti; Umberto,30,0,30,0
1745806167527,CSS 202S,A01,892056,Mignozzetti; Umberto,30,0,30,0
1745806168554,DSC 197,001,956898,Eldridge; Justin Matthew,9998,0,9999,1
1745806169583,DSC 297,001,958000,Mazumdar; Arya,9998,0,9999,1
1745806170607,EAP 100,A00,905686,Staff,9776,0,9999,223
1745806171636,ECE 45,A01,892618,Staff,0,12,50,50
1745806172662,ECE 109,A01,892620,Staff,0,43,0,0
1745806173692,ECE 111,A01,892719,Staff,0,7,50,50
1745806174717,ECE 197,001,957920,Mercier; Patrick Philip,9992,0,9999,7
1745806175742,ECON 178,A01,907814,Zhu; Ying,28,0,35,7
1745806176768,EDS 115,A00,895312,Staff,41,0,45,4
1745806177797,EDS 117,A01,895337,Staff,30,0,30,0
1745806178823,EDS 125,A00,895341,Jones; Gabrielle Anastasia,43,0,45,2
1745806179852,EDS 128A,A01,895459,Fargason; Sharon Gayle,44,0,45,1
1745806180882,EDS 128B,A01,895543,Pappas; Elizabeth,44,0,45,1
1745806181909,EDS 139,A00,897203,Pappas; Elizabeth,44,0,45,1
1745806181909,EDS 139,B00,897209,Fargason; Sharon Gayle,44,0,45,1
1745806182936,EDS 201,A00,895545,Staff,43,0,45,2
1745806183966,EDS 203,A01,895581,Halter; Christopher P.,43,0,45,2
1745806184995,EDS 204R,A01,895625,Heinzman; Erica M.,43,0,45,2
1745806184995,EDS 204R,B01,895693,Halter; Christopher P.,18,0,45,27
1745806186023,EDS 206R,A00,895694,Fargason; Sharon Gayle,9,0,30,21
1745806186023,EDS 206R,B00,895695,Choi; Bailey Miyeon,20,0,30,10
1745806187049,EDS 250,A00,895697,Hemans; Patricia Ann Benitez,43,0,45,2
1745806188077,EDS 281,A00,895701,Meyerott; Theresa Ann,15,0,15,0
1745806189102,EDS 284,A00,895736,Meyerott; Theresa Ann,15,0,15,0
1745806190132,EDS 286,A00,897210,Fine; Sarah,15,0,15,0
1745806191160,EDS 289C,A01,895770,Daly; Alan J.,15,0,15,0
1745806192190,EDS 290,A00,897211,Hofstetter; Carolyn,15,0,15,0
1745806193219,LIGM 5A,A00,896162,Fischer-Grunski; Eva K,15,0,20,5
1745806194246,LIGM 5B,A00,896260,Fischer-Grunski; Eva K,17,0,20,3
1745806195271,LIGM 5C,A00,896308,Fischer-Grunski; Eva K,18,0,20,2
1745806196299,LIIT 5AS,A00,896313,Carnelos; Chiara,18,0,20,2
1745806197330,LIIT 5BS,A00,896416,Carnelos; Chiara,20,0,20,0
1745806198360,LIIT 5CS,A00,896564,Carnelos; Chiara,20,0,20,0
1745806199391,LISP 5A,A00,896588,Munoz Sanchez; Alicia,4,0,20,16
1745806200418,LISP 5B,A00,896653,Munoz Sanchez; Alicia,10,0,20,10
1745806201446,LISP 5C,A00,896655,Munoz Sanchez; Alicia,4,0,20,16
1745806202471,MAE 197,001,957918,Kleissl; Jan,9998,0,9999,1
1745806203503,MATH 2,A01,957937,Staff,34,0,35,1
1745806204530,MATH 197,001,957876,Kedlaya; Kiran S.,9993,0,9999,6
1745806205561,MCWP 40,A00,892729,Duru; Nur,13,0,20,7
1745806205561,MCWP 40,B00,893304,Montejo; Carolina,20,0,20,0
1745806206588,MCWP 40R,A00,893757,Redela; Pamela Morgan,0,7,20,20
1745806207613,MCWP 50,A00,893758,Morshed; Michael James,2,0,20,18
1745806207613,MCWP 50,B00,893761,Bartulis; Jason Michael,17,0,20,3
1745806208644,MCWP 50R,A00,893766,Compas; Sean Matthew,0,1,20,20
1745806208644,MCWP 50R,B00,893769,Carter; Jennifer A,0,0,20,20
1745806208644,MCWP 50R,C00,893771,Krone; Jarret,0,3,20,20
1745806208644,MCWP 50R,D00,893772,Miller; Elizabeth Deen,3,0,20,17
1745806208644,MCWP 50R,E00,893775,Carter; Andrea L,0,0,20,20
1745806209670,MMW 11R,A01,892721,Herbst; Matthew,11,0,27,16
1745806209670,MMW 11R,A02,892722,Herbst; Matthew,0,0,0,3
1745806210695,MMW 12R,A01,892724,Herbst; Matthew,0,9,16,16
1745806210695,MMW 12R,A02,892725,Herbst; Matthew,0,9,16,16
1745806211724,MMW 13R,A01,892727,Staff,0,4,16,16
1745806211724,MMW 13R,A02,892728,Staff,0,4,16,16
1745806211724,MMW 13R,A03,958032,Staff,0,3,16,16
1745806211724,MMW 13R,A04,958033,Staff,0,2,16,16
1745806211724,MMW 13R,A05,958034,Staff,0,3,16,16
1745806212749,SIO 295LS,A00,894015,Staff,7,0,25,18
1745806213776,SIO 295S,A00,894020,Staff,7,0,25,18
1745806214803,SIOC 290S,B01,958918,Staff,0,0,0,0
1745806215830,SIOC 291S,B01,958922,Staff,0,0,0,0
1745806216856,SOCI 117,A01,895339,Staff,4,0,5,1
1745806217882,WES 237B,A00,894149,Staff,11,0,20,9
1745806219946,AESE 279B,A00,891859,Staff,13,0,35,22
1745806220974,AIP 197,001,891854,Staff,70,0,70,0
1745806222002,ANTH 289S,A00,891856,Gagneux; Pascal,12,0,12,0
1745806223031,BENG 196,001,957946,Engler; Adam J.,9996,0,9999,3
1745806224059,CAT 124RS,A01,956906,Staff,8,0,25,17
1745806225084,CAT 125RS,A01,922013,Staff,8,0,25,17
1745806226109,CLRE 250,A00,891860,Morris; Sheldon,9995,0,9999,4
1745806228162,CLRE 251R,A00,907817,Mehta; Ravindra L.,9994,0,9999,5
1745806229189,CLRE 252,A00,891864,Cuomo; Raphael Eduardo,9993,0,9999,6
1745806230218,CLRE 253,A00,891867,Vaida; Florin,9994,0,9999,5
1745806230218,CLRE 253,B00,907819,Staff,9999,0,9999,0
1745806231244,CLRE 259,A00,891868,Patel; Hemal,9998,0,9999,1
1745806232269,CLRE 260,A00,891872,Cuomo; Raphael Eduardo,9999,0,9999,0
1745806233297,CLRE 297,001,891888,Cuomo; Raphael Eduardo,9999,0,9999,0
1745806234325,CSE 191,A00,958773,Minnes Kemp; Mor Mia,9999,0,9999,0
1745806235351,CSS 201S,A01,892054,Mignozzetti; Umberto,30,0,30,0
1745806236380,CSS 202S,A01,892056,Mignozzetti; Umberto,30,0,30,0
1745806237405,DSC 197,001,956898,Eldridge; Justin Matthew,9998,0,9999,1
1745806238431,DSC 297,001,958000,Mazumdar; Arya,9998,0,9999,1
1745806239456,EAP 100,A00,905686,Staff,9776,0,9999,223
1745806240482,ECE 45,A01,892618,Staff,0,12,50,50
1745806241508,ECE 109,A01,892620,Staff,0,43,0,0
1745806242535,ECE 111,A01,892719,Staff,0,7,50,50
1745806243562,ECE 197,001,957920,Mercier; Patrick Philip,9992,0,9999,7
1745806244590,ECON 178,A01,907814,Zhu; Ying,28,0,35,7
1745806245616,EDS 115,A00,895312,Staff,41,0,45,4
1745806246641,EDS 117,A01,895337,Staff,30,0,30,0
1745806247668,EDS 125,A00,895341,Jones; Gabrielle Anastasia,43,0,45,2
1745806248697,EDS 128A,A01,895459,Fargason; Sharon Gayle,44,0,45,1
1745806249726,EDS 128B,A01,895543,Pappas; Elizabeth,44,0,45,1
1745806250752,EDS 139,A00,897203,Pappas; Elizabeth,44,0,45,1
1745806250752,EDS 139,B00,897209,Fargason; Sharon Gayle,44,0,45,1
1745806251779,EDS 201,A00,895545,Staff,43,0,45,2
1745806252806,EDS 203,A01,895581,Halter; Christopher P.,43,0,45,2
1745806253831,EDS 204R,A01,895625,Heinzman; Erica M.,43,0,45,2
1745806253831,EDS 204R,B01,895693,Halter; Christopher P.,18,0,45,27
1745806254860,EDS 206R,A00,895694,Fargason; Sharon Gayle,9,0,30,21
1745806254860,EDS 206R,B00,895695,Choi; Bailey Miyeon,20,0,30,10
1745806255887,EDS 250,A00,895697,Hemans; Patricia Ann Benitez,43,0,45,2
1745806256915,EDS 281,A00,895701,Meyerott; Theresa Ann,15,0,15,0
1745806257940,EDS 284,A00,895736,Meyerott; Theresa Ann,15,0,15,0
1745806258965,EDS 286,A00,897210,Fine; Sarah,15,0,15,0
1745806260031,EDS 289C,A01,895770,Daly; Alan J.,15,0,15,0
1745806261057,EDS 290,A00,897211,Hofstetter; Carolyn,15,0,15,0
1745806262086,LIGM 5A,A00,896162,Fischer-Grunski; Eva K,15,0,20,5
1745806263110,LIGM 5B,A00,896260,Fischer-Grunski; Eva K,17,0,20,3
1745806264134,LIGM 5C,A00,896308,Fischer-Grunski; Eva K,18,0,20,2
1745806265161,LIIT 5AS,A00,896313,Carnelos; Chiara,18,0,20,2
1745806266191,LIIT 5BS,A00,896416,Carnelos; Chiara,20,0,20,0
1745806267216,LIIT 5CS,A00,896564,Carnelos; Chiara,20,0,20,0
1745806268242,LISP 5A,A00,896588,Munoz Sanchez; Alicia,4,0,20,16
1745806269268,LISP 5B,A00,896653,Munoz Sanchez; Alicia,10,0,20,10
1745806270301,LISP 5C,A00,896655,Munoz Sanchez; Alicia,4,0,20,16
1745806271328,MAE 197,001,957918,Kleissl; Jan,9998,0,9999,1
1745806272356,MATH 2,A01,957937,Staff,34,0,35,1
1745806273381,MATH 197,001,957876,Kedlaya; Kiran S.,9993,0,9999,6
1745806274406,MCWP 40,A00,892729,Duru; Nur,13,0,20,7
1745806274406,MCWP 40,B00,893304,Montejo; Carolina,20,0,20,0
1745806275432,MCWP 40R,A00,893757,Redela; Pamela Morgan,0,7,20,20
1745806276458,MCWP 50,A00,893758,Morshed; Michael James,2,0,20,18
1745806276458,MCWP 50,B00,893761,Bartulis; Jason Michael,17,0,20,3
1745806277484,MCWP 50R,A00,893766,Compas; Sean Matthew,0,1,20,20
1745806277484,MCWP 50R,B00,893769,Carter; Jennifer A,0,0,20,20
1745806277484,MCWP 50R,C00,893771,Krone; Jarret,0,3,20,20
1745806277484,MCWP 50R,D00,893772,Miller; Elizabeth Deen,3,0,20,17
1745806277484,MCWP 50R,E00,893775,Carter; Andrea L,0,0,20,20
1745806278513,MMW 11R,A01,892721,Herbst; Matthew,11,0,27,16
1745806278513,MMW 11R,A02,892722,Herbst; Matthew,0,0,0,3
1745806279542,MMW 12R,A01,892724,Herbst; Matthew,0,9,16,16
1745806279542,MMW 12R,A02,892725,Herbst; Matthew,0,9,16,16
1745806280571,MMW 13R,A01,892727,Staff,0,4,16,16
1745806280571,MMW 13R,A02,892728,Staff,0,4,16,16
1745806280571,MMW 13R,A03,958032,Staff,0,3,16,16
1745806280571,MMW 13R,A04,958033,Staff,0,2,16,16
1745806280571,MMW 13R,A05,958034,Staff,0,3,16,16
1745806281597,SIO 295LS,A00,894015,Staff,7,0,25,18
1745806282621,SIO 295S,A00,894020,Staff,7,0,25,18
1745806283650,SIOC 290S,B01,958918,Staff,0,0,0,0
1745806284675,SIOC 291S,B01,958922,Staff,0,0,0,0
1745806285700,SOCI 117,A01,895339,Staff,4,0,5,1
1745806286725,WES 237B,A00,894149,Staff,11,0,20,9
1745806288789,AESE 279B,A00,891859,Staff,13,0,35,22
1745806289816,AIP 197,001,891854,Staff,70,0,70,0
1745806290845,ANTH 289S,A00,891856,Gagneux; Pascal,12,0,12,0
1745806291874,BENG 196,001,957946,Engler; Adam J.,9996,0,9999,3
1745806292900,CAT 124RS,A01,956906,Staff,8,0,25,17
1745806293930,CAT 125RS,A01,922013,Staff,8,0,25,17
1745806294959,CLRE 250,A00,891860,Morris; Sheldon,9995,0,9999,4
1745806297010,CLRE 251R,A00,907817,Mehta; Ravindra L.,9994,0,9999,5
1745806298036,CLRE 252,A00,891864,Cuomo; Raphael Eduardo,9993,0,9999,6
1745806299062,CLRE 253,A00,891867,Vaida; Florin,9994,0,9999,5
1745806299062,CLRE 253,B00,907819,Staff,9999,0,9999,0
1745806300088,CLRE 259,A00,891868,Patel; Hemal,9998,0,9999,1
1745806301114,CLRE 260,A00,891872,Cuomo; Raphael Eduardo,9999,0,9999,0
1745806302139,CLRE 297,001,891888,Cuomo; Raphael Eduardo,9999,0,9999,0
1745806303164,CSE 191,A00,958773,Minnes Kemp; Mor Mia,9999,0,9999,0
1745806304194,CSS 201S,A01,892054,Mignozzetti; Umberto,30,0,30,0
1745806305222,CSS 202S,A01,892056,Mignozzetti; Umberto,30,0,30,0
1745806306247,DSC 197,001,956898,Eldridge; Justin Matthew,9998,0,9999,1
1745806307274,DSC 297,001,958000,Mazumdar; Arya,9998,0,9999,1
1745806308298,EAP 100,A00,905686,Staff,9776,0,9999,223
1745806309327,ECE 45,A01,892618,Staff,0,12,50,50
1745806310356,ECE 109,A01,892620,Staff,0,43,0,0
1745806311382,ECE 111,A01,892719,Staff,0,7,50,50
1745806312411,ECE 197,001,957920,Mercier; Patrick Philip,9992,0,9999,7
1745806313436,ECON 178,A01,907814,Zhu; Ying,28,0,35,7
1745806314465,EDS 115,A00,895312,Staff,41,0,45,4
1745806315492,EDS 117,A01,895337,Staff,30,0,30,0
1745806316520,EDS 125,A00,895341,Jones; Gabrielle Anastasia,43,0,45,2
1745806317547,EDS 128A,A01,895459,Fargason; Sharon Gayle,44,0,45,1
1745806318574,EDS 128B,A01,895543,Pappas; Elizabeth,44,0,45,1
1745806319600,EDS 139,A00,897203,Pappas; Elizabeth,44,0,45,1
1745806319600,EDS 139,B00,897209,Fargason; Sharon Gayle,44,0,45,1
1745806320630,EDS 201,A00,895545,Staff,43,0,45,2
1745806321657,EDS 203,A01,895581,Halter; Christopher P.,43,0,45,2
1745806322682,EDS 204R,A01,895625,Heinzman; Erica M.,43,0,45,2
1745806322682,EDS 204R,B01,895693,Halter; Christopher P.,18,0,45,27
1745806323709,EDS 206R,A00,895694,Fargason; Sharon Gayle,9,0,30,21
1745806323709,EDS 206R,B00,895695,Choi; Bailey Miyeon,20,0,30,10
1745806324735,EDS 250,A00,895697,Hemans; Patricia Ann Benitez,43,0,45,2
1745806325762,EDS 281,A00,895701,Meyerott; Theresa Ann,15,0,15,0
1745806326791,EDS 284,A00,895736,Meyerott; Theresa Ann,15,0,15,0
1745806327816,EDS 286,A00,897210,Fine; Sarah,15,0,15,0
1745806328842,EDS 289C,A01,895770,Daly; Alan J.,15,0,15,0
1745806329867,EDS 290,A00,897211,Hofstetter; Carolyn,15,0,15,0
1745806330894,LIGM 5A,A00,896162,Fischer-Grunski; Eva K,15,0,20,5
1745806331922,LIGM 5B,A00,896260,Fischer-Grunski; Eva K,17,0,20,3
1745806332949,LIGM 5C,A00,896308,Fischer-Grunski; Eva K,18,0,20,2
1745806333978,LIIT 5AS,A00,896313,Carnelos; Chiara,18,0,20,2
1745806335009,LIIT 5BS,A00,896416,Carnelos; Chiara,20,0,20,0
1745806336036,LIIT 5CS,A00,896564,Carnelos; Chiara,20,0,20,0
1745806337065,LISP 5A,A00,896588,Munoz Sanchez; Alicia,4,0,20,16
1745806338095,LISP 5B,A00,896653,Munoz Sanchez; Alicia,10,0,20,10
1745806339122,LISP 5C,A00,896655,Munoz Sanchez; Alicia,4,0,20,16
1745806340150,MAE 197,001,957918,Kleissl; Jan,9998,0,9999,1
1745806341178,MATH 2,A01,957937,Staff,34,0,35,1
1745806342207,MATH 197,001,957876,Kedlaya; Kiran S.,9993,0,9999,6
1745806343235,MCWP 40,A00,892729,Duru; Nur,13,0,20,7
1745806343235,MCWP 40,B00,893304,Montejo; Carolina,20,0,20,0
1745806344262,MCWP 40R,A00,893757,Redela; Pamela Morgan,0,7,20,20
1745806345289,MCWP 50,A00,893758,Morshed; Michael James,2,0,20,18
1745806345289,MCWP 50,B00,893761,Bartulis; Jason Michael,17,0,20,3
1745806346320,MCWP 50R,A00,893766,Compas; Sean Matthew,0,1,20,20
1745806346320,MCWP 50R,B00,893769,Carter; Jennifer A,0,0,20,20
1745806346320,MCWP 50R,C00,893771,Krone; Jarret,0,3,20,20
1745806346320,MCWP 50R,D00,893772,Miller; Elizabeth Deen,3,0,20,17
1745806346320,MCWP 50R,E00,893775,Carter; Andrea L,0,0,20,20
1745806347348,MMW 11R,A01,892721,Herbst; Matthew,11,0,27,16
1745806347348,MMW 11R,A02,892722,Herbst; Matthew,0,0,0,3
1745806348373,MMW 12R,A01,892724,Herbst; Matthew,0,9,16,16
1745806348373,MMW 12R,A02,892725,Herbst; Matthew,0,9,16,16
1745806349400,MMW 13R,A01,892727,Staff,0,4,16,16
1745806349400,MMW 13R,A02,892728,Staff,0,4,16,16
1745806349400,MMW 13R,A03,958032,Staff,0,3,16,16
1745806349400,MMW 13R,A04,958033,Staff,0,2,16,16
1745806349400,MMW 13R,A05,958034,Staff,0,3,16,16
1745806350425,SIO 295LS,A00,894015,Staff,7,0,25,18
1745806351451,SIO 295S,A00,894020,Staff,7,0,25,18
1745806352478,SIOC 290S,B01,958918,Staff,0,0,0,0
1745806353506,SIOC 291S,B01,958922,Staff,0,0,0,0
1745806354531,SOCI 117,A01,895339,Staff,4,0,5,1
1745806355558,WES 237B,A00,894149,Staff,11,0,20,9
1745806357618,AESE 279B,A00,891859,Staff,13,0,35,22
1745806358644,AIP 197,001,891854,Staff,70,0,70,0
1745806359672,ANTH 289S,A00,891856,Gagneux; Pascal,12,0,12,0
1745806360697,BENG 196,001,957946,Engler; Adam J.,9996,0,9999,3
1745806361722,CAT 124RS,A01,956906,Staff,8,0,25,17
1745806362748,CAT 125RS,A01,922013,Staff,8,0,25,17
1745806363813,CLRE 250,A00,891860,Morris; Sheldon,9995,0,9999,4
1745806365866,CLRE 251R,A00,907817,Mehta; Ravindra L.,9994,0,9999,5
1745806366891,CLRE 252,A00,891864,Cuomo; Raphael Eduardo,9993,0,9999,6
1745806367918,CLRE 253,A00,891867,Vaida; Florin,9994,0,9999,5
1745806367918,CLRE 253,B00,907819,Staff,9999,0,9999,0
1745806368943,CLRE 259,A00,891868,Patel; Hemal,9998,0,9999,1
1745806369969,CLRE 260,A00,891872,Cuomo; Raphael Eduardo,9999,0,9999,0
1745806370998,CLRE 297,001,891888,Cuomo; Raphael Eduardo,9999,0,9999,0
1745806372025,CSE 191,A00,958773,Minnes Kemp; Mor Mia,9999,0,9999,0
1745806373053,CSS 201S,A01,892054,Mignozzetti; Umberto,30,0,30,0
1745806374080,CSS 202S,A01,892056,Mignozzetti; Umberto,30,0,30,0
1745806375106,DSC 197,001,956898,Eldridge; Justin Matthew,9998,0,9999,1
1745806376134,DSC 297,001,958000,Mazumdar; Arya,9998,0,9999,1
1745806377162,EAP 100,A00,905686,Staff,9776,0,9999,223
1745806378189,ECE 45,A01,892618,Staff,0,12,50,50
1745806379215,ECE 109,A01,892620,Staff,0,43,0,0
1745806380241,ECE 111,A01,892719,Staff,0,7,50,50
1745806381266,ECE 197,001,957920,Mercier; Patrick Philip,9992,0,9999,7
1745806382295,ECON 178,A01,907814,Zhu; Ying,28,0,35,7
1745806383320,EDS 115,A00,895312,Staff,41,0,45,4
1745806384346,EDS 117,A01,895337,Staff,30,0,30,0
1745806385374,EDS 125,A00,895341,Jones; Gabrielle Anastasia,43,0,45,2
1745806386400,EDS 128A,A01,895459,Fargason; Sharon Gayle,44,0,45,1
1745806387428,EDS 128B,A01,895543,Pappas; Elizabeth,44,0,45,1
1745806388453,EDS 139,A00,897203,Pappas; Elizabeth,44,0,45,1
1745806388453,EDS 139,B00,897209,Fargason; Sharon Gayle,44,0,45,1
1745806389482,EDS 201,A00,895545,Staff,43,0,45,2
1745806390512,EDS 203,A01,895581,Halter; Christopher P.,43,0,45,2
1745806391539,EDS 204R,A01,895625,Heinzman; Erica M.,43,0,45,2
1745806391539,EDS 204R,B01,895693,Halter; Christopher P.,18,0,45,27
1745806392565,EDS 206R,A00,895694,Fargason; Sharon Gayle,9,0,30,21
1745806392565,EDS 206R,B00,895695,Choi; Bailey Miyeon,20,0,30,10
1745806393592,EDS 250,A00,895697,Hemans; Patricia Ann Benitez,43,0,45,2
1745806394619,EDS 281,A00,895701,Meyerott; Theresa Ann,15,0,15,0
1745806395644,EDS 284,A00,895736,Meyerott; Theresa Ann,15,0,15,0
1745806396671,EDS 286,A00,897210,Fine; Sarah,15,0,15,0
1745806397699,EDS 289C,A01,895770,Daly; Alan J.,15,0,15,0
1745806398726,EDS 290,A00,897211,Hofstetter; Carolyn,15,0,15,0
1745806399754,LIGM 5A,A00,896162,Fischer-Grunski; Eva K,15,0,20,5
1745806400783,LIGM 5B,A00,896260,Fischer-Grunski; Eva K,17,0,20,3
1745806401814,LIGM 5C,A00,896308,Fischer-Grunski; Eva K,18,0,20,2
1745806402840,LIIT 5AS,A00,896313,Carnelos; Chiara,18,0,20,2
1745806403868,LIIT 5BS,A00,896416,Carnelos; Chiara,20,0,20,0
1745806404898,LIIT 5CS,A00,896564,Carnelos; Chiara,20,0,20,0
1745806405924,LISP 5A,A00,896588,Munoz Sanchez; Alicia,4,0,20,16
1745806406953,LISP 5B,A00,896653,Munoz Sanchez; Alicia,10,0,20,10
1745806407980,LISP 5C,A00,896655,Munoz Sanchez; Alicia,4,0,20,16
1745806409008,MAE 197,001,957918,Kleissl; Jan,9998,0,9999,1
1745806410037,MATH 2,A01,957937,Staff,34,0,35,1
1745806411065,MATH 197,001,957876,Kedlaya; Kiran S.,9993,0,9999,6
1745806412095,MCWP 40,A00,892729,Duru; Nur,13,0,20,7
1745806412095,MCWP 40,B00,893304,Montejo; Carolina,20,0,20,0
1745806413121,MCWP 40R,A00,893757,Redela; Pamela Morgan,0,7,20,20
1745806414148,MCWP 50,A00,893758,Morshed; Michael James,2,0,20,18
1745806414148,MCWP 50,B00,893761,Bartulis; Jason Michael,17,0,20,3
1745806415177,MCWP 50R,A00,893766,Compas; Sean Matthew,0,1,20,20
1745806415177,MCWP 50R,B00,893769,Carter; Jennifer A,0,0,20,20
1745806415177,MCWP 50R,C00,893771,Krone; Jarret,0,3,20,20
1745806415177,MCWP 50R,D00,893772,Miller; Elizabeth Deen,3,0,20,17
1745806415177,MCWP 50R,E00,893775,Carter; Andrea L,0,0,20,20
1745806416204,MMW 11R,A01,892721,Herbst; Matthew,11,0,27,16
1745806416204,MMW 11R,A02,892722,Herbst; Matthew,0,0,0,3
1745806417229,MMW 12R,A01,892724,Herbst; Matthew,0,9,16,16
1745806417229,MMW 12R,A02,892725,Herbst; Matthew,0,9,16,16
1745806418256,MMW 13R,A01,892727,Staff,0,4,16,16
1745806418256,MMW 13R,A02,892728,Staff,0,4,16,16
1745806418256,MMW 13R,A03,958032,Staff,0,3,16,16
1745806418256,MMW 13R,A04,958033,Staff,0,2,16,16
1745806418256,MMW 13R,A05,958034,Staff,0,3,16,16
1745806419286,SIO 295LS,A00,894015,Staff,7,0,25,18
1745806420311,SIO 295S,A00,894020,Staff,7,0,25,18
1745806421340,SIOC 290S,B01,958918,Staff,0,0,0,0
1745806422364,SIOC 291S,B01,958922,Staff,0,0,0,0
1745806423393,SOCI 117,A01,895339,Staff,4,0,5,1
1745806424420,WES 237B,A00,894149,Staff,11,0,20,9
1745806426484,AESE 279B,A00,891859,Staff,13,0,35,22
1745806427513,AIP 197,001,891854,Staff,70,0,70,0
1745806428539,ANTH 289S,A00,891856,Gagneux; Pascal,12,0,12,0
1745806429568,BENG 196,001,957946,Engler; Adam J.,9996,0,9999,3
1745806430594,CAT 124RS,A01,956906,Staff,8,0,25,17
1745806431619,CAT 125RS,A01,922013,Staff,8,0,25,17
1745806432643,CLRE 250,A00,891860,Morris; Sheldon,9995,0,9999,4
1745806434706,CLRE 251R,A00,907817,Mehta; Ravindra L.,9994,0,9999,5
1745806435732,CLRE 252,A00,891864,Cuomo; Raphael Eduardo,9993,0,9999,6
1745806436761,CLRE 253,A00,891867,Vaida; Florin,9994,0,9999,5
1745806436761,CLRE 253,B00,907819,Staff,9999,0,9999,0
1745806437787,CLRE 259,A00,891868,Patel; Hemal,9998,0,9999,1
1745806438813,CLRE 260,A00,891872,Cuomo; Raphael Eduardo,9999,0,9999,0
1745806439841,CLRE 297,001,891888,Cuomo; Raphael Eduardo,9999,0,9999,0
1745806440869,CSE 191,A00,958773,Minnes Kemp; Mor Mia,9999,0,9999,0
1745806441899,CSS 201S,A01,892054,Mignozzetti; Umberto,30,0,30,0
1745806442930,CSS 202S,A01,892056,Mignozzetti; Umberto,30,0,30,0
1745806443954,DSC 197,001,956898,Eldridge; Justin Matthew,9998,0,9999,1
1745806444981,DSC 297,001,958000,Mazumdar; Arya,9998,0,9999,1
1745806446006,EAP 100,A00,905686,Staff,9776,0,9999,223
1745806447032,ECE 45,A01,892618,Staff,0,12,50,50
1745806448057,ECE 109,A01,892620,Staff,0,43,0,0
1745806449083,ECE 111,A01,892719,Staff,0,7,50,50
1745806450109,ECE 197,001,957920,Mercier; Patrick Philip,9992,0,9999,7
1745806451136,ECON 178,A01,907814,Zhu; Ying,28,0,35,7
1745806452161,EDS 115,A00,895312,Staff,41,0,45,4
1745806453187,EDS 117,A01,895337,Staff,30,0,30,0
1745806454216,EDS 125,A00,895341,Jones; Gabrielle Anastasia,43,0,45,2
1745806455243,EDS 128A,A01,895459,Fargason; Sharon Gayle,44,0,45,1
1745806456269,EDS 128B,A01,895543,Pappas; Elizabeth,44,0,45,1
1745806457295,EDS 139,A00,897203,Pappas; Elizabeth,44,0,45,1
1745806457295,EDS 139,B00,897209,Fargason; Sharon Gayle,44,0,45,1
1745806458334,EDS 201,A00,895545,Staff,43,0,45,2
1745806459360,EDS 203,A01,895581,Halter; Christopher P.,43,0,45,2
1745806460385,EDS 204R,A01,895625,Heinzman; Erica M.,43,0,45,2
1745806460385,EDS 204R,B01,895693,Halter; Christopher P.,18,0,45,27
1745806461416,EDS 206R,A00,895694,Fargason; Sharon Gayle,9,0,30,21
1745806461416,EDS 206R,B00,895695,Choi; Bailey Miyeon,20,0,30,10
1745806462446,EDS 250,A00,895697,Hemans; Patricia Ann Benitez,43,0,45,2
1745806463472,EDS 281,A00,895701,Meyerott; Theresa Ann,15,0,15,0
1745806464498,EDS 284,A00,895736,Meyerott; Theresa Ann,15,0,15,0
1745806465527,EDS 286,A00,897210,Fine; Sarah,15,0,15,0
1745806466553,EDS 289C,A01,895770,Daly; Alan J.,15,0,15,0
1745806467622,EDS 290,A00,897211,Hofstetter; Carolyn,15,0,15,0
1745806468648,LIGM 5A,A00,896162,Fischer-Grunski; Eva K,15,0,20,5
1745806469678,LIGM 5B,A00,896260,Fischer-Grunski; Eva K,17,0,20,3
1745806470707,LIGM 5C,A00,896308,Fischer-Grunski; Eva K,18,0,20,2
1745806471735,LIIT 5AS,A00,896313,Carnelos; Chiara,18,0,20,2
1745806472764,LIIT 5BS,A00,896416,Carnelos; Chiara,20,0,20,0
1745806473790,LIIT 5CS,A00,896564,Carnelos; Chiara,20,0,20,0
1745806474820,LISP 5A,A00,896588,Munoz Sanchez; Alicia,4,0,20,16
1745806475846,LISP 5B,A00,896653,Munoz Sanchez; Alicia,10,0,20,10
1745806476872,LISP 5C,A00,896655,Munoz Sanchez; Alicia,4,0,20,16
1745806477901,MAE 197,001,957918,Kleissl; Jan,9998,0,9999,1
1745806478930,MATH 2,A01,957937,Staff,34,0,35,1
1745806479955,MATH 197,001,957876,Kedlaya; Kiran S.,9993,0,9999,6
1745806480980,MCWP 40,A00,892729,Duru; Nur,13,0,20,7
1745806480980,MCWP 40,B00,893304,Montejo; Carolina,20,0,20,0
1745806482007,MCWP 40R,A00,893757,Redela; Pamela Morgan,0,7,20,20
1745806483033,MCWP 50,A00,893758,Morshed; Michael James,2,0,20,18
1745806483033,MCWP 50,B00,893761,Bartulis; Jason Michael,17,0,20,3
1745806484064,MCWP 50R,A00,893766,Compas; Sean Matthew,0,1,20,20
1745806484064,MCWP 50R,B00,893769,Carter; Jennifer A,0,0,20,20
1745806484064,MCWP 50R,C00,893771,Krone; Jarret,0,3,20,20
1745806484064,MCWP 50R,D00,893772,Miller; Elizabeth Deen,3,0,20,17
1745806484064,MCWP 50R,E00,893775,Carter; Andrea L,0,0,20,20
1745806485093,MMW 11R,A01,892721,Herbst; Matthew,11,0,27,16
1745806485093,MMW 11R,A02,892722,Herbst; Matthew,0,0,0,3
1745806486121,MMW 12R,A01,892724,Herbst; Matthew,0,9,16,16
1745806486121,MMW 12R,A02,892725,Herbst; Matthew,0,9,16,16
1745806487147,MMW 13R,A01,892727,Staff,0,4,16,16
1745806487147,MMW 13R,A02,892728,Staff,0,4,16,16
1745806487147,MMW 13R,A03,958032,Staff,0,3,16,16
1745806487147,MMW 13R,A04,958033,Staff,0,2,16,16
1745806487147,MMW 13R,A05,958034,Staff,0,3,16,16
1745806488177,SIO 295LS,A00,894015,Staff,7,0,25,18
1745806489206,SIO 295S,A00,894020,Staff,7,0,25,18
1745806490232,SIOC 290S,B01,958918,Staff,0,0,0,0
1745806491258,SIOC 291S,B01,958922,Staff,0,0,0,0
1745806492284,SOCI 117,A01,895339,Staff,4,0,5,1
1745806493311,WES 237B,A00,894149,Staff,11,0,20,9
1745806495366,AESE 279B,A00,891859,Staff,13,0,35,22
1745806496391,AIP 197,001,891854,Staff,70,0,70,0
1745806497417,ANTH 289S,A00,891856,Gagneux; Pascal,12,0,12,0
1745806498443,BENG 196,001,957946,Engler; Adam J.,9996,0,9999,3
1745806499472,CAT 124RS,A01,956906,Staff,8,0,25,17
1745806500496,CAT 125RS,A01,922013,Staff,8,0,25,17
1745806501528,CLRE 250,A00,891860,Morris; Sheldon,9995,0,9999,4
1745806503580,CLRE 251R,A00,907817,Mehta; Ravindra L.,9994,0,9999,5
1745806504604,CLRE 252,A00,891864,Cuomo; Raphael Eduardo,9993,0,9999,6
1745806505631,CLRE 253,A00,891867,Vaida; Florin,9994,0,9999,5
1745806505631,CLRE 253,B00,907819,Staff,9999,0,9999,0
1745806506660,CLRE 259,A00,891868,Patel; Hemal,9998,0,9999,1
1745806507688,CLRE 260,A00,891872,Cuomo; Raphael Eduardo,9999,0,9999,0
1745806508718,CLRE 297,001,891888,Cuomo; Raphael Eduardo,9999,0,9999,0
1745806509745,CSE 191,A00,958773,Minnes Kemp; Mor Mia,9999,0,9999,0
1745806510772,CSS 201S,A01,892054,Mignozzetti; Umberto,30,0,30,0
1745806511798,CSS 202S,A01,892056,Mignozzetti; Umberto,30,0,30,0
1745806512826,DSC 197,001,956898,Eldridge; Justin Matthew,9998,0,9999,1
1745806513852,DSC 297,001,958000,Mazumdar; Arya,9998,0,9999,1
1745806514882,EAP 100,A00,905686,Staff,9776,0,9999,223
1745806515907,ECE 45,A01,892618,Staff,0,12,50,50
1745806516933,ECE 109,A01,892620,Staff,0,43,0,0
1745806517961,ECE 111,A01,892719,Staff,0,7,50,50
1745806518986,ECE 197,001,957920,Mercier; Patrick Philip,9992,0,9999,7
1745806520015,ECON 178,A01,907814,Zhu; Ying,28,0,35,7
1745806521043,EDS 115,A00,895312,Staff,41,0,45,4
1745806522071,EDS 117,A01,895337,Staff,30,0,30,0
1745806523098,EDS 125,A00,895341,Jones; Gabrielle Anastasia,43,0,45,2
1745806524133,EDS 128A,A01,895459,Fargason; Sharon Gayle,44,0,45,1
1745806525159,EDS 128B,A01,895543,Pappas; Elizabeth,44,0,45,1
1745806526185,EDS 139,A00,897203,Pappas; Elizabeth,44,0,45,1
1745806526185,EDS 139,B00,897209,Fargason; Sharon Gayle,44,0,45,1
1745806527213,EDS 201,A00,895545,Staff,43,0,45,2
1745806528238,EDS 203,A01,895581,Halter; Christopher P.,43,0,45,2
1745806529264,EDS 204R,A01,895625,Heinzman; Erica M.,43,0,45,2
1745806529264,EDS 204R,B01,895693,Halter; Christopher P.,18,0,45,27
1745806530289,EDS 206R,A00,895694,Fargason; Sharon Gayle,9,0,30,21
1745806530289,EDS 206R,B00,895695,Choi; Bailey Miyeon,20,0,30,10
1745806531316,EDS 250,A00,895697,Hemans; Patricia Ann Benitez,43,0,45,2
1745806532345,EDS 281,A00,895701,Meyerott; Theresa Ann,15,0,15,0
1745806533374,EDS 284,A00,895736,Meyerott; Theresa Ann,15,0,15,0
1745806534402,EDS 286,A00,897210,Fine; Sarah,15,0,15,0
1745806535428,EDS 289C,A01,895770,Daly; Alan J.,15,0,15,0
1745806536457,EDS 290,A00,897211,Hofstetter; Carolyn,15,0,15,0
1745806537481,LIGM 5A,A00,896162,Fischer-Grunski; Eva K,15,0,20,5
1745806538511,LIGM 5B,A00,896260,Fischer-Grunski; Eva K,17,0,20,3
1745806539536,LIGM 5C,A00,896308,Fischer-Grunski; Eva K,18,0,20,2
1745806540564,LIIT 5AS,A00,896313,Carnelos; Chiara,18,0,20,2
1745806541591,LIIT 5BS,A00,896416,Carnelos; Chiara,20,0,20,0
1745806542618,LIIT 5CS,A00,896564,Carnelos; Chiara,20,0,20,0
1745806543648,LISP 5A,A00,896588,Munoz Sanchez; Alicia,4,0,20,16
1745806544674,LISP 5B,A00,896653,Munoz Sanchez; Alicia,10,0,20,10
1745806545703,LISP 5C,A00,896655,Munoz Sanchez; Alicia,4,0,20,16
1745806546729,MAE 197,001,957918,Kleissl; Jan,9998,0,9999,1
1745806547757,MATH 2,A01,957937,Staff,34,0,35,1
1745806548784,MATH 197,001,957876,Kedlaya; Kiran S.,9993,0,9999,6
1745806549809,MCWP 40,A00,892729,Duru; Nur,13,0,20,7
1745806549809,MCWP 40,B00,893304,Montejo; Carolina,20,0,20,0
1745806550835,MCWP 40R,A00,893757,Redela; Pamela Morgan,0,7,20,20
1745806551862,MCWP 50,A00,893758,Morshed; Michael James,2,0,20,18
1745806551862,MCWP 50,B00,893761,Bartulis; Jason Michael,17,0,20,3
1745806552897,MCWP 50R,A00,893766,Compas; Sean Matthew,0,1,20,20
1745806552897,MCWP 50R,B00,893769,Carter; Jennifer A,0,0,20,20
1745806552897,MCWP 50R,C00,893771,Krone; Jarret,0,3,20,20
1745806552897,MCWP 50R,D00,893772,Miller; Elizabeth Deen,3,0,20,17
1745806552897,MCWP 50R,E00,893775,Carter; Andrea L,0,0,20,20
1745806553927,MMW 11R,A01,892721,Herbst; Matthew,11,0,27,16
1745806553927,MMW 11R,A02,892722,Herbst; Matthew,0,0,0,3
1745806554953,MMW 12R,A01,892724,Herbst; Matthew,0,9,16,16
1745806554953,MMW 12R,A02,892725,Herbst; Matthew,0,9,16,16
1745806555980,MMW 13R,A01,892727,Staff,0,4,16,16
1745806555980,MMW 13R,A02,892728,Staff,0,4,16,16
1745806555980,MMW 13R,A03,958032,Staff,0,3,16,16
1745806555980,MMW 13R,A04,958033,Staff,0,2,16,16
1745806555980,MMW 13R,A05,958034,Staff,0,3,16,16
1745806557007,SIO 295LS,A00,894015,Staff,7,0,25,18
1745806558034,SIO 295S,A00,894020,Staff,7,0,25,18
1745806559065,SIOC 290S,B01,958918,Staff,0,0,0,0
1745806560091,SIOC 291S,B01,958922,Staff,0,0,0,0
1745806561117,SOCI 117,A01,895339,Staff,4,0,5,1
1745806562147,WES 237B,A00,894149,Staff,11,0,20,9
1745806564207,AESE 279B,A00,891859,Staff,13,0,35,22
1745806565235,AIP 197,001,891854,Staff,70,0,70,0
1745806566262,ANTH 289S,A00,891856,Gagneux; Pascal,12,0,12,0
1745806567290,BENG 196,001,957946,Engler; Adam J.,9996,0,9999,3
1745806568317,CAT 124RS,A01,956906,Staff,8,0,25,17
1745806569342,CAT 125RS,A01,922013,Staff,8,0,25,17
1745806570372,CLRE 250,A00,891860,Morris; Sheldon,9995,0,9999,4
1745806572482,CLRE 251R,A00,907817,Mehta; Ravindra L.,9994,0,9999,5
1745806573505,CLRE 252,A00,891864,Cuomo; Raphael Eduardo,9993,0,9999,6
1745806574535,CLRE 253,A00,891867,Vaida; Florin,9994,0,9999,5
1745806574535,CLRE 253,B00,907819,Staff,9999,0,9999,0
1745806575559,CLRE 259,A00,891868,Patel; Hemal,9998,0,9999,1
1745806576586,CLRE 260,A00,891872,Cuomo; Raphael Eduardo,9999,0,9999,0
1745806577613,CLRE 297,001,891888,Cuomo; Raphael Eduardo,9999,0,9999,0
1745806578640,CSE 191,A00,958773,Minnes Kemp; Mor Mia,9999,0,9999,0
1745806579665,CSS 201S,A01,892054,Mignozzetti; Umberto,30,0,30,0
1745806580693,CSS 202S,A01,892056,Mignozzetti; Umberto,30,0,30,0
1745806581722,DSC 197,001,956898,Eldridge; Justin Matthew,9998,0,9999,1
1745806582747,DSC 297,001,958000,Mazumdar; Arya,9998,0,9999,1
1745806583775,EAP 100,A00,905686,Staff,9776,0,9999,223
1745806584805,ECE 45,A01,892618,Staff,0,12,50,50
1745806585834,ECE 109,A01,892620,Staff,0,43,0,0
1745806586859,ECE 111,A01,892719,Staff,0,7,50,50
1745806587886,ECE 197,001,957920,Mercier; Patrick Philip,9992,0,9999,7
1745806588910,ECON 178,A01,907814,Zhu; Ying,28,0,35,7
1745806589938,EDS 115,A00,895312,Staff,41,0,45,4
1745806590970,EDS 117,A01,895337,Staff,30,0,30,0
1745806591998,EDS 125,A00,895341,Jones; Gabrielle Anastasia,43,0,45,2
1745806593027,EDS 128A,A01,895459,Fargason; Sharon Gayle,44,0,45,1
1745806594053,EDS 128B,A01,895543,Pappas; Elizabeth,44,0,45,1
1745806595081,EDS 139,A00,897203,Pappas; Elizabeth,44,0,45,1
1745806595081,EDS 139,B00,897209,Fargason; Sharon Gayle,44,0,45,1
1745806596106,EDS 201,A00,895545,Staff,43,0,45,2
1745806597132,EDS 203,A01,895581,Halter; Christopher P.,43,0,45,2
1745806598156,EDS 204R,A01,895625,Heinzman; Erica M.,43,0,45,2
1745806598156,EDS 204R,B01,895693,Halter; Christopher P.,18,0,45,27
1745806599182,EDS 206R,A00,895694,Fargason; Sharon Gayle,9,0,30,21
1745806599182,EDS 206R,B00,895695,Choi; Bailey Miyeon,20,0,30,10
1745806600208,EDS 250,A00,895697,Hemans; Patricia Ann Benitez,43,0,45,2
1745806601233,EDS 281,A00,895701,Meyerott; Theresa Ann,15,0,15,0
1745806602260,EDS 284,A00,895736,Meyerott; Theresa Ann,15,0,15,0
1745806603285,EDS 286,A00,897210,Fine; Sarah,15,0,15,0
1745806604317,EDS 289C,A01,895770,Daly; Alan J.,15,0,15,0
1745806605345,EDS 290,A00,897211,Hofstetter; Carolyn,15,0,15,0
1745806606376,LIGM 5A,A00,896162,Fischer-Grunski; Eva K,15,0,20,5
1745806607407,LIGM 5B,A00,896260,Fischer-Grunski; Eva K,17,0,20,3
1745806608433,LIGM 5C,A00,896308,Fischer-Grunski; Eva K,18,0,20,2
1745806609462,LIIT 5AS,A00,896313,Carnelos; Chiara,18,0,20,2
1745806610492,LIIT 5BS,A00,896416,Carnelos; Chiara,20,0,20,0
1745806611518,LIIT 5CS,A00,896564,Carnelos; Chiara,20,0,20,0
1745806612545,LISP 5A,A00,896588,Munoz Sanchez; Alicia,4,0,20,16
1745806613570,LISP 5B,A00,896653,Munoz Sanchez; Alicia,10,0,20,10
1745806614598,LISP 5C,A00,896655,Munoz Sanchez; Alicia,4,0,20,16
1745806615623,MAE 197,001,957918,Kleissl; Jan,9998,0,9999,1
1745806616650,MATH 2,A01,957937,Staff,34,0,35,1
1745806617677,MATH 197,001,957876,Kedlaya; Kiran S.,9993,0,9999,6
1745806618701,MCWP 40,A00,892729,Duru; Nur,13,0,20,7
1745806618701,MCWP 40,B00,893304,Montejo; Carolina,20,0,20,0
1745806619726,MCWP 40R,A00,893757,Redela; Pamela Morgan,0,7,20,20
1745806620752,MCWP 50,A00,893758,Morshed; Michael James,2,0,20,18
1745806620752,MCWP 50,B00,893761,Bartulis; Jason Michael,17,0,20,3
1745806621785,MCWP 50R,A00,893766,Compas; Sean Matthew,0,1,20,20
1745806621785,MCWP 50R,B00,893769,Carter; Jennifer A,0,0,20,20
1745806621785,MCWP 50R,C00,893771,Krone; Jarret,0,3,20,20
1745806621785,MCWP 50R,D00,893772,Miller; Elizabeth Deen,3,0,20,17
1745806621785,MCWP 50R,E00,893775,Carter; Andrea L,0,0,20,20
1745806622815,MMW 11R,A01,892721,Herbst; Matthew,11,0,27,16
1745806622815,MMW 11R,A02,892722,Herbst; Matthew,0,0,0,3
1745806623841,MMW 12R,A01,892724,Herbst; Matthew,0,9,16,16
1745806623841,MMW 12R,A02,892725,Herbst; Matthew,0,9,16,16
1745806624869,MMW 13R,A01,892727,Staff,0,4,16,16
1745806624869,MMW 13R,A02,892728,Staff,0,4,16,16
1745806624869,MMW 13R,A03,958032,Staff,0,3,16,16
1745806624869,MMW 13R,A04,958033,Staff,0,2,16,16
1745806624869,MMW 13R,A05,958034,Staff,0,3,16,16
1745806625895,SIO 295LS,A00,894015,Staff,7,0,25,18
1745806626920,SIO 295S,A00,894020,Staff,7,0,25,18
1745806627947,SIOC 290S,B01,958918,Staff,0,0,0,0
1745806628975,SIOC 291S,B01,958922,Staff,0,0,0,0
1745806630001,SOCI 117,A01,895339,Staff,4,0,5,1
1745806631027,WES 237B,A00,894149,Staff,11,0,20,9
1745806633085,AESE 279B,A00,891859,Staff,13,0,35,22
1745806634112,AIP 197,001,891854,Staff,70,0,70,0
1745806635138,ANTH 289S,A00,891856,Gagneux; Pascal,12,0,12,0
1745806636164,BENG 196,001,957946,Engler; Adam J.,9996,0,9999,3
1745806637189,CAT 124RS,A01,956906,Staff,8,0,25,17
1745806638217,CAT 125RS,A01,922013,Staff,8,0,25,17
1745806639242,CLRE 250,A00,891860,Morris; Sheldon,9995,0,9999,4
1745806641294,CLRE 251R,A00,907817,Mehta; Ravindra L.,9994,0,9999,5
1745806642320,CLRE 252,A00,891864,Cuomo; Raphael Eduardo,9993,0,9999,6
1745806643349,CLRE 253,A00,891867,Vaida; Florin,9994,0,9999,5
1745806643349,CLRE 253,B00,907819,Staff,9999,0,9999,0
1745806644377,CLRE 259,A00,891868,Patel; Hemal,9998,0,9999,1
1745806645405,CLRE 260,A00,891872,Cuomo; Raphael Eduardo,9999,0,9999,0
1745806646433,CLRE 297,001,891888,Cuomo; Raphael Eduardo,9999,0,9999,0
1745806647461,CSE 191,A00,958773,Minnes Kemp; Mor Mia,9999,0,9999,0
1745806648490,CSS 201S,A01,892054,Mignozzetti; Umberto,30,0,30,0
1745806649515,CSS 202S,A01,892056,Mignozzetti; Umberto,30,0,30,0
1745806650542,DSC 197,001,956898,Eldridge; Justin Matthew,9998,0,9999,1
1745806651568,DSC 297,001,958000,Mazumdar; Arya,9998,0,9999,1
1745806652594,EAP 100,A00,905686,Staff,9776,0,9999,223
1745806653620,ECE 45,A01,892618,Staff,0,12,50,50
1745806654649,ECE 109,A01,892620,Staff,0,43,0,0
1745806655673,ECE 111,A01,892719,Staff,0,7,50,50
1745806656700,ECE 197,001,957920,Mercier; Patrick Philip,9992,0,9999,7
1745806657725,ECON 178,A01,907814,Zhu; Ying,28,0,35,7
1745806658751,EDS 115,A00,895312,Staff,41,0,45,4
1745806659776,EDS 117,A01,895337,Staff,30,0,30,0
1745806660800,EDS 125,A00,895341,Jones; Gabrielle Anastasia,43,0,45,2
1745806661827,EDS 128A,A01,895459,Fargason; Sharon Gayle,44,0,45,1
1745806662852,EDS 128B,A01,895543,Pappas; Elizabeth,44,0,45,1
1745806663876,EDS 139,A00,897203,Pappas; Elizabeth,44,0,45,1
1745806663876,EDS 139,B00,897209,Fargason; Sharon Gayle,44,0,45,1
1745806664901,EDS 201,A00,895545,Staff,43,0,45,2
1745806665926,EDS 203,A01,895581,Halter; Christopher P.,43,0,45,2
1745806666951,EDS 204R,A01,895625,Heinzman; Erica M.,43,0,45,2
1745806666951,EDS 204R,B01,895693,Halter; Christopher P.,18,0,45,27
1745806667980,EDS 206R,A00,895694,Fargason; Sharon Gayle,9,0,30,21
1745806667980,EDS 206R,B00,895695,Choi; Bailey Miyeon,20,0,30,10
1745806669005,EDS 250,A00,895697,Hemans; Patricia Ann Benitez,43,0,45,2
1745806670032,EDS 281,A00,895701,Meyerott; Theresa Ann,15,0,15,0
1745806671059,EDS 284,A00,895736,Meyerott; Theresa Ann,15,0,15,0
1745806672084,EDS 286,A00,897210,Fine; Sarah,15,0,15,0
1745806673112,EDS 289C,A01,895770,Daly; Alan J.,15,0,15,0
1745806674138,EDS 290,A00,897211,Hofstetter; Carolyn,15,0,15,0
1745806675164,LIGM 5A,A00,896162,Fischer-Grunski; Eva K,15,0,20,5
1745806676192,LIGM 5B,A00,896260,Fischer-Grunski; Eva K,17,0,20,3
1745806677218,LIGM 5C,A00,896308,Fischer-Grunski; Eva K,18,0,20,2
1745806678247,LIIT 5AS,A00,896313,Carnelos; Chiara,18,0,20,2
1745806679273,LIIT 5BS,A00,896416,Carnelos; Chiara,20,0,20,0
1745806680302,LIIT 5CS,A00,896564,Carnelos; Chiara,20,0,20,0
1745806681330,LISP 5A,A00,896588,Munoz Sanchez; Alicia,4,0,20,16
1745806682355,LISP 5B,A00,896653,Munoz Sanchez; Alicia,10,0,20,10
1745806683384,LISP 5C,A00,896655,Munoz Sanchez; Alicia,4,0,20,16
1745806684410,MAE 197,001,957918,Kleissl; Jan,9998,0,9999,1
1745806685436,MATH 2,A01,957937,Staff,34,0,35,1
1745806686460,MATH 197,001,957876,Kedlaya; Kiran S.,9993,0,9999,6
1745806687488,MCWP 40,A00,892729,Duru; Nur,13,0,20,7
1745806687488,MCWP 40,B00,893304,Montejo; Carolina,20,0,20,0
1745806688515,MCWP 40R,A00,893757,Redela; Pamela Morgan,0,7,20,20
1745806689543,MCWP 50,A00,893758,Morshed; Michael James,2,0,20,18
1745806689543,MCWP 50,B00,893761,Bartulis; Jason Michael,17,0,20,3
1745806690571,MCWP 50R,A00,893766,Compas; Sean Matthew,0,1,20,20
1745806690571,MCWP 50R,B00,893769,Carter; Jennifer A,0,0,20,20
1745806690571,MCWP 50R,C00,893771,Krone; Jarret,0,3,20,20
1745806690571,MCWP 50R,D00,893772,Miller; Elizabeth Deen,3,0,20,17
1745806690571,MCWP 50R,E00,893775,Carter; Andrea L,0,0,20,20
1745806691598,MMW 11R,A01,892721,Herbst; Matthew,11,0,27,16
1745806691598,MMW 11R,A02,892722,Herbst; Matthew,0,0,0,3
1745806692623,MMW 12R,A01,892724,Herbst; Matthew,0,9,16,16
1745806692623,MMW 12R,A02,892725,Herbst; Matthew,0,9,16,16
1745806693651,MMW 13R,A01,892727,Staff,0,4,16,16
1745806693651,MMW 13R,A02,892728,Staff,0,4,16,16
1745806693651,MMW 13R,A03,958032,Staff,0,3,16,16
1745806693651,MMW 13R,A04,958033,Staff,0,2,16,16
1745806693651,MMW 13R,A05,958034,Staff,0,3,16,16
1745806694675,SIO 295LS,A00,894015,Staff,7,0,25,18
1745806695700,SIO 295S,A00,894020,Staff,7,0,25,18
1745806696726,SIOC 290S,B01,958918,Staff,0,0,0,0
1745806697753,SIOC 291S,B01,958922,Staff,0,0,0,0
1745806698777,SOCI 117,A01,895339,Staff,4,0,5,1
1745806699803,WES 237B,A00,894149,Staff,11,0,20,9
1745806701863,AESE 279B,A00,891859,Staff,13,0,35,22
1745806702889,AIP 197,001,891854,Staff,70,0,70,0
1745806703916,ANTH 289S,A00,891856,Gagneux; Pascal,12,0,12,0
1745806704941,BENG 196,001,957946,Engler; Adam J.,9996,0,9999,3
1745806705966,CAT 124RS,A01,956906,Staff,8,0,25,17
1745806706992,CAT 125RS,A01,922013,Staff,8,0,25,17
1745806708017,CLRE 250,A00,891860,Morris; Sheldon,9995,0,9999,4
1745806710070,CLRE 251R,A00,907817,Mehta; Ravindra L.,9994,0,9999,5
1745806711095,CLRE 252,A00,891864,Cuomo; Raphael Eduardo,9993,0,9999,6
1745806712123,CLRE 253,A00,891867,Vaida; Florin,9994,0,9999,5
1745806712123,CLRE 253,B00,907819,Staff,9999,0,9999,0
1745806713150,CLRE 259,A00,891868,Patel; Hemal,9998,0,9999,1
1745806714176,CLRE 260,A00,891872,Cuomo; Raphael Eduardo,9999,0,9999,0
1745806715200,CLRE 297,001,891888,Cuomo; Raphael Eduardo,9999,0,9999,0
1745806716228,CSE 191,A00,958773,Minnes Kemp; Mor Mia,9999,0,9999,0
1745806717254,CSS 201S,A01,892054,Mignozzetti; Umberto,30,0,30,0
1745806718284,CSS 202S,A01,892056,Mignozzetti; Umberto,30,0,30,0
1745806719310,DSC 197,001,956898,Eldridge; Justin Matthew,9998,0,9999,1
1745806720339,DSC 297,001,958000,Mazumdar; Arya,9998,0,9999,1
1745806721364,EAP 100,A00,905686,Staff,9776,0,9999,223
1745806722390,ECE 45,A01,892618,Staff,0,12,50,50
1745806723419,ECE 109,A01,892620,Staff,0,43,0,0
1745806724444,ECE 111,A01,892719,Staff,0,7,50,50
1745806725471,ECE 197,001,957920,Mercier; Patrick Philip,9992,0,9999,7
1745806726500,ECON 178,A01,907814,Zhu; Ying,28,0,35,7
1745806727525,EDS 115,A00,895312,Staff,41,0,45,4
1745806728551,EDS 117,A01,895337,Staff,30,0,30,0
1745806729579,EDS 125,A00,895341,Jones; Gabrielle Anastasia,43,0,45,2
1745806730604,EDS 128A,A01,895459,Fargason; Sharon Gayle,44,0,45,1
1745806731629,EDS 128B,A01,895543,Pappas; Elizabeth,44,0,45,1
1745806732654,EDS 139,A00,897203,Pappas; Elizabeth,44,0,45,1
1745806732654,EDS 139,B00,897209,Fargason; Sharon Gayle,44,0,45,1
1745806733679,EDS 201,A00,895545,Staff,43,0,45,2
1745806734708,EDS 203,A01,895581,Halter; Christopher P.,43,0,45,2
1745806735733,EDS 204R,A01,895625,Heinzman; Erica M.,43,0,45,2
1745806735733,EDS 204R,B01,895693,Halter; Christopher P.,18,0,45,27
1745806736757,EDS 206R,A00,895694,Fargason; Sharon Gayle,9,0,30,21
1745806736757,EDS 206R,B00,895695,Choi; Bailey Miyeon,20,0,30,10
1745806737785,EDS 250,A00,895697,Hemans; Patricia Ann Benitez,43,0,45,2
1745806738810,EDS 281,A00,895701,Meyerott; Theresa Ann,15,0,15,0
1745806739839,EDS 284,A00,895736,Meyerott; Theresa Ann,15,0,15,0
1745806740864,EDS 286,A00,897210,Fine; Sarah,15,0,15,0
1745806741890,EDS 289C,A01,895770,Daly; Alan J.,15,0,15,0
1745806742920,EDS 290,A00,897211,Hofstetter; Carolyn,15,0,15,0
1745806743946,LIGM 5A,A00,896162,Fischer-Grunski; Eva K,15,0,20,5
1745806744972,LIGM 5B,A00,896260,Fischer-Grunski; Eva K,17,0,20,3
1745806745999,LIGM 5C,A00,896308,Fischer-Grunski; Eva K,18,0,20,2
1745806747028,LIIT 5AS,A00,896313,Carnelos; Chiara,18,0,20,2
1745806748056,LIIT 5BS,A00,896416,Carnelos; Chiara,20,0,20,0
1745806749084,LIIT 5CS,A00,896564,Carnelos; Chiara,20,0,20,0
1745806750108,LISP 5A,A00,896588,Munoz Sanchez; Alicia,4,0,20,16
1745806751134,LISP 5B,A00,896653,Munoz Sanchez; Alicia,10,0,20,10
1745806752165,LISP 5C,A00,896655,Munoz Sanchez; Alicia,4,0,20,16
1745806753189,MAE 197,001,957918,Kleissl; Jan,9998,0,9999,1
1745806754217,MATH 2,A01,957937,Staff,34,0,35,1
1745806755246,MATH 197,001,957876,Kedlaya; Kiran S.,9993,0,9999,6
1745806756273,MCWP 40,A00,892729,Duru; Nur,13,0,20,7
1745806756273,MCWP 40,B00,893304,Montejo; Carolina,20,0,20,0
1745806757299,MCWP 40R,A00,893757,Redela; Pamela Morgan,0,7,20,20
1745806758327,MCWP 50,A00,893758,Morshed; Michael James,2,0,20,18
1745806758327,MCWP 50,B00,893761,Bartulis; Jason Michael,17,0,20,3
1745806759356,MCWP 50R,A00,893766,Compas; Sean Matthew,0,1,20,20
1745806759356,MCWP 50R,B00,893769,Carter; Jennifer A,0,0,20,20
1745806759356,MCWP 50R,C00,893771,Krone; Jarret,0,3,20,20
1745806759356,MCWP 50R,D00,893772,Miller; Elizabeth Deen,3,0,20,17
1745806759356,MCWP 50R,E00,893775,Carter; Andrea L,0,0,20,20
1745806760383,MMW 11R,A01,892721,Herbst; Matthew,11,0,27,16
1745806760383,MMW 11R,A02,892722,Herbst; Matthew,0,0,0,3
1745806761409,MMW 12R,A01,892724,Herbst; Matthew,0,9,16,16
1745806761409,MMW 12R,A02,892725,Herbst; Matthew,0,9,16,16
1745806762436,MMW 13R,A01,892727,Staff,0,4,16,16
1745806762436,MMW 13R,A02,892728,Staff,0,4,16,16
1745806762436,MMW 13R,A03,958032,Staff,0,3,16,16
1745806762436,MMW 13R,A04,958033,Staff,0,2,16,16
1745806762436,MMW 13R,A05,958034,Staff,0,3,16,16
1745806763462,SIO 295LS,A00,894015,Staff,7,0,25,18
1745806764491,SIO 295S,A00,894020,Staff,7,0,25,18
1745806765520,SIOC 290S,B01,958918,Staff,0,0,0,0
1745806766546,SIOC 291S,B01,958922,Staff,0,0,0,0
1745806767572,SOCI 117,A01,895339,Staff,4,0,5,1
1745806768599,WES 237B,A00,894149,Staff,11,0,20,9
1745806770659,AESE 279B,A00,891859,Staff,13,0,35,22
1745806771686,AIP 197,001,891854,Staff,70,0,70,0
1745806772713,ANTH 289S,A00,891856,Gagneux; Pascal,12,0,12,0
1745806773740,BENG 196,001,957946,Engler; Adam J.,9996,0,9999,3
1745806774766,CAT 124RS,A01,956906,Staff,8,0,25,17
1745806775794,CAT 125RS,A01,922013,Staff,8,0,25,17
1745806776822,CLRE 250,A00,891860,Morris; Sheldon,9995,0,9999,4
1745806778875,CLRE 251R,A00,907817,Mehta; Ravindra L.,9994,0,9999,5
1745806779901,CLRE 252,A00,891864,Cuomo; Raphael Eduardo,9993,0,9999,6
1745806780927,CLRE 253,A00,891867,Vaida; Florin,9994,0,9999,5
1745806780927,CLRE 253,B00,907819,Staff,9999,0,9999,0
1745806781951,CLRE 259,A00,891868,Patel; Hemal,9998,0,9999,1
1745806782977,CLRE 260,A00,891872,Cuomo; Raphael Eduardo,9999,0,9999,0
1745806784003,CLRE 297,001,891888,Cuomo; Raphael Eduardo,9999,0,9999,0
1745806785029,CSE 191,A00,958773,Minnes Kemp; Mor Mia,9999,0,9999,0
1745806786057,CSS 201S,A01,892054,Mignozzetti; Umberto,30,0,30,0
1745806787088,CSS 202S,A01,892056,Mignozzetti; Umberto,30,0,30,0
1745806788116,DSC 197,001,956898,Eldridge; Justin Matthew,9998,0,9999,1
1745806789143,DSC 297,001,958000,Mazumdar; Arya,9998,0,9999,1
1745806790171,EAP 100,A00,905686,Staff,9776,0,9999,223
1745806791199,ECE 45,A01,892618,Staff,0,12,50,50
1745806792225,ECE 109,A01,892620,Staff,0,43,0,0
1745806793253,ECE 111,A01,892719,Staff,0,7,50,50
1745806794281,ECE 197,001,957920,Mercier; Patrick Philip,9992,0,9999,7
1745806795307,ECON 178,A01,907814,Zhu; Ying,28,0,35,7
1745806796333,EDS 115,A00,895312,Staff,41,0,45,4
1745806797360,EDS 117,A01,895337,Staff,30,0,30,0
1745806798386,EDS 125,A00,895341,Jones; Gabrielle Anastasia,43,0,45,2
1745806799414,EDS 128A,A01,895459,Fargason; Sharon Gayle,44,0,45,1
1745806800443,EDS 128B,A01,895543,Pappas; Elizabeth,44,0,45,1
1745806801473,EDS 139,A00,897203,Pappas; Elizabeth,44,0,45,1
1745806801473,EDS 139,B00,897209,Fargason; Sharon Gayle,44,0,45,1
1745806802499,EDS 201,A00,895545,Staff,43,0,45,2
1745806803528,EDS 203,A01,895581,Halter; Christopher P.,43,0,45,2
1745806804552,EDS 204R,A01,895625,Heinzman; Erica M.,43,0,45,2
1745806804552,EDS 204R,B01,895693,Halter; Christopher P.,18,0,45,27
1745806805578,EDS 206R,A00,895694,Fargason; Sharon Gayle,9,0,30,21
1745806805578,EDS 206R,B00,895695,Choi; Bailey Miyeon,20,0,30,10
1745806806605,EDS 250,A00,895697,Hemans; Patricia Ann Benitez,43,0,45,2
1745806807630,EDS 281,A00,895701,Meyerott; Theresa Ann,15,0,15,0
1745806808656,EDS 284,A00,895736,Meyerott; Theresa Ann,15,0,15,0
1745806809682,EDS 286,A00,897210,Fine; Sarah,15,0,15,0
1745806810709,EDS 289C,A01,895770,Daly; Alan J.,15,0,15,0
1745806811733,EDS 290,A00,897211,Hofstetter; Carolyn,15,0,15,0
1745806812759,LIGM 5A,A00,896162,Fischer-Grunski; Eva K,15,0,20,5
1745806813785,LIGM 5B,A00,896260,Fischer-Grunski; Eva K,17,0,20,3
1745806814812,LIGM 5C,A00,896308,Fischer-Grunski; Eva K,18,0,20,2
1745806815842,LIIT 5AS,A00,896313,Carnelos; Chiara,18,0,20,2
1745806816868,LIIT 5BS,A00,896416,Carnelos; Chiara,20,0,20,0
1745806817893,LIIT 5CS,A00,896564,Carnelos; Chiara,20,0,20,0
1745806818922,LISP 5A,A00,896588,Munoz Sanchez; Alicia,4,0,20,16
1745806819951,LISP 5B,A00,896653,Munoz Sanchez; Alicia,10,0,20,10
1745806820976,LISP 5C,A00,896655,Munoz Sanchez; Alicia,4,0,20,16
1745806822005,MAE 197,001,957918,Kleissl; Jan,9998,0,9999,1
1745806823032,MATH 2,A01,957937,Staff,34,0,35,1
1745806824058,MATH 197,001,957876,Kedlaya; Kiran S.,9993,0,9999,6
1745806825087,MCWP 40,A00,892729,Duru; Nur,13,0,20,7
1745806825087,MCWP 40,B00,893304,Montejo; Carolina,20,0,20,0
1745806826111,MCWP 40R,A00,893757,Redela; Pamela Morgan,0,7,20,20
1745806827137,MCWP 50,A00,893758,Morshed; Michael James,2,0,20,18
1745806827137,MCWP 50,B00,893761,Bartulis; Jason Michael,17,0,20,3
1745806828165,MCWP 50R,A00,893766,Compas; Sean Matthew,0,1,20,20
1745806828165,MCWP 50R,B00,893769,Carter; Jennifer A,0,0,20,20
1745806828165,MCWP 50R,C00,893771,Krone; Jarret,0,3,20,20
1745806828165,MCWP 50R,D00,893772,Miller; Elizabeth Deen,3,0,20,17
1745806828165,MCWP 50R,E00,893775,Carter; Andrea L,0,0,20,20
1745806829191,MMW 11R,A01,892721,Herbst; Matthew,11,0,27,16
1745806829191,MMW 11R,A02,892722,Herbst; Matthew,0,0,0,3
1745806830220,MMW 12R,A01,892724,Herbst; Matthew,0,9,16,16
1745806830220,MMW 12R,A02,892725,Herbst; Matthew,0,9,16,16
1745806831245,MMW 13R,A01,892727,Staff,0,4,16,16
1745806831245,MMW 13R,A02,892728,Staff,0,4,16,16
1745806831245,MMW 13R,A03,958032,Staff,0,3,16,16
1745806831245,MMW 13R,A04,958033,Staff,0,2,16,16
1745806831245,MMW 13R,A05,958034,Staff,0,3,16,16
1745806832274,SIO 295LS,A00,894015,Staff,7,0,25,18
1745806833302,SIO 295S,A00,894020,Staff,7,0,25,18
1745806834327,SIOC 290S,B01,958918,Staff,0,0,0,0
1745806835354,SIOC 291S,B01,958922,Staff,0,0,0,0
1745806836380,SOCI 117,A01,895339,Staff,4,0,5,1
1745806837414,WES 237B,A00,894149,Staff,11,0,20,9
1745806839473,AESE 279B,A00,891859,Staff,13,0,35,22
1745806840499,AIP 197,001,891854,Staff,70,0,70,0
1745806841524,ANTH 289S,A00,891856,Gagneux; Pascal,12,0,12,0
1745806842550,BENG 196,001,957946,Engler; Adam J.,9996,0,9999,3
1745806843575,CAT 124RS,A01,956906,Staff,8,0,25,17
1745806844601,CAT 125RS,A01,922013,Staff,8,0,25,17
1745806845626,CLRE 250,A00,891860,Morris; Sheldon,9995,0,9999,4
1745806847681,CLRE 251R,A00,907817,Mehta; Ravindra L.,9994,0,9999,5
1745806848709,CLRE 252,A00,891864,Cuomo; Raphael Eduardo,9993,0,9999,6
1745806849734,CLRE 253,A00,891867,Vaida; Florin,9994,0,9999,5
1745806849734,CLRE 253,B00,907819,Staff,9999,0,9999,0
1745806850759,CLRE 259,A00,891868,Patel; Hemal,9998,0,9999,1
1745806851788,CLRE 260,A00,891872,Cuomo; Raphael Eduardo,9999,0,9999,0
1745806852815,CLRE 297,001,891888,Cuomo; Raphael Eduardo,9999,0,9999,0
1745806853840,CSE 191,A00,958773,Minnes Kemp; Mor Mia,9999,0,9999,0
1745806854867,CSS 201S,A01,892054,Mignozzetti; Umberto,30,0,30,0
1745806855893,CSS 202S,A01,892056,Mignozzetti; Umberto,30,0,30,0
1745806856918,DSC 197,001,956898,Eldridge; Justin Matthew,9998,0,9999,1
1745806857944,DSC 297,001,958000,Mazumdar; Arya,9998,0,9999,1
1745806858970,EAP 100,A00,905686,Staff,9776,0,9999,223
1745806859996,ECE 45,A01,892618,Staff,0,12,50,50
1745806861024,ECE 109,A01,892620,Staff,0,43,0,0
1745806862048,ECE 111,A01,892719,Staff,0,7,50,50
1745806863074,ECE 197,001,957920,Mercier; Patrick Philip,9992,0,9999,7
1745806864099,ECON 178,A01,907814,Zhu; Ying,28,0,35,7
1745806865125,EDS 115,A00,895312,Staff,41,0,45,4
1745806866153,EDS 117,A01,895337,Staff,30,0,30,0
1745806867182,EDS 125,A00,895341,Jones; Gabrielle Anastasia,43,0,45,2
1745806868210,EDS 128A,A01,895459,Fargason; Sharon Gayle,44,0,45,1
1745806869236,EDS 128B,A01,895543,Pappas; Elizabeth,44,0,45,1
1745806870265,EDS 139,A00,897203,Pappas; Elizabeth,44,0,45,1
1745806870265,EDS 139,B00,897209,Fargason; Sharon Gayle,44,0,45,1
1745806871289,EDS 201,A00,895545,Staff,43,0,45,2
1745806872315,EDS 203,A01,895581,Halter; Christopher P.,43,0,45,2
1745806873340,EDS 204R,A01,895625,Heinzman; Erica M.,43,0,45,2
1745806873340,EDS 204R,B01,895693,Halter; Christopher P.,18,0,45,27
1745806874366,EDS 206R,A00,895694,Fargason; Sharon Gayle,9,0,30,21
1745806874366,EDS 206R,B00,895695,Choi; Bailey Miyeon,20,0,30,10
1745806875391,EDS 250,A00,895697,Hemans; Patricia Ann Benitez,43,0,45,2
1745806876419,EDS 281,A00,895701,Meyerott; Theresa Ann,15,0,15,0
1745806877447,EDS 284,A00,895736,Meyerott; Theresa Ann,15,0,15,0
1745806878475,EDS 286,A00,897210,Fine; Sarah,15,0,15,0
1745806879501,EDS 289C,A01,895770,Daly; Alan J.,15,0,15,0
1745806880531,EDS 290,A00,897211,Hofstetter; Carolyn,15,0,15,0
1745806881556,LIGM 5A,A00,896162,Fischer-Grunski; Eva K,15,0,20,5
1745806882583,LIGM 5B,A00,896260,Fischer-Grunski; Eva K,17,0,20,3
1745806883609,LIGM 5C,A00,896308,Fischer-Grunski; Eva K,18,0,20,2
1745806884634,LIIT 5AS,A00,896313,Carnelos; Chiara,18,0,20,2
1745806885659,LIIT 5BS,A00,896416,Carnelos; Chiara,20,0,20,0
1745806886686,LIIT 5CS,A00,896564,Carnelos; Chiara,20,0,20,0
1745806887712,LISP 5A,A00,896588,Munoz Sanchez; Alicia,4,0,20,16
1745806888740,LISP 5B,A00,896653,Munoz Sanchez; Alicia,10,0,20,10
1745806889764,LISP 5C,A00,896655,Munoz Sanchez; Alicia,4,0,20,16
1745806890789,MAE 197,001,957918,Kleissl; Jan,9998,0,9999,1
1745806891818,MATH 2,A01,957937,Staff,34,0,35,1
1745806892844,MATH 197,001,957876,Kedlaya; Kiran S.,9993,0,9999,6
1745806893870,MCWP 40,A00,892729,Duru; Nur,13,0,20,7
1745806893870,MCWP 40,B00,893304,Montejo; Carolina,20,0,20,0
1745806894895,MCWP 40R,A00,893757,Redela; Pamela Morgan,0,7,20,20
1745806895919,MCWP 50,A00,893758,Morshed; Michael James,2,0,20,18
1745806895919,MCWP 50,B00,893761,Bartulis; Jason Michael,17,0,20,3
1745806896948,MCWP 50R,A00,893766,Compas; Sean Matthew,0,1,20,20
1745806896948,MCWP 50R,B00,893769,Carter; Jennifer A,0,0,20,20
1745806896948,MCWP 50R,C00,893771,Krone; Jarret,0,3,20,20
1745806896948,MCWP 50R,D00,893772,Miller; Elizabeth Deen,3,0,20,17
1745806896948,MCWP 50R,E00,893775,Carter; Andrea L,0,0,20,20
1745806897977,MMW 11R,A01,892721,Herbst; Matthew,11,0,27,16
1745806897977,MMW 11R,A02,892722,Herbst; Matthew,0,0,0,3
1745806899003,MMW 12R,A01,892724,Herbst; Matthew,0,9,16,16
1745806899003,MMW 12R,A02,892725,Herbst; Matthew,0,9,16,16
1745806900029,MMW 13R,A01,892727,Staff,0,4,16,16
1745806900029,MMW 13R,A02,892728,Staff,0,4,16,16
1745806900029,MMW 13R,A03,958032,Staff,0,3,16,16
1745806900029,MMW 13R,A04,958033,Staff,0,2,16,16
1745806900029,MMW 13R,A05,958034,Staff,0,3,16,16
1745806901057,SIO 295LS,A00,894015,Staff,7,0,25,18
1745806902086,SIO 295S,A00,894020,Staff,7,0,25,18
1745806903112,SIOC 290S,B01,958918,Staff,0,0,0,0
1745806904136,SIOC 291S,B01,958922,Staff,0,0,0,0
1745806905162,SOCI 117,A01,895339,Staff,4,0,5,1
1745806906191,WES 237B,A00,894149,Staff,11,0,20,9
1745806908249,AESE 279B,A00,891859,Staff,13,0,35,22
1745806909275,AIP 197,001,891854,Staff,70,0,70,0
1745806910301,ANTH 289S,A00,891856,Gagneux; Pascal,12,0,12,0
1745806911328,BENG 196,001,957946,Engler; Adam J.,9996,0,9999,3
1745806912354,CAT 124RS,A01,956906,Staff,8,0,25,17
1745806913380,CAT 125RS,A01,922013,Staff,8,0,25,17
1745806914406,CLRE 250,A00,891860,Morris; Sheldon,9995,0,9999,4
1745806916457,CLRE 251R,A00,907817,Mehta; Ravindra L.,9994,0,9999,5
1745806917482,CLRE 252,A00,891864,Cuomo; Raphael Eduardo,9993,0,9999,6
1745806918508,CLRE 253,A00,891867,Vaida; Florin,9994,0,9999,5
1745806918508,CLRE 253,B00,907819,Staff,9999,0,9999,0
1745806919534,CLRE 259,A00,891868,Patel; Hemal,9998,0,9999,1
1745806920562,CLRE 260,A00,891872,Cuomo; Raphael Eduardo,9999,0,9999,0
1745806921590,CLRE 297,001,891888,Cuomo; Raphael Eduardo,9999,0,9999,0
1745806922616,CSE 191,A00,958773,Minnes Kemp; Mor Mia,9999,0,9999,0
1745806923641,CSS 201S,A01,892054,Mignozzetti; Umberto,30,0,30,0
1745806924667,CSS 202S,A01,892056,Mignozzetti; Umberto,30,0,30,0
1745806925696,DSC 197,001,956898,Eldridge; Justin Matthew,9998,0,9999,1
1745806926722,DSC 297,001,958000,Mazumdar; Arya,9998,0,9999,1
1745806927749,EAP 100,A00,905686,Staff,9776,0,9999,223
1745806928775,ECE 45,A01,892618,Staff,0,12,50,50
1745806929804,ECE 109,A01,892620,Staff,0,43,0,0
1745806930828,ECE 111,A01,892719,Staff,0,7,50,50
1745806931855,ECE 197,001,957920,Mercier; Patrick Philip,9992,0,9999,7
1745806932884,ECON 178,A01,907814,Zhu; Ying,28,0,35,7
1745806933913,EDS 115,A00,895312,Staff,41,0,45,4
1745806934943,EDS 117,A01,895337,Staff,30,0,30,0
1745806935968,EDS 125,A00,895341,Jones; Gabrielle Anastasia,43,0,45,2
1745806936994,EDS 128A,A01,895459,Fargason; Sharon Gayle,44,0,45,1
1745806938018,EDS 128B,A01,895543,Pappas; Elizabeth,44,0,45,1
1745806939045,EDS 139,A00,897203,Pappas; Elizabeth,44,0,45,1
1745806939045,EDS 139,B00,897209,Fargason; Sharon Gayle,44,0,45,1
1745806940070,EDS 201,A00,895545,Staff,43,0,45,2
1745806941094,EDS 203,A01,895581,Halter; Christopher P.,43,0,45,2
1745806942122,EDS 204R,A01,895625,Heinzman; Erica M.,43,0,45,2
1745806942122,EDS 204R,B01,895693,Halter; Christopher P.,18,0,45,27
1745806943147,EDS 206R,A00,895694,Fargason; Sharon Gayle,9,0,30,21
1745806943147,EDS 206R,B00,895695,Choi; Bailey Miyeon,20,0,30,10
1745806944172,EDS 250,A00,895697,Hemans; Patricia Ann Benitez,43,0,45,2
1745806945199,EDS 281,A00,895701,Meyerott; Theresa Ann,15,0,15,0
1745806946227,EDS 284,A00,895736,Meyerott; Theresa Ann,15,0,15,0
1745806947253,EDS 286,A00,897210,Fine; Sarah,15,0,15,0
1745806948283,EDS 289C,A01,895770,Daly; Alan J.,15,0,15,0
1745806949308,EDS 290,A00,897211,Hofstetter; Carolyn,15,0,15,0
1745806950338,LIGM 5A,A00,896162,Fischer-Grunski; Eva K,15,0,20,5
1745806951363,LIGM 5B,A00,896260,Fischer-Grunski; Eva K,17,0,20,3
1745806952403,LIGM 5C,A00,896308,Fischer-Grunski; Eva K,18,0,20,2
1745806953429,LIIT 5AS,A00,896313,Carnelos; Chiara,18,0,20,2
1745806954454,LIIT 5BS,A00,896416,Carnelos; Chiara,20,0,20,0
1745806955483,LIIT 5CS,A00,896564,Carnelos; Chiara,20,0,20,0
1745806956508,LISP 5A,A00,896588,Munoz Sanchez; Alicia,4,0,20,16
1745806957535,LISP 5B,A00,896653,Munoz Sanchez; Alicia,10,0,20,10
1745806958564,LISP 5C,A00,896655,Munoz Sanchez; Alicia,4,0,20,16
1745806959587,MAE 197,001,957918,Kleissl; Jan,9998,0,9999,1
1745806960616,MATH 2,A01,957937,Staff,34,0,35,1
1745806961643,MATH 197,001,957876,Kedlaya; Kiran S.,9993,0,9999,6
1745806962667,MCWP 40,A00,892729,Duru; Nur,13,0,20,7
1745806962667,MCWP 40,B00,893304,Montejo; Carolina,20,0,20,0
1745806963693,MCWP 40R,A00,893757,Redela; Pamela Morgan,0,7,20,20
1745806964719,MCWP 50,A00,893758,Morshed; Michael James,2,0,20,18
1745806964719,MCWP 50,B00,893761,Bartulis; Jason Michael,17,0,20,3
1745806965748,MCWP 50R,A00,893766,Compas; Sean Matthew,0,1,20,20
1745806965748,MCWP 50R,B00,893769,Carter; Jennifer A,0,0,20,20
1745806965748,MCWP 50R,C00,893771,Krone; Jarret,0,3,20,20
1745806965748,MCWP 50R,D00,893772,Miller; Elizabeth Deen,3,0,20,17
1745806965748,MCWP 50R,E00,893775,Carter; Andrea L,0,0,20,20
1745806966776,MMW 11R,A01,892721,Herbst; Matthew,11,0,27,16
1745806966776,MMW 11R,A02,892722,Herbst; Matthew,0,0,0,3
1745806967802,MMW 12R,A01,892724,Herbst; Matthew,0,9,16,16
1745806967802,MMW 12R,A02,892725,Herbst; Matthew,0,9,16,16
1745806968828,MMW 13R,A01,892727,Staff,0,4,16,16
1745806968828,MMW 13R,A02,892728,Staff,0,4,16,16
1745806968828,MMW 13R,A03,958032,Staff,0,3,16,16
1745806968828,MMW 13R,A04,958033,Staff,0,2,16,16
1745806968828,MMW 13R,A05,958034,Staff,0,3,16,16
1745806969856,SIO 295LS,A00,894015,Staff,7,0,25,18
1745806970883,SIO 295S,A00,894020,Staff,7,0,25,18
1745806971913,SIOC 290S,B01,958918,Staff,0,0,0,0
1745806972944,SIOC 291S,B01,958922,Staff,0,0,0,0
1745806973971,SOCI 117,A01,895339,Staff,4,0,5,1
1745806974998,WES 237B,A00,894149,Staff,11,0,20,9
1745806977063,AESE 279B,A00,891859,Staff,13,0,35,22
1745806978089,AIP 197,001,891854,Staff,70,0,70,0
1745806979119,ANTH 289S,A00,891856,Gagneux; Pascal,12,0,12,0
1745806980147,BENG 196,001,957946,Engler; Adam J.,9996,0,9999,3
1745806981173,CAT 124RS,A01,956906,Staff,8,0,25,17
1745806982201,CAT 125RS,A01,922013,Staff,8,0,25,17
1745806983228,CLRE 250,A00,891860,Morris; Sheldon,9995,0,9999,4
1745806985286,CLRE 251R,A00,907817,Mehta; Ravindra L.,9994,0,9999,5
1745806986314,CLRE 252,A00,891864,Cuomo; Raphael Eduardo,9993,0,9999,6
1745806987341,CLRE 253,A00,891867,Vaida; Florin,9994,0,9999,5
1745806987341,CLRE 253,B00,907819,Staff,9999,0,9999,0
1745806988371,CLRE 259,A00,891868,Patel; Hemal,9998,0,9999,1
1745806989396,CLRE 260,A00,891872,Cuomo; Raphael Eduardo,9999,0,9999,0
1745806990426,CLRE 297,001,891888,Cuomo; Raphael Eduardo,9999,0,9999,0
1745806991454,CSE 191,A00,958773,Minnes Kemp; Mor Mia,9999,0,9999,0
1745806992481,CSS 201S,A01,892054,Mignozzetti; Umberto,30,0,30,0
1745806993506,CSS 202S,A01,892056,Mignozzetti; Umberto,30,0,30,0
1745806994537,DSC 197,001,956898,Eldridge; Justin Matthew,9998,0,9999,1
1745806995560,DSC 297,001,958000,Mazumdar; Arya,9998,0,9999,1
1745806996584,EAP 100,A00,905686,Staff,9776,0,9999,223
1745806997610,ECE 45,A01,892618,Staff,0,12,50,50
1745806998637,ECE 109,A01,892620,Staff,0,43,0,0
1745806999661,ECE 111,A01,892719,Staff,0,7,50,50
1745807000686,ECE 197,001,957920,Mercier; Patrick Philip,9992,0,9999,7
1745807001715,ECON 178,A01,907814,Zhu; Ying,28,0,35,7
1745807002739,EDS 115,A00,895312,Staff,41,0,45,4
1745807003766,EDS 117,A01,895337,Staff,30,0,30,0
1745807004793,EDS 125,A00,895341,Jones; Gabrielle Anastasia,43,0,45,2
1745807005819,EDS 128A,A01,895459,Fargason; Sharon Gayle,44,0,45,1
1745807006848,EDS 128B,A01,895543,Pappas; Elizabeth,44,0,45,1
1745807007878,EDS 139,A00,897203,Pappas; Elizabeth,44,0,45,1
1745807007878,EDS 139,B00,897209,Fargason; Sharon Gayle,44,0,45,1
1745807008904,EDS 201,A00,895545,Staff,43,0,45,2
1745807009932,EDS 203,A01,895581,Halter; Christopher P.,43,0,45,2
1745807010961,EDS 204R,A01,895625,Heinzman; Erica M.,43,0,45,2
1745807010961,EDS 204R,B01,895693,Halter; Christopher P.,18,0,45,27
1745807011988,EDS 206R,A00,895694,Fargason; Sharon Gayle,9,0,30,21
1745807011988,EDS 206R,B00,895695,Choi; Bailey Miyeon,20,0,30,10
1745807013013,EDS 250,A00,895697,Hemans; Patricia Ann Benitez,43,0,45,2
1745807014038,EDS 281,A00,895701,Meyerott; Theresa Ann,15,0,15,0
1745807015067,EDS 284,A00,895736,Meyerott; Theresa Ann,15,0,15,0
1745807016094,EDS 286,A00,897210,Fine; Sarah,15,0,15,0
1745807017119,EDS 289C,A01,895770,Daly; Alan J.,15,0,15,0
1745807018145,EDS 290,A00,897211,Hofstetter; Carolyn,15,0,15,0
1745807019173,LIGM 5A,A00,896162,Fischer-Grunski; Eva K,15,0,20,5
1745807020204,LIGM 5B,A00,896260,Fischer-Grunski; Eva K,17,0,20,3
1745807021229,LIGM 5C,A00,896308,Fischer-Grunski; Eva K,18,0,20,2
1745807022260,LIIT 5AS,A00,896313,Carnelos; Chiara,18,0,20,2
1745807023286,LIIT 5BS,A00,896416,Carnelos; Chiara,20,0,20,0
1745807024311,LIIT 5CS,A00,896564,Carnelos; Chiara,20,0,20,0
1745807025338,LISP 5A,A00,896588,Munoz Sanchez; Alicia,4,0,20,16
1745807026362,LISP 5B,A00,896653,Munoz Sanchez; Alicia,10,0,20,10
1745807027388,LISP 5C,A00,896655,Munoz Sanchez; Alicia,4,0,20,16
1745807028416,MAE 197,001,957918,Kleissl; Jan,9998,0,9999,1
1745807029444,MATH 2,A01,957937,Staff,34,0,35,1
1745807030549,MATH 197,001,957876,Kedlaya; Kiran S.,9993,0,9999,6
1745807031574,MCWP 40,A00,892729,Duru; Nur,13,0,20,7
1745807031574,MCWP 40,B00,893304,Montejo; Carolina,20,0,20,0
1745807032601,MCWP 40R,A00,893757,Redela; Pamela Morgan,0,7,20,20
1745807033630,MCWP 50,A00,893758,Morshed; Michael James,2,0,20,18
1745807033630,MCWP 50,B00,893761,Bartulis; Jason Michael,17,0,20,3
1745807034656,MCWP 50R,A00,893766,Compas; Sean Matthew,0,1,20,20
1745807034656,MCWP 50R,B00,893769,Carter; Jennifer A,0,0,20,20
1745807034656,MCWP 50R,C00,893771,Krone; Jarret,0,3,20,20
1745807034656,MCWP 50R,D00,893772,Miller; Elizabeth Deen,3,0,20,17
1745807034656,MCWP 50R,E00,893775,Carter; Andrea L,0,0,20,20
1745807035681,MMW 11R,A01,892721,Herbst; Matthew,11,0,27,16
1745807035681,MMW 11R,A02,892722,Herbst; Matthew,0,0,0,3
1745807036707,MMW 12R,A01,892724,Herbst; Matthew,0,9,16,16
1745807036707,MMW 12R,A02,892725,Herbst; Matthew,0,9,16,16
1745807037733,MMW 13R,A01,892727,Staff,0,4,16,16
1745807037733,MMW 13R,A02,892728,Staff,0,4,16,16
1745807037733,MMW 13R,A03,958032,Staff,0,3,16,16
1745807037733,MMW 13R,A04,958033,Staff,0,2,16,16
1745807037733,MMW 13R,A05,958034,Staff,0,3,16,16
1745807038758,SIO 295LS,A00,894015,Staff,7,0,25,18
1745807039788,SIO 295S,A00,894020,Staff,7,0,25,18
1745807040816,SIOC 290S,B01,958918,Staff,0,0,0,0
1745807041846,SIOC 291S,B01,958922,Staff,0,0,0,0
1745807042871,SOCI 117,A01,895339,Staff,4,0,5,1
1745807043896,WES 237B,A00,894149,Staff,11,0,20,9
1745807045953,AESE 279B,A00,891859,Staff,13,0,35,22
1745807046980,AIP 197,001,891854,Staff,70,0,70,0
1745807048005,ANTH 289S,A00,891856,Gagneux; Pascal,12,0,12,0
1745807049031,BENG 196,001,957946,Engler; Adam J.,9996,0,9999,3
1745807050057,CAT 124RS,A01,956906,Staff,8,0,25,17
1745807051084,CAT 125RS,A01,922013,Staff,8,0,25,17
1745807052110,CLRE 250,A00,891860,Morris; Sheldon,9995,0,9999,4
1745807054164,CLRE 251R,A00,907817,Mehta; Ravindra L.,9994,0,9999,5
1745807055222,CLRE 252,A00,891864,Cuomo; Raphael Eduardo,9993,0,9999,6
1745807056251,CLRE 253,A00,891867,Vaida; Florin,9994,0,9999,5
1745807056251,CLRE 253,B00,907819,Staff,9999,0,9999,0
1745807057277,CLRE 259,A00,891868,Patel; Hemal,9998,0,9999,1
1745807058302,CLRE 260,A00,891872,Cuomo; Raphael Eduardo,9999,0,9999,0
1745807059331,CLRE 297,001,891888,Cuomo; Raphael Eduardo,9999,0,9999,0
1745807060358,CSE 191,A00,958773,Minnes Kemp; Mor Mia,9999,0,9999,0
1745807061384,CSS 201S,A01,892054,Mignozzetti; Umberto,30,0,30,0
1745807062414,CSS 202S,A01,892056,Mignozzetti; Umberto,30,0,30,0
1745807063440,DSC 197,001,956898,Eldridge; Justin Matthew,9998,0,9999,1
1745807064467,DSC 297,001,958000,Mazumdar; Arya,9998,0,9999,1
1745807065494,EAP 100,A00,905686,Staff,9776,0,9999,223
1745807066521,ECE 45,A01,892618,Staff,0,12,50,50
1745807067550,ECE 109,A01,892620,Staff,0,43,0,0
1745807068577,ECE 111,A01,892719,Staff,0,7,50,50
1745807069603,ECE 197,001,957920,Mercier; Patrick Philip,9992,0,9999,7
1745807070630,ECON 178,A01,907814,Zhu; Ying,28,0,35,7
1745807071656,EDS 115,A00,895312,Staff,41,0,45,4
1745807072682,EDS 117,A01,895337,Staff,30,0,30,0
1745807073707,EDS 125,A00,895341,Jones; Gabrielle Anastasia,43,0,45,2
1745807074737,EDS 128A,A01,895459,Fargason; Sharon Gayle,44,0,45,1
1745807075762,EDS 128B,A01,895543,Pappas; Elizabeth,44,0,45,1
1745807076788,EDS 139,A00,897203,Pappas; Elizabeth,44,0,45,1
1745807076788,EDS 139,B00,897209,Fargason; Sharon Gayle,44,0,45,1
1745807077813,EDS 201,A00,895545,Staff,43,0,45,2
1745807078841,EDS 203,A01,895581,Halter; Christopher P.,43,0,45,2
1745807079869,EDS 204R,A01,895625,Heinzman; Erica M.,43,0,45,2
1745807079869,EDS 204R,B01,895693,Halter; Christopher P.,18,0,45,27
1745807080896,EDS 206R,A00,895694,Fargason; Sharon Gayle,9,0,30,21
1745807080896,EDS 206R,B00,895695,Choi; Bailey Miyeon,20,0,30,10
1745807081921,EDS 250,A00,895697,Hemans; Patricia Ann Benitez,43,0,45,2
1745807082949,EDS 281,A00,895701,Meyerott; Theresa Ann,15,0,15,0
1745807083976,EDS 284,A00,895736,Meyerott; Theresa Ann,15,0,15,0
1745807085002,EDS 286,A00,897210,Fine; Sarah,15,0,15,0
1745807086027,EDS 289C,A01,895770,Daly; Alan J.,15,0,15,0
1745807087055,EDS 290,A00,897211,Hofstetter; Carolyn,15,0,15,0
1745807088082,LIGM 5A,A00,896162,Fischer-Grunski; Eva K,15,0,20,5
1745807089111,LIGM 5B,A00,896260,Fischer-Grunski; Eva K,17,0,20,3
1745807090135,LIGM 5C,A00,896308,Fischer-Grunski; Eva K,18,0,20,2
1745807091161,LIIT 5AS,A00,896313,Carnelos; Chiara,18,0,20,2
1745807092188,LIIT 5BS,A00,896416,Carnelos; Chiara,20,0,20,0
1745807093213,LIIT 5CS,A00,896564,Carnelos; Chiara,20,0,20,0
1745807094242,LISP 5A,A00,896588,Munoz Sanchez; Alicia,4,0,20,16
1745807095272,LISP 5B,A00,896653,Munoz Sanchez; Alicia,10,0,20,10
1745807096302,LISP 5C,A00,896655,Munoz Sanchez; Alicia,4,0,20,16
1745807097330,MAE 197,001,957918,Kleissl; Jan,9998,0,9999,1
1745807098357,MATH 2,A01,957937,Staff,34,0,35,1
1745807099383,MATH 197,001,957876,Kedlaya; Kiran S.,9993,0,9999,6
1745807100408,MCWP 40,A00,892729,Duru; Nur,13,0,20,7
1745807100408,MCWP 40,B00,893304,Montejo; Carolina,20,0,20,0
1745807101437,MCWP 40R,A00,893757,Redela; Pamela Morgan,0,7,20,20
1745807102465,MCWP 50,A00,893758,Morshed; Michael James,2,0,20,18
1745807102465,MCWP 50,B00,893761,Bartulis; Jason Michael,17,0,20,3
1745807103490,MCWP 50R,A00,893766,Compas; Sean Matthew,0,1,20,20
1745807103490,MCWP 50R,B00,893769,Carter; Jennifer A,0,0,20,20
1745807103490,MCWP 50R,C00,893771,Krone; Jarret,0,3,20,20
1745807103490,MCWP 50R,D00,893772,Miller; Elizabeth Deen,3,0,20,17
1745807103490,MCWP 50R,E00,893775,Carter; Andrea L,0,0,20,20
1745807104515,MMW 11R,A01,892721,Herbst; Matthew,11,0,27,16
1745807104515,MMW 11R,A02,892722,Herbst; Matthew,0,0,0,3
1745807105543,MMW 12R,A01,892724,Herbst; Matthew,0,9,16,16
1745807105543,MMW 12R,A02,892725,Herbst; Matthew,0,9,16,16
1745807106569,MMW 13R,A01,892727,Staff,0,4,16,16
1745807106569,MMW 13R,A02,892728,Staff,0,4,16,16
1745807106569,MMW 13R,A03,958032,Staff,0,3,16,16
1745807106569,MMW 13R,A04,958033,Staff,0,2,16,16
1745807106569,MMW 13R,A05,958034,Staff,0,3,16,16
1745807107595,SIO 295LS,A00,894015,Staff,7,0,25,18
1745807108623,SIO 295S,A00,894020,Staff,7,0,25,18
1745807109653,SIOC 290S,B01,958918,Staff,0,0,0,0
1745807110677,SIOC 291S,B01,958922,Staff,0,0,0,0
1745807111703,SOCI 117,A01,895339,Staff,4,0,5,1
1745807112730,WES 237B,A00,894149,Staff,11,0,20,9
1745807114800,AESE 279B,A00,891859,Staff,13,0,35,22
1745807115829,AIP 197,001,891854,Staff,70,0,70,0
1745807116856,ANTH 289S,A00,891856,Gagneux; Pascal,12,0,12,0
1745807117882,BENG 196,001,957946,Engler; Adam J.,9996,0,9999,3
1745807118909,CAT 124RS,A01,956906,Staff,8,0,25,17
1745807119937,CAT 125RS,A01,922013,Staff,8,0,25,17
1745807120963,CLRE 250,A00,891860,Morris; Sheldon,9995,0,9999,4
1745807123014,CLRE 251R,A00,907817,Mehta; Ravindra L.,9994,0,9999,5
1745807124040,CLRE 252,A00,891864,Cuomo; Raphael Eduardo,9993,0,9999,6
1745807125066,CLRE 253,A00,891867,Vaida; Florin,9994,0,9999,5
1745807125066,CLRE 253,B00,907819,Staff,9999,0,9999,0
1745807126095,CLRE 259,A00,891868,Patel; Hemal,9998,0,9999,1
1745807127122,CLRE 260,A00,891872,Cuomo; Raphael Eduardo,9999,0,9999,0
1745807128154,CLRE 297,001,891888,Cuomo; Raphael Eduardo,9999,0,9999,0
1745807129180,CSE 191,A00,958773,Minnes Kemp; Mor Mia,9999,0,9999,0
1745807130205,CSS 201S,A01,892054,Mignozzetti; Umberto,30,0,30,0
1745807131231,CSS 202S,A01,892056,Mignozzetti; Umberto,30,0,30,0
1745807132254,DSC 197,001,956898,Eldridge; Justin Matthew,9998,0,9999,1
1745807133279,DSC 297,001,958000,Mazumdar; Arya,9998,0,9999,1
1745807134307,EAP 100,A00,905686,Staff,9776,0,9999,223
1745807135332,ECE 45,A01,892618,Staff,0,12,50,50
1745807136358,ECE 109,A01,892620,Staff,0,43,0,0
1745807137383,ECE 111,A01,892719,Staff,0,7,50,50
1745807138411,ECE 197,001,957920,Mercier; Patrick Philip,9992,0,9999,7
1745807139436,ECON 178,A01,907814,Zhu; Ying,28,0,35,7
1745807140461,EDS 115,A00,895312,Staff,41,0,45,4
1745807141490,EDS 117,A01,895337,Staff,30,0,30,0
1745807142518,EDS 125,A00,895341,Jones; Gabrielle Anastasia,43,0,45,2
1745807143547,EDS 128A,A01,895459,Fargason; Sharon Gayle,44,0,45,1
1745807144573,EDS 128B,A01,895543,Pappas; Elizabeth,44,0,45,1
1745807145599,EDS 139,A00,897203,Pappas; Elizabeth,44,0,45,1
1745807145599,EDS 139,B00,897209,Fargason; Sharon Gayle,44,0,45,1
1745807146625,EDS 201,A00,895545,Staff,43,0,45,2
1745807147652,EDS 203,A01,895581,Halter; Christopher P.,43,0,45,2
1745807148676,EDS 204R,A01,895625,Heinzman; Erica M.,43,0,45,2
1745807148676,EDS 204R,B01,895693,Halter; Christopher P.,18,0,45,27
1745807149705,EDS 206R,A00,895694,Fargason; Sharon Gayle,9,0,30,21
1745807149705,EDS 206R,B00,895695,Choi; Bailey Miyeon,20,0,30,10
1745807150734,EDS 250,A00,895697,Hemans; Patricia Ann Benitez,43,0,45,2
1745807151760,EDS 281,A00,895701,Meyerott; Theresa Ann,15,0,15,0
1745807152785,EDS 284,A00,895736,Meyerott; Theresa Ann,15,0,15,0
1745807153813,EDS 286,A00,897210,Fine; Sarah,15,0,15,0
1745807154839,EDS 289C,A01,895770,Daly; Alan J.,15,0,15,0
1745807155865,EDS 290,A00,897211,Hofstetter; Carolyn,15,0,15,0
1745807156895,LIGM 5A,A00,896162,Fischer-Grunski; Eva K,15,0,20,5
1745807157924,LIGM 5B,A00,896260,Fischer-Grunski; Eva K,17,0,20,3
1745807158952,LIGM 5C,A00,896308,Fischer-Grunski; Eva K,18,0,20,2
1745807159981,LIIT 5AS,A00,896313,Carnelos; Chiara,18,0,20,2
1745807161009,LIIT 5BS,A00,896416,Carnelos; Chiara,20,0,20,0
1745807162039,LIIT 5CS,A00,896564,Carnelos; Chiara,20,0,20,0
1745807163069,LISP 5A,A00,896588,Munoz Sanchez; Alicia,4,0,20,16
1745807164095,LISP 5B,A00,896653,Munoz Sanchez; Alicia,10,0,20,10
1745807165124,LISP 5C,A00,896655,Munoz Sanchez; Alicia,4,0,20,16
1745807166150,MAE 197,001,957918,Kleissl; Jan,9998,0,9999,1
1745807167178,MATH 2,A01,957937,Staff,34,0,35,1
1745807168206,MATH 197,001,957876,Kedlaya; Kiran S.,9993,0,9999,6
1745807169231,MCWP 40,A00,892729,Duru; Nur,13,0,20,7
1745807169231,MCWP 40,B00,893304,Montejo; Carolina,20,0,20,0
1745807170259,MCWP 40R,A00,893757,Redela; Pamela Morgan,0,7,20,20
1745807171288,MCWP 50,A00,893758,Morshed; Michael James,2,0,20,18
1745807171288,MCWP 50,B00,893761,Bartulis; Jason Michael,17,0,20,3
1745807172315,MCWP 50R,A00,893766,Compas; Sean Matthew,0,1,20,20
1745807172315,MCWP 50R,B00,893769,Carter; Jennifer A,0,0,20,20
1745807172315,MCWP 50R,C00,893771,Krone; Jarret,0,3,20,20
1745807172315,MCWP 50R,D00,893772,Miller; Elizabeth Deen,3,0,20,17
1745807172315,MCWP 50R,E00,893775,Carter; Andrea L,0,0,20,20
1745807173341,MMW 11R,A01,892721,Herbst; Matthew,11,0,27,16
1745807173341,MMW 11R,A02,892722,Herbst; Matthew,0,0,0,3
1745807174371,MMW 12R,A01,892724,Herbst; Matthew,0,9,16,16
1745807174371,MMW 12R,A02,892725,Herbst; Matthew,0,9,16,16
1745807175396,MMW 13R,A01,892727,Staff,0,4,16,16
1745807175396,MMW 13R,A02,892728,Staff,0,4,16,16
1745807175396,MMW 13R,A03,958032,Staff,0,3,16,16
1745807175396,MMW 13R,A04,958033,Staff,0,2,16,16
1745807175396,MMW 13R,A05,958034,Staff,0,3,16,16
1745807176422,SIO 295LS,A00,894015,Staff,7,0,25,18
1745807177450,SIO 295S,A00,894020,Staff,7,0,25,18
1745807178479,SIOC 290S,B01,958918,Staff,0,0,0,0
1745807179505,SIOC 291S,B01,958922,Staff,0,0,0,0
1745807180531,SOCI 117,A01,895339,Staff,4,0,5,1
1745807181557,WES 237B,A00,894149,Staff,11,0,20,9
1745807183614,AESE 279B,A00,891859,Staff,13,0,35,22
1745807184640,AIP 197,001,891854,Staff,70,0,70,0
1745807185664,ANTH 289S,A00,891856,Gagneux; Pascal,12,0,12,0
1745807186692,BENG 196,001,957946,Engler; Adam J.,9996,0,9999,3
1745807187719,CAT 124RS,A01,956906,Staff,8,0,25,17
1745807188745,CAT 125RS,A01,922013,Staff,8,0,25,17
1745807189772,CLRE 250,A00,891860,Morris; Sheldon,9995,0,9999,4
1745807191822,CLRE 251R,A00,907817,Mehta; Ravindra L.,9994,0,9999,5
1745807192852,CLRE 252,A00,891864,Cuomo; Raphael Eduardo,9993,0,9999,6
1745807193877,CLRE 253,A00,891867,Vaida; Florin,9994,0,9999,5
1745807193877,CLRE 253,B00,907819,Staff,9999,0,9999,0
1745807194904,CLRE 259,A00,891868,Patel; Hemal,9998,0,9999,1
1745807195930,CLRE 260,A00,891872,Cuomo; Raphael Eduardo,9999,0,9999,0
1745807196956,CLRE 297,001,891888,Cuomo; Raphael Eduardo,9999,0,9999,0
1745807197984,CSE 191,A00,958773,Minnes Kemp; Mor Mia,9999,0,9999,0
1745807199013,CSS 201S,A01,892054,Mignozzetti; Umberto,30,0,30,0
1745807200043,CSS 202S,A01,892056,Mignozzetti; Umberto,30,0,30,0
1745807201070,DSC 197,001,956898,Eldridge; Justin Matthew,9998,0,9999,1
1745807202096,DSC 297,001,958000,Mazumdar; Arya,9998,0,9999,1
1745807203122,EAP 100,A00,905686,Staff,9776,0,9999,223
1745807204147,ECE 45,A01,892618,Staff,0,12,50,50
1745807205171,ECE 109,A01,892620,Staff,0,43,0,0
1745807206195,ECE 111,A01,892719,Staff,0,7,50,50
1745807207221,ECE 197,001,957920,Mercier; Patrick Philip,9992,0,9999,7
1745807208245,ECON 178,A01,907814,Zhu; Ying,28,0,35,7
1745807209272,EDS 115,A00,895312,Staff,41,0,45,4
1745807210300,EDS 117,A01,895337,Staff,30,0,30,0
1745807211326,EDS 125,A00,895341,Jones; Gabrielle Anastasia,43,0,45,2
1745807212354,EDS 128A,A01,895459,Fargason; Sharon Gayle,44,0,45,1
1745807213381,EDS 128B,A01,895543,Pappas; Elizabeth,44,0,45,1
1745807214407,EDS 139,A00,897203,Pappas; Elizabeth,44,0,45,1
1745807214407,EDS 139,B00,897209,Fargason; Sharon Gayle,44,0,45,1
1745807215432,EDS 201,A00,895545,Staff,43,0,45,2
1745807216458,EDS 203,A01,895581,Halter; Christopher P.,43,0,45,2
1745807217486,EDS 204R,A01,895625,Heinzman; Erica M.,43,0,45,2
1745807217486,EDS 204R,B01,895693,Halter; Christopher P.,18,0,45,27
1745807218515,EDS 206R,A00,895694,Fargason; Sharon Gayle,9,0,30,21
1745807218515,EDS 206R,B00,895695,Choi; Bailey Miyeon,20,0,30,10
1745807219539,EDS 250,A00,895697,Hemans; Patricia Ann Benitez,43,0,45,2
1745807220565,EDS 281,A00,895701,Meyerott; Theresa Ann,15,0,15,0
1745807221589,EDS 284,A00,895736,Meyerott; Theresa Ann,15,0,15,0
1745807222615,EDS 286,A00,897210,Fine; Sarah,15,0,15,0
1745807223643,EDS 289C,A01,895770,Daly; Alan J.,15,0,15,0
1745807224670,EDS 290,A00,897211,Hofstetter; Carolyn,15,0,15,0
1745807225696,LIGM 5A,A00,896162,Fischer-Grunski; Eva K,15,0,20,5
1745807226723,LIGM 5B,A00,896260,Fischer-Grunski; Eva K,17,0,20,3
1745807227753,LIGM 5C,A00,896308,Fischer-Grunski; Eva K,18,0,20,2
1745807228777,LIIT 5AS,A00,896313,Carnelos; Chiara,18,0,20,2
1745807229802,LIIT 5BS,A00,896416,Carnelos; Chiara,20,0,20,0
1745807230832,LIIT 5CS,A00,896564,Carnelos; Chiara,20,0,20,0
1745807231860,LISP 5A,A00,896588,Munoz Sanchez; Alicia,4,0,20,16
1745807232886,LISP 5B,A00,896653,Munoz Sanchez; Alicia,10,0,20,10
1745807233914,LISP 5C,A00,896655,Munoz Sanchez; Alicia,4,0,20,16
1745807234942,MAE 197,001,957918,Kleissl; Jan,9998,0,9999,1
1745807235969,MATH 2,A01,957937,Staff,34,0,35,1
1745807236995,MATH 197,001,957876,Kedlaya; Kiran S.,9993,0,9999,6
1745807238022,MCWP 40,A00,892729,Duru; Nur,13,0,20,7
1745807238022,MCWP 40,B00,893304,Montejo; Carolina,20,0,20,0
1745807239048,MCWP 40R,A00,893757,Redela; Pamela Morgan,0,7,20,20
1745807240075,MCWP 50,A00,893758,Morshed; Michael James,2,0,20,18
1745807240075,MCWP 50,B00,893761,Bartulis; Jason Michael,17,0,20,3
1745807241104,MCWP 50R,A00,893766,Compas; Sean Matthew,0,1,20,20
1745807241104,MCWP 50R,B00,893769,Carter; Jennifer A,0,0,20,20
1745807241104,MCWP 50R,C00,893771,Krone; Jarret,0,3,20,20
1745807241104,MCWP 50R,D00,893772,Miller; Elizabeth Deen,3,0,20,17
1745807241104,MCWP 50R,E00,893775,Carter; Andrea L,0,0,20,20
1745807242131,MMW 11R,A01,892721,Herbst; Matthew,11,0,27,16
1745807242131,MMW 11R,A02,892722,Herbst; Matthew,0,0,0,3
1745807243160,MMW 12R,A01,892724,Herbst; Matthew,0,9,16,16
1745807243160,MMW 12R,A02,892725,Herbst; Matthew,0,9,16,16
1745807244188,MMW 13R,A01,892727,Staff,0,4,16,16
1745807244188,MMW 13R,A02,892728,Staff,0,4,16,16
1745807244188,MMW 13R,A03,958032,Staff,0,3,16,16
1745807244188,MMW 13R,A04,958033,Staff,0,2,16,16
1745807244188,MMW 13R,A05,958034,Staff,0,3,16,16
1745807245216,SIO 295LS,A00,894015,Staff,7,0,25,18
1745807246241,SIO 295S,A00,894020,Staff,7,0,25,18
1745807247267,SIOC 290S,B01,958918,Staff,0,0,0,0
1745807248292,SIOC 291S,B01,958922,Staff,0,0,0,0
1745807249319,SOCI 117,A01,895339,Staff,4,0,5,1
1745807250346,WES 237B,A00,894149,Staff,11,0,20,9
1745807252411,AESE 279B,A00,891859,Staff,13,0,35,22
1745807253438,AIP 197,001,891854,Staff,70,0,70,0
1745807254463,ANTH 289S,A00,891856,Gagneux; Pascal,12,0,12,0
1745807255488,BENG 196,001,957946,Engler; Adam J.,9996,0,9999,3
1745807256516,CAT 124RS,A01,956906,Staff,8,0,25,17
1745807257543,CAT 125RS,A01,922013,Staff,8,0,25,17
1745807258567,CLRE 250,A00,891860,Morris; Sheldon,9995,0,9999,4
1745807260619,CLRE 251R,A00,907817,Mehta; Ravindra L.,9994,0,9999,5
1745807261643,CLRE 252,A00,891864,Cuomo; Raphael Eduardo,9993,0,9999,6
1745807262669,CLRE 253,A00,891867,Vaida; Florin,9994,0,9999,5
1745807262669,CLRE 253,B00,907819,Staff,9999,0,9999,0
1745807263695,CLRE 259,A00,891868,Patel; Hemal,9998,0,9999,1
1745807264718,CLRE 260,A00,891872,Cuomo; Raphael Eduardo,9999,0,9999,0
1745807265747,CLRE 297,001,891888,Cuomo; Raphael Eduardo,9999,0,9999,0
1745807266774,CSE 191,A00,958773,Minnes Kemp; Mor Mia,9999,0,9999,0
1745807267799,CSS 201S,A01,892054,Mignozzetti; Umberto,30,0,30,0
1745807268829,CSS 202S,A01,892056,Mignozzetti; Umberto,30,0,30,0
1745807269856,DSC 197,001,956898,Eldridge; Justin Matthew,9998,0,9999,1
1745807270883,DSC 297,001,958000,Mazumdar; Arya,9998,0,9999,1
1745807271909,EAP 100,A00,905686,Staff,9776,0,9999,223
1745807272934,ECE 45,A01,892618,Staff,0,12,50,50
1745807273960,ECE 109,A01,892620,Staff,0,43,0,0
1745807274985,ECE 111,A01,892719,Staff,0,7,50,50
1745807276012,ECE 197,001,957920,Mercier; Patrick Philip,9992,0,9999,7
1745807277038,ECON 178,A01,907814,Zhu; Ying,28,0,35,7
1745807278063,EDS 115,A00,895312,Staff,41,0,45,4
1745807279092,EDS 117,A01,895337,Staff,30,0,30,0
1745807280119,EDS 125,A00,895341,Jones; Gabrielle Anastasia,43,0,45,2
1745807281144,EDS 128A,A01,895459,Fargason; Sharon Gayle,44,0,45,1
1745807282170,EDS 128B,A01,895543,Pappas; Elizabeth,44,0,45,1
1745807283196,EDS 139,A00,897203,Pappas; Elizabeth,44,0,45,1
1745807283196,EDS 139,B00,897209,Fargason; Sharon Gayle,44,0,45,1
1745807284224,EDS 201,A00,895545,Staff,43,0,45,2
1745807285252,EDS 203,A01,895581,Halter; Christopher P.,43,0,45,2
1745807286281,EDS 204R,A01,895625,Heinzman; Erica M.,43,0,45,2
1745807286281,EDS 204R,B01,895693,Halter; Christopher P.,18,0,45,27
1745807287309,EDS 206R,A00,895694,Fargason; Sharon Gayle,9,0,30,21
1745807287309,EDS 206R,B00,895695,Choi; Bailey Miyeon,20,0,30,10
1745807288334,EDS 250,A00,895697,Hemans; Patricia Ann Benitez,43,0,45,2
1745807289362,EDS 281,A00,895701,Meyerott; Theresa Ann,15,0,15,0
1745807290389,EDS 284,A00,895736,Meyerott; Theresa Ann,15,0,15,0
1745807291417,EDS 286,A00,897210,Fine; Sarah,15,0,15,0
1745807292445,EDS 289C,A01,895770,Daly; Alan J.,15,0,15,0
1745807293472,EDS 290,A00,897211,Hofstetter; Carolyn,15,0,15,0
1745807294501,LIGM 5A,A00,896162,Fischer-Grunski; Eva K,15,0,20,5
1745807295534,LIGM 5B,A00,896260,Fischer-Grunski; Eva K,17,0,20,3
1745807296561,LIGM 5C,A00,896308,Fischer-Grunski; Eva K,18,0,20,2
1745807297587,LIIT 5AS,A00,896313,Carnelos; Chiara,18,0,20,2
1745807298616,LIIT 5BS,A00,896416,Carnelos; Chiara,20,0,20,0
1745807299641,LIIT 5CS,A00,896564,Carnelos; Chiara,20,0,20,0
1745807300671,LISP 5A,A00,896588,Munoz Sanchez; Alicia,4,0,20,16
1745807301696,LISP 5B,A00,896653,Munoz Sanchez; Alicia,10,0,20,10
1745807302722,LISP 5C,A00,896655,Munoz Sanchez; Alicia,4,0,20,16
1745807303748,MAE 197,001,957918,Kleissl; Jan,9998,0,9999,1
1745807304776,MATH 2,A01,957937,Staff,34,0,35,1
1745807305804,MATH 197,001,957876,Kedlaya; Kiran S.,9993,0,9999,6
1745807306830,MCWP 40,A00,892729,Duru; Nur,13,0,20,7
1745807306830,MCWP 40,B00,893304,Montejo; Carolina,20,0,20,0
1745807307857,MCWP 40R,A00,893757,Redela; Pamela Morgan,0,7,20,20
1745807308884,MCWP 50,A00,893758,Morshed; Michael James,2,0,20,18
1745807308884,MCWP 50,B00,893761,Bartulis; Jason Michael,17,0,20,3
1745807309913,MCWP 50R,A00,893766,Compas; Sean Matthew,0,1,20,20
1745807309913,MCWP 50R,B00,893769,Carter; Jennifer A,0,0,20,20
1745807309913,MCWP 50R,C00,893771,Krone; Jarret,0,3,20,20
1745807309913,MCWP 50R,D00,893772,Miller; Elizabeth Deen,3,0,20,17
1745807309913,MCWP 50R,E00,893775,Carter; Andrea L,0,0,20,20
1745807310941,MMW 11R,A01,892721,Herbst; Matthew,11,0,27,16
1745807310941,MMW 11R,A02,892722,Herbst; Matthew,0,0,0,3
1745807311967,MMW 12R,A01,892724,Herbst; Matthew,0,9,16,16
1745807311967,MMW 12R,A02,892725,Herbst; Matthew,0,9,16,16
1745807312996,MMW 13R,A01,892727,Staff,0,4,16,16
1745807312996,MMW 13R,A02,892728,Staff,0,4,16,16
1745807312996,MMW 13R,A03,958032,Staff,0,3,16,16
1745807312996,MMW 13R,A04,958033,Staff,0,2,16,16
1745807312996,MMW 13R,A05,958034,Staff,0,3,16,16
1745807314021,SIO 295LS,A00,894015,Staff,7,0,25,18
1745807315048,SIO 295S,A00,894020,Staff,7,0,25,18
1745807316074,SIOC 290S,B01,958918,Staff,0,0,0,0
1745807317100,SIOC 291S,B01,958922,Staff,0,0,0,0
1745807318128,SOCI 117,A01,895339,Staff,4,0,5,1
1745807319153,WES 237B,A00,894149,Staff,11,0,20,9
1745807321211,AESE 279B,A00,891859,Staff,13,0,35,22
1745807322240,AIP 197,001,891854,Staff,70,0,70,0
1745807323266,ANTH 289S,A00,891856,Gagneux; Pascal,12,0,12,0
1745807324291,BENG 196,001,957946,Engler; Adam J.,9996,0,9999,3
1745807325317,CAT 124RS,A01,956906,Staff,8,0,25,17
1745807326343,CAT 125RS,A01,922013,Staff,8,0,25,17
1745807327369,CLRE 250,A00,891860,Morris; Sheldon,9995,0,9999,4
1745807329423,CLRE 251R,A00,907817,Mehta; Ravindra L.,9994,0,9999,5
1745807330447,CLRE 252,A00,891864,Cuomo; Raphael Eduardo,9993,0,9999,6
1745807331476,CLRE 253,A00,891867,Vaida; Florin,9994,0,9999,5
1745807331476,CLRE 253,B00,907819,Staff,9999,0,9999,0
1745807332501,CLRE 259,A00,891868,Patel; Hemal,9998,0,9999,1
1745807333528,CLRE 260,A00,891872,Cuomo; Raphael Eduardo,9999,0,9999,0
1745807334556,CLRE 297,001,891888,Cuomo; Raphael Eduardo,9999,0,9999,0
1745807335580,CSE 191,A00,958773,Minnes Kemp; Mor Mia,9999,0,9999,0
1745807336607,CSS 201S,A01,892054,Mignozzetti; Umberto,30,0,30,0
1745807337632,CSS 202S,A01,892056,Mignozzetti; Umberto,30,0,30,0
1745807338656,DSC 197,001,956898,Eldridge; Justin Matthew,9998,0,9999,1
1745807339682,DSC 297,001,958000,Mazumdar; Arya,9998,0,9999,1
1745807340709,EAP 100,A00,905686,Staff,9776,0,9999,223
1745807341734,ECE 45,A01,892618,Staff,0,12,50,50
1745807342760,ECE 109,A01,892620,Staff,0,43,0,0
1745807343790,ECE 111,A01,892719,Staff,0,7,50,50
1745807344818,ECE 197,001,957920,Mercier; Patrick Philip,9992,0,9999,7
1745807345848,ECON 178,A01,907814,Zhu; Ying,28,0,35,7
1745807346872,EDS 115,A00,895312,Staff,41,0,45,4
1745807347905,EDS 117,A01,895337,Staff,30,0,30,0
1745807348930,EDS 125,A00,895341,Jones; Gabrielle Anastasia,43,0,45,2
1745807349959,EDS 128A,A01,895459,Fargason; Sharon Gayle,44,0,45,1
1745807350985,EDS 128B,A01,895543,Pappas; Elizabeth,44,0,45,1
1745807352015,EDS 139,A00,897203,Pappas; Elizabeth,44,0,45,1
1745807352015,EDS 139,B00,897209,Fargason; Sharon Gayle,44,0,45,1
1745807353039,EDS 201,A00,895545,Staff,43,0,45,2
1745807354065,EDS 203,A01,895581,Halter; Christopher P.,43,0,45,2
1745807355093,EDS 204R,A01,895625,Heinzman; Erica M.,43,0,45,2
1745807355093,EDS 204R,B01,895693,Halter; Christopher P.,18,0,45,27
1745807356122,EDS 206R,A00,895694,Fargason; Sharon Gayle,9,0,30,21
1745807356122,EDS 206R,B00,895695,Choi; Bailey Miyeon,20,0,30,10
1745807357151,EDS 250,A00,895697,Hemans; Patricia Ann Benitez,43,0,45,2
1745807358176,EDS 281,A00,895701,Meyerott; Theresa Ann,15,0,15,0
1745807359199,EDS 284,A00,895736,Meyerott; Theresa Ann,15,0,15,0
1745807360227,EDS 286,A00,897210,Fine; Sarah,15,0,15,0
1745807361253,EDS 289C,A01,895770,Daly; Alan J.,15,0,15,0
1745807362278,EDS 290,A00,897211,Hofstetter; Carolyn,15,0,15,0
1745807363309,LIGM 5A,A00,896162,Fischer-Grunski; Eva K,15,0,20,5
1745807364339,LIGM 5B,A00,896260,Fischer-Grunski; Eva K,17,0,20,3
1745807365365,LIGM 5C,A00,896308,Fischer-Grunski; Eva K,18,0,20,2
1745807366391,LIIT 5AS,A00,896313,Carnelos; Chiara,18,0,20,2
1745807367416,LIIT 5BS,A00,896416,Carnelos; Chiara,20,0,20,0
1745807368444,LIIT 5CS,A00,896564,Carnelos; Chiara,20,0,20,0
1745807369469,LISP 5A,A00,896588,Munoz Sanchez; Alicia,4,0,20,16
1745807370495,LISP 5B,A00,896653,Munoz Sanchez; Alicia,10,0,20,10
1745807371519,LISP 5C,A00,896655,Munoz Sanchez; Alicia,4,0,20,16
1745807372544,MAE 197,001,957918,Kleissl; Jan,9998,0,9999,1
1745807373573,MATH 2,A01,957937,Staff,34,0,35,1
1745807374597,MATH 197,001,957876,Kedlaya; Kiran S.,9993,0,9999,6
1745807375624,MCWP 40,A00,892729,Duru; Nur,13,0,20,7
1745807375624,MCWP 40,B00,893304,Montejo; Carolina,20,0,20,0
1745807376650,MCWP 40R,A00,893757,Redela; Pamela Morgan,0,7,20,20
1745807377678,MCWP 50,A00,893758,Morshed; Michael James,2,0,20,18
1745807377678,MCWP 50,B00,893761,Bartulis; Jason Michael,17,0,20,3
1745807378705,MCWP 50R,A00,893766,Compas; Sean Matthew,0,1,20,20
1745807378705,MCWP 50R,B00,893769,Carter; Jennifer A,0,0,20,20
1745807378705,MCWP 50R,C00,893771,Krone; Jarret,0,3,20,20
1745807378705,MCWP 50R,D00,893772,Miller; Elizabeth Deen,3,0,20,17
1745807378705,MCWP 50R,E00,893775,Carter; Andrea L,0,0,20,20
1745807379734,MMW 11R,A01,892721,Herbst; Matthew,11,0,27,16
1745807379734,MMW 11R,A02,892722,Herbst; Matthew,0,0,0,3
1745807380759,MMW 12R,A01,892724,Herbst; Matthew,0,9,16,16
1745807380759,MMW 12R,A02,892725,Herbst; Matthew,0,9,16,16
1745807381790,MMW 13R,A01,892727,Staff,0,4,16,16
1745807381790,MMW 13R,A02,892728,Staff,0,4,16,16
1745807381790,MMW 13R,A03,958032,Staff,0,3,16,16
1745807381790,MMW 13R,A04,958033,Staff,0,2,16,16
1745807381790,MMW 13R,A05,958034,Staff,0,3,16,16
1745807382816,SIO 295LS,A00,894015,Staff,7,0,25,18
1745807383842,SIO 295S,A00,894020,Staff,7,0,25,18
1745807384867,SIOC 290S,B01,958918,Staff,0,0,0,0
1745807385895,SIOC 291S,B01,958922,Staff,0,0,0,0
1745807386922,SOCI 117,A01,895339,Staff,4,0,5,1
1745807387949,WES 237B,A00,894149,Staff,11,0,20,9
1745807390007,AESE 279B,A00,891859,Staff,13,0,35,22
1745807391033,AIP 197,001,891854,Staff,70,0,70,0
1745807392063,ANTH 289S,A00,891856,Gagneux; Pascal,12,0,12,0
1745807393090,BENG 196,001,957946,Engler; Adam J.,9996,0,9999,3
1745807394119,CAT 124RS,A01,956906,Staff,8,0,25,17
1745807395166,CAT 125RS,A01,922013,Staff,8,0,25,17
1745807396191,CLRE 250,A00,891860,Morris; Sheldon,9995,0,9999,4
1745807398244,CLRE 251R,A00,907817,Mehta; Ravindra L.,9994,0,9999,5
1745807399270,CLRE 252,A00,891864,Cuomo; Raphael Eduardo,9993,0,9999,6
1745807400300,CLRE 253,A00,891867,Vaida; Florin,9994,0,9999,5
1745807400300,CLRE 253,B00,907819,Staff,9999,0,9999,0
1745807401325,CLRE 259,A00,891868,Patel; Hemal,9998,0,9999,1
1745807402355,CLRE 260,A00,891872,Cuomo; Raphael Eduardo,9999,0,9999,0
1745807403384,CLRE 297,001,891888,Cuomo; Raphael Eduardo,9999,0,9999,0
1745807404416,CSE 191,A00,958773,Minnes Kemp; Mor Mia,9999,0,9999,0
1745807405444,CSS 201S,A01,892054,Mignozzetti; Umberto,30,0,30,0
1745807406475,CSS 202S,A01,892056,Mignozzetti; Umberto,30,0,30,0
1745807407504,DSC 197,001,956898,Eldridge; Justin Matthew,9998,0,9999,1
1745807408529,DSC 297,001,958000,Mazumdar; Arya,9998,0,9999,1
1745807409558,EAP 100,A00,905686,Staff,9776,0,9999,223
1745807410588,ECE 45,A01,892618,Staff,0,12,50,50
1745807411614,ECE 109,A01,892620,Staff,0,43,0,0
1745807412640,ECE 111,A01,892719,Staff,0,7,50,50
1745807413668,ECE 197,001,957920,Mercier; Patrick Philip,9992,0,9999,7
1745807414699,ECON 178,A01,907814,Zhu; Ying,28,0,35,7
1745807415724,EDS 115,A00,895312,Staff,41,0,45,4
1745807416752,EDS 117,A01,895337,Staff,30,0,30,0
1745807417781,EDS 125,A00,895341,Jones; Gabrielle Anastasia,43,0,45,2
1745807418806,EDS 128A,A01,895459,Fargason; Sharon Gayle,44,0,45,1
1745807419832,EDS 128B,A01,895543,Pappas; Elizabeth,44,0,45,1
1745807420862,EDS 139,A00,897203,Pappas; Elizabeth,44,0,45,1
1745807420862,EDS 139,B00,897209,Fargason; Sharon Gayle,44,0,45,1
1745807421887,EDS 201,A00,895545,Staff,43,0,45,2
1745807422913,EDS 203,A01,895581,Halter; Christopher P.,43,0,45,2
1745807423941,EDS 204R,A01,895625,Heinzman; Erica M.,43,0,45,2
1745807423941,EDS 204R,B01,895693,Halter; Christopher P.,18,0,45,27
1745807424971,EDS 206R,A00,895694,Fargason; Sharon Gayle,9,0,30,21
1745807424971,EDS 206R,B00,895695,Choi; Bailey Miyeon,20,0,30,10
1745807425998,EDS 250,A00,895697,Hemans; Patricia Ann Benitez,43,0,45,2
1745807427026,EDS 281,A00,895701,Meyerott; Theresa Ann,15,0,15,0
1745807428053,EDS 284,A00,895736,Meyerott; Theresa Ann,15,0,15,0
1745807429080,EDS 286,A00,897210,Fine; Sarah,15,0,15,0
1745807430110,EDS 289C,A01,895770,Daly; Alan J.,15,0,15,0
1745807431136,EDS 290,A00,897211,Hofstetter; Carolyn,15,0,15,0
1745807432160,LIGM 5A,A00,896162,Fischer-Grunski; Eva K,15,0,20,5
1745807433187,LIGM 5B,A00,896260,Fischer-Grunski; Eva K,17,0,20,3
1745807434213,LIGM 5C,A00,896308,Fischer-Grunski; Eva K,18,0,20,2
1745807435241,LIIT 5AS,A00,896313,Carnelos; Chiara,18,0,20,2
1745807436266,LIIT 5BS,A00,896416,Carnelos; Chiara,20,0,20,0
1745807437294,LIIT 5CS,A00,896564,Carnelos; Chiara,20,0,20,0
1745807438319,LISP 5A,A00,896588,Munoz Sanchez; Alicia,4,0,20,16
1745807439345,LISP 5B,A00,896653,Munoz Sanchez; Alicia,10,0,20,10
1745807440373,LISP 5C,A00,896655,Munoz Sanchez; Alicia,4,0,20,16
1745807441400,MAE 197,001,957918,Kleissl; Jan,9998,0,9999,1
1745807442427,MATH 2,A01,957937,Staff,34,0,35,1
1745807443451,MATH 197,001,957876,Kedlaya; Kiran S.,9993,0,9999,6
1745807444476,MCWP 40,A00,892729,Duru; Nur,13,0,20,7
1745807444476,MCWP 40,B00,893304,Montejo; Carolina,20,0,20,0
1745807445501,MCWP 40R,A00,893757,Redela; Pamela Morgan,0,7,20,20
1745807446529,MCWP 50,A00,893758,Morshed; Michael James,2,0,20,18
1745807446529,MCWP 50,B00,893761,Bartulis; Jason Michael,17,0,20,3
1745807447561,MCWP 50R,A00,893766,Compas; Sean Matthew,0,1,20,20
1745807447561,MCWP 50R,B00,893769,Carter; Jennifer A,0,0,20,20
1745807447561,MCWP 50R,C00,893771,Krone; Jarret,0,3,20,20
1745807447561,MCWP 50R,D00,893772,Miller; Elizabeth Deen,3,0,20,17
1745807447561,MCWP 50R,E00,893775,Carter; Andrea L,0,0,20,20
1745807448586,MMW 11R,A01,892721,Herbst; Matthew,11,0,27,16
1745807448586,MMW 11R,A02,892722,Herbst; Matthew,0,0,0,3
1745807449611,MMW 12R,A01,892724,Herbst; Matthew,0,9,16,16
1745807449611,MMW 12R,A02,892725,Herbst; Matthew,0,9,16,16
1745807450637,MMW 13R,A01,892727,Staff,0,4,16,16
1745807450637,MMW 13R,A02,892728,Staff,0,4,16,16
1745807450637,MMW 13R,A03,958032,Staff,0,3,16,16
1745807450637,MMW 13R,A04,958033,Staff,0,2,16,16
1745807450637,MMW 13R,A05,958034,Staff,0,3,16,16
1745807451664,SIO 295LS,A00,894015,Staff,7,0,25,18
1745807452693,SIO 295S,A00,894020,Staff,7,0,25,18
1745807453723,SIOC 290S,B01,958918,Staff,0,0,0,0
1745807454750,SIOC 291S,B01,958922,Staff,0,0,0,0
1745807455778,SOCI 117,A01,895339,Staff,4,0,5,1
1745807456804,WES 237B,A00,894149,Staff,11,0,20,9
1745807458863,AESE 279B,A00,891859,Staff,13,0,35,22
1745807459893,AIP 197,001,891854,Staff,70,0,70,0
1745807460918,ANTH 289S,A00,891856,Gagneux; Pascal,12,0,12,0
1745807461948,BENG 196,001,957946,Engler; Adam J.,9996,0,9999,3
1745807462975,CAT 124RS,A01,956906,Staff,8,0,25,17
1745807464001,CAT 125RS,A01,922013,Staff,8,0,25,17
1745807465030,CLRE 250,A00,891860,Morris; Sheldon,9995,0,9999,4
1745807467086,CLRE 251R,A00,907817,Mehta; Ravindra L.,9994,0,9999,5
1745807468112,CLRE 252,A00,891864,Cuomo; Raphael Eduardo,9993,0,9999,6
1745807469141,CLRE 253,A00,891867,Vaida; Florin,9994,0,9999,5
1745807469141,CLRE 253,B00,907819,Staff,9999,0,9999,0
1745807470171,CLRE 259,A00,891868,Patel; Hemal,9998,0,9999,1
1745807471199,CLRE 260,A00,891872,Cuomo; Raphael Eduardo,9999,0,9999,0
1745807472225,CLRE 297,001,891888,Cuomo; Raphael Eduardo,9999,0,9999,0
1745807473252,CSE 191,A00,958773,Minnes Kemp; Mor Mia,9999,0,9999,0
1745807474281,CSS 201S,A01,892054,Mignozzetti; Umberto,30,0,30,0
1745807475306,CSS 202S,A01,892056,Mignozzetti; Umberto,30,0,30,0
1745807476331,DSC 197,001,956898,Eldridge; Justin Matthew,9998,0,9999,1
1745807477358,DSC 297,001,958000,Mazumdar; Arya,9998,0,9999,1
1745807478385,EAP 100,A00,905686,Staff,9776,0,9999,223
1745807479410,ECE 45,A01,892618,Staff,0,12,50,50
1745807480437,ECE 109,A01,892620,Staff,0,43,0,0
1745807481465,ECE 111,A01,892719,Staff,0,7,50,50
1745807482490,ECE 197,001,957920,Mercier; Patrick Philip,9992,0,9999,7
1745807483517,ECON 178,A01,907814,Zhu; Ying,28,0,35,7
1745807484543,EDS 115,A00,895312,Staff,41,0,45,4
1745807485571,EDS 117,A01,895337,Staff,30,0,30,0
1745807486597,EDS 125,A00,895341,Jones; Gabrielle Anastasia,43,0,45,2
1745807487623,EDS 128A,A01,895459,Fargason; Sharon Gayle,44,0,45,1
1745807488647,EDS 128B,A01,895543,Pappas; Elizabeth,44,0,45,1
1745807489676,EDS 139,A00,897203,Pappas; Elizabeth,44,0,45,1
1745807489676,EDS 139,B00,897209,Fargason; Sharon Gayle,44,0,45,1
1745807490700,EDS 201,A00,895545,Staff,43,0,45,2
1745807491727,EDS 203,A01,895581,Halter; Christopher P.,43,0,45,2
1745807492751,EDS 204R,A01,895625,Heinzman; Erica M.,43,0,45,2
1745807492751,EDS 204R,B01,895693,Halter; Christopher P.,18,0,45,27
1745807493778,EDS 206R,A00,895694,Fargason; Sharon Gayle,9,0,30,21
1745807493778,EDS 206R,B00,895695,Choi; Bailey Miyeon,20,0,30,10
1745807494804,EDS 250,A00,895697,Hemans; Patricia Ann Benitez,43,0,45,2
1745807495838,EDS 281,A00,895701,Meyerott; Theresa Ann,15,0,15,0
1745807496864,EDS 284,A00,895736,Meyerott; Theresa Ann,15,0,15,0
1745807497891,EDS 286,A00,897210,Fine; Sarah,15,0,15,0
1745807498919,EDS 289C,A01,895770,Daly; Alan J.,15,0,15,0
1745807499949,EDS 290,A00,897211,Hofstetter; Carolyn,15,0,15,0
1745807500977,LIGM 5A,A00,896162,Fischer-Grunski; Eva K,15,0,20,5
1745807502005,LIGM 5B,A00,896260,Fischer-Grunski; Eva K,17,0,20,3
1745807503035,LIGM 5C,A00,896308,Fischer-Grunski; Eva K,18,0,20,2
1745807504060,LIIT 5AS,A00,896313,Carnelos; Chiara,18,0,20,2
1745807505085,LIIT 5BS,A00,896416,Carnelos; Chiara,20,0,20,0
1745807506113,LIIT 5CS,A00,896564,Carnelos; Chiara,20,0,20,0
1745807507139,LISP 5A,A00,896588,Munoz Sanchez; Alicia,4,0,20,16
1745807508168,LISP 5B,A00,896653,Munoz Sanchez; Alicia,10,0,20,10
1745807509193,LISP 5C,A00,896655,Munoz Sanchez; Alicia,4,0,20,16
1745807510218,MAE 197,001,957918,Kleissl; Jan,9998,0,9999,1
1745807511244,MATH 2,A01,957937,Staff,34,0,35,1
1745807512271,MATH 197,001,957876,Kedlaya; Kiran S.,9993,0,9999,6
1745807513301,MCWP 40,A00,892729,Duru; Nur,13,0,20,7
1745807513301,MCWP 40,B00,893304,Montejo; Carolina,20,0,20,0
1745807514325,MCWP 40R,A00,893757,Redela; Pamela Morgan,0,7,20,20
1745807515354,MCWP 50,A00,893758,Morshed; Michael James,2,0,20,18
1745807515354,MCWP 50,B00,893761,Bartulis; Jason Michael,17,0,20,3
1745807516380,MCWP 50R,A00,893766,Compas; Sean Matthew,0,1,20,20
1745807516380,MCWP 50R,B00,893769,Carter; Jennifer A,0,0,20,20
1745807516380,MCWP 50R,C00,893771,Krone; Jarret,0,3,20,20
1745807516380,MCWP 50R,D00,893772,Miller; Elizabeth Deen,3,0,20,17
1745807516380,MCWP 50R,E00,893775,Carter; Andrea L,0,0,20,20
1745807517408,MMW 11R,A01,892721,Herbst; Matthew,11,0,27,16
1745807517408,MMW 11R,A02,892722,Herbst; Matthew,0,0,0,3
1745807518436,MMW 12R,A01,892724,Herbst; Matthew,0,9,16,16
1745807518436,MMW 12R,A02,892725,Herbst; Matthew,0,9,16,16
1745807519462,MMW 13R,A01,892727,Staff,0,4,16,16
1745807519462,MMW 13R,A02,892728,Staff,0,4,16,16
1745807519462,MMW 13R,A03,958032,Staff,0,3,16,16
1745807519462,MMW 13R,A04,958033,Staff,0,2,16,16
1745807519462,MMW 13R,A05,958034,Staff,0,3,16,16
1745807520489,SIO 295LS,A00,894015,Staff,7,0,25,18
1745807521519,SIO 295S,A00,894020,Staff,7,0,25,18
1745807522544,SIOC 290S,B01,958918,Staff,0,0,0,0
1745807523574,SIOC 291S,B01,958922,Staff,0,0,0,0
1745807524604,SOCI 117,A01,895339,Staff,4,0,5,1
1745807525631,WES 237B,A00,894149,Staff,11,0,20,9
1745807527703,AESE 279B,A00,891859,Staff,13,0,35,22
1745807528728,AIP 197,001,891854,Staff,70,0,70,0
1745807529756,ANTH 289S,A00,891856,Gagneux; Pascal,12,0,12,0
1745807530784,BENG 196,001,957946,Engler; Adam J.,9996,0,9999,3
1745807531809,CAT 124RS,A01,956906,Staff,8,0,25,17
1745807532833,CAT 125RS,A01,922013,Staff,8,0,25,17
1745807533858,CLRE 250,A00,891860,Morris; Sheldon,9995,0,9999,4
1745807535909,CLRE 251R,A00,907817,Mehta; Ravindra L.,9994,0,9999,5
1745807536937,CLRE 252,A00,891864,Cuomo; Raphael Eduardo,9993,0,9999,6
1745807537967,CLRE 253,A00,891867,Vaida; Florin,9994,0,9999,5
1745807537967,CLRE 253,B00,907819,Staff,9999,0,9999,0
1745807538994,CLRE 259,A00,891868,Patel; Hemal,9998,0,9999,1
1745807540021,CLRE 260,A00,891872,Cuomo; Raphael Eduardo,9999,0,9999,0
1745807541047,CLRE 297,001,891888,Cuomo; Raphael Eduardo,9999,0,9999,0
1745807542073,CSE 191,A00,958773,Minnes Kemp; Mor Mia,9999,0,9999,0
1745807543102,CSS 201S,A01,892054,Mignozzetti; Umberto,30,0,30,0
1745807544129,CSS 202S,A01,892056,Mignozzetti; Umberto,30,0,30,0
1745807545153,DSC 197,001,956898,Eldridge; Justin Matthew,9998,0,9999,1
1745807546179,DSC 297,001,958000,Mazumdar; Arya,9998,0,9999,1
1745807547204,EAP 100,A00,905686,Staff,9776,0,9999,223
1745807548229,ECE 45,A01,892618,Staff,0,12,50,50
1745807549255,ECE 109,A01,892620,Staff,0,44,0,0
1745807550283,ECE 111,A01,892719,Staff,0,8,50,50
1745807551308,ECE 197,001,957920,Mercier; Patrick Philip,9992,0,9999,7
1745807552338,ECON 178,A01,907814,Zhu; Ying,28,0,35,7
1745807553362,EDS 115,A00,895312,Staff,41,0,45,4
1745807554387,EDS 117,A01,895337,Staff,30,0,30,0
1745807555410,EDS 125,A00,895341,Jones; Gabrielle Anastasia,43,0,45,2
1745807556436,EDS 128A,A01,895459,Fargason; Sharon Gayle,44,0,45,1
1745807557460,EDS 128B,A01,895543,Pappas; Elizabeth,44,0,45,1
1745807558486,EDS 139,A00,897203,Pappas; Elizabeth,44,0,45,1
1745807558486,EDS 139,B00,897209,Fargason; Sharon Gayle,44,0,45,1
1745807559511,EDS 201,A00,895545,Staff,43,0,45,2
1745807560537,EDS 203,A01,895581,Halter; Christopher P.,43,0,45,2
1745807561565,EDS 204R,A01,895625,Heinzman; Erica M.,43,0,45,2
1745807561565,EDS 204R,B01,895693,Halter; Christopher P.,18,0,45,27
1745807562591,EDS 206R,A00,895694,Fargason; Sharon Gayle,9,0,30,21
1745807562591,EDS 206R,B00,895695,Choi; Bailey Miyeon,20,0,30,10
1745807563615,EDS 250,A00,895697,Hemans; Patricia Ann Benitez,43,0,45,2
1745807564643,EDS 281,A00,895701,Meyerott; Theresa Ann,15,0,15,0
1745807565671,EDS 284,A00,895736,Meyerott; Theresa Ann,15,0,15,0
1745807566695,EDS 286,A00,897210,Fine; Sarah,15,0,15,0
1745807567721,EDS 289C,A01,895770,Daly; Alan J.,15,0,15,0
1745807568748,EDS 290,A00,897211,Hofstetter; Carolyn,15,0,15,0
1745807569773,LIGM 5A,A00,896162,Fischer-Grunski; Eva K,15,0,20,5
1745807570798,LIGM 5B,A00,896260,Fischer-Grunski; Eva K,17,0,20,3
1745807571826,LIGM 5C,A00,896308,Fischer-Grunski; Eva K,18,0,20,2
1745807572851,LIIT 5AS,A00,896313,Carnelos; Chiara,18,0,20,2
1745807573879,LIIT 5BS,A00,896416,Carnelos; Chiara,20,0,20,0
1745807574905,LIIT 5CS,A00,896564,Carnelos; Chiara,20,0,20,0
1745807575930,LISP 5A,A00,896588,Munoz Sanchez; Alicia,4,0,20,16
1745807576957,LISP 5B,A00,896653,Munoz Sanchez; Alicia,10,0,20,10
1745807577983,LISP 5C,A00,896655,Munoz Sanchez; Alicia,4,0,20,16
1745807579011,MAE 197,001,957918,Kleissl; Jan,9998,0,9999,1
1745807580037,MATH 2,A01,957937,Staff,34,0,35,1
1745807581065,MATH 197,001,957876,Kedlaya; Kiran S.,9993,0,9999,6
1745807582092,MCWP 40,A00,892729,Duru; Nur,13,0,20,7
1745807582092,MCWP 40,B00,893304,Montejo; Carolina,20,0,20,0
1745807583121,MCWP 40R,A00,893757,Redela; Pamela Morgan,0,7,20,20
1745807584146,MCWP 50,A00,893758,Morshed; Michael James,2,0,20,18
1745807584146,MCWP 50,B00,893761,Bartulis; Jason Michael,17,0,20,3
1745807585174,MCWP 50R,A00,893766,Compas; Sean Matthew,0,1,20,20
1745807585174,MCWP 50R,B00,893769,Carter; Jennifer A,0,0,20,20
1745807585174,MCWP 50R,C00,893771,Krone; Jarret,0,3,20,20
1745807585174,MCWP 50R,D00,893772,Miller; Elizabeth Deen,3,0,20,17
1745807585174,MCWP 50R,E00,893775,Carter; Andrea L,0,0,20,20
1745807586201,MMW 11R,A01,892721,Herbst; Matthew,11,0,27,16
1745807586201,MMW 11R,A02,892722,Herbst; Matthew,0,0,0,3
1745807587226,MMW 12R,A01,892724,Herbst; Matthew,0,9,16,16
1745807587226,MMW 12R,A02,892725,Herbst; Matthew,0,9,16,16
1745807588252,MMW 13R,A01,892727,Staff,0,4,16,16
1745807588252,MMW 13R,A02,892728,Staff,0,4,16,16
1745807588252,MMW 13R,A03,958032,Staff,0,3,16,16
1745807588252,MMW 13R,A04,958033,Staff,0,2,16,16
1745807588252,MMW 13R,A05,958034,Staff,0,3,16,16
1745807589294,SIO 295LS,A00,894015,Staff,7,0,25,18
1745807590321,SIO 295S,A00,894020,Staff,7,0,25,18
1745807591346,SIOC 290S,B01,958918,Staff,0,0,0,0
1745807592372,SIOC 291S,B01,958922,Staff,0,0,0,0
1745807593396,SOCI 117,A01,895339,Staff,4,0,5,1
1745807594421,WES 237B,A00,894149,Staff,11,0,20,9
1745807596479,AESE 279B,A00,891859,Staff,13,0,35,22
1745807597504,AIP 197,001,891854,Staff,70,0,70,0
1745807598532,ANTH 289S,A00,891856,Gagneux; Pascal,12,0,12,0
1745807599558,BENG 196,001,957946,Engler; Adam J.,9996,0,9999,3
1745807600586,CAT 124RS,A01,956906,Staff,8,0,25,17
1745807601610,CAT 125RS,A01,922013,Staff,8,0,25,17
1745807602634,CLRE 250,A00,891860,Morris; Sheldon,9995,0,9999,4
1745807604687,CLRE 251R,A00,907817,Mehta; Ravindra L.,9994,0,9999,5
1745807605714,CLRE 252,A00,891864,Cuomo; Raphael Eduardo,9993,0,9999,6
1745807606743,CLRE 253,A00,891867,Vaida; Florin,9994,0,9999,5
1745807606743,CLRE 253,B00,907819,Staff,9999,0,9999,0
1745807607768,CLRE 259,A00,891868,Patel; Hemal,9998,0,9999,1
1745807608792,CLRE 260,A00,891872,Cuomo; Raphael Eduardo,9999,0,9999,0
1745807609820,CLRE 297,001,891888,Cuomo; Raphael Eduardo,9999,0,9999,0
1745807610844,CSE 191,A00,958773,Minnes Kemp; Mor Mia,9999,0,9999,0
1745807611870,CSS 201S,A01,892054,Mignozzetti; Umberto,30,0,30,0
1745807612899,CSS 202S,A01,892056,Mignozzetti; Umberto,30,0,30,0
1745807613925,DSC 197,001,956898,Eldridge; Justin Matthew,9998,0,9999,1
1745807614950,DSC 297,001,958000,Mazumdar; Arya,9998,0,9999,1
1745807615975,EAP 100,A00,905686,Staff,9776,0,9999,223
1745807616999,ECE 45,A01,892618,Staff,0,12,50,50
1745807618027,ECE 109,A01,892620,Staff,0,44,0,0
1745807619052,ECE 111,A01,892719,Staff,0,8,50,50
1745807620077,ECE 197,001,957920,Mercier; Patrick Philip,9992,0,9999,7
1745807621107,ECON 178,A01,907814,Zhu; Ying,28,0,35,7
1745807622133,EDS 115,A00,895312,Staff,41,0,45,4
1745807623160,EDS 117,A01,895337,Staff,30,0,30,0
1745807624185,EDS 125,A00,895341,Jones; Gabrielle Anastasia,43,0,45,2
1745807625209,EDS 128A,A01,895459,Fargason; Sharon Gayle,44,0,45,1
1745807626236,EDS 128B,A01,895543,Pappas; Elizabeth,44,0,45,1
1745807627266,EDS 139,A00,897203,Pappas; Elizabeth,44,0,45,1
1745807627266,EDS 139,B00,897209,Fargason; Sharon Gayle,44,0,45,1
1745807628293,EDS 201,A00,895545,Staff,43,0,45,2
1745807629318,EDS 203,A01,895581,Halter; Christopher P.,43,0,45,2
1745807630347,EDS 204R,A01,895625,Heinzman; Erica M.,43,0,45,2
1745807630347,EDS 204R,B01,895693,Halter; Christopher P.,18,0,45,27
1745807631377,EDS 206R,A00,895694,Fargason; Sharon Gayle,9,0,30,21
1745807631377,EDS 206R,B00,895695,Choi; Bailey Miyeon,20,0,30,10
1745807632405,EDS 250,A00,895697,Hemans; Patricia Ann Benitez,43,0,45,2
1745807633432,EDS 281,A00,895701,Meyerott; Theresa Ann,15,0,15,0
1745807634460,EDS 284,A00,895736,Meyerott; Theresa Ann,15,0,15,0
1745807635482,EDS 286,A00,897210,Fine; Sarah,15,0,15,0
1745807636509,EDS 289C,A01,895770,Daly; Alan J.,15,0,15,0
1745807637535,EDS 290,A00,897211,Hofstetter; Carolyn,15,0,15,0
1745807638560,LIGM 5A,A00,896162,Fischer-Grunski; Eva K,15,0,20,5
1745807639589,LIGM 5B,A00,896260,Fischer-Grunski; Eva K,17,0,20,3
1745807640620,LIGM 5C,A00,896308,Fischer-Grunski; Eva K,18,0,20,2
1745807641647,LIIT 5AS,A00,896313,Carnelos; Chiara,18,0,20,2
1745807642672,LIIT 5BS,A00,896416,Carnelos; Chiara,20,0,20,0
1745807643703,LIIT 5CS,A00,896564,Carnelos; Chiara,20,0,20,0
1745807644729,LISP 5A,A00,896588,Munoz Sanchez; Alicia,4,0,20,16
1745807645755,LISP 5B,A00,896653,Munoz Sanchez; Alicia,10,0,20,10
1745807646786,LISP 5C,A00,896655,Munoz Sanchez; Alicia,4,0,20,16
1745807647810,MAE 197,001,957918,Kleissl; Jan,9998,0,9999,1
1745807648836,MATH 2,A01,957937,Staff,34,0,35,1
1745807649868,MATH 197,001,957876,Kedlaya; Kiran S.,9993,0,9999,6
1745807650892,MCWP 40,A00,892729,Duru; Nur,13,0,20,7
1745807650892,MCWP 40,B00,893304,Montejo; Carolina,20,0,20,0
1745807651921,MCWP 40R,A00,893757,Redela; Pamela Morgan,0,7,20,20
1745807652947,MCWP 50,A00,893758,Morshed; Michael James,2,0,20,18
1745807652947,MCWP 50,B00,893761,Bartulis; Jason Michael,17,0,20,3
1745807653973,MCWP 50R,A00,893766,Compas; Sean Matthew,0,1,20,20
1745807653973,MCWP 50R,B00,893769,Carter; Jennifer A,0,0,20,20
1745807653973,MCWP 50R,C00,893771,Krone; Jarret,0,3,20,20
1745807653973,MCWP 50R,D00,893772,Miller; Elizabeth Deen,3,0,20,17
1745807653973,MCWP 50R,E00,893775,Carter; Andrea L,0,0,20,20
1745807654998,MMW 11R,A01,892721,Herbst; Matthew,11,0,27,16
1745807654998,MMW 11R,A02,892722,Herbst; Matthew,0,0,0,3
1745807656025,MMW 12R,A01,892724,Herbst; Matthew,0,9,16,16
1745807656025,MMW 12R,A02,892725,Herbst; Matthew,0,9,16,16
1745807657054,MMW 13R,A01,892727,Staff,0,4,16,16
1745807657054,MMW 13R,A02,892728,Staff,0,4,16,16
1745807657054,MMW 13R,A03,958032,Staff,0,3,16,16
1745807657054,MMW 13R,A04,958033,Staff,0,2,16,16
1745807657054,MMW 13R,A05,958034,Staff,0,3,16,16
1745807658081,SIO 295LS,A00,894015,Staff,7,0,25,18
1745807659109,SIO 295S,A00,894020,Staff,7,0,25,18
1745807660137,SIOC 290S,B01,958918,Staff,0,0,0,0
1745807661163,SIOC 291S,B01,958922,Staff,0,0,0,0
1745807662189,SOCI 117,A01,895339,Staff,4,0,5,1
1745807663215,WES 237B,A00,894149,Staff,11,0,20,9
1745807665280,AESE 279B,A00,891859,Staff,13,0,35,22
1745807666308,AIP 197,001,891854,Staff,70,0,70,0
1745807667336,ANTH 289S,A00,891856,Gagneux; Pascal,12,0,12,0
1745807668363,BENG 196,001,957946,Engler; Adam J.,9996,0,9999,3
1745807669389,CAT 124RS,A01,956906,Staff,8,0,25,17
1745807670418,CAT 125RS,A01,922013,Staff,8,0,25,17
1745807671444,CLRE 250,A00,891860,Morris; Sheldon,9995,0,9999,4
1745807673499,CLRE 251R,A00,907817,Mehta; Ravindra L.,9994,0,9999,5
1745807674523,CLRE 252,A00,891864,Cuomo; Raphael Eduardo,9993,0,9999,6
1745807675551,CLRE 253,A00,891867,Vaida; Florin,9994,0,9999,5
1745807675551,CLRE 253,B00,907819,Staff,9999,0,9999,0
1745807676580,CLRE 259,A00,891868,Patel; Hemal,9998,0,9999,1
1745807677606,CLRE 260,A00,891872,Cuomo; Raphael Eduardo,9999,0,9999,0
1745807678633,CLRE 297,001,891888,Cuomo; Raphael Eduardo,9999,0,9999,0
1745807679662,CSE 191,A00,958773,Minnes Kemp; Mor Mia,9999,0,9999,0
1745807680687,CSS 201S,A01,892054,Mignozzetti; Umberto,30,0,30,0
1745807681714,CSS 202S,A01,892056,Mignozzetti; Umberto,30,0,30,0
1745807682741,DSC 197,001,956898,Eldridge; Justin Matthew,9998,0,9999,1
1745807683766,DSC 297,001,958000,Mazumdar; Arya,9998,0,9999,1
1745807684792,EAP 100,A00,905686,Staff,9776,0,9999,223
1745807685818,ECE 45,A01,892618,Staff,0,12,50,50
1745807686844,ECE 109,A01,892620,Staff,0,44,0,0
1745807687868,ECE 111,A01,892719,Staff,0,8,50,50
1745807688894,ECE 197,001,957920,Mercier; Patrick Philip,9992,0,9999,7
1745807689921,ECON 178,A01,907814,Zhu; Ying,28,0,35,7
1745807690950,EDS 115,A00,895312,Staff,41,0,45,4
1745807691977,EDS 117,A01,895337,Staff,30,0,30,0
1745807693003,EDS 125,A00,895341,Jones; Gabrielle Anastasia,43,0,45,2
1745807694029,EDS 128A,A01,895459,Fargason; Sharon Gayle,44,0,45,1
1745807695055,EDS 128B,A01,895543,Pappas; Elizabeth,44,0,45,1
1745807696081,EDS 139,A00,897203,Pappas; Elizabeth,44,0,45,1
1745807696081,EDS 139,B00,897209,Fargason; Sharon Gayle,44,0,45,1
1745807697106,EDS 201,A00,895545,Staff,43,0,45,2
1745807698135,EDS 203,A01,895581,Halter; Christopher P.,43,0,45,2
1745807699161,EDS 204R,A01,895625,Heinzman; Erica M.,43,0,45,2
1745807699161,EDS 204R,B01,895693,Halter; Christopher P.,18,0,45,27
1745807700193,EDS 206R,A00,895694,Fargason; Sharon Gayle,9,0,30,21
1745807700193,EDS 206R,B00,895695,Choi; Bailey Miyeon,20,0,30,10
1745807701224,EDS 250,A00,895697,Hemans; Patricia Ann Benitez,43,0,45,2
1745807702257,EDS 281,A00,895701,Meyerott; Theresa Ann,15,0,15,0
1745807703304,EDS 284,A00,895736,Meyerott; Theresa Ann,15,0,15,0
1745807704329,EDS 286,A00,897210,Fine; Sarah,15,0,15,0
1745807705359,EDS 289C,A01,895770,Daly; Alan J.,15,0,15,0
1745807706386,EDS 290,A00,897211,Hofstetter; Carolyn,15,0,15,0
1745807707412,LIGM 5A,A00,896162,Fischer-Grunski; Eva K,15,0,20,5
1745807708438,LIGM 5B,A00,896260,Fischer-Grunski; Eva K,17,0,20,3
1745807709466,LIGM 5C,A00,896308,Fischer-Grunski; Eva K,18,0,20,2
1745807710490,LIIT 5AS,A00,896313,Carnelos; Chiara,18,0,20,2
1745807711517,LIIT 5BS,A00,896416,Carnelos; Chiara,20,0,20,0
1745807712543,LIIT 5CS,A00,896564,Carnelos; Chiara,20,0,20,0
1745807713571,LISP 5A,A00,896588,Munoz Sanchez; Alicia,4,0,20,16
1745807714597,LISP 5B,A00,896653,Munoz Sanchez; Alicia,10,0,20,10
1745807715625,LISP 5C,A00,896655,Munoz Sanchez; Alicia,4,0,20,16
1745807716652,MAE 197,001,957918,Kleissl; Jan,9998,0,9999,1
1745807717677,MATH 2,A01,957937,Staff,34,0,35,1
1745807718705,MATH 197,001,957876,Kedlaya; Kiran S.,9993,0,9999,6
1745807719736,MCWP 40,A00,892729,Duru; Nur,13,0,20,7
1745807719736,MCWP 40,B00,893304,Montejo; Carolina,20,0,20,0
1745807720760,MCWP 40R,A00,893757,Redela; Pamela Morgan,0,7,20,20
1745807721789,MCWP 50,A00,893758,Morshed; Michael James,2,0,20,18
1745807721789,MCWP 50,B00,893761,Bartulis; Jason Michael,17,0,20,3
1745807722818,MCWP 50R,A00,893766,Compas; Sean Matthew,0,1,20,20
1745807722818,MCWP 50R,B00,893769,Carter; Jennifer A,0,0,20,20
1745807722818,MCWP 50R,C00,893771,Krone; Jarret,0,3,20,20
1745807722818,MCWP 50R,D00,893772,Miller; Elizabeth Deen,3,0,20,17
1745807722818,MCWP 50R,E00,893775,Carter; Andrea L,0,0,20,20
1745807723847,MMW 11R,A01,892721,Herbst; Matthew,11,0,27,16
1745807723847,MMW 11R,A02,892722,Herbst; Matthew,0,0,0,3
1745807724895,MMW 12R,A01,892724,Herbst; Matthew,0,9,16,16
1745807724895,MMW 12R,A02,892725,Herbst; Matthew,0,9,16,16
1745807725919,MMW 13R,A01,892727,Staff,0,4,16,16
1745807725919,MMW 13R,A02,892728,Staff,0,4,16,16
1745807725919,MMW 13R,A03,958032,Staff,0,3,16,16
1745807725919,MMW 13R,A04,958033,Staff,0,2,16,16
1745807725919,MMW 13R,A05,958034,Staff,0,3,16,16
1745807726946,SIO 295LS,A00,894015,Staff,7,0,25,18
1745807727971,SIO 295S,A00,894020,Staff,7,0,25,18
1745807729000,SIOC 290S,B01,958918,Staff,0,0,0,0
1745807730027,SIOC 291S,B01,958922,Staff,0,0,0,0
1745807731054,SOCI 117,A01,895339,Staff,4,0,5,1
1745807732079,WES 237B,A00,894149,Staff,11,0,20,9
1745807734136,AESE 279B,A00,891859,Staff,13,0,35,22
1745807735165,AIP 197,001,891854,Staff,70,0,70,0
1745807736189,ANTH 289S,A00,891856,Gagneux; Pascal,12,0,12,0
1745807737216,BENG 196,001,957946,Engler; Adam J.,9996,0,9999,3
1745807738242,CAT 124RS,A01,956906,Staff,8,0,25,17
1745807739268,CAT 125RS,A01,922013,Staff,8,0,25,17
1745807740294,CLRE 250,A00,891860,Morris; Sheldon,9995,0,9999,4
1745807742345,CLRE 251R,A00,907817,Mehta; Ravindra L.,9994,0,9999,5
1745807743371,CLRE 252,A00,891864,Cuomo; Raphael Eduardo,9993,0,9999,6
1745807744397,CLRE 253,A00,891867,Vaida; Florin,9994,0,9999,5
1745807744397,CLRE 253,B00,907819,Staff,9999,0,9999,0
1745807745423,CLRE 259,A00,891868,Patel; Hemal,9998,0,9999,1
1745807746448,CLRE 260,A00,891872,Cuomo; Raphael Eduardo,9999,0,9999,0
1745807747473,CLRE 297,001,891888,Cuomo; Raphael Eduardo,9999,0,9999,0
1745807748511,CSE 191,A00,958773,Minnes Kemp; Mor Mia,9999,0,9999,0
1745807749539,CSS 201S,A01,892054,Mignozzetti; Umberto,30,0,30,0
1745807750568,CSS 202S,A01,892056,Mignozzetti; Umberto,30,0,30,0
1745807751596,DSC 197,001,956898,Eldridge; Justin Matthew,9998,0,9999,1
1745807752620,DSC 297,001,958000,Mazumdar; Arya,9998,0,9999,1
1745807753647,EAP 100,A00,905686,Staff,9776,0,9999,223
1745807754673,ECE 45,A01,892618,Staff,0,12,50,50
1745807755706,ECE 109,A01,892620,Staff,0,44,0,0
1745807756734,ECE 111,A01,892719,Staff,0,8,50,50
1745807757763,ECE 197,001,957920,Mercier; Patrick Philip,9992,0,9999,7
1745807758793,ECON 178,A01,907814,Zhu; Ying,28,0,35,7
1745807759819,EDS 115,A00,895312,Staff,41,0,45,4
1745807760845,EDS 117,A01,895337,Staff,30,0,30,0
1745807761873,EDS 125,A00,895341,Jones; Gabrielle Anastasia,43,0,45,2
1745807762901,EDS 128A,A01,895459,Fargason; Sharon Gayle,44,0,45,1
1745807763928,EDS 128B,A01,895543,Pappas; Elizabeth,44,0,45,1
1745807764956,EDS 139,A00,897203,Pappas; Elizabeth,44,0,45,1
1745807764956,EDS 139,B00,897209,Fargason; Sharon Gayle,44,0,45,1
1745807765987,EDS 201,A00,895545,Staff,43,0,45,2
1745807767017,EDS 203,A01,895581,Halter; Christopher P.,43,0,45,2
1745807768048,EDS 204R,A01,895625,Heinzman; Erica M.,43,0,45,2
1745807768048,EDS 204R,B01,895693,Halter; Christopher P.,18,0,45,27
1745807769078,EDS 206R,A00,895694,Fargason; Sharon Gayle,9,0,30,21
1745807769078,EDS 206R,B00,895695,Choi; Bailey Miyeon,20,0,30,10
1745807770103,EDS 250,A00,895697,Hemans; Patricia Ann Benitez,43,0,45,2
1745807771130,EDS 281,A00,895701,Meyerott; Theresa Ann,15,0,15,0
1745807772159,EDS 284,A00,895736,Meyerott; Theresa Ann,15,0,15,0
1745807773188,EDS 286,A00,897210,Fine; Sarah,15,0,15,0
1745807774217,EDS 289C,A01,895770,Daly; Alan J.,15,0,15,0
1745807775313,EDS 290,A00,897211,Hofstetter; Carolyn,15,0,15,0
1745807776340,LIGM 5A,A00,896162,Fischer-Grunski; Eva K,15,0,20,5
1745807777368,LIGM 5B,A00,896260,Fischer-Grunski; Eva K,17,0,20,3
1745807778393,LIGM 5C,A00,896308,Fischer-Grunski; Eva K,18,0,20,2
1745807779421,LIIT 5AS,A00,896313,Carnelos; Chiara,18,0,20,2
1745807780446,LIIT 5BS,A00,896416,Carnelos; Chiara,20,0,20,0
1745807781476,LIIT 5CS,A00,896564,Carnelos; Chiara,20,0,20,0
1745807782505,LISP 5A,A00,896588,Munoz Sanchez; Alicia,4,0,20,16
1745807783531,LISP 5B,A00,896653,Munoz Sanchez; Alicia,10,0,20,10
1745807784557,LISP 5C,A00,896655,Munoz Sanchez; Alicia,4,0,20,16
1745807785582,MAE 197,001,957918,Kleissl; Jan,9998,0,9999,1
1745807786608,MATH 2,A01,957937,Staff,34,0,35,1
1745807787636,MATH 197,001,957876,Kedlaya; Kiran S.,9993,0,9999,6
1745807788666,MCWP 40,A00,892729,Duru; Nur,13,0,20,7
1745807788666,MCWP 40,B00,893304,Montejo; Carolina,20,0,20,0
1745807789695,MCWP 40R,A00,893757,Redela; Pamela Morgan,0,7,20,20
1745807790722,MCWP 50,A00,893758,Morshed; Michael James,2,0,20,18
1745807790722,MCWP 50,B00,893761,Bartulis; Jason Michael,17,0,20,3
1745807791749,MCWP 50R,A00,893766,Compas; Sean Matthew,0,1,20,20
1745807791749,MCWP 50R,B00,893769,Carter; Jennifer A,0,0,20,20
1745807791749,MCWP 50R,C00,893771,Krone; Jarret,0,3,20,20
1745807791749,MCWP 50R,D00,893772,Miller; Elizabeth Deen,3,0,20,17
1745807791749,MCWP 50R,E00,893775,Carter; Andrea L,0,0,20,20
1745807792773,MMW 11R,A01,892721,Herbst; Matthew,11,0,27,16
1745807792773,MMW 11R,A02,892722,Herbst; Matthew,0,0,0,3
1745807793798,MMW 12R,A01,892724,Herbst; Matthew,0,9,16,16
1745807793798,MMW 12R,A02,892725,Herbst; Matthew,0,9,16,16
1745807794825,MMW 13R,A01,892727,Staff,0,4,16,16
1745807794825,MMW 13R,A02,892728,Staff,0,4,16,16
1745807794825,MMW 13R,A03,958032,Staff,0,3,16,16
1745807794825,MMW 13R,A04,958033,Staff,0,2,16,16
1745807794825,MMW 13R,A05,958034,Staff,0,3,16,16
1745807795851,SIO 295LS,A00,894015,Staff,7,0,25,18
1745807796877,SIO 295S,A00,894020,Staff,7,0,25,18
1745807797904,SIOC 290S,B01,958918,Staff,0,0,0,0
1745807798934,SIOC 291S,B01,958922,Staff,0,0,0,0
1745807799958,SOCI 117,A01,895339,Staff,4,0,5,1
1745807800983,WES 237B,A00,894149,Staff,11,0,20,9
1745807803042,AESE 279B,A00,891859,Staff,13,0,35,22
1745807804069,AIP 197,001,891854,Staff,70,0,70,0
1745807805096,ANTH 289S,A00,891856,Gagneux; Pascal,12,0,12,0
1745807806122,BENG 196,001,957946,Engler; Adam J.,9996,0,9999,3
1745807807150,CAT 124RS,A01,956906,Staff,8,0,25,17
1745807808175,CAT 125RS,A01,922013,Staff,8,0,25,17
1745807809202,CLRE 250,A00,891860,Morris; Sheldon,9995,0,9999,4
1745807811259,CLRE 251R,A00,907817,Mehta; Ravindra L.,9994,0,9999,5
1745807812309,CLRE 252,A00,891864,Cuomo; Raphael Eduardo,9993,0,9999,6
1745807813335,CLRE 253,A00,891867,Vaida; Florin,9994,0,9999,5
1745807813335,CLRE 253,B00,907819,Staff,9999,0,9999,0
1745807814361,CLRE 259,A00,891868,Patel; Hemal,9998,0,9999,1
1745807815388,CLRE 260,A00,891872,Cuomo; Raphael Eduardo,9999,0,9999,0
1745807816418,CLRE 297,001,891888,Cuomo; Raphael Eduardo,9999,0,9999,0
1745807817445,CSE 191,A00,958773,Minnes Kemp; Mor Mia,9999,0,9999,0
1745807818468,CSS 201S,A01,892054,Mignozzetti; Umberto,30,0,30,0
1745807819493,CSS 202S,A01,892056,Mignozzetti; Umberto,30,0,30,0
1745807820517,DSC 197,001,956898,Eldridge; Justin Matthew,9998,0,9999,1
1745807821545,DSC 297,001,958000,Mazumdar; Arya,9998,0,9999,1
1745807822570,EAP 100,A00,905686,Staff,9776,0,9999,223
1745807823596,ECE 45,A01,892618,Staff,0,12,50,50
1745807824622,ECE 109,A01,892620,Staff,0,44,0,0
1745807825650,ECE 111,A01,892719,Staff,0,8,50,50
1745807826675,ECE 197,001,957920,Mercier; Patrick Philip,9992,0,9999,7
1745807827702,ECON 178,A01,907814,Zhu; Ying,28,0,35,7
1745807828732,EDS 115,A00,895312,Staff,41,0,45,4
1745807829759,EDS 117,A01,895337,Staff,30,0,30,0
1745807830784,EDS 125,A00,895341,Jones; Gabrielle Anastasia,43,0,45,2
1745807831810,EDS 128A,A01,895459,Fargason; Sharon Gayle,44,0,45,1
1745807832837,EDS 128B,A01,895543,Pappas; Elizabeth,44,0,45,1
1745807833861,EDS 139,A00,897203,Pappas; Elizabeth,44,0,45,1
1745807833861,EDS 139,B00,897209,Fargason; Sharon Gayle,44,0,45,1
1745807834886,EDS 201,A00,895545,Staff,43,0,45,2
1745807835912,EDS 203,A01,895581,Halter; Christopher P.,43,0,45,2
1745807836938,EDS 204R,A01,895625,Heinzman; Erica M.,43,0,45,2
1745807836938,EDS 204R,B01,895693,Halter; Christopher P.,18,0,45,27
1745807837964,EDS 206R,A00,895694,Fargason; Sharon Gayle,9,0,30,21
1745807837964,EDS 206R,B00,895695,Choi; Bailey Miyeon,20,0,30,10
1745807838992,EDS 250,A00,895697,Hemans; Patricia Ann Benitez,43,0,45,2
1745807840018,EDS 281,A00,895701,Meyerott; Theresa Ann,15,0,15,0
1745807841044,EDS 284,A00,895736,Meyerott; Theresa Ann,15,0,15,0
1745807842069,EDS 286,A00,897210,Fine; Sarah,15,0,15,0
1745807843098,EDS 289C,A01,895770,Daly; Alan J.,15,0,15,0
1745807844127,EDS 290,A00,897211,Hofstetter; Carolyn,15,0,15,0
1745807845155,LIGM 5A,A00,896162,Fischer-Grunski; Eva K,15,0,20,5
1745807846179,LIGM 5B,A00,896260,Fischer-Grunski; Eva K,17,0,20,3
1745807847204,LIGM 5C,A00,896308,Fischer-Grunski; Eva K,18,0,20,2
1745807848230,LIIT 5AS,A00,896313,Carnelos; Chiara,18,0,20,2
1745807849254,LIIT 5BS,A00,896416,Carnelos; Chiara,20,0,20,0
1745807850281,LIIT 5CS,A00,896564,Carnelos; Chiara,20,0,20,0
1745807851312,LISP 5A,A00,896588,Munoz Sanchez; Alicia,4,0,20,16
1745807852339,LISP 5B,A00,896653,Munoz Sanchez; Alicia,10,0,20,10
1745807853369,LISP 5C,A00,896655,Munoz Sanchez; Alicia,4,0,20,16
1745807854396,MAE 197,001,957918,Kleissl; Jan,9998,0,9999,1
1745807855424,MATH 2,A01,957937,Staff,34,0,35,1
1745807856448,MATH 197,001,957876,Kedlaya; Kiran S.,9993,0,9999,6
1745807857471,MCWP 40,A00,892729,Duru; Nur,13,0,20,7
1745807857471,MCWP 40,B00,893304,Montejo; Carolina,20,0,20,0
1745807858496,MCWP 40R,A00,893757,Redela; Pamela Morgan,0,7,20,20
1745807859521,MCWP 50,A00,893758,Morshed; Michael James,2,0,20,18
1745807859521,MCWP 50,B00,893761,Bartulis; Jason Michael,17,0,20,3
1745807860545,MCWP 50R,A00,893766,Compas; Sean Matthew,0,1,20,20
1745807860545,MCWP 50R,B00,893769,Carter; Jennifer A,0,0,20,20
1745807860545,MCWP 50R,C00,893771,Krone; Jarret,0,3,20,20
1745807860545,MCWP 50R,D00,893772,Miller; Elizabeth Deen,3,0,20,17
1745807860545,MCWP 50R,E00,893775,Carter; Andrea L,0,0,20,20
1745807861571,MMW 11R,A01,892721,Herbst; Matthew,11,0,27,16
1745807861571,MMW 11R,A02,892722,Herbst; Matthew,0,0,0,3
1745807862599,MMW 12R,A01,892724,Herbst; Matthew,0,9,16,16
1745807862599,MMW 12R,A02,892725,Herbst; Matthew,0,9,16,16
1745807863626,MMW 13R,A01,892727,Staff,0,4,16,16
1745807863626,MMW 13R,A02,892728,Staff,0,4,16,16
1745807863626,MMW 13R,A03,958032,Staff,0,3,16,16
1745807863626,MMW 13R,A04,958033,Staff,0,2,16,16
1745807863626,MMW 13R,A05,958034,Staff,0,3,16,16
1745807864654,SIO 295LS,A00,894015,Staff,7,0,25,18
1745807865678,SIO 295S,A00,894020,Staff,7,0,25,18
1745807866704,SIOC 290S,B01,958918,Staff,0,0,0,0
1745807867730,SIOC 291S,B01,958922,Staff,0,0,0,0
1745807868757,SOCI 117,A01,895339,Staff,4,0,5,1
1745807869783,WES 237B,A00,894149,Staff,11,0,20,9
1745807871843,AESE 279B,A00,891859,Staff,13,0,35,22
1745807872871,AIP 197,001,891854,Staff,70,0,70,0
1745807873899,ANTH 289S,A00,891856,Gagneux; Pascal,12,0,12,0
1745807874922,BENG 196,001,957946,Engler; Adam J.,9996,0,9999,3
1745807875951,CAT 124RS,A01,956906,Staff,8,0,25,17
1745807876976,CAT 125RS,A01,922013,Staff,8,0,25,17
1745807878004,CLRE 250,A00,891860,Morris; Sheldon,9995,0,9999,4
1745807880058,CLRE 251R,A00,907817,Mehta; Ravindra L.,9994,0,9999,5
1745807881083,CLRE 252,A00,891864,Cuomo; Raphael Eduardo,9993,0,9999,6
1745807882113,CLRE 253,A00,891867,Vaida; Florin,9994,0,9999,5
1745807882113,CLRE 253,B00,907819,Staff,9999,0,9999,0
1745807883138,CLRE 259,A00,891868,Patel; Hemal,9998,0,9999,1
1745807884164,CLRE 260,A00,891872,Cuomo; Raphael Eduardo,9999,0,9999,0
1745807885194,CLRE 297,001,891888,Cuomo; Raphael Eduardo,9999,0,9999,0
1745807886224,CSE 191,A00,958773,Minnes Kemp; Mor Mia,9999,0,9999,0
1745807887256,CSS 201S,A01,892054,Mignozzetti; Umberto,30,0,30,0
1745807888284,CSS 202S,A01,892056,Mignozzetti; Umberto,30,0,30,0
1745807889312,DSC 197,001,956898,Eldridge; Justin Matthew,9998,0,9999,1
1745807890337,DSC 297,001,958000,Mazumdar; Arya,9998,0,9999,1
1745807891363,EAP 100,A00,905686,Staff,9776,0,9999,223
1745807892403,ECE 45,A01,892618,Staff,0,12,50,50
1745807893428,ECE 109,A01,892620,Staff,0,44,0,0
1745807894458,ECE 111,A01,892719,Staff,0,8,50,50
1745807895483,ECE 197,001,957920,Mercier; Patrick Philip,9992,0,9999,7
1745807896511,ECON 178,A01,907814,Zhu; Ying,28,0,35,7
1745807897540,EDS 115,A00,895312,Staff,41,0,45,4
1745807898565,EDS 117,A01,895337,Staff,30,0,30,0
1745807899591,EDS 125,A00,895341,Jones; Gabrielle Anastasia,43,0,45,2
1745807900619,EDS 128A,A01,895459,Fargason; Sharon Gayle,44,0,45,1
1745807901646,EDS 128B,A01,895543,Pappas; Elizabeth,44,0,45,1
1745807902671,EDS 139,A00,897203,Pappas; Elizabeth,44,0,45,1
1745807902671,EDS 139,B00,897209,Fargason; Sharon Gayle,44,0,45,1
1745807903696,EDS 201,A00,895545,Staff,43,0,45,2
1745807904724,EDS 203,A01,895581,Halter; Christopher P.,43,0,45,2
1745807905750,EDS 204R,A01,895625,Heinzman; Erica M.,43,0,45,2
1745807905750,EDS 204R,B01,895693,Halter; Christopher P.,18,0,45,27
1745807906777,EDS 206R,A00,895694,Fargason; Sharon Gayle,9,0,30,21
1745807906777,EDS 206R,B00,895695,Choi; Bailey Miyeon,20,0,30,10
1745807907802,EDS 250,A00,895697,Hemans; Patricia Ann Benitez,43,0,45,2
1745807908833,EDS 281,A00,895701,Meyerott; Theresa Ann,15,0,15,0
1745807909857,EDS 284,A00,895736,Meyerott; Theresa Ann,15,0,15,0
1745807910886,EDS 286,A00,897210,Fine; Sarah,15,0,15,0
1745807911914,EDS 289C,A01,895770,Daly; Alan J.,15,0,15,0
1745807912942,EDS 290,A00,897211,Hofstetter; Carolyn,15,0,15,0
1745807913969,LIGM 5A,A00,896162,Fischer-Grunski; Eva K,15,0,20,5
1745807914996,LIGM 5B,A00,896260,Fischer-Grunski; Eva K,17,0,20,3
1745807916023,LIGM 5C,A00,896308,Fischer-Grunski; Eva K,18,0,20,2
1745807917054,LIIT 5AS,A00,896313,Carnelos; Chiara,18,0,20,2
1745807918084,LIIT 5BS,A00,896416,Carnelos; Chiara,20,0,20,0
1745807919110,LIIT 5CS,A00,896564,Carnelos; Chiara,20,0,20,0
1745807920138,LISP 5A,A00,896588,Munoz Sanchez; Alicia,4,0,20,16
1745807921163,LISP 5B,A00,896653,Munoz Sanchez; Alicia,10,0,20,10
1745807922192,LISP 5C,A00,896655,Munoz Sanchez; Alicia,4,0,20,16
1745807923220,MAE 197,001,957918,Kleissl; Jan,9998,0,9999,1
1745807924245,MATH 2,A01,957937,Staff,34,0,35,1
1745807925274,MATH 197,001,957876,Kedlaya; Kiran S.,9993,0,9999,6
1745807926302,MCWP 40,A00,892729,Duru; Nur,13,0,20,7
1745807926302,MCWP 40,B00,893304,Montejo; Carolina,20,0,20,0
1745807927329,MCWP 40R,A00,893757,Redela; Pamela Morgan,0,7,20,20
1745807928356,MCWP 50,A00,893758,Morshed; Michael James,2,0,20,18
1745807928356,MCWP 50,B00,893761,Bartulis; Jason Michael,17,0,20,3
1745807929387,MCWP 50R,A00,893766,Compas; Sean Matthew,0,1,20,20
1745807929387,MCWP 50R,B00,893769,Carter; Jennifer A,0,0,20,20
1745807929387,MCWP 50R,C00,893771,Krone; Jarret,0,3,20,20
1745807929387,MCWP 50R,D00,893772,Miller; Elizabeth Deen,3,0,20,17
1745807929387,MCWP 50R,E00,893775,Carter; Andrea L,0,0,20,20
1745807930415,MMW 11R,A01,892721,Herbst; Matthew,11,0,27,16
1745807930415,MMW 11R,A02,892722,Herbst; Matthew,0,0,0,3
1745807931439,MMW 12R,A01,892724,Herbst; Matthew,0,9,16,16
1745807931439,MMW 12R,A02,892725,Herbst; Matthew,0,9,16,16
1745807932463,MMW 13R,A01,892727,Staff,0,4,16,16
1745807932463,MMW 13R,A02,892728,Staff,0,4,16,16
1745807932463,MMW 13R,A03,958032,Staff,0,3,16,16
1745807932463,MMW 13R,A04,958033,Staff,0,2,16,16
1745807932463,MMW 13R,A05,958034,Staff,0,3,16,16
1745807933492,SIO 295LS,A00,894015,Staff,7,0,25,18
1745807934521,SIO 295S,A00,894020,Staff,7,0,25,18
1745807935545,SIOC 290S,B01,958918,Staff,0,0,0,0
1745807936575,SIOC 291S,B01,958922,Staff,0,0,0,0
1745807937602,SOCI 117,A01,895339,Staff,4,0,5,1
1745807938626,WES 237B,A00,894149,Staff,11,0,20,9
1745807940683,AESE 279B,A00,891859,Staff,13,0,35,22
1745807941710,AIP 197,001,891854,Staff,70,0,70,0
1745807942738,ANTH 289S,A00,891856,Gagneux; Pascal,12,0,12,0
1745807943766,BENG 196,001,957946,Engler; Adam J.,9996,0,9999,3
1745807944793,CAT 124RS,A01,956906,Staff,8,0,25,17
1745807945819,CAT 125RS,A01,922013,Staff,8,0,25,17
1745807946846,CLRE 250,A00,891860,Morris; Sheldon,9995,0,9999,4
1745807948902,CLRE 251R,A00,907817,Mehta; Ravindra L.,9994,0,9999,5
1745807949932,CLRE 252,A00,891864,Cuomo; Raphael Eduardo,9993,0,9999,6
1745807950955,CLRE 253,A00,891867,Vaida; Florin,9994,0,9999,5
1745807950955,CLRE 253,B00,907819,Staff,9999,0,9999,0
1745807951984,CLRE 259,A00,891868,Patel; Hemal,9998,0,9999,1
1745807953009,CLRE 260,A00,891872,Cuomo; Raphael Eduardo,9999,0,9999,0
1745807954037,CLRE 297,001,891888,Cuomo; Raphael Eduardo,9999,0,9999,0
1745807955064,CSE 191,A00,958773,Minnes Kemp; Mor Mia,9999,0,9999,0
1745807956089,CSS 201S,A01,892054,Mignozzetti; Umberto,30,0,30,0
1745807957118,CSS 202S,A01,892056,Mignozzetti; Umberto,30,0,30,0
1745807958145,DSC 197,001,956898,Eldridge; Justin Matthew,9998,0,9999,1
1745807959171,DSC 297,001,958000,Mazumdar; Arya,9998,0,9999,1
1745807960198,EAP 100,A00,905686,Staff,9776,0,9999,223
1745807961224,ECE 45,A01,892618,Staff,0,12,50,50
1745807962255,ECE 109,A01,892620,Staff,0,44,0,0
1745807963283,ECE 111,A01,892719,Staff,0,8,50,50
1745807964314,ECE 197,001,957920,Mercier; Patrick Philip,9992,0,9999,7
1745807965344,ECON 178,A01,907814,Zhu; Ying,28,0,35,7
1745807966373,EDS 115,A00,895312,Staff,41,0,45,4
1745807967402,EDS 117,A01,895337,Staff,30,0,30,0
1745807968430,EDS 125,A00,895341,Jones; Gabrielle Anastasia,43,0,45,2
1745807969455,EDS 128A,A01,895459,Fargason; Sharon Gayle,44,0,45,1
1745807970485,EDS 128B,A01,895543,Pappas; Elizabeth,44,0,45,1
1745807971512,EDS 139,A00,897203,Pappas; Elizabeth,44,0,45,1
1745807971512,EDS 139,B00,897209,Fargason; Sharon Gayle,44,0,45,1
1745807972537,EDS 201,A00,895545,Staff,43,0,45,2
1745807973561,EDS 203,A01,895581,Halter; Christopher P.,43,0,45,2
1745807974588,EDS 204R,A01,895625,Heinzman; Erica M.,43,0,45,2
1745807974588,EDS 204R,B01,895693,Halter; Christopher P.,18,0,45,27
1745807975615,EDS 206R,A00,895694,Fargason; Sharon Gayle,9,0,30,21
1745807975615,EDS 206R,B00,895695,Choi; Bailey Miyeon,20,0,30,10
1745807976644,EDS 250,A00,895697,Hemans; Patricia Ann Benitez,43,0,45,2
1745807977668,EDS 281,A00,895701,Meyerott; Theresa Ann,15,0,15,0
1745807978693,EDS 284,A00,895736,Meyerott; Theresa Ann,15,0,15,0
1745807979721,EDS 286,A00,897210,Fine; Sarah,15,0,15,0
1745807980748,EDS 289C,A01,895770,Daly; Alan J.,15,0,15,0
1745807981777,EDS 290,A00,897211,Hofstetter; Carolyn,15,0,15,0
1745807982804,LIGM 5A,A00,896162,Fischer-Grunski; Eva K,15,0,20,5
1745807983834,LIGM 5B,A00,896260,Fischer-Grunski; Eva K,17,0,20,3
1745807984862,LIGM 5C,A00,896308,Fischer-Grunski; Eva K,18,0,20,2
1745807985894,LIIT 5AS,A00,896313,Carnelos; Chiara,18,0,20,2
1745807986924,LIIT 5BS,A00,896416,Carnelos; Chiara,20,0,20,0
1745807987951,LIIT 5CS,A00,896564,Carnelos; Chiara,20,0,20,0
1745807988977,LISP 5A,A00,896588,Munoz Sanchez; Alicia,4,0,20,16
1745807990003,LISP 5B,A00,896653,Munoz Sanchez; Alicia,10,0,20,10
1745807991032,LISP 5C,A00,896655,Munoz Sanchez; Alicia,4,0,20,16
1745807992061,MAE 197,001,957918,Kleissl; Jan,9998,0,9999,1
1745807993087,MATH 2,A01,957937,Staff,34,0,35,1
1745807994116,MATH 197,001,957876,Kedlaya; Kiran S.,9993,0,9999,6
1745807995143,MCWP 40,A00,892729,Duru; Nur,13,0,20,7
1745807995143,MCWP 40,B00,893304,Montejo; Carolina,20,0,20,0
1745807996171,MCWP 40R,A00,893757,Redela; Pamela Morgan,0,7,20,20
1745807997200,MCWP 50,A00,893758,Morshed; Michael James,2,0,20,18
1745807997200,MCWP 50,B00,893761,Bartulis; Jason Michael,17,0,20,3
1745807998226,MCWP 50R,A00,893766,Compas; Sean Matthew,0,1,20,20
1745807998226,MCWP 50R,B00,893769,Carter; Jennifer A,0,0,20,20
1745807998226,MCWP 50R,C00,893771,Krone; Jarret,0,3,20,20
1745807998226,MCWP 50R,D00,893772,Miller; Elizabeth Deen,3,0,20,17
1745807998226,MCWP 50R,E00,893775,Carter; Andrea L,0,0,20,20
1745807999257,MMW 11R,A01,892721,Herbst; Matthew,11,0,27,16
1745807999257,MMW 11R,A02,892722,Herbst; Matthew,0,0,0,3
1745808000285,MMW 12R,A01,892724,Herbst; Matthew,0,9,16,16
1745808000285,MMW 12R,A02,892725,Herbst; Matthew,0,9,16,16
1745808001314,MMW 13R,A01,892727,Staff,0,4,16,16
1745808001314,MMW 13R,A02,892728,Staff,0,4,16,16
1745808001314,MMW 13R,A03,958032,Staff,0,3,16,16
1745808001314,MMW 13R,A04,958033,Staff,0,2,16,16
1745808001314,MMW 13R,A05,958034,Staff,0,3,16,16
1745808002343,SIO 295LS,A00,894015,Staff,7,0,25,18
1745808003369,SIO 295S,A00,894020,Staff,7,0,25,18
1745808004402,SIOC 290S,B01,958918,Staff,0,0,0,0
1745808005430,SIOC 291S,B01,958922,Staff,0,0,0,0
1745808006454,SOCI 117,A01,895339,Staff,4,0,5,1
1745808007484,WES 237B,A00,894149,Staff,11,0,20,9
1745808009542,AESE 279B,A00,891859,Staff,13,0,35,22
1745808010571,AIP 197,001,891854,Staff,70,0,70,0
1745808011600,ANTH 289S,A00,891856,Gagneux; Pascal,12,0,12,0
1745808012629,BENG 196,001,957946,Engler; Adam J.,9996,0,9999,3
1745808013652,CAT 124RS,A01,956906,Staff,8,0,25,17
1745808014681,CAT 125RS,A01,922013,Staff,8,0,25,17
1745808015711,CLRE 250,A00,891860,Morris; Sheldon,9995,0,9999,4
1745808017775,CLRE 251R,A00,907817,Mehta; Ravindra L.,9994,0,9999,5
1745808018802,CLRE 252,A00,891864,Cuomo; Raphael Eduardo,9993,0,9999,6
1745808019827,CLRE 253,A00,891867,Vaida; Florin,9994,0,9999,5
1745808019827,CLRE 253,B00,907819,Staff,9999,0,9999,0
1745808020853,CLRE 259,A00,891868,Patel; Hemal,9998,0,9999,1
1745808021878,CLRE 260,A00,891872,Cuomo; Raphael Eduardo,9999,0,9999,0
1745808022906,CLRE 297,001,891888,Cuomo; Raphael Eduardo,9999,0,9999,0
1745808023932,CSE 191,A00,958773,Minnes Kemp; Mor Mia,9999,0,9999,0
1745808024966,CSS 201S,A01,892054,Mignozzetti; Umberto,30,0,30,0
1745808025995,CSS 202S,A01,892056,Mignozzetti; Umberto,30,0,30,0
1745808027028,DSC 197,001,956898,Eldridge; Justin Matthew,9998,0,9999,1
1745808028056,DSC 297,001,958000,Mazumdar; Arya,9998,0,9999,1
1745808029083,EAP 100,A00,905686,Staff,9776,0,9999,223
1745808030113,ECE 45,A01,892618,Staff,0,12,50,50
1745808031138,ECE 109,A01,892620,Staff,0,44,0,0
1745808032165,ECE 111,A01,892719,Staff,0,8,50,50
1745808033191,ECE 197,001,957920,Mercier; Patrick Philip,9992,0,9999,7
1745808034222,ECON 178,A01,907814,Zhu; Ying,28,0,35,7
1745808035251,EDS 115,A00,895312,Staff,41,0,45,4
1745808036278,EDS 117,A01,895337,Staff,30,0,30,0
1745808037306,EDS 125,A00,895341,Jones; Gabrielle Anastasia,43,0,45,2
1745808038332,EDS 128A,A01,895459,Fargason; Sharon Gayle,44,0,45,1
1745808039359,EDS 128B,A01,895543,Pappas; Elizabeth,44,0,45,1
1745808040384,EDS 139,A00,897203,Pappas; Elizabeth,44,0,45,1
1745808040384,EDS 139,B00,897209,Fargason; Sharon Gayle,44,0,45,1
1745808041411,EDS 201,A00,895545,Staff,43,0,45,2
1745808042439,EDS 203,A01,895581,Halter; Christopher P.,43,0,45,2
1745808043467,EDS 204R,A01,895625,Heinzman; Erica M.,43,0,45,2
1745808043467,EDS 204R,B01,895693,Halter; Christopher P.,18,0,45,27
1745808044495,EDS 206R,A00,895694,Fargason; Sharon Gayle,9,0,30,21
1745808044495,EDS 206R,B00,895695,Choi; Bailey Miyeon,20,0,30,10
1745808045521,EDS 250,A00,895697,Hemans; Patricia Ann Benitez,43,0,45,2
1745808046547,EDS 281,A00,895701,Meyerott; Theresa Ann,15,0,15,0
1745808047582,EDS 284,A00,895736,Meyerott; Theresa Ann,15,0,15,0
1745808048607,EDS 286,A00,897210,Fine; Sarah,15,0,15,0
1745808049632,EDS 289C,A01,895770,Daly; Alan J.,15,0,15,0
1745808050657,EDS 290,A00,897211,Hofstetter; Carolyn,15,0,15,0
1745808051683,LIGM 5A,A00,896162,Fischer-Grunski; Eva K,15,0,20,5
1745808052713,LIGM 5B,A00,896260,Fischer-Grunski; Eva K,17,0,20,3
1745808053743,LIGM 5C,A00,896308,Fischer-Grunski; Eva K,18,0,20,2
1745808054769,LIIT 5AS,A00,896313,Carnelos; Chiara,18,0,20,2
1745808055798,LIIT 5BS,A00,896416,Carnelos; Chiara,20,0,20,0
1745808056826,LIIT 5CS,A00,896564,Carnelos; Chiara,20,0,20,0
1745808057853,LISP 5A,A00,896588,Munoz Sanchez; Alicia,4,0,20,16
1745808058881,LISP 5B,A00,896653,Munoz Sanchez; Alicia,10,0,20,10
1745808059907,LISP 5C,A00,896655,Munoz Sanchez; Alicia,4,0,20,16
1745808060934,MAE 197,001,957918,Kleissl; Jan,9998,0,9999,1
1745808061962,MATH 2,A01,957937,Staff,34,0,35,1
1745808062990,MATH 197,001,957876,Kedlaya; Kiran S.,9993,0,9999,6
1745808064015,MCWP 40,A00,892729,Duru; Nur,13,0,20,7
1745808064015,MCWP 40,B00,893304,Montejo; Carolina,20,0,20,0
1745808065040,MCWP 40R,A00,893757,Redela; Pamela Morgan,0,7,20,20
1745808066068,MCWP 50,A00,893758,Morshed; Michael James,2,0,20,18
1745808066068,MCWP 50,B00,893761,Bartulis; Jason Michael,17,0,20,3
1745808067095,MCWP 50R,A00,893766,Compas; Sean Matthew,0,1,20,20
1745808067095,MCWP 50R,B00,893769,Carter; Jennifer A,0,0,20,20
1745808067095,MCWP 50R,C00,893771,Krone; Jarret,0,3,20,20
1745808067095,MCWP 50R,D00,893772,Miller; Elizabeth Deen,3,0,20,17
1745808067095,MCWP 50R,E00,893775,Carter; Andrea L,0,0,20,20
1745808068121,MMW 11R,A01,892721,Herbst; Matthew,11,0,27,16
1745808068121,MMW 11R,A02,892722,Herbst; Matthew,0,0,0,3
1745808069145,MMW 12R,A01,892724,Herbst; Matthew,0,9,16,16
1745808069145,MMW 12R,A02,892725,Herbst; Matthew,0,9,16,16
1745808070172,MMW 13R,A01,892727,Staff,0,4,16,16
1745808070172,MMW 13R,A02,892728,Staff,0,4,16,16
1745808070172,MMW 13R,A03,958032,Staff,0,3,16,16
1745808070172,MMW 13R,A04,958033,Staff,0,2,16,16
1745808070172,MMW 13R,A05,958034,Staff,0,3,16,16
1745808071198,SIO 295LS,A00,894015,Staff,7,0,25,18
1745808072227,SIO 295S,A00,894020,Staff,7,0,25,18
1745808073257,SIOC 290S,B01,958918,Staff,0,0,0,0
1745808074284,SIOC 291S,B01,958922,Staff,0,0,0,0
1745808075314,SOCI 117,A01,895339,Staff,4,0,5,1
1745808076340,WES 237B,A00,894149,Staff,11,0,20,9
1745808078404,AESE 279B,A00,891859,Staff,13,0,35,22
1745808079431,AIP 197,001,891854,Staff,70,0,70,0
1745808080456,ANTH 289S,A00,891856,Gagneux; Pascal,12,0,12,0
1745808081483,BENG 196,001,957946,Engler; Adam J.,9996,0,9999,3
1745808082511,CAT 124RS,A01,956906,Staff,8,0,25,17
1745808083539,CAT 125RS,A01,922013,Staff,8,0,25,17
1745808084565,CLRE 250,A00,891860,Morris; Sheldon,9995,0,9999,4
1745808086619,CLRE 251R,A00,907817,Mehta; Ravindra L.,9994,0,9999,5
1745808087644,CLRE 252,A00,891864,Cuomo; Raphael Eduardo,9993,0,9999,6
1745808088670,CLRE 253,A00,891867,Vaida; Florin,9994,0,9999,5
1745808088670,CLRE 253,B00,907819,Staff,9999,0,9999,0
1745808089695,CLRE 259,A00,891868,Patel; Hemal,9998,0,9999,1
1745808090723,CLRE 260,A00,891872,Cuomo; Raphael Eduardo,9999,0,9999,0
1745808091752,CLRE 297,001,891888,Cuomo; Raphael Eduardo,9999,0,9999,0
1745808092782,CSE 191,A00,958773,Minnes Kemp; Mor Mia,9999,0,9999,0
1745808093810,CSS 201S,A01,892054,Mignozzetti; Umberto,30,0,30,0
1745808094837,CSS 202S,A01,892056,Mignozzetti; Umberto,30,0,30,0
1745808095864,DSC 197,001,956898,Eldridge; Justin Matthew,9998,0,9999,1
1745808096889,DSC 297,001,958000,Mazumdar; Arya,9998,0,9999,1
1745808097919,EAP 100,A00,905686,Staff,9776,0,9999,223
1745808098947,ECE 45,A01,892618,Staff,0,12,50,50
1745808099973,ECE 109,A01,892620,Staff,0,44,0,0
1745808101002,ECE 111,A01,892719,Staff,0,8,50,50
1745808102031,ECE 197,001,957920,Mercier; Patrick Philip,9992,0,9999,7
1745808103054,ECON 178,A01,907814,Zhu; Ying,28,0,35,7
1745808104081,EDS 115,A00,895312,Staff,41,0,45,4
1745808105107,EDS 117,A01,895337,Staff,30,0,30,0
1745808106133,EDS 125,A00,895341,Jones; Gabrielle Anastasia,43,0,45,2
1745808107163,EDS 128A,A01,895459,Fargason; Sharon Gayle,44,0,45,1
1745808108221,EDS 128B,A01,895543,Pappas; Elizabeth,44,0,45,1
1745808109249,EDS 139,A00,897203,Pappas; Elizabeth,44,0,45,1
1745808109249,EDS 139,B00,897209,Fargason; Sharon Gayle,44,0,45,1
1745808110275,EDS 201,A00,895545,Staff,43,0,45,2
1745808111305,EDS 203,A01,895581,Halter; Christopher P.,43,0,45,2
1745808112332,EDS 204R,A01,895625,Heinzman; Erica M.,43,0,45,2
1745808112332,EDS 204R,B01,895693,Halter; Christopher P.,18,0,45,27
1745808113360,EDS 206R,A00,895694,Fargason; Sharon Gayle,9,0,30,21
1745808113360,EDS 206R,B00,895695,Choi; Bailey Miyeon,20,0,30,10
1745808114388,EDS 250,A00,895697,Hemans; Patricia Ann Benitez,43,0,45,2
1745808115414,EDS 281,A00,895701,Meyerott; Theresa Ann,15,0,15,0
1745808116443,EDS 284,A00,895736,Meyerott; Theresa Ann,15,0,15,0
1745808117470,EDS 286,A00,897210,Fine; Sarah,15,0,15,0
1745808118495,EDS 289C,A01,895770,Daly; Alan J.,15,0,15,0
1745808119521,EDS 290,A00,897211,Hofstetter; Carolyn,15,0,15,0
1745808120550,LIGM 5A,A00,896162,Fischer-Grunski; Eva K,15,0,20,5
1745808121577,LIGM 5B,A00,896260,Fischer-Grunski; Eva K,17,0,20,3
1745808122607,LIGM 5C,A00,896308,Fischer-Grunski; Eva K,18,0,20,2
1745808123633,LIIT 5AS,A00,896313,Carnelos; Chiara,18,0,20,2
1745808124660,LIIT 5BS,A00,896416,Carnelos; Chiara,20,0,20,0
1745808125689,LIIT 5CS,A00,896564,Carnelos; Chiara,20,0,20,0
1745808126718,LISP 5A,A00,896588,Munoz Sanchez; Alicia,4,0,20,16
1745808127746,LISP 5B,A00,896653,Munoz Sanchez; Alicia,10,0,20,10
1745808128771,LISP 5C,A00,896655,Munoz Sanchez; Alicia,4,0,20,16
1745808129795,MAE 197,001,957918,Kleissl; Jan,9998,0,9999,1
1745808130822,MATH 2,A01,957937,Staff,34,0,35,1
1745808131848,MATH 197,001,957876,Kedlaya; Kiran S.,9993,0,9999,6
1745808132877,MCWP 40,A00,892729,Duru; Nur,13,0,20,7
1745808132877,MCWP 40,B00,893304,Montejo; Carolina,20,0,20,0
1745808133906,MCWP 40R,A00,893757,Redela; Pamela Morgan,0,7,20,20
1745808134933,MCWP 50,A00,893758,Morshed; Michael James,2,0,20,18
1745808134933,MCWP 50,B00,893761,Bartulis; Jason Michael,17,0,20,3
1745808135960,MCWP 50R,A00,893766,Compas; Sean Matthew,0,1,20,20
1745808135960,MCWP 50R,B00,893769,Carter; Jennifer A,0,0,20,20
1745808135960,MCWP 50R,C00,893771,Krone; Jarret,0,3,20,20
1745808135960,MCWP 50R,D00,893772,Miller; Elizabeth Deen,3,0,20,17
1745808135960,MCWP 50R,E00,893775,Carter; Andrea L,0,0,20,20
1745808136987,MMW 11R,A01,892721,Herbst; Matthew,11,0,27,16
1745808136987,MMW 11R,A02,892722,Herbst; Matthew,0,0,0,3
1745808138015,MMW 12R,A01,892724,Herbst; Matthew,0,9,16,16
1745808138015,MMW 12R,A02,892725,Herbst; Matthew,0,9,16,16
1745808139041,MMW 13R,A01,892727,Staff,0,4,16,16
1745808139041,MMW 13R,A02,892728,Staff,0,4,16,16
1745808139041,MMW 13R,A03,958032,Staff,0,3,16,16
1745808139041,MMW 13R,A04,958033,Staff,0,2,16,16
1745808139041,MMW 13R,A05,958034,Staff,0,3,16,16
1745808140071,SIO 295LS,A00,894015,Staff,7,0,25,18
1745808141099,SIO 295S,A00,894020,Staff,7,0,25,18
1745808142128,SIOC 290S,B01,958918,Staff,0,0,0,0
1745808143158,SIOC 291S,B01,958922,Staff,0,0,0,0
1745808144186,SOCI 117,A01,895339,Staff,4,0,5,1
1745808145211,WES 237B,A00,894149,Staff,11,0,20,9
1745808147277,AESE 279B,A00,891859,Staff,13,0,35,22
1745808148303,AIP 197,001,891854,Staff,70,0,70,0
1745808149329,ANTH 289S,A00,891856,Gagneux; Pascal,12,0,12,0
1745808150355,BENG 196,001,957946,Engler; Adam J.,9996,0,9999,3
1745808151382,CAT 124RS,A01,956906,Staff,8,0,25,17
1745808152409,CAT 125RS,A01,922013,Staff,8,0,25,17
1745808153433,CLRE 250,A00,891860,Morris; Sheldon,9995,0,9999,4
1745808155482,CLRE 251R,A00,907817,Mehta; Ravindra L.,9994,0,9999,5
1745808156510,CLRE 252,A00,891864,Cuomo; Raphael Eduardo,9993,0,9999,6
1745808157538,CLRE 253,A00,891867,Vaida; Florin,9994,0,9999,5
1745808157538,CLRE 253,B00,907819,Staff,9999,0,9999,0
1745808158563,CLRE 259,A00,891868,Patel; Hemal,9998,0,9999,1
1745808159588,CLRE 260,A00,891872,Cuomo; Raphael Eduardo,9999,0,9999,0
1745808160616,CLRE 297,001,891888,Cuomo; Raphael Eduardo,9999,0,9999,0
1745808161644,CSE 191,A00,958773,Minnes Kemp; Mor Mia,9999,0,9999,0
1745808162670,CSS 201S,A01,892054,Mignozzetti; Umberto,30,0,30,0
1745808163699,CSS 202S,A01,892056,Mignozzetti; Umberto,30,0,30,0
1745808164726,DSC 197,001,956898,Eldridge; Justin Matthew,9998,0,9999,1
1745808165752,DSC 297,001,958000,Mazumdar; Arya,9998,0,9999,1
1745808166779,EAP 100,A00,905686,Staff,9776,0,9999,223
1745808167806,ECE 45,A01,892618,Staff,0,12,50,50
1745808168832,ECE 109,A01,892620,Staff,0,44,0,0
1745808169859,ECE 111,A01,892719,Staff,0,8,50,50
1745808170885,ECE 197,001,957920,Mercier; Patrick Philip,9992,0,9999,7
1745808171911,ECON 178,A01,907814,Zhu; Ying,28,0,35,7
1745808172940,EDS 115,A00,895312,Staff,41,0,45,4
1745808173966,EDS 117,A01,895337,Staff,30,0,30,0
1745808174992,EDS 125,A00,895341,Jones; Gabrielle Anastasia,43,0,45,2
1745808176020,EDS 128A,A01,895459,Fargason; Sharon Gayle,44,0,45,1
1745808177049,EDS 128B,A01,895543,Pappas; Elizabeth,44,0,45,1
1745808178075,EDS 139,A00,897203,Pappas; Elizabeth,44,0,45,1
1745808178075,EDS 139,B00,897209,Fargason; Sharon Gayle,44,0,45,1
1745808179103,EDS 201,A00,895545,Staff,43,0,45,2
1745808180156,EDS 203,A01,895581,Halter; Christopher P.,43,0,45,2
1745808181182,EDS 204R,A01,895625,Heinzman; Erica M.,43,0,45,2
1745808181182,EDS 204R,B01,895693,Halter; Christopher P.,18,0,45,27
1745808182210,EDS 206R,A00,895694,Fargason; Sharon Gayle,9,0,30,21
1745808182210,EDS 206R,B00,895695,Choi; Bailey Miyeon,20,0,30,10
1745808183237,EDS 250,A00,895697,Hemans; Patricia Ann Benitez,43,0,45,2
1745808184263,EDS 281,A00,895701,Meyerott; Theresa Ann,15,0,15,0
1745808185292,EDS 284,A00,895736,Meyerott; Theresa Ann,15,0,15,0
1745808186318,EDS 286,A00,897210,Fine; Sarah,15,0,15,0
1745808187346,EDS 289C,A01,895770,Daly; Alan J.,15,0,15,0
1745808188374,EDS 290,A00,897211,Hofstetter; Carolyn,15,0,15,0
1745808189400,LIGM 5A,A00,896162,Fischer-Grunski; Eva K,15,0,20,5
1745808190429,LIGM 5B,A00,896260,Fischer-Grunski; Eva K,17,0,20,3
1745808191454,LIGM 5C,A00,896308,Fischer-Grunski; Eva K,18,0,20,2
1745808192480,LIIT 5AS,A00,896313,Carnelos; Chiara,18,0,20,2
1745808193503,LIIT 5BS,A00,896416,Carnelos; Chiara,20,0,20,0
1745808194530,LIIT 5CS,A00,896564,Carnelos; Chiara,20,0,20,0
1745808195555,LISP 5A,A00,896588,Munoz Sanchez; Alicia,4,0,20,16
1745808196581,LISP 5B,A00,896653,Munoz Sanchez; Alicia,10,0,20,10
1745808197608,LISP 5C,A00,896655,Munoz Sanchez; Alicia,4,0,20,16
1745808198635,MAE 197,001,957918,Kleissl; Jan,9998,0,9999,1
1745808199663,MATH 2,A01,957937,Staff,34,0,35,1
1745808200691,MATH 197,001,957876,Kedlaya; Kiran S.,9993,0,9999,6
1745808201718,MCWP 40,A00,892729,Duru; Nur,13,0,20,7
1745808201718,MCWP 40,B00,893304,Montejo; Carolina,20,0,20,0
1745808202745,MCWP 40R,A00,893757,Redela; Pamela Morgan,0,7,20,20
1745808203773,MCWP 50,A00,893758,Morshed; Michael James,2,0,20,18
1745808203773,MCWP 50,B00,893761,Bartulis; Jason Michael,17,0,20,3
1745808204800,MCWP 50R,A00,893766,Compas; Sean Matthew,0,1,20,20
1745808204800,MCWP 50R,B00,893769,Carter; Jennifer A,0,0,20,20
1745808204800,MCWP 50R,C00,893771,Krone; Jarret,0,3,20,20
1745808204800,MCWP 50R,D00,893772,Miller; Elizabeth Deen,3,0,20,17
1745808204800,MCWP 50R,E00,893775,Carter; Andrea L,0,0,20,20
1745808205826,MMW 11R,A01,892721,Herbst; Matthew,11,0,27,16
1745808205826,MMW 11R,A02,892722,Herbst; Matthew,0,0,0,3
1745808206853,MMW 12R,A01,892724,Herbst; Matthew,0,9,16,16
1745808206853,MMW 12R,A02,892725,Herbst; Matthew,0,9,16,16
1745808207879,MMW 13R,A01,892727,Staff,0,4,16,16
1745808207879,MMW 13R,A02,892728,Staff,0,4,16,16
1745808207879,MMW 13R,A03,958032,Staff,0,3,16,16
1745808207879,MMW 13R,A04,958033,Staff,0,2,16,16
1745808207879,MMW 13R,A05,958034,Staff,0,3,16,16
1745808208907,SIO 295LS,A00,894015,Staff,7,0,25,18
1745808209935,SIO 295S,A00,894020,Staff,7,0,25,18
1745808210963,SIOC 290S,B01,958918,Staff,0,0,0,0
1745808211995,SIOC 291S,B01,958922,Staff,0,0,0,0
1745808213024,SOCI 117,A01,895339,Staff,4,0,5,1
1745808214055,WES 237B,A00,894149,Staff,11,0,20,9
1745808216112,AESE 279B,A00,891859,Staff,13,0,35,22
1745808217136,AIP 197,001,891854,Staff,70,0,70,0
1745808218165,ANTH 289S,A00,891856,Gagneux; Pascal,12,0,12,0
1745808219189,BENG 196,001,957946,Engler; Adam J.,9996,0,9999,3
1745808220217,CAT 124RS,A01,956906,Staff,8,0,25,17
1745808221241,CAT 125RS,A01,922013,Staff,8,0,25,17
1745808222269,CLRE 250,A00,891860,Morris; Sheldon,9995,0,9999,4
1745808224324,CLRE 251R,A00,907817,Mehta; Ravindra L.,9994,0,9999,5
1745808225352,CLRE 252,A00,891864,Cuomo; Raphael Eduardo,9993,0,9999,6
1745808226379,CLRE 253,A00,891867,Vaida; Florin,9994,0,9999,5
1745808226379,CLRE 253,B00,907819,Staff,9999,0,9999,0
1745808227407,CLRE 259,A00,891868,Patel; Hemal,9998,0,9999,1
1745808228436,CLRE 260,A00,891872,Cuomo; Raphael Eduardo,9999,0,9999,0
1745808229462,CLRE 297,001,891888,Cuomo; Raphael Eduardo,9999,0,9999,0
1745808230490,CSE 191,A00,958773,Minnes Kemp; Mor Mia,9999,0,9999,0
1745808231519,CSS 201S,A01,892054,Mignozzetti; Umberto,30,0,30,0
1745808232549,CSS 202S,A01,892056,Mignozzetti; Umberto,30,0,30,0
1745808233578,DSC 197,001,956898,Eldridge; Justin Matthew,9998,0,9999,1
1745808234604,DSC 297,001,958000,Mazumdar; Arya,9998,0,9999,1
1745808235629,EAP 100,A00,905686,Staff,9776,0,9999,223
1745808236657,ECE 45,A01,892618,Staff,0,12,50,50
1745808237684,ECE 109,A01,892620,Staff,0,44,0,0
1745808238712,ECE 111,A01,892719,Staff,0,8,50,50
1745808239741,ECE 197,001,957920,Mercier; Patrick Philip,9992,0,9999,7
1745808240767,ECON 178,A01,907814,Zhu; Ying,28,0,35,7
1745808241797,EDS 115,A00,895312,Staff,41,0,45,4
1745808242849,EDS 117,A01,895337,Staff,30,0,30,0
1745808243881,EDS 125,A00,895341,Jones; Gabrielle Anastasia,43,0,45,2
1745808244906,EDS 128A,A01,895459,Fargason; Sharon Gayle,44,0,45,1
1745808245933,EDS 128B,A01,895543,Pappas; Elizabeth,44,0,45,1
1745808246962,EDS 139,A00,897203,Pappas; Elizabeth,44,0,45,1
1745808246962,EDS 139,B00,897209,Fargason; Sharon Gayle,44,0,45,1
1745808247987,EDS 201,A00,895545,Staff,43,0,45,2
1745808249015,EDS 203,A01,895581,Halter; Christopher P.,43,0,45,2
1745808250044,EDS 204R,A01,895625,Heinzman; Erica M.,43,0,45,2
1745808250044,EDS 204R,B01,895693,Halter; Christopher P.,18,0,45,27
1745808251072,EDS 206R,A00,895694,Fargason; Sharon Gayle,9,0,30,21
1745808251072,EDS 206R,B00,895695,Choi; Bailey Miyeon,20,0,30,10
1745808252096,EDS 250,A00,895697,Hemans; Patricia Ann Benitez,43,0,45,2
1745808253120,EDS 281,A00,895701,Meyerott; Theresa Ann,15,0,15,0
1745808254144,EDS 284,A00,895736,Meyerott; Theresa Ann,15,0,15,0
1745808255172,EDS 286,A00,897210,Fine; Sarah,15,0,15,0
1745808256196,EDS 289C,A01,895770,Daly; Alan J.,15,0,15,0
1745808257244,EDS 290,A00,897211,Hofstetter; Carolyn,15,0,15,0
1745808258270,LIGM 5A,A00,896162,Fischer-Grunski; Eva K,15,0,20,5
1745808259296,LIGM 5B,A00,896260,Fischer-Grunski; Eva K,17,0,20,3
1745808260324,LIGM 5C,A00,896308,Fischer-Grunski; Eva K,18,0,20,2
1745808261352,LIIT 5AS,A00,896313,Carnelos; Chiara,18,0,20,2
1745808262377,LIIT 5BS,A00,896416,Carnelos; Chiara,20,0,20,0
1745808263402,LIIT 5CS,A00,896564,Carnelos; Chiara,20,0,20,0
1745808264427,LISP 5A,A00,896588,Munoz Sanchez; Alicia,4,0,20,16
1745808265455,LISP 5B,A00,896653,Munoz Sanchez; Alicia,10,0,20,10
1745808266481,LISP 5C,A00,896655,Munoz Sanchez; Alicia,4,0,20,16
1745808267508,MAE 197,001,957918,Kleissl; Jan,9998,0,9999,1
1745808268531,MATH 2,A01,957937,Staff,34,0,35,1
1745808269555,MATH 197,001,957876,Kedlaya; Kiran S.,9993,0,9999,6
1745808270578,MCWP 40,A00,892729,Duru; Nur,13,0,20,7
1745808270578,MCWP 40,B00,893304,Montejo; Carolina,20,0,20,0
1745808271603,MCWP 40R,A00,893757,Redela; Pamela Morgan,0,7,20,20
1745808272628,MCWP 50,A00,893758,Morshed; Michael James,2,0,20,18
1745808272628,MCWP 50,B00,893761,Bartulis; Jason Michael,17,0,20,3
1745808273657,MCWP 50R,A00,893766,Compas; Sean Matthew,0,1,20,20
1745808273657,MCWP 50R,B00,893769,Carter; Jennifer A,0,0,20,20
1745808273657,MCWP 50R,C00,893771,Krone; Jarret,0,3,20,20
1745808273657,MCWP 50R,D00,893772,Miller; Elizabeth Deen,3,0,20,17
1745808273657,MCWP 50R,E00,893775,Carter; Andrea L,0,0,20,20
1745808274681,MMW 11R,A01,892721,Herbst; Matthew,11,0,27,16
1745808274681,MMW 11R,A02,892722,Herbst; Matthew,0,0,0,3
1745808275710,MMW 12R,A01,892724,Herbst; Matthew,0,9,16,16
1745808275710,MMW 12R,A02,892725,Herbst; Matthew,0,9,16,16
1745808276737,MMW 13R,A01,892727,Staff,0,4,16,16
1745808276737,MMW 13R,A02,892728,Staff,0,4,16,16
1745808276737,MMW 13R,A03,958032,Staff,0,3,16,16
1745808276737,MMW 13R,A04,958033,Staff,0,2,16,16
1745808276737,MMW 13R,A05,958034,Staff,0,3,16,16
1745808277763,SIO 295LS,A00,894015,Staff,7,0,25,18
1745808278790,SIO 295S,A00,894020,Staff,7,0,25,18
1745808279819,SIOC 290S,B01,958918,Staff,0,0,0,0
1745808280844,SIOC 291S,B01,958922,Staff,0,0,0,0
1745808281867,SOCI 117,A01,895339,Staff,4,0,5,1
1745808282894,WES 237B,A00,894149,Staff,11,0,20,9
1745808284948,AESE 279B,A00,891859,Staff,13,0,35,22
1745808285977,AIP 197,001,891854,Staff,70,0,70,0
1745808287004,ANTH 289S,A00,891856,Gagneux; Pascal,12,0,12,0
1745808288032,BENG 196,001,957946,Engler; Adam J.,9996,0,9999,3
1745808289059,CAT 124RS,A01,956906,Staff,8,0,25,17
1745808290085,CAT 125RS,A01,922013,Staff,8,0,25,17
1745808291113,CLRE 250,A00,891860,Morris; Sheldon,9995,0,9999,4
1745808293170,CLRE 251R,A00,907817,Mehta; Ravindra L.,9994,0,9999,5
1745808294196,CLRE 252,A00,891864,Cuomo; Raphael Eduardo,9993,0,9999,6
1745808295225,CLRE 253,A00,891867,Vaida; Florin,9994,0,9999,5
1745808295225,CLRE 253,B00,907819,Staff,9999,0,9999,0
1745808296251,CLRE 259,A00,891868,Patel; Hemal,9998,0,9999,1
1745808297278,CLRE 260,A00,891872,Cuomo; Raphael Eduardo,9999,0,9999,0
1745808298304,CLRE 297,001,891888,Cuomo; Raphael Eduardo,9999,0,9999,0
1745808299332,CSE 191,A00,958773,Minnes Kemp; Mor Mia,9999,0,9999,0
1745808300357,CSS 201S,A01,892054,Mignozzetti; Umberto,30,0,30,0
1745808301384,CSS 202S,A01,892056,Mignozzetti; Umberto,30,0,30,0
1745808302411,DSC 197,001,956898,Eldridge; Justin Matthew,9998,0,9999,1
1745808303444,DSC 297,001,958000,Mazumdar; Arya,9998,0,9999,1
1745808304470,EAP 100,A00,905686,Staff,9776,0,9999,223
1745808305497,ECE 45,A01,892618,Staff,0,12,50,50
1745808306524,ECE 109,A01,892620,Staff,0,44,0,0
1745808307552,ECE 111,A01,892719,Staff,0,8,50,50
1745808308577,ECE 197,001,957920,Mercier; Patrick Philip,9992,0,9999,7
1745808309605,ECON 178,A01,907814,Zhu; Ying,28,0,35,7
1745808310632,EDS 115,A00,895312,Staff,41,0,45,4
1745808311661,EDS 117,A01,895337,Staff,30,0,30,0
1745808312690,EDS 125,A00,895341,Jones; Gabrielle Anastasia,43,0,45,2
1745808313717,EDS 128A,A01,895459,Fargason; Sharon Gayle,44,0,45,1
1745808314744,EDS 128B,A01,895543,Pappas; Elizabeth,44,0,45,1
1745808315773,EDS 139,A00,897203,Pappas; Elizabeth,44,0,45,1
1745808315773,EDS 139,B00,897209,Fargason; Sharon Gayle,44,0,45,1
1745808316798,EDS 201,A00,895545,Staff,43,0,45,2
1745808317825,EDS 203,A01,895581,Halter; Christopher P.,43,0,45,2
1745808318852,EDS 204R,A01,895625,Heinzman; Erica M.,43,0,45,2
1745808318852,EDS 204R,B01,895693,Halter; Christopher P.,18,0,45,27
1745808319881,EDS 206R,A00,895694,Fargason; Sharon Gayle,9,0,30,21
1745808319881,EDS 206R,B00,895695,Choi; Bailey Miyeon,20,0,30,10
1745808320909,EDS 250,A00,895697,Hemans; Patricia Ann Benitez,43,0,45,2
1745808321934,EDS 281,A00,895701,Meyerott; Theresa Ann,15,0,15,0
1745808322960,EDS 284,A00,895736,Meyerott; Theresa Ann,15,0,15,0
1745808323986,EDS 286,A00,897210,Fine; Sarah,15,0,15,0
1745808325013,EDS 289C,A01,895770,Daly; Alan J.,15,0,15,0
1745808326037,EDS 290,A00,897211,Hofstetter; Carolyn,15,0,15,0
1745808327067,LIGM 5A,A00,896162,Fischer-Grunski; Eva K,15,0,20,5
1745808328093,LIGM 5B,A00,896260,Fischer-Grunski; Eva K,17,0,20,3
1745808329120,LIGM 5C,A00,896308,Fischer-Grunski; Eva K,18,0,20,2
1745808330149,LIIT 5AS,A00,896313,Carnelos; Chiara,18,0,20,2
1745808331175,LIIT 5BS,A00,896416,Carnelos; Chiara,20,0,20,0
1745808332200,LIIT 5CS,A00,896564,Carnelos; Chiara,20,0,20,0
1745808333229,LISP 5A,A00,896588,Munoz Sanchez; Alicia,4,0,20,16
1745808334257,LISP 5B,A00,896653,Munoz Sanchez; Alicia,10,0,20,10
1745808335286,LISP 5C,A00,896655,Munoz Sanchez; Alicia,4,0,20,16
1745808336312,MAE 197,001,957918,Kleissl; Jan,9998,0,9999,1
1745808337339,MATH 2,A01,957937,Staff,34,0,35,1
1745808338365,MATH 197,001,957876,Kedlaya; Kiran S.,9993,0,9999,6
1745808339390,MCWP 40,A00,892729,Duru; Nur,13,0,20,7
1745808339390,MCWP 40,B00,893304,Montejo; Carolina,20,0,20,0
1745808340416,MCWP 40R,A00,893757,Redela; Pamela Morgan,0,7,20,20
1745808341447,MCWP 50,A00,893758,Morshed; Michael James,2,0,20,18
1745808341447,MCWP 50,B00,893761,Bartulis; Jason Michael,17,0,20,3
1745808342473,MCWP 50R,A00,893766,Compas; Sean Matthew,0,1,20,20
1745808342473,MCWP 50R,B00,893769,Carter; Jennifer A,0,0,20,20
1745808342473,MCWP 50R,C00,893771,Krone; Jarret,0,3,20,20
1745808342473,MCWP 50R,D00,893772,Miller; Elizabeth Deen,3,0,20,17
1745808342473,MCWP 50R,E00,893775,Carter; Andrea L,0,0,20,20
1745808343498,MMW 11R,A01,892721,Herbst; Matthew,11,0,27,16
1745808343498,MMW 11R,A02,892722,Herbst; Matthew,0,0,0,3
1745808344524,MMW 12R,A01,892724,Herbst; Matthew,0,9,16,16
1745808344524,MMW 12R,A02,892725,Herbst; Matthew,0,9,16,16
1745808345554,MMW 13R,A01,892727,Staff,0,4,16,16
1745808345554,MMW 13R,A02,892728,Staff,0,4,16,16
1745808345554,MMW 13R,A03,958032,Staff,0,3,16,16
1745808345554,MMW 13R,A04,958033,Staff,0,2,16,16
1745808345554,MMW 13R,A05,958034,Staff,0,3,16,16
1745808346580,SIO 295LS,A00,894015,Staff,7,0,25,18
1745808347608,SIO 295S,A00,894020,Staff,7,0,25,18
1745808348638,SIOC 290S,B01,958918,Staff,0,0,0,0
1745808349663,SIOC 291S,B01,958922,Staff,0,0,0,0
1745808350690,SOCI 117,A01,895339,Staff,4,0,5,1
1745808351717,WES 237B,A00,894149,Staff,11,0,20,9
1745808353780,AESE 279B,A00,891859,Staff,13,0,35,22
1745808354805,AIP 197,001,891854,Staff,70,0,70,0
1745808355836,ANTH 289S,A00,891856,Gagneux; Pascal,12,0,12,0
1745808356863,BENG 196,001,957946,Engler; Adam J.,9996,0,9999,3
1745808357892,CAT 124RS,A01,956906,Staff,8,0,25,17
1745808358922,CAT 125RS,A01,922013,Staff,8,0,25,17
1745808359951,CLRE 250,A00,891860,Morris; Sheldon,9995,0,9999,4
1745808362010,CLRE 251R,A00,907817,Mehta; Ravindra L.,9994,0,9999,5
1745808363035,CLRE 252,A00,891864,Cuomo; Raphael Eduardo,9993,0,9999,6
1745808364060,CLRE 253,A00,891867,Vaida; Florin,9994,0,9999,5
1745808364060,CLRE 253,B00,907819,Staff,9999,0,9999,0
1745808365088,CLRE 259,A00,891868,Patel; Hemal,9998,0,9999,1
1745808366113,CLRE 260,A00,891872,Cuomo; Raphael Eduardo,9999,0,9999,0
1745808367138,CLRE 297,001,891888,Cuomo; Raphael Eduardo,9999,0,9999,0
1745808368166,CSE 191,A00,958773,Minnes Kemp; Mor Mia,9999,0,9999,0
1745808369193,CSS 201S,A01,892054,Mignozzetti; Umberto,30,0,30,0
1745808370219,CSS 202S,A01,892056,Mignozzetti; Umberto,30,0,30,0
1745808371250,DSC 197,001,956898,Eldridge; Justin Matthew,9998,0,9999,1
1745808372279,DSC 297,001,958000,Mazumdar; Arya,9998,0,9999,1
1745808373308,EAP 100,A00,905686,Staff,9776,0,9999,223
1745808374336,ECE 45,A01,892618,Staff,0,12,50,50
1745808375362,ECE 109,A01,892620,Staff,0,44,0,0
1745808376389,ECE 111,A01,892719,Staff,0,8,50,50
1745808377415,ECE 197,001,957920,Mercier; Patrick Philip,9992,0,9999,7
1745808378445,ECON 178,A01,907814,Zhu; Ying,28,0,35,7
1745808379471,EDS 115,A00,895312,Staff,41,0,45,4
1745808380504,EDS 117,A01,895337,Staff,30,0,30,0
1745808381533,EDS 125,A00,895341,Jones; Gabrielle Anastasia,43,0,45,2
1745808382559,EDS 128A,A01,895459,Fargason; Sharon Gayle,44,0,45,1
1745808383583,EDS 128B,A01,895543,Pappas; Elizabeth,44,0,45,1
1745808384611,EDS 139,A00,897203,Pappas; Elizabeth,44,0,45,1
1745808384611,EDS 139,B00,897209,Fargason; Sharon Gayle,44,0,45,1
1745808385639,EDS 201,A00,895545,Staff,43,0,45,2
1745808386665,EDS 203,A01,895581,Halter; Christopher P.,43,0,45,2
1745808387691,EDS 204R,A01,895625,Heinzman; Erica M.,43,0,45,2
1745808387691,EDS 204R,B01,895693,Halter; Christopher P.,18,0,45,27
1745808388716,EDS 206R,A00,895694,Fargason; Sharon Gayle,9,0,30,21
1745808388716,EDS 206R,B00,895695,Choi; Bailey Miyeon,20,0,30,10
1745808389742,EDS 250,A00,895697,Hemans; Patricia Ann Benitez,43,0,45,2
1745808390771,EDS 281,A00,895701,Meyerott; Theresa Ann,15,0,15,0
1745808391801,EDS 284,A00,895736,Meyerott; Theresa Ann,15,0,15,0
1745808392826,EDS 286,A00,897210,Fine; Sarah,15,0,15,0
1745808393854,EDS 289C,A01,895770,Daly; Alan J.,15,0,15,0
1745808394882,EDS 290,A00,897211,Hofstetter; Carolyn,15,0,15,0
1745808395907,LIGM 5A,A00,896162,Fischer-Grunski; Eva K,15,0,20,5
1745808396938,LIGM 5B,A00,896260,Fischer-Grunski; Eva K,17,0,20,3
1745808397962,LIGM 5C,A00,896308,Fischer-Grunski; Eva K,18,0,20,2
1745808398991,LIIT 5AS,A00,896313,Carnelos; Chiara,18,0,20,2
1745808400019,LIIT 5BS,A00,896416,Carnelos; Chiara,20,0,20,0
1745808401046,LIIT 5CS,A00,896564,Carnelos; Chiara,20,0,20,0
1745808402072,LISP 5A,A00,896588,Munoz Sanchez; Alicia,4,0,20,16
1745808403098,LISP 5B,A00,896653,Munoz Sanchez; Alicia,10,0,20,10
1745808404126,LISP 5C,A00,896655,Munoz Sanchez; Alicia,4,0,20,16
1745808405153,MAE 197,001,957918,Kleissl; Jan,9998,0,9999,1
1745808406183,MATH 2,A01,957937,Staff,34,0,35,1
1745808407210,MATH 197,001,957876,Kedlaya; Kiran S.,9993,0,9999,6
1745808408236,MCWP 40,A00,892729,Duru; Nur,13,0,20,7
1745808408236,MCWP 40,B00,893304,Montejo; Carolina,20,0,20,0
1745808409263,MCWP 40R,A00,893757,Redela; Pamela Morgan,0,7,20,20
1745808410290,MCWP 50,A00,893758,Morshed; Michael James,2,0,20,18
1745808410290,MCWP 50,B00,893761,Bartulis; Jason Michael,17,0,20,3
1745808411320,MCWP 50R,A00,893766,Compas; Sean Matthew,0,1,20,20
1745808411320,MCWP 50R,B00,893769,Carter; Jennifer A,0,0,20,20
1745808411320,MCWP 50R,C00,893771,Krone; Jarret,0,3,20,20
1745808411320,MCWP 50R,D00,893772,Miller; Elizabeth Deen,3,0,20,17
1745808411320,MCWP 50R,E00,893775,Carter; Andrea L,0,0,20,20
1745808412347,MMW 11R,A01,892721,Herbst; Matthew,11,0,27,16
1745808412347,MMW 11R,A02,892722,Herbst; Matthew,0,0,0,3
1745808413374,MMW 12R,A01,892724,Herbst; Matthew,0,9,16,16
1745808413374,MMW 12R,A02,892725,Herbst; Matthew,0,9,16,16
1745808414402,MMW 13R,A01,892727,Staff,0,4,16,16
1745808414402,MMW 13R,A02,892728,Staff,0,4,16,16
1745808414402,MMW 13R,A03,958032,Staff,0,3,16,16
1745808414402,MMW 13R,A04,958033,Staff,0,2,16,16
1745808414402,MMW 13R,A05,958034,Staff,0,3,16,16
1745808415429,SIO 295LS,A00,894015,Staff,7,0,25,18
1745808416455,SIO 295S,A00,894020,Staff,7,0,25,18
1745808417482,SIOC 290S,B01,958918,Staff,0,0,0,0
1745808418509,SIOC 291S,B01,958922,Staff,0,0,0,0
1745808419537,SOCI 117,A01,895339,Staff,4,0,5,1
1745808420564,WES 237B,A00,894149,Staff,11,0,20,9
1745808422628,AESE 279B,A00,891859,Staff,13,0,35,22
1745808423652,AIP 197,001,891854,Staff,70,0,70,0
1745808424680,ANTH 289S,A00,891856,Gagneux; Pascal,12,0,12,0
1745808425706,BENG 196,001,957946,Engler; Adam J.,9996,0,9999,3
1745808426741,CAT 124RS,A01,956906,Staff,8,0,25,17
1745808427766,CAT 125RS,A01,922013,Staff,8,0,25,17
1745808428789,CLRE 250,A00,891860,Morris; Sheldon,9995,0,9999,4
1745808430844,CLRE 251R,A00,907817,Mehta; Ravindra L.,9994,0,9999,5
1745808431872,CLRE 252,A00,891864,Cuomo; Raphael Eduardo,9993,0,9999,6
1745808432898,CLRE 253,A00,891867,Vaida; Florin,9994,0,9999,5
1745808432898,CLRE 253,B00,907819,Staff,9999,0,9999,0
1745808433991,CLRE 259,A00,891868,Patel; Hemal,9998,0,9999,1
1745808435019,CLRE 260,A00,891872,Cuomo; Raphael Eduardo,9999,0,9999,0
1745808436045,CLRE 297,001,891888,Cuomo; Raphael Eduardo,9999,0,9999,0
1745808437069,CSE 191,A00,958773,Minnes Kemp; Mor Mia,9999,0,9999,0
1745808438092,CSS 201S,A01,892054,Mignozzetti; Umberto,30,0,30,0
1745808439121,CSS 202S,A01,892056,Mignozzetti; Umberto,30,0,30,0
1745808440145,DSC 197,001,956898,Eldridge; Justin Matthew,9998,0,9999,1
1745808441170,DSC 297,001,958000,Mazumdar; Arya,9998,0,9999,1
1745808442195,EAP 100,A00,905686,Staff,9776,0,9999,223
1745808443220,ECE 45,A01,892618,Staff,0,12,50,50
1745808444244,ECE 109,A01,892620,Staff,0,44,0,0
1745808445270,ECE 111,A01,892719,Staff,0,8,50,50
1745808446298,ECE 197,001,957920,Mercier; Patrick Philip,9992,0,9999,7
1745808447323,ECON 178,A01,907814,Zhu; Ying,28,0,35,7
1745808448366,EDS 115,A00,895312,Staff,41,0,45,4
1745808449393,EDS 117,A01,895337,Staff,30,0,30,0
1745808450419,EDS 125,A00,895341,Jones; Gabrielle Anastasia,43,0,45,2
1745808451444,EDS 128A,A01,895459,Fargason; Sharon Gayle,44,0,45,1
1745808452473,EDS 128B,A01,895543,Pappas; Elizabeth,44,0,45,1
1745808453500,EDS 139,A00,897203,Pappas; Elizabeth,44,0,45,1
1745808453500,EDS 139,B00,897209,Fargason; Sharon Gayle,44,0,45,1
1745808454528,EDS 201,A00,895545,Staff,43,0,45,2
1745808455553,EDS 203,A01,895581,Halter; Christopher P.,43,0,45,2
1745808456577,EDS 204R,A01,895625,Heinzman; Erica M.,43,0,45,2
1745808456577,EDS 204R,B01,895693,Halter; Christopher P.,18,0,45,27
1745808457602,EDS 206R,A00,895694,Fargason; Sharon Gayle,9,0,30,21
1745808457602,EDS 206R,B00,895695,Choi; Bailey Miyeon,20,0,30,10
1745808458627,EDS 250,A00,895697,Hemans; Patricia Ann Benitez,43,0,45,2
1745808459651,EDS 281,A00,895701,Meyerott; Theresa Ann,15,0,15,0
1745808460675,EDS 284,A00,895736,Meyerott; Theresa Ann,15,0,15,0
1745808461698,EDS 286,A00,897210,Fine; Sarah,15,0,15,0
1745808462723,EDS 289C,A01,895770,Daly; Alan J.,15,0,15,0
1745808463748,EDS 290,A00,897211,Hofstetter; Carolyn,15,0,15,0
1745808464775,LIGM 5A,A00,896162,Fischer-Grunski; Eva K,15,0,20,5
1745808465801,LIGM 5B,A00,896260,Fischer-Grunski; Eva K,17,0,20,3
1745808466826,LIGM 5C,A00,896308,Fischer-Grunski; Eva K,18,0,20,2
1745808467851,LIIT 5AS,A00,896313,Carnelos; Chiara,18,0,20,2
1745808468876,LIIT 5BS,A00,896416,Carnelos; Chiara,20,0,20,0
1745808469902,LIIT 5CS,A00,896564,Carnelos; Chiara,20,0,20,0
1745808470929,LISP 5A,A00,896588,Munoz Sanchez; Alicia,4,0,20,16
1745808471958,LISP 5B,A00,896653,Munoz Sanchez; Alicia,10,0,20,10
1745808472984,LISP 5C,A00,896655,Munoz Sanchez; Alicia,4,0,20,16
1745808474011,MAE 197,001,957918,Kleissl; Jan,9998,0,9999,1
1745808475038,MATH 2,A01,957937,Staff,34,0,35,1
1745808476064,MATH 197,001,957876,Kedlaya; Kiran S.,9993,0,9999,6
1745808477090,MCWP 40,A00,892729,Duru; Nur,13,0,20,7
1745808477090,MCWP 40,B00,893304,Montejo; Carolina,20,0,20,0
1745808478116,MCWP 40R,A00,893757,Redela; Pamela Morgan,0,7,20,20
1745808479143,MCWP 50,A00,893758,Morshed; Michael James,2,0,20,18
1745808479143,MCWP 50,B00,893761,Bartulis; Jason Michael,17,0,20,3
1745808480172,MCWP 50R,A00,893766,Compas; Sean Matthew,0,1,20,20
1745808480172,MCWP 50R,B00,893769,Carter; Jennifer A,0,0,20,20
1745808480172,MCWP 50R,C00,893771,Krone; Jarret,0,3,20,20
1745808480172,MCWP 50R,D00,893772,Miller; Elizabeth Deen,3,0,20,17
1745808480172,MCWP 50R,E00,893775,Carter; Andrea L,0,0,20,20
1745808481198,MMW 11R,A01,892721,Herbst; Matthew,11,0,27,16
1745808481198,MMW 11R,A02,892722,Herbst; Matthew,0,0,0,3
1745808482226,MMW 12R,A01,892724,Herbst; Matthew,0,9,16,16
1745808482226,MMW 12R,A02,892725,Herbst; Matthew,0,9,16,16
1745808483254,MMW 13R,A01,892727,Staff,0,4,16,16
1745808483254,MMW 13R,A02,892728,Staff,0,4,16,16
1745808483254,MMW 13R,A03,958032,Staff,0,3,16,16
1745808483254,MMW 13R,A04,958033,Staff,0,2,16,16
1745808483254,MMW 13R,A05,958034,Staff,0,3,16,16
1745808484280,SIO 295LS,A00,894015,Staff,7,0,25,18
1745808485308,SIO 295S,A00,894020,Staff,7,0,25,18
1745808486335,SIOC 290S,B01,958918,Staff,0,0,0,0
1745808487364,SIOC 291S,B01,958922,Staff,0,0,0,0
1745808488392,SOCI 117,A01,895339,Staff,4,0,5,1
1745808489420,WES 237B,A00,894149,Staff,11,0,20,9
1745808491482,AESE 279B,A00,891859,Staff,13,0,35,22
1745808492506,AIP 197,001,891854,Staff,70,0,70,0
1745808493531,ANTH 289S,A00,891856,Gagneux; Pascal,12,0,12,0
1745808494558,BENG 196,001,957946,Engler; Adam J.,9996,0,9999,3
1745808495588,CAT 124RS,A01,956906,Staff,8,0,25,17
1745808496613,CAT 125RS,A01,922013,Staff,8,0,25,17
1745808497639,CLRE 250,A00,891860,Morris; Sheldon,9995,0,9999,4
1745808499696,CLRE 251R,A00,907817,Mehta; Ravindra L.,9994,0,9999,5
1745808500723,CLRE 252,A00,891864,Cuomo; Raphael Eduardo,9993,0,9999,6
1745808501751,CLRE 253,A00,891867,Vaida; Florin,9994,0,9999,5
1745808501751,CLRE 253,B00,907819,Staff,9999,0,9999,0
1745808502778,CLRE 259,A00,891868,Patel; Hemal,9998,0,9999,1
1745808503804,CLRE 260,A00,891872,Cuomo; Raphael Eduardo,9999,0,9999,0
1745808504831,CLRE 297,001,891888,Cuomo; Raphael Eduardo,9999,0,9999,0
1745808505858,CSE 191,A00,958773,Minnes Kemp; Mor Mia,9999,0,9999,0
1745808506883,CSS 201S,A01,892054,Mignozzetti; Umberto,30,0,30,0
1745808507908,CSS 202S,A01,892056,Mignozzetti; Umberto,30,0,30,0
1745808508933,DSC 197,001,956898,Eldridge; Justin Matthew,9998,0,9999,1
1745808509958,DSC 297,001,958000,Mazumdar; Arya,9998,0,9999,1
1745808510982,EAP 100,A00,905686,Staff,9776,0,9999,223
1745808512008,ECE 45,A01,892618,Staff,0,12,50,50
1745808513033,ECE 109,A01,892620,Staff,0,44,0,0
1745808514057,ECE 111,A01,892719,Staff,0,8,50,50
1745808515084,ECE 197,001,957920,Mercier; Patrick Philip,9992,0,9999,7
1745808516114,ECON 178,A01,907814,Zhu; Ying,28,0,35,7
1745808517144,EDS 115,A00,895312,Staff,41,0,45,4
1745808518168,EDS 117,A01,895337,Staff,30,0,30,0
1745808519195,EDS 125,A00,895341,Jones; Gabrielle Anastasia,43,0,45,2
1745808520223,EDS 128A,A01,895459,Fargason; Sharon Gayle,44,0,45,1
1745808521250,EDS 128B,A01,895543,Pappas; Elizabeth,44,0,45,1
1745808522276,EDS 139,A00,897203,Pappas; Elizabeth,44,0,45,1
1745808522276,EDS 139,B00,897209,Fargason; Sharon Gayle,44,0,45,1
1745808523302,EDS 201,A00,895545,Staff,43,0,45,2
1745808524327,EDS 203,A01,895581,Halter; Christopher P.,43,0,45,2
1745808525358,EDS 204R,A01,895625,Heinzman; Erica M.,43,0,45,2
1745808525358,EDS 204R,B01,895693,Halter; Christopher P.,18,0,45,27
1745808526388,EDS 206R,A00,895694,Fargason; Sharon Gayle,9,0,30,21
1745808526388,EDS 206R,B00,895695,Choi; Bailey Miyeon,20,0,30,10
1745808527415,EDS 250,A00,895697,Hemans; Patricia Ann Benitez,43,0,45,2
1745808528443,EDS 281,A00,895701,Meyerott; Theresa Ann,15,0,15,0
1745808529468,EDS 284,A00,895736,Meyerott; Theresa Ann,15,0,15,0
1745808530494,EDS 286,A00,897210,Fine; Sarah,15,0,15,0
1745808531522,EDS 289C,A01,895770,Daly; Alan J.,15,0,15,0
1745808532552,EDS 290,A00,897211,Hofstetter; Carolyn,15,0,15,0
1745808533578,LIGM 5A,A00,896162,Fischer-Grunski; Eva K,15,0,20,5
1745808534609,LIGM 5B,A00,896260,Fischer-Grunski; Eva K,17,0,20,3
1745808535635,LIGM 5C,A00,896308,Fischer-Grunski; Eva K,18,0,20,2
1745808536661,LIIT 5AS,A00,896313,Carnelos; Chiara,18,0,20,2
1745808537688,LIIT 5BS,A00,896416,Carnelos; Chiara,20,0,20,0
1745808538716,LIIT 5CS,A00,896564,Carnelos; Chiara,20,0,20,0
1745808539743,LISP 5A,A00,896588,Munoz Sanchez; Alicia,4,0,20,16
1745808540769,LISP 5B,A00,896653,Munoz Sanchez; Alicia,10,0,20,10
1745808541799,LISP 5C,A00,896655,Munoz Sanchez; Alicia,4,0,20,16
1745808542829,MAE 197,001,957918,Kleissl; Jan,9998,0,9999,1
1745808543859,MATH 2,A01,957937,Staff,34,0,35,1
1745808544885,MATH 197,001,957876,Kedlaya; Kiran S.,9993,0,9999,6
1745808545914,MCWP 40,A00,892729,Duru; Nur,13,0,20,7
1745808545914,MCWP 40,B00,893304,Montejo; Carolina,20,0,20,0
1745808546944,MCWP 40R,A00,893757,Redela; Pamela Morgan,0,7,20,20
1745808547971,MCWP 50,A00,893758,Morshed; Michael James,2,0,20,18
1745808547971,MCWP 50,B00,893761,Bartulis; Jason Michael,17,0,20,3
1745808549002,MCWP 50R,A00,893766,Compas; Sean Matthew,0,1,20,20
1745808549002,MCWP 50R,B00,893769,Carter; Jennifer A,0,0,20,20
1745808549002,MCWP 50R,C00,893771,Krone; Jarret,0,3,20,20
1745808549002,MCWP 50R,D00,893772,Miller; Elizabeth Deen,3,0,20,17
1745808549002,MCWP 50R,E00,893775,Carter; Andrea L,0,0,20,20
1745808550033,MMW 11R,A01,892721,Herbst; Matthew,11,0,27,16
1745808550033,MMW 11R,A02,892722,Herbst; Matthew,0,0,0,3
1745808551061,MMW 12R,A01,892724,Herbst; Matthew,0,9,16,16
1745808551061,MMW 12R,A02,892725,Herbst; Matthew,0,9,16,16
1745808552093,MMW 13R,A01,892727,Staff,0,4,16,16
1745808552093,MMW 13R,A02,892728,Staff,0,4,16,16
1745808552093,MMW 13R,A03,958032,Staff,0,3,16,16
1745808552093,MMW 13R,A04,958033,Staff,0,2,16,16
1745808552093,MMW 13R,A05,958034,Staff,0,3,16,16
1745808553121,SIO 295LS,A00,894015,Staff,7,0,25,18
1745808554147,SIO 295S,A00,894020,Staff,7,0,25,18
1745808555175,SIOC 290S,B01,958918,Staff,0,0,0,0
1745808556202,SIOC 291S,B01,958922,Staff,0,0,0,0
1745808557230,SOCI 117,A01,895339,Staff,4,0,5,1
1745808558257,WES 237B,A00,894149,Staff,11,0,20,9
1745808560318,AESE 279B,A00,891859,Staff,13,0,35,22
1745808561345,AIP 197,001,891854,Staff,70,0,70,0
1745808562373,ANTH 289S,A00,891856,Gagneux; Pascal,12,0,12,0
1745808563401,BENG 196,001,957946,Engler; Adam J.,9996,0,9999,3
1745808564425,CAT 124RS,A01,956906,Staff,8,0,25,17
1745808565451,CAT 125RS,A01,922013,Staff,8,0,25,17
1745808566479,CLRE 250,A00,891860,Morris; Sheldon,9995,0,9999,4
1745808568531,CLRE 251R,A00,907817,Mehta; Ravindra L.,9994,0,9999,5
1745808569558,CLRE 252,A00,891864,Cuomo; Raphael Eduardo,9993,0,9999,6
1745808570584,CLRE 253,A00,891867,Vaida; Florin,9994,0,9999,5
1745808570584,CLRE 253,B00,907819,Staff,9999,0,9999,0
1745808571609,CLRE 259,A00,891868,Patel; Hemal,9998,0,9999,1
1745808572635,CLRE 260,A00,891872,Cuomo; Raphael Eduardo,9999,0,9999,0
1745808573664,CLRE 297,001,891888,Cuomo; Raphael Eduardo,9999,0,9999,0
1745808574692,CSE 191,A00,958773,Minnes Kemp; Mor Mia,9999,0,9999,0
1745808575719,CSS 201S,A01,892054,Mignozzetti; Umberto,30,0,30,0
1745808576744,CSS 202S,A01,892056,Mignozzetti; Umberto,30,0,30,0
1745808577771,DSC 197,001,956898,Eldridge; Justin Matthew,9998,0,9999,1
1745808578799,DSC 297,001,958000,Mazumdar; Arya,9998,0,9999,1
1745808579823,EAP 100,A00,905686,Staff,9776,0,9999,223
1745808580851,ECE 45,A01,892618,Staff,0,12,50,50
1745808581877,ECE 109,A01,892620,Staff,0,44,0,0
1745808582902,ECE 111,A01,892719,Staff,0,8,50,50
1745808583926,ECE 197,001,957920,Mercier; Patrick Philip,9992,0,9999,7
1745808584957,ECON 178,A01,907814,Zhu; Ying,28,0,35,7
1745808585985,EDS 115,A00,895312,Staff,41,0,45,4
1745808587012,EDS 117,A01,895337,Staff,30,0,30,0
1745808588039,EDS 125,A00,895341,Jones; Gabrielle Anastasia,43,0,45,2
1745808589070,EDS 128A,A01,895459,Fargason; Sharon Gayle,44,0,45,1
1745808590097,EDS 128B,A01,895543,Pappas; Elizabeth,44,0,45,1
1745808591124,EDS 139,A00,897203,Pappas; Elizabeth,44,0,45,1
1745808591124,EDS 139,B00,897209,Fargason; Sharon Gayle,44,0,45,1
1745808592153,EDS 201,A00,895545,Staff,43,0,45,2
1745808593179,EDS 203,A01,895581,Halter; Christopher P.,43,0,45,2
1745808594207,EDS 204R,A01,895625,Heinzman; Erica M.,43,0,45,2
1745808594207,EDS 204R,B01,895693,Halter; Christopher P.,18,0,45,27
1745808595232,EDS 206R,A00,895694,Fargason; Sharon Gayle,9,0,30,21
1745808595232,EDS 206R,B00,895695,Choi; Bailey Miyeon,20,0,30,10
1745808596259,EDS 250,A00,895697,Hemans; Patricia Ann Benitez,43,0,45,2
1745808597285,EDS 281,A00,895701,Meyerott; Theresa Ann,15,0,15,0
1745808598311,EDS 284,A00,895736,Meyerott; Theresa Ann,15,0,15,0
1745808599341,EDS 286,A00,897210,Fine; Sarah,15,0,15,0
1745808600367,EDS 289C,A01,895770,Daly; Alan J.,15,0,15,0
1745808601394,EDS 290,A00,897211,Hofstetter; Carolyn,15,0,15,0
1745808602424,LIGM 5A,A00,896162,Fischer-Grunski; Eva K,15,0,20,5
1745808603452,LIGM 5B,A00,896260,Fischer-Grunski; Eva K,17,0,20,3
1745808604479,LIGM 5C,A00,896308,Fischer-Grunski; Eva K,18,0,20,2
1745808605509,LIIT 5AS,A00,896313,Carnelos; Chiara,18,0,20,2
1745808606538,LIIT 5BS,A00,896416,Carnelos; Chiara,20,0,20,0
1745808607566,LIIT 5CS,A00,896564,Carnelos; Chiara,20,0,20,0
1745808608591,LISP 5A,A00,896588,Munoz Sanchez; Alicia,4,0,20,16
1745808609618,LISP 5B,A00,896653,Munoz Sanchez; Alicia,10,0,20,10
1745808610643,LISP 5C,A00,896655,Munoz Sanchez; Alicia,4,0,20,16
1745808611667,MAE 197,001,957918,Kleissl; Jan,9998,0,9999,1
1745808612695,MATH 2,A01,957937,Staff,34,0,35,1
1745808613720,MATH 197,001,957876,Kedlaya; Kiran S.,9993,0,9999,6
1745808614749,MCWP 40,A00,892729,Duru; Nur,13,0,20,7
1745808614749,MCWP 40,B00,893304,Montejo; Carolina,20,0,20,0
1745808615775,MCWP 40R,A00,893757,Redela; Pamela Morgan,0,7,20,20
1745808616801,MCWP 50,A00,893758,Morshed; Michael James,2,0,20,18
1745808616801,MCWP 50,B00,893761,Bartulis; Jason Michael,17,0,20,3
1745808617827,MCWP 50R,A00,893766,Compas; Sean Matthew,0,1,20,20
1745808617827,MCWP 50R,B00,893769,Carter; Jennifer A,0,0,20,20
1745808617827,MCWP 50R,C00,893771,Krone; Jarret,0,3,20,20
1745808617827,MCWP 50R,D00,893772,Miller; Elizabeth Deen,3,0,20,17
1745808617827,MCWP 50R,E00,893775,Carter; Andrea L,0,0,20,20
1745808618854,MMW 11R,A01,892721,Herbst; Matthew,11,0,27,16
1745808618854,MMW 11R,A02,892722,Herbst; Matthew,0,0,0,3
1745808619882,MMW 12R,A01,892724,Herbst; Matthew,0,9,16,16
1745808619882,MMW 12R,A02,892725,Herbst; Matthew,0,9,16,16
1745808620908,MMW 13R,A01,892727,Staff,0,4,16,16
1745808620908,MMW 13R,A02,892728,Staff,0,4,16,16
1745808620908,MMW 13R,A03,958032,Staff,0,3,16,16
1745808620908,MMW 13R,A04,958033,Staff,0,2,16,16
1745808620908,MMW 13R,A05,958034,Staff,0,3,16,16
1745808621936,SIO 295LS,A00,894015,Staff,7,0,25,18
1745808622960,SIO 295S,A00,894020,Staff,7,0,25,18
1745808623991,SIOC 290S,B01,958918,Staff,0,0,0,0
1745808625018,SIOC 291S,B01,958922,Staff,0,0,0,0
1745808626048,SOCI 117,A01,895339,Staff,4,0,5,1
1745808627073,WES 237B,A00,894149,Staff,11,0,20,9
1745808629136,AESE 279B,A00,891859,Staff,13,0,35,22
1745808630161,AIP 197,001,891854,Staff,70,0,70,0
1745808631186,ANTH 289S,A00,891856,Gagneux; Pascal,12,0,12,0
1745808632215,BENG 196,001,957946,Engler; Adam J.,9996,0,9999,3
1745808633242,CAT 124RS,A01,956906,Staff,8,0,25,17
1745808634269,CAT 125RS,A01,922013,Staff,8,0,25,17
1745808635295,CLRE 250,A00,891860,Morris; Sheldon,9995,0,9999,4
1745808637382,CLRE 251R,A00,907817,Mehta; Ravindra L.,9994,0,9999,5
1745808638413,CLRE 252,A00,891864,Cuomo; Raphael Eduardo,9993,0,9999,6
1745808639439,CLRE 253,A00,891867,Vaida; Florin,9994,0,9999,5
1745808639439,CLRE 253,B00,907819,Staff,9999,0,9999,0
1745808640465,CLRE 259,A00,891868,Patel; Hemal,9998,0,9999,1
1745808641492,CLRE 260,A00,891872,Cuomo; Raphael Eduardo,9999,0,9999,0
1745808642522,CLRE 297,001,891888,Cuomo; Raphael Eduardo,9999,0,9999,0
1745808643549,CSE 191,A00,958773,Minnes Kemp; Mor Mia,9999,0,9999,0
1745808644577,CSS 201S,A01,892054,Mignozzetti; Umberto,30,0,30,0
1745808645607,CSS 202S,A01,892056,Mignozzetti; Umberto,30,0,30,0
1745808646635,DSC 197,001,956898,Eldridge; Justin Matthew,9998,0,9999,1
1745808647661,DSC 297,001,958000,Mazumdar; Arya,9998,0,9999,1
1745808648690,EAP 100,A00,905686,Staff,9776,0,9999,223
1745808649719,ECE 45,A01,892618,Staff,0,12,50,50
1745808650744,ECE 109,A01,892620,Staff,0,44,0,0
1745808651773,ECE 111,A01,892719,Staff,0,8,50,50
1745808652799,ECE 197,001,957920,Mercier; Patrick Philip,9992,0,9999,7
1745808653830,ECON 178,A01,907814,Zhu; Ying,28,0,35,7
1745808654858,EDS 115,A00,895312,Staff,41,0,45,4
1745808655887,EDS 117,A01,895337,Staff,30,0,30,0
1745808656912,EDS 125,A00,895341,Jones; Gabrielle Anastasia,43,0,45,2
1745808657940,EDS 128A,A01,895459,Fargason; Sharon Gayle,44,0,45,1
1745808658967,EDS 128B,A01,895543,Pappas; Elizabeth,44,0,45,1
1745808659996,EDS 139,A00,897203,Pappas; Elizabeth,44,0,45,1
1745808659996,EDS 139,B00,897209,Fargason; Sharon Gayle,44,0,45,1
1745808661024,EDS 201,A00,895545,Staff,43,0,45,2
1745808662051,EDS 203,A01,895581,Halter; Christopher P.,43,0,45,2
1745808663079,EDS 204R,A01,895625,Heinzman; Erica M.,43,0,45,2
1745808663079,EDS 204R,B01,895693,Halter; Christopher P.,18,0,45,27
1745808664108,EDS 206R,A00,895694,Fargason; Sharon Gayle,9,0,30,21
1745808664108,EDS 206R,B00,895695,Choi; Bailey Miyeon,20,0,30,10
1745808665133,EDS 250,A00,895697,Hemans; Patricia Ann Benitez,43,0,45,2
1745808666161,EDS 281,A00,895701,Meyerott; Theresa Ann,15,0,15,0
1745808667190,EDS 284,A00,895736,Meyerott; Theresa Ann,15,0,15,0
1745808668218,EDS 286,A00,897210,Fine; Sarah,15,0,15,0
1745808669243,EDS 289C,A01,895770,Daly; Alan J.,15,0,15,0
1745808670271,EDS 290,A00,897211,Hofstetter; Carolyn,15,0,15,0
1745808671299,LIGM 5A,A00,896162,Fischer-Grunski; Eva K,15,0,20,5
1745808672328,LIGM 5B,A00,896260,Fischer-Grunski; Eva K,17,0,20,3
1745808673353,LIGM 5C,A00,896308,Fischer-Grunski; Eva K,18,0,20,2
1745808674383,LIIT 5AS,A00,896313,Carnelos; Chiara,18,0,20,2
1745808675412,LIIT 5BS,A00,896416,Carnelos; Chiara,20,0,20,0
1745808676438,LIIT 5CS,A00,896564,Carnelos; Chiara,20,0,20,0
1745808677462,LISP 5A,A00,896588,Munoz Sanchez; Alicia,4,0,20,16
1745808678487,LISP 5B,A00,896653,Munoz Sanchez; Alicia,10,0,20,10
1745808679514,LISP 5C,A00,896655,Munoz Sanchez; Alicia,4,0,20,16
1745808680543,MAE 197,001,957918,Kleissl; Jan,9998,0,9999,1
1745808681569,MATH 2,A01,957937,Staff,34,0,35,1
1745808682595,MATH 197,001,957876,Kedlaya; Kiran S.,9993,0,9999,6
1745808683623,MCWP 40,A00,892729,Duru; Nur,13,0,20,7
1745808683623,MCWP 40,B00,893304,Montejo; Carolina,20,0,20,0
1745808684651,MCWP 40R,A00,893757,Redela; Pamela Morgan,0,7,20,20
1745808685679,MCWP 50,A00,893758,Morshed; Michael James,2,0,20,18
1745808685679,MCWP 50,B00,893761,Bartulis; Jason Michael,17,0,20,3
1745808686710,MCWP 50R,A00,893766,Compas; Sean Matthew,0,1,20,20
1745808686710,MCWP 50R,B00,893769,Carter; Jennifer A,0,0,20,20
1745808686710,MCWP 50R,C00,893771,Krone; Jarret,0,3,20,20
1745808686710,MCWP 50R,D00,893772,Miller; Elizabeth Deen,3,0,20,17
1745808686710,MCWP 50R,E00,893775,Carter; Andrea L,0,0,20,20
1745808687738,MMW 11R,A01,892721,Herbst; Matthew,11,0,27,16
1745808687738,MMW 11R,A02,892722,Herbst; Matthew,0,0,0,3
1745808688766,MMW 12R,A01,892724,Herbst; Matthew,0,9,16,16
1745808688766,MMW 12R,A02,892725,Herbst; Matthew,0,9,16,16
1745808689796,MMW 13R,A01,892727,Staff,0,4,16,16
1745808689796,MMW 13R,A02,892728,Staff,0,4,16,16
1745808689796,MMW 13R,A03,958032,Staff,0,3,16,16
1745808689796,MMW 13R,A04,958033,Staff,0,2,16,16
1745808689796,MMW 13R,A05,958034,Staff,0,3,16,16
1745808690822,SIO 295LS,A00,894015,Staff,7,0,25,18
1745808691850,SIO 295S,A00,894020,Staff,7,0,25,18
1745808692880,SIOC 290S,B01,958918,Staff,0,0,0,0
1745808693906,SIOC 291S,B01,958922,Staff,0,0,0,0
1745808694930,SOCI 117,A01,895339,Staff,4,0,5,1
1745808695955,WES 237B,A00,894149,Staff,11,0,20,9
1745808698020,AESE 279B,A00,891859,Staff,13,0,35,22
1745808699045,AIP 197,001,891854,Staff,70,0,70,0
1745808700072,ANTH 289S,A00,891856,Gagneux; Pascal,12,0,12,0
1745808701095,BENG 196,001,957946,Engler; Adam J.,9996,0,9999,3
1745808702121,CAT 124RS,A01,956906,Staff,8,0,25,17
1745808703145,CAT 125RS,A01,922013,Staff,8,0,25,17
1745808704170,CLRE 250,A00,891860,Morris; Sheldon,9995,0,9999,4
1745808706226,CLRE 251R,A00,907817,Mehta; Ravindra L.,9994,0,9999,5
1745808707253,CLRE 252,A00,891864,Cuomo; Raphael Eduardo,9993,0,9999,6
1745808708282,CLRE 253,A00,891867,Vaida; Florin,9994,0,9999,5
1745808708282,CLRE 253,B00,907819,Staff,9999,0,9999,0
1745808709307,CLRE 259,A00,891868,Patel; Hemal,9998,0,9999,1
1745808710335,CLRE 260,A00,891872,Cuomo; Raphael Eduardo,9999,0,9999,0
1745808711361,CLRE 297,001,891888,Cuomo; Raphael Eduardo,9999,0,9999,0
1745808712399,CSE 191,A00,958773,Minnes Kemp; Mor Mia,9999,0,9999,0
1745808713427,CSS 201S,A01,892054,Mignozzetti; Umberto,30,0,30,0
1745808714453,CSS 202S,A01,892056,Mignozzetti; Umberto,30,0,30,0
1745808715478,DSC 197,001,956898,Eldridge; Justin Matthew,9998,0,9999,1
1745808716503,DSC 297,001,958000,Mazumdar; Arya,9998,0,9999,1
1745808717529,EAP 100,A00,905686,Staff,9776,0,9999,223
1745808718571,ECE 45,A01,892618,Staff,0,12,50,50
1745808719596,ECE 109,A01,892620,Staff,0,44,0,0
1745808720626,ECE 111,A01,892719,Staff,0,8,50,50
1745808721653,ECE 197,001,957920,Mercier; Patrick Philip,9992,0,9999,7
1745808722678,ECON 178,A01,907814,Zhu; Ying,28,0,35,7
1745808723703,EDS 115,A00,895312,Staff,41,0,45,4
1745808724727,EDS 117,A01,895337,Staff,30,0,30,0
1745808725752,EDS 125,A00,895341,Jones; Gabrielle Anastasia,43,0,45,2
1745808726776,EDS 128A,A01,895459,Fargason; Sharon Gayle,44,0,45,1
1745808727800,EDS 128B,A01,895543,Pappas; Elizabeth,44,0,45,1
1745808728825,EDS 139,A00,897203,Pappas; Elizabeth,44,0,45,1
1745808728825,EDS 139,B00,897209,Fargason; Sharon Gayle,44,0,45,1
1745808729854,EDS 201,A00,895545,Staff,43,0,45,2
1745808730881,EDS 203,A01,895581,Halter; Christopher P.,43,0,45,2
1745808731912,EDS 204R,A01,895625,Heinzman; Erica M.,43,0,45,2
1745808731912,EDS 204R,B01,895693,Halter; Christopher P.,18,0,45,27
1745808732939,EDS 206R,A00,895694,Fargason; Sharon Gayle,9,0,30,21
1745808732939,EDS 206R,B00,895695,Choi; Bailey Miyeon,20,0,30,10
1745808733964,EDS 250,A00,895697,Hemans; Patricia Ann Benitez,43,0,45,2
1745808734992,EDS 281,A00,895701,Meyerott; Theresa Ann,15,0,15,0
1745808736023,EDS 284,A00,895736,Meyerott; Theresa Ann,15,0,15,0
1745808737051,EDS 286,A00,897210,Fine; Sarah,15,0,15,0
1745808738076,EDS 289C,A01,895770,Daly; Alan J.,15,0,15,0
1745808739101,EDS 290,A00,897211,Hofstetter; Carolyn,15,0,15,0
1745808740127,LIGM 5A,A00,896162,Fischer-Grunski; Eva K,15,0,20,5
1745808741155,LIGM 5B,A00,896260,Fischer-Grunski; Eva K,17,0,20,3
1745808742181,LIGM 5C,A00,896308,Fischer-Grunski; Eva K,18,0,20,2
1745808743208,LIIT 5AS,A00,896313,Carnelos; Chiara,18,0,20,2
1745808744237,LIIT 5BS,A00,896416,Carnelos; Chiara,20,0,20,0
1745808745267,LIIT 5CS,A00,896564,Carnelos; Chiara,20,0,20,0
1745808746312,LISP 5A,A00,896588,Munoz Sanchez; Alicia,4,0,20,16
1745808747341,LISP 5B,A00,896653,Munoz Sanchez; Alicia,10,0,20,10
1745808748365,LISP 5C,A00,896655,Munoz Sanchez; Alicia,4,0,20,16
1745808749393,MAE 197,001,957918,Kleissl; Jan,9998,0,9999,1
1745808750417,MATH 2,A01,957937,Staff,34,0,35,1
1745808751445,MATH 197,001,957876,Kedlaya; Kiran S.,9993,0,9999,6
1745808752471,MCWP 40,A00,892729,Duru; Nur,13,0,20,7
1745808752471,MCWP 40,B00,893304,Montejo; Carolina,20,0,20,0
1745808753498,MCWP 40R,A00,893757,Redela; Pamela Morgan,0,7,20,20
1745808754523,MCWP 50,A00,893758,Morshed; Michael James,2,0,20,18
1745808754523,MCWP 50,B00,893761,Bartulis; Jason Michael,17,0,20,3
1745808755551,MCWP 50R,A00,893766,Compas; Sean Matthew,0,1,20,20
1745808755551,MCWP 50R,B00,893769,Carter; Jennifer A,0,0,20,20
1745808755551,MCWP 50R,C00,893771,Krone; Jarret,0,3,20,20
1745808755551,MCWP 50R,D00,893772,Miller; Elizabeth Deen,3,0,20,17
1745808755551,MCWP 50R,E00,893775,Carter; Andrea L,0,0,20,20
1745808756577,MMW 11R,A01,892721,Herbst; Matthew,11,0,27,16
1745808756577,MMW 11R,A02,892722,Herbst; Matthew,0,0,0,3
1745808757601,MMW 12R,A01,892724,Herbst; Matthew,0,9,16,16
1745808757601,MMW 12R,A02,892725,Herbst; Matthew,0,9,16,16
1745808758629,MMW 13R,A01,892727,Staff,0,4,16,16
1745808758629,MMW 13R,A02,892728,Staff,0,4,16,16
1745808758629,MMW 13R,A03,958032,Staff,0,3,16,16
1745808758629,MMW 13R,A04,958033,Staff,0,2,16,16
1745808758629,MMW 13R,A05,958034,Staff,0,3,16,16
1745808759652,SIO 295LS,A00,894015,Staff,7,0,25,18
1745808760679,SIO 295S,A00,894020,Staff,7,0,25,18
1745808761705,SIOC 290S,B01,958918,Staff,0,0,0,0
1745808762731,SIOC 291S,B01,958922,Staff,0,0,0,0
1745808763759,SOCI 117,A01,895339,Staff,4,0,5,1
1745808764783,WES 237B,A00,894149,Staff,11,0,20,9
1745808766846,AESE 279B,A00,891859,Staff,13,0,35,22
1745808767872,AIP 197,001,891854,Staff,70,0,70,0
1745808768895,ANTH 289S,A00,891856,Gagneux; Pascal,12,0,12,0
1745808769920,BENG 196,001,957946,Engler; Adam J.,9996,0,9999,3
1745808770943,CAT 124RS,A01,956906,Staff,8,0,25,17
1745808771971,CAT 125RS,A01,922013,Staff,8,0,25,17
1745808772999,CLRE 250,A00,891860,Morris; Sheldon,9995,0,9999,4
1745808775050,CLRE 251R,A00,907817,Mehta; Ravindra L.,9994,0,9999,5
1745808776073,CLRE 252,A00,891864,Cuomo; Raphael Eduardo,9993,0,9999,6
1745808777100,CLRE 253,A00,891867,Vaida; Florin,9994,0,9999,5
1745808777100,CLRE 253,B00,907819,Staff,9999,0,9999,0
1745808778128,CLRE 259,A00,891868,Patel; Hemal,9998,0,9999,1
1745808779155,CLRE 260,A00,891872,Cuomo; Raphael Eduardo,9999,0,9999,0
1745808780182,CLRE 297,001,891888,Cuomo; Raphael Eduardo,9999,0,9999,0
1745808781207,CSE 191,A00,958773,Minnes Kemp; Mor Mia,9999,0,9999,0
1745808782242,CSS 201S,A01,892054,Mignozzetti; Umberto,30,0,30,0
1745808783273,CSS 202S,A01,892056,Mignozzetti; Umberto,30,0,30,0
1745808784301,DSC 197,001,956898,Eldridge; Justin Matthew,9998,0,9999,1
1745808785330,DSC 297,001,958000,Mazumdar; Arya,9998,0,9999,1
1745808786358,EAP 100,A00,905686,Staff,9776,0,9999,223
1745808787383,ECE 45,A01,892618,Staff,0,12,50,50
1745808788412,ECE 109,A01,892620,Staff,0,44,0,0
1745808789438,ECE 111,A01,892719,Staff,0,8,50,50
1745808790462,ECE 197,001,957920,Mercier; Patrick Philip,9992,0,9999,7
1745808791489,ECON 178,A01,907814,Zhu; Ying,28,0,35,7
1745808792515,EDS 115,A00,895312,Staff,41,0,45,4
1745808793542,EDS 117,A01,895337,Staff,30,0,30,0
1745808794570,EDS 125,A00,895341,Jones; Gabrielle Anastasia,43,0,45,2
1745808795597,EDS 128A,A01,895459,Fargason; Sharon Gayle,44,0,45,1
1745808796627,EDS 128B,A01,895543,Pappas; Elizabeth,44,0,45,1
1745808797653,EDS 139,A00,897203,Pappas; Elizabeth,44,0,45,1
1745808797653,EDS 139,B00,897209,Fargason; Sharon Gayle,44,0,45,1
1745808798678,EDS 201,A00,895545,Staff,43,0,45,2
1745808799705,EDS 203,A01,895581,Halter; Christopher P.,43,0,45,2
1745808800732,EDS 204R,A01,895625,Heinzman; Erica M.,43,0,45,2
1745808800732,EDS 204R,B01,895693,Halter; Christopher P.,18,0,45,27
1745808801760,EDS 206R,A00,895694,Fargason; Sharon Gayle,9,0,30,21
1745808801760,EDS 206R,B00,895695,Choi; Bailey Miyeon,20,0,30,10
1745808802788,EDS 250,A00,895697,Hemans; Patricia Ann Benitez,43,0,45,2
1745808803815,EDS 281,A00,895701,Meyerott; Theresa Ann,15,0,15,0
1745808804843,EDS 284,A00,895736,Meyerott; Theresa Ann,15,0,15,0
1745808805871,EDS 286,A00,897210,Fine; Sarah,15,0,15,0
1745808806901,EDS 289C,A01,895770,Daly; Alan J.,15,0,15,0
1745808807929,EDS 290,A00,897211,Hofstetter; Carolyn,15,0,15,0
1745808808959,LIGM 5A,A00,896162,Fischer-Grunski; Eva K,15,0,20,5
1745808809987,LIGM 5B,A00,896260,Fischer-Grunski; Eva K,17,0,20,3
1745808811014,LIGM 5C,A00,896308,Fischer-Grunski; Eva K,18,0,20,2
1745808812040,LIIT 5AS,A00,896313,Carnelos; Chiara,18,0,20,2
1745808813065,LIIT 5BS,A00,896416,Carnelos; Chiara,20,0,20,0
1745808814093,LIIT 5CS,A00,896564,Carnelos; Chiara,20,0,20,0
1745808815124,LISP 5A,A00,896588,Munoz Sanchez; Alicia,4,0,20,16
1745808816154,LISP 5B,A00,896653,Munoz Sanchez; Alicia,10,0,20,10
1745808817179,LISP 5C,A00,896655,Munoz Sanchez; Alicia,4,0,20,16
1745808818205,MAE 197,001,957918,Kleissl; Jan,9998,0,9999,1
1745808819236,MATH 2,A01,957937,Staff,34,0,35,1
1745808820264,MATH 197,001,957876,Kedlaya; Kiran S.,9993,0,9999,6
1745808821294,MCWP 40,A00,892729,Duru; Nur,13,0,20,7
1745808821294,MCWP 40,B00,893304,Montejo; Carolina,20,0,20,0
1745808822348,MCWP 40R,A00,893757,Redela; Pamela Morgan,0,7,20,20
1745808823374,MCWP 50,A00,893758,Morshed; Michael James,2,0,20,18
1745808823374,MCWP 50,B00,893761,Bartulis; Jason Michael,17,0,20,3
1745808824406,MCWP 50R,A00,893766,Compas; Sean Matthew,0,1,20,20
1745808824406,MCWP 50R,B00,893769,Carter; Jennifer A,0,0,20,20
1745808824406,MCWP 50R,C00,893771,Krone; Jarret,0,3,20,20
1745808824406,MCWP 50R,D00,893772,Miller; Elizabeth Deen,3,0,20,17
1745808824406,MCWP 50R,E00,893775,Carter; Andrea L,0,0,20,20
1745808825435,MMW 11R,A01,892721,Herbst; Matthew,11,0,27,16
1745808825435,MMW 11R,A02,892722,Herbst; Matthew,0,0,0,3
1745808826484,MMW 12R,A01,892724,Herbst; Matthew,0,9,16,16
1745808826484,MMW 12R,A02,892725,Herbst; Matthew,0,9,16,16
1745808827509,MMW 13R,A01,892727,Staff,0,4,16,16
1745808827509,MMW 13R,A02,892728,Staff,0,4,16,16
1745808827509,MMW 13R,A03,958032,Staff,0,3,16,16
1745808827509,MMW 13R,A04,958033,Staff,0,2,16,16
1745808827509,MMW 13R,A05,958034,Staff,0,3,16,16
1745808828533,SIO 295LS,A00,894015,Staff,7,0,25,18
1745808829560,SIO 295S,A00,894020,Staff,7,0,25,18
1745808830588,SIOC 290S,B01,958918,Staff,0,0,0,0
1745808831618,SIOC 291S,B01,958922,Staff,0,0,0,0
1745808832644,SOCI 117,A01,895339,Staff,4,0,5,1
1745808833668,WES 237B,A00,894149,Staff,11,0,20,9
1745808835732,AESE 279B,A00,891859,Staff,13,0,35,22
1745808836758,AIP 197,001,891854,Staff,70,0,70,0
1745808837783,ANTH 289S,A00,891856,Gagneux; Pascal,12,0,12,0
1745808838809,BENG 196,001,957946,Engler; Adam J.,9996,0,9999,3
1745808839833,CAT 124RS,A01,956906,Staff,8,0,25,17
1745808840856,CAT 125RS,A01,922013,Staff,8,0,25,17
1745808841883,CLRE 250,A00,891860,Morris; Sheldon,9995,0,9999,4
1745808843935,CLRE 251R,A00,907817,Mehta; Ravindra L.,9994,0,9999,5
1745808844961,CLRE 252,A00,891864,Cuomo; Raphael Eduardo,9993,0,9999,6
1745808845988,CLRE 253,A00,891867,Vaida; Florin,9994,0,9999,5
1745808845988,CLRE 253,B00,907819,Staff,9999,0,9999,0
1745808847016,CLRE 259,A00,891868,Patel; Hemal,9998,0,9999,1
1745808848045,CLRE 260,A00,891872,Cuomo; Raphael Eduardo,9999,0,9999,0
1745808849097,CLRE 297,001,891888,Cuomo; Raphael Eduardo,9999,0,9999,0
1745808850121,CSE 191,A00,958773,Minnes Kemp; Mor Mia,9999,0,9999,0
1745808851148,CSS 201S,A01,892054,Mignozzetti; Umberto,30,0,30,0
1745808852175,CSS 202S,A01,892056,Mignozzetti; Umberto,30,0,30,0
1745808853199,DSC 197,001,956898,Eldridge; Justin Matthew,9998,0,9999,1
1745808854228,DSC 297,001,958000,Mazumdar; Arya,9998,0,9999,1
1745808855252,EAP 100,A00,905686,Staff,9776,0,9999,223
1745808856278,ECE 45,A01,892618,Staff,0,12,50,50
1745808857305,ECE 109,A01,892620,Staff,0,44,0,0
1745808858332,ECE 111,A01,892719,Staff,0,8,50,50
1745808859359,ECE 197,001,957920,Mercier; Patrick Philip,9992,0,9999,7
1745808860385,ECON 178,A01,907814,Zhu; Ying,28,0,35,7
1745808861410,EDS 115,A00,895312,Staff,41,0,45,4
1745808862437,EDS 117,A01,895337,Staff,30,0,30,0
1745808863463,EDS 125,A00,895341,Jones; Gabrielle Anastasia,43,0,45,2
1745808864491,EDS 128A,A01,895459,Fargason; Sharon Gayle,44,0,45,1
1745808865522,EDS 128B,A01,895543,Pappas; Elizabeth,44,0,45,1
1745808866551,EDS 139,A00,897203,Pappas; Elizabeth,44,0,45,1
1745808866551,EDS 139,B00,897209,Fargason; Sharon Gayle,44,0,45,1
1745808867578,EDS 201,A00,895545,Staff,43,0,45,2
1745808868602,EDS 203,A01,895581,Halter; Christopher P.,43,0,45,2
1745808869631,EDS 204R,A01,895625,Heinzman; Erica M.,43,0,45,2
1745808869631,EDS 204R,B01,895693,Halter; Christopher P.,18,0,45,27
1745808870659,EDS 206R,A00,895694,Fargason; Sharon Gayle,9,0,30,21
1745808870659,EDS 206R,B00,895695,Choi; Bailey Miyeon,20,0,30,10
1745808871683,EDS 250,A00,895697,Hemans; Patricia Ann Benitez,43,0,45,2
1745808872710,EDS 281,A00,895701,Meyerott; Theresa Ann,15,0,15,0
1745808873739,EDS 284,A00,895736,Meyerott; Theresa Ann,15,0,15,0
1745808874765,EDS 286,A00,897210,Fine; Sarah,15,0,15,0
1745808875793,EDS 289C,A01,895770,Daly; Alan J.,15,0,15,0
1745808876820,EDS 290,A00,897211,Hofstetter; Carolyn,15,0,15,0
1745808877847,LIGM 5A,A00,896162,Fischer-Grunski; Eva K,15,0,20,5
1745808878876,LIGM 5B,A00,896260,Fischer-Grunski; Eva K,17,0,20,3
1745808879901,LIGM 5C,A00,896308,Fischer-Grunski; Eva K,18,0,20,2
1745808880927,LIIT 5AS,A00,896313,Carnelos; Chiara,18,0,20,2
1745808881956,LIIT 5BS,A00,896416,Carnelos; Chiara,20,0,20,0
1745808882985,LIIT 5CS,A00,896564,Carnelos; Chiara,20,0,20,0
1745808884012,LISP 5A,A00,896588,Munoz Sanchez; Alicia,4,0,20,16
1745808885044,LISP 5B,A00,896653,Munoz Sanchez; Alicia,10,0,20,10
1745808886071,LISP 5C,A00,896655,Munoz Sanchez; Alicia,4,0,20,16
1745808887097,MAE 197,001,957918,Kleissl; Jan,9998,0,9999,1
1745808888124,MATH 2,A01,957937,Staff,34,0,35,1
1745808889155,MATH 197,001,957876,Kedlaya; Kiran S.,9993,0,9999,6
1745808890181,MCWP 40,A00,892729,Duru; Nur,13,0,20,7
1745808890181,MCWP 40,B00,893304,Montejo; Carolina,20,0,20,0
1745808891209,MCWP 40R,A00,893757,Redela; Pamela Morgan,0,7,20,20
1745808892312,MCWP 50,A00,893758,Morshed; Michael James,2,0,20,18
1745808892312,MCWP 50,B00,893761,Bartulis; Jason Michael,17,0,20,3
1745808893375,MCWP 50R,A00,893766,Compas; Sean Matthew,0,1,20,20
1745808893375,MCWP 50R,B00,893769,Carter; Jennifer A,0,0,20,20
1745808893375,MCWP 50R,C00,893771,Krone; Jarret,0,3,20,20
1745808893375,MCWP 50R,D00,893772,Miller; Elizabeth Deen,3,0,20,17
1745808893375,MCWP 50R,E00,893775,Carter; Andrea L,0,0,20,20
1745808894402,MMW 11R,A01,892721,Herbst; Matthew,11,0,27,16
1745808894402,MMW 11R,A02,892722,Herbst; Matthew,0,0,0,3
1745808895429,MMW 12R,A01,892724,Herbst; Matthew,0,9,16,16
1745808895429,MMW 12R,A02,892725,Herbst; Matthew,0,9,16,16
1745808896460,MMW 13R,A01,892727,Staff,0,4,16,16
1745808896460,MMW 13R,A02,892728,Staff,0,4,16,16
1745808896460,MMW 13R,A03,958032,Staff,0,3,16,16
1745808896460,MMW 13R,A04,958033,Staff,0,2,16,16
1745808896460,MMW 13R,A05,958034,Staff,0,3,16,16
1745808897484,SIO 295LS,A00,894015,Staff,7,0,25,18
1745808898509,SIO 295S,A00,894020,Staff,7,0,25,18
1745808899536,SIOC 290S,B01,958918,Staff,0,0,0,0
1745808900567,SIOC 291S,B01,958922,Staff,0,0,0,0
1745808901595,SOCI 117,A01,895339,Staff,4,0,5,1
1745808902622,WES 237B,A00,894149,Staff,11,0,20,9
1745808904685,AESE 279B,A00,891859,Staff,13,0,35,22
1745808905712,AIP 197,001,891854,Staff,70,0,70,0
1745808906744,ANTH 289S,A00,891856,Gagneux; Pascal,12,0,12,0
1745808907773,BENG 196,001,957946,Engler; Adam J.,9996,0,9999,3
1745808908799,CAT 124RS,A01,956906,Staff,8,0,25,17
1745808909825,CAT 125RS,A01,922013,Staff,8,0,25,17
1745808910852,CLRE 250,A00,891860,Morris; Sheldon,9995,0,9999,4
1745808912903,CLRE 251R,A00,907817,Mehta; Ravindra L.,9994,0,9999,5
1745808913937,CLRE 252,A00,891864,Cuomo; Raphael Eduardo,9993,0,9999,6
1745808914963,CLRE 253,A00,891867,Vaida; Florin,9994,0,9999,5
1745808914963,CLRE 253,B00,907819,Staff,9999,0,9999,0
1745808915989,CLRE 259,A00,891868,Patel; Hemal,9998,0,9999,1
1745808917015,CLRE 260,A00,891872,Cuomo; Raphael Eduardo,9999,0,9999,0
1745808918041,CLRE 297,001,891888,Cuomo; Raphael Eduardo,9999,0,9999,0
1745808919066,CSE 191,A00,958773,Minnes Kemp; Mor Mia,9999,0,9999,0
1745808920096,CSS 201S,A01,892054,Mignozzetti; Umberto,30,0,30,0
1745808921126,CSS 202S,A01,892056,Mignozzetti; Umberto,30,0,30,0
1745808922153,DSC 197,001,956898,Eldridge; Justin Matthew,9998,0,9999,1
1745808923178,DSC 297,001,958000,Mazumdar; Arya,9998,0,9999,1
1745808924204,EAP 100,A00,905686,Staff,9776,0,9999,223
1745808925232,ECE 45,A01,892618,Staff,0,12,50,50
1745808926256,ECE 109,A01,892620,Staff,0,44,0,0
1745808927281,ECE 111,A01,892719,Staff,0,8,50,50
1745808928307,ECE 197,001,957920,Mercier; Patrick Philip,9992,0,9999,7
1745808929336,ECON 178,A01,907814,Zhu; Ying,28,0,35,7
1745808930366,EDS 115,A00,895312,Staff,41,0,45,4
1745808931393,EDS 117,A01,895337,Staff,30,0,30,0
1745808932418,EDS 125,A00,895341,Jones; Gabrielle Anastasia,43,0,45,2
1745808933446,EDS 128A,A01,895459,Fargason; Sharon Gayle,44,0,45,1
1745808934486,EDS 128B,A01,895543,Pappas; Elizabeth,44,0,45,1
1745808935511,EDS 139,A00,897203,Pappas; Elizabeth,44,0,45,1
1745808935511,EDS 139,B00,897209,Fargason; Sharon Gayle,44,0,45,1
1745808936538,EDS 201,A00,895545,Staff,43,0,45,2
1745808937566,EDS 203,A01,895581,Halter; Christopher P.,43,0,45,2
1745808938593,EDS 204R,A01,895625,Heinzman; Erica M.,43,0,45,2
1745808938593,EDS 204R,B01,895693,Halter; Christopher P.,18,0,45,27
1745808939619,EDS 206R,A00,895694,Fargason; Sharon Gayle,9,0,30,21
1745808939619,EDS 206R,B00,895695,Choi; Bailey Miyeon,20,0,30,10
1745808940645,EDS 250,A00,895697,Hemans; Patricia Ann Benitez,43,0,45,2
1745808941670,EDS 281,A00,895701,Meyerott; Theresa Ann,15,0,15,0
1745808942698,EDS 284,A00,895736,Meyerott; Theresa Ann,15,0,15,0
1745808943723,EDS 286,A00,897210,Fine; Sarah,15,0,15,0
1745808944749,EDS 289C,A01,895770,Daly; Alan J.,15,0,15,0
1745808945775,EDS 290,A00,897211,Hofstetter; Carolyn,15,0,15,0
1745808946800,LIGM 5A,A00,896162,Fischer-Grunski; Eva K,15,0,20,5
1745808947826,LIGM 5B,A00,896260,Fischer-Grunski; Eva K,17,0,20,3
1745808948856,LIGM 5C,A00,896308,Fischer-Grunski; Eva K,18,0,20,2
1745808949880,LIIT 5AS,A00,896313,Carnelos; Chiara,18,0,20,2
1745808950905,LIIT 5BS,A00,896416,Carnelos; Chiara,20,0,20,0
1745808951930,LIIT 5CS,A00,896564,Carnelos; Chiara,20,0,20,0
1745808952957,LISP 5A,A00,896588,Munoz Sanchez; Alicia,4,0,20,16
1745808953983,LISP 5B,A00,896653,Munoz Sanchez; Alicia,10,0,20,10
1745808955014,LISP 5C,A00,896655,Munoz Sanchez; Alicia,4,0,20,16
1745808956041,MAE 197,001,957918,Kleissl; Jan,9998,0,9999,1
1745808957068,MATH 2,A01,957937,Staff,34,0,35,1
1745808958096,MATH 197,001,957876,Kedlaya; Kiran S.,9993,0,9999,6
1745808959124,MCWP 40,A00,892729,Duru; Nur,13,0,20,7
1745808959124,MCWP 40,B00,893304,Montejo; Carolina,20,0,20,0
1745808960153,MCWP 40R,A00,893757,Redela; Pamela Morgan,0,7,20,20
1745808961181,MCWP 50,A00,893758,Morshed; Michael James,2,0,20,18
1745808961181,MCWP 50,B00,893761,Bartulis; Jason Michael,17,0,20,3
1745808962208,MCWP 50R,A00,893766,Compas; Sean Matthew,0,1,20,20
1745808962208,MCWP 50R,B00,893769,Carter; Jennifer A,0,0,20,20
1745808962208,MCWP 50R,C00,893771,Krone; Jarret,0,3,20,20
1745808962208,MCWP 50R,D00,893772,Miller; Elizabeth Deen,3,0,20,17
1745808962208,MCWP 50R,E00,893775,Carter; Andrea L,0,0,20,20
1745808963236,MMW 11R,A01,892721,Herbst; Matthew,11,0,27,16
1745808963236,MMW 11R,A02,892722,Herbst; Matthew,0,0,0,3
1745808964263,MMW 12R,A01,892724,Herbst; Matthew,0,9,16,16
1745808964263,MMW 12R,A02,892725,Herbst; Matthew,0,9,16,16
1745808965288,MMW 13R,A01,892727,Staff,0,4,16,16
1745808965288,MMW 13R,A02,892728,Staff,0,4,16,16
1745808965288,MMW 13R,A03,958032,Staff,0,3,16,16
1745808965288,MMW 13R,A04,958033,Staff,0,2,16,16
1745808965288,MMW 13R,A05,958034,Staff,0,3,16,16
1745808966313,SIO 295LS,A00,894015,Staff,7,0,25,18
1745808967340,SIO 295S,A00,894020,Staff,7,0,25,18
1745808968370,SIOC 290S,B01,958918,Staff,0,0,0,0
1745808969401,SIOC 291S,B01,958922,Staff,0,0,0,0
1745808970429,SOCI 117,A01,895339,Staff,4,0,5,1
1745808971455,WES 237B,A00,894149,Staff,11,0,20,9
1745808973518,AESE 279B,A00,891859,Staff,13,0,35,22
1745808974546,AIP 197,001,891854,Staff,70,0,70,0
1745808975575,ANTH 289S,A00,891856,Gagneux; Pascal,12,0,12,0
1745808976603,BENG 196,001,957946,Engler; Adam J.,9996,0,9999,3
1745808977628,CAT 124RS,A01,956906,Staff,8,0,25,17
1745808978652,CAT 125RS,A01,922013,Staff,8,0,25,17
1745808979680,CLRE 250,A00,891860,Morris; Sheldon,9995,0,9999,4
1745808981733,CLRE 251R,A00,907817,Mehta; Ravindra L.,9994,0,9999,5
1745808982759,CLRE 252,A00,891864,Cuomo; Raphael Eduardo,9993,0,9999,6
1745808983784,CLRE 253,A00,891867,Vaida; Florin,9994,0,9999,5
1745808983784,CLRE 253,B00,907819,Staff,9999,0,9999,0
1745808984812,CLRE 259,A00,891868,Patel; Hemal,9998,0,9999,1
1745808985840,CLRE 260,A00,891872,Cuomo; Raphael Eduardo,9999,0,9999,0
1745808986870,CLRE 297,001,891888,Cuomo; Raphael Eduardo,9999,0,9999,0
1745808987899,CSE 191,A00,958773,Minnes Kemp; Mor Mia,9999,0,9999,0
1745808988928,CSS 201S,A01,892054,Mignozzetti; Umberto,30,0,30,0
1745808989955,CSS 202S,A01,892056,Mignozzetti; Umberto,30,0,30,0
1745808990983,DSC 197,001,956898,Eldridge; Justin Matthew,9998,0,9999,1
1745808992011,DSC 297,001,958000,Mazumdar; Arya,9998,0,9999,1
1745808993040,EAP 100,A00,905686,Staff,9776,0,9999,223
1745808994068,ECE 45,A01,892618,Staff,0,12,50,50
1745808995096,ECE 109,A01,892620,Staff,0,44,0,0
1745808996121,ECE 111,A01,892719,Staff,0,8,50,50
1745808997149,ECE 197,001,957920,Mercier; Patrick Philip,9992,0,9999,7
1745808998178,ECON 178,A01,907814,Zhu; Ying,28,0,35,7
1745808999205,EDS 115,A00,895312,Staff,41,0,45,4
1745809000232,EDS 117,A01,895337,Staff,30,0,30,0
1745809001258,EDS 125,A00,895341,Jones; Gabrielle Anastasia,43,0,45,2
1745809002282,EDS 128A,A01,895459,Fargason; Sharon Gayle,44,0,45,1
1745809003310,EDS 128B,A01,895543,Pappas; Elizabeth,44,0,45,1
1745809004356,EDS 139,A00,897203,Pappas; Elizabeth,44,0,45,1
1745809004356,EDS 139,B00,897209,Fargason; Sharon Gayle,44,0,45,1
1745809005384,EDS 201,A00,895545,Staff,43,0,45,2
1745809006409,EDS 203,A01,895581,Halter; Christopher P.,43,0,45,2
1745809007436,EDS 204R,A01,895625,Heinzman; Erica M.,43,0,45,2
1745809007436,EDS 204R,B01,895693,Halter; Christopher P.,18,0,45,27
1745809008461,EDS 206R,A00,895694,Fargason; Sharon Gayle,9,0,30,21
1745809008461,EDS 206R,B00,895695,Choi; Bailey Miyeon,20,0,30,10
1745809009484,EDS 250,A00,895697,Hemans; Patricia Ann Benitez,43,0,45,2
1745809010509,EDS 281,A00,895701,Meyerott; Theresa Ann,15,0,15,0
1745809011535,EDS 284,A00,895736,Meyerott; Theresa Ann,15,0,15,0
1745809012560,EDS 286,A00,897210,Fine; Sarah,15,0,15,0
1745809013586,EDS 289C,A01,895770,Daly; Alan J.,15,0,15,0
1745809014611,EDS 290,A00,897211,Hofstetter; Carolyn,15,0,15,0
1745809015640,LIGM 5A,A00,896162,Fischer-Grunski; Eva K,15,0,20,5
1745809016669,LIGM 5B,A00,896260,Fischer-Grunski; Eva K,17,0,20,3
1745809017696,LIGM 5C,A00,896308,Fischer-Grunski; Eva K,18,0,20,2
1745809018720,LIIT 5AS,A00,896313,Carnelos; Chiara,18,0,20,2
1745809019744,LIIT 5BS,A00,896416,Carnelos; Chiara,20,0,20,0
1745809020771,LIIT 5CS,A00,896564,Carnelos; Chiara,20,0,20,0
1745809021801,LISP 5A,A00,896588,Munoz Sanchez; Alicia,4,0,20,16
1745809022833,LISP 5B,A00,896653,Munoz Sanchez; Alicia,10,0,20,10
1745809023860,LISP 5C,A00,896655,Munoz Sanchez; Alicia,4,0,20,16
1745809024888,MAE 197,001,957918,Kleissl; Jan,9998,0,9999,1
1745809025914,MATH 2,A01,957937,Staff,34,0,35,1
1745809026944,MATH 197,001,957876,Kedlaya; Kiran S.,9993,0,9999,6
1745809027970,MCWP 40,A00,892729,Duru; Nur,13,0,20,7
1745809027970,MCWP 40,B00,893304,Montejo; Carolina,20,0,20,0
1745809028997,MCWP 40R,A00,893757,Redela; Pamela Morgan,0,7,20,20
1745809030024,MCWP 50,A00,893758,Morshed; Michael James,2,0,20,18
1745809030024,MCWP 50,B00,893761,Bartulis; Jason Michael,17,0,20,3
1745809031051,MCWP 50R,A00,893766,Compas; Sean Matthew,0,1,20,20
1745809031051,MCWP 50R,B00,893769,Carter; Jennifer A,0,0,20,20
1745809031051,MCWP 50R,C00,893771,Krone; Jarret,0,3,20,20
1745809031051,MCWP 50R,D00,893772,Miller; Elizabeth Deen,3,0,20,17
1745809031051,MCWP 50R,E00,893775,Carter; Andrea L,0,0,20,20
1745809032079,MMW 11R,A01,892721,Herbst; Matthew,11,0,27,16
1745809032079,MMW 11R,A02,892722,Herbst; Matthew,0,0,0,3
1745809033105,MMW 12R,A01,892724,Herbst; Matthew,0,9,16,16
1745809033105,MMW 12R,A02,892725,Herbst; Matthew,0,9,16,16
1745809034132,MMW 13R,A01,892727,Staff,0,4,16,16
1745809034132,MMW 13R,A02,892728,Staff,0,4,16,16
1745809034132,MMW 13R,A03,958032,Staff,0,3,16,16
1745809034132,MMW 13R,A04,958033,Staff,0,2,16,16
1745809034132,MMW 13R,A05,958034,Staff,0,3,16,16
1745809035158,SIO 295LS,A00,894015,Staff,7,0,25,18
1745809036183,SIO 295S,A00,894020,Staff,7,0,25,18
1745809037212,SIOC 290S,B01,958918,Staff,0,0,0,0
1745809038241,SIOC 291S,B01,958922,Staff,0,0,0,0
1745809039268,SOCI 117,A01,895339,Staff,4,0,5,1
1745809040297,WES 237B,A00,894149,Staff,11,0,20,9
1745809042361,AESE 279B,A00,891859,Staff,13,0,35,22
1745809043385,AIP 197,001,891854,Staff,70,0,70,0
1745809044410,ANTH 289S,A00,891856,Gagneux; Pascal,12,0,12,0
1745809045437,BENG 196,001,957946,Engler; Adam J.,9996,0,9999,3
1745809046464,CAT 124RS,A01,956906,Staff,8,0,25,17
1745809047490,CAT 125RS,A01,922013,Staff,8,0,25,17
1745809048517,CLRE 250,A00,891860,Morris; Sheldon,9995,0,9999,4
1745809050568,CLRE 251R,A00,907817,Mehta; Ravindra L.,9994,0,9999,5
1745809051594,CLRE 252,A00,891864,Cuomo; Raphael Eduardo,9993,0,9999,6
1745809052623,CLRE 253,A00,891867,Vaida; Florin,9994,0,9999,5
1745809052623,CLRE 253,B00,907819,Staff,9999,0,9999,0
1745809053654,CLRE 259,A00,891868,Patel; Hemal,9998,0,9999,1
1745809054680,CLRE 260,A00,891872,Cuomo; Raphael Eduardo,9999,0,9999,0
1745809055705,CLRE 297,001,891888,Cuomo; Raphael Eduardo,9999,0,9999,0
1745809056729,CSE 191,A00,958773,Minnes Kemp; Mor Mia,9999,0,9999,0
1745809057755,CSS 201S,A01,892054,Mignozzetti; Umberto,30,0,30,0
1745809058780,CSS 202S,A01,892056,Mignozzetti; Umberto,30,0,30,0
1745809059807,DSC 197,001,956898,Eldridge; Justin Matthew,9998,0,9999,1
1745809060831,DSC 297,001,958000,Mazumdar; Arya,9998,0,9999,1
1745809061858,EAP 100,A00,905686,Staff,9776,0,9999,223
1745809062884,ECE 45,A01,892618,Staff,0,12,50,50
1745809063914,ECE 109,A01,892620,Staff,0,44,0,0
1745809064945,ECE 111,A01,892719,Staff,0,8,50,50
1745809065975,ECE 197,001,957920,Mercier; Patrick Philip,9992,0,9999,7
1745809067004,ECON 178,A01,907814,Zhu; Ying,28,0,35,7
1745809068029,EDS 115,A00,895312,Staff,41,0,45,4
1745809069058,EDS 117,A01,895337,Staff,30,0,30,0
1745809070084,EDS 125,A00,895341,Jones; Gabrielle Anastasia,43,0,45,2
1745809071132,EDS 128A,A01,895459,Fargason; Sharon Gayle,44,0,45,1
1745809072160,EDS 128B,A01,895543,Pappas; Elizabeth,44,0,45,1
1745809073185,EDS 139,A00,897203,Pappas; Elizabeth,44,0,45,1
1745809073185,EDS 139,B00,897209,Fargason; Sharon Gayle,44,0,45,1
1745809074211,EDS 201,A00,895545,Staff,43,0,45,2
1745809075236,EDS 203,A01,895581,Halter; Christopher P.,43,0,45,2
1745809076260,EDS 204R,A01,895625,Heinzman; Erica M.,43,0,45,2
1745809076260,EDS 204R,B01,895693,Halter; Christopher P.,18,0,45,27
1745809077285,EDS 206R,A00,895694,Fargason; Sharon Gayle,9,0,30,21
1745809077285,EDS 206R,B00,895695,Choi; Bailey Miyeon,20,0,30,10
1745809078312,EDS 250,A00,895697,Hemans; Patricia Ann Benitez,43,0,45,2
1745809079336,EDS 281,A00,895701,Meyerott; Theresa Ann,15,0,15,0
1745809080362,EDS 284,A00,895736,Meyerott; Theresa Ann,15,0,15,0
1745809081390,EDS 286,A00,897210,Fine; Sarah,15,0,15,0
1745809082423,EDS 289C,A01,895770,Daly; Alan J.,15,0,15,0
1745809083449,EDS 290,A00,897211,Hofstetter; Carolyn,15,0,15,0
1745809084475,LIGM 5A,A00,896162,Fischer-Grunski; Eva K,15,0,20,5
1745809085501,LIGM 5B,A00,896260,Fischer-Grunski; Eva K,17,0,20,3
1745809086525,LIGM 5C,A00,896308,Fischer-Grunski; Eva K,18,0,20,2
1745809087549,LIIT 5AS,A00,896313,Carnelos; Chiara,18,0,20,2
1745809088577,LIIT 5BS,A00,896416,Carnelos; Chiara,20,0,20,0
1745809089605,LIIT 5CS,A00,896564,Carnelos; Chiara,20,0,20,0
1745809090630,LISP 5A,A00,896588,Munoz Sanchez; Alicia,4,0,20,16
1745809091658,LISP 5B,A00,896653,Munoz Sanchez; Alicia,10,0,20,10
1745809092687,LISP 5C,A00,896655,Munoz Sanchez; Alicia,4,0,20,16
1745809093714,MAE 197,001,957918,Kleissl; Jan,9998,0,9999,1
1745809094738,MATH 2,A01,957937,Staff,34,0,35,1
1745809095763,MATH 197,001,957876,Kedlaya; Kiran S.,9993,0,9999,6
1745809096791,MCWP 40,A00,892729,Duru; Nur,13,0,20,7
1745809096791,MCWP 40,B00,893304,Montejo; Carolina,20,0,20,0
1745809097817,MCWP 40R,A00,893757,Redela; Pamela Morgan,0,7,20,20
1745809098843,MCWP 50,A00,893758,Morshed; Michael James,2,0,20,18
1745809098843,MCWP 50,B00,893761,Bartulis; Jason Michael,17,0,20,3
1745809099871,MCWP 50R,A00,893766,Compas; Sean Matthew,0,1,20,20
1745809099871,MCWP 50R,B00,893769,Carter; Jennifer A,0,0,20,20
1745809099871,MCWP 50R,C00,893771,Krone; Jarret,0,3,20,20
1745809099871,MCWP 50R,D00,893772,Miller; Elizabeth Deen,3,0,20,17
1745809099871,MCWP 50R,E00,893775,Carter; Andrea L,0,0,20,20
1745809100897,MMW 11R,A01,892721,Herbst; Matthew,11,0,27,16
1745809100897,MMW 11R,A02,892722,Herbst; Matthew,0,0,0,3
1745809101921,MMW 12R,A01,892724,Herbst; Matthew,0,9,16,16
1745809101921,MMW 12R,A02,892725,Herbst; Matthew,0,9,16,16
1745809102947,MMW 13R,A01,892727,Staff,0,4,16,16
1745809102947,MMW 13R,A02,892728,Staff,0,4,16,16
1745809102947,MMW 13R,A03,958032,Staff,0,3,16,16
1745809102947,MMW 13R,A04,958033,Staff,0,2,16,16
1745809102947,MMW 13R,A05,958034,Staff,0,3,16,16
1745809103975,SIO 295LS,A00,894015,Staff,7,0,25,18
1745809105003,SIO 295S,A00,894020,Staff,7,0,25,18
1745809106030,SIOC 290S,B01,958918,Staff,0,0,0,0
1745809107056,SIOC 291S,B01,958922,Staff,0,0,0,0
1745809108080,SOCI 117,A01,895339,Staff,4,0,5,1
1745809109105,WES 237B,A00,894149,Staff,11,0,20,9
1745809111169,AESE 279B,A00,891859,Staff,13,0,35,22
1745809112197,AIP 197,001,891854,Staff,70,0,70,0
1745809113222,ANTH 289S,A00,891856,Gagneux; Pascal,12,0,12,0
1745809114248,BENG 196,001,957946,Engler; Adam J.,9996,0,9999,3
1745809115274,CAT 124RS,A01,956906,Staff,8,0,25,17
1745809116298,CAT 125RS,A01,922013,Staff,8,0,25,17
1745809117326,CLRE 250,A00,891860,Morris; Sheldon,9995,0,9999,4
1745809119376,CLRE 251R,A00,907817,Mehta; Ravindra L.,9994,0,9999,5
1745809120402,CLRE 252,A00,891864,Cuomo; Raphael Eduardo,9993,0,9999,6
1745809121429,CLRE 253,A00,891867,Vaida; Florin,9994,0,9999,5
1745809121429,CLRE 253,B00,907819,Staff,9999,0,9999,0
1745809122457,CLRE 259,A00,891868,Patel; Hemal,9998,0,9999,1
1745809123481,CLRE 260,A00,891872,Cuomo; Raphael Eduardo,9999,0,9999,0
1745809124504,CLRE 297,001,891888,Cuomo; Raphael Eduardo,9999,0,9999,0
1745809125530,CSE 191,A00,958773,Minnes Kemp; Mor Mia,9999,0,9999,0
1745809126561,CSS 201S,A01,892054,Mignozzetti; Umberto,30,0,30,0
1745809127590,CSS 202S,A01,892056,Mignozzetti; Umberto,30,0,30,0
1745809128615,DSC 197,001,956898,Eldridge; Justin Matthew,9998,0,9999,1
1745809129639,DSC 297,001,958000,Mazumdar; Arya,9998,0,9999,1
1745809130665,EAP 100,A00,905686,Staff,9776,0,9999,223
1745809131694,ECE 45,A01,892618,Staff,0,12,50,50
1745809132723,ECE 109,A01,892620,Staff,0,44,0,0
1745809133749,ECE 111,A01,892719,Staff,0,8,50,50
1745809134777,ECE 197,001,957920,Mercier; Patrick Philip,9992,0,9999,7
1745809135803,ECON 178,A01,907814,Zhu; Ying,28,0,35,7
1745809136829,EDS 115,A00,895312,Staff,41,0,45,4
1745809137858,EDS 117,A01,895337,Staff,30,0,30,0
1745809138884,EDS 125,A00,895341,Jones; Gabrielle Anastasia,43,0,45,2
1745809139914,EDS 128A,A01,895459,Fargason; Sharon Gayle,44,0,45,1
1745809140944,EDS 128B,A01,895543,Pappas; Elizabeth,44,0,45,1
1745809141969,EDS 139,A00,897203,Pappas; Elizabeth,44,0,45,1
1745809141969,EDS 139,B00,897209,Fargason; Sharon Gayle,44,0,45,1
1745809142996,EDS 201,A00,895545,Staff,43,0,45,2
1745809144025,EDS 203,A01,895581,Halter; Christopher P.,43,0,45,2
1745809145054,EDS 204R,A01,895625,Heinzman; Erica M.,43,0,45,2
1745809145054,EDS 204R,B01,895693,Halter; Christopher P.,18,0,45,27
1745809146080,EDS 206R,A00,895694,Fargason; Sharon Gayle,9,0,30,21
1745809146080,EDS 206R,B00,895695,Choi; Bailey Miyeon,20,0,30,10
1745809147110,EDS 250,A00,895697,Hemans; Patricia Ann Benitez,43,0,45,2
1745809148136,EDS 281,A00,895701,Meyerott; Theresa Ann,15,0,15,0
1745809149163,EDS 284,A00,895736,Meyerott; Theresa Ann,15,0,15,0
1745809150193,EDS 286,A00,897210,Fine; Sarah,15,0,15,0
1745809151217,EDS 289C,A01,895770,Daly; Alan J.,15,0,15,0
1745809152246,EDS 290,A00,897211,Hofstetter; Carolyn,15,0,15,0
1745809153272,LIGM 5A,A00,896162,Fischer-Grunski; Eva K,15,0,20,5
1745809154298,LIGM 5B,A00,896260,Fischer-Grunski; Eva K,17,0,20,3
1745809155325,LIGM 5C,A00,896308,Fischer-Grunski; Eva K,18,0,20,2
1745809156354,LIIT 5AS,A00,896313,Carnelos; Chiara,18,0,20,2
1745809157383,LIIT 5BS,A00,896416,Carnelos; Chiara,20,0,20,0
1745809158413,LIIT 5CS,A00,896564,Carnelos; Chiara,20,0,20,0
1745809159442,LISP 5A,A00,896588,Munoz Sanchez; Alicia,4,0,20,16
1745809160469,LISP 5B,A00,896653,Munoz Sanchez; Alicia,10,0,20,10
1745809161495,LISP 5C,A00,896655,Munoz Sanchez; Alicia,4,0,20,16
1745809162520,MAE 197,001,957918,Kleissl; Jan,9998,0,9999,1
1745809163551,MATH 2,A01,957937,Staff,34,0,35,1
1745809164577,MATH 197,001,957876,Kedlaya; Kiran S.,9993,0,9999,6
1745809165602,MCWP 40,A00,892729,Duru; Nur,13,0,20,7
1745809165602,MCWP 40,B00,893304,Montejo; Carolina,20,0,20,0
1745809166630,MCWP 40R,A00,893757,Redela; Pamela Morgan,0,7,20,20
1745809167658,MCWP 50,A00,893758,Morshed; Michael James,2,0,20,18
1745809167658,MCWP 50,B00,893761,Bartulis; Jason Michael,17,0,20,3
1745809168683,MCWP 50R,A00,893766,Compas; Sean Matthew,0,1,20,20
1745809168683,MCWP 50R,B00,893769,Carter; Jennifer A,0,0,20,20
1745809168683,MCWP 50R,C00,893771,Krone; Jarret,0,3,20,20
1745809168683,MCWP 50R,D00,893772,Miller; Elizabeth Deen,3,0,20,17
1745809168683,MCWP 50R,E00,893775,Carter; Andrea L,0,0,20,20
1745809169709,MMW 11R,A01,892721,Herbst; Matthew,11,0,27,16
1745809169709,MMW 11R,A02,892722,Herbst; Matthew,0,0,0,3
1745809170737,MMW 12R,A01,892724,Herbst; Matthew,0,9,16,16
1745809170737,MMW 12R,A02,892725,Herbst; Matthew,0,9,16,16
1745809171761,MMW 13R,A01,892727,Staff,0,4,16,16
1745809171761,MMW 13R,A02,892728,Staff,0,4,16,16
1745809171761,MMW 13R,A03,958032,Staff,0,3,16,16
1745809171761,MMW 13R,A04,958033,Staff,0,2,16,16
1745809171761,MMW 13R,A05,958034,Staff,0,3,16,16
1745809172787,SIO 295LS,A00,894015,Staff,7,0,25,18
1745809173813,SIO 295S,A00,894020,Staff,7,0,25,18
1745809174843,SIOC 290S,B01,958918,Staff,0,0,0,0
1745809175871,SIOC 291S,B01,958922,Staff,0,0,0,0
1745809176900,SOCI 117,A01,895339,Staff,4,0,5,1
1745809177926,WES 237B,A00,894149,Staff,11,0,20,9
1745809179990,AESE 279B,A00,891859,Staff,13,0,35,22
1745809181014,AIP 197,001,891854,Staff,70,0,70,0
1745809182040,ANTH 289S,A00,891856,Gagneux; Pascal,12,0,12,0
1745809183066,BENG 196,001,957946,Engler; Adam J.,9996,0,9999,3
1745809184091,CAT 124RS,A01,956906,Staff,8,0,25,17
1745809185118,CAT 125RS,A01,922013,Staff,8,0,25,17
1745809186144,CLRE 250,A00,891860,Morris; Sheldon,9995,0,9999,4
1745809188197,CLRE 251R,A00,907817,Mehta; Ravindra L.,9994,0,9999,5
1745809189223,CLRE 252,A00,891864,Cuomo; Raphael Eduardo,9993,0,9999,6
1745809190252,CLRE 253,A00,891867,Vaida; Florin,9994,0,9999,5
1745809190252,CLRE 253,B00,907819,Staff,9999,0,9999,0
1745809191277,CLRE 259,A00,891868,Patel; Hemal,9998,0,9999,1
1745809192306,CLRE 260,A00,891872,Cuomo; Raphael Eduardo,9999,0,9999,0
1745809193334,CLRE 297,001,891888,Cuomo; Raphael Eduardo,9999,0,9999,0
1745809194361,CSE 191,A00,958773,Minnes Kemp; Mor Mia,9999,0,9999,0
1745809195393,CSS 201S,A01,892054,Mignozzetti; Umberto,30,0,30,0
1745809196424,CSS 202S,A01,892056,Mignozzetti; Umberto,30,0,30,0
1745809197454,DSC 197,001,956898,Eldridge; Justin Matthew,9998,0,9999,1
1745809198482,DSC 297,001,958000,Mazumdar; Arya,9998,0,9999,1
1745809199518,EAP 100,A00,905686,Staff,9776,0,9999,223
1745809200547,ECE 45,A01,892618,Staff,0,12,50,50
1745809201573,ECE 109,A01,892620,Staff,0,44,0,0
1745809202600,ECE 111,A01,892719,Staff,0,8,50,50
1745809203624,ECE 197,001,957920,Mercier; Patrick Philip,9992,0,9999,7
1745809204655,ECON 178,A01,907814,Zhu; Ying,28,0,35,7
1745809205685,EDS 115,A00,895312,Staff,41,0,45,4
1745809206714,EDS 117,A01,895337,Staff,30,0,30,0
1745809207738,EDS 125,A00,895341,Jones; Gabrielle Anastasia,43,0,45,2
1745809208768,EDS 128A,A01,895459,Fargason; Sharon Gayle,44,0,45,1
1745809209793,EDS 128B,A01,895543,Pappas; Elizabeth,44,0,45,1
1745809210821,EDS 139,A00,897203,Pappas; Elizabeth,44,0,45,1
1745809210821,EDS 139,B00,897209,Fargason; Sharon Gayle,44,0,45,1
1745809211847,EDS 201,A00,895545,Staff,43,0,45,2
1745809212873,EDS 203,A01,895581,Halter; Christopher P.,43,0,45,2
1745809213902,EDS 204R,A01,895625,Heinzman; Erica M.,43,0,45,2
1745809213902,EDS 204R,B01,895693,Halter; Christopher P.,18,0,45,27
1745809214927,EDS 206R,A00,895694,Fargason; Sharon Gayle,9,0,30,21
1745809214927,EDS 206R,B00,895695,Choi; Bailey Miyeon,20,0,30,10
1745809215953,EDS 250,A00,895697,Hemans; Patricia Ann Benitez,43,0,45,2
1745809216987,EDS 281,A00,895701,Meyerott; Theresa Ann,15,0,15,0
1745809218012,EDS 284,A00,895736,Meyerott; Theresa Ann,15,0,15,0
1745809219039,EDS 286,A00,897210,Fine; Sarah,15,0,15,0
1745809220067,EDS 289C,A01,895770,Daly; Alan J.,15,0,15,0
1745809221095,EDS 290,A00,897211,Hofstetter; Carolyn,15,0,15,0
1745809222125,LIGM 5A,A00,896162,Fischer-Grunski; Eva K,15,0,20,5
1745809223152,LIGM 5B,A00,896260,Fischer-Grunski; Eva K,17,0,20,3
1745809224178,LIGM 5C,A00,896308,Fischer-Grunski; Eva K,18,0,20,2
1745809225208,LIIT 5AS,A00,896313,Carnelos; Chiara,18,0,20,2
1745809226237,LIIT 5BS,A00,896416,Carnelos; Chiara,20,0,20,0
1745809227263,LIIT 5CS,A00,896564,Carnelos; Chiara,20,0,20,0
1745809228292,LISP 5A,A00,896588,Munoz Sanchez; Alicia,4,0,20,16
1745809229318,LISP 5B,A00,896653,Munoz Sanchez; Alicia,10,0,20,10
1745809230343,LISP 5C,A00,896655,Munoz Sanchez; Alicia,4,0,20,16
1745809231374,MAE 197,001,957918,Kleissl; Jan,9998,0,9999,1
1745809232402,MATH 2,A01,957937,Staff,34,0,35,1
1745809233431,MATH 197,001,957876,Kedlaya; Kiran S.,9993,0,9999,6
1745809234456,MCWP 40,A00,892729,Duru; Nur,13,0,20,7
1745809234456,MCWP 40,B00,893304,Montejo; Carolina,20,0,20,0
1745809235484,MCWP 40R,A00,893757,Redela; Pamela Morgan,0,7,20,20
1745809236510,MCWP 50,A00,893758,Morshed; Michael James,2,0,20,18
1745809236510,MCWP 50,B00,893761,Bartulis; Jason Michael,17,0,20,3
1745809237537,MCWP 50R,A00,893766,Compas; Sean Matthew,0,1,20,20
1745809237537,MCWP 50R,B00,893769,Carter; Jennifer A,0,0,20,20
1745809237537,MCWP 50R,C00,893771,Krone; Jarret,0,3,20,20
1745809237537,MCWP 50R,D00,893772,Miller; Elizabeth Deen,3,0,20,17
1745809237537,MCWP 50R,E00,893775,Carter; Andrea L,0,0,20,20
1745809238565,MMW 11R,A01,892721,Herbst; Matthew,11,0,27,16
1745809238565,MMW 11R,A02,892722,Herbst; Matthew,0,0,0,3
1745809239590,MMW 12R,A01,892724,Herbst; Matthew,0,9,16,16
1745809239590,MMW 12R,A02,892725,Herbst; Matthew,0,9,16,16
1745809240617,MMW 13R,A01,892727,Staff,0,4,16,16
1745809240617,MMW 13R,A02,892728,Staff,0,4,16,16
1745809240617,MMW 13R,A03,958032,Staff,0,3,16,16
1745809240617,MMW 13R,A04,958033,Staff,0,2,16,16
1745809240617,MMW 13R,A05,958034,Staff,0,3,16,16
1745809241642,SIO 295LS,A00,894015,Staff,7,0,25,18
1745809242667,SIO 295S,A00,894020,Staff,7,0,25,18
1745809243694,SIOC 290S,B01,958918,Staff,0,0,0,0
1745809244721,SIOC 291S,B01,958922,Staff,0,0,0,0
1745809245753,SOCI 117,A01,895339,Staff,4,0,5,1
1745809246782,WES 237B,A00,894149,Staff,11,0,20,9
1745809248846,AESE 279B,A00,891859,Staff,13,0,35,22
1745809249871,AIP 197,001,891854,Staff,70,0,70,0
1745809250899,ANTH 289S,A00,891856,Gagneux; Pascal,12,0,12,0
1745809251928,BENG 196,001,957946,Engler; Adam J.,9996,0,9999,3
1745809252952,CAT 124RS,A01,956906,Staff,8,0,25,17
1745809253982,CAT 125RS,A01,922013,Staff,8,0,25,17
1745809255008,CLRE 250,A00,891860,Morris; Sheldon,9995,0,9999,4
1745809257064,CLRE 251R,A00,907817,Mehta; Ravindra L.,9994,0,9999,5
1745809258093,CLRE 252,A00,891864,Cuomo; Raphael Eduardo,9993,0,9999,6
1745809259148,CLRE 253,A00,891867,Vaida; Florin,9994,0,9999,5
1745809259148,CLRE 253,B00,907819,Staff,9999,0,9999,0
1745809260174,CLRE 259,A00,891868,Patel; Hemal,9998,0,9999,1
1745809261201,CLRE 260,A00,891872,Cuomo; Raphael Eduardo,9999,0,9999,0
1745809262230,CLRE 297,001,891888,Cuomo; Raphael Eduardo,9999,0,9999,0
1745809263259,CSE 191,A00,958773,Minnes Kemp; Mor Mia,9999,0,9999,0
1745809264289,CSS 201S,A01,892054,Mignozzetti; Umberto,30,0,30,0
1745809265318,CSS 202S,A01,892056,Mignozzetti; Umberto,30,0,30,0
1745809266346,DSC 197,001,956898,Eldridge; Justin Matthew,9998,0,9999,1
1745809267377,DSC 297,001,958000,Mazumdar; Arya,9998,0,9999,1
1745809268402,EAP 100,A00,905686,Staff,9776,0,9999,223
1745809269428,ECE 45,A01,892618,Staff,0,12,50,50
1745809270455,ECE 109,A01,892620,Staff,0,44,0,0
1745809271481,ECE 111,A01,892719,Staff,0,8,50,50
1745809272508,ECE 197,001,957920,Mercier; Patrick Philip,9992,0,9999,7
1745809273534,ECON 178,A01,907814,Zhu; Ying,28,0,35,7
1745809274560,EDS 115,A00,895312,Staff,41,0,45,4
1745809275588,EDS 117,A01,895337,Staff,30,0,30,0
1745809276613,EDS 125,A00,895341,Jones; Gabrielle Anastasia,43,0,45,2
1745809277642,EDS 128A,A01,895459,Fargason; Sharon Gayle,44,0,45,1
1745809278668,EDS 128B,A01,895543,Pappas; Elizabeth,44,0,45,1
1745809279694,EDS 139,A00,897203,Pappas; Elizabeth,44,0,45,1
1745809279694,EDS 139,B00,897209,Fargason; Sharon Gayle,44,0,45,1
1745809280721,EDS 201,A00,895545,Staff,43,0,45,2
1745809281750,EDS 203,A01,895581,Halter; Christopher P.,43,0,45,2
1745809282776,EDS 204R,A01,895625,Heinzman; Erica M.,43,0,45,2
1745809282776,EDS 204R,B01,895693,Halter; Christopher P.,18,0,45,27
1745809283803,EDS 206R,A00,895694,Fargason; Sharon Gayle,9,0,30,21
1745809283803,EDS 206R,B00,895695,Choi; Bailey Miyeon,20,0,30,10
1745809284828,EDS 250,A00,895697,Hemans; Patricia Ann Benitez,43,0,45,2
1745809285854,EDS 281,A00,895701,Meyerott; Theresa Ann,15,0,15,0
1745809286881,EDS 284,A00,895736,Meyerott; Theresa Ann,15,0,15,0
1745809287907,EDS 286,A00,897210,Fine; Sarah,15,0,15,0
1745809288935,EDS 289C,A01,895770,Daly; Alan J.,15,0,15,0
1745809289959,EDS 290,A00,897211,Hofstetter; Carolyn,15,0,15,0
1745809290987,LIGM 5A,A00,896162,Fischer-Grunski; Eva K,15,0,20,5
1745809292038,LIGM 5B,A00,896260,Fischer-Grunski; Eva K,17,0,20,3
1745809293064,LIGM 5C,A00,896308,Fischer-Grunski; Eva K,18,0,20,2
1745809294098,LIIT 5AS,A00,896313,Carnelos; Chiara,18,0,20,2
1745809295125,LIIT 5BS,A00,896416,Carnelos; Chiara,20,0,20,0
1745809296153,LIIT 5CS,A00,896564,Carnelos; Chiara,20,0,20,0
1745809297181,LISP 5A,A00,896588,Munoz Sanchez; Alicia,4,0,20,16
1745809298209,LISP 5B,A00,896653,Munoz Sanchez; Alicia,10,0,20,10
1745809299246,LISP 5C,A00,896655,Munoz Sanchez; Alicia,4,0,20,16
1745809300272,MAE 197,001,957918,Kleissl; Jan,9998,0,9999,1
1745809301298,MATH 2,A01,957937,Staff,34,0,35,1
1745809302326,MATH 197,001,957876,Kedlaya; Kiran S.,9993,0,9999,6
1745809303354,MCWP 40,A00,892729,Duru; Nur,13,0,20,7
1745809303354,MCWP 40,B00,893304,Montejo; Carolina,20,0,20,0
1745809304379,MCWP 40R,A00,893757,Redela; Pamela Morgan,0,7,20,20
1745809305403,MCWP 50,A00,893758,Morshed; Michael James,2,0,20,18
1745809305403,MCWP 50,B00,893761,Bartulis; Jason Michael,17,0,20,3
1745809306433,MCWP 50R,A00,893766,Compas; Sean Matthew,0,1,20,20
1745809306433,MCWP 50R,B00,893769,Carter; Jennifer A,0,0,20,20
1745809306433,MCWP 50R,C00,893771,Krone; Jarret,0,3,20,20
1745809306433,MCWP 50R,D00,893772,Miller; Elizabeth Deen,3,0,20,17
1745809306433,MCWP 50R,E00,893775,Carter; Andrea L,0,0,20,20
1745809307457,MMW 11R,A01,892721,Herbst; Matthew,11,0,27,16
1745809307457,MMW 11R,A02,892722,Herbst; Matthew,0,0,0,3
1745809308486,MMW 12R,A01,892724,Herbst; Matthew,0,9,16,16
1745809308486,MMW 12R,A02,892725,Herbst; Matthew,0,9,16,16
1745809309514,MMW 13R,A01,892727,Staff,0,4,16,16
1745809309514,MMW 13R,A02,892728,Staff,0,4,16,16
1745809309514,MMW 13R,A03,958032,Staff,0,3,16,16
1745809309514,MMW 13R,A04,958033,Staff,0,2,16,16
1745809309514,MMW 13R,A05,958034,Staff,0,3,16,16
1745809310540,SIO 295LS,A00,894015,Staff,7,0,25,18
1745809311568,SIO 295S,A00,894020,Staff,7,0,25,18
1745809312595,SIOC 290S,B01,958918,Staff,0,0,0,0
1745809313622,SIOC 291S,B01,958922,Staff,0,0,0,0
1745809314648,SOCI 117,A01,895339,Staff,4,0,5,1
1745809315673,WES 237B,A00,894149,Staff,11,0,20,9
1745809317736,AESE 279B,A00,891859,Staff,13,0,35,22
1745809318761,AIP 197,001,891854,Staff,70,0,70,0
1745809319789,ANTH 289S,A00,891856,Gagneux; Pascal,12,0,12,0
1745809320814,BENG 196,001,957946,Engler; Adam J.,9996,0,9999,3
1745809321842,CAT 124RS,A01,956906,Staff,8,0,25,17
1745809322867,CAT 125RS,A01,922013,Staff,8,0,25,17
1745809323897,CLRE 250,A00,891860,Morris; Sheldon,9995,0,9999,4
1745809325954,CLRE 251R,A00,907817,Mehta; Ravindra L.,9994,0,9999,5
1745809326983,CLRE 252,A00,891864,Cuomo; Raphael Eduardo,9993,0,9999,6
1745809328012,CLRE 253,A00,891867,Vaida; Florin,9994,0,9999,5
1745809328012,CLRE 253,B00,907819,Staff,9999,0,9999,0
1745809329062,CLRE 259,A00,891868,Patel; Hemal,9998,0,9999,1
1745809330087,CLRE 260,A00,891872,Cuomo; Raphael Eduardo,9999,0,9999,0
1745809331115,CLRE 297,001,891888,Cuomo; Raphael Eduardo,9999,0,9999,0
1745809332141,CSE 191,A00,958773,Minnes Kemp; Mor Mia,9999,0,9999,0
1745809333169,CSS 201S,A01,892054,Mignozzetti; Umberto,30,0,30,0
1745809334198,CSS 202S,A01,892056,Mignozzetti; Umberto,30,0,30,0
1745809335226,DSC 197,001,956898,Eldridge; Justin Matthew,9998,0,9999,1
1745809336254,DSC 297,001,958000,Mazumdar; Arya,9998,0,9999,1
1745809337279,EAP 100,A00,905686,Staff,9776,0,9999,223
1745809338306,ECE 45,A01,892618,Staff,0,12,50,50
1745809339334,ECE 109,A01,892620,Staff,0,44,0,0
1745809340360,ECE 111,A01,892719,Staff,0,8,50,50
1745809341388,ECE 197,001,957920,Mercier; Patrick Philip,9992,0,9999,7
1745809342419,ECON 178,A01,907814,Zhu; Ying,28,0,35,7
1745809343447,EDS 115,A00,895312,Staff,41,0,45,4
1745809344472,EDS 117,A01,895337,Staff,30,0,30,0
1745809345535,EDS 125,A00,895341,Jones; Gabrielle Anastasia,43,0,45,2
1745809346563,EDS 128A,A01,895459,Fargason; Sharon Gayle,44,0,45,1
1745809347591,EDS 128B,A01,895543,Pappas; Elizabeth,44,0,45,1
1745809348620,EDS 139,A00,897203,Pappas; Elizabeth,44,0,45,1
1745809348620,EDS 139,B00,897209,Fargason; Sharon Gayle,44,0,45,1
1745809349645,EDS 201,A00,895545,Staff,43,0,45,2
1745809350672,EDS 203,A01,895581,Halter; Christopher P.,43,0,45,2
1745809351698,EDS 204R,A01,895625,Heinzman; Erica M.,43,0,45,2
1745809351698,EDS 204R,B01,895693,Halter; Christopher P.,18,0,45,27
1745809352723,EDS 206R,A00,895694,Fargason; Sharon Gayle,9,0,30,21
1745809352723,EDS 206R,B00,895695,Choi; Bailey Miyeon,20,0,30,10
1745809353753,EDS 250,A00,895697,Hemans; Patricia Ann Benitez,43,0,45,2
1745809354779,EDS 281,A00,895701,Meyerott; Theresa Ann,15,0,15,0
1745809355805,EDS 284,A00,895736,Meyerott; Theresa Ann,15,0,15,0
1745809356831,EDS 286,A00,897210,Fine; Sarah,15,0,15,0
1745809357859,EDS 289C,A01,895770,Daly; Alan J.,15,0,15,0
1745809358886,EDS 290,A00,897211,Hofstetter; Carolyn,15,0,15,0
1745809359912,LIGM 5A,A00,896162,Fischer-Grunski; Eva K,15,0,20,5
1745809360943,LIGM 5B,A00,896260,Fischer-Grunski; Eva K,17,0,20,3
1745809361973,LIGM 5C,A00,896308,Fischer-Grunski; Eva K,18,0,20,2
1745809362998,LIIT 5AS,A00,896313,Carnelos; Chiara,18,0,20,2
1745809364027,LIIT 5BS,A00,896416,Carnelos; Chiara,20,0,20,0
1745809365051,LIIT 5CS,A00,896564,Carnelos; Chiara,20,0,20,0
1745809366080,LISP 5A,A00,896588,Munoz Sanchez; Alicia,4,0,20,16
1745809367108,LISP 5B,A00,896653,Munoz Sanchez; Alicia,10,0,20,10
1745809368133,LISP 5C,A00,896655,Munoz Sanchez; Alicia,4,0,20,16
1745809369159,MAE 197,001,957918,Kleissl; Jan,9998,0,9999,1
1745809370186,MATH 2,A01,957937,Staff,34,0,35,1
1745809371213,MATH 197,001,957876,Kedlaya; Kiran S.,9993,0,9999,6
1745809372242,MCWP 40,A00,892729,Duru; Nur,13,0,20,7
1745809372242,MCWP 40,B00,893304,Montejo; Carolina,20,0,20,0
1745809373267,MCWP 40R,A00,893757,Redela; Pamela Morgan,0,7,20,20
1745809374295,MCWP 50,A00,893758,Morshed; Michael James,2,0,20,18
1745809374295,MCWP 50,B00,893761,Bartulis; Jason Michael,17,0,20,3
1745809375319,MCWP 50R,A00,893766,Compas; Sean Matthew,0,1,20,20
1745809375319,MCWP 50R,B00,893769,Carter; Jennifer A,0,0,20,20
1745809375319,MCWP 50R,C00,893771,Krone; Jarret,0,3,20,20
1745809375319,MCWP 50R,D00,893772,Miller; Elizabeth Deen,3,0,20,17
1745809375319,MCWP 50R,E00,893775,Carter; Andrea L,0,0,20,20
1745809376345,MMW 11R,A01,892721,Herbst; Matthew,11,0,27,16
1745809376345,MMW 11R,A02,892722,Herbst; Matthew,0,0,0,3
1745809377371,MMW 12R,A01,892724,Herbst; Matthew,0,9,16,16
1745809377371,MMW 12R,A02,892725,Herbst; Matthew,0,9,16,16
1745809378397,MMW 13R,A01,892727,Staff,0,4,16,16
1745809378397,MMW 13R,A02,892728,Staff,0,4,16,16
1745809378397,MMW 13R,A03,958032,Staff,0,3,16,16
1745809378397,MMW 13R,A04,958033,Staff,0,2,16,16
1745809378397,MMW 13R,A05,958034,Staff,0,3,16,16
1745809379426,SIO 295LS,A00,894015,Staff,7,0,25,18
1745809380454,SIO 295S,A00,894020,Staff,7,0,25,18
1745809381481,SIOC 290S,B01,958918,Staff,0,0,0,0
1745809382511,SIOC 291S,B01,958922,Staff,0,0,0,0
1745809383538,SOCI 117,A01,895339,Staff,4,0,5,1
1745809384565,WES 237B,A00,894149,Staff,11,0,20,9
1745809386620,AESE 279B,A00,891859,Staff,13,0,35,22
1745809387646,AIP 197,001,891854,Staff,70,0,70,0
1745809388671,ANTH 289S,A00,891856,Gagneux; Pascal,12,0,12,0
1745809389723,BENG 196,001,957946,Engler; Adam J.,9996,0,9999,3
1745809390749,CAT 124RS,A01,956906,Staff,8,0,25,17
1745809391774,CAT 125RS,A01,922013,Staff,8,0,25,17
1745809392798,CLRE 250,A00,891860,Morris; Sheldon,9995,0,9999,4
1745809394849,CLRE 251R,A00,907817,Mehta; Ravindra L.,9994,0,9999,5
1745809395873,CLRE 252,A00,891864,Cuomo; Raphael Eduardo,9993,0,9999,6
1745809396903,CLRE 253,A00,891867,Vaida; Florin,9994,0,9999,5
1745809396903,CLRE 253,B00,907819,Staff,9999,0,9999,0
1745809397932,CLRE 259,A00,891868,Patel; Hemal,9998,0,9999,1
1745809398956,CLRE 260,A00,891872,Cuomo; Raphael Eduardo,9999,0,9999,0
1745809399982,CLRE 297,001,891888,Cuomo; Raphael Eduardo,9999,0,9999,0
1745809401008,CSE 191,A00,958773,Minnes Kemp; Mor Mia,9999,0,9999,0
1745809402037,CSS 201S,A01,892054,Mignozzetti; Umberto,30,0,30,0
1745809403062,CSS 202S,A01,892056,Mignozzetti; Umberto,30,0,30,0
1745809404090,DSC 197,001,956898,Eldridge; Justin Matthew,9998,0,9999,1
1745809405118,DSC 297,001,958000,Mazumdar; Arya,9998,0,9999,1
1745809406144,EAP 100,A00,905686,Staff,9776,0,9999,223
1745809407171,ECE 45,A01,892618,Staff,0,12,50,50
1745809408197,ECE 109,A01,892620,Staff,0,44,0,0
1745809409225,ECE 111,A01,892719,Staff,0,8,50,50
1745809410251,ECE 197,001,957920,Mercier; Patrick Philip,9992,0,9999,7
1745809411278,ECON 178,A01,907814,Zhu; Ying,28,0,35,7
1745809412305,EDS 115,A00,895312,Staff,41,0,45,4
1745809413330,EDS 117,A01,895337,Staff,30,0,30,0
1745809414355,EDS 125,A00,895341,Jones; Gabrielle Anastasia,43,0,45,2
1745809415380,EDS 128A,A01,895459,Fargason; Sharon Gayle,44,0,45,1
1745809416407,EDS 128B,A01,895543,Pappas; Elizabeth,44,0,45,1
1745809417435,EDS 139,A00,897203,Pappas; Elizabeth,44,0,45,1
1745809417435,EDS 139,B00,897209,Fargason; Sharon Gayle,44,0,45,1
1745809418462,EDS 201,A00,895545,Staff,43,0,45,2
1745809419491,EDS 203,A01,895581,Halter; Christopher P.,43,0,45,2
1745809420521,EDS 204R,A01,895625,Heinzman; Erica M.,43,0,45,2
1745809420521,EDS 204R,B01,895693,Halter; Christopher P.,18,0,45,27
1745809421546,EDS 206R,A00,895694,Fargason; Sharon Gayle,9,0,30,21
1745809421546,EDS 206R,B00,895695,Choi; Bailey Miyeon,20,0,30,10
1745809422571,EDS 250,A00,895697,Hemans; Patricia Ann Benitez,43,0,45,2
1745809423599,EDS 281,A00,895701,Meyerott; Theresa Ann,15,0,15,0
1745809424625,EDS 284,A00,895736,Meyerott; Theresa Ann,15,0,15,0
1745809425650,EDS 286,A00,897210,Fine; Sarah,15,0,15,0
1745809426678,EDS 289C,A01,895770,Daly; Alan J.,15,0,15,0
1745809427703,EDS 290,A00,897211,Hofstetter; Carolyn,15,0,15,0
1745809428730,LIGM 5A,A00,896162,Fischer-Grunski; Eva K,15,0,20,5
1745809429755,LIGM 5B,A00,896260,Fischer-Grunski; Eva K,17,0,20,3
1745809430782,LIGM 5C,A00,896308,Fischer-Grunski; Eva K,18,0,20,2
1745809431806,LIIT 5AS,A00,896313,Carnelos; Chiara,18,0,20,2
1745809432832,LIIT 5BS,A00,896416,Carnelos; Chiara,20,0,20,0
1745809433858,LIIT 5CS,A00,896564,Carnelos; Chiara,20,0,20,0
1745809434889,LISP 5A,A00,896588,Munoz Sanchez; Alicia,4,0,20,16
1745809435918,LISP 5B,A00,896653,Munoz Sanchez; Alicia,10,0,20,10
1745809436964,LISP 5C,A00,896655,Munoz Sanchez; Alicia,4,0,20,16
1745809437989,MAE 197,001,957918,Kleissl; Jan,9998,0,9999,1
1745809439016,MATH 2,A01,957937,Staff,34,0,35,1
1745809440041,MATH 197,001,957876,Kedlaya; Kiran S.,9993,0,9999,6
1745809441069,MCWP 40,A00,892729,Duru; Nur,13,0,20,7
1745809441069,MCWP 40,B00,893304,Montejo; Carolina,20,0,20,0
1745809442095,MCWP 40R,A00,893757,Redela; Pamela Morgan,0,7,20,20
1745809443122,MCWP 50,A00,893758,Morshed; Michael James,2,0,20,18
1745809443122,MCWP 50,B00,893761,Bartulis; Jason Michael,17,0,20,3
1745809444152,MCWP 50R,A00,893766,Compas; Sean Matthew,0,1,20,20
1745809444152,MCWP 50R,B00,893769,Carter; Jennifer A,0,0,20,20
1745809444152,MCWP 50R,C00,893771,Krone; Jarret,0,3,20,20
1745809444152,MCWP 50R,D00,893772,Miller; Elizabeth Deen,3,0,20,17
1745809444152,MCWP 50R,E00,893775,Carter; Andrea L,0,0,20,20
1745809445177,MMW 11R,A01,892721,Herbst; Matthew,11,0,27,16
1745809445177,MMW 11R,A02,892722,Herbst; Matthew,0,0,0,3
1745809446203,MMW 12R,A01,892724,Herbst; Matthew,0,9,16,16
1745809446203,MMW 12R,A02,892725,Herbst; Matthew,0,9,16,16
1745809447229,MMW 13R,A01,892727,Staff,0,4,16,16
1745809447229,MMW 13R,A02,892728,Staff,0,4,16,16
1745809447229,MMW 13R,A03,958032,Staff,0,3,16,16
1745809447229,MMW 13R,A04,958033,Staff,0,2,16,16
1745809447229,MMW 13R,A05,958034,Staff,0,3,16,16
1745809448255,SIO 295LS,A00,894015,Staff,7,0,25,18
1745809449321,SIO 295S,A00,894020,Staff,7,0,25,18
1745809450347,SIOC 290S,B01,958918,Staff,0,0,0,0
1745809451374,SIOC 291S,B01,958922,Staff,0,0,0,0
1745809452403,SOCI 117,A01,895339,Staff,4,0,5,1
1745809453432,WES 237B,A00,894149,Staff,11,0,20,9
1745809455496,AESE 279B,A00,891859,Staff,13,0,35,22
1745809456522,AIP 197,001,891854,Staff,70,0,70,0
1745809457551,ANTH 289S,A00,891856,Gagneux; Pascal,12,0,12,0
1745809458576,BENG 196,001,957946,Engler; Adam J.,9996,0,9999,3
1745809459601,CAT 124RS,A01,956906,Staff,8,0,25,17
1745809460628,CAT 125RS,A01,922013,Staff,8,0,25,17
1745809461657,CLRE 250,A00,891860,Morris; Sheldon,9995,0,9999,4
1745809463713,CLRE 251R,A00,907817,Mehta; Ravindra L.,9994,0,9999,5
1745809464742,CLRE 252,A00,891864,Cuomo; Raphael Eduardo,9993,0,9999,6
1745809465768,CLRE 253,A00,891867,Vaida; Florin,9994,0,9999,5
1745809465768,CLRE 253,B00,907819,Staff,9999,0,9999,0
1745809466797,CLRE 259,A00,891868,Patel; Hemal,9998,0,9999,1
1745809467822,CLRE 260,A00,891872,Cuomo; Raphael Eduardo,9999,0,9999,0
1745809468850,CLRE 297,001,891888,Cuomo; Raphael Eduardo,9999,0,9999,0
1745809469874,CSE 191,A00,958773,Minnes Kemp; Mor Mia,9999,0,9999,0
1745809470901,CSS 201S,A01,892054,Mignozzetti; Umberto,30,0,30,0
1745809471932,CSS 202S,A01,892056,Mignozzetti; Umberto,30,0,30,0
1745809472957,DSC 197,001,956898,Eldridge; Justin Matthew,9998,0,9999,1
1745809473987,DSC 297,001,958000,Mazumdar; Arya,9998,0,9999,1
1745809475019,EAP 100,A00,905686,Staff,9776,0,9999,223
1745809476047,ECE 45,A01,892618,Staff,0,12,50,50
1745809477073,ECE 109,A01,892620,Staff,0,44,0,0
1745809478099,ECE 111,A01,892719,Staff,0,8,50,50
1745809479127,ECE 197,001,957920,Mercier; Patrick Philip,9992,0,9999,7
1745809480156,ECON 178,A01,907814,Zhu; Ying,28,0,35,7
1745809481182,EDS 115,A00,895312,Staff,41,0,45,4
1745809482209,EDS 117,A01,895337,Staff,30,0,30,0
1745809483235,EDS 125,A00,895341,Jones; Gabrielle Anastasia,43,0,45,2
1745809484260,EDS 128A,A01,895459,Fargason; Sharon Gayle,44,0,45,1
1745809485286,EDS 128B,A01,895543,Pappas; Elizabeth,44,0,45,1
1745809486314,EDS 139,A00,897203,Pappas; Elizabeth,44,0,45,1
1745809486314,EDS 139,B00,897209,Fargason; Sharon Gayle,44,0,45,1
1745809487342,EDS 201,A00,895545,Staff,43,0,45,2
1745809488367,EDS 203,A01,895581,Halter; Christopher P.,43,0,45,2
1745809489397,EDS 204R,A01,895625,Heinzman; Erica M.,43,0,45,2
1745809489397,EDS 204R,B01,895693,Halter; Christopher P.,18,0,45,27
1745809490421,EDS 206R,A00,895694,Fargason; Sharon Gayle,9,0,30,21
1745809490421,EDS 206R,B00,895695,Choi; Bailey Miyeon,20,0,30,10
1745809491448,EDS 250,A00,895697,Hemans; Patricia Ann Benitez,43,0,45,2
1745809492472,EDS 281,A00,895701,Meyerott; Theresa Ann,15,0,15,0
1745809493499,EDS 284,A00,895736,Meyerott; Theresa Ann,15,0,15,0
1745809494527,EDS 286,A00,897210,Fine; Sarah,15,0,15,0
1745809495554,EDS 289C,A01,895770,Daly; Alan J.,15,0,15,0
1745809496579,EDS 290,A00,897211,Hofstetter; Carolyn,15,0,15,0
1745809497606,LIGM 5A,A00,896162,Fischer-Grunski; Eva K,15,0,20,5
1745809498631,LIGM 5B,A00,896260,Fischer-Grunski; Eva K,17,0,20,3
1745809499656,LIGM 5C,A00,896308,Fischer-Grunski; Eva K,18,0,20,2
1745809500681,LIIT 5AS,A00,896313,Carnelos; Chiara,18,0,20,2
1745809501705,LIIT 5BS,A00,896416,Carnelos; Chiara,20,0,20,0
1745809502734,LIIT 5CS,A00,896564,Carnelos; Chiara,20,0,20,0
1745809503764,LISP 5A,A00,896588,Munoz Sanchez; Alicia,4,0,20,16
1745809504797,LISP 5B,A00,896653,Munoz Sanchez; Alicia,10,0,20,10
1745809505826,LISP 5C,A00,896655,Munoz Sanchez; Alicia,4,0,20,16
1745809506853,MAE 197,001,957918,Kleissl; Jan,9998,0,9999,1
1745809507879,MATH 2,A01,957937,Staff,34,0,35,1
1745809508908,MATH 197,001,957876,Kedlaya; Kiran S.,9993,0,9999,6
1745809509934,MCWP 40,A00,892729,Duru; Nur,13,0,20,7
1745809509934,MCWP 40,B00,893304,Montejo; Carolina,20,0,20,0
1745809510963,MCWP 40R,A00,893757,Redela; Pamela Morgan,0,7,20,20
1745809511992,MCWP 50,A00,893758,Morshed; Michael James,2,0,20,18
1745809511992,MCWP 50,B00,893761,Bartulis; Jason Michael,17,0,20,3
1745809513020,MCWP 50R,A00,893766,Compas; Sean Matthew,0,1,20,20
1745809513020,MCWP 50R,B00,893769,Carter; Jennifer A,0,0,20,20
1745809513020,MCWP 50R,C00,893771,Krone; Jarret,0,3,20,20
1745809513020,MCWP 50R,D00,893772,Miller; Elizabeth Deen,3,0,20,17
1745809513020,MCWP 50R,E00,893775,Carter; Andrea L,0,0,20,20
1745809514048,MMW 11R,A01,892721,Herbst; Matthew,11,0,27,16
1745809514048,MMW 11R,A02,892722,Herbst; Matthew,0,0,0,3
1745809515078,MMW 12R,A01,892724,Herbst; Matthew,0,9,16,16
1745809515078,MMW 12R,A02,892725,Herbst; Matthew,0,9,16,16
1745809516105,MMW 13R,A01,892727,Staff,0,4,16,16
1745809516105,MMW 13R,A02,892728,Staff,0,4,16,16
1745809516105,MMW 13R,A03,958032,Staff,0,3,16,16
1745809516105,MMW 13R,A04,958033,Staff,0,2,16,16
1745809516105,MMW 13R,A05,958034,Staff,0,3,16,16
1745809517131,SIO 295LS,A00,894015,Staff,7,0,25,18
1745809518157,SIO 295S,A00,894020,Staff,7,0,25,18
1745809519183,SIOC 290S,B01,958918,Staff,0,0,0,0
1745809520207,SIOC 291S,B01,958922,Staff,0,0,0,0
1745809521235,SOCI 117,A01,895339,Staff,4,0,5,1
1745809522261,WES 237B,A00,894149,Staff,11,0,20,9
1745809524319,AESE 279B,A00,891859,Staff,13,0,35,22
1745809525344,AIP 197,001,891854,Staff,70,0,70,0
1745809526373,ANTH 289S,A00,891856,Gagneux; Pascal,12,0,12,0
1745809527399,BENG 196,001,957946,Engler; Adam J.,9996,0,9999,3
1745809528423,CAT 124RS,A01,956906,Staff,8,0,25,17
1745809529448,CAT 125RS,A01,922013,Staff,8,0,25,17
1745809530476,CLRE 250,A00,891860,Morris; Sheldon,9995,0,9999,4
1745809532527,CLRE 251R,A00,907817,Mehta; Ravindra L.,9994,0,9999,5
1745809533555,CLRE 252,A00,891864,Cuomo; Raphael Eduardo,9993,0,9999,6
1745809534582,CLRE 253,A00,891867,Vaida; Florin,9994,0,9999,5
1745809534582,CLRE 253,B00,907819,Staff,9999,0,9999,0
1745809535607,CLRE 259,A00,891868,Patel; Hemal,9998,0,9999,1
1745809536631,CLRE 260,A00,891872,Cuomo; Raphael Eduardo,9999,0,9999,0
1745809537657,CLRE 297,001,891888,Cuomo; Raphael Eduardo,9999,0,9999,0
1745809538685,CSE 191,A00,958773,Minnes Kemp; Mor Mia,9999,0,9999,0
1745809539711,CSS 201S,A01,892054,Mignozzetti; Umberto,30,0,30,0
1745809540737,CSS 202S,A01,892056,Mignozzetti; Umberto,30,0,30,0
1745809541762,DSC 197,001,956898,Eldridge; Justin Matthew,9998,0,9999,1
1745809542786,DSC 297,001,958000,Mazumdar; Arya,9998,0,9999,1
1745809543829,EAP 100,A00,905686,Staff,9776,0,9999,223
1745809544856,ECE 45,A01,892618,Staff,0,12,50,50
1745809545882,ECE 109,A01,892620,Staff,0,44,0,0
1745809546906,ECE 111,A01,892719,Staff,0,8,50,50
1745809547930,ECE 197,001,957920,Mercier; Patrick Philip,9992,0,9999,7
1745809548959,ECON 178,A01,907814,Zhu; Ying,28,0,35,7
1745809549984,EDS 115,A00,895312,Staff,41,0,45,4
1745809551008,EDS 117,A01,895337,Staff,30,0,30,0
1745809552034,EDS 125,A00,895341,Jones; Gabrielle Anastasia,43,0,45,2
1745809553061,EDS 128A,A01,895459,Fargason; Sharon Gayle,44,0,45,1
1745809554089,EDS 128B,A01,895543,Pappas; Elizabeth,44,0,45,1
1745809555117,EDS 139,A00,897203,Pappas; Elizabeth,44,0,45,1
1745809555117,EDS 139,B00,897209,Fargason; Sharon Gayle,44,0,45,1
1745809556144,EDS 201,A00,895545,Staff,43,0,45,2
1745809557170,EDS 203,A01,895581,Halter; Christopher P.,43,0,45,2
1745809558198,EDS 204R,A01,895625,Heinzman; Erica M.,43,0,45,2
1745809558198,EDS 204R,B01,895693,Halter; Christopher P.,18,0,45,27
1745809559227,EDS 206R,A00,895694,Fargason; Sharon Gayle,9,0,30,21
1745809559227,EDS 206R,B00,895695,Choi; Bailey Miyeon,20,0,30,10
1745809560252,EDS 250,A00,895697,Hemans; Patricia Ann Benitez,43,0,45,2
1745809561280,EDS 281,A00,895701,Meyerott; Theresa Ann,15,0,15,0
1745809562309,EDS 284,A00,895736,Meyerott; Theresa Ann,15,0,15,0
1745809563363,EDS 286,A00,897210,Fine; Sarah,15,0,15,0
1745809564388,EDS 289C,A01,895770,Daly; Alan J.,15,0,15,0
1745809565414,EDS 290,A00,897211,Hofstetter; Carolyn,15,0,15,0
1745809566439,LIGM 5A,A00,896162,Fischer-Grunski; Eva K,15,0,20,5
1745809567463,LIGM 5B,A00,896260,Fischer-Grunski; Eva K,17,0,20,3
1745809568488,LIGM 5C,A00,896308,Fischer-Grunski; Eva K,18,0,20,2
1745809569513,LIIT 5AS,A00,896313,Carnelos; Chiara,18,0,20,2
1745809570540,LIIT 5BS,A00,896416,Carnelos; Chiara,20,0,20,0
1745809571569,LIIT 5CS,A00,896564,Carnelos; Chiara,20,0,20,0
1745809572595,LISP 5A,A00,896588,Munoz Sanchez; Alicia,4,0,20,16
1745809573624,LISP 5B,A00,896653,Munoz Sanchez; Alicia,10,0,20,10
1745809574649,LISP 5C,A00,896655,Munoz Sanchez; Alicia,4,0,20,16
1745809575678,MAE 197,001,957918,Kleissl; Jan,9998,0,9999,1
1745809576704,MATH 2,A01,957937,Staff,34,0,35,1
1745809577730,MATH 197,001,957876,Kedlaya; Kiran S.,9993,0,9999,6
1745809578758,MCWP 40,A00,892729,Duru; Nur,13,0,20,7
1745809578758,MCWP 40,B00,893304,Montejo; Carolina,20,0,20,0
1745809579783,MCWP 40R,A00,893757,Redela; Pamela Morgan,0,7,20,20
1745809580807,MCWP 50,A00,893758,Morshed; Michael James,2,0,20,18
1745809580807,MCWP 50,B00,893761,Bartulis; Jason Michael,17,0,20,3
1745809581833,MCWP 50R,A00,893766,Compas; Sean Matthew,0,1,20,20
1745809581833,MCWP 50R,B00,893769,Carter; Jennifer A,0,0,20,20
1745809581833,MCWP 50R,C00,893771,Krone; Jarret,0,3,20,20
1745809581833,MCWP 50R,D00,893772,Miller; Elizabeth Deen,3,0,20,17
1745809581833,MCWP 50R,E00,893775,Carter; Andrea L,0,0,20,20
1745809582861,MMW 11R,A01,892721,Herbst; Matthew,11,0,27,16
1745809582861,MMW 11R,A02,892722,Herbst; Matthew,0,0,0,3
1745809583889,MMW 12R,A01,892724,Herbst; Matthew,0,9,16,16
1745809583889,MMW 12R,A02,892725,Herbst; Matthew,0,9,16,16
1745809584917,MMW 13R,A01,892727,Staff,0,4,16,16
1745809584917,MMW 13R,A02,892728,Staff,0,4,16,16
1745809584917,MMW 13R,A03,958032,Staff,0,3,16,16
1745809584917,MMW 13R,A04,958033,Staff,0,2,16,16
1745809584917,MMW 13R,A05,958034,Staff,0,3,16,16
1745809585944,SIO 295LS,A00,894015,Staff,7,0,25,18
1745809586973,SIO 295S,A00,894020,Staff,7,0,25,18
1745809587998,SIOC 290S,B01,958918,Staff,0,0,0,0
1745809589027,SIOC 291S,B01,958922,Staff,0,0,0,0
1745809590054,SOCI 117,A01,895339,Staff,4,0,5,1
1745809591080,WES 237B,A00,894149,Staff,11,0,20,9
1745809593148,AESE 279B,A00,891859,Staff,13,0,35,22
1745809594174,AIP 197,001,891854,Staff,70,0,70,0
1745809595203,ANTH 289S,A00,891856,Gagneux; Pascal,12,0,12,0
1745809596229,BENG 196,001,957946,Engler; Adam J.,9996,0,9999,3
1745809597255,CAT 124RS,A01,956906,Staff,8,0,25,17
1745809598284,CAT 125RS,A01,922013,Staff,8,0,25,17
1745809599311,CLRE 250,A00,891860,Morris; Sheldon,9995,0,9999,4
1745809601364,CLRE 251R,A00,907817,Mehta; Ravindra L.,9994,0,9999,5
1745809602392,CLRE 252,A00,891864,Cuomo; Raphael Eduardo,9993,0,9999,6
1745809603417,CLRE 253,A00,891867,Vaida; Florin,9994,0,9999,5
1745809603417,CLRE 253,B00,907819,Staff,9999,0,9999,0
1745809604442,CLRE 259,A00,891868,Patel; Hemal,9998,0,9999,1
1745809605471,CLRE 260,A00,891872,Cuomo; Raphael Eduardo,9999,0,9999,0
1745809606495,CLRE 297,001,891888,Cuomo; Raphael Eduardo,9999,0,9999,0
1745809607522,CSE 191,A00,958773,Minnes Kemp; Mor Mia,9999,0,9999,0
1745809608549,CSS 201S,A01,892054,Mignozzetti; Umberto,30,0,30,0
1745809609577,CSS 202S,A01,892056,Mignozzetti; Umberto,30,0,30,0
1745809610611,DSC 197,001,956898,Eldridge; Justin Matthew,9998,0,9999,1
1745809611648,DSC 297,001,958000,Mazumdar; Arya,9998,0,9999,1
1745809612673,EAP 100,A00,905686,Staff,9776,0,9999,223
1745809613701,ECE 45,A01,892618,Staff,0,12,50,50
1745809614727,ECE 109,A01,892620,Staff,0,44,0,0
1745809615753,ECE 111,A01,892719,Staff,0,8,50,50
1745809616778,ECE 197,001,957920,Mercier; Patrick Philip,9992,0,9999,7
1745809617802,ECON 178,A01,907814,Zhu; Ying,28,0,35,7
1745809618828,EDS 115,A00,895312,Staff,41,0,45,4
1745809619853,EDS 117,A01,895337,Staff,30,0,30,0
1745809620889,EDS 125,A00,895341,Jones; Gabrielle Anastasia,43,0,45,2
1745809621917,EDS 128A,A01,895459,Fargason; Sharon Gayle,44,0,45,1
1745809622941,EDS 128B,A01,895543,Pappas; Elizabeth,44,0,45,1
1745809623969,EDS 139,A00,897203,Pappas; Elizabeth,44,0,45,1
1745809623969,EDS 139,B00,897209,Fargason; Sharon Gayle,44,0,45,1
1745809624997,EDS 201,A00,895545,Staff,43,0,45,2
1745809626025,EDS 203,A01,895581,Halter; Christopher P.,43,0,45,2
1745809627059,EDS 204R,A01,895625,Heinzman; Erica M.,43,0,45,2
1745809627059,EDS 204R,B01,895693,Halter; Christopher P.,18,0,45,27
1745809628087,EDS 206R,A00,895694,Fargason; Sharon Gayle,9,0,30,21
1745809628087,EDS 206R,B00,895695,Choi; Bailey Miyeon,20,0,30,10
1745809629112,EDS 250,A00,895697,Hemans; Patricia Ann Benitez,43,0,45,2
1745809630139,EDS 281,A00,895701,Meyerott; Theresa Ann,15,0,15,0
1745809631167,EDS 284,A00,895736,Meyerott; Theresa Ann,15,0,15,0
1745809632192,EDS 286,A00,897210,Fine; Sarah,15,0,15,0
1745809633220,EDS 289C,A01,895770,Daly; Alan J.,15,0,15,0
1745809634245,EDS 290,A00,897211,Hofstetter; Carolyn,15,0,15,0
1745809635274,LIGM 5A,A00,896162,Fischer-Grunski; Eva K,15,0,20,5
1745809636305,LIGM 5B,A00,896260,Fischer-Grunski; Eva K,17,0,20,3
1745809637332,LIGM 5C,A00,896308,Fischer-Grunski; Eva K,18,0,20,2
1745809638358,LIIT 5AS,A00,896313,Carnelos; Chiara,18,0,20,2
1745809639388,LIIT 5BS,A00,896416,Carnelos; Chiara,20,0,20,0
1745809640411,LIIT 5CS,A00,896564,Carnelos; Chiara,20,0,20,0
1745809641439,LISP 5A,A00,896588,Munoz Sanchez; Alicia,4,0,20,16
1745809642465,LISP 5B,A00,896653,Munoz Sanchez; Alicia,10,0,20,10
1745809643492,LISP 5C,A00,896655,Munoz Sanchez; Alicia,4,0,20,16
1745809644519,MAE 197,001,957918,Kleissl; Jan,9998,0,9999,1
1745809645542,MATH 2,A01,957937,Staff,34,0,35,1
1745809646568,MATH 197,001,957876,Kedlaya; Kiran S.,9993,0,9999,6
1745809647594,MCWP 40,A00,892729,Duru; Nur,13,0,20,7
1745809647594,MCWP 40,B00,893304,Montejo; Carolina,20,0,20,0
1745809648617,MCWP 40R,A00,893757,Redela; Pamela Morgan,0,7,20,20
1745809649645,MCWP 50,A00,893758,Morshed; Michael James,2,0,20,18
1745809649645,MCWP 50,B00,893761,Bartulis; Jason Michael,17,0,20,3
1745809650674,MCWP 50R,A00,893766,Compas; Sean Matthew,0,1,20,20
1745809650674,MCWP 50R,B00,893769,Carter; Jennifer A,0,0,20,20
1745809650674,MCWP 50R,C00,893771,Krone; Jarret,0,3,20,20
1745809650674,MCWP 50R,D00,893772,Miller; Elizabeth Deen,3,0,20,17
1745809650674,MCWP 50R,E00,893775,Carter; Andrea L,0,0,20,20
1745809651701,MMW 11R,A01,892721,Herbst; Matthew,11,0,27,16
1745809651701,MMW 11R,A02,892722,Herbst; Matthew,0,0,0,3
1745809652728,MMW 12R,A01,892724,Herbst; Matthew,0,9,16,16
1745809652728,MMW 12R,A02,892725,Herbst; Matthew,0,9,16,16
1745809653753,MMW 13R,A01,892727,Staff,0,4,16,16
1745809653753,MMW 13R,A02,892728,Staff,0,4,16,16
1745809653753,MMW 13R,A03,958032,Staff,0,3,16,16
1745809653753,MMW 13R,A04,958033,Staff,0,2,16,16
1745809653753,MMW 13R,A05,958034,Staff,0,3,16,16
1745809654778,SIO 295LS,A00,894015,Staff,7,0,25,18
1745809655802,SIO 295S,A00,894020,Staff,7,0,25,18
1745809656882,SIOC 290S,B01,958918,Staff,0,0,0,0
1745809657907,SIOC 291S,B01,958922,Staff,0,0,0,0
1745809658932,SOCI 117,A01,895339,Staff,4,0,5,1
1745809659961,WES 237B,A00,894149,Staff,11,0,20,9
1745809662019,AESE 279B,A00,891859,Staff,13,0,35,22
1745809663046,AIP 197,001,891854,Staff,70,0,70,0
1745809664073,ANTH 289S,A00,891856,Gagneux; Pascal,12,0,12,0
1745809665100,BENG 196,001,957946,Engler; Adam J.,9996,0,9999,3
1745809666126,CAT 124RS,A01,956906,Staff,8,0,25,17
1745809667151,CAT 125RS,A01,922013,Staff,8,0,25,17
1745809668180,CLRE 250,A00,891860,Morris; Sheldon,9995,0,9999,4
1745809670230,CLRE 251R,A00,907817,Mehta; Ravindra L.,9994,0,9999,5
1745809671256,CLRE 252,A00,891864,Cuomo; Raphael Eduardo,9993,0,9999,6
1745809672286,CLRE 253,A00,891867,Vaida; Florin,9994,0,9999,5
1745809672286,CLRE 253,B00,907819,Staff,9999,0,9999,0
1745809673311,CLRE 259,A00,891868,Patel; Hemal,9998,0,9999,1
1745809674342,CLRE 260,A00,891872,Cuomo; Raphael Eduardo,9999,0,9999,0
1745809675369,CLRE 297,001,891888,Cuomo; Raphael Eduardo,9999,0,9999,0
1745809676394,CSE 191,A00,958773,Minnes Kemp; Mor Mia,9999,0,9999,0
1745809677420,CSS 201S,A01,892054,Mignozzetti; Umberto,30,0,30,0
1745809678450,CSS 202S,A01,892056,Mignozzetti; Umberto,30,0,30,0
1745809679478,DSC 197,001,956898,Eldridge; Justin Matthew,9998,0,9999,1
1745809680506,DSC 297,001,958000,Mazumdar; Arya,9998,0,9999,1
1745809681532,EAP 100,A00,905686,Staff,9776,0,9999,223
1745809682558,ECE 45,A01,892618,Staff,0,12,50,50
1745809683583,ECE 109,A01,892620,Staff,0,44,0,0
1745809684609,ECE 111,A01,892719,Staff,0,8,50,50
1745809685634,ECE 197,001,957920,Mercier; Patrick Philip,9992,0,9999,7
1745809686661,ECON 178,A01,907814,Zhu; Ying,28,0,35,7
1745809687685,EDS 115,A00,895312,Staff,41,0,45,4
1745809688710,EDS 117,A01,895337,Staff,30,0,30,0
1745809689735,EDS 125,A00,895341,Jones; Gabrielle Anastasia,43,0,45,2
1745809690761,EDS 128A,A01,895459,Fargason; Sharon Gayle,44,0,45,1
1745809691787,EDS 128B,A01,895543,Pappas; Elizabeth,44,0,45,1
1745809692814,EDS 139,A00,897203,Pappas; Elizabeth,44,0,45,1
1745809692814,EDS 139,B00,897209,Fargason; Sharon Gayle,44,0,45,1
1745809693842,EDS 201,A00,895545,Staff,43,0,45,2
1745809694871,EDS 203,A01,895581,Halter; Christopher P.,43,0,45,2
1745809695897,EDS 204R,A01,895625,Heinzman; Erica M.,43,0,45,2
1745809695897,EDS 204R,B01,895693,Halter; Christopher P.,18,0,45,27
1745809696923,EDS 206R,A00,895694,Fargason; Sharon Gayle,9,0,30,21
1745809696923,EDS 206R,B00,895695,Choi; Bailey Miyeon,20,0,30,10
1745809697949,EDS 250,A00,895697,Hemans; Patricia Ann Benitez,43,0,45,2
1745809698974,EDS 281,A00,895701,Meyerott; Theresa Ann,15,0,15,0
1745809700001,EDS 284,A00,895736,Meyerott; Theresa Ann,15,0,15,0
1745809701029,EDS 286,A00,897210,Fine; Sarah,15,0,15,0
1745809702067,EDS 289C,A01,895770,Daly; Alan J.,15,0,15,0
1745809703099,EDS 290,A00,897211,Hofstetter; Carolyn,15,0,15,0
1745809704126,LIGM 5A,A00,896162,Fischer-Grunski; Eva K,15,0,20,5
1745809705152,LIGM 5B,A00,896260,Fischer-Grunski; Eva K,17,0,20,3
1745809706182,LIGM 5C,A00,896308,Fischer-Grunski; Eva K,18,0,20,2
1745809707208,LIIT 5AS,A00,896313,Carnelos; Chiara,18,0,20,2
1745809708233,LIIT 5BS,A00,896416,Carnelos; Chiara,20,0,20,0
1745809709262,LIIT 5CS,A00,896564,Carnelos; Chiara,20,0,20,0
1745809710290,LISP 5A,A00,896588,Munoz Sanchez; Alicia,4,0,20,16
1745809711318,LISP 5B,A00,896653,Munoz Sanchez; Alicia,10,0,20,10
1745809712343,LISP 5C,A00,896655,Munoz Sanchez; Alicia,4,0,20,16
1745809713369,MAE 197,001,957918,Kleissl; Jan,9998,0,9999,1
1745809714398,MATH 2,A01,957937,Staff,34,0,35,1
1745809715427,MATH 197,001,957876,Kedlaya; Kiran S.,9993,0,9999,6
1745809716457,MCWP 40,A00,892729,Duru; Nur,13,0,20,7
1745809716457,MCWP 40,B00,893304,Montejo; Carolina,20,0,20,0
1745809717483,MCWP 40R,A00,893757,Redela; Pamela Morgan,0,7,20,20
1745809718510,MCWP 50,A00,893758,Morshed; Michael James,2,0,20,18
1745809718510,MCWP 50,B00,893761,Bartulis; Jason Michael,17,0,20,3
1745809719538,MCWP 50R,A00,893766,Compas; Sean Matthew,0,1,20,20
1745809719538,MCWP 50R,B00,893769,Carter; Jennifer A,0,0,20,20
1745809719538,MCWP 50R,C00,893771,Krone; Jarret,0,3,20,20
1745809719538,MCWP 50R,D00,893772,Miller; Elizabeth Deen,3,0,20,17
1745809719538,MCWP 50R,E00,893775,Carter; Andrea L,0,0,20,20
1745809720566,MMW 11R,A01,892721,Herbst; Matthew,11,0,27,16
1745809720566,MMW 11R,A02,892722,Herbst; Matthew,0,0,0,3
1745809721593,MMW 12R,A01,892724,Herbst; Matthew,0,9,16,16
1745809721593,MMW 12R,A02,892725,Herbst; Matthew,0,9,16,16
1745809722619,MMW 13R,A01,892727,Staff,0,4,16,16
1745809722619,MMW 13R,A02,892728,Staff,0,4,16,16
1745809722619,MMW 13R,A03,958032,Staff,0,3,16,16
1745809722619,MMW 13R,A04,958033,Staff,0,2,16,16
1745809722619,MMW 13R,A05,958034,Staff,0,3,16,16
1745809723645,SIO 295LS,A00,894015,Staff,7,0,25,18
1745809724672,SIO 295S,A00,894020,Staff,7,0,25,18
1745809725697,SIOC 290S,B01,958918,Staff,0,0,0,0
1745809726726,SIOC 291S,B01,958922,Staff,0,0,0,0
1745809727753,SOCI 117,A01,895339,Staff,4,0,5,1
1745809728777,WES 237B,A00,894149,Staff,11,0,20,9
1745809730843,AESE 279B,A00,891859,Staff,13,0,35,22
1745809731868,AIP 197,001,891854,Staff,70,0,70,0
1745809732894,ANTH 289S,A00,891856,Gagneux; Pascal,12,0,12,0
1745809733918,BENG 196,001,957946,Engler; Adam J.,9996,0,9999,3
1745809734943,CAT 124RS,A01,956906,Staff,8,0,25,17
1745809735967,CAT 125RS,A01,922013,Staff,8,0,25,17
1745809736993,CLRE 250,A00,891860,Morris; Sheldon,9995,0,9999,4
1745809739045,CLRE 251R,A00,907817,Mehta; Ravindra L.,9994,0,9999,5
1745809740072,CLRE 252,A00,891864,Cuomo; Raphael Eduardo,9993,0,9999,6
1745809741103,CLRE 253,A00,891867,Vaida; Florin,9994,0,9999,5
1745809741103,CLRE 253,B00,907819,Staff,9999,0,9999,0
1745809742129,CLRE 259,A00,891868,Patel; Hemal,9998,0,9999,1
1745809743156,CLRE 260,A00,891872,Cuomo; Raphael Eduardo,9999,0,9999,0
1745809744184,CLRE 297,001,891888,Cuomo; Raphael Eduardo,9999,0,9999,0
1745809745210,CSE 191,A00,958773,Minnes Kemp; Mor Mia,9999,0,9999,0
1745809746236,CSS 201S,A01,892054,Mignozzetti; Umberto,30,0,30,0
1745809747264,CSS 202S,A01,892056,Mignozzetti; Umberto,30,0,30,0
1745809748291,DSC 197,001,956898,Eldridge; Justin Matthew,9998,0,9999,1
1745809749318,DSC 297,001,958000,Mazumdar; Arya,9998,0,9999,1
1745809750343,EAP 100,A00,905686,Staff,9776,0,9999,223
1745809751369,ECE 45,A01,892618,Staff,0,12,50,50
1745809752397,ECE 109,A01,892620,Staff,0,44,0,0
1745809753423,ECE 111,A01,892719,Staff,0,8,50,50
1745809754452,ECE 197,001,957920,Mercier; Patrick Philip,9992,0,9999,7
1745809755484,ECON 178,A01,907814,Zhu; Ying,28,0,35,7
1745809756510,EDS 115,A00,895312,Staff,41,0,45,4
1745809757541,EDS 117,A01,895337,Staff,30,0,30,0
1745809758567,EDS 125,A00,895341,Jones; Gabrielle Anastasia,43,0,45,2
1745809759594,EDS 128A,A01,895459,Fargason; Sharon Gayle,44,0,45,1
1745809760622,EDS 128B,A01,895543,Pappas; Elizabeth,44,0,45,1
1745809761648,EDS 139,A00,897203,Pappas; Elizabeth,44,0,45,1
1745809761648,EDS 139,B00,897209,Fargason; Sharon Gayle,44,0,45,1
1745809762675,EDS 201,A00,895545,Staff,43,0,45,2
1745809763701,EDS 203,A01,895581,Halter; Christopher P.,43,0,45,2
1745809764729,EDS 204R,A01,895625,Heinzman; Erica M.,43,0,45,2
1745809764729,EDS 204R,B01,895693,Halter; Christopher P.,18,0,45,27
1745809765753,EDS 206R,A00,895694,Fargason; Sharon Gayle,9,0,30,21
1745809765753,EDS 206R,B00,895695,Choi; Bailey Miyeon,20,0,30,10
1745809766783,EDS 250,A00,895697,Hemans; Patricia Ann Benitez,43,0,45,2
1745809767810,EDS 281,A00,895701,Meyerott; Theresa Ann,15,0,15,0
1745809768840,EDS 284,A00,895736,Meyerott; Theresa Ann,15,0,15,0
1745809769866,EDS 286,A00,897210,Fine; Sarah,15,0,15,0
1745809770893,EDS 289C,A01,895770,Daly; Alan J.,15,0,15,0
1745809771920,EDS 290,A00,897211,Hofstetter; Carolyn,15,0,15,0
1745809772948,LIGM 5A,A00,896162,Fischer-Grunski; Eva K,15,0,20,5
1745809773972,LIGM 5B,A00,896260,Fischer-Grunski; Eva K,17,0,20,3
1745809775004,LIGM 5C,A00,896308,Fischer-Grunski; Eva K,18,0,20,2
1745809776029,LIIT 5AS,A00,896313,Carnelos; Chiara,18,0,20,2
1745809777056,LIIT 5BS,A00,896416,Carnelos; Chiara,20,0,20,0
1745809778084,LIIT 5CS,A00,896564,Carnelos; Chiara,20,0,20,0
1745809779111,LISP 5A,A00,896588,Munoz Sanchez; Alicia,4,0,20,16
1745809780138,LISP 5B,A00,896653,Munoz Sanchez; Alicia,10,0,20,10
1745809781164,LISP 5C,A00,896655,Munoz Sanchez; Alicia,4,0,20,16
1745809782191,MAE 197,001,957918,Kleissl; Jan,9998,0,9999,1
1745809783220,MATH 2,A01,957937,Staff,34,0,35,1
1745809784244,MATH 197,001,957876,Kedlaya; Kiran S.,9993,0,9999,6
1745809785274,MCWP 40,A00,892729,Duru; Nur,13,0,20,7
1745809785274,MCWP 40,B00,893304,Montejo; Carolina,20,0,20,0
1745809786302,MCWP 40R,A00,893757,Redela; Pamela Morgan,0,7,20,20
1745809787329,MCWP 50,A00,893758,Morshed; Michael James,2,0,20,18
1745809787329,MCWP 50,B00,893761,Bartulis; Jason Michael,17,0,20,3
1745809788361,MCWP 50R,A00,893766,Compas; Sean Matthew,0,1,20,20
1745809788361,MCWP 50R,B00,893769,Carter; Jennifer A,0,0,20,20
1745809788361,MCWP 50R,C00,893771,Krone; Jarret,0,3,20,20
1745809788361,MCWP 50R,D00,893772,Miller; Elizabeth Deen,3,0,20,17
1745809788361,MCWP 50R,E00,893775,Carter; Andrea L,0,0,20,20
1745809789392,MMW 11R,A01,892721,Herbst; Matthew,11,0,27,16
1745809789392,MMW 11R,A02,892722,Herbst; Matthew,0,0,0,3
1745809790421,MMW 12R,A01,892724,Herbst; Matthew,0,9,16,16
1745809790421,MMW 12R,A02,892725,Herbst; Matthew,0,9,16,16
1745809791447,MMW 13R,A01,892727,Staff,0,4,16,16
1745809791447,MMW 13R,A02,892728,Staff,0,4,16,16
1745809791447,MMW 13R,A03,958032,Staff,0,3,16,16
1745809791447,MMW 13R,A04,958033,Staff,0,2,16,16
1745809791447,MMW 13R,A05,958034,Staff,0,3,16,16
1745809792477,SIO 295LS,A00,894015,Staff,7,0,25,18
1745809793505,SIO 295S,A00,894020,Staff,7,0,25,18
1745809794558,SIOC 290S,B01,958918,Staff,0,0,0,0
1745809795585,SIOC 291S,B01,958922,Staff,0,0,0,0
1745809796613,SOCI 117,A01,895339,Staff,4,0,5,1
1745809797640,WES 237B,A00,894149,Staff,11,0,20,9
1745809799697,AESE 279B,A00,891859,Staff,13,0,35,22
1745809800721,AIP 197,001,891854,Staff,70,0,70,0
1745809801747,ANTH 289S,A00,891856,Gagneux; Pascal,12,0,12,0
1745809802779,BENG 196,001,957946,Engler; Adam J.,9996,0,9999,3
1745809803808,CAT 124RS,A01,956906,Staff,8,0,25,17
1745809804833,CAT 125RS,A01,922013,Staff,8,0,25,17
1745809805858,CLRE 250,A00,891860,Morris; Sheldon,9995,0,9999,4
1745809807910,CLRE 251R,A00,907817,Mehta; Ravindra L.,9994,0,9999,5
1745809808936,CLRE 252,A00,891864,Cuomo; Raphael Eduardo,9993,0,9999,6
1745809809961,CLRE 253,A00,891867,Vaida; Florin,9994,0,9999,5
1745809809961,CLRE 253,B00,907819,Staff,9999,0,9999,0
1745809810986,CLRE 259,A00,891868,Patel; Hemal,9998,0,9999,1
1745809812011,CLRE 260,A00,891872,Cuomo; Raphael Eduardo,9999,0,9999,0
1745809813036,CLRE 297,001,891888,Cuomo; Raphael Eduardo,9999,0,9999,0
1745809814064,CSE 191,A00,958773,Minnes Kemp; Mor Mia,9999,0,9999,0
1745809815093,CSS 201S,A01,892054,Mignozzetti; Umberto,30,0,30,0
1745809816119,CSS 202S,A01,892056,Mignozzetti; Umberto,30,0,30,0
1745809817147,DSC 197,001,956898,Eldridge; Justin Matthew,9998,0,9999,1
1745809818174,DSC 297,001,958000,Mazumdar; Arya,9998,0,9999,1
1745809819203,EAP 100,A00,905686,Staff,9776,0,9999,223
1745809820233,ECE 45,A01,892618,Staff,0,12,50,50
1745809821259,ECE 109,A01,892620,Staff,0,44,0,0
1745809822288,ECE 111,A01,892719,Staff,0,8,50,50
1745809823315,ECE 197,001,957920,Mercier; Patrick Philip,9992,0,9999,7
1745809824342,ECON 178,A01,907814,Zhu; Ying,28,0,35,7
1745809825369,EDS 115,A00,895312,Staff,41,0,45,4
1745809826395,EDS 117,A01,895337,Staff,30,0,30,0
1745809827422,EDS 125,A00,895341,Jones; Gabrielle Anastasia,43,0,45,2
1745809828449,EDS 128A,A01,895459,Fargason; Sharon Gayle,44,0,45,1
1745809829475,EDS 128B,A01,895543,Pappas; Elizabeth,44,0,45,1
1745809830504,EDS 139,A00,897203,Pappas; Elizabeth,44,0,45,1
1745809830504,EDS 139,B00,897209,Fargason; Sharon Gayle,44,0,45,1
1745809831531,EDS 201,A00,895545,Staff,43,0,45,2
1745809832561,EDS 203,A01,895581,Halter; Christopher P.,43,0,45,2
1745809833589,EDS 204R,A01,895625,Heinzman; Erica M.,43,0,45,2
1745809833589,EDS 204R,B01,895693,Halter; Christopher P.,18,0,45,27
1745809834615,EDS 206R,A00,895694,Fargason; Sharon Gayle,9,0,30,21
1745809834615,EDS 206R,B00,895695,Choi; Bailey Miyeon,20,0,30,10
1745809835643,EDS 250,A00,895697,Hemans; Patricia Ann Benitez,43,0,45,2
1745809836670,EDS 281,A00,895701,Meyerott; Theresa Ann,15,0,15,0
1745809837698,EDS 284,A00,895736,Meyerott; Theresa Ann,15,0,15,0
1745809838724,EDS 286,A00,897210,Fine; Sarah,15,0,15,0
1745809839751,EDS 289C,A01,895770,Daly; Alan J.,15,0,15,0
1745809840778,EDS 290,A00,897211,Hofstetter; Carolyn,15,0,15,0
1745809841831,LIGM 5A,A00,896162,Fischer-Grunski; Eva K,15,0,20,5
1745809842858,LIGM 5B,A00,896260,Fischer-Grunski; Eva K,17,0,20,3
1745809843886,LIGM 5C,A00,896308,Fischer-Grunski; Eva K,18,0,20,2
1745809844916,LIIT 5AS,A00,896313,Carnelos; Chiara,18,0,20,2
1745809845942,LIIT 5BS,A00,896416,Carnelos; Chiara,20,0,20,0
1745809846972,LIIT 5CS,A00,896564,Carnelos; Chiara,20,0,20,0
1745809847999,LISP 5A,A00,896588,Munoz Sanchez; Alicia,4,0,20,16
1745809849027,LISP 5B,A00,896653,Munoz Sanchez; Alicia,10,0,20,10
1745809850054,LISP 5C,A00,896655,Munoz Sanchez; Alicia,4,0,20,16
1745809851078,MAE 197,001,957918,Kleissl; Jan,9998,0,9999,1
1745809852104,MATH 2,A01,957937,Staff,34,0,35,1
1745809853134,MATH 197,001,957876,Kedlaya; Kiran S.,9993,0,9999,6
1745809854159,MCWP 40,A00,892729,Duru; Nur,13,0,20,7
1745809854159,MCWP 40,B00,893304,Montejo; Carolina,20,0,20,0
1745809855185,MCWP 40R,A00,893757,Redela; Pamela Morgan,0,7,20,20
1745809856213,MCWP 50,A00,893758,Morshed; Michael James,2,0,20,18
1745809856213,MCWP 50,B00,893761,Bartulis; Jason Michael,17,0,20,3
1745809857252,MCWP 50R,A00,893766,Compas; Sean Matthew,0,1,20,20
1745809857252,MCWP 50R,B00,893769,Carter; Jennifer A,0,0,20,20
1745809857252,MCWP 50R,C00,893771,Krone; Jarret,0,3,20,20
1745809857252,MCWP 50R,D00,893772,Miller; Elizabeth Deen,3,0,20,17
1745809857252,MCWP 50R,E00,893775,Carter; Andrea L,0,0,20,20
1745809858280,MMW 11R,A01,892721,Herbst; Matthew,11,0,27,16
1745809858280,MMW 11R,A02,892722,Herbst; Matthew,0,0,0,3
1745809859310,MMW 12R,A01,892724,Herbst; Matthew,0,9,16,16
1745809859310,MMW 12R,A02,892725,Herbst; Matthew,0,9,16,16
1745809860339,MMW 13R,A01,892727,Staff,0,4,16,16
1745809860339,MMW 13R,A02,892728,Staff,0,4,16,16
1745809860339,MMW 13R,A03,958032,Staff,0,3,16,16
1745809860339,MMW 13R,A04,958033,Staff,0,2,16,16
1745809860339,MMW 13R,A05,958034,Staff,0,3,16,16
1745809861366,SIO 295LS,A00,894015,Staff,7,0,25,18
1745809862394,SIO 295S,A00,894020,Staff,7,0,25,18
1745809863424,SIOC 290S,B01,958918,Staff,0,0,0,0
1745809864451,SIOC 291S,B01,958922,Staff,0,0,0,0
1745809865479,SOCI 117,A01,895339,Staff,4,0,5,1
1745809866505,WES 237B,A00,894149,Staff,11,0,20,9
1745809868568,AESE 279B,A00,891859,Staff,13,0,35,22
1745809869594,AIP 197,001,891854,Staff,70,0,70,0
1745809870622,ANTH 289S,A00,891856,Gagneux; Pascal,12,0,12,0
1745809871651,BENG 196,001,957946,Engler; Adam J.,9996,0,9999,3
1745809872678,CAT 124RS,A01,956906,Staff,8,0,25,17
1745809873703,CAT 125RS,A01,922013,Staff,8,0,25,17
1745809874728,CLRE 250,A00,891860,Morris; Sheldon,9995,0,9999,4
1745809876788,CLRE 251R,A00,907817,Mehta; Ravindra L.,9994,0,9999,5
1745809877816,CLRE 252,A00,891864,Cuomo; Raphael Eduardo,9993,0,9999,6
1745809878843,CLRE 253,A00,891867,Vaida; Florin,9994,0,9999,5
1745809878843,CLRE 253,B00,907819,Staff,9999,0,9999,0
1745809879867,CLRE 259,A00,891868,Patel; Hemal,9998,0,9999,1
1745809880907,CLRE 260,A00,891872,Cuomo; Raphael Eduardo,9999,0,9999,0
1745809881935,CLRE 297,001,891888,Cuomo; Raphael Eduardo,9999,0,9999,0
1745809882963,CSE 191,A00,958773,Minnes Kemp; Mor Mia,9999,0,9999,0
1745809883991,CSS 201S,A01,892054,Mignozzetti; Umberto,30,0,30,0
1745809885021,CSS 202S,A01,892056,Mignozzetti; Umberto,30,0,30,0
1745809886046,DSC 197,001,956898,Eldridge; Justin Matthew,9998,0,9999,1
1745809887071,DSC 297,001,958000,Mazumdar; Arya,9998,0,9999,1
1745809888098,EAP 100,A00,905686,Staff,9776,0,9999,223
1745809889124,ECE 45,A01,892618,Staff,0,12,50,50
1745809890149,ECE 109,A01,892620,Staff,0,44,0,0
1745809891178,ECE 111,A01,892719,Staff,0,8,50,50
1745809892202,ECE 197,001,957920,Mercier; Patrick Philip,9992,0,9999,7
1745809893227,ECON 178,A01,907814,Zhu; Ying,28,0,35,7
1745809894251,EDS 115,A00,895312,Staff,41,0,45,4
1745809895277,EDS 117,A01,895337,Staff,30,0,30,0
1745809896302,EDS 125,A00,895341,Jones; Gabrielle Anastasia,43,0,45,2
1745809897326,EDS 128A,A01,895459,Fargason; Sharon Gayle,44,0,45,1
1745809898353,EDS 128B,A01,895543,Pappas; Elizabeth,44,0,45,1
1745809899379,EDS 139,A00,897203,Pappas; Elizabeth,44,0,45,1
1745809899379,EDS 139,B00,897209,Fargason; Sharon Gayle,44,0,45,1
1745809900403,EDS 201,A00,895545,Staff,43,0,45,2
1745809901428,EDS 203,A01,895581,Halter; Christopher P.,43,0,45,2
1745809902457,EDS 204R,A01,895625,Heinzman; Erica M.,43,0,45,2
1745809902457,EDS 204R,B01,895693,Halter; Christopher P.,18,0,45,27
1745809903484,EDS 206R,A00,895694,Fargason; Sharon Gayle,9,0,30,21
1745809903484,EDS 206R,B00,895695,Choi; Bailey Miyeon,20,0,30,10
1745809904511,EDS 250,A00,895697,Hemans; Patricia Ann Benitez,43,0,45,2
1745809905536,EDS 281,A00,895701,Meyerott; Theresa Ann,15,0,15,0
1745809906562,EDS 284,A00,895736,Meyerott; Theresa Ann,15,0,15,0
1745809907589,EDS 286,A00,897210,Fine; Sarah,15,0,15,0
1745809908617,EDS 289C,A01,895770,Daly; Alan J.,15,0,15,0
1745809909640,EDS 290,A00,897211,Hofstetter; Carolyn,15,0,15,0
1745809910667,LIGM 5A,A00,896162,Fischer-Grunski; Eva K,15,0,20,5
1745809911693,LIGM 5B,A00,896260,Fischer-Grunski; Eva K,17,0,20,3
1745809912722,LIGM 5C,A00,896308,Fischer-Grunski; Eva K,18,0,20,2
1745809913752,LIIT 5AS,A00,896313,Carnelos; Chiara,18,0,20,2
1745809914781,LIIT 5BS,A00,896416,Carnelos; Chiara,20,0,20,0
1745809915808,LIIT 5CS,A00,896564,Carnelos; Chiara,20,0,20,0
1745809916837,LISP 5A,A00,896588,Munoz Sanchez; Alicia,4,0,20,16
1745809917864,LISP 5B,A00,896653,Munoz Sanchez; Alicia,10,0,20,10
1745809918894,LISP 5C,A00,896655,Munoz Sanchez; Alicia,4,0,20,16
1745809919920,MAE 197,001,957918,Kleissl; Jan,9998,0,9999,1
1745809920950,MATH 2,A01,957937,Staff,34,0,35,1
1745809921975,MATH 197,001,957876,Kedlaya; Kiran S.,9993,0,9999,6
1745809923001,MCWP 40,A00,892729,Duru; Nur,13,0,20,7
1745809923001,MCWP 40,B00,893304,Montejo; Carolina,20,0,20,0
1745809924030,MCWP 40R,A00,893757,Redela; Pamela Morgan,0,7,20,20
1745809925055,MCWP 50,A00,893758,Morshed; Michael James,2,0,20,18
1745809925055,MCWP 50,B00,893761,Bartulis; Jason Michael,17,0,20,3
1745809926082,MCWP 50R,A00,893766,Compas; Sean Matthew,0,1,20,20
1745809926082,MCWP 50R,B00,893769,Carter; Jennifer A,0,0,20,20
1745809926082,MCWP 50R,C00,893771,Krone; Jarret,0,3,20,20
1745809926082,MCWP 50R,D00,893772,Miller; Elizabeth Deen,3,0,20,17
1745809926082,MCWP 50R,E00,893775,Carter; Andrea L,0,0,20,20
1745809927109,MMW 11R,A01,892721,Herbst; Matthew,11,0,27,16
1745809927109,MMW 11R,A02,892722,Herbst; Matthew,0,0,0,3
1745809928144,MMW 12R,A01,892724,Herbst; Matthew,0,9,16,16
1745809928144,MMW 12R,A02,892725,Herbst; Matthew,0,9,16,16
1745809929169,MMW 13R,A01,892727,Staff,0,4,16,16
1745809929169,MMW 13R,A02,892728,Staff,0,4,16,16
1745809929169,MMW 13R,A03,958032,Staff,0,3,16,16
1745809929169,MMW 13R,A04,958033,Staff,0,2,16,16
1745809929169,MMW 13R,A05,958034,Staff,0,3,16,16
1745809930198,SIO 295LS,A00,894015,Staff,7,0,25,18
1745809931227,SIO 295S,A00,894020,Staff,7,0,25,18
1745809932257,SIOC 290S,B01,958918,Staff,0,0,0,0
1745809933288,SIOC 291S,B01,958922,Staff,0,0,0,0
1745809934315,SOCI 117,A01,895339,Staff,4,0,5,1
1745809935340,WES 237B,A00,894149,Staff,11,0,20,9
1745809937407,AESE 279B,A00,891859,Staff,13,0,35,22
1745809938435,AIP 197,001,891854,Staff,70,0,70,0
1745809939462,ANTH 289S,A00,891856,Gagneux; Pascal,12,0,12,0
1745809940487,BENG 196,001,957946,Engler; Adam J.,9996,0,9999,3
1745809941514,CAT 124RS,A01,956906,Staff,8,0,25,17
1745809942540,CAT 125RS,A01,922013,Staff,8,0,25,17
1745809943568,CLRE 250,A00,891860,Morris; Sheldon,9995,0,9999,4
1745809945622,CLRE 251R,A00,907817,Mehta; Ravindra L.,9994,0,9999,5
1745809946649,CLRE 252,A00,891864,Cuomo; Raphael Eduardo,9993,0,9999,6
1745809947679,CLRE 253,A00,891867,Vaida; Florin,9994,0,9999,5
1745809947679,CLRE 253,B00,907819,Staff,9999,0,9999,0
1745809948705,CLRE 259,A00,891868,Patel; Hemal,9998,0,9999,1
1745809949729,CLRE 260,A00,891872,Cuomo; Raphael Eduardo,9999,0,9999,0
1745809950757,CLRE 297,001,891888,Cuomo; Raphael Eduardo,9999,0,9999,0
1745809951785,CSE 191,A00,958773,Minnes Kemp; Mor Mia,9999,0,9999,0
1745809952812,CSS 201S,A01,892054,Mignozzetti; Umberto,30,0,30,0
1745809953842,CSS 202S,A01,892056,Mignozzetti; Umberto,30,0,30,0
1745809954868,DSC 197,001,956898,Eldridge; Justin Matthew,9998,0,9999,1
1745809955898,DSC 297,001,958000,Mazumdar; Arya,9998,0,9999,1
1745809956922,EAP 100,A00,905686,Staff,9776,0,9999,223
1745809957949,ECE 45,A01,892618,Staff,0,12,50,50
1745809958977,ECE 109,A01,892620,Staff,0,44,0,0
1745809960007,ECE 111,A01,892719,Staff,0,8,50,50
1745809961035,ECE 197,001,957920,Mercier; Patrick Philip,9992,0,9999,7
1745809962064,ECON 178,A01,907814,Zhu; Ying,28,0,35,7
1745809963094,EDS 115,A00,895312,Staff,41,0,45,4
1745809964122,EDS 117,A01,895337,Staff,30,0,30,0
1745809965148,EDS 125,A00,895341,Jones; Gabrielle Anastasia,43,0,45,2
1745809966173,EDS 128A,A01,895459,Fargason; Sharon Gayle,44,0,45,1
1745809967202,EDS 128B,A01,895543,Pappas; Elizabeth,44,0,45,1
1745809968231,EDS 139,A00,897203,Pappas; Elizabeth,44,0,45,1
1745809968231,EDS 139,B00,897209,Fargason; Sharon Gayle,44,0,45,1
1745809969257,EDS 201,A00,895545,Staff,43,0,45,2
1745809970283,EDS 203,A01,895581,Halter; Christopher P.,43,0,45,2
1745809971310,EDS 204R,A01,895625,Heinzman; Erica M.,43,0,45,2
1745809971310,EDS 204R,B01,895693,Halter; Christopher P.,18,0,45,27
1745809972338,EDS 206R,A00,895694,Fargason; Sharon Gayle,9,0,30,21
1745809972338,EDS 206R,B00,895695,Choi; Bailey Miyeon,20,0,30,10
1745809973366,EDS 250,A00,895697,Hemans; Patricia Ann Benitez,43,0,45,2
1745809974396,EDS 281,A00,895701,Meyerott; Theresa Ann,15,0,15,0
1745809975420,EDS 284,A00,895736,Meyerott; Theresa Ann,15,0,15,0
1745809976449,EDS 286,A00,897210,Fine; Sarah,15,0,15,0
1745809977477,EDS 289C,A01,895770,Daly; Alan J.,15,0,15,0
1745809978506,EDS 290,A00,897211,Hofstetter; Carolyn,15,0,15,0
1745809979531,LIGM 5A,A00,896162,Fischer-Grunski; Eva K,15,0,20,5
1745809980571,LIGM 5B,A00,896260,Fischer-Grunski; Eva K,17,0,20,3
1745809981597,LIGM 5C,A00,896308,Fischer-Grunski; Eva K,18,0,20,2
1745809982625,LIIT 5AS,A00,896313,Carnelos; Chiara,18,0,20,2
1745809983654,LIIT 5BS,A00,896416,Carnelos; Chiara,20,0,20,0
1745809984689,LIIT 5CS,A00,896564,Carnelos; Chiara,20,0,20,0
1745809985711,LISP 5A,A00,896588,Munoz Sanchez; Alicia,4,0,20,16
1745809986743,LISP 5B,A00,896653,Munoz Sanchez; Alicia,10,0,20,10
1745809987773,LISP 5C,A00,896655,Munoz Sanchez; Alicia,4,0,20,16
1745809988800,MAE 197,001,957918,Kleissl; Jan,9998,0,9999,1
1745809989829,MATH 2,A01,957937,Staff,34,0,35,1
1745809990857,MATH 197,001,957876,Kedlaya; Kiran S.,9993,0,9999,6
1745809991881,MCWP 40,A00,892729,Duru; Nur,13,0,20,7
1745809991881,MCWP 40,B00,893304,Montejo; Carolina,20,0,20,0
1745809992907,MCWP 40R,A00,893757,Redela; Pamela Morgan,0,7,20,20
1745809993938,MCWP 50,A00,893758,Morshed; Michael James,2,0,20,18
1745809993938,MCWP 50,B00,893761,Bartulis; Jason Michael,17,0,20,3
1745809994963,MCWP 50R,A00,893766,Compas; Sean Matthew,0,1,20,20
1745809994963,MCWP 50R,B00,893769,Carter; Jennifer A,0,0,20,20
1745809994963,MCWP 50R,C00,893771,Krone; Jarret,0,3,20,20
1745809994963,MCWP 50R,D00,893772,Miller; Elizabeth Deen,3,0,20,17
1745809994963,MCWP 50R,E00,893775,Carter; Andrea L,0,0,20,20
1745809995990,MMW 11R,A01,892721,Herbst; Matthew,11,0,27,16
1745809995990,MMW 11R,A02,892722,Herbst; Matthew,0,0,0,3
1745809997015,MMW 12R,A01,892724,Herbst; Matthew,0,9,16,16
1745809997015,MMW 12R,A02,892725,Herbst; Matthew,0,9,16,16
1745809998041,MMW 13R,A01,892727,Staff,0,4,16,16
1745809998041,MMW 13R,A02,892728,Staff,0,4,16,16
1745809998041,MMW 13R,A03,958032,Staff,0,3,16,16
1745809998041,MMW 13R,A04,958033,Staff,0,2,16,16
1745809998041,MMW 13R,A05,958034,Staff,0,3,16,16
1745809999070,SIO 295LS,A00,894015,Staff,7,0,25,18
1745810000097,SIO 295S,A00,894020,Staff,7,0,25,18
1745810001123,SIOC 290S,B01,958918,Staff,0,0,0,0
1745810002150,SIOC 291S,B01,958922,Staff,0,0,0,0
1745810003176,SOCI 117,A01,895339,Staff,4,0,5,1
1745810004205,WES 237B,A00,894149,Staff,11,0,20,9
1745810006264,AESE 279B,A00,891859,Staff,13,0,35,22
1745810007288,AIP 197,001,891854,Staff,70,0,70,0
1745810008316,ANTH 289S,A00,891856,Gagneux; Pascal,12,0,12,0
1745810009342,BENG 196,001,957946,Engler; Adam J.,9996,0,9999,3
1745810010367,CAT 124RS,A01,956906,Staff,8,0,25,17
1745810011392,CAT 125RS,A01,922013,Staff,8,0,25,17
1745810012420,CLRE 250,A00,891860,Morris; Sheldon,9995,0,9999,4
1745810014476,CLRE 251R,A00,907817,Mehta; Ravindra L.,9994,0,9999,5
1745810015506,CLRE 252,A00,891864,Cuomo; Raphael Eduardo,9993,0,9999,6
1745810016537,CLRE 253,A00,891867,Vaida; Florin,9994,0,9999,5
1745810016537,CLRE 253,B00,907819,Staff,9999,0,9999,0
1745810017566,CLRE 259,A00,891868,Patel; Hemal,9998,0,9999,1
1745810018593,CLRE 260,A00,891872,Cuomo; Raphael Eduardo,9999,0,9999,0
1745810019621,CLRE 297,001,891888,Cuomo; Raphael Eduardo,9999,0,9999,0
1745810020645,CSE 191,A00,958773,Minnes Kemp; Mor Mia,9999,0,9999,0
1745810021672,CSS 201S,A01,892054,Mignozzetti; Umberto,30,0,30,0
1745810022699,CSS 202S,A01,892056,Mignozzetti; Umberto,30,0,30,0
1745810023727,DSC 197,001,956898,Eldridge; Justin Matthew,9998,0,9999,1
1745810024756,DSC 297,001,958000,Mazumdar; Arya,9998,0,9999,1
1745810025783,EAP 100,A00,905686,Staff,9776,0,9999,223
1745810026809,ECE 45,A01,892618,Staff,0,12,50,50
1745810027835,ECE 109,A01,892620,Staff,0,44,0,0
1745810028860,ECE 111,A01,892719,Staff,0,8,50,50
1745810029888,ECE 197,001,957920,Mercier; Patrick Philip,9992,0,9999,7
1745810030916,ECON 178,A01,907814,Zhu; Ying,28,0,35,7
1745810031943,EDS 115,A00,895312,Staff,41,0,45,4
1745810032972,EDS 117,A01,895337,Staff,30,0,30,0
1745810034001,EDS 125,A00,895341,Jones; Gabrielle Anastasia,43,0,45,2
1745810035027,EDS 128A,A01,895459,Fargason; Sharon Gayle,44,0,45,1
1745810036056,EDS 128B,A01,895543,Pappas; Elizabeth,44,0,45,1
1745810037080,EDS 139,A00,897203,Pappas; Elizabeth,44,0,45,1
1745810037080,EDS 139,B00,897209,Fargason; Sharon Gayle,44,0,45,1
1745810038107,EDS 201,A00,895545,Staff,43,0,45,2
1745810039135,EDS 203,A01,895581,Halter; Christopher P.,43,0,45,2
1745810040166,EDS 204R,A01,895625,Heinzman; Erica M.,43,0,45,2
1745810040166,EDS 204R,B01,895693,Halter; Christopher P.,18,0,45,27
1745810041193,EDS 206R,A00,895694,Fargason; Sharon Gayle,9,0,30,21
1745810041193,EDS 206R,B00,895695,Choi; Bailey Miyeon,20,0,30,10
1745810042221,EDS 250,A00,895697,Hemans; Patricia Ann Benitez,43,0,45,2
1745810043248,EDS 281,A00,895701,Meyerott; Theresa Ann,15,0,15,0
1745810044277,EDS 284,A00,895736,Meyerott; Theresa Ann,15,0,15,0
1745810045308,EDS 286,A00,897210,Fine; Sarah,15,0,15,0
1745810046334,EDS 289C,A01,895770,Daly; Alan J.,15,0,15,0
1745810047363,EDS 290,A00,897211,Hofstetter; Carolyn,15,0,15,0
1745810048391,LIGM 5A,A00,896162,Fischer-Grunski; Eva K,15,0,20,5
1745810049421,LIGM 5B,A00,896260,Fischer-Grunski; Eva K,17,0,20,3
1745810050449,LIGM 5C,A00,896308,Fischer-Grunski; Eva K,18,0,20,2
1745810051479,LIIT 5AS,A00,896313,Carnelos; Chiara,18,0,20,2
1745810052506,LIIT 5BS,A00,896416,Carnelos; Chiara,20,0,20,0
1745810053534,LIIT 5CS,A00,896564,Carnelos; Chiara,20,0,20,0
1745810054562,LISP 5A,A00,896588,Munoz Sanchez; Alicia,4,0,20,16
1745810055588,LISP 5B,A00,896653,Munoz Sanchez; Alicia,10,0,20,10
1745810056615,LISP 5C,A00,896655,Munoz Sanchez; Alicia,4,0,20,16
1745810057641,MAE 197,001,957918,Kleissl; Jan,9998,0,9999,1
1745810058669,MATH 2,A01,957937,Staff,34,0,35,1
1745810059696,MATH 197,001,957876,Kedlaya; Kiran S.,9993,0,9999,6
1745810060724,MCWP 40,A00,892729,Duru; Nur,13,0,20,7
1745810060724,MCWP 40,B00,893304,Montejo; Carolina,20,0,20,0
1745810061750,MCWP 40R,A00,893757,Redela; Pamela Morgan,0,7,20,20
1745810062779,MCWP 50,A00,893758,Morshed; Michael James,2,0,20,18
1745810062779,MCWP 50,B00,893761,Bartulis; Jason Michael,17,0,20,3
1745810063810,MCWP 50R,A00,893766,Compas; Sean Matthew,0,1,20,20
1745810063810,MCWP 50R,B00,893769,Carter; Jennifer A,0,0,20,20
1745810063810,MCWP 50R,C00,893771,Krone; Jarret,0,3,20,20
1745810063810,MCWP 50R,D00,893772,Miller; Elizabeth Deen,3,0,20,17
1745810063810,MCWP 50R,E00,893775,Carter; Andrea L,0,0,20,20
1745810064836,MMW 11R,A01,892721,Herbst; Matthew,11,0,27,16
1745810064836,MMW 11R,A02,892722,Herbst; Matthew,0,0,0,3
1745810065865,MMW 12R,A01,892724,Herbst; Matthew,0,9,16,16
1745810065865,MMW 12R,A02,892725,Herbst; Matthew,0,9,16,16
1745810066890,MMW 13R,A01,892727,Staff,0,4,16,16
1745810066890,MMW 13R,A02,892728,Staff,0,4,16,16
1745810066890,MMW 13R,A03,958032,Staff,0,3,16,16
1745810066890,MMW 13R,A04,958033,Staff,0,2,16,16
1745810066890,MMW 13R,A05,958034,Staff,0,3,16,16
1745810067917,SIO 295LS,A00,894015,Staff,7,0,25,18
1745810068945,SIO 295S,A00,894020,Staff,7,0,25,18
1745810069973,SIOC 290S,B01,958918,Staff,0,0,0,0
1745810070999,SIOC 291S,B01,958922,Staff,0,0,0,0
1745810072028,SOCI 117,A01,895339,Staff,4,0,5,1
1745810073052,WES 237B,A00,894149,Staff,11,0,20,9
1745810075121,AESE 279B,A00,891859,Staff,13,0,35,22
1745810076147,AIP 197,001,891854,Staff,70,0,70,0
1745810077173,ANTH 289S,A00,891856,Gagneux; Pascal,12,0,12,0
1745810078199,BENG 196,001,957946,Engler; Adam J.,9996,0,9999,3
1745810079226,CAT 124RS,A01,956906,Staff,8,0,25,17
1745810080251,CAT 125RS,A01,922013,Staff,8,0,25,17
1745810081278,CLRE 250,A00,891860,Morris; Sheldon,9995,0,9999,4
1745810083331,CLRE 251R,A00,907817,Mehta; Ravindra L.,9994,0,9999,5
1745810084360,CLRE 252,A00,891864,Cuomo; Raphael Eduardo,9993,0,9999,6
1745810085390,CLRE 253,A00,891867,Vaida; Florin,9994,0,9999,5
1745810085390,CLRE 253,B00,907819,Staff,9999,0,9999,0
1745810086415,CLRE 259,A00,891868,Patel; Hemal,9998,0,9999,1
1745810087440,CLRE 260,A00,891872,Cuomo; Raphael Eduardo,9999,0,9999,0
1745810088467,CLRE 297,001,891888,Cuomo; Raphael Eduardo,9999,0,9999,0
1745810089493,CSE 191,A00,958773,Minnes Kemp; Mor Mia,9999,0,9999,0
1745810090519,CSS 201S,A01,892054,Mignozzetti; Umberto,30,0,30,0
1745810091547,CSS 202S,A01,892056,Mignozzetti; Umberto,30,0,30,0
1745810092572,DSC 197,001,956898,Eldridge; Justin Matthew,9998,0,9999,1
1745810093599,DSC 297,001,958000,Mazumdar; Arya,9998,0,9999,1
1745810094626,EAP 100,A00,905686,Staff,9776,0,9999,223
1745810095652,ECE 45,A01,892618,Staff,0,12,50,50
1745810096681,ECE 109,A01,892620,Staff,0,44,0,0
1745810097709,ECE 111,A01,892719,Staff,0,8,50,50
1745810098735,ECE 197,001,957920,Mercier; Patrick Philip,9992,0,9999,7
1745810099763,ECON 178,A01,907814,Zhu; Ying,28,0,35,7
1745810100790,EDS 115,A00,895312,Staff,41,0,45,4
1745810101817,EDS 117,A01,895337,Staff,30,0,30,0
1745810102842,EDS 125,A00,895341,Jones; Gabrielle Anastasia,43,0,45,2
1745810103873,EDS 128A,A01,895459,Fargason; Sharon Gayle,44,0,45,1
1745810104900,EDS 128B,A01,895543,Pappas; Elizabeth,44,0,45,1
1745810105931,EDS 139,A00,897203,Pappas; Elizabeth,44,0,45,1
1745810105931,EDS 139,B00,897209,Fargason; Sharon Gayle,44,0,45,1
1745810106955,EDS 201,A00,895545,Staff,43,0,45,2
1745810107983,EDS 203,A01,895581,Halter; Christopher P.,43,0,45,2
1745810109007,EDS 204R,A01,895625,Heinzman; Erica M.,43,0,45,2
1745810109007,EDS 204R,B01,895693,Halter; Christopher P.,18,0,45,27
1745810110039,EDS 206R,A00,895694,Fargason; Sharon Gayle,9,0,30,21
1745810110039,EDS 206R,B00,895695,Choi; Bailey Miyeon,20,0,30,10
1745810111065,EDS 250,A00,895697,Hemans; Patricia Ann Benitez,43,0,45,2
1745810112093,EDS 281,A00,895701,Meyerott; Theresa Ann,15,0,15,0
1745810113121,EDS 284,A00,895736,Meyerott; Theresa Ann,15,0,15,0
1745810114152,EDS 286,A00,897210,Fine; Sarah,15,0,15,0
1745810115180,EDS 289C,A01,895770,Daly; Alan J.,15,0,15,0
1745810116207,EDS 290,A00,897211,Hofstetter; Carolyn,15,0,15,0
1745810117235,LIGM 5A,A00,896162,Fischer-Grunski; Eva K,15,0,20,5
1745810118265,LIGM 5B,A00,896260,Fischer-Grunski; Eva K,17,0,20,3
1745810119292,LIGM 5C,A00,896308,Fischer-Grunski; Eva K,18,0,20,2
1745810120321,LIIT 5AS,A00,896313,Carnelos; Chiara,18,0,20,2
1745810121347,LIIT 5BS,A00,896416,Carnelos; Chiara,20,0,20,0
1745810122373,LIIT 5CS,A00,896564,Carnelos; Chiara,20,0,20,0
1745810123403,LISP 5A,A00,896588,Munoz Sanchez; Alicia,4,0,20,16
1745810124432,LISP 5B,A00,896653,Munoz Sanchez; Alicia,10,0,20,10
1745810125459,LISP 5C,A00,896655,Munoz Sanchez; Alicia,4,0,20,16
1745810126485,MAE 197,001,957918,Kleissl; Jan,9998,0,9999,1
1745810127511,MATH 2,A01,957937,Staff,34,0,35,1
1745810128537,MATH 197,001,957876,Kedlaya; Kiran S.,9993,0,9999,6
1745810129566,MCWP 40,A00,892729,Duru; Nur,13,0,20,7
1745810129566,MCWP 40,B00,893304,Montejo; Carolina,20,0,20,0
1745810130592,MCWP 40R,A00,893757,Redela; Pamela Morgan,0,7,20,20
1745810131617,MCWP 50,A00,893758,Morshed; Michael James,2,0,20,18
1745810131617,MCWP 50,B00,893761,Bartulis; Jason Michael,17,0,20,3
1745810132648,MCWP 50R,A00,893766,Compas; Sean Matthew,0,1,20,20
1745810132648,MCWP 50R,B00,893769,Carter; Jennifer A,0,0,20,20
1745810132648,MCWP 50R,C00,893771,Krone; Jarret,0,3,20,20
1745810132648,MCWP 50R,D00,893772,Miller; Elizabeth Deen,3,0,20,17
1745810132648,MCWP 50R,E00,893775,Carter; Andrea L,0,0,20,20
1745810133674,MMW 11R,A01,892721,Herbst; Matthew,11,0,27,16
1745810133674,MMW 11R,A02,892722,Herbst; Matthew,0,0,0,3
1745810134701,MMW 12R,A01,892724,Herbst; Matthew,0,9,16,16
1745810134701,MMW 12R,A02,892725,Herbst; Matthew,0,9,16,16
1745810135731,MMW 13R,A01,892727,Staff,0,4,16,16
1745810135731,MMW 13R,A02,892728,Staff,0,4,16,16
1745810135731,MMW 13R,A03,958032,Staff,0,3,16,16
1745810135731,MMW 13R,A04,958033,Staff,0,2,16,16
1745810135731,MMW 13R,A05,958034,Staff,0,3,16,16
1745810136757,SIO 295LS,A00,894015,Staff,7,0,25,18
1745810137785,SIO 295S,A00,894020,Staff,7,0,25,18
1745810138812,SIOC 290S,B01,958918,Staff,0,0,0,0
1745810139844,SIOC 291S,B01,958922,Staff,0,0,0,0
1745810140872,SOCI 117,A01,895339,Staff,4,0,5,1
1745810141898,WES 237B,A00,894149,Staff,11,0,20,9
1745810143969,AESE 279B,A00,891859,Staff,13,0,35,22
1745810144997,AIP 197,001,891854,Staff,70,0,70,0
1745810146025,ANTH 289S,A00,891856,Gagneux; Pascal,12,0,12,0
1745810147053,BENG 196,001,957946,Engler; Adam J.,9996,0,9999,3
1745810148078,CAT 124RS,A01,956906,Staff,8,0,25,17
1745810149104,CAT 125RS,A01,922013,Staff,8,0,25,17
1745810150132,CLRE 250,A00,891860,Morris; Sheldon,9995,0,9999,4
1745810152185,CLRE 251R,A00,907817,Mehta; Ravindra L.,9994,0,9999,5
1745810153211,CLRE 252,A00,891864,Cuomo; Raphael Eduardo,9993,0,9999,6
1745810154237,CLRE 253,A00,891867,Vaida; Florin,9994,0,9999,5
1745810154237,CLRE 253,B00,907819,Staff,9999,0,9999,0
1745810155265,CLRE 259,A00,891868,Patel; Hemal,9998,0,9999,1
1745810156291,CLRE 260,A00,891872,Cuomo; Raphael Eduardo,9999,0,9999,0
1745810157317,CLRE 297,001,891888,Cuomo; Raphael Eduardo,9999,0,9999,0
1745810158346,CSE 191,A00,958773,Minnes Kemp; Mor Mia,9999,0,9999,0
1745810159374,CSS 201S,A01,892054,Mignozzetti; Umberto,30,0,30,0
1745810160406,CSS 202S,A01,892056,Mignozzetti; Umberto,30,0,30,0
1745810161435,DSC 197,001,956898,Eldridge; Justin Matthew,9998,0,9999,1
1745810162464,DSC 297,001,958000,Mazumdar; Arya,9998,0,9999,1
1745810163492,EAP 100,A00,905686,Staff,9776,0,9999,223
1745810164518,ECE 45,A01,892618,Staff,0,12,50,50
1745810165549,ECE 109,A01,892620,Staff,0,44,0,0
1745810166575,ECE 111,A01,892719,Staff,0,8,50,50
1745810167602,ECE 197,001,957920,Mercier; Patrick Philip,9992,0,9999,7
1745810168628,ECON 178,A01,907814,Zhu; Ying,28,0,35,7
1745810169656,EDS 115,A00,895312,Staff,41,0,45,4
1745810170682,EDS 117,A01,895337,Staff,30,0,30,0
1745810171710,EDS 125,A00,895341,Jones; Gabrielle Anastasia,43,0,45,2
1745810172739,EDS 128A,A01,895459,Fargason; Sharon Gayle,44,0,45,1
1745810173766,EDS 128B,A01,895543,Pappas; Elizabeth,44,0,45,1
1745810174794,EDS 139,A00,897203,Pappas; Elizabeth,44,0,45,1
1745810174794,EDS 139,B00,897209,Fargason; Sharon Gayle,44,0,45,1
1745810175822,EDS 201,A00,895545,Staff,43,0,45,2
1745810176852,EDS 203,A01,895581,Halter; Christopher P.,43,0,45,2
1745810177879,EDS 204R,A01,895625,Heinzman; Erica M.,43,0,45,2
1745810177879,EDS 204R,B01,895693,Halter; Christopher P.,18,0,45,27
1745810178906,EDS 206R,A00,895694,Fargason; Sharon Gayle,9,0,30,21
1745810178906,EDS 206R,B00,895695,Choi; Bailey Miyeon,20,0,30,10
1745810179935,EDS 250,A00,895697,Hemans; Patricia Ann Benitez,43,0,45,2
1745810180962,EDS 281,A00,895701,Meyerott; Theresa Ann,15,0,15,0
1745810181991,EDS 284,A00,895736,Meyerott; Theresa Ann,15,0,15,0
1745810183016,EDS 286,A00,897210,Fine; Sarah,15,0,15,0
1745810184042,EDS 289C,A01,895770,Daly; Alan J.,15,0,15,0
1745810185071,EDS 290,A00,897211,Hofstetter; Carolyn,15,0,15,0
1745810186099,LIGM 5A,A00,896162,Fischer-Grunski; Eva K,15,0,20,5
1745810187129,LIGM 5B,A00,896260,Fischer-Grunski; Eva K,17,0,20,3
1745810188154,LIGM 5C,A00,896308,Fischer-Grunski; Eva K,18,0,20,2
1745810189185,LIIT 5AS,A00,896313,Carnelos; Chiara,18,0,20,2
1745810190216,LIIT 5BS,A00,896416,Carnelos; Chiara,20,0,20,0
1745810191245,LIIT 5CS,A00,896564,Carnelos; Chiara,20,0,20,0
1745810192271,LISP 5A,A00,896588,Munoz Sanchez; Alicia,4,0,20,16
1745810193299,LISP 5B,A00,896653,Munoz Sanchez; Alicia,10,0,20,10
1745810194328,LISP 5C,A00,896655,Munoz Sanchez; Alicia,4,0,20,16
1745810195355,MAE 197,001,957918,Kleissl; Jan,9998,0,9999,1
1745810196381,MATH 2,A01,957937,Staff,34,0,35,1
1745810197426,MATH 197,001,957876,Kedlaya; Kiran S.,9993,0,9999,6
1745810198451,MCWP 40,A00,892729,Duru; Nur,13,0,20,7
1745810198451,MCWP 40,B00,893304,Montejo; Carolina,20,0,20,0
1745810199479,MCWP 40R,A00,893757,Redela; Pamela Morgan,0,7,20,20
1745810200505,MCWP 50,A00,893758,Morshed; Michael James,2,0,20,18
1745810200505,MCWP 50,B00,893761,Bartulis; Jason Michael,17,0,20,3
1745810201533,MCWP 50R,A00,893766,Compas; Sean Matthew,0,1,20,20
1745810201533,MCWP 50R,B00,893769,Carter; Jennifer A,0,0,20,20
1745810201533,MCWP 50R,C00,893771,Krone; Jarret,0,3,20,20
1745810201533,MCWP 50R,D00,893772,Miller; Elizabeth Deen,3,0,20,17
1745810201533,MCWP 50R,E00,893775,Carter; Andrea L,0,0,20,20
1745810202561,MMW 11R,A01,892721,Herbst; Matthew,11,0,27,16
1745810202561,MMW 11R,A02,892722,Herbst; Matthew,0,0,0,3
1745810203584,MMW 12R,A01,892724,Herbst; Matthew,0,9,16,16
1745810203584,MMW 12R,A02,892725,Herbst; Matthew,0,9,16,16
1745810204609,MMW 13R,A01,892727,Staff,0,4,16,16
1745810204609,MMW 13R,A02,892728,Staff,0,4,16,16
1745810204609,MMW 13R,A03,958032,Staff,0,3,16,16
1745810204609,MMW 13R,A04,958033,Staff,0,2,16,16
1745810204609,MMW 13R,A05,958034,Staff,0,3,16,16
1745810205634,SIO 295LS,A00,894015,Staff,7,0,25,18
1745810206661,SIO 295S,A00,894020,Staff,7,0,25,18
1745810207687,SIOC 290S,B01,958918,Staff,0,0,0,0
1745810208715,SIOC 291S,B01,958922,Staff,0,0,0,0
1745810209739,SOCI 117,A01,895339,Staff,4,0,5,1
1745810210765,WES 237B,A00,894149,Staff,11,0,20,9
1745810212825,AESE 279B,A00,891859,Staff,13,0,35,22
1745810213849,AIP 197,001,891854,Staff,70,0,70,0
1745810214917,ANTH 289S,A00,891856,Gagneux; Pascal,12,0,12,0
1745810215942,BENG 196,001,957946,Engler; Adam J.,9996,0,9999,3
1745810216968,CAT 124RS,A01,956906,Staff,8,0,25,17
1745810217995,CAT 125RS,A01,922013,Staff,8,0,25,17
1745810219024,CLRE 250,A00,891860,Morris; Sheldon,9995,0,9999,4
1745810221080,CLRE 251R,A00,907817,Mehta; Ravindra L.,9994,0,9999,5
1745810222108,CLRE 252,A00,891864,Cuomo; Raphael Eduardo,9993,0,9999,6
1745810223135,CLRE 253,A00,891867,Vaida; Florin,9994,0,9999,5
1745810223135,CLRE 253,B00,907819,Staff,9999,0,9999,0
1745810224161,CLRE 259,A00,891868,Patel; Hemal,9998,0,9999,1
1745810225190,CLRE 260,A00,891872,Cuomo; Raphael Eduardo,9999,0,9999,0
1745810226217,CLRE 297,001,891888,Cuomo; Raphael Eduardo,9999,0,9999,0
1745810227244,CSE 191,A00,958773,Minnes Kemp; Mor Mia,9999,0,9999,0
1745810228275,CSS 201S,A01,892054,Mignozzetti; Umberto,30,0,30,0
1745810229302,CSS 202S,A01,892056,Mignozzetti; Umberto,30,0,30,0
1745810230330,DSC 197,001,956898,Eldridge; Justin Matthew,9998,0,9999,1
1745810231354,DSC 297,001,958000,Mazumdar; Arya,9998,0,9999,1
1745810232395,EAP 100,A00,905686,Staff,9776,0,9999,223
1745810233422,ECE 45,A01,892618,Staff,0,12,50,50
1745810234447,ECE 109,A01,892620,Staff,0,44,0,0
1745810235474,ECE 111,A01,892719,Staff,0,8,50,50
1745810236514,ECE 197,001,957920,Mercier; Patrick Philip,9992,0,9999,7
1745810237541,ECON 178,A01,907814,Zhu; Ying,28,0,35,7
1745810238565,EDS 115,A00,895312,Staff,41,0,45,4
1745810239592,EDS 117,A01,895337,Staff,30,0,30,0
1745810240622,EDS 125,A00,895341,Jones; Gabrielle Anastasia,43,0,45,2
1745810241647,EDS 128A,A01,895459,Fargason; Sharon Gayle,44,0,45,1
1745810242670,EDS 128B,A01,895543,Pappas; Elizabeth,44,0,45,1
1745810243695,EDS 139,A00,897203,Pappas; Elizabeth,44,0,45,1
1745810243695,EDS 139,B00,897209,Fargason; Sharon Gayle,44,0,45,1
1745810244719,EDS 201,A00,895545,Staff,43,0,45,2
1745810245746,EDS 203,A01,895581,Halter; Christopher P.,43,0,45,2
1745810246770,EDS 204R,A01,895625,Heinzman; Erica M.,43,0,45,2
1745810246770,EDS 204R,B01,895693,Halter; Christopher P.,18,0,45,27
1745810247799,EDS 206R,A00,895694,Fargason; Sharon Gayle,9,0,30,21
1745810247799,EDS 206R,B00,895695,Choi; Bailey Miyeon,20,0,30,10
1745810248825,EDS 250,A00,895697,Hemans; Patricia Ann Benitez,43,0,45,2
1745810249854,EDS 281,A00,895701,Meyerott; Theresa Ann,15,0,15,0
1745810250881,EDS 284,A00,895736,Meyerott; Theresa Ann,15,0,15,0
1745810251908,EDS 286,A00,897210,Fine; Sarah,15,0,15,0
1745810252934,EDS 289C,A01,895770,Daly; Alan J.,15,0,15,0
1745810253961,EDS 290,A00,897211,Hofstetter; Carolyn,15,0,15,0
1745810254987,LIGM 5A,A00,896162,Fischer-Grunski; Eva K,15,0,20,5
1745810256013,LIGM 5B,A00,896260,Fischer-Grunski; Eva K,17,0,20,3
1745810257045,LIGM 5C,A00,896308,Fischer-Grunski; Eva K,18,0,20,2
1745810258070,LIIT 5AS,A00,896313,Carnelos; Chiara,18,0,20,2
1745810259098,LIIT 5BS,A00,896416,Carnelos; Chiara,20,0,20,0
1745810260127,LIIT 5CS,A00,896564,Carnelos; Chiara,20,0,20,0
1745810261153,LISP 5A,A00,896588,Munoz Sanchez; Alicia,4,0,20,16
1745810262184,LISP 5B,A00,896653,Munoz Sanchez; Alicia,10,0,20,10
1745810263210,LISP 5C,A00,896655,Munoz Sanchez; Alicia,4,0,20,16
1745810264236,MAE 197,001,957918,Kleissl; Jan,9998,0,9999,1
1745810265264,MATH 2,A01,957937,Staff,34,0,35,1
1745810266291,MATH 197,001,957876,Kedlaya; Kiran S.,9993,0,9999,6
1745810267317,MCWP 40,A00,892729,Duru; Nur,13,0,20,7
1745810267317,MCWP 40,B00,893304,Montejo; Carolina,20,0,20,0
1745810268344,MCWP 40R,A00,893757,Redela; Pamela Morgan,0,7,20,20
1745810269373,MCWP 50,A00,893758,Morshed; Michael James,2,0,20,18
1745810269373,MCWP 50,B00,893761,Bartulis; Jason Michael,17,0,20,3
1745810270400,MCWP 50R,A00,893766,Compas; Sean Matthew,0,1,20,20
1745810270400,MCWP 50R,B00,893769,Carter; Jennifer A,0,0,20,20
1745810270400,MCWP 50R,C00,893771,Krone; Jarret,0,3,20,20
1745810270400,MCWP 50R,D00,893772,Miller; Elizabeth Deen,3,0,20,17
1745810270400,MCWP 50R,E00,893775,Carter; Andrea L,0,0,20,20
1745810271429,MMW 11R,A01,892721,Herbst; Matthew,11,0,27,16
1745810271429,MMW 11R,A02,892722,Herbst; Matthew,0,0,0,3
1745810272454,MMW 12R,A01,892724,Herbst; Matthew,0,9,16,16
1745810272454,MMW 12R,A02,892725,Herbst; Matthew,0,9,16,16
1745810273482,MMW 13R,A01,892727,Staff,0,4,16,16
1745810273482,MMW 13R,A02,892728,Staff,0,4,16,16
1745810273482,MMW 13R,A03,958032,Staff,0,3,16,16
1745810273482,MMW 13R,A04,958033,Staff,0,2,16,16
1745810273482,MMW 13R,A05,958034,Staff,0,3,16,16
1745810274509,SIO 295LS,A00,894015,Staff,7,0,25,18
1745810275536,SIO 295S,A00,894020,Staff,7,0,25,18
1745810276568,SIOC 290S,B01,958918,Staff,0,0,0,0
1745810277597,SIOC 291S,B01,958922,Staff,0,0,0,0
1745810278622,SOCI 117,A01,895339,Staff,4,0,5,1
1745810279650,WES 237B,A00,894149,Staff,11,0,20,9
1745810281715,AESE 279B,A00,891859,Staff,13,0,35,22
1745810282740,AIP 197,001,891854,Staff,70,0,70,0
1745810283768,ANTH 289S,A00,891856,Gagneux; Pascal,12,0,12,0
1745810284795,BENG 196,001,957946,Engler; Adam J.,9996,0,9999,3
1745810285820,CAT 124RS,A01,956906,Staff,8,0,25,17
1745810286847,CAT 125RS,A01,922013,Staff,8,0,25,17
1745810287873,CLRE 250,A00,891860,Morris; Sheldon,9995,0,9999,4
1745810289929,CLRE 251R,A00,907817,Mehta; Ravindra L.,9994,0,9999,5
1745810290956,CLRE 252,A00,891864,Cuomo; Raphael Eduardo,9993,0,9999,6
1745810291983,CLRE 253,A00,891867,Vaida; Florin,9994,0,9999,5
1745810291983,CLRE 253,B00,907819,Staff,9999,0,9999,0
1745810293012,CLRE 259,A00,891868,Patel; Hemal,9998,0,9999,1
1745810294040,CLRE 260,A00,891872,Cuomo; Raphael Eduardo,9999,0,9999,0
1745810295068,CLRE 297,001,891888,Cuomo; Raphael Eduardo,9999,0,9999,0
1745810296094,CSE 191,A00,958773,Minnes Kemp; Mor Mia,9999,0,9999,0
1745810297120,CSS 201S,A01,892054,Mignozzetti; Umberto,30,0,30,0
1745810298148,CSS 202S,A01,892056,Mignozzetti; Umberto,30,0,30,0
1745810299178,DSC 197,001,956898,Eldridge; Justin Matthew,9998,0,9999,1
1745810300225,DSC 297,001,958000,Mazumdar; Arya,9998,0,9999,1
1745810301253,EAP 100,A00,905686,Staff,9776,0,9999,223
1745810302280,ECE 45,A01,892618,Staff,0,12,50,50
1745810303308,ECE 109,A01,892620,Staff,0,44,0,0
1745810304337,ECE 111,A01,892719,Staff,0,8,50,50
1745810305361,ECE 197,001,957920,Mercier; Patrick Philip,9992,0,9999,7
1745810306387,ECON 178,A01,907814,Zhu; Ying,28,0,35,7
1745810307415,EDS 115,A00,895312,Staff,41,0,45,4
1745810308441,EDS 117,A01,895337,Staff,30,0,30,0
1745810309467,EDS 125,A00,895341,Jones; Gabrielle Anastasia,43,0,45,2
1745810310492,EDS 128A,A01,895459,Fargason; Sharon Gayle,44,0,45,1
1745810311517,EDS 128B,A01,895543,Pappas; Elizabeth,44,0,45,1
1745810312544,EDS 139,A00,897203,Pappas; Elizabeth,44,0,45,1
1745810312544,EDS 139,B00,897209,Fargason; Sharon Gayle,44,0,45,1
1745810313569,EDS 201,A00,895545,Staff,43,0,45,2
1745810314594,EDS 203,A01,895581,Halter; Christopher P.,43,0,45,2
1745810315622,EDS 204R,A01,895625,Heinzman; Erica M.,43,0,45,2
1745810315622,EDS 204R,B01,895693,Halter; Christopher P.,18,0,45,27
1745810316647,EDS 206R,A00,895694,Fargason; Sharon Gayle,9,0,30,21
1745810316647,EDS 206R,B00,895695,Choi; Bailey Miyeon,20,0,30,10
1745810317671,EDS 250,A00,895697,Hemans; Patricia Ann Benitez,43,0,45,2
1745810318695,EDS 281,A00,895701,Meyerott; Theresa Ann,15,0,15,0
1745810319721,EDS 284,A00,895736,Meyerott; Theresa Ann,15,0,15,0
1745810320747,EDS 286,A00,897210,Fine; Sarah,15,0,15,0
1745810321773,EDS 289C,A01,895770,Daly; Alan J.,15,0,15,0
1745810322801,EDS 290,A00,897211,Hofstetter; Carolyn,15,0,15,0
1745810323827,LIGM 5A,A00,896162,Fischer-Grunski; Eva K,15,0,20,5
1745810324856,LIGM 5B,A00,896260,Fischer-Grunski; Eva K,17,0,20,3
1745810325886,LIGM 5C,A00,896308,Fischer-Grunski; Eva K,18,0,20,2
1745810326916,LIIT 5AS,A00,896313,Carnelos; Chiara,18,0,20,2
1745810327941,LIIT 5BS,A00,896416,Carnelos; Chiara,20,0,20,0
1745810328971,LIIT 5CS,A00,896564,Carnelos; Chiara,20,0,20,0
1745810330001,LISP 5A,A00,896588,Munoz Sanchez; Alicia,4,0,20,16
1745810331032,LISP 5B,A00,896653,Munoz Sanchez; Alicia,10,0,20,10
1745810332061,LISP 5C,A00,896655,Munoz Sanchez; Alicia,4,0,20,16
1745810333086,MAE 197,001,957918,Kleissl; Jan,9998,0,9999,1
1745810334110,MATH 2,A01,957937,Staff,34,0,35,1
1745810335136,MATH 197,001,957876,Kedlaya; Kiran S.,9993,0,9999,6
1745810336178,MCWP 40,A00,892729,Duru; Nur,13,0,20,7
1745810336178,MCWP 40,B00,893304,Montejo; Carolina,20,0,20,0
1745810337203,MCWP 40R,A00,893757,Redela; Pamela Morgan,0,7,20,20
1745810338231,MCWP 50,A00,893758,Morshed; Michael James,2,0,20,18
1745810338231,MCWP 50,B00,893761,Bartulis; Jason Michael,17,0,20,3
1745810339258,MCWP 50R,A00,893766,Compas; Sean Matthew,0,1,20,20
1745810339258,MCWP 50R,B00,893769,Carter; Jennifer A,0,0,20,20
1745810339258,MCWP 50R,C00,893771,Krone; Jarret,0,3,20,20
1745810339258,MCWP 50R,D00,893772,Miller; Elizabeth Deen,3,0,20,17
1745810339258,MCWP 50R,E00,893775,Carter; Andrea L,0,0,20,20
1745810340288,MMW 11R,A01,892721,Herbst; Matthew,11,0,27,16
1745810340288,MMW 11R,A02,892722,Herbst; Matthew,0,0,0,3
1745810341314,MMW 12R,A01,892724,Herbst; Matthew,0,9,16,16
1745810341314,MMW 12R,A02,892725,Herbst; Matthew,0,9,16,16
1745810342341,MMW 13R,A01,892727,Staff,0,4,16,16
1745810342341,MMW 13R,A02,892728,Staff,0,4,16,16
1745810342341,MMW 13R,A03,958032,Staff,0,3,16,16
1745810342341,MMW 13R,A04,958033,Staff,0,2,16,16
1745810342341,MMW 13R,A05,958034,Staff,0,3,16,16
1745810343369,SIO 295LS,A00,894015,Staff,7,0,25,18
1745810344394,SIO 295S,A00,894020,Staff,7,0,25,18
1745810345425,SIOC 290S,B01,958918,Staff,0,0,0,0
1745810346453,SIOC 291S,B01,958922,Staff,0,0,0,0
1745810347477,SOCI 117,A01,895339,Staff,4,0,5,1
1745810348507,WES 237B,A00,894149,Staff,11,0,20,9
1745810350569,AESE 279B,A00,891859,Staff,13,0,35,22
1745810351596,AIP 197,001,891854,Staff,70,0,70,0
1745810352623,ANTH 289S,A00,891856,Gagneux; Pascal,12,0,12,0
1745810353650,BENG 196,001,957946,Engler; Adam J.,9996,0,9999,3
1745810354676,CAT 124RS,A01,956906,Staff,8,0,25,17
1745810355699,CAT 125RS,A01,922013,Staff,8,0,25,17
1745810356729,CLRE 250,A00,891860,Morris; Sheldon,9995,0,9999,4
1745810358783,CLRE 251R,A00,907817,Mehta; Ravindra L.,9994,0,9999,5
1745810359807,CLRE 252,A00,891864,Cuomo; Raphael Eduardo,9993,0,9999,6
1745810360834,CLRE 253,A00,891867,Vaida; Florin,9994,0,9999,5
1745810360834,CLRE 253,B00,907819,Staff,9999,0,9999,0
1745810361864,CLRE 259,A00,891868,Patel; Hemal,9998,0,9999,1
1745810362891,CLRE 260,A00,891872,Cuomo; Raphael Eduardo,9999,0,9999,0
1745810363917,CLRE 297,001,891888,Cuomo; Raphael Eduardo,9999,0,9999,0
1745810364943,CSE 191,A00,958773,Minnes Kemp; Mor Mia,9999,0,9999,0
1745810365979,CSS 201S,A01,892054,Mignozzetti; Umberto,30,0,30,0
1745810367005,CSS 202S,A01,892056,Mignozzetti; Umberto,30,0,30,0
1745810368089,DSC 197,001,956898,Eldridge; Justin Matthew,9998,0,9999,1
1745810369116,DSC 297,001,958000,Mazumdar; Arya,9998,0,9999,1
1745810370143,EAP 100,A00,905686,Staff,9776,0,9999,223
1745810371167,ECE 45,A01,892618,Staff,0,12,50,50
1745810372194,ECE 109,A01,892620,Staff,0,44,0,0
1745810373223,ECE 111,A01,892719,Staff,0,8,50,50
1745810374250,ECE 197,001,957920,Mercier; Patrick Philip,9992,0,9999,7
1745810375280,ECON 178,A01,907814,Zhu; Ying,28,0,35,7
1745810376308,EDS 115,A00,895312,Staff,41,0,45,4
1745810377337,EDS 117,A01,895337,Staff,30,0,30,0
1745810378367,EDS 125,A00,895341,Jones; Gabrielle Anastasia,43,0,45,2
1745810379395,EDS 128A,A01,895459,Fargason; Sharon Gayle,44,0,45,1
1745810380422,EDS 128B,A01,895543,Pappas; Elizabeth,44,0,45,1
1745810381447,EDS 139,A00,897203,Pappas; Elizabeth,44,0,45,1
1745810381447,EDS 139,B00,897209,Fargason; Sharon Gayle,44,0,45,1
1745810382473,EDS 201,A00,895545,Staff,43,0,45,2
1745810383501,EDS 203,A01,895581,Halter; Christopher P.,43,0,45,2
1745810384530,EDS 204R,A01,895625,Heinzman; Erica M.,43,0,45,2
1745810384530,EDS 204R,B01,895693,Halter; Christopher P.,18,0,45,27
1745810385560,EDS 206R,A00,895694,Fargason; Sharon Gayle,9,0,30,21
1745810385560,EDS 206R,B00,895695,Choi; Bailey Miyeon,20,0,30,10
1745810386585,EDS 250,A00,895697,Hemans; Patricia Ann Benitez,43,0,45,2
1745810387612,EDS 281,A00,895701,Meyerott; Theresa Ann,15,0,15,0
1745810388641,EDS 284,A00,895736,Meyerott; Theresa Ann,15,0,15,0
1745810389665,EDS 286,A00,897210,Fine; Sarah,15,0,15,0
1745810390693,EDS 289C,A01,895770,Daly; Alan J.,15,0,15,0
1745810391720,EDS 290,A00,897211,Hofstetter; Carolyn,15,0,15,0
1745810392746,LIGM 5A,A00,896162,Fischer-Grunski; Eva K,15,0,20,5
1745810393772,LIGM 5B,A00,896260,Fischer-Grunski; Eva K,17,0,20,3
1745810394802,LIGM 5C,A00,896308,Fischer-Grunski; Eva K,18,0,20,2
1745810395833,LIIT 5AS,A00,896313,Carnelos; Chiara,18,0,20,2
1745810396859,LIIT 5BS,A00,896416,Carnelos; Chiara,20,0,20,0
1745810397884,LIIT 5CS,A00,896564,Carnelos; Chiara,20,0,20,0
1745810398915,LISP 5A,A00,896588,Munoz Sanchez; Alicia,4,0,20,16
1745810399944,LISP 5B,A00,896653,Munoz Sanchez; Alicia,10,0,20,10
1745810400971,LISP 5C,A00,896655,Munoz Sanchez; Alicia,4,0,20,16
1745810401999,MAE 197,001,957918,Kleissl; Jan,9998,0,9999,1
1745810403024,MATH 2,A01,957937,Staff,34,0,35,1
1745810404054,MATH 197,001,957876,Kedlaya; Kiran S.,9993,0,9999,6
1745810405080,MCWP 40,A00,892729,Duru; Nur,13,0,20,7
1745810405080,MCWP 40,B00,893304,Montejo; Carolina,20,0,20,0
1745810406105,MCWP 40R,A00,893757,Redela; Pamela Morgan,0,7,20,20
1745810407135,MCWP 50,A00,893758,Morshed; Michael James,2,0,20,18
1745810407135,MCWP 50,B00,893761,Bartulis; Jason Michael,17,0,20,3
1745810408162,MCWP 50R,A00,893766,Compas; Sean Matthew,0,1,20,20
1745810408162,MCWP 50R,B00,893769,Carter; Jennifer A,0,0,20,20
1745810408162,MCWP 50R,C00,893771,Krone; Jarret,0,3,20,20
1745810408162,MCWP 50R,D00,893772,Miller; Elizabeth Deen,3,0,20,17
1745810408162,MCWP 50R,E00,893775,Carter; Andrea L,0,0,20,20
1745810409188,MMW 11R,A01,892721,Herbst; Matthew,11,0,27,16
1745810409188,MMW 11R,A02,892722,Herbst; Matthew,0,0,0,3
1745810410217,MMW 12R,A01,892724,Herbst; Matthew,0,9,16,16
1745810410217,MMW 12R,A02,892725,Herbst; Matthew,0,9,16,16
1745810411243,MMW 13R,A01,892727,Staff,0,4,16,16
1745810411243,MMW 13R,A02,892728,Staff,0,4,16,16
1745810411243,MMW 13R,A03,958032,Staff,0,3,16,16
1745810411243,MMW 13R,A04,958033,Staff,0,2,16,16
1745810411243,MMW 13R,A05,958034,Staff,0,3,16,16
1745810412271,SIO 295LS,A00,894015,Staff,7,0,25,18
1745810413297,SIO 295S,A00,894020,Staff,7,0,25,18
1745810414327,SIOC 290S,B01,958918,Staff,0,0,0,0
1745810415356,SIOC 291S,B01,958922,Staff,0,0,0,0
1745810416384,SOCI 117,A01,895339,Staff,4,0,5,1
1745810417412,WES 237B,A00,894149,Staff,11,0,20,9
1745810419482,AESE 279B,A00,891859,Staff,13,0,35,22
1745810420508,AIP 197,001,891854,Staff,70,0,70,0
1745810421537,ANTH 289S,A00,891856,Gagneux; Pascal,12,0,12,0
1745810422563,BENG 196,001,957946,Engler; Adam J.,9996,0,9999,3
1745810423589,CAT 124RS,A01,956906,Staff,8,0,25,17
1745810424615,CAT 125RS,A01,922013,Staff,8,0,25,17
1745810425641,CLRE 250,A00,891860,Morris; Sheldon,9995,0,9999,4
1745810427698,CLRE 251R,A00,907817,Mehta; Ravindra L.,9994,0,9999,5
1745810428723,CLRE 252,A00,891864,Cuomo; Raphael Eduardo,9993,0,9999,6
1745810429747,CLRE 253,A00,891867,Vaida; Florin,9994,0,9999,5
1745810429747,CLRE 253,B00,907819,Staff,9999,0,9999,0
1745810430776,CLRE 259,A00,891868,Patel; Hemal,9998,0,9999,1
1745810431800,CLRE 260,A00,891872,Cuomo; Raphael Eduardo,9999,0,9999,0
1745810432825,CLRE 297,001,891888,Cuomo; Raphael Eduardo,9999,0,9999,0
1745810433855,CSE 191,A00,958773,Minnes Kemp; Mor Mia,9999,0,9999,0
1745810434883,CSS 201S,A01,892054,Mignozzetti; Umberto,30,0,30,0
1745810435907,CSS 202S,A01,892056,Mignozzetti; Umberto,30,0,30,0
1745810436936,DSC 197,001,956898,Eldridge; Justin Matthew,9998,0,9999,1
1745810437962,DSC 297,001,958000,Mazumdar; Arya,9998,0,9999,1
1745810438989,EAP 100,A00,905686,Staff,9776,0,9999,223
1745810440014,ECE 45,A01,892618,Staff,0,12,50,50
1745810441043,ECE 109,A01,892620,Staff,0,44,0,0
1745810442071,ECE 111,A01,892719,Staff,0,8,50,50
1745810443095,ECE 197,001,957920,Mercier; Patrick Philip,9992,0,9999,7
1745810444124,ECON 178,A01,907814,Zhu; Ying,28,0,35,7
1745810445149,EDS 115,A00,895312,Staff,41,0,45,4
1745810446176,EDS 117,A01,895337,Staff,30,0,30,0
1745810447201,EDS 125,A00,895341,Jones; Gabrielle Anastasia,43,0,45,2
1745810448235,EDS 128A,A01,895459,Fargason; Sharon Gayle,44,0,45,1
1745810449264,EDS 128B,A01,895543,Pappas; Elizabeth,44,0,45,1
1745810450299,EDS 139,A00,897203,Pappas; Elizabeth,44,0,45,1
1745810450299,EDS 139,B00,897209,Fargason; Sharon Gayle,44,0,45,1
1745810451327,EDS 201,A00,895545,Staff,43,0,45,2
1745810452353,EDS 203,A01,895581,Halter; Christopher P.,43,0,45,2
1745810453408,EDS 204R,A01,895625,Heinzman; Erica M.,43,0,45,2
1745810453408,EDS 204R,B01,895693,Halter; Christopher P.,18,0,45,27
1745810454438,EDS 206R,A00,895694,Fargason; Sharon Gayle,9,0,30,21
1745810454438,EDS 206R,B00,895695,Choi; Bailey Miyeon,20,0,30,10
1745810455464,EDS 250,A00,895697,Hemans; Patricia Ann Benitez,43,0,45,2
1745810456488,EDS 281,A00,895701,Meyerott; Theresa Ann,15,0,15,0
1745810457513,EDS 284,A00,895736,Meyerott; Theresa Ann,15,0,15,0
1745810458537,EDS 286,A00,897210,Fine; Sarah,15,0,15,0
1745810459563,EDS 289C,A01,895770,Daly; Alan J.,15,0,15,0
1745810460590,EDS 290,A00,897211,Hofstetter; Carolyn,15,0,15,0
1745810461616,LIGM 5A,A00,896162,Fischer-Grunski; Eva K,15,0,20,5
1745810462644,LIGM 5B,A00,896260,Fischer-Grunski; Eva K,17,0,20,3
1745810463669,LIGM 5C,A00,896308,Fischer-Grunski; Eva K,18,0,20,2
1745810464694,LIIT 5AS,A00,896313,Carnelos; Chiara,18,0,20,2
1745810465722,LIIT 5BS,A00,896416,Carnelos; Chiara,20,0,20,0
1745810466747,LIIT 5CS,A00,896564,Carnelos; Chiara,20,0,20,0
1745810467773,LISP 5A,A00,896588,Munoz Sanchez; Alicia,4,0,20,16
1745810468803,LISP 5B,A00,896653,Munoz Sanchez; Alicia,10,0,20,10
1745810469831,LISP 5C,A00,896655,Munoz Sanchez; Alicia,4,0,20,16
1745810470858,MAE 197,001,957918,Kleissl; Jan,9998,0,9999,1
1745810471884,MATH 2,A01,957937,Staff,34,0,35,1
1745810472914,MATH 197,001,957876,Kedlaya; Kiran S.,9993,0,9999,6
1745810473940,MCWP 40,A00,892729,Duru; Nur,13,0,20,7
1745810473940,MCWP 40,B00,893304,Montejo; Carolina,20,0,20,0
1745810474968,MCWP 40R,A00,893757,Redela; Pamela Morgan,0,7,20,20
1745810475994,MCWP 50,A00,893758,Morshed; Michael James,2,0,20,18
1745810475994,MCWP 50,B00,893761,Bartulis; Jason Michael,17,0,20,3
1745810477023,MCWP 50R,A00,893766,Compas; Sean Matthew,0,1,20,20
1745810477023,MCWP 50R,B00,893769,Carter; Jennifer A,0,0,20,20
1745810477023,MCWP 50R,C00,893771,Krone; Jarret,0,3,20,20
1745810477023,MCWP 50R,D00,893772,Miller; Elizabeth Deen,3,0,20,17
1745810477023,MCWP 50R,E00,893775,Carter; Andrea L,0,0,20,20
1745810478051,MMW 11R,A01,892721,Herbst; Matthew,11,0,27,16
1745810478051,MMW 11R,A02,892722,Herbst; Matthew,0,0,0,3
1745810479076,MMW 12R,A01,892724,Herbst; Matthew,0,9,16,16
1745810479076,MMW 12R,A02,892725,Herbst; Matthew,0,9,16,16
1745810480104,MMW 13R,A01,892727,Staff,0,4,16,16
1745810480104,MMW 13R,A02,892728,Staff,0,4,16,16
1745810480104,MMW 13R,A03,958032,Staff,0,3,16,16
1745810480104,MMW 13R,A04,958033,Staff,0,2,16,16
1745810480104,MMW 13R,A05,958034,Staff,0,3,16,16
1745810481132,SIO 295LS,A00,894015,Staff,7,0,25,18
1745810482160,SIO 295S,A00,894020,Staff,7,0,25,18
1745810483187,SIOC 290S,B01,958918,Staff,0,0,0,0
1745810484217,SIOC 291S,B01,958922,Staff,0,0,0,0
1745810485243,SOCI 117,A01,895339,Staff,4,0,5,1
1745810486270,WES 237B,A00,894149,Staff,11,0,20,9
1745810488340,AESE 279B,A00,891859,Staff,13,0,35,22
1745810489367,AIP 197,001,891854,Staff,70,0,70,0
1745810490393,ANTH 289S,A00,891856,Gagneux; Pascal,12,0,12,0
1745810491418,BENG 196,001,957946,Engler; Adam J.,9996,0,9999,3
1745810492447,CAT 124RS,A01,956906,Staff,8,0,25,17
1745810493475,CAT 125RS,A01,922013,Staff,8,0,25,17
1745810494504,CLRE 250,A00,891860,Morris; Sheldon,9995,0,9999,4
1745810496553,CLRE 251R,A00,907817,Mehta; Ravindra L.,9994,0,9999,5
1745810497577,CLRE 252,A00,891864,Cuomo; Raphael Eduardo,9993,0,9999,6
1745810498603,CLRE 253,A00,891867,Vaida; Florin,9994,0,9999,5
1745810498603,CLRE 253,B00,907819,Staff,9999,0,9999,0
1745810499629,CLRE 259,A00,891868,Patel; Hemal,9998,0,9999,1
1745810500654,CLRE 260,A00,891872,Cuomo; Raphael Eduardo,9999,0,9999,0
1745810501678,CLRE 297,001,891888,Cuomo; Raphael Eduardo,9999,0,9999,0
1745810502706,CSE 191,A00,958773,Minnes Kemp; Mor Mia,9999,0,9999,0
1745810503733,CSS 201S,A01,892054,Mignozzetti; Umberto,30,0,30,0
1745810504759,CSS 202S,A01,892056,Mignozzetti; Umberto,30,0,30,0
1745810505786,DSC 197,001,956898,Eldridge; Justin Matthew,9998,0,9999,1
1745810506815,DSC 297,001,958000,Mazumdar; Arya,9998,0,9999,1
1745810507845,EAP 100,A00,905686,Staff,9776,0,9999,223
1745810508872,ECE 45,A01,892618,Staff,0,12,50,50
1745810509900,ECE 109,A01,892620,Staff,0,44,0,0
1745810510925,ECE 111,A01,892719,Staff,0,8,50,50
1745810511955,ECE 197,001,957920,Mercier; Patrick Philip,9992,0,9999,7
1745810512983,ECON 178,A01,907814,Zhu; Ying,28,0,35,7
1745810514008,EDS 115,A00,895312,Staff,41,0,45,4
1745810515035,EDS 117,A01,895337,Staff,30,0,30,0
1745810516064,EDS 125,A00,895341,Jones; Gabrielle Anastasia,43,0,45,2
1745810517089,EDS 128A,A01,895459,Fargason; Sharon Gayle,44,0,45,1
1745810518117,EDS 128B,A01,895543,Pappas; Elizabeth,44,0,45,1
1745810519145,EDS 139,A00,897203,Pappas; Elizabeth,44,0,45,1
1745810519145,EDS 139,B00,897209,Fargason; Sharon Gayle,44,0,45,1
1745810520173,EDS 201,A00,895545,Staff,43,0,45,2
1745810521199,EDS 203,A01,895581,Halter; Christopher P.,43,0,45,2
1745810522232,EDS 204R,A01,895625,Heinzman; Erica M.,43,0,45,2
1745810522232,EDS 204R,B01,895693,Halter; Christopher P.,18,0,45,27
1745810523264,EDS 206R,A00,895694,Fargason; Sharon Gayle,9,0,30,21
1745810523264,EDS 206R,B00,895695,Choi; Bailey Miyeon,20,0,30,10
1745810524289,EDS 250,A00,895697,Hemans; Patricia Ann Benitez,43,0,45,2
1745810525315,EDS 281,A00,895701,Meyerott; Theresa Ann,15,0,15,0
1745810526340,EDS 284,A00,895736,Meyerott; Theresa Ann,15,0,15,0
1745810527368,EDS 286,A00,897210,Fine; Sarah,15,0,15,0
1745810528395,EDS 289C,A01,895770,Daly; Alan J.,15,0,15,0
1745810529424,EDS 290,A00,897211,Hofstetter; Carolyn,15,0,15,0
1745810530450,LIGM 5A,A00,896162,Fischer-Grunski; Eva K,15,0,20,5
1745810531479,LIGM 5B,A00,896260,Fischer-Grunski; Eva K,17,0,20,3
1745810532505,LIGM 5C,A00,896308,Fischer-Grunski; Eva K,18,0,20,2
1745810533534,LIIT 5AS,A00,896313,Carnelos; Chiara,18,0,20,2
1745810534592,LIIT 5BS,A00,896416,Carnelos; Chiara,20,0,20,0
1745810535622,LIIT 5CS,A00,896564,Carnelos; Chiara,20,0,20,0
1745810536648,LISP 5A,A00,896588,Munoz Sanchez; Alicia,4,0,20,16
1745810537674,LISP 5B,A00,896653,Munoz Sanchez; Alicia,10,0,20,10
1745810538701,LISP 5C,A00,896655,Munoz Sanchez; Alicia,4,0,20,16
1745810539725,MAE 197,001,957918,Kleissl; Jan,9998,0,9999,1
1745810540753,MATH 2,A01,957937,Staff,34,0,35,1
1745810541780,MATH 197,001,957876,Kedlaya; Kiran S.,9993,0,9999,6
1745810542808,MCWP 40,A00,892729,Duru; Nur,13,0,20,7
1745810542808,MCWP 40,B00,893304,Montejo; Carolina,20,0,20,0
1745810543837,MCWP 40R,A00,893757,Redela; Pamela Morgan,0,7,20,20
1745810544865,MCWP 50,A00,893758,Morshed; Michael James,2,0,20,18
1745810544865,MCWP 50,B00,893761,Bartulis; Jason Michael,17,0,20,3
1745810545891,MCWP 50R,A00,893766,Compas; Sean Matthew,0,1,20,20
1745810545891,MCWP 50R,B00,893769,Carter; Jennifer A,0,0,20,20
1745810545891,MCWP 50R,C00,893771,Krone; Jarret,0,3,20,20
1745810545891,MCWP 50R,D00,893772,Miller; Elizabeth Deen,3,0,20,17
1745810545891,MCWP 50R,E00,893775,Carter; Andrea L,0,0,20,20
1745810546915,MMW 11R,A01,892721,Herbst; Matthew,11,0,27,16
1745810546915,MMW 11R,A02,892722,Herbst; Matthew,0,0,0,3
1745810547941,MMW 12R,A01,892724,Herbst; Matthew,0,9,16,16
1745810547941,MMW 12R,A02,892725,Herbst; Matthew,0,9,16,16
1745810548976,MMW 13R,A01,892727,Staff,0,4,16,16
1745810548976,MMW 13R,A02,892728,Staff,0,4,16,16
1745810548976,MMW 13R,A03,958032,Staff,0,3,16,16
1745810548976,MMW 13R,A04,958033,Staff,0,2,16,16
1745810548976,MMW 13R,A05,958034,Staff,0,3,16,16
1745810550005,SIO 295LS,A00,894015,Staff,7,0,25,18
1745810551030,SIO 295S,A00,894020,Staff,7,0,25,18
1745810552058,SIOC 290S,B01,958918,Staff,0,0,0,0
1745810553085,SIOC 291S,B01,958922,Staff,0,0,0,0
1745810554115,SOCI 117,A01,895339,Staff,4,0,5,1
1745810555141,WES 237B,A00,894149,Staff,11,0,20,9
1745810557207,AESE 279B,A00,891859,Staff,13,0,35,22
1745810558234,AIP 197,001,891854,Staff,70,0,70,0
1745810559262,ANTH 289S,A00,891856,Gagneux; Pascal,12,0,12,0
1745810560289,BENG 196,001,957946,Engler; Adam J.,9996,0,9999,3
1745810561316,CAT 124RS,A01,956906,Staff,8,0,25,17
1745810562343,CAT 125RS,A01,922013,Staff,8,0,25,17
1745810563370,CLRE 250,A00,891860,Morris; Sheldon,9995,0,9999,4
1745810565420,CLRE 251R,A00,907817,Mehta; Ravindra L.,9994,0,9999,5
1745810566447,CLRE 252,A00,891864,Cuomo; Raphael Eduardo,9993,0,9999,6
1745810567475,CLRE 253,A00,891867,Vaida; Florin,9994,0,9999,5
1745810567475,CLRE 253,B00,907819,Staff,9999,0,9999,0
1745810568503,CLRE 259,A00,891868,Patel; Hemal,9998,0,9999,1
1745810569527,CLRE 260,A00,891872,Cuomo; Raphael Eduardo,9999,0,9999,0
1745810570551,CLRE 297,001,891888,Cuomo; Raphael Eduardo,9999,0,9999,0
1745810571576,CSE 191,A00,958773,Minnes Kemp; Mor Mia,9999,0,9999,0
1745810572605,CSS 201S,A01,892054,Mignozzetti; Umberto,30,0,30,0
1745810573632,CSS 202S,A01,892056,Mignozzetti; Umberto,30,0,30,0
1745810574661,DSC 197,001,956898,Eldridge; Justin Matthew,9998,0,9999,1
1745810575685,DSC 297,001,958000,Mazumdar; Arya,9998,0,9999,1
1745810576709,EAP 100,A00,905686,Staff,9776,0,9999,223
1745810577762,ECE 45,A01,892618,Staff,0,12,50,50
1745810578790,ECE 109,A01,892620,Staff,0,44,0,0
1745810579817,ECE 111,A01,892719,Staff,0,8,50,50
1745810580845,ECE 197,001,957920,Mercier; Patrick Philip,9992,0,9999,7
1745810581875,ECON 178,A01,907814,Zhu; Ying,28,0,35,7
1745810582900,EDS 115,A00,895312,Staff,41,0,45,4
1745810583926,EDS 117,A01,895337,Staff,30,0,30,0
1745810584955,EDS 125,A00,895341,Jones; Gabrielle Anastasia,43,0,45,2
1745810585987,EDS 128A,A01,895459,Fargason; Sharon Gayle,44,0,45,1
1745810587013,EDS 128B,A01,895543,Pappas; Elizabeth,44,0,45,1
1745810588042,EDS 139,A00,897203,Pappas; Elizabeth,44,0,45,1
1745810588042,EDS 139,B00,897209,Fargason; Sharon Gayle,44,0,45,1
1745810589068,EDS 201,A00,895545,Staff,43,0,45,2
1745810590094,EDS 203,A01,895581,Halter; Christopher P.,43,0,45,2
1745810591120,EDS 204R,A01,895625,Heinzman; Erica M.,43,0,45,2
1745810591120,EDS 204R,B01,895693,Halter; Christopher P.,18,0,45,27
1745810592148,EDS 206R,A00,895694,Fargason; Sharon Gayle,9,0,30,21
1745810592148,EDS 206R,B00,895695,Choi; Bailey Miyeon,20,0,30,10
1745810593177,EDS 250,A00,895697,Hemans; Patricia Ann Benitez,43,0,45,2
1745810594204,EDS 281,A00,895701,Meyerott; Theresa Ann,15,0,15,0
1745810595230,EDS 284,A00,895736,Meyerott; Theresa Ann,15,0,15,0
1745810596258,EDS 286,A00,897210,Fine; Sarah,15,0,15,0
1745810597287,EDS 289C,A01,895770,Daly; Alan J.,15,0,15,0
1745810598311,EDS 290,A00,897211,Hofstetter; Carolyn,15,0,15,0
1745810599338,LIGM 5A,A00,896162,Fischer-Grunski; Eva K,15,0,20,5
1745810600396,LIGM 5B,A00,896260,Fischer-Grunski; Eva K,17,0,20,3
1745810601423,LIGM 5C,A00,896308,Fischer-Grunski; Eva K,18,0,20,2
1745810602449,LIIT 5AS,A00,896313,Carnelos; Chiara,18,0,20,2
1745810603475,LIIT 5BS,A00,896416,Carnelos; Chiara,20,0,20,0
1745810604504,LIIT 5CS,A00,896564,Carnelos; Chiara,20,0,20,0
1745810605531,LISP 5A,A00,896588,Munoz Sanchez; Alicia,4,0,20,16
1745810606561,LISP 5B,A00,896653,Munoz Sanchez; Alicia,10,0,20,10
1745810607586,LISP 5C,A00,896655,Munoz Sanchez; Alicia,4,0,20,16
1745810608614,MAE 197,001,957918,Kleissl; Jan,9998,0,9999,1
1745810609639,MATH 2,A01,957937,Staff,34,0,35,1
1745810610664,MATH 197,001,957876,Kedlaya; Kiran S.,9993,0,9999,6
1745810611692,MCWP 40,A00,892729,Duru; Nur,13,0,20,7
1745810611692,MCWP 40,B00,893304,Montejo; Carolina,20,0,20,0
1745810612719,MCWP 40R,A00,893757,Redela; Pamela Morgan,0,7,20,20
1745810613744,MCWP 50,A00,893758,Morshed; Michael James,2,0,20,18
1745810613744,MCWP 50,B00,893761,Bartulis; Jason Michael,17,0,20,3
1745810614771,MCWP 50R,A00,893766,Compas; Sean Matthew,0,1,20,20
1745810614771,MCWP 50R,B00,893769,Carter; Jennifer A,0,0,20,20
1745810614771,MCWP 50R,C00,893771,Krone; Jarret,0,3,20,20
1745810614771,MCWP 50R,D00,893772,Miller; Elizabeth Deen,3,0,20,17
1745810614771,MCWP 50R,E00,893775,Carter; Andrea L,0,0,20,20
1745810615800,MMW 11R,A01,892721,Herbst; Matthew,11,0,27,16
1745810615800,MMW 11R,A02,892722,Herbst; Matthew,0,0,0,3
1745810616825,MMW 12R,A01,892724,Herbst; Matthew,0,9,16,16
1745810616825,MMW 12R,A02,892725,Herbst; Matthew,0,9,16,16
1745810617853,MMW 13R,A01,892727,Staff,0,4,16,16
1745810617853,MMW 13R,A02,892728,Staff,0,4,16,16
1745810617853,MMW 13R,A03,958032,Staff,0,3,16,16
1745810617853,MMW 13R,A04,958033,Staff,0,2,16,16
1745810617853,MMW 13R,A05,958034,Staff,0,3,16,16
1745810618880,SIO 295LS,A00,894015,Staff,7,0,25,18
1745810619907,SIO 295S,A00,894020,Staff,7,0,25,18
1745810620937,SIOC 290S,B01,958918,Staff,0,0,0,0
1745810621963,SIOC 291S,B01,958922,Staff,0,0,0,0
1745810622987,SOCI 117,A01,895339,Staff,4,0,5,1
1745810624016,WES 237B,A00,894149,Staff,11,0,20,9
1745810626080,AESE 279B,A00,891859,Staff,13,0,35,22
1745810627106,AIP 197,001,891854,Staff,70,0,70,0
1745810628131,ANTH 289S,A00,891856,Gagneux; Pascal,12,0,12,0
1745810629158,BENG 196,001,957946,Engler; Adam J.,9996,0,9999,3
1745810630186,CAT 124RS,A01,956906,Staff,8,0,25,17
1745810631211,CAT 125RS,A01,922013,Staff,8,0,25,17
1745810632237,CLRE 250,A00,891860,Morris; Sheldon,9995,0,9999,4
1745810634291,CLRE 251R,A00,907817,Mehta; Ravindra L.,9994,0,9999,5
1745810635322,CLRE 252,A00,891864,Cuomo; Raphael Eduardo,9993,0,9999,6
1745810636348,CLRE 253,A00,891867,Vaida; Florin,9994,0,9999,5
1745810636348,CLRE 253,B00,907819,Staff,9999,0,9999,0
1745810637378,CLRE 259,A00,891868,Patel; Hemal,9998,0,9999,1
1745810638407,CLRE 260,A00,891872,Cuomo; Raphael Eduardo,9999,0,9999,0
1745810639437,CLRE 297,001,891888,Cuomo; Raphael Eduardo,9999,0,9999,0
1745810640463,CSE 191,A00,958773,Minnes Kemp; Mor Mia,9999,0,9999,0
1745810641492,CSS 201S,A01,892054,Mignozzetti; Umberto,30,0,30,0
1745810642517,CSS 202S,A01,892056,Mignozzetti; Umberto,30,0,30,0
1745810643544,DSC 197,001,956898,Eldridge; Justin Matthew,9998,0,9999,1
1745810644572,DSC 297,001,958000,Mazumdar; Arya,9998,0,9999,1
1745810645598,EAP 100,A00,905686,Staff,9776,0,9999,223
1745810646627,ECE 45,A01,892618,Staff,0,12,50,50
1745810647656,ECE 109,A01,892620,Staff,0,44,0,0
1745810648682,ECE 111,A01,892719,Staff,0,8,50,50
1745810649711,ECE 197,001,957920,Mercier; Patrick Philip,9992,0,9999,7
1745810650741,ECON 178,A01,907814,Zhu; Ying,28,0,35,7
1745810651768,EDS 115,A00,895312,Staff,41,0,45,4
1745810652794,EDS 117,A01,895337,Staff,30,0,30,0
1745810653820,EDS 125,A00,895341,Jones; Gabrielle Anastasia,43,0,45,2
1745810654848,EDS 128A,A01,895459,Fargason; Sharon Gayle,44,0,45,1
1745810655878,EDS 128B,A01,895543,Pappas; Elizabeth,44,0,45,1
1745810656904,EDS 139,A00,897203,Pappas; Elizabeth,44,0,45,1
1745810656904,EDS 139,B00,897209,Fargason; Sharon Gayle,44,0,45,1
1745810657932,EDS 201,A00,895545,Staff,43,0,45,2
1745810658958,EDS 203,A01,895581,Halter; Christopher P.,43,0,45,2
1745810659986,EDS 204R,A01,895625,Heinzman; Erica M.,43,0,45,2
1745810659986,EDS 204R,B01,895693,Halter; Christopher P.,18,0,45,27
1745810661013,EDS 206R,A00,895694,Fargason; Sharon Gayle,9,0,30,21
1745810661013,EDS 206R,B00,895695,Choi; Bailey Miyeon,20,0,30,10
1745810662041,EDS 250,A00,895697,Hemans; Patricia Ann Benitez,43,0,45,2
1745810663067,EDS 281,A00,895701,Meyerott; Theresa Ann,15,0,15,0
1745810664095,EDS 284,A00,895736,Meyerott; Theresa Ann,15,0,15,0
1745810665123,EDS 286,A00,897210,Fine; Sarah,15,0,15,0
1745810666149,EDS 289C,A01,895770,Daly; Alan J.,15,0,15,0
1745810667175,EDS 290,A00,897211,Hofstetter; Carolyn,15,0,15,0
1745810668201,LIGM 5A,A00,896162,Fischer-Grunski; Eva K,15,0,20,5
1745810669233,LIGM 5B,A00,896260,Fischer-Grunski; Eva K,17,0,20,3
1745810670257,LIGM 5C,A00,896308,Fischer-Grunski; Eva K,18,0,20,2
1745810671283,LIIT 5AS,A00,896313,Carnelos; Chiara,18,0,20,2
1745810672312,LIIT 5BS,A00,896416,Carnelos; Chiara,20,0,20,0
1745810673341,LIIT 5CS,A00,896564,Carnelos; Chiara,20,0,20,0
1745810674368,LISP 5A,A00,896588,Munoz Sanchez; Alicia,4,0,20,16
1745810675394,LISP 5B,A00,896653,Munoz Sanchez; Alicia,10,0,20,10
1745810676420,LISP 5C,A00,896655,Munoz Sanchez; Alicia,4,0,20,16
1745810677446,MAE 197,001,957918,Kleissl; Jan,9998,0,9999,1
1745810678476,MATH 2,A01,957937,Staff,34,0,35,1
1745810679502,MATH 197,001,957876,Kedlaya; Kiran S.,9993,0,9999,6
1745810680528,MCWP 40,A00,892729,Duru; Nur,13,0,20,7
1745810680528,MCWP 40,B00,893304,Montejo; Carolina,20,0,20,0
1745810681554,MCWP 40R,A00,893757,Redela; Pamela Morgan,0,7,20,20
1745810682582,MCWP 50,A00,893758,Morshed; Michael James,2,0,20,18
1745810682582,MCWP 50,B00,893761,Bartulis; Jason Michael,17,0,20,3
1745810683607,MCWP 50R,A00,893766,Compas; Sean Matthew,0,1,20,20
1745810683607,MCWP 50R,B00,893769,Carter; Jennifer A,0,0,20,20
1745810683607,MCWP 50R,C00,893771,Krone; Jarret,0,3,20,20
1745810683607,MCWP 50R,D00,893772,Miller; Elizabeth Deen,3,0,20,17
1745810683607,MCWP 50R,E00,893775,Carter; Andrea L,0,0,20,20
1745810684632,MMW 11R,A01,892721,Herbst; Matthew,11,0,27,16
1745810684632,MMW 11R,A02,892722,Herbst; Matthew,0,0,0,3
1745810685658,MMW 12R,A01,892724,Herbst; Matthew,0,9,16,16
1745810685658,MMW 12R,A02,892725,Herbst; Matthew,0,9,16,16
1745810686684,MMW 13R,A01,892727,Staff,0,4,16,16
1745810686684,MMW 13R,A02,892728,Staff,0,4,16,16
1745810686684,MMW 13R,A03,958032,Staff,0,3,16,16
1745810686684,MMW 13R,A04,958033,Staff,0,2,16,16
1745810686684,MMW 13R,A05,958034,Staff,0,3,16,16
1745810687710,SIO 295LS,A00,894015,Staff,7,0,25,18
1745810688738,SIO 295S,A00,894020,Staff,7,0,25,18
1745810689766,SIOC 290S,B01,958918,Staff,0,0,0,0
1745810690797,SIOC 291S,B01,958922,Staff,0,0,0,0
1745810691822,SOCI 117,A01,895339,Staff,4,0,5,1
1745810692849,WES 237B,A00,894149,Staff,11,0,20,9
1745810694917,AESE 279B,A00,891859,Staff,13,0,35,22
1745810695943,AIP 197,001,891854,Staff,70,0,70,0
1745810696969,ANTH 289S,A00,891856,Gagneux; Pascal,12,0,12,0
1745810697997,BENG 196,001,957946,Engler; Adam J.,9996,0,9999,3
1745810699026,CAT 124RS,A01,956906,Staff,8,0,25,17
1745810700050,CAT 125RS,A01,922013,Staff,8,0,25,17
1745810701080,CLRE 250,A00,891860,Morris; Sheldon,9995,0,9999,4
1745810703131,CLRE 251R,A00,907817,Mehta; Ravindra L.,9994,0,9999,5
1745810704161,CLRE 252,A00,891864,Cuomo; Raphael Eduardo,9993,0,9999,6
1745810705188,CLRE 253,A00,891867,Vaida; Florin,9994,0,9999,5
1745810705188,CLRE 253,B00,907819,Staff,9999,0,9999,0
1745810706214,CLRE 259,A00,891868,Patel; Hemal,9998,0,9999,1
1745810707241,CLRE 260,A00,891872,Cuomo; Raphael Eduardo,9999,0,9999,0
1745810708268,CLRE 297,001,891888,Cuomo; Raphael Eduardo,9999,0,9999,0
1745810709295,CSE 191,A00,958773,Minnes Kemp; Mor Mia,9999,0,9999,0
1745810710325,CSS 201S,A01,892054,Mignozzetti; Umberto,30,0,30,0
1745810711351,CSS 202S,A01,892056,Mignozzetti; Umberto,30,0,30,0
1745810712397,DSC 197,001,956898,Eldridge; Justin Matthew,9998,0,9999,1
1745810713423,DSC 297,001,958000,Mazumdar; Arya,9998,0,9999,1
1745810714450,EAP 100,A00,905686,Staff,9776,0,9999,223
1745810715476,ECE 45,A01,892618,Staff,0,12,50,50
1745810716504,ECE 109,A01,892620,Staff,0,44,0,0
1745810717533,ECE 111,A01,892719,Staff,0,8,50,50
1745810718561,ECE 197,001,957920,Mercier; Patrick Philip,9992,0,9999,7
1745810719588,ECON 178,A01,907814,Zhu; Ying,28,0,35,7
1745810720615,EDS 115,A00,895312,Staff,41,0,45,4
1745810721643,EDS 117,A01,895337,Staff,30,0,30,0
1745810722670,EDS 125,A00,895341,Jones; Gabrielle Anastasia,43,0,45,2
1745810723700,EDS 128A,A01,895459,Fargason; Sharon Gayle,44,0,45,1
1745810724725,EDS 128B,A01,895543,Pappas; Elizabeth,44,0,45,1
1745810725751,EDS 139,A00,897203,Pappas; Elizabeth,44,0,45,1
1745810725751,EDS 139,B00,897209,Fargason; Sharon Gayle,44,0,45,1
1745810726779,EDS 201,A00,895545,Staff,43,0,45,2
1745810727806,EDS 203,A01,895581,Halter; Christopher P.,43,0,45,2
1745810728832,EDS 204R,A01,895625,Heinzman; Erica M.,43,0,45,2
1745810728832,EDS 204R,B01,895693,Halter; Christopher P.,18,0,45,27
1745810729857,EDS 206R,A00,895694,Fargason; Sharon Gayle,9,0,30,21
1745810729857,EDS 206R,B00,895695,Choi; Bailey Miyeon,20,0,30,10
1745810730884,EDS 250,A00,895697,Hemans; Patricia Ann Benitez,43,0,45,2
1745810731912,EDS 281,A00,895701,Meyerott; Theresa Ann,15,0,15,0
1745810732938,EDS 284,A00,895736,Meyerott; Theresa Ann,15,0,15,0
1745810733965,EDS 286,A00,897210,Fine; Sarah,15,0,15,0
1745810734993,EDS 289C,A01,895770,Daly; Alan J.,15,0,15,0
1745810736021,EDS 290,A00,897211,Hofstetter; Carolyn,15,0,15,0
1745810737045,LIGM 5A,A00,896162,Fischer-Grunski; Eva K,15,0,20,5
1745810738070,LIGM 5B,A00,896260,Fischer-Grunski; Eva K,17,0,20,3
1745810739100,LIGM 5C,A00,896308,Fischer-Grunski; Eva K,18,0,20,2
1745810740129,LIIT 5AS,A00,896313,Carnelos; Chiara,18,0,20,2
1745810741156,LIIT 5BS,A00,896416,Carnelos; Chiara,20,0,20,0
1745810742182,LIIT 5CS,A00,896564,Carnelos; Chiara,20,0,20,0
1745810743209,LISP 5A,A00,896588,Munoz Sanchez; Alicia,4,0,20,16
1745810744237,LISP 5B,A00,896653,Munoz Sanchez; Alicia,10,0,20,10
1745810745261,LISP 5C,A00,896655,Munoz Sanchez; Alicia,4,0,20,16
1745810746291,MAE 197,001,957918,Kleissl; Jan,9998,0,9999,1
1745810747318,MATH 2,A01,957937,Staff,34,0,35,1
1745810748344,MATH 197,001,957876,Kedlaya; Kiran S.,9993,0,9999,6
1745810749373,MCWP 40,A00,892729,Duru; Nur,13,0,20,7
1745810749373,MCWP 40,B00,893304,Montejo; Carolina,20,0,20,0
1745810750401,MCWP 40R,A00,893757,Redela; Pamela Morgan,0,7,20,20
1745810751428,MCWP 50,A00,893758,Morshed; Michael James,2,0,20,18
1745810751428,MCWP 50,B00,893761,Bartulis; Jason Michael,17,0,20,3
1745810752456,MCWP 50R,A00,893766,Compas; Sean Matthew,0,1,20,20
1745810752456,MCWP 50R,B00,893769,Carter; Jennifer A,0,0,20,20
1745810752456,MCWP 50R,C00,893771,Krone; Jarret,0,3,20,20
1745810752456,MCWP 50R,D00,893772,Miller; Elizabeth Deen,3,0,20,17
1745810752456,MCWP 50R,E00,893775,Carter; Andrea L,0,0,20,20
1745810753483,MMW 11R,A01,892721,Herbst; Matthew,11,0,27,16
1745810753483,MMW 11R,A02,892722,Herbst; Matthew,0,0,0,3
1745810754508,MMW 12R,A01,892724,Herbst; Matthew,0,9,16,16
1745810754508,MMW 12R,A02,892725,Herbst; Matthew,0,9,16,16
1745810755534,MMW 13R,A01,892727,Staff,0,4,16,16
1745810755534,MMW 13R,A02,892728,Staff,0,4,16,16
1745810755534,MMW 13R,A03,958032,Staff,0,3,16,16
1745810755534,MMW 13R,A04,958033,Staff,0,2,16,16
1745810755534,MMW 13R,A05,958034,Staff,0,3,16,16
1745810756564,SIO 295LS,A00,894015,Staff,7,0,25,18
1745810757590,SIO 295S,A00,894020,Staff,7,0,25,18
1745810758617,SIOC 290S,B01,958918,Staff,0,0,0,0
1745810759644,SIOC 291S,B01,958922,Staff,0,0,0,0
1745810760672,SOCI 117,A01,895339,Staff,4,0,5,1
1745810761700,WES 237B,A00,894149,Staff,11,0,20,9
1745810763765,AESE 279B,A00,891859,Staff,13,0,35,22
1745810764791,AIP 197,001,891854,Staff,70,0,70,0
1745810765816,ANTH 289S,A00,891856,Gagneux; Pascal,12,0,12,0
1745810766841,BENG 196,001,957946,Engler; Adam J.,9996,0,9999,3
1745810767868,CAT 124RS,A01,956906,Staff,8,0,25,17
1745810768892,CAT 125RS,A01,922013,Staff,8,0,25,17
1745810769920,CLRE 250,A00,891860,Morris; Sheldon,9995,0,9999,4
1745810771975,CLRE 251R,A00,907817,Mehta; Ravindra L.,9994,0,9999,5
1745810773000,CLRE 252,A00,891864,Cuomo; Raphael Eduardo,9993,0,9999,6
1745810774025,CLRE 253,A00,891867,Vaida; Florin,9994,0,9999,5
1745810774025,CLRE 253,B00,907819,Staff,9999,0,9999,0
1745810775052,CLRE 259,A00,891868,Patel; Hemal,9998,0,9999,1
1745810776078,CLRE 260,A00,891872,Cuomo; Raphael Eduardo,9999,0,9999,0
1745810777107,CLRE 297,001,891888,Cuomo; Raphael Eduardo,9999,0,9999,0
1745810778133,CSE 191,A00,958773,Minnes Kemp; Mor Mia,9999,0,9999,0
1745810779159,CSS 201S,A01,892054,Mignozzetti; Umberto,30,0,30,0
1745810780185,CSS 202S,A01,892056,Mignozzetti; Umberto,30,0,30,0
1745810781214,DSC 197,001,956898,Eldridge; Justin Matthew,9998,0,9999,1
1745810782239,DSC 297,001,958000,Mazumdar; Arya,9998,0,9999,1
1745810783269,EAP 100,A00,905686,Staff,9776,0,9999,223
1745810784295,ECE 45,A01,892618,Staff,0,12,50,50
1745810785321,ECE 109,A01,892620,Staff,0,44,0,0
1745810786350,ECE 111,A01,892719,Staff,0,8,50,50
1745810787376,ECE 197,001,957920,Mercier; Patrick Philip,9992,0,9999,7
1745810788406,ECON 178,A01,907814,Zhu; Ying,28,0,35,7
1745810789432,EDS 115,A00,895312,Staff,41,0,45,4
1745810790461,EDS 117,A01,895337,Staff,30,0,30,0
1745810791487,EDS 125,A00,895341,Jones; Gabrielle Anastasia,43,0,45,2
1745810792515,EDS 128A,A01,895459,Fargason; Sharon Gayle,44,0,45,1
1745810793545,EDS 128B,A01,895543,Pappas; Elizabeth,44,0,45,1
1745810794569,EDS 139,A00,897203,Pappas; Elizabeth,44,0,45,1
1745810794569,EDS 139,B00,897209,Fargason; Sharon Gayle,44,0,45,1
1745810795596,EDS 201,A00,895545,Staff,43,0,45,2
1745810796625,EDS 203,A01,895581,Halter; Christopher P.,43,0,45,2
1745810797650,EDS 204R,A01,895625,Heinzman; Erica M.,43,0,45,2
1745810797650,EDS 204R,B01,895693,Halter; Christopher P.,18,0,45,27
1745810798677,EDS 206R,A00,895694,Fargason; Sharon Gayle,9,0,30,21
1745810798677,EDS 206R,B00,895695,Choi; Bailey Miyeon,20,0,30,10
1745810799703,EDS 250,A00,895697,Hemans; Patricia Ann Benitez,43,0,45,2
1745810800731,EDS 281,A00,895701,Meyerott; Theresa Ann,15,0,15,0
1745810801757,EDS 284,A00,895736,Meyerott; Theresa Ann,15,0,15,0
1745810802785,EDS 286,A00,897210,Fine; Sarah,15,0,15,0
1745810803809,EDS 289C,A01,895770,Daly; Alan J.,15,0,15,0
1745810804839,EDS 290,A00,897211,Hofstetter; Carolyn,15,0,15,0
1745810805867,LIGM 5A,A00,896162,Fischer-Grunski; Eva K,15,0,20,5
1745810806896,LIGM 5B,A00,896260,Fischer-Grunski; Eva K,17,0,20,3
1745810807922,LIGM 5C,A00,896308,Fischer-Grunski; Eva K,18,0,20,2
1745810808949,LIIT 5AS,A00,896313,Carnelos; Chiara,18,0,20,2
1745810809975,LIIT 5BS,A00,896416,Carnelos; Chiara,20,0,20,0
1745810810999,LIIT 5CS,A00,896564,Carnelos; Chiara,20,0,20,0
1745810812028,LISP 5A,A00,896588,Munoz Sanchez; Alicia,4,0,20,16
1745810813053,LISP 5B,A00,896653,Munoz Sanchez; Alicia,10,0,20,10
1745810814078,LISP 5C,A00,896655,Munoz Sanchez; Alicia,4,0,20,16
1745810815104,MAE 197,001,957918,Kleissl; Jan,9998,0,9999,1
1745810816132,MATH 2,A01,957937,Staff,34,0,35,1
1745810817158,MATH 197,001,957876,Kedlaya; Kiran S.,9993,0,9999,6
1745810818187,MCWP 40,A00,892729,Duru; Nur,13,0,20,7
1745810818187,MCWP 40,B00,893304,Montejo; Carolina,20,0,20,0
1745810819213,MCWP 40R,A00,893757,Redela; Pamela Morgan,0,7,20,20
1745810820242,MCWP 50,A00,893758,Morshed; Michael James,2,0,20,18
1745810820242,MCWP 50,B00,893761,Bartulis; Jason Michael,17,0,20,3
1745810821267,MCWP 50R,A00,893766,Compas; Sean Matthew,0,1,20,20
1745810821267,MCWP 50R,B00,893769,Carter; Jennifer A,0,0,20,20
1745810821267,MCWP 50R,C00,893771,Krone; Jarret,0,3,20,20
1745810821267,MCWP 50R,D00,893772,Miller; Elizabeth Deen,3,0,20,17
1745810821267,MCWP 50R,E00,893775,Carter; Andrea L,0,0,20,20
1745810822293,MMW 11R,A01,892721,Herbst; Matthew,11,0,27,16
1745810822293,MMW 11R,A02,892722,Herbst; Matthew,0,0,0,3
1745810823319,MMW 12R,A01,892724,Herbst; Matthew,0,9,16,16
1745810823319,MMW 12R,A02,892725,Herbst; Matthew,0,9,16,16
1745810824347,MMW 13R,A01,892727,Staff,0,4,16,16
1745810824347,MMW 13R,A02,892728,Staff,0,4,16,16
1745810824347,MMW 13R,A03,958032,Staff,0,3,16,16
1745810824347,MMW 13R,A04,958033,Staff,0,2,16,16
1745810824347,MMW 13R,A05,958034,Staff,0,3,16,16
1745810825376,SIO 295LS,A00,894015,Staff,7,0,25,18
1745810826402,SIO 295S,A00,894020,Staff,7,0,25,18
1745810827431,SIOC 290S,B01,958918,Staff,0,0,0,0
1745810828457,SIOC 291S,B01,958922,Staff,0,0,0,0
1745810829483,SOCI 117,A01,895339,Staff,4,0,5,1
1745810830507,WES 237B,A00,894149,Staff,11,0,20,9
1745810832578,AESE 279B,A00,891859,Staff,13,0,35,22
1745810833602,AIP 197,001,891854,Staff,70,0,70,0
1745810834630,ANTH 289S,A00,891856,Gagneux; Pascal,12,0,12,0
1745810835657,BENG 196,001,957946,Engler; Adam J.,9996,0,9999,3
1745810836681,CAT 124RS,A01,956906,Staff,8,0,25,17
1745810837705,CAT 125RS,A01,922013,Staff,8,0,25,17
1745810838733,CLRE 250,A00,891860,Morris; Sheldon,9995,0,9999,4
1745810840783,CLRE 251R,A00,907817,Mehta; Ravindra L.,9994,0,9999,5
1745810841808,CLRE 252,A00,891864,Cuomo; Raphael Eduardo,9993,0,9999,6
1745810842833,CLRE 253,A00,891867,Vaida; Florin,9994,0,9999,5
1745810842833,CLRE 253,B00,907819,Staff,9999,0,9999,0
1745810843860,CLRE 259,A00,891868,Patel; Hemal,9998,0,9999,1
1745810844885,CLRE 260,A00,891872,Cuomo; Raphael Eduardo,9999,0,9999,0
1745810845911,CLRE 297,001,891888,Cuomo; Raphael Eduardo,9999,0,9999,0
1745810846938,CSE 191,A00,958773,Minnes Kemp; Mor Mia,9999,0,9999,0
1745810847965,CSS 201S,A01,892054,Mignozzetti; Umberto,30,0,30,0
1745810848989,CSS 202S,A01,892056,Mignozzetti; Umberto,30,0,30,0
1745810850015,DSC 197,001,956898,Eldridge; Justin Matthew,9998,0,9999,1
1745810851043,DSC 297,001,958000,Mazumdar; Arya,9998,0,9999,1
1745810852066,EAP 100,A00,905686,Staff,9776,0,9999,223
1745810853093,ECE 45,A01,892618,Staff,0,12,50,50
1745810854121,ECE 109,A01,892620,Staff,0,44,0,0
1745810855146,ECE 111,A01,892719,Staff,0,8,50,50
1745810856173,ECE 197,001,957920,Mercier; Patrick Philip,9992,0,9999,7
1745810857197,ECON 178,A01,907814,Zhu; Ying,28,0,35,7
1745810858224,EDS 115,A00,895312,Staff,41,0,45,4
1745810859250,EDS 117,A01,895337,Staff,30,0,30,0
1745810860277,EDS 125,A00,895341,Jones; Gabrielle Anastasia,43,0,45,2
1745810861306,EDS 128A,A01,895459,Fargason; Sharon Gayle,44,0,45,1
1745810862333,EDS 128B,A01,895543,Pappas; Elizabeth,44,0,45,1
1745810863360,EDS 139,A00,897203,Pappas; Elizabeth,44,0,45,1
1745810863360,EDS 139,B00,897209,Fargason; Sharon Gayle,44,0,45,1
1745810864385,EDS 201,A00,895545,Staff,43,0,45,2
1745810865414,EDS 203,A01,895581,Halter; Christopher P.,43,0,45,2
1745810866440,EDS 204R,A01,895625,Heinzman; Erica M.,43,0,45,2
1745810866440,EDS 204R,B01,895693,Halter; Christopher P.,18,0,45,27
1745810867465,EDS 206R,A00,895694,Fargason; Sharon Gayle,9,0,30,21
1745810867465,EDS 206R,B00,895695,Choi; Bailey Miyeon,20,0,30,10
1745810868490,EDS 250,A00,895697,Hemans; Patricia Ann Benitez,43,0,45,2
1745810869516,EDS 281,A00,895701,Meyerott; Theresa Ann,15,0,15,0
1745810870544,EDS 284,A00,895736,Meyerott; Theresa Ann,15,0,15,0
1745810871572,EDS 286,A00,897210,Fine; Sarah,15,0,15,0
1745810872597,EDS 289C,A01,895770,Daly; Alan J.,15,0,15,0
1745810873624,EDS 290,A00,897211,Hofstetter; Carolyn,15,0,15,0
1745810874649,LIGM 5A,A00,896162,Fischer-Grunski; Eva K,15,0,20,5
1745810875678,LIGM 5B,A00,896260,Fischer-Grunski; Eva K,17,0,20,3
1745810876706,LIGM 5C,A00,896308,Fischer-Grunski; Eva K,18,0,20,2
1745810877731,LIIT 5AS,A00,896313,Carnelos; Chiara,18,0,20,2
1745810878756,LIIT 5BS,A00,896416,Carnelos; Chiara,20,0,20,0
1745810879782,LIIT 5CS,A00,896564,Carnelos; Chiara,20,0,20,0
1745810880811,LISP 5A,A00,896588,Munoz Sanchez; Alicia,4,0,20,16
1745810881840,LISP 5B,A00,896653,Munoz Sanchez; Alicia,10,0,20,10
1745810882864,LISP 5C,A00,896655,Munoz Sanchez; Alicia,4,0,20,16
1745810883888,MAE 197,001,957918,Kleissl; Jan,9998,0,9999,1
1745810884916,MATH 2,A01,957937,Staff,34,0,35,1
1745810885941,MATH 197,001,957876,Kedlaya; Kiran S.,9993,0,9999,6
1745810886972,MCWP 40,A00,892729,Duru; Nur,13,0,20,7
1745810886972,MCWP 40,B00,893304,Montejo; Carolina,20,0,20,0
1745810888001,MCWP 40R,A00,893757,Redela; Pamela Morgan,0,7,20,20
1745810889031,MCWP 50,A00,893758,Morshed; Michael James,2,0,20,18
1745810889031,MCWP 50,B00,893761,Bartulis; Jason Michael,17,0,20,3
1745810890059,MCWP 50R,A00,893766,Compas; Sean Matthew,0,1,20,20
1745810890059,MCWP 50R,B00,893769,Carter; Jennifer A,0,0,20,20
1745810890059,MCWP 50R,C00,893771,Krone; Jarret,0,3,20,20
1745810890059,MCWP 50R,D00,893772,Miller; Elizabeth Deen,3,0,20,17
1745810890059,MCWP 50R,E00,893775,Carter; Andrea L,0,0,20,20
1745810891085,MMW 11R,A01,892721,Herbst; Matthew,11,0,27,16
1745810891085,MMW 11R,A02,892722,Herbst; Matthew,0,0,0,3
1745810892112,MMW 12R,A01,892724,Herbst; Matthew,0,9,16,16
1745810892112,MMW 12R,A02,892725,Herbst; Matthew,0,9,16,16
1745810893162,MMW 13R,A01,892727,Staff,0,4,16,16
1745810893162,MMW 13R,A02,892728,Staff,0,4,16,16
1745810893162,MMW 13R,A03,958032,Staff,0,3,16,16
1745810893162,MMW 13R,A04,958033,Staff,0,2,16,16
1745810893162,MMW 13R,A05,958034,Staff,0,3,16,16
1745810894193,SIO 295LS,A00,894015,Staff,7,0,25,18
1745810895221,SIO 295S,A00,894020,Staff,7,0,25,18
1745810896248,SIOC 290S,B01,958918,Staff,0,0,0,0
1745810897277,SIOC 291S,B01,958922,Staff,0,0,0,0
1745810898304,SOCI 117,A01,895339,Staff,4,0,5,1
1745810899327,WES 237B,A00,894149,Staff,11,0,20,9
1745810901393,AESE 279B,A00,891859,Staff,13,0,35,22
1745810902419,AIP 197,001,891854,Staff,70,0,70,0
1745810903445,ANTH 289S,A00,891856,Gagneux; Pascal,12,0,12,0
1745810904469,BENG 196,001,957946,Engler; Adam J.,9996,0,9999,3
1745810905497,CAT 124RS,A01,956906,Staff,8,0,25,17
1745810906525,CAT 125RS,A01,922013,Staff,8,0,25,17
1745810907548,CLRE 250,A00,891860,Morris; Sheldon,9995,0,9999,4
1745810909599,CLRE 251R,A00,907817,Mehta; Ravindra L.,9994,0,9999,5
1745810910624,CLRE 252,A00,891864,Cuomo; Raphael Eduardo,9993,0,9999,6
1745810911648,CLRE 253,A00,891867,Vaida; Florin,9994,0,9999,5
1745810911648,CLRE 253,B00,907819,Staff,9999,0,9999,0
1745810912675,CLRE 259,A00,891868,Patel; Hemal,9998,0,9999,1
1745810913701,CLRE 260,A00,891872,Cuomo; Raphael Eduardo,9999,0,9999,0
1745810914725,CLRE 297,001,891888,Cuomo; Raphael Eduardo,9999,0,9999,0
1745810915753,CSE 191,A00,958773,Minnes Kemp; Mor Mia,9999,0,9999,0
1745810916777,CSS 201S,A01,892054,Mignozzetti; Umberto,30,0,30,0
1745810917805,CSS 202S,A01,892056,Mignozzetti; Umberto,30,0,30,0
1745810918833,DSC 197,001,956898,Eldridge; Justin Matthew,9998,0,9999,1
1745810919860,DSC 297,001,958000,Mazumdar; Arya,9998,0,9999,1
1745810920885,EAP 100,A00,905686,Staff,9776,0,9999,223
1745810921912,ECE 45,A01,892618,Staff,0,12,50,50
1745810922939,ECE 109,A01,892620,Staff,0,44,0,0
1745810923968,ECE 111,A01,892719,Staff,0,8,50,50
1745810924995,ECE 197,001,957920,Mercier; Patrick Philip,9992,0,9999,7
1745810926027,ECON 178,A01,907814,Zhu; Ying,28,0,35,7
1745810927053,EDS 115,A00,895312,Staff,41,0,45,4
1745810928077,EDS 117,A01,895337,Staff,30,0,30,0
1745810929105,EDS 125,A00,895341,Jones; Gabrielle Anastasia,43,0,45,2
1745810930132,EDS 128A,A01,895459,Fargason; Sharon Gayle,44,0,45,1
1745810931162,EDS 128B,A01,895543,Pappas; Elizabeth,44,0,45,1
1745810932188,EDS 139,A00,897203,Pappas; Elizabeth,44,0,45,1
1745810932188,EDS 139,B00,897209,Fargason; Sharon Gayle,44,0,45,1
1745810933211,EDS 201,A00,895545,Staff,43,0,45,2
1745810934241,EDS 203,A01,895581,Halter; Christopher P.,43,0,45,2
1745810935268,EDS 204R,A01,895625,Heinzman; Erica M.,43,0,45,2
1745810935268,EDS 204R,B01,895693,Halter; Christopher P.,18,0,45,27
1745810936296,EDS 206R,A00,895694,Fargason; Sharon Gayle,9,0,30,21
1745810936296,EDS 206R,B00,895695,Choi; Bailey Miyeon,20,0,30,10
1745810937327,EDS 250,A00,895697,Hemans; Patricia Ann Benitez,43,0,45,2
1745810938358,EDS 281,A00,895701,Meyerott; Theresa Ann,15,0,15,0
1745810939387,EDS 284,A00,895736,Meyerott; Theresa Ann,15,0,15,0
1745810940413,EDS 286,A00,897210,Fine; Sarah,15,0,15,0
1745810941441,EDS 289C,A01,895770,Daly; Alan J.,15,0,15,0
1745810942470,EDS 290,A00,897211,Hofstetter; Carolyn,15,0,15,0
1745810943501,LIGM 5A,A00,896162,Fischer-Grunski; Eva K,15,0,20,5
1745810944527,LIGM 5B,A00,896260,Fischer-Grunski; Eva K,17,0,20,3
1745810945553,LIGM 5C,A00,896308,Fischer-Grunski; Eva K,18,0,20,2
1745810946582,LIIT 5AS,A00,896313,Carnelos; Chiara,18,0,20,2
1745810947607,LIIT 5BS,A00,896416,Carnelos; Chiara,20,0,20,0
1745810948634,LIIT 5CS,A00,896564,Carnelos; Chiara,20,0,20,0
1745810949658,LISP 5A,A00,896588,Munoz Sanchez; Alicia,4,0,20,16
1745810950685,LISP 5B,A00,896653,Munoz Sanchez; Alicia,10,0,20,10
1745810951712,LISP 5C,A00,896655,Munoz Sanchez; Alicia,4,0,20,16
1745810952741,MAE 197,001,957918,Kleissl; Jan,9998,0,9999,1
1745810953768,MATH 2,A01,957937,Staff,34,0,35,1
1745810954798,MATH 197,001,957876,Kedlaya; Kiran S.,9993,0,9999,6
1745810955828,MCWP 40,A00,892729,Duru; Nur,13,0,20,7
1745810955828,MCWP 40,B00,893304,Montejo; Carolina,20,0,20,0
1745810956858,MCWP 40R,A00,893757,Redela; Pamela Morgan,0,7,20,20
1745810957887,MCWP 50,A00,893758,Morshed; Michael James,2,0,20,18
1745810957887,MCWP 50,B00,893761,Bartulis; Jason Michael,17,0,20,3
1745810958917,MCWP 50R,A00,893766,Compas; Sean Matthew,0,1,20,20
1745810958917,MCWP 50R,B00,893769,Carter; Jennifer A,0,0,20,20
1745810958917,MCWP 50R,C00,893771,Krone; Jarret,0,3,20,20
1745810958917,MCWP 50R,D00,893772,Miller; Elizabeth Deen,3,0,20,17
1745810958917,MCWP 50R,E00,893775,Carter; Andrea L,0,0,20,20
1745810959945,MMW 11R,A01,892721,Herbst; Matthew,11,0,27,16
1745810959945,MMW 11R,A02,892722,Herbst; Matthew,0,0,0,3
1745810960972,MMW 12R,A01,892724,Herbst; Matthew,0,9,16,16
1745810960972,MMW 12R,A02,892725,Herbst; Matthew,0,9,16,16
1745810962000,MMW 13R,A01,892727,Staff,0,4,16,16
1745810962000,MMW 13R,A02,892728,Staff,0,4,16,16
1745810962000,MMW 13R,A03,958032,Staff,0,3,16,16
1745810962000,MMW 13R,A04,958033,Staff,0,2,16,16
1745810962000,MMW 13R,A05,958034,Staff,0,3,16,16
1745810963029,SIO 295LS,A00,894015,Staff,7,0,25,18
1745810964057,SIO 295S,A00,894020,Staff,7,0,25,18
1745810965083,SIOC 290S,B01,958918,Staff,0,0,0,0
1745810966110,SIOC 291S,B01,958922,Staff,0,0,0,0
1745810967186,SOCI 117,A01,895339,Staff,4,0,5,1
1745810968212,WES 237B,A00,894149,Staff,11,0,20,9
1745810970287,AESE 279B,A00,891859,Staff,13,0,35,22
1745810971312,AIP 197,001,891854,Staff,70,0,70,0
1745810972337,ANTH 289S,A00,891856,Gagneux; Pascal,12,0,12,0
1745810973366,BENG 196,001,957946,Engler; Adam J.,9996,0,9999,3
1745810974395,CAT 124RS,A01,956906,Staff,8,0,25,17
1745810975420,CAT 125RS,A01,922013,Staff,8,0,25,17
1745810976445,CLRE 250,A00,891860,Morris; Sheldon,9995,0,9999,4
1745810978496,CLRE 251R,A00,907817,Mehta; Ravindra L.,9994,0,9999,5
1745810979520,CLRE 252,A00,891864,Cuomo; Raphael Eduardo,9993,0,9999,6
1745810980545,CLRE 253,A00,891867,Vaida; Florin,9994,0,9999,5
1745810980545,CLRE 253,B00,907819,Staff,9999,0,9999,0
1745810981573,CLRE 259,A00,891868,Patel; Hemal,9998,0,9999,1
1745810982599,CLRE 260,A00,891872,Cuomo; Raphael Eduardo,9999,0,9999,0
1745810983624,CLRE 297,001,891888,Cuomo; Raphael Eduardo,9999,0,9999,0
1745810984650,CSE 191,A00,958773,Minnes Kemp; Mor Mia,9999,0,9999,0
1745810985681,CSS 201S,A01,892054,Mignozzetti; Umberto,30,0,30,0
1745810986705,CSS 202S,A01,892056,Mignozzetti; Umberto,30,0,30,0
1745810987730,DSC 197,001,956898,Eldridge; Justin Matthew,9998,0,9999,1
1745810988760,DSC 297,001,958000,Mazumdar; Arya,9998,0,9999,1
1745810989786,EAP 100,A00,905686,Staff,9776,0,9999,223
1745810990812,ECE 45,A01,892618,Staff,0,12,50,50
1745810991842,ECE 109,A01,892620,Staff,0,44,0,0
1745810992867,ECE 111,A01,892719,Staff,0,8,50,50
1745810993898,ECE 197,001,957920,Mercier; Patrick Philip,9992,0,9999,7
1745810994926,ECON 178,A01,907814,Zhu; Ying,28,0,35,7
1745810995953,EDS 115,A00,895312,Staff,41,0,45,4
1745810996977,EDS 117,A01,895337,Staff,30,0,30,0
1745810998050,EDS 125,A00,895341,Jones; Gabrielle Anastasia,43,0,45,2
1745810999077,EDS 128A,A01,895459,Fargason; Sharon Gayle,44,0,45,1
1745811000107,EDS 128B,A01,895543,Pappas; Elizabeth,44,0,45,1
1745811001134,EDS 139,A00,897203,Pappas; Elizabeth,44,0,45,1
1745811001134,EDS 139,B00,897209,Fargason; Sharon Gayle,44,0,45,1
1745811002159,EDS 201,A00,895545,Staff,43,0,45,2
1745811003184,EDS 203,A01,895581,Halter; Christopher P.,43,0,45,2
1745811004210,EDS 204R,A01,895625,Heinzman; Erica M.,43,0,45,2
1745811004210,EDS 204R,B01,895693,Halter; Christopher P.,18,0,45,27
1745811005236,EDS 206R,A00,895694,Fargason; Sharon Gayle,9,0,30,21
1745811005236,EDS 206R,B00,895695,Choi; Bailey Miyeon,20,0,30,10
1745811006263,EDS 250,A00,895697,Hemans; Patricia Ann Benitez,43,0,45,2
1745811007289,EDS 281,A00,895701,Meyerott; Theresa Ann,15,0,15,0
1745811008317,EDS 284,A00,895736,Meyerott; Theresa Ann,15,0,15,0
1745811009343,EDS 286,A00,897210,Fine; Sarah,15,0,15,0
1745811010369,EDS 289C,A01,895770,Daly; Alan J.,15,0,15,0
1745811011397,EDS 290,A00,897211,Hofstetter; Carolyn,15,0,15,0
1745811012426,LIGM 5A,A00,896162,Fischer-Grunski; Eva K,15,0,20,5
1745811013452,LIGM 5B,A00,896260,Fischer-Grunski; Eva K,17,0,20,3
1745811014476,LIGM 5C,A00,896308,Fischer-Grunski; Eva K,18,0,20,2
1745811015506,LIIT 5AS,A00,896313,Carnelos; Chiara,18,0,20,2
1745811016537,LIIT 5BS,A00,896416,Carnelos; Chiara,20,0,20,0
1745811017564,LIIT 5CS,A00,896564,Carnelos; Chiara,20,0,20,0
1745811018594,LISP 5A,A00,896588,Munoz Sanchez; Alicia,4,0,20,16
1745811019621,LISP 5B,A00,896653,Munoz Sanchez; Alicia,10,0,20,10
1745811020651,LISP 5C,A00,896655,Munoz Sanchez; Alicia,4,0,20,16
1745811021680,MAE 197,001,957918,Kleissl; Jan,9998,0,9999,1
1745811022706,MATH 2,A01,957937,Staff,34,0,35,1
1745811023733,MATH 197,001,957876,Kedlaya; Kiran S.,9993,0,9999,6
1745811024759,MCWP 40,A00,892729,Duru; Nur,13,0,20,7
1745811024759,MCWP 40,B00,893304,Montejo; Carolina,20,0,20,0
1745811025790,MCWP 40R,A00,893757,Redela; Pamela Morgan,0,7,20,20
1745811026816,MCWP 50,A00,893758,Morshed; Michael James,2,0,20,18
1745811026816,MCWP 50,B00,893761,Bartulis; Jason Michael,17,0,20,3
1745811027845,MCWP 50R,A00,893766,Compas; Sean Matthew,0,1,20,20
1745811027845,MCWP 50R,B00,893769,Carter; Jennifer A,0,0,20,20
1745811027845,MCWP 50R,C00,893771,Krone; Jarret,0,3,20,20
1745811027845,MCWP 50R,D00,893772,Miller; Elizabeth Deen,3,0,20,17
1745811027845,MCWP 50R,E00,893775,Carter; Andrea L,0,0,20,20
1745811028874,MMW 11R,A01,892721,Herbst; Matthew,11,0,27,16
1745811028874,MMW 11R,A02,892722,Herbst; Matthew,0,0,0,3
1745811029902,MMW 12R,A01,892724,Herbst; Matthew,0,9,16,16
1745811029902,MMW 12R,A02,892725,Herbst; Matthew,0,9,16,16
1745811030929,MMW 13R,A01,892727,Staff,0,4,16,16
1745811030929,MMW 13R,A02,892728,Staff,0,4,16,16
1745811030929,MMW 13R,A03,958032,Staff,0,3,16,16
1745811030929,MMW 13R,A04,958033,Staff,0,2,16,16
1745811030929,MMW 13R,A05,958034,Staff,0,3,16,16
1745811031952,SIO 295LS,A00,894015,Staff,7,0,25,18
1745811032980,SIO 295S,A00,894020,Staff,7,0,25,18
1745811034004,SIOC 290S,B01,958918,Staff,0,0,0,0
1745811035035,SIOC 291S,B01,958922,Staff,0,0,0,0
1745811036062,SOCI 117,A01,895339,Staff,4,0,5,1
1745811037089,WES 237B,A00,894149,Staff,11,0,20,9
1745811039146,AESE 279B,A00,891859,Staff,13,0,35,22
1745811040175,AIP 197,001,891854,Staff,70,0,70,0
1745811041203,ANTH 289S,A00,891856,Gagneux; Pascal,12,0,12,0
1745811042228,BENG 196,001,957946,Engler; Adam J.,9996,0,9999,3
1745811043254,CAT 124RS,A01,956906,Staff,8,0,25,17
1745811044280,CAT 125RS,A01,922013,Staff,8,0,25,17
1745811045306,CLRE 250,A00,891860,Morris; Sheldon,9995,0,9999,4
1745811047355,CLRE 251R,A00,907817,Mehta; Ravindra L.,9994,0,9999,5
1745811048381,CLRE 252,A00,891864,Cuomo; Raphael Eduardo,9993,0,9999,6
1745811049410,CLRE 253,A00,891867,Vaida; Florin,9994,0,9999,5
1745811049410,CLRE 253,B00,907819,Staff,9999,0,9999,0
1745811050436,CLRE 259,A00,891868,Patel; Hemal,9998,0,9999,1
1745811051465,CLRE 260,A00,891872,Cuomo; Raphael Eduardo,9999,0,9999,0
1745811052491,CLRE 297,001,891888,Cuomo; Raphael Eduardo,9999,0,9999,0
1745811053517,CSE 191,A00,958773,Minnes Kemp; Mor Mia,9999,0,9999,0
1745811054542,CSS 201S,A01,892054,Mignozzetti; Umberto,30,0,30,0
1745811055570,CSS 202S,A01,892056,Mignozzetti; Umberto,30,0,30,0
1745811056594,DSC 197,001,956898,Eldridge; Justin Matthew,9998,0,9999,1
1745811057623,DSC 297,001,958000,Mazumdar; Arya,9998,0,9999,1
1745811058647,EAP 100,A00,905686,Staff,9776,0,9999,223
1745811059676,ECE 45,A01,892618,Staff,0,12,50,50
1745811060704,ECE 109,A01,892620,Staff,0,44,0,0
1745811061735,ECE 111,A01,892719,Staff,0,8,50,50
1745811062759,ECE 197,001,957920,Mercier; Patrick Philip,9992,0,9999,7
1745811063784,ECON 178,A01,907814,Zhu; Ying,28,0,35,7
1745811064811,EDS 115,A00,895312,Staff,41,0,45,4
1745811065836,EDS 117,A01,895337,Staff,30,0,30,0
1745811066865,EDS 125,A00,895341,Jones; Gabrielle Anastasia,43,0,45,2
1745811067890,EDS 128A,A01,895459,Fargason; Sharon Gayle,44,0,45,1
1745811068919,EDS 128B,A01,895543,Pappas; Elizabeth,44,0,45,1
1745811069949,EDS 139,A00,897203,Pappas; Elizabeth,44,0,45,1
1745811069949,EDS 139,B00,897209,Fargason; Sharon Gayle,44,0,45,1
1745811070978,EDS 201,A00,895545,Staff,43,0,45,2
1745811072002,EDS 203,A01,895581,Halter; Christopher P.,43,0,45,2
1745811073031,EDS 204R,A01,895625,Heinzman; Erica M.,43,0,45,2
1745811073031,EDS 204R,B01,895693,Halter; Christopher P.,18,0,45,27
1745811074058,EDS 206R,A00,895694,Fargason; Sharon Gayle,9,0,30,21
1745811074058,EDS 206R,B00,895695,Choi; Bailey Miyeon,20,0,30,10
1745811075083,EDS 250,A00,895697,Hemans; Patricia Ann Benitez,43,0,45,2
1745811076114,EDS 281,A00,895701,Meyerott; Theresa Ann,15,0,15,0
1745811077142,EDS 284,A00,895736,Meyerott; Theresa Ann,15,0,15,0
1745811078171,EDS 286,A00,897210,Fine; Sarah,15,0,15,0
1745811079196,EDS 289C,A01,895770,Daly; Alan J.,15,0,15,0
1745811080227,EDS 290,A00,897211,Hofstetter; Carolyn,15,0,15,0
1745811081255,LIGM 5A,A00,896162,Fischer-Grunski; Eva K,15,0,20,5
1745811082282,LIGM 5B,A00,896260,Fischer-Grunski; Eva K,17,0,20,3
1745811083309,LIGM 5C,A00,896308,Fischer-Grunski; Eva K,18,0,20,2
1745811084336,LIIT 5AS,A00,896313,Carnelos; Chiara,18,0,20,2
1745811085362,LIIT 5BS,A00,896416,Carnelos; Chiara,20,0,20,0
1745811086389,LIIT 5CS,A00,896564,Carnelos; Chiara,20,0,20,0
1745811087418,LISP 5A,A00,896588,Munoz Sanchez; Alicia,4,0,20,16
1745811088443,LISP 5B,A00,896653,Munoz Sanchez; Alicia,10,0,20,10
1745811089474,LISP 5C,A00,896655,Munoz Sanchez; Alicia,4,0,20,16
1745811090503,MAE 197,001,957918,Kleissl; Jan,9998,0,9999,1
1745811091530,MATH 2,A01,957937,Staff,34,0,35,1
1745811092557,MATH 197,001,957876,Kedlaya; Kiran S.,9993,0,9999,6
1745811093581,MCWP 40,A00,892729,Duru; Nur,13,0,20,7
1745811093581,MCWP 40,B00,893304,Montejo; Carolina,20,0,20,0
1745811094610,MCWP 40R,A00,893757,Redela; Pamela Morgan,0,7,20,20
1745811095638,MCWP 50,A00,893758,Morshed; Michael James,2,0,20,18
1745811095638,MCWP 50,B00,893761,Bartulis; Jason Michael,17,0,20,3
1745811096667,MCWP 50R,A00,893766,Compas; Sean Matthew,0,1,20,20
1745811096667,MCWP 50R,B00,893769,Carter; Jennifer A,0,0,20,20
1745811096667,MCWP 50R,C00,893771,Krone; Jarret,0,3,20,20
1745811096667,MCWP 50R,D00,893772,Miller; Elizabeth Deen,3,0,20,17
1745811096667,MCWP 50R,E00,893775,Carter; Andrea L,0,0,20,20
1745811097692,MMW 11R,A01,892721,Herbst; Matthew,11,0,27,16
1745811097692,MMW 11R,A02,892722,Herbst; Matthew,0,0,0,3
1745811098718,MMW 12R,A01,892724,Herbst; Matthew,0,9,16,16
1745811098718,MMW 12R,A02,892725,Herbst; Matthew,0,9,16,16
1745811099748,MMW 13R,A01,892727,Staff,0,4,16,16
1745811099748,MMW 13R,A02,892728,Staff,0,4,16,16
1745811099748,MMW 13R,A03,958032,Staff,0,3,16,16
1745811099748,MMW 13R,A04,958033,Staff,0,2,16,16
1745811099748,MMW 13R,A05,958034,Staff,0,3,16,16
1745811100776,SIO 295LS,A00,894015,Staff,7,0,25,18
1745811101806,SIO 295S,A00,894020,Staff,7,0,25,18
1745811102838,SIOC 290S,B01,958918,Staff,0,0,0,0
1745811103863,SIOC 291S,B01,958922,Staff,0,0,0,0
1745811104892,SOCI 117,A01,895339,Staff,4,0,5,1
1745811105919,WES 237B,A00,894149,Staff,11,0,20,9
1745811107976,AESE 279B,A00,891859,Staff,13,0,35,22
1745811109000,AIP 197,001,891854,Staff,70,0,70,0
1745811110032,ANTH 289S,A00,891856,Gagneux; Pascal,12,0,12,0
1745811111059,BENG 196,001,957946,Engler; Adam J.,9996,0,9999,3
1745811112085,CAT 124RS,A01,956906,Staff,8,0,25,17
1745811113112,CAT 125RS,A01,922013,Staff,8,0,25,17
1745811114142,CLRE 250,A00,891860,Morris; Sheldon,9995,0,9999,4
1745811116196,CLRE 251R,A00,907817,Mehta; Ravindra L.,9994,0,9999,5
1745811117226,CLRE 252,A00,891864,Cuomo; Raphael Eduardo,9993,0,9999,6
1745811118253,CLRE 253,A00,891867,Vaida; Florin,9994,0,9999,5
1745811118253,CLRE 253,B00,907819,Staff,9999,0,9999,0
1745811119278,CLRE 259,A00,891868,Patel; Hemal,9998,0,9999,1
1745811120309,CLRE 260,A00,891872,Cuomo; Raphael Eduardo,9999,0,9999,0
1745811121335,CLRE 297,001,891888,Cuomo; Raphael Eduardo,9999,0,9999,0
1745811122364,CSE 191,A00,958773,Minnes Kemp; Mor Mia,9999,0,9999,0
1745811123391,CSS 201S,A01,892054,Mignozzetti; Umberto,30,0,30,0
1745811124423,CSS 202S,A01,892056,Mignozzetti; Umberto,30,0,30,0
1745811125449,DSC 197,001,956898,Eldridge; Justin Matthew,9998,0,9999,1
1745811126473,DSC 297,001,958000,Mazumdar; Arya,9998,0,9999,1
1745811127502,EAP 100,A00,905686,Staff,9776,0,9999,223
1745811128529,ECE 45,A01,892618,Staff,0,12,50,50
1745811129556,ECE 109,A01,892620,Staff,0,44,0,0
1745811130588,ECE 111,A01,892719,Staff,0,8,50,50
1745811131615,ECE 197,001,957920,Mercier; Patrick Philip,9992,0,9999,7
1745811132640,ECON 178,A01,907814,Zhu; Ying,28,0,35,7
1745811133668,EDS 115,A00,895312,Staff,41,0,45,4
1745811134693,EDS 117,A01,895337,Staff,30,0,30,0
1745811135719,EDS 125,A00,895341,Jones; Gabrielle Anastasia,43,0,45,2
1745811136745,EDS 128A,A01,895459,Fargason; Sharon Gayle,44,0,45,1
1745811137771,EDS 128B,A01,895543,Pappas; Elizabeth,44,0,45,1
1745811138798,EDS 139,A00,897203,Pappas; Elizabeth,44,0,45,1
1745811138798,EDS 139,B00,897209,Fargason; Sharon Gayle,44,0,45,1
1745811139824,EDS 201,A00,895545,Staff,43,0,45,2
1745811140853,EDS 203,A01,895581,Halter; Christopher P.,43,0,45,2
1745811141880,EDS 204R,A01,895625,Heinzman; Erica M.,43,0,45,2
1745811141880,EDS 204R,B01,895693,Halter; Christopher P.,18,0,45,27
1745811142907,EDS 206R,A00,895694,Fargason; Sharon Gayle,9,0,30,21
1745811142907,EDS 206R,B00,895695,Choi; Bailey Miyeon,20,0,30,10
1745811143938,EDS 250,A00,895697,Hemans; Patricia Ann Benitez,43,0,45,2
1745811144964,EDS 281,A00,895701,Meyerott; Theresa Ann,15,0,15,0
1745811145992,EDS 284,A00,895736,Meyerott; Theresa Ann,15,0,15,0
1745811147020,EDS 286,A00,897210,Fine; Sarah,15,0,15,0
1745811148047,EDS 289C,A01,895770,Daly; Alan J.,15,0,15,0
1745811149073,EDS 290,A00,897211,Hofstetter; Carolyn,15,0,15,0
1745811150098,LIGM 5A,A00,896162,Fischer-Grunski; Eva K,15,0,20,5
1745811151123,LIGM 5B,A00,896260,Fischer-Grunski; Eva K,17,0,20,3
1745811152151,LIGM 5C,A00,896308,Fischer-Grunski; Eva K,18,0,20,2
1745811153177,LIIT 5AS,A00,896313,Carnelos; Chiara,18,0,20,2
1745811154202,LIIT 5BS,A00,896416,Carnelos; Chiara,20,0,20,0
1745811155230,LIIT 5CS,A00,896564,Carnelos; Chiara,20,0,20,0
1745811156257,LISP 5A,A00,896588,Munoz Sanchez; Alicia,4,0,20,16
1745811157286,LISP 5B,A00,896653,Munoz Sanchez; Alicia,10,0,20,10
1745811158317,LISP 5C,A00,896655,Munoz Sanchez; Alicia,4,0,20,16
1745811159341,MAE 197,001,957918,Kleissl; Jan,9998,0,9999,1
1745811160369,MATH 2,A01,957937,Staff,34,0,35,1
1745811161396,MATH 197,001,957876,Kedlaya; Kiran S.,9993,0,9999,6
1745811162428,MCWP 40,A00,892729,Duru; Nur,13,0,20,7
1745811162428,MCWP 40,B00,893304,Montejo; Carolina,20,0,20,0
1745811163458,MCWP 40R,A00,893757,Redela; Pamela Morgan,0,7,20,20
1745811164486,MCWP 50,A00,893758,Morshed; Michael James,2,0,20,18
1745811164486,MCWP 50,B00,893761,Bartulis; Jason Michael,17,0,20,3
1745811165532,MCWP 50R,A00,893766,Compas; Sean Matthew,0,1,20,20
1745811165532,MCWP 50R,B00,893769,Carter; Jennifer A,0,0,20,20
1745811165532,MCWP 50R,C00,893771,Krone; Jarret,0,3,20,20
1745811165532,MCWP 50R,D00,893772,Miller; Elizabeth Deen,3,0,20,17
1745811165532,MCWP 50R,E00,893775,Carter; Andrea L,0,0,20,20
1745811166559,MMW 11R,A01,892721,Herbst; Matthew,11,0,27,16
1745811166559,MMW 11R,A02,892722,Herbst; Matthew,0,0,0,3
1745811167590,MMW 12R,A01,892724,Herbst; Matthew,0,9,16,16
1745811167590,MMW 12R,A02,892725,Herbst; Matthew,0,9,16,16
1745811168617,MMW 13R,A01,892727,Staff,0,4,16,16
1745811168617,MMW 13R,A02,892728,Staff,0,4,16,16
1745811168617,MMW 13R,A03,958032,Staff,0,3,16,16
1745811168617,MMW 13R,A04,958033,Staff,0,2,16,16
1745811168617,MMW 13R,A05,958034,Staff,0,3,16,16
1745811169643,SIO 295LS,A00,894015,Staff,7,0,25,18
1745811170666,SIO 295S,A00,894020,Staff,7,0,25,18
1745811171694,SIOC 290S,B01,958918,Staff,0,0,0,0
1745811172719,SIOC 291S,B01,958922,Staff,0,0,0,0
1745811173743,SOCI 117,A01,895339,Staff,4,0,5,1
1745811174768,WES 237B,A00,894149,Staff,11,0,20,9
1745811176822,AESE 279B,A00,891859,Staff,13,0,35,22
1745811177846,AIP 197,001,891854,Staff,70,0,70,0
1745811178869,ANTH 289S,A00,891856,Gagneux; Pascal,12,0,12,0
1745811179898,BENG 196,001,957946,Engler; Adam J.,9996,0,9999,3
1745811180922,CAT 124RS,A01,956906,Staff,8,0,25,17
1745811181948,CAT 125RS,A01,922013,Staff,8,0,25,17
1745811182976,CLRE 250,A00,891860,Morris; Sheldon,9995,0,9999,4
1745811185029,CLRE 251R,A00,907817,Mehta; Ravindra L.,9994,0,9999,5
1745811186056,CLRE 252,A00,891864,Cuomo; Raphael Eduardo,9993,0,9999,6
1745811187081,CLRE 253,A00,891867,Vaida; Florin,9994,0,9999,5
1745811187081,CLRE 253,B00,907819,Staff,9999,0,9999,0
1745811188110,CLRE 259,A00,891868,Patel; Hemal,9998,0,9999,1
1745811189136,CLRE 260,A00,891872,Cuomo; Raphael Eduardo,9999,0,9999,0
1745811190163,CLRE 297,001,891888,Cuomo; Raphael Eduardo,9999,0,9999,0
1745811191191,CSE 191,A00,958773,Minnes Kemp; Mor Mia,9999,0,9999,0
1745811192219,CSS 201S,A01,892054,Mignozzetti; Umberto,30,0,30,0
1745811193248,CSS 202S,A01,892056,Mignozzetti; Umberto,30,0,30,0
1745811194272,DSC 197,001,956898,Eldridge; Justin Matthew,9998,0,9999,1
1745811195299,DSC 297,001,958000,Mazumdar; Arya,9998,0,9999,1
1745811196322,EAP 100,A00,905686,Staff,9776,0,9999,223
1745811197347,ECE 45,A01,892618,Staff,0,12,50,50
1745811198372,ECE 109,A01,892620,Staff,0,44,0,0
1745811199399,ECE 111,A01,892719,Staff,0,8,50,50
1745811200425,ECE 197,001,957920,Mercier; Patrick Philip,9992,0,9999,7
1745811201456,ECON 178,A01,907814,Zhu; Ying,28,0,35,7
1745811202481,EDS 115,A00,895312,Staff,41,0,45,4
1745811203509,EDS 117,A01,895337,Staff,30,0,30,0
1745811204535,EDS 125,A00,895341,Jones; Gabrielle Anastasia,43,0,45,2
1745811205559,EDS 128A,A01,895459,Fargason; Sharon Gayle,44,0,45,1
1745811206588,EDS 128B,A01,895543,Pappas; Elizabeth,44,0,45,1
1745811207617,EDS 139,A00,897203,Pappas; Elizabeth,44,0,45,1
1745811207617,EDS 139,B00,897209,Fargason; Sharon Gayle,44,0,45,1
1745811208642,EDS 201,A00,895545,Staff,43,0,45,2
1745811209671,EDS 203,A01,895581,Halter; Christopher P.,43,0,45,2
1745811210696,EDS 204R,A01,895625,Heinzman; Erica M.,43,0,45,2
1745811210696,EDS 204R,B01,895693,Halter; Christopher P.,18,0,45,27
1745811211725,EDS 206R,A00,895694,Fargason; Sharon Gayle,9,0,30,21
1745811211725,EDS 206R,B00,895695,Choi; Bailey Miyeon,20,0,30,10
1745811212755,EDS 250,A00,895697,Hemans; Patricia Ann Benitez,43,0,45,2
1745811213783,EDS 281,A00,895701,Meyerott; Theresa Ann,15,0,15,0
1745811214807,EDS 284,A00,895736,Meyerott; Theresa Ann,15,0,15,0
1745811215835,EDS 286,A00,897210,Fine; Sarah,15,0,15,0
1745811216858,EDS 289C,A01,895770,Daly; Alan J.,15,0,15,0
1745811217887,EDS 290,A00,897211,Hofstetter; Carolyn,15,0,15,0
1745811218916,LIGM 5A,A00,896162,Fischer-Grunski; Eva K,15,0,20,5
1745811219947,LIGM 5B,A00,896260,Fischer-Grunski; Eva K,17,0,20,3
1745811220971,LIGM 5C,A00,896308,Fischer-Grunski; Eva K,18,0,20,2
1745811221997,LIIT 5AS,A00,896313,Carnelos; Chiara,18,0,20,2
1745811223024,LIIT 5BS,A00,896416,Carnelos; Chiara,20,0,20,0
1745811224052,LIIT 5CS,A00,896564,Carnelos; Chiara,20,0,20,0
1745811225080,LISP 5A,A00,896588,Munoz Sanchez; Alicia,4,0,20,16
1745811226107,LISP 5B,A00,896653,Munoz Sanchez; Alicia,10,0,20,10
1745811227136,LISP 5C,A00,896655,Munoz Sanchez; Alicia,4,0,20,16
1745811228162,MAE 197,001,957918,Kleissl; Jan,9998,0,9999,1
1745811229190,MATH 2,A01,957937,Staff,34,0,35,1
1745811230218,MATH 197,001,957876,Kedlaya; Kiran S.,9993,0,9999,6
1745811231247,MCWP 40,A00,892729,Duru; Nur,13,0,20,7
1745811231247,MCWP 40,B00,893304,Montejo; Carolina,20,0,20,0
1745811232278,MCWP 40R,A00,893757,Redela; Pamela Morgan,0,7,20,20
1745811233308,MCWP 50,A00,893758,Morshed; Michael James,2,0,20,18
1745811233308,MCWP 50,B00,893761,Bartulis; Jason Michael,17,0,20,3
1745811234337,MCWP 50R,A00,893766,Compas; Sean Matthew,0,1,20,20
1745811234337,MCWP 50R,B00,893769,Carter; Jennifer A,0,0,20,20
1745811234337,MCWP 50R,C00,893771,Krone; Jarret,0,3,20,20
1745811234337,MCWP 50R,D00,893772,Miller; Elizabeth Deen,3,0,20,17
1745811234337,MCWP 50R,E00,893775,Carter; Andrea L,0,0,20,20
1745811235367,MMW 11R,A01,892721,Herbst; Matthew,11,0,27,16
1745811235367,MMW 11R,A02,892722,Herbst; Matthew,0,0,0,3
1745811236395,MMW 12R,A01,892724,Herbst; Matthew,0,9,16,16
1745811236395,MMW 12R,A02,892725,Herbst; Matthew,0,9,16,16
1745811237423,MMW 13R,A01,892727,Staff,0,4,16,16
1745811237423,MMW 13R,A02,892728,Staff,0,4,16,16
1745811237423,MMW 13R,A03,958032,Staff,0,3,16,16
1745811237423,MMW 13R,A04,958033,Staff,0,2,16,16
1745811237423,MMW 13R,A05,958034,Staff,0,3,16,16
1745811238453,SIO 295LS,A00,894015,Staff,7,0,25,18
1745811239479,SIO 295S,A00,894020,Staff,7,0,25,18
1745811240506,SIOC 290S,B01,958918,Staff,0,0,0,0
1745811241534,SIOC 291S,B01,958922,Staff,0,0,0,0
1745811242563,SOCI 117,A01,895339,Staff,4,0,5,1
1745811243590,WES 237B,A00,894149,Staff,11,0,20,9
1745811245651,AESE 279B,A00,891859,Staff,13,0,35,22
1745811246677,AIP 197,001,891854,Staff,70,0,70,0
1745811247704,ANTH 289S,A00,891856,Gagneux; Pascal,12,0,12,0
1745811248729,BENG 196,001,957946,Engler; Adam J.,9996,0,9999,3
1745811249756,CAT 124RS,A01,956906,Staff,8,0,25,17
1745811250784,CAT 125RS,A01,922013,Staff,8,0,25,17
1745811251810,CLRE 250,A00,891860,Morris; Sheldon,9995,0,9999,4
1745811253860,CLRE 251R,A00,907817,Mehta; Ravindra L.,9994,0,9999,5
1745811254890,CLRE 252,A00,891864,Cuomo; Raphael Eduardo,9993,0,9999,6
1745811255920,CLRE 253,A00,891867,Vaida; Florin,9994,0,9999,5
1745811255920,CLRE 253,B00,907819,Staff,9999,0,9999,0
1745811257011,CLRE 259,A00,891868,Patel; Hemal,9998,0,9999,1
1745811258034,CLRE 260,A00,891872,Cuomo; Raphael Eduardo,9999,0,9999,0
1745811259061,CLRE 297,001,891888,Cuomo; Raphael Eduardo,9999,0,9999,0
1745811260088,CSE 191,A00,958773,Minnes Kemp; Mor Mia,9999,0,9999,0
1745811261116,CSS 201S,A01,892054,Mignozzetti; Umberto,30,0,30,0
1745811262145,CSS 202S,A01,892056,Mignozzetti; Umberto,30,0,30,0
1745811263174,DSC 197,001,956898,Eldridge; Justin Matthew,9998,0,9999,1
1745811264199,DSC 297,001,958000,Mazumdar; Arya,9998,0,9999,1
1745811265225,EAP 100,A00,905686,Staff,9776,0,9999,223
1745811266249,ECE 45,A01,892618,Staff,0,12,50,50
1745811267277,ECE 109,A01,892620,Staff,0,44,0,0
1745811268303,ECE 111,A01,892719,Staff,0,8,50,50
1745811269327,ECE 197,001,957920,Mercier; Patrick Philip,9992,0,9999,7
1745811270360,ECON 178,A01,907814,Zhu; Ying,28,0,35,7
1745811271388,EDS 115,A00,895312,Staff,41,0,45,4
1745811272414,EDS 117,A01,895337,Staff,30,0,30,0
1745811273440,EDS 125,A00,895341,Jones; Gabrielle Anastasia,43,0,45,2
1745811274469,EDS 128A,A01,895459,Fargason; Sharon Gayle,44,0,45,1
1745811275498,EDS 128B,A01,895543,Pappas; Elizabeth,44,0,45,1
1745811276527,EDS 139,A00,897203,Pappas; Elizabeth,44,0,45,1
1745811276527,EDS 139,B00,897209,Fargason; Sharon Gayle,44,0,45,1
1745811277556,EDS 201,A00,895545,Staff,43,0,45,2
1745811278584,EDS 203,A01,895581,Halter; Christopher P.,43,0,45,2
1745811279610,EDS 204R,A01,895625,Heinzman; Erica M.,43,0,45,2
1745811279610,EDS 204R,B01,895693,Halter; Christopher P.,18,0,45,27
1745811280633,EDS 206R,A00,895694,Fargason; Sharon Gayle,9,0,30,21
1745811280633,EDS 206R,B00,895695,Choi; Bailey Miyeon,20,0,30,10
1745811281661,EDS 250,A00,895697,Hemans; Patricia Ann Benitez,43,0,45,2
1745811282685,EDS 281,A00,895701,Meyerott; Theresa Ann,15,0,15,0
1745811283709,EDS 284,A00,895736,Meyerott; Theresa Ann,15,0,15,0
1745811284735,EDS 286,A00,897210,Fine; Sarah,15,0,15,0
1745811285762,EDS 289C,A01,895770,Daly; Alan J.,15,0,15,0
1745811286785,EDS 290,A00,897211,Hofstetter; Carolyn,15,0,15,0
1745811287811,LIGM 5A,A00,896162,Fischer-Grunski; Eva K,15,0,20,5
1745811288837,LIGM 5B,A00,896260,Fischer-Grunski; Eva K,17,0,20,3
1745811289862,LIGM 5C,A00,896308,Fischer-Grunski; Eva K,18,0,20,2
1745811290888,LIIT 5AS,A00,896313,Carnelos; Chiara,18,0,20,2
1745811291916,LIIT 5BS,A00,896416,Carnelos; Chiara,20,0,20,0
1745811292948,LIIT 5CS,A00,896564,Carnelos; Chiara,20,0,20,0
1745811293973,LISP 5A,A00,896588,Munoz Sanchez; Alicia,4,0,20,16
1745811295001,LISP 5B,A00,896653,Munoz Sanchez; Alicia,10,0,20,10
1745811296030,LISP 5C,A00,896655,Munoz Sanchez; Alicia,4,0,20,16
1745811297060,MAE 197,001,957918,Kleissl; Jan,9998,0,9999,1
1745811298090,MATH 2,A01,957937,Staff,34,0,35,1
1745811299116,MATH 197,001,957876,Kedlaya; Kiran S.,9993,0,9999,6
1745811300143,MCWP 40,A00,892729,Duru; Nur,13,0,20,7
1745811300143,MCWP 40,B00,893304,Montejo; Carolina,20,0,20,0
1745811301167,MCWP 40R,A00,893757,Redela; Pamela Morgan,0,7,20,20
1745811302203,MCWP 50,A00,893758,Morshed; Michael James,2,0,20,18
1745811302203,MCWP 50,B00,893761,Bartulis; Jason Michael,17,0,20,3
1745811303234,MCWP 50R,A00,893766,Compas; Sean Matthew,0,1,20,20
1745811303234,MCWP 50R,B00,893769,Carter; Jennifer A,0,0,20,20
1745811303234,MCWP 50R,C00,893771,Krone; Jarret,0,3,20,20
1745811303234,MCWP 50R,D00,893772,Miller; Elizabeth Deen,3,0,20,17
1745811303234,MCWP 50R,E00,893775,Carter; Andrea L,0,0,20,20
1745811304262,MMW 11R,A01,892721,Herbst; Matthew,11,0,27,16
1745811304262,MMW 11R,A02,892722,Herbst; Matthew,0,0,0,3
1745811305289,MMW 12R,A01,892724,Herbst; Matthew,0,9,16,16
1745811305289,MMW 12R,A02,892725,Herbst; Matthew,0,9,16,16
1745811306316,MMW 13R,A01,892727,Staff,0,4,16,16
1745811306316,MMW 13R,A02,892728,Staff,0,4,16,16
1745811306316,MMW 13R,A03,958032,Staff,0,3,16,16
1745811306316,MMW 13R,A04,958033,Staff,0,2,16,16
1745811306316,MMW 13R,A05,958034,Staff,0,3,16,16
1745811307342,SIO 295LS,A00,894015,Staff,7,0,25,18
1745811308371,SIO 295S,A00,894020,Staff,7,0,25,18
1745811309398,SIOC 290S,B01,958918,Staff,0,0,0,0
1745811310427,SIOC 291S,B01,958922,Staff,0,0,0,0
1745811311457,SOCI 117,A01,895339,Staff,4,0,5,1
1745811312482,WES 237B,A00,894149,Staff,11,0,20,9
1745811314546,AESE 279B,A00,891859,Staff,13,0,35,22
1745811315572,AIP 197,001,891854,Staff,70,0,70,0
1745811316601,ANTH 289S,A00,891856,Gagneux; Pascal,12,0,12,0
1745811317628,BENG 196,001,957946,Engler; Adam J.,9996,0,9999,3
1745811318656,CAT 124RS,A01,956906,Staff,8,0,25,17
1745811319683,CAT 125RS,A01,922013,Staff,8,0,25,17
1745811320708,CLRE 250,A00,891860,Morris; Sheldon,9995,0,9999,4
1745811322764,CLRE 251R,A00,907817,Mehta; Ravindra L.,9994,0,9999,5
1745811323789,CLRE 252,A00,891864,Cuomo; Raphael Eduardo,9993,0,9999,6
1745811324815,CLRE 253,A00,891867,Vaida; Florin,9994,0,9999,5
1745811324815,CLRE 253,B00,907819,Staff,9999,0,9999,0
1745811325842,CLRE 259,A00,891868,Patel; Hemal,9998,0,9999,1
1745811326871,CLRE 260,A00,891872,Cuomo; Raphael Eduardo,9999,0,9999,0
1745811327903,CLRE 297,001,891888,Cuomo; Raphael Eduardo,9999,0,9999,0
1745811328930,CSE 191,A00,958773,Minnes Kemp; Mor Mia,9999,0,9999,0
1745811329960,CSS 201S,A01,892054,Mignozzetti; Umberto,30,0,30,0
1745811330989,CSS 202S,A01,892056,Mignozzetti; Umberto,30,0,30,0
1745811332015,DSC 197,001,956898,Eldridge; Justin Matthew,9998,0,9999,1
1745811333042,DSC 297,001,958000,Mazumdar; Arya,9998,0,9999,1
1745811334070,EAP 100,A00,905686,Staff,9776,0,9999,223
1745811335097,ECE 45,A01,892618,Staff,0,12,50,50
1745811336124,ECE 109,A01,892620,Staff,0,44,0,0
1745811337154,ECE 111,A01,892719,Staff,0,8,50,50
1745811338181,ECE 197,001,957920,Mercier; Patrick Philip,9992,0,9999,7
1745811339208,ECON 178,A01,907814,Zhu; Ying,28,0,35,7
1745811340236,EDS 115,A00,895312,Staff,41,0,45,4
1745811341263,EDS 117,A01,895337,Staff,30,0,30,0
1745811342289,EDS 125,A00,895341,Jones; Gabrielle Anastasia,43,0,45,2
1745811343316,EDS 128A,A01,895459,Fargason; Sharon Gayle,44,0,45,1
1745811344344,EDS 128B,A01,895543,Pappas; Elizabeth,44,0,45,1
1745811345373,EDS 139,A00,897203,Pappas; Elizabeth,44,0,45,1
1745811345373,EDS 139,B00,897209,Fargason; Sharon Gayle,44,0,45,1
1745811346402,EDS 201,A00,895545,Staff,43,0,45,2
1745811347427,EDS 203,A01,895581,Halter; Christopher P.,43,0,45,2
1745811348454,EDS 204R,A01,895625,Heinzman; Erica M.,43,0,45,2
1745811348454,EDS 204R,B01,895693,Halter; Christopher P.,18,0,45,27
1745811349479,EDS 206R,A00,895694,Fargason; Sharon Gayle,9,0,30,21
1745811349479,EDS 206R,B00,895695,Choi; Bailey Miyeon,20,0,30,10
1745811350509,EDS 250,A00,895697,Hemans; Patricia Ann Benitez,43,0,45,2
1745811351539,EDS 281,A00,895701,Meyerott; Theresa Ann,15,0,15,0
1745811352566,EDS 284,A00,895736,Meyerott; Theresa Ann,15,0,15,0
1745811353592,EDS 286,A00,897210,Fine; Sarah,15,0,15,0
1745811354618,EDS 289C,A01,895770,Daly; Alan J.,15,0,15,0
1745811355643,EDS 290,A00,897211,Hofstetter; Carolyn,15,0,15,0
1745811356672,LIGM 5A,A00,896162,Fischer-Grunski; Eva K,15,0,20,5
1745811357701,LIGM 5B,A00,896260,Fischer-Grunski; Eva K,17,0,20,3
1745811358726,LIGM 5C,A00,896308,Fischer-Grunski; Eva K,18,0,20,2
1745811359753,LIIT 5AS,A00,896313,Carnelos; Chiara,18,0,20,2
1745811360783,LIIT 5BS,A00,896416,Carnelos; Chiara,20,0,20,0
1745811361818,LIIT 5CS,A00,896564,Carnelos; Chiara,20,0,20,0
1745811362848,LISP 5A,A00,896588,Munoz Sanchez; Alicia,4,0,20,16
1745811363877,LISP 5B,A00,896653,Munoz Sanchez; Alicia,10,0,20,10
1745811364908,LISP 5C,A00,896655,Munoz Sanchez; Alicia,4,0,20,16
1745811365932,MAE 197,001,957918,Kleissl; Jan,9998,0,9999,1
1745811366957,MATH 2,A01,957937,Staff,34,0,35,1
1745811367984,MATH 197,001,957876,Kedlaya; Kiran S.,9993,0,9999,6
1745811369009,MCWP 40,A00,892729,Duru; Nur,13,0,20,7
1745811369009,MCWP 40,B00,893304,Montejo; Carolina,20,0,20,0
1745811370035,MCWP 40R,A00,893757,Redela; Pamela Morgan,0,7,20,20
1745811371060,MCWP 50,A00,893758,Morshed; Michael James,2,0,20,18
1745811371060,MCWP 50,B00,893761,Bartulis; Jason Michael,17,0,20,3
1745811372089,MCWP 50R,A00,893766,Compas; Sean Matthew,0,1,20,20
1745811372089,MCWP 50R,B00,893769,Carter; Jennifer A,0,0,20,20
1745811372089,MCWP 50R,C00,893771,Krone; Jarret,0,3,20,20
1745811372089,MCWP 50R,D00,893772,Miller; Elizabeth Deen,3,0,20,17
1745811372089,MCWP 50R,E00,893775,Carter; Andrea L,0,0,20,20
1745811373117,MMW 11R,A01,892721,Herbst; Matthew,11,0,27,16
1745811373117,MMW 11R,A02,892722,Herbst; Matthew,0,0,0,3
1745811374145,MMW 12R,A01,892724,Herbst; Matthew,0,9,16,16
1745811374145,MMW 12R,A02,892725,Herbst; Matthew,0,9,16,16
1745811375173,MMW 13R,A01,892727,Staff,0,4,16,16
1745811375173,MMW 13R,A02,892728,Staff,0,4,16,16
1745811375173,MMW 13R,A03,958032,Staff,0,3,16,16
1745811375173,MMW 13R,A04,958033,Staff,0,2,16,16
1745811375173,MMW 13R,A05,958034,Staff,0,3,16,16
1745811376199,SIO 295LS,A00,894015,Staff,7,0,25,18
1745811377228,SIO 295S,A00,894020,Staff,7,0,25,18
1745811378259,SIOC 290S,B01,958918,Staff,0,0,0,0
1745811379290,SIOC 291S,B01,958922,Staff,0,0,0,0
1745811380318,SOCI 117,A01,895339,Staff,4,0,5,1
1745811381343,WES 237B,A00,894149,Staff,11,0,20,9
1745811383397,AESE 279B,A00,891859,Staff,13,0,35,22
1745811384423,AIP 197,001,891854,Staff,70,0,70,0
1745811385449,ANTH 289S,A00,891856,Gagneux; Pascal,12,0,12,0
1745811386475,BENG 196,001,957946,Engler; Adam J.,9996,0,9999,3
1745811387501,CAT 124RS,A01,956906,Staff,8,0,25,17
1745811388524,CAT 125RS,A01,922013,Staff,8,0,25,17
1745811389550,CLRE 250,A00,891860,Morris; Sheldon,9995,0,9999,4
1745811391601,CLRE 251R,A00,907817,Mehta; Ravindra L.,9994,0,9999,5
1745811392628,CLRE 252,A00,891864,Cuomo; Raphael Eduardo,9993,0,9999,6
1745811393653,CLRE 253,A00,891867,Vaida; Florin,9994,0,9999,5
1745811393653,CLRE 253,B00,907819,Staff,9999,0,9999,0
1745811394677,CLRE 259,A00,891868,Patel; Hemal,9998,0,9999,1
1745811395702,CLRE 260,A00,891872,Cuomo; Raphael Eduardo,9999,0,9999,0
1745811396729,CLRE 297,001,891888,Cuomo; Raphael Eduardo,9999,0,9999,0
1745811397755,CSE 191,A00,958773,Minnes Kemp; Mor Mia,9999,0,9999,0
1745811398780,CSS 201S,A01,892054,Mignozzetti; Umberto,30,0,30,0
1745811399807,CSS 202S,A01,892056,Mignozzetti; Umberto,30,0,30,0
1745811400831,DSC 197,001,956898,Eldridge; Justin Matthew,9998,0,9999,1
1745811401860,DSC 297,001,958000,Mazumdar; Arya,9998,0,9999,1
1745811402889,EAP 100,A00,905686,Staff,9776,0,9999,223
1745811403914,ECE 45,A01,892618,Staff,0,12,50,50
1745811404943,ECE 109,A01,892620,Staff,0,44,0,0
1745811405972,ECE 111,A01,892719,Staff,0,8,50,50
1745811406997,ECE 197,001,957920,Mercier; Patrick Philip,9992,0,9999,7
1745811408033,ECON 178,A01,907814,Zhu; Ying,28,0,35,7
1745811409061,EDS 115,A00,895312,Staff,41,0,45,4
1745811410091,EDS 117,A01,895337,Staff,30,0,30,0
1745811411117,EDS 125,A00,895341,Jones; Gabrielle Anastasia,43,0,45,2
1745811412145,EDS 128A,A01,895459,Fargason; Sharon Gayle,44,0,45,1
1745811413176,EDS 128B,A01,895543,Pappas; Elizabeth,44,0,45,1
1745811414203,EDS 139,A00,897203,Pappas; Elizabeth,44,0,45,1
1745811414203,EDS 139,B00,897209,Fargason; Sharon Gayle,44,0,45,1
1745811415229,EDS 201,A00,895545,Staff,43,0,45,2
1745811416261,EDS 203,A01,895581,Halter; Christopher P.,43,0,45,2
1745811417289,EDS 204R,A01,895625,Heinzman; Erica M.,43,0,45,2
1745811417289,EDS 204R,B01,895693,Halter; Christopher P.,18,0,45,27
1745811418350,EDS 206R,A00,895694,Fargason; Sharon Gayle,9,0,30,21
1745811418350,EDS 206R,B00,895695,Choi; Bailey Miyeon,20,0,30,10
1745811419378,EDS 250,A00,895697,Hemans; Patricia Ann Benitez,43,0,45,2
1745811420403,EDS 281,A00,895701,Meyerott; Theresa Ann,15,0,15,0
1745811421430,EDS 284,A00,895736,Meyerott; Theresa Ann,15,0,15,0
1745811422456,EDS 286,A00,897210,Fine; Sarah,15,0,15,0
1745811423483,EDS 289C,A01,895770,Daly; Alan J.,15,0,15,0
1745811424511,EDS 290,A00,897211,Hofstetter; Carolyn,15,0,15,0
1745811425537,LIGM 5A,A00,896162,Fischer-Grunski; Eva K,15,0,20,5
1745811426563,LIGM 5B,A00,896260,Fischer-Grunski; Eva K,17,0,20,3
1745811427591,LIGM 5C,A00,896308,Fischer-Grunski; Eva K,18,0,20,2
1745811428619,LIIT 5AS,A00,896313,Carnelos; Chiara,18,0,20,2
1745811429645,LIIT 5BS,A00,896416,Carnelos; Chiara,20,0,20,0
1745811430671,LIIT 5CS,A00,896564,Carnelos; Chiara,20,0,20,0
1745811431701,LISP 5A,A00,896588,Munoz Sanchez; Alicia,4,0,20,16
1745811432729,LISP 5B,A00,896653,Munoz Sanchez; Alicia,10,0,20,10
1745811433754,LISP 5C,A00,896655,Munoz Sanchez; Alicia,4,0,20,16
1745811434780,MAE 197,001,957918,Kleissl; Jan,9998,0,9999,1
1745811435809,MATH 2,A01,957937,Staff,34,0,35,1
1745811436834,MATH 197,001,957876,Kedlaya; Kiran S.,9993,0,9999,6
1745811437864,MCWP 40,A00,892729,Duru; Nur,13,0,20,7
1745811437864,MCWP 40,B00,893304,Montejo; Carolina,20,0,20,0
1745811438891,MCWP 40R,A00,893757,Redela; Pamela Morgan,0,7,20,20
1745811439919,MCWP 50,A00,893758,Morshed; Michael James,2,0,20,18
1745811439919,MCWP 50,B00,893761,Bartulis; Jason Michael,17,0,20,3
1745811440946,MCWP 50R,A00,893766,Compas; Sean Matthew,0,1,20,20
1745811440946,MCWP 50R,B00,893769,Carter; Jennifer A,0,0,20,20
1745811440946,MCWP 50R,C00,893771,Krone; Jarret,0,3,20,20
1745811440946,MCWP 50R,D00,893772,Miller; Elizabeth Deen,3,0,20,17
1745811440946,MCWP 50R,E00,893775,Carter; Andrea L,0,0,20,20
1745811441972,MMW 11R,A01,892721,Herbst; Matthew,11,0,27,16
1745811441972,MMW 11R,A02,892722,Herbst; Matthew,0,0,0,3
1745811442999,MMW 12R,A01,892724,Herbst; Matthew,0,9,16,16
1745811442999,MMW 12R,A02,892725,Herbst; Matthew,0,9,16,16
1745811444028,MMW 13R,A01,892727,Staff,0,4,16,16
1745811444028,MMW 13R,A02,892728,Staff,0,4,16,16
1745811444028,MMW 13R,A03,958032,Staff,0,3,16,16
1745811444028,MMW 13R,A04,958033,Staff,0,2,16,16
1745811444028,MMW 13R,A05,958034,Staff,0,3,16,16
1745811445054,SIO 295LS,A00,894015,Staff,7,0,25,18
1745811446082,SIO 295S,A00,894020,Staff,7,0,25,18
1745811447111,SIOC 290S,B01,958918,Staff,0,0,0,0
1745811448138,SIOC 291S,B01,958922,Staff,0,0,0,0
1745811449166,SOCI 117,A01,895339,Staff,4,0,5,1
1745811450192,WES 237B,A00,894149,Staff,11,0,20,9
1745811452250,AESE 279B,A00,891859,Staff,13,0,35,22
1745811453275,AIP 197,001,891854,Staff,70,0,70,0
1745811454304,ANTH 289S,A00,891856,Gagneux; Pascal,12,0,12,0
1745811455332,BENG 196,001,957946,Engler; Adam J.,9996,0,9999,3
1745811456358,CAT 124RS,A01,956906,Staff,8,0,25,17
1745811457385,CAT 125RS,A01,922013,Staff,8,0,25,17
1745811458413,CLRE 250,A00,891860,Morris; Sheldon,9995,0,9999,4
1745811460468,CLRE 251R,A00,907817,Mehta; Ravindra L.,9994,0,9999,5
1745811461499,CLRE 252,A00,891864,Cuomo; Raphael Eduardo,9993,0,9999,6
1745811462527,CLRE 253,A00,891867,Vaida; Florin,9994,0,9999,5
1745811462527,CLRE 253,B00,907819,Staff,9999,0,9999,0
1745811463553,CLRE 259,A00,891868,Patel; Hemal,9998,0,9999,1
1745811464581,CLRE 260,A00,891872,Cuomo; Raphael Eduardo,9999,0,9999,0
1745811465624,CLRE 297,001,891888,Cuomo; Raphael Eduardo,9999,0,9999,0
1745811466651,CSE 191,A00,958773,Minnes Kemp; Mor Mia,9999,0,9999,0
1745811467678,CSS 201S,A01,892054,Mignozzetti; Umberto,30,0,30,0
1745811468709,CSS 202S,A01,892056,Mignozzetti; Umberto,30,0,30,0
1745811469736,DSC 197,001,956898,Eldridge; Justin Matthew,9998,0,9999,1
1745811470761,DSC 297,001,958000,Mazumdar; Arya,9998,0,9999,1
1745811471788,EAP 100,A00,905686,Staff,9776,0,9999,223
1745811472818,ECE 45,A01,892618,Staff,0,12,50,50
1745811473845,ECE 109,A01,892620,Staff,0,44,0,0
1745811474874,ECE 111,A01,892719,Staff,0,8,50,50
1745811475899,ECE 197,001,957920,Mercier; Patrick Philip,9992,0,9999,7
1745811476926,ECON 178,A01,907814,Zhu; Ying,28,0,35,7
1745811477952,EDS 115,A00,895312,Staff,41,0,45,4
1745811478980,EDS 117,A01,895337,Staff,30,0,30,0
1745811480008,EDS 125,A00,895341,Jones; Gabrielle Anastasia,43,0,45,2
1745811481034,EDS 128A,A01,895459,Fargason; Sharon Gayle,44,0,45,1
1745811482063,EDS 128B,A01,895543,Pappas; Elizabeth,44,0,45,1
1745811483092,EDS 139,A00,897203,Pappas; Elizabeth,44,0,45,1
1745811483092,EDS 139,B00,897209,Fargason; Sharon Gayle,44,0,45,1
1745811484116,EDS 201,A00,895545,Staff,43,0,45,2
1745811485142,EDS 203,A01,895581,Halter; Christopher P.,43,0,45,2
1745811486169,EDS 204R,A01,895625,Heinzman; Erica M.,43,0,45,2
1745811486169,EDS 204R,B01,895693,Halter; Christopher P.,18,0,45,27
1745811487194,EDS 206R,A00,895694,Fargason; Sharon Gayle,9,0,30,21
1745811487194,EDS 206R,B00,895695,Choi; Bailey Miyeon,20,0,30,10
1745811488220,EDS 250,A00,895697,Hemans; Patricia Ann Benitez,43,0,45,2
1745811489247,EDS 281,A00,895701,Meyerott; Theresa Ann,15,0,15,0
1745811490272,EDS 284,A00,895736,Meyerott; Theresa Ann,15,0,15,0
1745811491301,EDS 286,A00,897210,Fine; Sarah,15,0,15,0
1745811492327,EDS 289C,A01,895770,Daly; Alan J.,15,0,15,0
1745811493352,EDS 290,A00,897211,Hofstetter; Carolyn,15,0,15,0
1745811494381,LIGM 5A,A00,896162,Fischer-Grunski; Eva K,15,0,20,5
1745811495410,LIGM 5B,A00,896260,Fischer-Grunski; Eva K,17,0,20,3
1745811496435,LIGM 5C,A00,896308,Fischer-Grunski; Eva K,18,0,20,2
1745811497460,LIIT 5AS,A00,896313,Carnelos; Chiara,18,0,20,2
1745811498484,LIIT 5BS,A00,896416,Carnelos; Chiara,20,0,20,0
1745811499514,LIIT 5CS,A00,896564,Carnelos; Chiara,20,0,20,0
1745811500542,LISP 5A,A00,896588,Munoz Sanchez; Alicia,4,0,20,16
1745811501568,LISP 5B,A00,896653,Munoz Sanchez; Alicia,10,0,20,10
1745811502593,LISP 5C,A00,896655,Munoz Sanchez; Alicia,4,0,20,16
1745811503620,MAE 197,001,957918,Kleissl; Jan,9998,0,9999,1
1745811504648,MATH 2,A01,957937,Staff,34,0,35,1
1745811505672,MATH 197,001,957876,Kedlaya; Kiran S.,9993,0,9999,6
1745811506697,MCWP 40,A00,892729,Duru; Nur,13,0,20,7
1745811506697,MCWP 40,B00,893304,Montejo; Carolina,20,0,20,0
1745811507722,MCWP 40R,A00,893757,Redela; Pamela Morgan,0,7,20,20
1745811508747,MCWP 50,A00,893758,Morshed; Michael James,2,0,20,18
1745811508747,MCWP 50,B00,893761,Bartulis; Jason Michael,17,0,20,3
1745811509773,MCWP 50R,A00,893766,Compas; Sean Matthew,0,1,20,20
1745811509773,MCWP 50R,B00,893769,Carter; Jennifer A,0,0,20,20
1745811509773,MCWP 50R,C00,893771,Krone; Jarret,0,3,20,20
1745811509773,MCWP 50R,D00,893772,Miller; Elizabeth Deen,3,0,20,17
1745811509773,MCWP 50R,E00,893775,Carter; Andrea L,0,0,20,20
1745811510803,MMW 11R,A01,892721,Herbst; Matthew,11,0,27,16
1745811510803,MMW 11R,A02,892722,Herbst; Matthew,0,0,0,3
1745811511829,MMW 12R,A01,892724,Herbst; Matthew,0,9,16,16
1745811511829,MMW 12R,A02,892725,Herbst; Matthew,0,9,16,16
1745811512856,MMW 13R,A01,892727,Staff,0,4,16,16
1745811512856,MMW 13R,A02,892728,Staff,0,4,16,16
1745811512856,MMW 13R,A03,958032,Staff,0,3,16,16
1745811512856,MMW 13R,A04,958033,Staff,0,2,16,16
1745811512856,MMW 13R,A05,958034,Staff,0,3,16,16
1745811513880,SIO 295LS,A00,894015,Staff,7,0,25,18
1745811514907,SIO 295S,A00,894020,Staff,7,0,25,18
1745811515936,SIOC 290S,B01,958918,Staff,0,0,0,0
1745811516964,SIOC 291S,B01,958922,Staff,0,0,0,0
1745811517989,SOCI 117,A01,895339,Staff,4,0,5,1
1745811519015,WES 237B,A00,894149,Staff,11,0,20,9
1745811521075,AESE 279B,A00,891859,Staff,13,0,35,22
1745811522104,AIP 197,001,891854,Staff,70,0,70,0
1745811523130,ANTH 289S,A00,891856,Gagneux; Pascal,12,0,12,0
1745811524160,BENG 196,001,957946,Engler; Adam J.,9996,0,9999,3
1745811525189,CAT 124RS,A01,956906,Staff,8,0,25,17
1745811526214,CAT 125RS,A01,922013,Staff,8,0,25,17
1745811527239,CLRE 250,A00,891860,Morris; Sheldon,9995,0,9999,4
1745811529294,CLRE 251R,A00,907817,Mehta; Ravindra L.,9994,0,9999,5
1745811530319,CLRE 252,A00,891864,Cuomo; Raphael Eduardo,9993,0,9999,6
1745811531344,CLRE 253,A00,891867,Vaida; Florin,9994,0,9999,5
1745811531344,CLRE 253,B00,907819,Staff,9999,0,9999,0
1745811532384,CLRE 259,A00,891868,Patel; Hemal,9998,0,9999,1
1745811533412,CLRE 260,A00,891872,Cuomo; Raphael Eduardo,9999,0,9999,0
1745811534441,CLRE 297,001,891888,Cuomo; Raphael Eduardo,9999,0,9999,0
1745811535468,CSE 191,A00,958773,Minnes Kemp; Mor Mia,9999,0,9999,0
1745811536497,CSS 201S,A01,892054,Mignozzetti; Umberto,30,0,30,0
1745811537521,CSS 202S,A01,892056,Mignozzetti; Umberto,30,0,30,0
1745811538545,DSC 197,001,956898,Eldridge; Justin Matthew,9998,0,9999,1
1745811539573,DSC 297,001,958000,Mazumdar; Arya,9998,0,9999,1
1745811540599,EAP 100,A00,905686,Staff,9776,0,9999,223
1745811541630,ECE 45,A01,892618,Staff,0,12,50,50
1745811542657,ECE 109,A01,892620,Staff,0,44,0,0
1745811543682,ECE 111,A01,892719,Staff,0,8,50,50
1745811544708,ECE 197,001,957920,Mercier; Patrick Philip,9992,0,9999,7
1745811545735,ECON 178,A01,907814,Zhu; Ying,28,0,35,7
1745811546761,EDS 115,A00,895312,Staff,41,0,45,4
1745811547788,EDS 117,A01,895337,Staff,30,0,30,0
1745811548818,EDS 125,A00,895341,Jones; Gabrielle Anastasia,43,0,45,2
1745811549844,EDS 128A,A01,895459,Fargason; Sharon Gayle,44,0,45,1
1745811550870,EDS 128B,A01,895543,Pappas; Elizabeth,44,0,45,1
1745811551898,EDS 139,A00,897203,Pappas; Elizabeth,44,0,45,1
1745811551898,EDS 139,B00,897209,Fargason; Sharon Gayle,44,0,45,1
1745811552927,EDS 201,A00,895545,Staff,43,0,45,2
1745811553954,EDS 203,A01,895581,Halter; Christopher P.,43,0,45,2
1745811554983,EDS 204R,A01,895625,Heinzman; Erica M.,43,0,45,2
1745811554983,EDS 204R,B01,895693,Halter; Christopher P.,18,0,45,27
1745811556010,EDS 206R,A00,895694,Fargason; Sharon Gayle,9,0,30,21
1745811556010,EDS 206R,B00,895695,Choi; Bailey Miyeon,20,0,30,10
1745811557040,EDS 250,A00,895697,Hemans; Patricia Ann Benitez,43,0,45,2
1745811558067,EDS 281,A00,895701,Meyerott; Theresa Ann,15,0,15,0
1745811559095,EDS 284,A00,895736,Meyerott; Theresa Ann,15,0,15,0
1745811560124,EDS 286,A00,897210,Fine; Sarah,15,0,15,0
1745811561149,EDS 289C,A01,895770,Daly; Alan J.,15,0,15,0
1745811562177,EDS 290,A00,897211,Hofstetter; Carolyn,15,0,15,0
1745811563207,LIGM 5A,A00,896162,Fischer-Grunski; Eva K,15,0,20,5
1745811564232,LIGM 5B,A00,896260,Fischer-Grunski; Eva K,17,0,20,3
1745811565258,LIGM 5C,A00,896308,Fischer-Grunski; Eva K,18,0,20,2
1745811566285,LIIT 5AS,A00,896313,Carnelos; Chiara,18,0,20,2
1745811567317,LIIT 5BS,A00,896416,Carnelos; Chiara,20,0,20,0
1745811568343,LIIT 5CS,A00,896564,Carnelos; Chiara,20,0,20,0
1745811569373,LISP 5A,A00,896588,Munoz Sanchez; Alicia,4,0,20,16
1745811570404,LISP 5B,A00,896653,Munoz Sanchez; Alicia,10,0,20,10
1745811571430,LISP 5C,A00,896655,Munoz Sanchez; Alicia,4,0,20,16
1745811572458,MAE 197,001,957918,Kleissl; Jan,9998,0,9999,1
1745811573486,MATH 2,A01,957937,Staff,34,0,35,1
1745811574512,MATH 197,001,957876,Kedlaya; Kiran S.,9993,0,9999,6
1745811575538,MCWP 40,A00,892729,Duru; Nur,13,0,20,7
1745811575538,MCWP 40,B00,893304,Montejo; Carolina,20,0,20,0
1745811576569,MCWP 40R,A00,893757,Redela; Pamela Morgan,0,7,20,20
1745811577595,MCWP 50,A00,893758,Morshed; Michael James,2,0,20,18
1745811577595,MCWP 50,B00,893761,Bartulis; Jason Michael,17,0,20,3
1745811578625,MCWP 50R,A00,893766,Compas; Sean Matthew,0,1,20,20
1745811578625,MCWP 50R,B00,893769,Carter; Jennifer A,0,0,20,20
1745811578625,MCWP 50R,C00,893771,Krone; Jarret,0,3,20,20
1745811578625,MCWP 50R,D00,893772,Miller; Elizabeth Deen,3,0,20,17
1745811578625,MCWP 50R,E00,893775,Carter; Andrea L,0,0,20,20
1745811579652,MMW 11R,A01,892721,Herbst; Matthew,11,0,27,16
1745811579652,MMW 11R,A02,892722,Herbst; Matthew,0,0,0,3
1745811580680,MMW 12R,A01,892724,Herbst; Matthew,0,9,16,16
1745811580680,MMW 12R,A02,892725,Herbst; Matthew,0,9,16,16
1745811581707,MMW 13R,A01,892727,Staff,0,4,16,16
1745811581707,MMW 13R,A02,892728,Staff,0,4,16,16
1745811581707,MMW 13R,A03,958032,Staff,0,3,16,16
1745811581707,MMW 13R,A04,958033,Staff,0,2,16,16
1745811581707,MMW 13R,A05,958034,Staff,0,3,16,16
1745811582737,SIO 295LS,A00,894015,Staff,7,0,25,18
1745811583762,SIO 295S,A00,894020,Staff,7,0,25,18
1745811584794,SIOC 290S,B01,958918,Staff,0,0,0,0
1745811585821,SIOC 291S,B01,958922,Staff,0,0,0,0
1745811586847,SOCI 117,A01,895339,Staff,4,0,5,1
1745811587876,WES 237B,A00,894149,Staff,11,0,20,9
1745811589941,AESE 279B,A00,891859,Staff,13,0,35,22
1745811590966,AIP 197,001,891854,Staff,70,0,70,0
1745811591990,ANTH 289S,A00,891856,Gagneux; Pascal,12,0,12,0
1745811593015,BENG 196,001,957946,Engler; Adam J.,9996,0,9999,3
1745811594043,CAT 124RS,A01,956906,Staff,8,0,25,17
1745811595072,CAT 125RS,A01,922013,Staff,8,0,25,17
1745811596102,CLRE 250,A00,891860,Morris; Sheldon,9995,0,9999,4
1745811598156,CLRE 251R,A00,907817,Mehta; Ravindra L.,9994,0,9999,5
1745811599185,CLRE 252,A00,891864,Cuomo; Raphael Eduardo,9993,0,9999,6
1745811600211,CLRE 253,A00,891867,Vaida; Florin,9994,0,9999,5
1745811600211,CLRE 253,B00,907819,Staff,9999,0,9999,0
1745811601243,CLRE 259,A00,891868,Patel; Hemal,9998,0,9999,1
1745811602270,CLRE 260,A00,891872,Cuomo; Raphael Eduardo,9999,0,9999,0
1745811603297,CLRE 297,001,891888,Cuomo; Raphael Eduardo,9999,0,9999,0
1745811604327,CSE 191,A00,958773,Minnes Kemp; Mor Mia,9999,0,9999,0
1745811605359,CSS 201S,A01,892054,Mignozzetti; Umberto,30,0,30,0
1745811606385,CSS 202S,A01,892056,Mignozzetti; Umberto,30,0,30,0
1745811607412,DSC 197,001,956898,Eldridge; Justin Matthew,9998,0,9999,1
1745811608448,DSC 297,001,958000,Mazumdar; Arya,9998,0,9999,1
1745811609475,EAP 100,A00,905686,Staff,9776,0,9999,223
1745811610501,ECE 45,A01,892618,Staff,0,12,50,50
1745811611526,ECE 109,A01,892620,Staff,0,44,0,0
1745811612553,ECE 111,A01,892719,Staff,0,8,50,50
1745811613577,ECE 197,001,957920,Mercier; Patrick Philip,9992,0,9999,7
1745811614608,ECON 178,A01,907814,Zhu; Ying,28,0,35,7
1745811615636,EDS 115,A00,895312,Staff,41,0,45,4
1745811616664,EDS 117,A01,895337,Staff,30,0,30,0
1745811617703,EDS 125,A00,895341,Jones; Gabrielle Anastasia,43,0,45,2
1745811618729,EDS 128A,A01,895459,Fargason; Sharon Gayle,44,0,45,1
1745811619757,EDS 128B,A01,895543,Pappas; Elizabeth,44,0,45,1
1745811620783,EDS 139,A00,897203,Pappas; Elizabeth,44,0,45,1
1745811620783,EDS 139,B00,897209,Fargason; Sharon Gayle,44,0,45,1
1745811621810,EDS 201,A00,895545,Staff,43,0,45,2
1745811622838,EDS 203,A01,895581,Halter; Christopher P.,43,0,45,2
1745811623869,EDS 204R,A01,895625,Heinzman; Erica M.,43,0,45,2
1745811623869,EDS 204R,B01,895693,Halter; Christopher P.,18,0,45,27
1745811624896,EDS 206R,A00,895694,Fargason; Sharon Gayle,9,0,30,21
1745811624896,EDS 206R,B00,895695,Choi; Bailey Miyeon,20,0,30,10
1745811625923,EDS 250,A00,895697,Hemans; Patricia Ann Benitez,43,0,45,2
1745811626949,EDS 281,A00,895701,Meyerott; Theresa Ann,15,0,15,0
1745811627978,EDS 284,A00,895736,Meyerott; Theresa Ann,15,0,15,0
1745811629008,EDS 286,A00,897210,Fine; Sarah,15,0,15,0
1745811630035,EDS 289C,A01,895770,Daly; Alan J.,15,0,15,0
1745811631062,EDS 290,A00,897211,Hofstetter; Carolyn,15,0,15,0
1745811632089,LIGM 5A,A00,896162,Fischer-Grunski; Eva K,15,0,20,5
1745811633120,LIGM 5B,A00,896260,Fischer-Grunski; Eva K,17,0,20,3
1745811634149,LIGM 5C,A00,896308,Fischer-Grunski; Eva K,18,0,20,2
1745811635177,LIIT 5AS,A00,896313,Carnelos; Chiara,18,0,20,2
1745811636204,LIIT 5BS,A00,896416,Carnelos; Chiara,20,0,20,0
1745811637251,LIIT 5CS,A00,896564,Carnelos; Chiara,20,0,20,0
1745811638277,LISP 5A,A00,896588,Munoz Sanchez; Alicia,4,0,20,16
1745811639301,LISP 5B,A00,896653,Munoz Sanchez; Alicia,10,0,20,10
1745811640330,LISP 5C,A00,896655,Munoz Sanchez; Alicia,4,0,20,16
1745811641357,MAE 197,001,957918,Kleissl; Jan,9998,0,9999,1
1745811642393,MATH 2,A01,957937,Staff,34,0,35,1
1745811643418,MATH 197,001,957876,Kedlaya; Kiran S.,9993,0,9999,6
1745811644449,MCWP 40,A00,892729,Duru; Nur,13,0,20,7
1745811644449,MCWP 40,B00,893304,Montejo; Carolina,20,0,20,0
1745811645477,MCWP 40R,A00,893757,Redela; Pamela Morgan,0,7,20,20
1745811646506,MCWP 50,A00,893758,Morshed; Michael James,2,0,20,18
1745811646506,MCWP 50,B00,893761,Bartulis; Jason Michael,17,0,20,3
1745811647532,MCWP 50R,A00,893766,Compas; Sean Matthew,0,1,20,20
1745811647532,MCWP 50R,B00,893769,Carter; Jennifer A,0,0,20,20
1745811647532,MCWP 50R,C00,893771,Krone; Jarret,0,3,20,20
1745811647532,MCWP 50R,D00,893772,Miller; Elizabeth Deen,3,0,20,17
1745811647532,MCWP 50R,E00,893775,Carter; Andrea L,0,0,20,20
1745811648560,MMW 11R,A01,892721,Herbst; Matthew,11,0,27,16
1745811648560,MMW 11R,A02,892722,Herbst; Matthew,0,0,0,3
1745811649585,MMW 12R,A01,892724,Herbst; Matthew,0,9,16,16
1745811649585,MMW 12R,A02,892725,Herbst; Matthew,0,9,16,16
1745811650614,MMW 13R,A01,892727,Staff,0,4,16,16
1745811650614,MMW 13R,A02,892728,Staff,0,4,16,16
1745811650614,MMW 13R,A03,958032,Staff,0,3,16,16
1745811650614,MMW 13R,A04,958033,Staff,0,2,16,16
1745811650614,MMW 13R,A05,958034,Staff,0,3,16,16
1745811651642,SIO 295LS,A00,894015,Staff,7,0,25,18
1745811652667,SIO 295S,A00,894020,Staff,7,0,25,18
1745811653695,SIOC 290S,B01,958918,Staff,0,0,0,0
1745811654726,SIOC 291S,B01,958922,Staff,0,0,0,0
1745811655750,SOCI 117,A01,895339,Staff,4,0,5,1
1745811656776,WES 237B,A00,894149,Staff,11,0,20,9
1745811658836,AESE 279B,A00,891859,Staff,13,0,35,22
1745811659863,AIP 197,001,891854,Staff,70,0,70,0
1745811660887,ANTH 289S,A00,891856,Gagneux; Pascal,12,0,12,0
1745811661915,BENG 196,001,957946,Engler; Adam J.,9996,0,9999,3
1745811662941,CAT 124RS,A01,956906,Staff,8,0,25,17
1745811663965,CAT 125RS,A01,922013,Staff,8,0,25,17
1745811664989,CLRE 250,A00,891860,Morris; Sheldon,9995,0,9999,4
1745811667040,CLRE 251R,A00,907817,Mehta; Ravindra L.,9994,0,9999,5
1745811668069,CLRE 252,A00,891864,Cuomo; Raphael Eduardo,9993,0,9999,6
1745811669098,CLRE 253,A00,891867,Vaida; Florin,9994,0,9999,5
1745811669098,CLRE 253,B00,907819,Staff,9999,0,9999,0
1745811670124,CLRE 259,A00,891868,Patel; Hemal,9998,0,9999,1
1745811671154,CLRE 260,A00,891872,Cuomo; Raphael Eduardo,9999,0,9999,0
1745811672180,CLRE 297,001,891888,Cuomo; Raphael Eduardo,9999,0,9999,0
1745811673206,CSE 191,A00,958773,Minnes Kemp; Mor Mia,9999,0,9999,0
1745811674235,CSS 201S,A01,892054,Mignozzetti; Umberto,30,0,30,0
1745811675263,CSS 202S,A01,892056,Mignozzetti; Umberto,30,0,30,0
1745811676289,DSC 197,001,956898,Eldridge; Justin Matthew,9998,0,9999,1
1745811677315,DSC 297,001,958000,Mazumdar; Arya,9998,0,9999,1
1745811678339,EAP 100,A00,905686,Staff,9776,0,9999,223
1745811679370,ECE 45,A01,892618,Staff,0,12,50,50
1745811680397,ECE 109,A01,892620,Staff,0,44,0,0
1745811681420,ECE 111,A01,892719,Staff,0,8,50,50
1745811682447,ECE 197,001,957920,Mercier; Patrick Philip,9992,0,9999,7
1745811683477,ECON 178,A01,907814,Zhu; Ying,28,0,35,7
1745811684521,EDS 115,A00,895312,Staff,41,0,45,4
1745811685552,EDS 117,A01,895337,Staff,30,0,30,0
1745811686580,EDS 125,A00,895341,Jones; Gabrielle Anastasia,43,0,45,2
1745811687606,EDS 128A,A01,895459,Fargason; Sharon Gayle,44,0,45,1
1745811688630,EDS 128B,A01,895543,Pappas; Elizabeth,44,0,45,1
1745811689659,EDS 139,A00,897203,Pappas; Elizabeth,44,0,45,1
1745811689659,EDS 139,B00,897209,Fargason; Sharon Gayle,44,0,45,1
1745811690683,EDS 201,A00,895545,Staff,43,0,45,2
1745811691711,EDS 203,A01,895581,Halter; Christopher P.,43,0,45,2
1745811692737,EDS 204R,A01,895625,Heinzman; Erica M.,43,0,45,2
1745811692737,EDS 204R,B01,895693,Halter; Christopher P.,18,0,45,27
1745811693764,EDS 206R,A00,895694,Fargason; Sharon Gayle,9,0,30,21
1745811693764,EDS 206R,B00,895695,Choi; Bailey Miyeon,20,0,30,10
1745811694791,EDS 250,A00,895697,Hemans; Patricia Ann Benitez,43,0,45,2
1745811695820,EDS 281,A00,895701,Meyerott; Theresa Ann,15,0,15,0
1745811696851,EDS 284,A00,895736,Meyerott; Theresa Ann,15,0,15,0
1745811697881,EDS 286,A00,897210,Fine; Sarah,15,0,15,0
1745811698908,EDS 289C,A01,895770,Daly; Alan J.,15,0,15,0
1745811699935,EDS 290,A00,897211,Hofstetter; Carolyn,15,0,15,0
1745811700959,LIGM 5A,A00,896162,Fischer-Grunski; Eva K,15,0,20,5
1745811701984,LIGM 5B,A00,896260,Fischer-Grunski; Eva K,17,0,20,3
1745811703011,LIGM 5C,A00,896308,Fischer-Grunski; Eva K,18,0,20,2
1745811704036,LIIT 5AS,A00,896313,Carnelos; Chiara,18,0,20,2
1745811705060,LIIT 5BS,A00,896416,Carnelos; Chiara,20,0,20,0
1745811706091,LIIT 5CS,A00,896564,Carnelos; Chiara,20,0,20,0
1745811707119,LISP 5A,A00,896588,Munoz Sanchez; Alicia,4,0,20,16
1745811708147,LISP 5B,A00,896653,Munoz Sanchez; Alicia,10,0,20,10
1745811709176,LISP 5C,A00,896655,Munoz Sanchez; Alicia,4,0,20,16
1745811710200,MAE 197,001,957918,Kleissl; Jan,9998,0,9999,1
1745811711228,MATH 2,A01,957937,Staff,34,0,35,1
1745811712253,MATH 197,001,957876,Kedlaya; Kiran S.,9993,0,9999,6
1745811713279,MCWP 40,A00,892729,Duru; Nur,13,0,20,7
1745811713279,MCWP 40,B00,893304,Montejo; Carolina,20,0,20,0
1745811714304,MCWP 40R,A00,893757,Redela; Pamela Morgan,0,7,20,20
1745811715330,MCWP 50,A00,893758,Morshed; Michael James,2,0,20,18
1745811715330,MCWP 50,B00,893761,Bartulis; Jason Michael,17,0,20,3
1745811716355,MCWP 50R,A00,893766,Compas; Sean Matthew,0,1,20,20
1745811716355,MCWP 50R,B00,893769,Carter; Jennifer A,0,0,20,20
1745811716355,MCWP 50R,C00,893771,Krone; Jarret,0,3,20,20
1745811716355,MCWP 50R,D00,893772,Miller; Elizabeth Deen,3,0,20,17
1745811716355,MCWP 50R,E00,893775,Carter; Andrea L,0,0,20,20
1745811717383,MMW 11R,A01,892721,Herbst; Matthew,11,0,27,16
1745811717383,MMW 11R,A02,892722,Herbst; Matthew,0,0,0,3
1745811718408,MMW 12R,A01,892724,Herbst; Matthew,0,9,16,16
1745811718408,MMW 12R,A02,892725,Herbst; Matthew,0,9,16,16
1745811719432,MMW 13R,A01,892727,Staff,0,4,16,16
1745811719432,MMW 13R,A02,892728,Staff,0,4,16,16
1745811719432,MMW 13R,A03,958032,Staff,0,3,16,16
1745811719432,MMW 13R,A04,958033,Staff,0,2,16,16
1745811719432,MMW 13R,A05,958034,Staff,0,3,16,16
1745811720457,SIO 295LS,A00,894015,Staff,7,0,25,18
1745811721484,SIO 295S,A00,894020,Staff,7,0,25,18
1745811722513,SIOC 290S,B01,958918,Staff,0,0,0,0
1745811723540,SIOC 291S,B01,958922,Staff,0,0,0,0
1745811724566,SOCI 117,A01,895339,Staff,4,0,5,1
1745811725595,WES 237B,A00,894149,Staff,11,0,20,9
1745811727661,AESE 279B,A00,891859,Staff,13,0,35,22
1745811728686,AIP 197,001,891854,Staff,70,0,70,0
1745811729714,ANTH 289S,A00,891856,Gagneux; Pascal,12,0,12,0
1745811730738,BENG 196,001,957946,Engler; Adam J.,9996,0,9999,3
1745811731766,CAT 124RS,A01,956906,Staff,8,0,25,17
1745811732794,CAT 125RS,A01,922013,Staff,8,0,25,17
1745811733820,CLRE 250,A00,891860,Morris; Sheldon,9995,0,9999,4
1745811735876,CLRE 251R,A00,907817,Mehta; Ravindra L.,9994,0,9999,5
1745811736901,CLRE 252,A00,891864,Cuomo; Raphael Eduardo,9993,0,9999,6
1745811737926,CLRE 253,A00,891867,Vaida; Florin,9994,0,9999,5
1745811737926,CLRE 253,B00,907819,Staff,9999,0,9999,0
1745811738954,CLRE 259,A00,891868,Patel; Hemal,9998,0,9999,1
1745811739979,CLRE 260,A00,891872,Cuomo; Raphael Eduardo,9999,0,9999,0
1745811741005,CLRE 297,001,891888,Cuomo; Raphael Eduardo,9999,0,9999,0
1745811742031,CSE 191,A00,958773,Minnes Kemp; Mor Mia,9999,0,9999,0
1745811743059,CSS 201S,A01,892054,Mignozzetti; Umberto,30,0,30,0
1745811744085,CSS 202S,A01,892056,Mignozzetti; Umberto,30,0,30,0
1745811745113,DSC 197,001,956898,Eldridge; Justin Matthew,9998,0,9999,1
1745811746138,DSC 297,001,958000,Mazumdar; Arya,9998,0,9999,1
1745811747164,EAP 100,A00,905686,Staff,9776,0,9999,223
1745811748189,ECE 45,A01,892618,Staff,0,12,50,50
1745811749217,ECE 109,A01,892620,Staff,0,44,0,0
1745811750245,ECE 111,A01,892719,Staff,0,8,50,50
1745811751270,ECE 197,001,957920,Mercier; Patrick Philip,9992,0,9999,7
1745811752297,ECON 178,A01,907814,Zhu; Ying,28,0,35,7
1745811753324,EDS 115,A00,895312,Staff,41,0,45,4
1745811754352,EDS 117,A01,895337,Staff,30,0,30,0
1745811755377,EDS 125,A00,895341,Jones; Gabrielle Anastasia,43,0,45,2
1745811756407,EDS 128A,A01,895459,Fargason; Sharon Gayle,44,0,45,1
1745811757431,EDS 128B,A01,895543,Pappas; Elizabeth,44,0,45,1
1745811758462,EDS 139,A00,897203,Pappas; Elizabeth,44,0,45,1
1745811758462,EDS 139,B00,897209,Fargason; Sharon Gayle,44,0,45,1
1745811759488,EDS 201,A00,895545,Staff,43,0,45,2
1745811760513,EDS 203,A01,895581,Halter; Christopher P.,43,0,45,2
1745811761539,EDS 204R,A01,895625,Heinzman; Erica M.,43,0,45,2
1745811761539,EDS 204R,B01,895693,Halter; Christopher P.,18,0,45,27
1745811762564,EDS 206R,A00,895694,Fargason; Sharon Gayle,9,0,30,21
1745811762564,EDS 206R,B00,895695,Choi; Bailey Miyeon,20,0,30,10
1745811763591,EDS 250,A00,895697,Hemans; Patricia Ann Benitez,43,0,45,2
1745811764616,EDS 281,A00,895701,Meyerott; Theresa Ann,15,0,15,0
1745811765644,EDS 284,A00,895736,Meyerott; Theresa Ann,15,0,15,0
1745811766670,EDS 286,A00,897210,Fine; Sarah,15,0,15,0
1745811767697,EDS 289C,A01,895770,Daly; Alan J.,15,0,15,0
1745811768721,EDS 290,A00,897211,Hofstetter; Carolyn,15,0,15,0
1745811769750,LIGM 5A,A00,896162,Fischer-Grunski; Eva K,15,0,20,5
1745811770775,LIGM 5B,A00,896260,Fischer-Grunski; Eva K,17,0,20,3
1745811771805,LIGM 5C,A00,896308,Fischer-Grunski; Eva K,18,0,20,2
1745811772834,LIIT 5AS,A00,896313,Carnelos; Chiara,18,0,20,2
1745811773859,LIIT 5BS,A00,896416,Carnelos; Chiara,20,0,20,0
1745811774889,LIIT 5CS,A00,896564,Carnelos; Chiara,20,0,20,0
1745811775916,LISP 5A,A00,896588,Munoz Sanchez; Alicia,4,0,20,16
1745811776943,LISP 5B,A00,896653,Munoz Sanchez; Alicia,10,0,20,10
1745811777971,LISP 5C,A00,896655,Munoz Sanchez; Alicia,4,0,20,16
1745811778997,MAE 197,001,957918,Kleissl; Jan,9998,0,9999,1
1745811780024,MATH 2,A01,957937,Staff,34,0,35,1
1745811781052,MATH 197,001,957876,Kedlaya; Kiran S.,9993,0,9999,6
1745811782077,MCWP 40,A00,892729,Duru; Nur,13,0,20,7
1745811782077,MCWP 40,B00,893304,Montejo; Carolina,20,0,20,0
1745811783104,MCWP 40R,A00,893757,Redela; Pamela Morgan,0,7,20,20
1745811784131,MCWP 50,A00,893758,Morshed; Michael James,2,0,20,18
1745811784131,MCWP 50,B00,893761,Bartulis; Jason Michael,17,0,20,3
1745811785160,MCWP 50R,A00,893766,Compas; Sean Matthew,0,1,20,20
1745811785160,MCWP 50R,B00,893769,Carter; Jennifer A,0,0,20,20
1745811785160,MCWP 50R,C00,893771,Krone; Jarret,0,3,20,20
1745811785160,MCWP 50R,D00,893772,Miller; Elizabeth Deen,3,0,20,17
1745811785160,MCWP 50R,E00,893775,Carter; Andrea L,0,0,20,20
1745811786190,MMW 11R,A01,892721,Herbst; Matthew,11,0,27,16
1745811786190,MMW 11R,A02,892722,Herbst; Matthew,0,0,0,3
1745811787217,MMW 12R,A01,892724,Herbst; Matthew,0,9,16,16
1745811787217,MMW 12R,A02,892725,Herbst; Matthew,0,9,16,16
1745811788245,MMW 13R,A01,892727,Staff,0,4,16,16
1745811788245,MMW 13R,A02,892728,Staff,0,4,16,16
1745811788245,MMW 13R,A03,958032,Staff,0,3,16,16
1745811788245,MMW 13R,A04,958033,Staff,0,2,16,16
1745811788245,MMW 13R,A05,958034,Staff,0,3,16,16
1745811789274,SIO 295LS,A00,894015,Staff,7,0,25,18
1745811790303,SIO 295S,A00,894020,Staff,7,0,25,18
1745811791332,SIOC 290S,B01,958918,Staff,0,0,0,0
1745811792362,SIOC 291S,B01,958922,Staff,0,0,0,0
1745811793390,SOCI 117,A01,895339,Staff,4,0,5,1
1745811794418,WES 237B,A00,894149,Staff,11,0,20,9
1745811796473,AESE 279B,A00,891859,Staff,13,0,35,22
1745811797500,AIP 197,001,891854,Staff,70,0,70,0
1745811798528,ANTH 289S,A00,891856,Gagneux; Pascal,12,0,12,0
1745811799553,BENG 196,001,957946,Engler; Adam J.,9996,0,9999,3
1745811800579,CAT 124RS,A01,956906,Staff,8,0,25,17
1745811801605,CAT 125RS,A01,922013,Staff,8,0,25,17
1745811802629,CLRE 250,A00,891860,Morris; Sheldon,9995,0,9999,4
1745811804686,CLRE 251R,A00,907817,Mehta; Ravindra L.,9994,0,9999,5
1745811805714,CLRE 252,A00,891864,Cuomo; Raphael Eduardo,9993,0,9999,6
1745811806742,CLRE 253,A00,891867,Vaida; Florin,9994,0,9999,5
1745811806742,CLRE 253,B00,907819,Staff,9999,0,9999,0
1745811807770,CLRE 259,A00,891868,Patel; Hemal,9998,0,9999,1
1745811808796,CLRE 260,A00,891872,Cuomo; Raphael Eduardo,9999,0,9999,0
1745811809822,CLRE 297,001,891888,Cuomo; Raphael Eduardo,9999,0,9999,0
1745811810852,CSE 191,A00,958773,Minnes Kemp; Mor Mia,9999,0,9999,0
1745811811882,CSS 201S,A01,892054,Mignozzetti; Umberto,30,0,30,0
1745811812908,CSS 202S,A01,892056,Mignozzetti; Umberto,30,0,30,0
1745811813934,DSC 197,001,956898,Eldridge; Justin Matthew,9998,0,9999,1
1745811814960,DSC 297,001,958000,Mazumdar; Arya,9998,0,9999,1
1745811815988,EAP 100,A00,905686,Staff,9776,0,9999,223
1745811817017,ECE 45,A01,892618,Staff,0,12,50,50
1745811818044,ECE 109,A01,892620,Staff,0,44,0,0
1745811819069,ECE 111,A01,892719,Staff,0,8,50,50
1745811820095,ECE 197,001,957920,Mercier; Patrick Philip,9992,0,9999,7
1745811821121,ECON 178,A01,907814,Zhu; Ying,28,0,35,7
1745811822148,EDS 115,A00,895312,Staff,41,0,45,4
1745811823173,EDS 117,A01,895337,Staff,30,0,30,0
1745811824200,EDS 125,A00,895341,Jones; Gabrielle Anastasia,43,0,45,2
1745811825226,EDS 128A,A01,895459,Fargason; Sharon Gayle,44,0,45,1
1745811826255,EDS 128B,A01,895543,Pappas; Elizabeth,44,0,45,1
1745811827280,EDS 139,A00,897203,Pappas; Elizabeth,44,0,45,1
1745811827280,EDS 139,B00,897209,Fargason; Sharon Gayle,44,0,45,1
1745811828309,EDS 201,A00,895545,Staff,43,0,45,2
1745811829336,EDS 203,A01,895581,Halter; Christopher P.,43,0,45,2
1745811830363,EDS 204R,A01,895625,Heinzman; Erica M.,43,0,45,2
1745811830363,EDS 204R,B01,895693,Halter; Christopher P.,18,0,45,27
1745811831390,EDS 206R,A00,895694,Fargason; Sharon Gayle,9,0,30,21
1745811831390,EDS 206R,B00,895695,Choi; Bailey Miyeon,20,0,30,10
1745811832417,EDS 250,A00,895697,Hemans; Patricia Ann Benitez,43,0,45,2
1745811833443,EDS 281,A00,895701,Meyerott; Theresa Ann,15,0,15,0
1745811834468,EDS 284,A00,895736,Meyerott; Theresa Ann,15,0,15,0
1745811835493,EDS 286,A00,897210,Fine; Sarah,15,0,15,0
1745811836523,EDS 289C,A01,895770,Daly; Alan J.,15,0,15,0
1745811837549,EDS 290,A00,897211,Hofstetter; Carolyn,15,0,15,0
1745811838576,LIGM 5A,A00,896162,Fischer-Grunski; Eva K,15,0,20,5
1745811839602,LIGM 5B,A00,896260,Fischer-Grunski; Eva K,17,0,20,3
1745811840629,LIGM 5C,A00,896308,Fischer-Grunski; Eva K,18,0,20,2
1745811841653,LIIT 5AS,A00,896313,Carnelos; Chiara,18,0,20,2
1745811842680,LIIT 5BS,A00,896416,Carnelos; Chiara,20,0,20,0
1745811843707,LIIT 5CS,A00,896564,Carnelos; Chiara,20,0,20,0
1745811844733,LISP 5A,A00,896588,Munoz Sanchez; Alicia,4,0,20,16
1745811845760,LISP 5B,A00,896653,Munoz Sanchez; Alicia,10,0,20,10
1745811846788,LISP 5C,A00,896655,Munoz Sanchez; Alicia,4,0,20,16
1745811847814,MAE 197,001,957918,Kleissl; Jan,9998,0,9999,1
1745811848840,MATH 2,A01,957937,Staff,34,0,35,1
1745811849870,MATH 197,001,957876,Kedlaya; Kiran S.,9993,0,9999,6
1745811850896,MCWP 40,A00,892729,Duru; Nur,13,0,20,7
1745811850896,MCWP 40,B00,893304,Montejo; Carolina,20,0,20,0
1745811851924,MCWP 40R,A00,893757,Redela; Pamela Morgan,0,7,20,20
1745811852953,MCWP 50,A00,893758,Morshed; Michael James,2,0,20,18
1745811852953,MCWP 50,B00,893761,Bartulis; Jason Michael,17,0,20,3
1745811853980,MCWP 50R,A00,893766,Compas; Sean Matthew,0,1,20,20
1745811853980,MCWP 50R,B00,893769,Carter; Jennifer A,0,0,20,20
1745811853980,MCWP 50R,C00,893771,Krone; Jarret,0,3,20,20
1745811853980,MCWP 50R,D00,893772,Miller; Elizabeth Deen,3,0,20,17
1745811853980,MCWP 50R,E00,893775,Carter; Andrea L,0,0,20,20
1745811855008,MMW 11R,A01,892721,Herbst; Matthew,11,0,27,16
1745811855008,MMW 11R,A02,892722,Herbst; Matthew,0,0,0,3
1745811856036,MMW 12R,A01,892724,Herbst; Matthew,0,9,16,16
1745811856036,MMW 12R,A02,892725,Herbst; Matthew,0,9,16,16
1745811857064,MMW 13R,A01,892727,Staff,0,4,16,16
1745811857064,MMW 13R,A02,892728,Staff,0,4,16,16
1745811857064,MMW 13R,A03,958032,Staff,0,3,16,16
1745811857064,MMW 13R,A04,958033,Staff,0,2,16,16
1745811857064,MMW 13R,A05,958034,Staff,0,3,16,16
1745811858095,SIO 295LS,A00,894015,Staff,7,0,25,18
1745811859121,SIO 295S,A00,894020,Staff,7,0,25,18
1745811860148,SIOC 290S,B01,958918,Staff,0,0,0,0
1745811861178,SIOC 291S,B01,958922,Staff,0,0,0,0
1745811862206,SOCI 117,A01,895339,Staff,4,0,5,1
1745811863231,WES 237B,A00,894149,Staff,11,0,20,9
1745811865301,AESE 279B,A00,891859,Staff,13,0,35,22
1745811866327,AIP 197,001,891854,Staff,70,0,70,0
1745811867352,ANTH 289S,A00,891856,Gagneux; Pascal,12,0,12,0
1745811868377,BENG 196,001,957946,Engler; Adam J.,9996,0,9999,3
1745811869404,CAT 124RS,A01,956906,Staff,8,0,25,17
1745811870431,CAT 125RS,A01,922013,Staff,8,0,25,17
1745811871457,CLRE 250,A00,891860,Morris; Sheldon,9995,0,9999,4
1745811873509,CLRE 251R,A00,907817,Mehta; Ravindra L.,9994,0,9999,5
1745811874534,CLRE 252,A00,891864,Cuomo; Raphael Eduardo,9993,0,9999,6
1745811875616,CLRE 253,A00,891867,Vaida; Florin,9994,0,9999,5
1745811875616,CLRE 253,B00,907819,Staff,9999,0,9999,0
1745811876645,CLRE 259,A00,891868,Patel; Hemal,9998,0,9999,1
1745811877671,CLRE 260,A00,891872,Cuomo; Raphael Eduardo,9999,0,9999,0
1745811878707,CLRE 297,001,891888,Cuomo; Raphael Eduardo,9999,0,9999,0
1745811879735,CSE 191,A00,958773,Minnes Kemp; Mor Mia,9999,0,9999,0
1745811880761,CSS 201S,A01,892054,Mignozzetti; Umberto,30,0,30,0
1745811881788,CSS 202S,A01,892056,Mignozzetti; Umberto,30,0,30,0
1745811882815,DSC 197,001,956898,Eldridge; Justin Matthew,9998,0,9999,1
1745811883845,DSC 297,001,958000,Mazumdar; Arya,9998,0,9999,1
1745811884870,EAP 100,A00,905686,Staff,9776,0,9999,223
1745811885897,ECE 45,A01,892618,Staff,0,12,50,50
1745811886925,ECE 109,A01,892620,Staff,0,44,0,0
1745811887952,ECE 111,A01,892719,Staff,0,8,50,50
1745811888978,ECE 197,001,957920,Mercier; Patrick Philip,9992,0,9999,7
1745811890004,ECON 178,A01,907814,Zhu; Ying,28,0,35,7
1745811891033,EDS 115,A00,895312,Staff,41,0,45,4
1745811892059,EDS 117,A01,895337,Staff,30,0,30,0
1745811893085,EDS 125,A00,895341,Jones; Gabrielle Anastasia,43,0,45,2
1745811894112,EDS 128A,A01,895459,Fargason; Sharon Gayle,44,0,45,1
1745811895143,EDS 128B,A01,895543,Pappas; Elizabeth,44,0,45,1
1745811896170,EDS 139,A00,897203,Pappas; Elizabeth,44,0,45,1
1745811896170,EDS 139,B00,897209,Fargason; Sharon Gayle,44,0,45,1
1745811897195,EDS 201,A00,895545,Staff,43,0,45,2
1745811898220,EDS 203,A01,895581,Halter; Christopher P.,43,0,45,2
1745811899245,EDS 204R,A01,895625,Heinzman; Erica M.,43,0,45,2
1745811899245,EDS 204R,B01,895693,Halter; Christopher P.,18,0,45,27
1745811900274,EDS 206R,A00,895694,Fargason; Sharon Gayle,9,0,30,21
1745811900274,EDS 206R,B00,895695,Choi; Bailey Miyeon,20,0,30,10
1745811901304,EDS 250,A00,895697,Hemans; Patricia Ann Benitez,43,0,45,2
1745811902333,EDS 281,A00,895701,Meyerott; Theresa Ann,15,0,15,0
1745811903359,EDS 284,A00,895736,Meyerott; Theresa Ann,15,0,15,0
1745811904388,EDS 286,A00,897210,Fine; Sarah,15,0,15,0
1745811905438,EDS 289C,A01,895770,Daly; Alan J.,15,0,15,0
1745811906467,EDS 290,A00,897211,Hofstetter; Carolyn,15,0,15,0
1745811907493,LIGM 5A,A00,896162,Fischer-Grunski; Eva K,15,0,20,5
1745811908521,LIGM 5B,A00,896260,Fischer-Grunski; Eva K,17,0,20,3
1745811909547,LIGM 5C,A00,896308,Fischer-Grunski; Eva K,18,0,20,2
1745811910574,LIIT 5AS,A00,896313,Carnelos; Chiara,18,0,20,2
1745811911606,LIIT 5BS,A00,896416,Carnelos; Chiara,20,0,20,0
1745811912637,LIIT 5CS,A00,896564,Carnelos; Chiara,20,0,20,0
1745811913667,LISP 5A,A00,896588,Munoz Sanchez; Alicia,4,0,20,16
1745811914695,LISP 5B,A00,896653,Munoz Sanchez; Alicia,10,0,20,10
1745811915724,LISP 5C,A00,896655,Munoz Sanchez; Alicia,4,0,20,16
1745811916749,MAE 197,001,957918,Kleissl; Jan,9998,0,9999,1
1745811917774,MATH 2,A01,957937,Staff,34,0,35,1
1745811918802,MATH 197,001,957876,Kedlaya; Kiran S.,9993,0,9999,6
1745811919827,MCWP 40,A00,892729,Duru; Nur,13,0,20,7
1745811919827,MCWP 40,B00,893304,Montejo; Carolina,20,0,20,0
1745811920856,MCWP 40R,A00,893757,Redela; Pamela Morgan,0,7,20,20
1745811921882,MCWP 50,A00,893758,Morshed; Michael James,2,0,20,18
1745811921882,MCWP 50,B00,893761,Bartulis; Jason Michael,17,0,20,3
1745811922912,MCWP 50R,A00,893766,Compas; Sean Matthew,0,1,20,20
1745811922912,MCWP 50R,B00,893769,Carter; Jennifer A,0,0,20,20
1745811922912,MCWP 50R,C00,893771,Krone; Jarret,0,3,20,20
1745811922912,MCWP 50R,D00,893772,Miller; Elizabeth Deen,3,0,20,17
1745811922912,MCWP 50R,E00,893775,Carter; Andrea L,0,0,20,20
1745811923937,MMW 11R,A01,892721,Herbst; Matthew,11,0,27,16
1745811923937,MMW 11R,A02,892722,Herbst; Matthew,0,0,0,3
1745811924964,MMW 12R,A01,892724,Herbst; Matthew,0,9,16,16
1745811924964,MMW 12R,A02,892725,Herbst; Matthew,0,9,16,16
1745811925988,MMW 13R,A01,892727,Staff,0,4,16,16
1745811925988,MMW 13R,A02,892728,Staff,0,4,16,16
1745811925988,MMW 13R,A03,958032,Staff,0,3,16,16
1745811925988,MMW 13R,A04,958033,Staff,0,2,16,16
1745811925988,MMW 13R,A05,958034,Staff,0,3,16,16
1745811927014,SIO 295LS,A00,894015,Staff,7,0,25,18
1745811928041,SIO 295S,A00,894020,Staff,7,0,25,18
1745811929068,SIOC 290S,B01,958918,Staff,0,0,0,0
1745811930095,SIOC 291S,B01,958922,Staff,0,0,0,0
1745811931121,SOCI 117,A01,895339,Staff,4,0,5,1
1745811932149,WES 237B,A00,894149,Staff,11,0,20,9
1745811934210,AESE 279B,A00,891859,Staff,13,0,35,22
1745811935237,AIP 197,001,891854,Staff,70,0,70,0
1745811936267,ANTH 289S,A00,891856,Gagneux; Pascal,12,0,12,0
1745811937291,BENG 196,001,957946,Engler; Adam J.,9996,0,9999,3
1745811938317,CAT 124RS,A01,956906,Staff,8,0,25,17
1745811939342,CAT 125RS,A01,922013,Staff,8,0,25,17
1745811940371,CLRE 250,A00,891860,Morris; Sheldon,9995,0,9999,4
1745811942424,CLRE 251R,A00,907817,Mehta; Ravindra L.,9994,0,9999,5
1745811943450,CLRE 252,A00,891864,Cuomo; Raphael Eduardo,9993,0,9999,6
1745811944475,CLRE 253,A00,891867,Vaida; Florin,9994,0,9999,5
1745811944475,CLRE 253,B00,907819,Staff,9999,0,9999,0
1745811945503,CLRE 259,A00,891868,Patel; Hemal,9998,0,9999,1
1745811946528,CLRE 260,A00,891872,Cuomo; Raphael Eduardo,9999,0,9999,0
1745811947556,CLRE 297,001,891888,Cuomo; Raphael Eduardo,9999,0,9999,0
1745811948582,CSE 191,A00,958773,Minnes Kemp; Mor Mia,9999,0,9999,0
1745811949607,CSS 201S,A01,892054,Mignozzetti; Umberto,30,0,30,0
1745811950634,CSS 202S,A01,892056,Mignozzetti; Umberto,30,0,30,0
1745811951661,DSC 197,001,956898,Eldridge; Justin Matthew,9998,0,9999,1
1745811952685,DSC 297,001,958000,Mazumdar; Arya,9998,0,9999,1
1745811953711,EAP 100,A00,905686,Staff,9776,0,9999,223
1745811954741,ECE 45,A01,892618,Staff,0,12,50,50
1745811955767,ECE 109,A01,892620,Staff,0,44,0,0
1745811956795,ECE 111,A01,892719,Staff,0,8,50,50
1745811957825,ECE 197,001,957920,Mercier; Patrick Philip,9992,0,9999,7
1745811958850,ECON 178,A01,907814,Zhu; Ying,28,0,35,7
1745811959879,EDS 115,A00,895312,Staff,41,0,45,4
1745811960904,EDS 117,A01,895337,Staff,30,0,30,0
1745811961929,EDS 125,A00,895341,Jones; Gabrielle Anastasia,43,0,45,2
1745811962956,EDS 128A,A01,895459,Fargason; Sharon Gayle,44,0,45,1
1745811963985,EDS 128B,A01,895543,Pappas; Elizabeth,44,0,45,1
1745811965012,EDS 139,A00,897203,Pappas; Elizabeth,44,0,45,1
1745811965012,EDS 139,B00,897209,Fargason; Sharon Gayle,44,0,45,1
1745811966039,EDS 201,A00,895545,Staff,43,0,45,2
1745811967066,EDS 203,A01,895581,Halter; Christopher P.,43,0,45,2
1745811968101,EDS 204R,A01,895625,Heinzman; Erica M.,43,0,45,2
1745811968101,EDS 204R,B01,895693,Halter; Christopher P.,18,0,45,27
1745811969127,EDS 206R,A00,895694,Fargason; Sharon Gayle,9,0,30,21
1745811969127,EDS 206R,B00,895695,Choi; Bailey Miyeon,20,0,30,10
1745811970154,EDS 250,A00,895697,Hemans; Patricia Ann Benitez,43,0,45,2
1745811971179,EDS 281,A00,895701,Meyerott; Theresa Ann,15,0,15,0
1745811972206,EDS 284,A00,895736,Meyerott; Theresa Ann,15,0,15,0
1745811973235,EDS 286,A00,897210,Fine; Sarah,15,0,15,0
1745811974260,EDS 289C,A01,895770,Daly; Alan J.,15,0,15,0
1745811975288,EDS 290,A00,897211,Hofstetter; Carolyn,15,0,15,0
1745811976319,LIGM 5A,A00,896162,Fischer-Grunski; Eva K,15,0,20,5
1745811977346,LIGM 5B,A00,896260,Fischer-Grunski; Eva K,17,0,20,3
1745811978373,LIGM 5C,A00,896308,Fischer-Grunski; Eva K,18,0,20,2
1745811979401,LIIT 5AS,A00,896313,Carnelos; Chiara,18,0,20,2
1745811980427,LIIT 5BS,A00,896416,Carnelos; Chiara,20,0,20,0
1745811981453,LIIT 5CS,A00,896564,Carnelos; Chiara,20,0,20,0
1745811982479,LISP 5A,A00,896588,Munoz Sanchez; Alicia,4,0,20,16
1745811983509,LISP 5B,A00,896653,Munoz Sanchez; Alicia,10,0,20,10
1745811984538,LISP 5C,A00,896655,Munoz Sanchez; Alicia,4,0,20,16
1745811985567,MAE 197,001,957918,Kleissl; Jan,9998,0,9999,1
1745811986591,MATH 2,A01,957937,Staff,34,0,35,1
1745811987618,MATH 197,001,957876,Kedlaya; Kiran S.,9993,0,9999,6
1745811988680,MCWP 40,A00,892729,Duru; Nur,13,0,20,7
1745811988680,MCWP 40,B00,893304,Montejo; Carolina,20,0,20,0
1745811989706,MCWP 40R,A00,893757,Redela; Pamela Morgan,0,7,20,20
1745811990731,MCWP 50,A00,893758,Morshed; Michael James,2,0,20,18
1745811990731,MCWP 50,B00,893761,Bartulis; Jason Michael,17,0,20,3
1745811991758,MCWP 50R,A00,893766,Compas; Sean Matthew,0,1,20,20
1745811991758,MCWP 50R,B00,893769,Carter; Jennifer A,0,0,20,20
1745811991758,MCWP 50R,C00,893771,Krone; Jarret,0,3,20,20
1745811991758,MCWP 50R,D00,893772,Miller; Elizabeth Deen,3,0,20,17
1745811991758,MCWP 50R,E00,893775,Carter; Andrea L,0,0,20,20
1745811992784,MMW 11R,A01,892721,Herbst; Matthew,11,0,27,16
1745811992784,MMW 11R,A02,892722,Herbst; Matthew,0,0,0,3
1745811993815,MMW 12R,A01,892724,Herbst; Matthew,0,9,16,16
1745811993815,MMW 12R,A02,892725,Herbst; Matthew,0,9,16,16
1745811994843,MMW 13R,A01,892727,Staff,0,4,16,16
1745811994843,MMW 13R,A02,892728,Staff,0,4,16,16
1745811994843,MMW 13R,A03,958032,Staff,0,3,16,16
1745811994843,MMW 13R,A04,958033,Staff,0,2,16,16
1745811994843,MMW 13R,A05,958034,Staff,0,3,16,16
1745811995869,SIO 295LS,A00,894015,Staff,7,0,25,18
1745811996898,SIO 295S,A00,894020,Staff,7,0,25,18
1745811997928,SIOC 290S,B01,958918,Staff,0,0,0,0
1745811998958,SIOC 291S,B01,958922,Staff,0,0,0,0
1745811999984,SOCI 117,A01,895339,Staff,4,0,5,1
1745812001008,WES 237B,A00,894149,Staff,11,0,20,9
1745812003076,AESE 279B,A00,891859,Staff,13,0,35,22
1745812004104,AIP 197,001,891854,Staff,70,0,70,0
1745812005130,ANTH 289S,A00,891856,Gagneux; Pascal,12,0,12,0
1745812006158,BENG 196,001,957946,Engler; Adam J.,9996,0,9999,3
1745812007183,CAT 124RS,A01,956906,Staff,8,0,25,17
1745812008211,CAT 125RS,A01,922013,Staff,8,0,25,17
1745812009235,CLRE 250,A00,891860,Morris; Sheldon,9995,0,9999,4
1745812011290,CLRE 251R,A00,907817,Mehta; Ravindra L.,9994,0,9999,5
1745812012318,CLRE 252,A00,891864,Cuomo; Raphael Eduardo,9993,0,9999,6
1745812013343,CLRE 253,A00,891867,Vaida; Florin,9994,0,9999,5
1745812013343,CLRE 253,B00,907819,Staff,9999,0,9999,0
1745812014372,CLRE 259,A00,891868,Patel; Hemal,9998,0,9999,1
1745812015399,CLRE 260,A00,891872,Cuomo; Raphael Eduardo,9999,0,9999,0
1745812016424,CLRE 297,001,891888,Cuomo; Raphael Eduardo,9999,0,9999,0
1745812017454,CSE 191,A00,958773,Minnes Kemp; Mor Mia,9999,0,9999,0
1745812018478,CSS 201S,A01,892054,Mignozzetti; Umberto,30,0,30,0
1745812019505,CSS 202S,A01,892056,Mignozzetti; Umberto,30,0,30,0
1745812020530,DSC 197,001,956898,Eldridge; Justin Matthew,9998,0,9999,1
1745812021554,DSC 297,001,958000,Mazumdar; Arya,9998,0,9999,1
1745812022580,EAP 100,A00,905686,Staff,9776,0,9999,223
1745812023605,ECE 45,A01,892618,Staff,0,12,50,50
1745812024633,ECE 109,A01,892620,Staff,0,44,0,0
1745812025660,ECE 111,A01,892719,Staff,0,8,50,50
1745812026692,ECE 197,001,957920,Mercier; Patrick Philip,9992,0,9999,7
1745812027721,ECON 178,A01,907814,Zhu; Ying,28,0,35,7
1745812028748,EDS 115,A00,895312,Staff,41,0,45,4
1745812029774,EDS 117,A01,895337,Staff,30,0,30,0
1745812030800,EDS 125,A00,895341,Jones; Gabrielle Anastasia,43,0,45,2
1745812031828,EDS 128A,A01,895459,Fargason; Sharon Gayle,44,0,45,1
1745812032857,EDS 128B,A01,895543,Pappas; Elizabeth,44,0,45,1
1745812033886,EDS 139,A00,897203,Pappas; Elizabeth,44,0,45,1
1745812033886,EDS 139,B00,897209,Fargason; Sharon Gayle,44,0,45,1
1745812034912,EDS 201,A00,895545,Staff,43,0,45,2
1745812035941,EDS 203,A01,895581,Halter; Christopher P.,43,0,45,2
1745812036967,EDS 204R,A01,895625,Heinzman; Erica M.,43,0,45,2
1745812036967,EDS 204R,B01,895693,Halter; Christopher P.,18,0,45,27
1745812037996,EDS 206R,A00,895694,Fargason; Sharon Gayle,9,0,30,21
1745812037996,EDS 206R,B00,895695,Choi; Bailey Miyeon,20,0,30,10
1745812039021,EDS 250,A00,895697,Hemans; Patricia Ann Benitez,43,0,45,2
1745812040050,EDS 281,A00,895701,Meyerott; Theresa Ann,15,0,15,0
1745812041079,EDS 284,A00,895736,Meyerott; Theresa Ann,15,0,15,0
1745812042106,EDS 286,A00,897210,Fine; Sarah,15,0,15,0
1745812043134,EDS 289C,A01,895770,Daly; Alan J.,15,0,15,0
1745812044159,EDS 290,A00,897211,Hofstetter; Carolyn,15,0,15,0
1745812045187,LIGM 5A,A00,896162,Fischer-Grunski; Eva K,15,0,20,5
1745812046218,LIGM 5B,A00,896260,Fischer-Grunski; Eva K,17,0,20,3
1745812047243,LIGM 5C,A00,896308,Fischer-Grunski; Eva K,18,0,20,2
1745812048270,LIIT 5AS,A00,896313,Carnelos; Chiara,18,0,20,2
1745812049297,LIIT 5BS,A00,896416,Carnelos; Chiara,20,0,20,0
1745812050323,LIIT 5CS,A00,896564,Carnelos; Chiara,20,0,20,0
1745812051353,LISP 5A,A00,896588,Munoz Sanchez; Alicia,4,0,20,16
1745812052393,LISP 5B,A00,896653,Munoz Sanchez; Alicia,10,0,20,10
1745812053422,LISP 5C,A00,896655,Munoz Sanchez; Alicia,4,0,20,16
1745812054447,MAE 197,001,957918,Kleissl; Jan,9998,0,9999,1
1745812055475,MATH 2,A01,957937,Staff,34,0,35,1
1745812056502,MATH 197,001,957876,Kedlaya; Kiran S.,9993,0,9999,6
1745812057532,MCWP 40,A00,892729,Duru; Nur,13,0,20,7
1745812057532,MCWP 40,B00,893304,Montejo; Carolina,20,0,20,0
1745812058557,MCWP 40R,A00,893757,Redela; Pamela Morgan,0,7,20,20
1745812059583,MCWP 50,A00,893758,Morshed; Michael James,2,0,20,18
1745812059583,MCWP 50,B00,893761,Bartulis; Jason Michael,17,0,20,3
1745812060609,MCWP 50R,A00,893766,Compas; Sean Matthew,0,1,20,20
1745812060609,MCWP 50R,B00,893769,Carter; Jennifer A,0,0,20,20
1745812060609,MCWP 50R,C00,893771,Krone; Jarret,0,3,20,20
1745812060609,MCWP 50R,D00,893772,Miller; Elizabeth Deen,3,0,20,17
1745812060609,MCWP 50R,E00,893775,Carter; Andrea L,0,0,20,20
1745812061635,MMW 11R,A01,892721,Herbst; Matthew,11,0,27,16
1745812061635,MMW 11R,A02,892722,Herbst; Matthew,0,0,0,3
1745812062663,MMW 12R,A01,892724,Herbst; Matthew,0,9,16,16
1745812062663,MMW 12R,A02,892725,Herbst; Matthew,0,9,16,16
1745812063687,MMW 13R,A01,892727,Staff,0,4,16,16
1745812063687,MMW 13R,A02,892728,Staff,0,4,16,16
1745812063687,MMW 13R,A03,958032,Staff,0,3,16,16
1745812063687,MMW 13R,A04,958033,Staff,0,2,16,16
1745812063687,MMW 13R,A05,958034,Staff,0,3,16,16
1745812064715,SIO 295LS,A00,894015,Staff,7,0,25,18
1745812065742,SIO 295S,A00,894020,Staff,7,0,25,18
1745812066767,SIOC 290S,B01,958918,Staff,0,0,0,0
1745812067793,SIOC 291S,B01,958922,Staff,0,0,0,0
1745812068826,SOCI 117,A01,895339,Staff,4,0,5,1
1745812069850,WES 237B,A00,894149,Staff,11,0,20,9
1745812071913,AESE 279B,A00,891859,Staff,13,0,35,22
1745812072942,AIP 197,001,891854,Staff,70,0,70,0
1745812073968,ANTH 289S,A00,891856,Gagneux; Pascal,12,0,12,0
1745812074994,BENG 196,001,957946,Engler; Adam J.,9996,0,9999,3
1745812076021,CAT 124RS,A01,956906,Staff,8,0,25,17
1745812077048,CAT 125RS,A01,922013,Staff,8,0,25,17
1745812078074,CLRE 250,A00,891860,Morris; Sheldon,9995,0,9999,4
1745812080130,CLRE 251R,A00,907817,Mehta; Ravindra L.,9994,0,9999,5
1745812081155,CLRE 252,A00,891864,Cuomo; Raphael Eduardo,9993,0,9999,6
1745812082180,CLRE 253,A00,891867,Vaida; Florin,9994,0,9999,5
1745812082180,CLRE 253,B00,907819,Staff,9999,0,9999,0
1745812083207,CLRE 259,A00,891868,Patel; Hemal,9998,0,9999,1
1745812084235,CLRE 260,A00,891872,Cuomo; Raphael Eduardo,9999,0,9999,0
1745812085270,CLRE 297,001,891888,Cuomo; Raphael Eduardo,9999,0,9999,0
1745812086296,CSE 191,A00,958773,Minnes Kemp; Mor Mia,9999,0,9999,0
1745812087321,CSS 201S,A01,892054,Mignozzetti; Umberto,30,0,30,0
1745812088348,CSS 202S,A01,892056,Mignozzetti; Umberto,30,0,30,0
1745812089374,DSC 197,001,956898,Eldridge; Justin Matthew,9998,0,9999,1
1745812090400,DSC 297,001,958000,Mazumdar; Arya,9998,0,9999,1
1745812091428,EAP 100,A00,905686,Staff,9776,0,9999,223
1745812092493,ECE 45,A01,892618,Staff,0,12,50,50
1745812093521,ECE 109,A01,892620,Staff,0,44,0,0
1745812094550,ECE 111,A01,892719,Staff,0,8,50,50
1745812095576,ECE 197,001,957920,Mercier; Patrick Philip,9992,0,9999,7
1745812096599,ECON 178,A01,907814,Zhu; Ying,28,0,35,7
1745812097628,EDS 115,A00,895312,Staff,41,0,45,4
1745812098656,EDS 117,A01,895337,Staff,30,0,30,0
1745812099684,EDS 125,A00,895341,Jones; Gabrielle Anastasia,43,0,45,2
1745812100711,EDS 128A,A01,895459,Fargason; Sharon Gayle,44,0,45,1
1745812101737,EDS 128B,A01,895543,Pappas; Elizabeth,44,0,45,1
1745812102764,EDS 139,A00,897203,Pappas; Elizabeth,44,0,45,1
1745812102764,EDS 139,B00,897209,Fargason; Sharon Gayle,44,0,45,1
1745812103789,EDS 201,A00,895545,Staff,43,0,45,2
1745812104815,EDS 203,A01,895581,Halter; Christopher P.,43,0,45,2
1745812105842,EDS 204R,A01,895625,Heinzman; Erica M.,43,0,45,2
1745812105842,EDS 204R,B01,895693,Halter; Christopher P.,18,0,45,27
1745812106868,EDS 206R,A00,895694,Fargason; Sharon Gayle,9,0,30,21
1745812106868,EDS 206R,B00,895695,Choi; Bailey Miyeon,20,0,30,10
1745812107895,EDS 250,A00,895697,Hemans; Patricia Ann Benitez,43,0,45,2
1745812108919,EDS 281,A00,895701,Meyerott; Theresa Ann,15,0,15,0
1745812109948,EDS 284,A00,895736,Meyerott; Theresa Ann,15,0,15,0
1745812110976,EDS 286,A00,897210,Fine; Sarah,15,0,15,0
1745812112003,EDS 289C,A01,895770,Daly; Alan J.,15,0,15,0
1745812113029,EDS 290,A00,897211,Hofstetter; Carolyn,15,0,15,0
1745812114054,LIGM 5A,A00,896162,Fischer-Grunski; Eva K,15,0,20,5
1745812115082,LIGM 5B,A00,896260,Fischer-Grunski; Eva K,17,0,20,3
1745812116108,LIGM 5C,A00,896308,Fischer-Grunski; Eva K,18,0,20,2
1745812117138,LIIT 5AS,A00,896313,Carnelos; Chiara,18,0,20,2
1745812118162,LIIT 5BS,A00,896416,Carnelos; Chiara,20,0,20,0
1745812119189,LIIT 5CS,A00,896564,Carnelos; Chiara,20,0,20,0
1745812120215,LISP 5A,A00,896588,Munoz Sanchez; Alicia,4,0,20,16
1745812121241,LISP 5B,A00,896653,Munoz Sanchez; Alicia,10,0,20,10
1745812122266,LISP 5C,A00,896655,Munoz Sanchez; Alicia,4,0,20,16
1745812123291,MAE 197,001,957918,Kleissl; Jan,9998,0,9999,1
1745812124319,MATH 2,A01,957937,Staff,34,0,35,1
1745812125347,MATH 197,001,957876,Kedlaya; Kiran S.,9993,0,9999,6
1745812126392,MCWP 40,A00,892729,Duru; Nur,13,0,20,7
1745812126392,MCWP 40,B00,893304,Montejo; Carolina,20,0,20,0
1745812127418,MCWP 40R,A00,893757,Redela; Pamela Morgan,0,7,20,20
1745812128444,MCWP 50,A00,893758,Morshed; Michael James,2,0,20,18
1745812128444,MCWP 50,B00,893761,Bartulis; Jason Michael,17,0,20,3
1745812129473,MCWP 50R,A00,893766,Compas; Sean Matthew,0,1,20,20
1745812129473,MCWP 50R,B00,893769,Carter; Jennifer A,0,0,20,20
1745812129473,MCWP 50R,C00,893771,Krone; Jarret,0,3,20,20
1745812129473,MCWP 50R,D00,893772,Miller; Elizabeth Deen,3,0,20,17
1745812129473,MCWP 50R,E00,893775,Carter; Andrea L,0,0,20,20
1745812130503,MMW 11R,A01,892721,Herbst; Matthew,11,0,27,16
1745812130503,MMW 11R,A02,892722,Herbst; Matthew,0,0,0,3
1745812131530,MMW 12R,A01,892724,Herbst; Matthew,0,9,16,16
1745812131530,MMW 12R,A02,892725,Herbst; Matthew,0,9,16,16
1745812132555,MMW 13R,A01,892727,Staff,0,4,16,16
1745812132555,MMW 13R,A02,892728,Staff,0,4,16,16
1745812132555,MMW 13R,A03,958032,Staff,0,3,16,16
1745812132555,MMW 13R,A04,958033,Staff,0,2,16,16
1745812132555,MMW 13R,A05,958034,Staff,0,3,16,16
1745812133580,SIO 295LS,A00,894015,Staff,7,0,25,18
1745812134607,SIO 295S,A00,894020,Staff,7,0,25,18
1745812135634,SIOC 290S,B01,958918,Staff,0,0,0,0
1745812136662,SIOC 291S,B01,958922,Staff,0,0,0,0
1745812137688,SOCI 117,A01,895339,Staff,4,0,5,1
1745812138712,WES 237B,A00,894149,Staff,11,0,20,9
1745812140770,AESE 279B,A00,891859,Staff,13,0,35,22
1745812141798,AIP 197,001,891854,Staff,70,0,70,0
1745812142828,ANTH 289S,A00,891856,Gagneux; Pascal,12,0,12,0
1745812143853,BENG 196,001,957946,Engler; Adam J.,9996,0,9999,3
1745812144880,CAT 124RS,A01,956906,Staff,8,0,25,17
1745812145908,CAT 125RS,A01,922013,Staff,8,0,25,17
1745812146935,CLRE 250,A00,891860,Morris; Sheldon,9995,0,9999,4
1745812148988,CLRE 251R,A00,907817,Mehta; Ravindra L.,9994,0,9999,5
1745812150018,CLRE 252,A00,891864,Cuomo; Raphael Eduardo,9993,0,9999,6
1745812151046,CLRE 253,A00,891867,Vaida; Florin,9994,0,9999,5
1745812151046,CLRE 253,B00,907819,Staff,9999,0,9999,0
1745812152072,CLRE 259,A00,891868,Patel; Hemal,9998,0,9999,1
1745812153100,CLRE 260,A00,891872,Cuomo; Raphael Eduardo,9999,0,9999,0
1745812154125,CLRE 297,001,891888,Cuomo; Raphael Eduardo,9999,0,9999,0
1745812155152,CSE 191,A00,958773,Minnes Kemp; Mor Mia,9999,0,9999,0
1745812156179,CSS 201S,A01,892054,Mignozzetti; Umberto,30,0,30,0
1745812157206,CSS 202S,A01,892056,Mignozzetti; Umberto,30,0,30,0
1745812158232,DSC 197,001,956898,Eldridge; Justin Matthew,9998,0,9999,1
1745812159259,DSC 297,001,958000,Mazumdar; Arya,9998,0,9999,1
1745812160286,EAP 100,A00,905686,Staff,9776,0,9999,223
1745812161316,ECE 45,A01,892618,Staff,0,12,50,50
1745812162343,ECE 109,A01,892620,Staff,0,44,0,0
1745812163372,ECE 111,A01,892719,Staff,0,8,50,50
1745812164396,ECE 197,001,957920,Mercier; Patrick Philip,9992,0,9999,7
1745812165426,ECON 178,A01,907814,Zhu; Ying,28,0,35,7
1745812166451,EDS 115,A00,895312,Staff,41,0,45,4
1745812167480,EDS 117,A01,895337,Staff,30,0,30,0
1745812168520,EDS 125,A00,895341,Jones; Gabrielle Anastasia,43,0,45,2
1745812169549,EDS 128A,A01,895459,Fargason; Sharon Gayle,44,0,45,1
1745812170574,EDS 128B,A01,895543,Pappas; Elizabeth,44,0,45,1
1745812171601,EDS 139,A00,897203,Pappas; Elizabeth,44,0,45,1
1745812171601,EDS 139,B00,897209,Fargason; Sharon Gayle,44,0,45,1
1745812172630,EDS 201,A00,895545,Staff,43,0,45,2
1745812173657,EDS 203,A01,895581,Halter; Christopher P.,43,0,45,2
1745812174683,EDS 204R,A01,895625,Heinzman; Erica M.,43,0,45,2
1745812174683,EDS 204R,B01,895693,Halter; Christopher P.,18,0,45,27
1745812175709,EDS 206R,A00,895694,Fargason; Sharon Gayle,9,0,30,21
1745812175709,EDS 206R,B00,895695,Choi; Bailey Miyeon,20,0,30,10
1745812176736,EDS 250,A00,895697,Hemans; Patricia Ann Benitez,43,0,45,2
1745812177761,EDS 281,A00,895701,Meyerott; Theresa Ann,15,0,15,0
1745812178785,EDS 284,A00,895736,Meyerott; Theresa Ann,15,0,15,0
1745812179812,EDS 286,A00,897210,Fine; Sarah,15,0,15,0
1745812180838,EDS 289C,A01,895770,Daly; Alan J.,15,0,15,0
1745812181864,EDS 290,A00,897211,Hofstetter; Carolyn,15,0,15,0
1745812182894,LIGM 5A,A00,896162,Fischer-Grunski; Eva K,15,0,20,5
1745812183921,LIGM 5B,A00,896260,Fischer-Grunski; Eva K,17,0,20,3
1745812184948,LIGM 5C,A00,896308,Fischer-Grunski; Eva K,18,0,20,2
1745812185975,LIIT 5AS,A00,896313,Carnelos; Chiara,18,0,20,2
1745812187001,LIIT 5BS,A00,896416,Carnelos; Chiara,20,0,20,0
1745812188027,LIIT 5CS,A00,896564,Carnelos; Chiara,20,0,20,0
1745812189055,LISP 5A,A00,896588,Munoz Sanchez; Alicia,4,0,20,16
1745812190081,LISP 5B,A00,896653,Munoz Sanchez; Alicia,10,0,20,10
1745812191107,LISP 5C,A00,896655,Munoz Sanchez; Alicia,4,0,20,16
1745812192135,MAE 197,001,957918,Kleissl; Jan,9998,0,9999,1
1745812193161,MATH 2,A01,957937,Staff,34,0,35,1
1745812194189,MATH 197,001,957876,Kedlaya; Kiran S.,9993,0,9999,6
1745812195218,MCWP 40,A00,892729,Duru; Nur,13,0,20,7
1745812195218,MCWP 40,B00,893304,Montejo; Carolina,20,0,20,0
1745812196248,MCWP 40R,A00,893757,Redela; Pamela Morgan,0,7,20,20
1745812197273,MCWP 50,A00,893758,Morshed; Michael James,2,0,20,18
1745812197273,MCWP 50,B00,893761,Bartulis; Jason Michael,17,0,20,3
1745812198300,MCWP 50R,A00,893766,Compas; Sean Matthew,0,1,20,20
1745812198300,MCWP 50R,B00,893769,Carter; Jennifer A,0,0,20,20
1745812198300,MCWP 50R,C00,893771,Krone; Jarret,0,3,20,20
1745812198300,MCWP 50R,D00,893772,Miller; Elizabeth Deen,3,0,20,17
1745812198300,MCWP 50R,E00,893775,Carter; Andrea L,0,0,20,20
1745812199326,MMW 11R,A01,892721,Herbst; Matthew,11,0,27,16
1745812199326,MMW 11R,A02,892722,Herbst; Matthew,0,0,0,3
1745812200352,MMW 12R,A01,892724,Herbst; Matthew,0,9,16,16
1745812200352,MMW 12R,A02,892725,Herbst; Matthew,0,9,16,16
1745812201400,MMW 13R,A01,892727,Staff,0,4,16,16
1745812201400,MMW 13R,A02,892728,Staff,0,4,16,16
1745812201400,MMW 13R,A03,958032,Staff,0,3,16,16
1745812201400,MMW 13R,A04,958033,Staff,0,2,16,16
1745812201400,MMW 13R,A05,958034,Staff,0,3,16,16
1745812202427,SIO 295LS,A00,894015,Staff,7,0,25,18
1745812203454,SIO 295S,A00,894020,Staff,7,0,25,18
1745812204481,SIOC 290S,B01,958918,Staff,0,0,0,0
1745812205513,SIOC 291S,B01,958922,Staff,0,0,0,0
1745812206541,SOCI 117,A01,895339,Staff,4,0,5,1
1745812207568,WES 237B,A00,894149,Staff,11,0,20,9
1745812209629,AESE 279B,A00,891859,Staff,13,0,35,22
1745812210656,AIP 197,001,891854,Staff,70,0,70,0
1745812211686,ANTH 289S,A00,891856,Gagneux; Pascal,12,0,12,0
1745812212713,BENG 196,001,957946,Engler; Adam J.,9996,0,9999,3
1745812213738,CAT 124RS,A01,956906,Staff,8,0,25,17
1745812214768,CAT 125RS,A01,922013,Staff,8,0,25,17
1745812215794,CLRE 250,A00,891860,Morris; Sheldon,9995,0,9999,4
1745812217847,CLRE 251R,A00,907817,Mehta; Ravindra L.,9994,0,9999,5
1745812218872,CLRE 252,A00,891864,Cuomo; Raphael Eduardo,9993,0,9999,6
1745812219900,CLRE 253,A00,891867,Vaida; Florin,9994,0,9999,5
1745812219900,CLRE 253,B00,907819,Staff,9999,0,9999,0
1745812220926,CLRE 259,A00,891868,Patel; Hemal,9998,0,9999,1
1745812221954,CLRE 260,A00,891872,Cuomo; Raphael Eduardo,9999,0,9999,0
1745812222980,CLRE 297,001,891888,Cuomo; Raphael Eduardo,9999,0,9999,0
1745812224008,CSE 191,A00,958773,Minnes Kemp; Mor Mia,9999,0,9999,0
1745812225034,CSS 201S,A01,892054,Mignozzetti; Umberto,30,0,30,0
1745812226060,CSS 202S,A01,892056,Mignozzetti; Umberto,30,0,30,0
1745812227088,DSC 197,001,956898,Eldridge; Justin Matthew,9998,0,9999,1
1745812228116,DSC 297,001,958000,Mazumdar; Arya,9998,0,9999,1
1745812229144,EAP 100,A00,905686,Staff,9776,0,9999,223
1745812230175,ECE 45,A01,892618,Staff,0,12,50,50
1745812231203,ECE 109,A01,892620,Staff,0,44,0,0
1745812232230,ECE 111,A01,892719,Staff,0,8,50,50
1745812233258,ECE 197,001,957920,Mercier; Patrick Philip,9992,0,9999,7
1745812234288,ECON 178,A01,907814,Zhu; Ying,28,0,35,7
1745812235317,EDS 115,A00,895312,Staff,41,0,45,4
1745812236347,EDS 117,A01,895337,Staff,30,0,30,0
1745812237372,EDS 125,A00,895341,Jones; Gabrielle Anastasia,43,0,45,2
1745812238399,EDS 128A,A01,895459,Fargason; Sharon Gayle,44,0,45,1
1745812239425,EDS 128B,A01,895543,Pappas; Elizabeth,44,0,45,1
1745812240453,EDS 139,A00,897203,Pappas; Elizabeth,44,0,45,1
1745812240453,EDS 139,B00,897209,Fargason; Sharon Gayle,44,0,45,1
1745812241480,EDS 201,A00,895545,Staff,43,0,45,2
1745812242508,EDS 203,A01,895581,Halter; Christopher P.,43,0,45,2
1745812243535,EDS 204R,A01,895625,Heinzman; Erica M.,43,0,45,2
1745812243535,EDS 204R,B01,895693,Halter; Christopher P.,18,0,45,27
1745812244563,EDS 206R,A00,895694,Fargason; Sharon Gayle,9,0,30,21
1745812244563,EDS 206R,B00,895695,Choi; Bailey Miyeon,20,0,30,10
1745812245588,EDS 250,A00,895697,Hemans; Patricia Ann Benitez,43,0,45,2
1745812246614,EDS 281,A00,895701,Meyerott; Theresa Ann,15,0,15,0
1745812247639,EDS 284,A00,895736,Meyerott; Theresa Ann,15,0,15,0
1745812248666,EDS 286,A00,897210,Fine; Sarah,15,0,15,0
1745812249690,EDS 289C,A01,895770,Daly; Alan J.,15,0,15,0
1745812250716,EDS 290,A00,897211,Hofstetter; Carolyn,15,0,15,0
1745812251743,LIGM 5A,A00,896162,Fischer-Grunski; Eva K,15,0,20,5
1745812252769,LIGM 5B,A00,896260,Fischer-Grunski; Eva K,17,0,20,3
1745812253795,LIGM 5C,A00,896308,Fischer-Grunski; Eva K,18,0,20,2
1745812254824,LIIT 5AS,A00,896313,Carnelos; Chiara,18,0,20,2
1745812255853,LIIT 5BS,A00,896416,Carnelos; Chiara,20,0,20,0
1745812256880,LIIT 5CS,A00,896564,Carnelos; Chiara,20,0,20,0
1745812257907,LISP 5A,A00,896588,Munoz Sanchez; Alicia,4,0,20,16
1745812258932,LISP 5B,A00,896653,Munoz Sanchez; Alicia,10,0,20,10
1745812259963,LISP 5C,A00,896655,Munoz Sanchez; Alicia,4,0,20,16
1745812260989,MAE 197,001,957918,Kleissl; Jan,9998,0,9999,1
1745812262017,MATH 2,A01,957937,Staff,34,0,35,1
1745812263064,MATH 197,001,957876,Kedlaya; Kiran S.,9993,0,9999,6
1745812264090,MCWP 40,A00,892729,Duru; Nur,13,0,20,7
1745812264090,MCWP 40,B00,893304,Montejo; Carolina,20,0,20,0
1745812265121,MCWP 40R,A00,893757,Redela; Pamela Morgan,0,7,20,20
1745812266149,MCWP 50,A00,893758,Morshed; Michael James,2,0,20,18
1745812266149,MCWP 50,B00,893761,Bartulis; Jason Michael,17,0,20,3
1745812267197,MCWP 50R,A00,893766,Compas; Sean Matthew,0,1,20,20
1745812267197,MCWP 50R,B00,893769,Carter; Jennifer A,0,0,20,20
1745812267197,MCWP 50R,C00,893771,Krone; Jarret,0,3,20,20
1745812267197,MCWP 50R,D00,893772,Miller; Elizabeth Deen,3,0,20,17
1745812267197,MCWP 50R,E00,893775,Carter; Andrea L,0,0,20,20
1745812268222,MMW 11R,A01,892721,Herbst; Matthew,11,0,27,16
1745812268222,MMW 11R,A02,892722,Herbst; Matthew,0,0,0,3
1745812269250,MMW 12R,A01,892724,Herbst; Matthew,0,9,16,16
1745812269250,MMW 12R,A02,892725,Herbst; Matthew,0,9,16,16
1745812270279,MMW 13R,A01,892727,Staff,0,4,16,16
1745812270279,MMW 13R,A02,892728,Staff,0,4,16,16
1745812270279,MMW 13R,A03,958032,Staff,0,3,16,16
1745812270279,MMW 13R,A04,958033,Staff,0,2,16,16
1745812270279,MMW 13R,A05,958034,Staff,0,3,16,16
1745812271304,SIO 295LS,A00,894015,Staff,7,0,25,18
1745812272331,SIO 295S,A00,894020,Staff,7,0,25,18
1745812273356,SIOC 290S,B01,958918,Staff,0,0,0,0
1745812274382,SIOC 291S,B01,958922,Staff,0,0,0,0
1745812275409,SOCI 117,A01,895339,Staff,4,0,5,1
1745812276435,WES 237B,A00,894149,Staff,11,0,20,9
1745812278492,AESE 279B,A00,891859,Staff,13,0,35,22
1745812279520,AIP 197,001,891854,Staff,70,0,70,0
1745812280549,ANTH 289S,A00,891856,Gagneux; Pascal,12,0,12,0
1745812281573,BENG 196,001,957946,Engler; Adam J.,9996,0,9999,3
1745812282600,CAT 124RS,A01,956906,Staff,8,0,25,17
1745812283628,CAT 125RS,A01,922013,Staff,8,0,25,17
1745812284656,CLRE 250,A00,891860,Morris; Sheldon,9995,0,9999,4
1745812286712,CLRE 251R,A00,907817,Mehta; Ravindra L.,9994,0,9999,5
1745812287736,CLRE 252,A00,891864,Cuomo; Raphael Eduardo,9993,0,9999,6
1745812288761,CLRE 253,A00,891867,Vaida; Florin,9994,0,9999,5
1745812288761,CLRE 253,B00,907819,Staff,9999,0,9999,0
1745812289787,CLRE 259,A00,891868,Patel; Hemal,9998,0,9999,1
1745812290813,CLRE 260,A00,891872,Cuomo; Raphael Eduardo,9999,0,9999,0
1745812291842,CLRE 297,001,891888,Cuomo; Raphael Eduardo,9999,0,9999,0
1745812292868,CSE 191,A00,958773,Minnes Kemp; Mor Mia,9999,0,9999,0
1745812293894,CSS 201S,A01,892054,Mignozzetti; Umberto,30,0,30,0
1745812294920,CSS 202S,A01,892056,Mignozzetti; Umberto,30,0,30,0
1745812295945,DSC 197,001,956898,Eldridge; Justin Matthew,9998,0,9999,1
1745812296971,DSC 297,001,958000,Mazumdar; Arya,9998,0,9999,1
1745812297995,EAP 100,A00,905686,Staff,9776,0,9999,223
1745812299024,ECE 45,A01,892618,Staff,0,12,50,50
1745812300049,ECE 109,A01,892620,Staff,0,44,0,0
1745812301075,ECE 111,A01,892719,Staff,0,8,50,50
1745812302101,ECE 197,001,957920,Mercier; Patrick Philip,9992,0,9999,7
1745812303128,ECON 178,A01,907814,Zhu; Ying,28,0,35,7
1745812304152,EDS 115,A00,895312,Staff,41,0,45,4
1745812305181,EDS 117,A01,895337,Staff,30,0,30,0
1745812306207,EDS 125,A00,895341,Jones; Gabrielle Anastasia,43,0,45,2
1745812307236,EDS 128A,A01,895459,Fargason; Sharon Gayle,44,0,45,1
1745812308266,EDS 128B,A01,895543,Pappas; Elizabeth,44,0,45,1
1745812309291,EDS 139,A00,897203,Pappas; Elizabeth,44,0,45,1
1745812309291,EDS 139,B00,897209,Fargason; Sharon Gayle,44,0,45,1
1745812310315,EDS 201,A00,895545,Staff,43,0,45,2
1745812311341,EDS 203,A01,895581,Halter; Christopher P.,43,0,45,2
1745812312367,EDS 204R,A01,895625,Heinzman; Erica M.,43,0,45,2
1745812312367,EDS 204R,B01,895693,Halter; Christopher P.,18,0,45,27
1745812313399,EDS 206R,A00,895694,Fargason; Sharon Gayle,9,0,30,21
1745812313399,EDS 206R,B00,895695,Choi; Bailey Miyeon,20,0,30,10
1745812314427,EDS 250,A00,895697,Hemans; Patricia Ann Benitez,43,0,45,2
1745812315455,EDS 281,A00,895701,Meyerott; Theresa Ann,15,0,15,0
1745812316481,EDS 284,A00,895736,Meyerott; Theresa Ann,15,0,15,0
1745812317507,EDS 286,A00,897210,Fine; Sarah,15,0,15,0
1745812318532,EDS 289C,A01,895770,Daly; Alan J.,15,0,15,0
1745812319558,EDS 290,A00,897211,Hofstetter; Carolyn,15,0,15,0
1745812320589,LIGM 5A,A00,896162,Fischer-Grunski; Eva K,15,0,20,5
1745812321617,LIGM 5B,A00,896260,Fischer-Grunski; Eva K,17,0,20,3
1745812322644,LIGM 5C,A00,896308,Fischer-Grunski; Eva K,18,0,20,2
1745812323672,LIIT 5AS,A00,896313,Carnelos; Chiara,18,0,20,2
1745812324698,LIIT 5BS,A00,896416,Carnelos; Chiara,20,0,20,0
1745812325726,LIIT 5CS,A00,896564,Carnelos; Chiara,20,0,20,0
1745812326755,LISP 5A,A00,896588,Munoz Sanchez; Alicia,4,0,20,16
1745812327781,LISP 5B,A00,896653,Munoz Sanchez; Alicia,10,0,20,10
1745812328812,LISP 5C,A00,896655,Munoz Sanchez; Alicia,4,0,20,16
1745812329840,MAE 197,001,957918,Kleissl; Jan,9998,0,9999,1
1745812330869,MATH 2,A01,957937,Staff,34,0,35,1
1745812331894,MATH 197,001,957876,Kedlaya; Kiran S.,9993,0,9999,6
1745812332919,MCWP 40,A00,892729,Duru; Nur,13,0,20,7
1745812332919,MCWP 40,B00,893304,Montejo; Carolina,20,0,20,0
1745812333943,MCWP 40R,A00,893757,Redela; Pamela Morgan,0,7,20,20
1745812334969,MCWP 50,A00,893758,Morshed; Michael James,2,0,20,18
1745812334969,MCWP 50,B00,893761,Bartulis; Jason Michael,17,0,20,3
1745812335996,MCWP 50R,A00,893766,Compas; Sean Matthew,0,1,20,20
1745812335996,MCWP 50R,B00,893769,Carter; Jennifer A,0,0,20,20
1745812335996,MCWP 50R,C00,893771,Krone; Jarret,0,3,20,20
1745812335996,MCWP 50R,D00,893772,Miller; Elizabeth Deen,3,0,20,17
1745812335996,MCWP 50R,E00,893775,Carter; Andrea L,0,0,20,20
1745812337025,MMW 11R,A01,892721,Herbst; Matthew,11,0,27,16
1745812337025,MMW 11R,A02,892722,Herbst; Matthew,0,0,0,3
1745812338052,MMW 12R,A01,892724,Herbst; Matthew,0,9,16,16
1745812338052,MMW 12R,A02,892725,Herbst; Matthew,0,9,16,16
1745812339083,MMW 13R,A01,892727,Staff,0,4,16,16
1745812339083,MMW 13R,A02,892728,Staff,0,4,16,16
1745812339083,MMW 13R,A03,958032,Staff,0,3,16,16
1745812339083,MMW 13R,A04,958033,Staff,0,2,16,16
1745812339083,MMW 13R,A05,958034,Staff,0,3,16,16
1745812340109,SIO 295LS,A00,894015,Staff,7,0,25,18
1745812341136,SIO 295S,A00,894020,Staff,7,0,25,18
1745812342163,SIOC 290S,B01,958918,Staff,0,0,0,0
1745812343194,SIOC 291S,B01,958922,Staff,0,0,0,0
1745812344219,SOCI 117,A01,895339,Staff,4,0,5,1
1745812345247,WES 237B,A00,894149,Staff,11,0,20,9
1745812347314,AESE 279B,A00,891859,Staff,13,0,35,22
1745812348342,AIP 197,001,891854,Staff,70,0,70,0
1745812349368,ANTH 289S,A00,891856,Gagneux; Pascal,12,0,12,0
1745812350398,BENG 196,001,957946,Engler; Adam J.,9996,0,9999,3
1745812351425,CAT 124RS,A01,956906,Staff,8,0,25,17
1745812352451,CAT 125RS,A01,922013,Staff,8,0,25,17
1745812353479,CLRE 250,A00,891860,Morris; Sheldon,9995,0,9999,4
1745812355532,CLRE 251R,A00,907817,Mehta; Ravindra L.,9994,0,9999,5
1745812356558,CLRE 252,A00,891864,Cuomo; Raphael Eduardo,9993,0,9999,6
1745812357583,CLRE 253,A00,891867,Vaida; Florin,9994,0,9999,5
1745812357583,CLRE 253,B00,907819,Staff,9999,0,9999,0
1745812358612,CLRE 259,A00,891868,Patel; Hemal,9998,0,9999,1
1745812359640,CLRE 260,A00,891872,Cuomo; Raphael Eduardo,9999,0,9999,0
1745812360663,CLRE 297,001,891888,Cuomo; Raphael Eduardo,9999,0,9999,0
1745812361692,CSE 191,A00,958773,Minnes Kemp; Mor Mia,9999,0,9999,0
1745812362717,CSS 201S,A01,892054,Mignozzetti; Umberto,30,0,30,0
1745812363743,CSS 202S,A01,892056,Mignozzetti; Umberto,30,0,30,0
1745812364772,DSC 197,001,956898,Eldridge; Justin Matthew,9998,0,9999,1
1745812365797,DSC 297,001,958000,Mazumdar; Arya,9998,0,9999,1
1745812366825,EAP 100,A00,905686,Staff,9776,0,9999,223
1745812367851,ECE 45,A01,892618,Staff,0,12,50,50
1745812368877,ECE 109,A01,892620,Staff,0,44,0,0
1745812369903,ECE 111,A01,892719,Staff,0,8,50,50
1745812370932,ECE 197,001,957920,Mercier; Patrick Philip,9992,0,9999,7
1745812371959,ECON 178,A01,907814,Zhu; Ying,28,0,35,7
1745812372984,EDS 115,A00,895312,Staff,41,0,45,4
1745812374011,EDS 117,A01,895337,Staff,30,0,30,0
1745812375037,EDS 125,A00,895341,Jones; Gabrielle Anastasia,43,0,45,2
1745812376064,EDS 128A,A01,895459,Fargason; Sharon Gayle,44,0,45,1
1745812377093,EDS 128B,A01,895543,Pappas; Elizabeth,44,0,45,1
1745812378119,EDS 139,A00,897203,Pappas; Elizabeth,44,0,45,1
1745812378119,EDS 139,B00,897209,Fargason; Sharon Gayle,44,0,45,1
1745812379149,EDS 201,A00,895545,Staff,43,0,45,2
1745812380180,EDS 203,A01,895581,Halter; Christopher P.,43,0,45,2
1745812381207,EDS 204R,A01,895625,Heinzman; Erica M.,43,0,45,2
1745812381207,EDS 204R,B01,895693,Halter; Christopher P.,18,0,45,27
1745812382240,EDS 206R,A00,895694,Fargason; Sharon Gayle,9,0,30,21
1745812382240,EDS 206R,B00,895695,Choi; Bailey Miyeon,20,0,30,10
1745812383267,EDS 250,A00,895697,Hemans; Patricia Ann Benitez,43,0,45,2
1745812384294,EDS 281,A00,895701,Meyerott; Theresa Ann,15,0,15,0
1745812385324,EDS 284,A00,895736,Meyerott; Theresa Ann,15,0,15,0
1745812386353,EDS 286,A00,897210,Fine; Sarah,15,0,15,0
1745812387379,EDS 289C,A01,895770,Daly; Alan J.,15,0,15,0
1745812388405,EDS 290,A00,897211,Hofstetter; Carolyn,15,0,15,0
1745812389434,LIGM 5A,A00,896162,Fischer-Grunski; Eva K,15,0,20,5
1745812390461,LIGM 5B,A00,896260,Fischer-Grunski; Eva K,17,0,20,3
1745812391490,LIGM 5C,A00,896308,Fischer-Grunski; Eva K,18,0,20,2
1745812392516,LIIT 5AS,A00,896313,Carnelos; Chiara,18,0,20,2
1745812393541,LIIT 5BS,A00,896416,Carnelos; Chiara,20,0,20,0
1745812394568,LIIT 5CS,A00,896564,Carnelos; Chiara,20,0,20,0
1745812395593,LISP 5A,A00,896588,Munoz Sanchez; Alicia,4,0,20,16
1745812396617,LISP 5B,A00,896653,Munoz Sanchez; Alicia,10,0,20,10
1745812397643,LISP 5C,A00,896655,Munoz Sanchez; Alicia,4,0,20,16
1745812398670,MAE 197,001,957918,Kleissl; Jan,9998,0,9999,1
1745812399699,MATH 2,A01,957937,Staff,34,0,35,1
1745812400724,MATH 197,001,957876,Kedlaya; Kiran S.,9993,0,9999,6
1745812401752,MCWP 40,A00,892729,Duru; Nur,13,0,20,7
1745812401752,MCWP 40,B00,893304,Montejo; Carolina,20,0,20,0
1745812402778,MCWP 40R,A00,893757,Redela; Pamela Morgan,0,7,20,20
1745812403803,MCWP 50,A00,893758,Morshed; Michael James,2,0,20,18
1745812403803,MCWP 50,B00,893761,Bartulis; Jason Michael,17,0,20,3
1745812404833,MCWP 50R,A00,893766,Compas; Sean Matthew,0,1,20,20
1745812404833,MCWP 50R,B00,893769,Carter; Jennifer A,0,0,20,20
1745812404833,MCWP 50R,C00,893771,Krone; Jarret,0,3,20,20
1745812404833,MCWP 50R,D00,893772,Miller; Elizabeth Deen,3,0,20,17
1745812404833,MCWP 50R,E00,893775,Carter; Andrea L,0,0,20,20
1745812405863,MMW 11R,A01,892721,Herbst; Matthew,11,0,27,16
1745812405863,MMW 11R,A02,892722,Herbst; Matthew,0,0,0,3
1745812406894,MMW 12R,A01,892724,Herbst; Matthew,0,9,16,16
1745812406894,MMW 12R,A02,892725,Herbst; Matthew,0,9,16,16
1745812407920,MMW 13R,A01,892727,Staff,0,4,16,16
1745812407920,MMW 13R,A02,892728,Staff,0,4,16,16
1745812407920,MMW 13R,A03,958032,Staff,0,3,16,16
1745812407920,MMW 13R,A04,958033,Staff,0,2,16,16
1745812407920,MMW 13R,A05,958034,Staff,0,3,16,16
1745812408946,SIO 295LS,A00,894015,Staff,7,0,25,18
1745812409973,SIO 295S,A00,894020,Staff,7,0,25,18
1745812410998,SIOC 290S,B01,958918,Staff,0,0,0,0
1745812412026,SIOC 291S,B01,958922,Staff,0,0,0,0
1745812413051,SOCI 117,A01,895339,Staff,4,0,5,1
1745812414077,WES 237B,A00,894149,Staff,11,0,20,9
1745812416143,AESE 279B,A00,891859,Staff,13,0,35,22
1745812417168,AIP 197,001,891854,Staff,70,0,70,0
1745812418195,ANTH 289S,A00,891856,Gagneux; Pascal,12,0,12,0
1745812419221,BENG 196,001,957946,Engler; Adam J.,9996,0,9999,3
1745812420246,CAT 124RS,A01,956906,Staff,8,0,25,17
1745812421273,CAT 125RS,A01,922013,Staff,8,0,25,17
1745812422300,CLRE 250,A00,891860,Morris; Sheldon,9995,0,9999,4
1745812424358,CLRE 251R,A00,907817,Mehta; Ravindra L.,9994,0,9999,5
1745812425387,CLRE 252,A00,891864,Cuomo; Raphael Eduardo,9993,0,9999,6
1745812426415,CLRE 253,A00,891867,Vaida; Florin,9994,0,9999,5
1745812426415,CLRE 253,B00,907819,Staff,9999,0,9999,0
1745812427443,CLRE 259,A00,891868,Patel; Hemal,9998,0,9999,1
1745812428475,CLRE 260,A00,891872,Cuomo; Raphael Eduardo,9999,0,9999,0
1745812429508,CLRE 297,001,891888,Cuomo; Raphael Eduardo,9999,0,9999,0
1745812430533,CSE 191,A00,958773,Minnes Kemp; Mor Mia,9999,0,9999,0
1745812431559,CSS 201S,A01,892054,Mignozzetti; Umberto,30,0,30,0
1745812432584,CSS 202S,A01,892056,Mignozzetti; Umberto,30,0,30,0
1745812433610,DSC 197,001,956898,Eldridge; Justin Matthew,9998,0,9999,1
1745812434637,DSC 297,001,958000,Mazumdar; Arya,9998,0,9999,1
1745812435665,EAP 100,A00,905686,Staff,9776,0,9999,223
1745812436694,ECE 45,A01,892618,Staff,0,12,50,50
1745812437720,ECE 109,A01,892620,Staff,0,44,0,0
1745812438745,ECE 111,A01,892719,Staff,0,8,50,50
1745812439773,ECE 197,001,957920,Mercier; Patrick Philip,9992,0,9999,7
1745812440802,ECON 178,A01,907814,Zhu; Ying,28,0,35,7
1745812441829,EDS 115,A00,895312,Staff,41,0,45,4
1745812442855,EDS 117,A01,895337,Staff,30,0,30,0
1745812443881,EDS 125,A00,895341,Jones; Gabrielle Anastasia,43,0,45,2
1745812444907,EDS 128A,A01,895459,Fargason; Sharon Gayle,44,0,45,1
1745812445934,EDS 128B,A01,895543,Pappas; Elizabeth,44,0,45,1
1745812446960,EDS 139,A00,897203,Pappas; Elizabeth,44,0,45,1
1745812446960,EDS 139,B00,897209,Fargason; Sharon Gayle,44,0,45,1
1745812447988,EDS 201,A00,895545,Staff,43,0,45,2
1745812449014,EDS 203,A01,895581,Halter; Christopher P.,43,0,45,2
1745812450040,EDS 204R,A01,895625,Heinzman; Erica M.,43,0,45,2
1745812450040,EDS 204R,B01,895693,Halter; Christopher P.,18,0,45,27
1745812451070,EDS 206R,A00,895694,Fargason; Sharon Gayle,9,0,30,21
1745812451070,EDS 206R,B00,895695,Choi; Bailey Miyeon,20,0,30,10
1745812452096,EDS 250,A00,895697,Hemans; Patricia Ann Benitez,43,0,45,2
1745812453126,EDS 281,A00,895701,Meyerott; Theresa Ann,15,0,15,0
1745812454154,EDS 284,A00,895736,Meyerott; Theresa Ann,15,0,15,0
1745812455183,EDS 286,A00,897210,Fine; Sarah,15,0,15,0
1745812456210,EDS 289C,A01,895770,Daly; Alan J.,15,0,15,0
1745812457234,EDS 290,A00,897211,Hofstetter; Carolyn,15,0,15,0
1745812458263,LIGM 5A,A00,896162,Fischer-Grunski; Eva K,15,0,20,5
1745812459292,LIGM 5B,A00,896260,Fischer-Grunski; Eva K,17,0,20,3
1745812460317,LIGM 5C,A00,896308,Fischer-Grunski; Eva K,18,0,20,2
1745812461346,LIIT 5AS,A00,896313,Carnelos; Chiara,18,0,20,2
1745812462383,LIIT 5BS,A00,896416,Carnelos; Chiara,20,0,20,0
1745812463412,LIIT 5CS,A00,896564,Carnelos; Chiara,20,0,20,0
1745812464438,LISP 5A,A00,896588,Munoz Sanchez; Alicia,4,0,20,16
1745812465464,LISP 5B,A00,896653,Munoz Sanchez; Alicia,10,0,20,10
1745812466493,LISP 5C,A00,896655,Munoz Sanchez; Alicia,4,0,20,16
1745812467521,MAE 197,001,957918,Kleissl; Jan,9998,0,9999,1
1745812468549,MATH 2,A01,957937,Staff,34,0,35,1
1745812469575,MATH 197,001,957876,Kedlaya; Kiran S.,9993,0,9999,6
1745812470604,MCWP 40,A00,892729,Duru; Nur,13,0,20,7
1745812470604,MCWP 40,B00,893304,Montejo; Carolina,20,0,20,0
1745812471633,MCWP 40R,A00,893757,Redela; Pamela Morgan,0,7,20,20
1745812472659,MCWP 50,A00,893758,Morshed; Michael James,2,0,20,18
1745812472659,MCWP 50,B00,893761,Bartulis; Jason Michael,17,0,20,3
1745812473686,MCWP 50R,A00,893766,Compas; Sean Matthew,0,1,20,20
1745812473686,MCWP 50R,B00,893769,Carter; Jennifer A,0,0,20,20
1745812473686,MCWP 50R,C00,893771,Krone; Jarret,0,3,20,20
1745812473686,MCWP 50R,D00,893772,Miller; Elizabeth Deen,3,0,20,17
1745812473686,MCWP 50R,E00,893775,Carter; Andrea L,0,0,20,20
1745812474712,MMW 11R,A01,892721,Herbst; Matthew,11,0,27,16
1745812474712,MMW 11R,A02,892722,Herbst; Matthew,0,0,0,3
1745812475740,MMW 12R,A01,892724,Herbst; Matthew,0,9,16,16
1745812475740,MMW 12R,A02,892725,Herbst; Matthew,0,9,16,16
1745812476769,MMW 13R,A01,892727,Staff,0,4,16,16
1745812476769,MMW 13R,A02,892728,Staff,0,4,16,16
1745812476769,MMW 13R,A03,958032,Staff,0,3,16,16
1745812476769,MMW 13R,A04,958033,Staff,0,2,16,16
1745812476769,MMW 13R,A05,958034,Staff,0,3,16,16
1745812477798,SIO 295LS,A00,894015,Staff,7,0,25,18
1745812478827,SIO 295S,A00,894020,Staff,7,0,25,18
1745812479856,SIOC 290S,B01,958918,Staff,0,0,0,0
1745812480881,SIOC 291S,B01,958922,Staff,0,0,0,0
1745812481909,SOCI 117,A01,895339,Staff,4,0,5,1
1745812482935,WES 237B,A00,894149,Staff,11,0,20,9
1745812484990,AESE 279B,A00,891859,Staff,13,0,35,22
1745812486019,AIP 197,001,891854,Staff,70,0,70,0
1745812487044,ANTH 289S,A00,891856,Gagneux; Pascal,12,0,12,0
1745812488072,BENG 196,001,957946,Engler; Adam J.,9996,0,9999,3
1745812489098,CAT 124RS,A01,956906,Staff,8,0,25,17
1745812490128,CAT 125RS,A01,922013,Staff,8,0,25,17
1745812491154,CLRE 250,A00,891860,Morris; Sheldon,9995,0,9999,4
1745812493205,CLRE 251R,A00,907817,Mehta; Ravindra L.,9994,0,9999,5
1745812494234,CLRE 252,A00,891864,Cuomo; Raphael Eduardo,9993,0,9999,6
1745812495258,CLRE 253,A00,891867,Vaida; Florin,9994,0,9999,5
1745812495258,CLRE 253,B00,907819,Staff,9999,0,9999,0
1745812496284,CLRE 259,A00,891868,Patel; Hemal,9998,0,9999,1
1745812497309,CLRE 260,A00,891872,Cuomo; Raphael Eduardo,9999,0,9999,0
1745812498334,CLRE 297,001,891888,Cuomo; Raphael Eduardo,9999,0,9999,0
1745812499360,CSE 191,A00,958773,Minnes Kemp; Mor Mia,9999,0,9999,0
1745812500390,CSS 201S,A01,892054,Mignozzetti; Umberto,30,0,30,0
1745812501418,CSS 202S,A01,892056,Mignozzetti; Umberto,30,0,30,0
1745812502443,DSC 197,001,956898,Eldridge; Justin Matthew,9998,0,9999,1
1745812503473,DSC 297,001,958000,Mazumdar; Arya,9998,0,9999,1
1745812504501,EAP 100,A00,905686,Staff,9776,0,9999,223
1745812505530,ECE 45,A01,892618,Staff,0,12,50,50
1745812506562,ECE 109,A01,892620,Staff,0,44,0,0
1745812507587,ECE 111,A01,892719,Staff,0,8,50,50
1745812508613,ECE 197,001,957920,Mercier; Patrick Philip,9992,0,9999,7
1745812509644,ECON 178,A01,907814,Zhu; Ying,28,0,35,7
1745812510668,EDS 115,A00,895312,Staff,41,0,45,4
1745812511695,EDS 117,A01,895337,Staff,30,0,30,0
1745812512723,EDS 125,A00,895341,Jones; Gabrielle Anastasia,43,0,45,2
1745812513749,EDS 128A,A01,895459,Fargason; Sharon Gayle,44,0,45,1
1745812514778,EDS 128B,A01,895543,Pappas; Elizabeth,44,0,45,1
1745812515804,EDS 139,A00,897203,Pappas; Elizabeth,44,0,45,1
1745812515804,EDS 139,B00,897209,Fargason; Sharon Gayle,44,0,45,1
1745812516832,EDS 201,A00,895545,Staff,43,0,45,2
1745812517861,EDS 203,A01,895581,Halter; Christopher P.,43,0,45,2
1745812518888,EDS 204R,A01,895625,Heinzman; Erica M.,43,0,45,2
1745812518888,EDS 204R,B01,895693,Halter; Christopher P.,18,0,45,27
1745812519917,EDS 206R,A00,895694,Fargason; Sharon Gayle,9,0,30,21
1745812519917,EDS 206R,B00,895695,Choi; Bailey Miyeon,20,0,30,10
1745812520946,EDS 250,A00,895697,Hemans; Patricia Ann Benitez,43,0,45,2
1745812521974,EDS 281,A00,895701,Meyerott; Theresa Ann,15,0,15,0
1745812523001,EDS 284,A00,895736,Meyerott; Theresa Ann,15,0,15,0
1745812524030,EDS 286,A00,897210,Fine; Sarah,15,0,15,0
1745812525056,EDS 289C,A01,895770,Daly; Alan J.,15,0,15,0
1745812526081,EDS 290,A00,897211,Hofstetter; Carolyn,15,0,15,0
1745812527110,LIGM 5A,A00,896162,Fischer-Grunski; Eva K,15,0,20,5
1745812528140,LIGM 5B,A00,896260,Fischer-Grunski; Eva K,17,0,20,3
1745812529167,LIGM 5C,A00,896308,Fischer-Grunski; Eva K,18,0,20,2
1745812530193,LIIT 5AS,A00,896313,Carnelos; Chiara,18,0,20,2
1745812531219,LIIT 5BS,A00,896416,Carnelos; Chiara,20,0,20,0
1745812532244,LIIT 5CS,A00,896564,Carnelos; Chiara,20,0,20,0
1745812533269,LISP 5A,A00,896588,Munoz Sanchez; Alicia,4,0,20,16
1745812534296,LISP 5B,A00,896653,Munoz Sanchez; Alicia,10,0,20,10
1745812535322,LISP 5C,A00,896655,Munoz Sanchez; Alicia,4,0,20,16
1745812536348,MAE 197,001,957918,Kleissl; Jan,9998,0,9999,1
1745812537377,MATH 2,A01,957937,Staff,34,0,35,1
1745812538403,MATH 197,001,957876,Kedlaya; Kiran S.,9993,0,9999,6
1745812539428,MCWP 40,A00,892729,Duru; Nur,13,0,20,7
1745812539428,MCWP 40,B00,893304,Montejo; Carolina,20,0,20,0
1745812540454,MCWP 40R,A00,893757,Redela; Pamela Morgan,0,7,20,20
1745812541479,MCWP 50,A00,893758,Morshed; Michael James,2,0,20,18
1745812541479,MCWP 50,B00,893761,Bartulis; Jason Michael,17,0,20,3
1745812542508,MCWP 50R,A00,893766,Compas; Sean Matthew,0,1,20,20
1745812542508,MCWP 50R,B00,893769,Carter; Jennifer A,0,0,20,20
1745812542508,MCWP 50R,C00,893771,Krone; Jarret,0,3,20,20
1745812542508,MCWP 50R,D00,893772,Miller; Elizabeth Deen,3,0,20,17
1745812542508,MCWP 50R,E00,893775,Carter; Andrea L,0,0,20,20
1745812543536,MMW 11R,A01,892721,Herbst; Matthew,11,0,27,16
1745812543536,MMW 11R,A02,892722,Herbst; Matthew,0,0,0,3
1745812544564,MMW 12R,A01,892724,Herbst; Matthew,0,9,16,16
1745812544564,MMW 12R,A02,892725,Herbst; Matthew,0,9,16,16
1745812545591,MMW 13R,A01,892727,Staff,0,4,16,16
1745812545591,MMW 13R,A02,892728,Staff,0,4,16,16
1745812545591,MMW 13R,A03,958032,Staff,0,3,16,16
1745812545591,MMW 13R,A04,958033,Staff,0,2,16,16
1745812545591,MMW 13R,A05,958034,Staff,0,3,16,16
1745812546618,SIO 295LS,A00,894015,Staff,7,0,25,18
1745812547647,SIO 295S,A00,894020,Staff,7,0,25,18
1745812548675,SIOC 290S,B01,958918,Staff,0,0,0,0
1745812549702,SIOC 291S,B01,958922,Staff,0,0,0,0
1745812550730,SOCI 117,A01,895339,Staff,4,0,5,1
1745812551759,WES 237B,A00,894149,Staff,11,0,20,9
1745812553819,AESE 279B,A00,891859,Staff,13,0,35,22
1745812554847,AIP 197,001,891854,Staff,70,0,70,0
1745812555877,ANTH 289S,A00,891856,Gagneux; Pascal,12,0,12,0
1745812556902,BENG 196,001,957946,Engler; Adam J.,9996,0,9999,3
1745812557927,CAT 124RS,A01,956906,Staff,8,0,25,17
1745812558956,CAT 125RS,A01,922013,Staff,8,0,25,17
1745812559982,CLRE 250,A00,891860,Morris; Sheldon,9995,0,9999,4
1745812562037,CLRE 251R,A00,907817,Mehta; Ravindra L.,9994,0,9999,5
1745812563066,CLRE 252,A00,891864,Cuomo; Raphael Eduardo,9993,0,9999,6
1745812564095,CLRE 253,A00,891867,Vaida; Florin,9994,0,9999,5
1745812564095,CLRE 253,B00,907819,Staff,9999,0,9999,0
1745812565156,CLRE 259,A00,891868,Patel; Hemal,9998,0,9999,1
1745812566184,CLRE 260,A00,891872,Cuomo; Raphael Eduardo,9999,0,9999,0
1745812567209,CLRE 297,001,891888,Cuomo; Raphael Eduardo,9999,0,9999,0
1745812568237,CSE 191,A00,958773,Minnes Kemp; Mor Mia,9999,0,9999,0
1745812569272,CSS 201S,A01,892054,Mignozzetti; Umberto,30,0,30,0
1745812570296,CSS 202S,A01,892056,Mignozzetti; Umberto,30,0,30,0
1745812571322,DSC 197,001,956898,Eldridge; Justin Matthew,9998,0,9999,1
1745812572350,DSC 297,001,958000,Mazumdar; Arya,9998,0,9999,1
1745812573376,EAP 100,A00,905686,Staff,9776,0,9999,223
1745812574402,ECE 45,A01,892618,Staff,0,12,50,50
1745812575428,ECE 109,A01,892620,Staff,0,44,0,0
1745812576455,ECE 111,A01,892719,Staff,0,8,50,50
1745812577484,ECE 197,001,957920,Mercier; Patrick Philip,9992,0,9999,7
1745812578509,ECON 178,A01,907814,Zhu; Ying,28,0,35,7
1745812579534,EDS 115,A00,895312,Staff,41,0,45,4
1745812580560,EDS 117,A01,895337,Staff,30,0,30,0
1745812581587,EDS 125,A00,895341,Jones; Gabrielle Anastasia,43,0,45,2
1745812582612,EDS 128A,A01,895459,Fargason; Sharon Gayle,44,0,45,1
1745812583640,EDS 128B,A01,895543,Pappas; Elizabeth,44,0,45,1
1745812584667,EDS 139,A00,897203,Pappas; Elizabeth,44,0,45,1
1745812584667,EDS 139,B00,897209,Fargason; Sharon Gayle,44,0,45,1
1745812585693,EDS 201,A00,895545,Staff,43,0,45,2
1745812586719,EDS 203,A01,895581,Halter; Christopher P.,43,0,45,2
1745812587749,EDS 204R,A01,895625,Heinzman; Erica M.,43,0,45,2
1745812587749,EDS 204R,B01,895693,Halter; Christopher P.,18,0,45,27
1745812588775,EDS 206R,A00,895694,Fargason; Sharon Gayle,9,0,30,21
1745812588775,EDS 206R,B00,895695,Choi; Bailey Miyeon,20,0,30,10
1745812589802,EDS 250,A00,895697,Hemans; Patricia Ann Benitez,43,0,45,2
1745812590827,EDS 281,A00,895701,Meyerott; Theresa Ann,15,0,15,0
1745812591853,EDS 284,A00,895736,Meyerott; Theresa Ann,15,0,15,0
1745812592878,EDS 286,A00,897210,Fine; Sarah,15,0,15,0
1745812593905,EDS 289C,A01,895770,Daly; Alan J.,15,0,15,0
1745812594931,EDS 290,A00,897211,Hofstetter; Carolyn,15,0,15,0
1745812595958,LIGM 5A,A00,896162,Fischer-Grunski; Eva K,15,0,20,5
1745812596984,LIGM 5B,A00,896260,Fischer-Grunski; Eva K,17,0,20,3
1745812598010,LIGM 5C,A00,896308,Fischer-Grunski; Eva K,18,0,20,2
1745812599035,LIIT 5AS,A00,896313,Carnelos; Chiara,18,0,20,2
1745812600061,LIIT 5BS,A00,896416,Carnelos; Chiara,20,0,20,0
1745812601087,LIIT 5CS,A00,896564,Carnelos; Chiara,20,0,20,0
1745812602115,LISP 5A,A00,896588,Munoz Sanchez; Alicia,4,0,20,16
1745812603142,LISP 5B,A00,896653,Munoz Sanchez; Alicia,10,0,20,10
1745812604170,LISP 5C,A00,896655,Munoz Sanchez; Alicia,4,0,20,16
1745812605195,MAE 197,001,957918,Kleissl; Jan,9998,0,9999,1
1745812606222,MATH 2,A01,957937,Staff,34,0,35,1
1745812607247,MATH 197,001,957876,Kedlaya; Kiran S.,9993,0,9999,6
1745812608274,MCWP 40,A00,892729,Duru; Nur,13,0,20,7
1745812608274,MCWP 40,B00,893304,Montejo; Carolina,20,0,20,0
1745812609305,MCWP 40R,A00,893757,Redela; Pamela Morgan,0,7,20,20
1745812610330,MCWP 50,A00,893758,Morshed; Michael James,2,0,20,18
1745812610330,MCWP 50,B00,893761,Bartulis; Jason Michael,17,0,20,3
1745812611357,MCWP 50R,A00,893766,Compas; Sean Matthew,0,1,20,20
1745812611357,MCWP 50R,B00,893769,Carter; Jennifer A,0,0,20,20
1745812611357,MCWP 50R,C00,893771,Krone; Jarret,0,3,20,20
1745812611357,MCWP 50R,D00,893772,Miller; Elizabeth Deen,3,0,20,17
1745812611357,MCWP 50R,E00,893775,Carter; Andrea L,0,0,20,20
1745812612389,MMW 11R,A01,892721,Herbst; Matthew,11,0,27,16
1745812612389,MMW 11R,A02,892722,Herbst; Matthew,0,0,0,3
1745812613418,MMW 12R,A01,892724,Herbst; Matthew,0,9,16,16
1745812613418,MMW 12R,A02,892725,Herbst; Matthew,0,9,16,16
1745812614447,MMW 13R,A01,892727,Staff,0,4,16,16
1745812614447,MMW 13R,A02,892728,Staff,0,4,16,16
1745812614447,MMW 13R,A03,958032,Staff,0,3,16,16
1745812614447,MMW 13R,A04,958033,Staff,0,2,16,16
1745812614447,MMW 13R,A05,958034,Staff,0,3,16,16
1745812615473,SIO 295LS,A00,894015,Staff,7,0,25,18
1745812616499,SIO 295S,A00,894020,Staff,7,0,25,18
1745812617526,SIOC 290S,B01,958918,Staff,0,0,0,0
1745812618555,SIOC 291S,B01,958922,Staff,0,0,0,0
1745812619581,SOCI 117,A01,895339,Staff,4,0,5,1
1745812620610,WES 237B,A00,894149,Staff,11,0,20,9
1745812622675,AESE 279B,A00,891859,Staff,13,0,35,22
1745812623705,AIP 197,001,891854,Staff,70,0,70,0
1745812624730,ANTH 289S,A00,891856,Gagneux; Pascal,12,0,12,0
1745812625759,BENG 196,001,957946,Engler; Adam J.,9996,0,9999,3
1745812626784,CAT 124RS,A01,956906,Staff,8,0,25,17
1745812627808,CAT 125RS,A01,922013,Staff,8,0,25,17
1745812628837,CLRE 250,A00,891860,Morris; Sheldon,9995,0,9999,4
1745812630887,CLRE 251R,A00,907817,Mehta; Ravindra L.,9994,0,9999,5
1745812631912,CLRE 252,A00,891864,Cuomo; Raphael Eduardo,9993,0,9999,6
1745812632940,CLRE 253,A00,891867,Vaida; Florin,9994,0,9999,5
1745812632940,CLRE 253,B00,907819,Staff,9999,0,9999,0
1745812633967,CLRE 259,A00,891868,Patel; Hemal,9998,0,9999,1
1745812634998,CLRE 260,A00,891872,Cuomo; Raphael Eduardo,9999,0,9999,0
1745812636025,CLRE 297,001,891888,Cuomo; Raphael Eduardo,9999,0,9999,0
1745812637049,CSE 191,A00,958773,Minnes Kemp; Mor Mia,9999,0,9999,0
1745812638079,CSS 201S,A01,892054,Mignozzetti; Umberto,30,0,30,0
1745812639106,CSS 202S,A01,892056,Mignozzetti; Umberto,30,0,30,0
1745812640136,DSC 197,001,956898,Eldridge; Justin Matthew,9998,0,9999,1
1745812641165,DSC 297,001,958000,Mazumdar; Arya,9998,0,9999,1
1745812642191,EAP 100,A00,905686,Staff,9776,0,9999,223
1745812643220,ECE 45,A01,892618,Staff,0,12,50,50
1745812644246,ECE 109,A01,892620,Staff,0,44,0,0
1745812645278,ECE 111,A01,892719,Staff,0,8,50,50
1745812646305,ECE 197,001,957920,Mercier; Patrick Philip,9992,0,9999,7
1745812647334,ECON 178,A01,907814,Zhu; Ying,28,0,35,7
1745812648358,EDS 115,A00,895312,Staff,41,0,45,4
1745812649382,EDS 117,A01,895337,Staff,30,0,30,0
1745812650411,EDS 125,A00,895341,Jones; Gabrielle Anastasia,43,0,45,2
1745812651447,EDS 128A,A01,895459,Fargason; Sharon Gayle,44,0,45,1
1745812652473,EDS 128B,A01,895543,Pappas; Elizabeth,44,0,45,1
1745812653504,EDS 139,A00,897203,Pappas; Elizabeth,44,0,45,1
1745812653504,EDS 139,B00,897209,Fargason; Sharon Gayle,44,0,45,1
1745812654535,EDS 201,A00,895545,Staff,43,0,45,2
1745812655563,EDS 203,A01,895581,Halter; Christopher P.,43,0,45,2
1745812656588,EDS 204R,A01,895625,Heinzman; Erica M.,43,0,45,2
1745812656588,EDS 204R,B01,895693,Halter; Christopher P.,18,0,45,27
1745812657613,EDS 206R,A00,895694,Fargason; Sharon Gayle,9,0,30,21
1745812657613,EDS 206R,B00,895695,Choi; Bailey Miyeon,20,0,30,10
1745812658642,EDS 250,A00,895697,Hemans; Patricia Ann Benitez,43,0,45,2
1745812659669,EDS 281,A00,895701,Meyerott; Theresa Ann,15,0,15,0
1745812660695,EDS 284,A00,895736,Meyerott; Theresa Ann,15,0,15,0
1745812661721,EDS 286,A00,897210,Fine; Sarah,15,0,15,0
1745812662748,EDS 289C,A01,895770,Daly; Alan J.,15,0,15,0
1745812663777,EDS 290,A00,897211,Hofstetter; Carolyn,15,0,15,0
1745812664802,LIGM 5A,A00,896162,Fischer-Grunski; Eva K,15,0,20,5
1745812665827,LIGM 5B,A00,896260,Fischer-Grunski; Eva K,17,0,20,3
1745812666852,LIGM 5C,A00,896308,Fischer-Grunski; Eva K,18,0,20,2
1745812667876,LIIT 5AS,A00,896313,Carnelos; Chiara,18,0,20,2
1745812668900,LIIT 5BS,A00,896416,Carnelos; Chiara,20,0,20,0
1745812669929,LIIT 5CS,A00,896564,Carnelos; Chiara,20,0,20,0
1745812670954,LISP 5A,A00,896588,Munoz Sanchez; Alicia,4,0,20,16
1745812671980,LISP 5B,A00,896653,Munoz Sanchez; Alicia,10,0,20,10
1745812673010,LISP 5C,A00,896655,Munoz Sanchez; Alicia,4,0,20,16
1745812674038,MAE 197,001,957918,Kleissl; Jan,9998,0,9999,1
1745812675064,MATH 2,A01,957937,Staff,34,0,35,1
1745812676091,MATH 197,001,957876,Kedlaya; Kiran S.,9993,0,9999,6
1745812677120,MCWP 40,A00,892729,Duru; Nur,13,0,20,7
1745812677120,MCWP 40,B00,893304,Montejo; Carolina,20,0,20,0
1745812678145,MCWP 40R,A00,893757,Redela; Pamela Morgan,0,7,20,20
1745812679169,MCWP 50,A00,893758,Morshed; Michael James,2,0,20,18
1745812679169,MCWP 50,B00,893761,Bartulis; Jason Michael,17,0,20,3
1745812680200,MCWP 50R,A00,893766,Compas; Sean Matthew,0,1,20,20
1745812680200,MCWP 50R,B00,893769,Carter; Jennifer A,0,0,20,20
1745812680200,MCWP 50R,C00,893771,Krone; Jarret,0,3,20,20
1745812680200,MCWP 50R,D00,893772,Miller; Elizabeth Deen,3,0,20,17
1745812680200,MCWP 50R,E00,893775,Carter; Andrea L,0,0,20,20
1745812681227,MMW 11R,A01,892721,Herbst; Matthew,11,0,27,16
1745812681227,MMW 11R,A02,892722,Herbst; Matthew,0,0,0,3
1745812682251,MMW 12R,A01,892724,Herbst; Matthew,0,9,16,16
1745812682251,MMW 12R,A02,892725,Herbst; Matthew,0,9,16,16
1745812683276,MMW 13R,A01,892727,Staff,0,4,16,16
1745812683276,MMW 13R,A02,892728,Staff,0,4,16,16
1745812683276,MMW 13R,A03,958032,Staff,0,3,16,16
1745812683276,MMW 13R,A04,958033,Staff,0,2,16,16
1745812683276,MMW 13R,A05,958034,Staff,0,3,16,16
1745812684301,SIO 295LS,A00,894015,Staff,7,0,25,18
1745812685327,SIO 295S,A00,894020,Staff,7,0,25,18
1745812686351,SIOC 290S,B01,958918,Staff,0,0,0,0
1745812687381,SIOC 291S,B01,958922,Staff,0,0,0,0
1745812688407,SOCI 117,A01,895339,Staff,4,0,5,1
1745812689435,WES 237B,A00,894149,Staff,11,0,20,9
1745812691496,AESE 279B,A00,891859,Staff,13,0,35,22
1745812692525,AIP 197,001,891854,Staff,70,0,70,0
1745812693553,ANTH 289S,A00,891856,Gagneux; Pascal,12,0,12,0
1745812694575,BENG 196,001,957946,Engler; Adam J.,9996,0,9999,3
1745812695599,CAT 124RS,A01,956906,Staff,8,0,25,17
1745812696624,CAT 125RS,A01,922013,Staff,8,0,25,17
1745812697650,CLRE 250,A00,891860,Morris; Sheldon,9995,0,9999,4
1745812699701,CLRE 251R,A00,907817,Mehta; Ravindra L.,9994,0,9999,5
1745812700725,CLRE 252,A00,891864,Cuomo; Raphael Eduardo,9993,0,9999,6
1745812701750,CLRE 253,A00,891867,Vaida; Florin,9994,0,9999,5
1745812701750,CLRE 253,B00,907819,Staff,9999,0,9999,0
1745812702776,CLRE 259,A00,891868,Patel; Hemal,9998,0,9999,1
1745812703801,CLRE 260,A00,891872,Cuomo; Raphael Eduardo,9999,0,9999,0
1745812704829,CLRE 297,001,891888,Cuomo; Raphael Eduardo,9999,0,9999,0
1745812705856,CSE 191,A00,958773,Minnes Kemp; Mor Mia,9999,0,9999,0
1745812706884,CSS 201S,A01,892054,Mignozzetti; Umberto,30,0,30,0
1745812707913,CSS 202S,A01,892056,Mignozzetti; Umberto,30,0,30,0
1745812708939,DSC 197,001,956898,Eldridge; Justin Matthew,9998,0,9999,1
1745812709965,DSC 297,001,958000,Mazumdar; Arya,9998,0,9999,1
1745812710991,EAP 100,A00,905686,Staff,9776,0,9999,223
1745812712019,ECE 45,A01,892618,Staff,0,12,50,50
1745812713048,ECE 109,A01,892620,Staff,0,44,0,0
1745812714073,ECE 111,A01,892719,Staff,0,8,50,50
1745812715102,ECE 197,001,957920,Mercier; Patrick Philip,9992,0,9999,7
1745812716132,ECON 178,A01,907814,Zhu; Ying,28,0,35,7
1745812717159,EDS 115,A00,895312,Staff,41,0,45,4
1745812718184,EDS 117,A01,895337,Staff,30,0,30,0
1745812719214,EDS 125,A00,895341,Jones; Gabrielle Anastasia,43,0,45,2
1745812720245,EDS 128A,A01,895459,Fargason; Sharon Gayle,44,0,45,1
1745812721271,EDS 128B,A01,895543,Pappas; Elizabeth,44,0,45,1
1745812722299,EDS 139,A00,897203,Pappas; Elizabeth,44,0,45,1
1745812722299,EDS 139,B00,897209,Fargason; Sharon Gayle,44,0,45,1
1745812723326,EDS 201,A00,895545,Staff,43,0,45,2
1745812724351,EDS 203,A01,895581,Halter; Christopher P.,43,0,45,2
1745812725378,EDS 204R,A01,895625,Heinzman; Erica M.,43,0,45,2
1745812725378,EDS 204R,B01,895693,Halter; Christopher P.,18,0,45,27
1745812726405,EDS 206R,A00,895694,Fargason; Sharon Gayle,9,0,30,21
1745812726405,EDS 206R,B00,895695,Choi; Bailey Miyeon,20,0,30,10
1745812727434,EDS 250,A00,895697,Hemans; Patricia Ann Benitez,43,0,45,2
1745812728463,EDS 281,A00,895701,Meyerott; Theresa Ann,15,0,15,0
1745812729490,EDS 284,A00,895736,Meyerott; Theresa Ann,15,0,15,0
1745812730519,EDS 286,A00,897210,Fine; Sarah,15,0,15,0
1745812731546,EDS 289C,A01,895770,Daly; Alan J.,15,0,15,0
1745812732571,EDS 290,A00,897211,Hofstetter; Carolyn,15,0,15,0
1745812733598,LIGM 5A,A00,896162,Fischer-Grunski; Eva K,15,0,20,5
1745812734629,LIGM 5B,A00,896260,Fischer-Grunski; Eva K,17,0,20,3
1745812735657,LIGM 5C,A00,896308,Fischer-Grunski; Eva K,18,0,20,2
1745812736689,LIIT 5AS,A00,896313,Carnelos; Chiara,18,0,20,2
1745812737719,LIIT 5BS,A00,896416,Carnelos; Chiara,20,0,20,0
1745812738747,LIIT 5CS,A00,896564,Carnelos; Chiara,20,0,20,0
1745812739777,LISP 5A,A00,896588,Munoz Sanchez; Alicia,4,0,20,16
1745812740804,LISP 5B,A00,896653,Munoz Sanchez; Alicia,10,0,20,10
1745812741831,LISP 5C,A00,896655,Munoz Sanchez; Alicia,4,0,20,16
1745812742858,MAE 197,001,957918,Kleissl; Jan,9998,0,9999,1
1745812743884,MATH 2,A01,957937,Staff,34,0,35,1
1745812744912,MATH 197,001,957876,Kedlaya; Kiran S.,9993,0,9999,6
1745812745942,MCWP 40,A00,892729,Duru; Nur,13,0,20,7
1745812745942,MCWP 40,B00,893304,Montejo; Carolina,20,0,20,0
1745812746969,MCWP 40R,A00,893757,Redela; Pamela Morgan,0,7,20,20
1745812747996,MCWP 50,A00,893758,Morshed; Michael James,2,0,20,18
1745812747996,MCWP 50,B00,893761,Bartulis; Jason Michael,17,0,20,3
1745812749022,MCWP 50R,A00,893766,Compas; Sean Matthew,0,1,20,20
1745812749022,MCWP 50R,B00,893769,Carter; Jennifer A,0,0,20,20
1745812749022,MCWP 50R,C00,893771,Krone; Jarret,0,3,20,20
1745812749022,MCWP 50R,D00,893772,Miller; Elizabeth Deen,3,0,20,17
1745812749022,MCWP 50R,E00,893775,Carter; Andrea L,0,0,20,20
1745812750051,MMW 11R,A01,892721,Herbst; Matthew,11,0,27,16
1745812750051,MMW 11R,A02,892722,Herbst; Matthew,0,0,0,3
1745812751078,MMW 12R,A01,892724,Herbst; Matthew,0,9,16,16
1745812751078,MMW 12R,A02,892725,Herbst; Matthew,0,9,16,16
1745812752108,MMW 13R,A01,892727,Staff,0,4,16,16
1745812752108,MMW 13R,A02,892728,Staff,0,4,16,16
1745812752108,MMW 13R,A03,958032,Staff,0,3,16,16
1745812752108,MMW 13R,A04,958033,Staff,0,2,16,16
1745812752108,MMW 13R,A05,958034,Staff,0,3,16,16
1745812753135,SIO 295LS,A00,894015,Staff,7,0,25,18
1745812754160,SIO 295S,A00,894020,Staff,7,0,25,18
1745812755186,SIOC 290S,B01,958918,Staff,0,0,0,0
1745812756211,SIOC 291S,B01,958922,Staff,0,0,0,0
1745812757238,SOCI 117,A01,895339,Staff,4,0,5,1
1745812758264,WES 237B,A00,894149,Staff,11,0,20,9
1745812760325,AESE 279B,A00,891859,Staff,13,0,35,22
1745812761352,AIP 197,001,891854,Staff,70,0,70,0
1745812762392,ANTH 289S,A00,891856,Gagneux; Pascal,12,0,12,0
1745812763419,BENG 196,001,957946,Engler; Adam J.,9996,0,9999,3
1745812764445,CAT 124RS,A01,956906,Staff,8,0,25,17
1745812765468,CAT 125RS,A01,922013,Staff,8,0,25,17
1745812766494,CLRE 250,A00,891860,Morris; Sheldon,9995,0,9999,4
1745812768546,CLRE 251R,A00,907817,Mehta; Ravindra L.,9994,0,9999,5
1745812769572,CLRE 252,A00,891864,Cuomo; Raphael Eduardo,9993,0,9999,6
1745812770600,CLRE 253,A00,891867,Vaida; Florin,9994,0,9999,5
1745812770600,CLRE 253,B00,907819,Staff,9999,0,9999,0
1745812771625,CLRE 259,A00,891868,Patel; Hemal,9998,0,9999,1
1745812772651,CLRE 260,A00,891872,Cuomo; Raphael Eduardo,9999,0,9999,0
1745812773681,CLRE 297,001,891888,Cuomo; Raphael Eduardo,9999,0,9999,0
1745812774707,CSE 191,A00,958773,Minnes Kemp; Mor Mia,9999,0,9999,0
1745812775736,CSS 201S,A01,892054,Mignozzetti; Umberto,30,0,30,0
1745812776768,CSS 202S,A01,892056,Mignozzetti; Umberto,30,0,30,0
1745812777795,DSC 197,001,956898,Eldridge; Justin Matthew,9998,0,9999,1
1745812778820,DSC 297,001,958000,Mazumdar; Arya,9998,0,9999,1
1745812779847,EAP 100,A00,905686,Staff,9776,0,9999,223
1745812780876,ECE 45,A01,892618,Staff,0,12,50,50
1745812781905,ECE 109,A01,892620,Staff,0,44,0,0
1745812782931,ECE 111,A01,892719,Staff,0,8,50,50
1745812783959,ECE 197,001,957920,Mercier; Patrick Philip,9992,0,9999,7
1745812784991,ECON 178,A01,907814,Zhu; Ying,28,0,35,7
1745812786015,EDS 115,A00,895312,Staff,41,0,45,4
1745812787045,EDS 117,A01,895337,Staff,30,0,30,0
1745812788074,EDS 125,A00,895341,Jones; Gabrielle Anastasia,43,0,45,2
1745812789098,EDS 128A,A01,895459,Fargason; Sharon Gayle,44,0,45,1
1745812790125,EDS 128B,A01,895543,Pappas; Elizabeth,44,0,45,1
1745812791152,EDS 139,A00,897203,Pappas; Elizabeth,44,0,45,1
1745812791152,EDS 139,B00,897209,Fargason; Sharon Gayle,44,0,45,1
1745812792182,EDS 201,A00,895545,Staff,43,0,45,2
1745812793211,EDS 203,A01,895581,Halter; Christopher P.,43,0,45,2
1745812794236,EDS 204R,A01,895625,Heinzman; Erica M.,43,0,45,2
1745812794236,EDS 204R,B01,895693,Halter; Christopher P.,18,0,45,27
1745812795265,EDS 206R,A00,895694,Fargason; Sharon Gayle,9,0,30,21
1745812795265,EDS 206R,B00,895695,Choi; Bailey Miyeon,20,0,30,10
1745812796293,EDS 250,A00,895697,Hemans; Patricia Ann Benitez,43,0,45,2
1745812797317,EDS 281,A00,895701,Meyerott; Theresa Ann,15,0,15,0
1745812798344,EDS 284,A00,895736,Meyerott; Theresa Ann,15,0,15,0
1745812799372,EDS 286,A00,897210,Fine; Sarah,15,0,15,0
1745812800397,EDS 289C,A01,895770,Daly; Alan J.,15,0,15,0
1745812801446,EDS 290,A00,897211,Hofstetter; Carolyn,15,0,15,0
1745812802473,LIGM 5A,A00,896162,Fischer-Grunski; Eva K,15,0,20,5
1745812803515,LIGM 5B,A00,896260,Fischer-Grunski; Eva K,17,0,20,3
1745812804548,LIGM 5C,A00,896308,Fischer-Grunski; Eva K,18,0,20,2
1745812805573,LIIT 5AS,A00,896313,Carnelos; Chiara,18,0,20,2
1745812806600,LIIT 5BS,A00,896416,Carnelos; Chiara,20,0,20,0
1745812807625,LIIT 5CS,A00,896564,Carnelos; Chiara,20,0,20,0
1745812808650,LISP 5A,A00,896588,Munoz Sanchez; Alicia,4,0,20,16
1745812809679,LISP 5B,A00,896653,Munoz Sanchez; Alicia,10,0,20,10
1745812810707,LISP 5C,A00,896655,Munoz Sanchez; Alicia,4,0,20,16
1745812811735,MAE 197,001,957918,Kleissl; Jan,9998,0,9999,1
1745812812770,MATH 2,A01,957937,Staff,34,0,35,1
1745812813798,MATH 197,001,957876,Kedlaya; Kiran S.,9993,0,9999,6
1745812814830,MCWP 40,A00,892729,Duru; Nur,13,0,20,7
1745812814830,MCWP 40,B00,893304,Montejo; Carolina,20,0,20,0
1745812815861,MCWP 40R,A00,893757,Redela; Pamela Morgan,0,7,20,20
1745812816887,MCWP 50,A00,893758,Morshed; Michael James,2,0,20,18
1745812816887,MCWP 50,B00,893761,Bartulis; Jason Michael,17,0,20,3
1745812817915,MCWP 50R,A00,893766,Compas; Sean Matthew,0,1,20,20
1745812817915,MCWP 50R,B00,893769,Carter; Jennifer A,0,0,20,20
1745812817915,MCWP 50R,C00,893771,Krone; Jarret,0,3,20,20
1745812817915,MCWP 50R,D00,893772,Miller; Elizabeth Deen,3,0,20,17
1745812817915,MCWP 50R,E00,893775,Carter; Andrea L,0,0,20,20
1745812818942,MMW 11R,A01,892721,Herbst; Matthew,11,0,27,16
1745812818942,MMW 11R,A02,892722,Herbst; Matthew,0,0,0,3
1745812819968,MMW 12R,A01,892724,Herbst; Matthew,0,9,16,16
1745812819968,MMW 12R,A02,892725,Herbst; Matthew,0,9,16,16
1745812820997,MMW 13R,A01,892727,Staff,0,4,16,16
1745812820997,MMW 13R,A02,892728,Staff,0,4,16,16
1745812820997,MMW 13R,A03,958032,Staff,0,3,16,16
1745812820997,MMW 13R,A04,958033,Staff,0,2,16,16
1745812820997,MMW 13R,A05,958034,Staff,0,3,16,16
1745812822028,SIO 295LS,A00,894015,Staff,7,0,25,18
1745812823054,SIO 295S,A00,894020,Staff,7,0,25,18
1745812824086,SIOC 290S,B01,958918,Staff,0,0,0,0
1745812825113,SIOC 291S,B01,958922,Staff,0,0,0,0
1745812826138,SOCI 117,A01,895339,Staff,4,0,5,1
1745812827163,WES 237B,A00,894149,Staff,11,0,20,9
1745812829227,AESE 279B,A00,891859,Staff,13,0,35,22
1745812830251,AIP 197,001,891854,Staff,70,0,70,0
1745812831276,ANTH 289S,A00,891856,Gagneux; Pascal,12,0,12,0
1745812832302,BENG 196,001,957946,Engler; Adam J.,9996,0,9999,3
1745812833327,CAT 124RS,A01,956906,Staff,8,0,25,17
1745812834355,CAT 125RS,A01,922013,Staff,8,0,25,17
1745812835381,CLRE 250,A00,891860,Morris; Sheldon,9995,0,9999,4
1745812837446,CLRE 251R,A00,907817,Mehta; Ravindra L.,9994,0,9999,5
1745812838489,CLRE 252,A00,891864,Cuomo; Raphael Eduardo,9993,0,9999,6
1745812839516,CLRE 253,A00,891867,Vaida; Florin,9994,0,9999,5
1745812839516,CLRE 253,B00,907819,Staff,9999,0,9999,0
1745812840541,CLRE 259,A00,891868,Patel; Hemal,9998,0,9999,1
1745812841570,CLRE 260,A00,891872,Cuomo; Raphael Eduardo,9999,0,9999,0
1745812842599,CLRE 297,001,891888,Cuomo; Raphael Eduardo,9999,0,9999,0
1745812843624,CSE 191,A00,958773,Minnes Kemp; Mor Mia,9999,0,9999,0
1745812844651,CSS 201S,A01,892054,Mignozzetti; Umberto,30,0,30,0
1745812845678,CSS 202S,A01,892056,Mignozzetti; Umberto,30,0,30,0
1745812846706,DSC 197,001,956898,Eldridge; Justin Matthew,9998,0,9999,1
1745812847732,DSC 297,001,958000,Mazumdar; Arya,9998,0,9999,1
1745812848757,EAP 100,A00,905686,Staff,9776,0,9999,223
1745812849785,ECE 45,A01,892618,Staff,0,12,50,50
1745812850812,ECE 109,A01,892620,Staff,0,44,0,0
1745812851840,ECE 111,A01,892719,Staff,0,8,50,50
1745812852867,ECE 197,001,957920,Mercier; Patrick Philip,9992,0,9999,7
1745812853897,ECON 178,A01,907814,Zhu; Ying,28,0,35,7
1745812854926,EDS 115,A00,895312,Staff,41,0,45,4
1745812855953,EDS 117,A01,895337,Staff,30,0,30,0
1745812856981,EDS 125,A00,895341,Jones; Gabrielle Anastasia,43,0,45,2
1745812858024,EDS 128A,A01,895459,Fargason; Sharon Gayle,44,0,45,1
1745812859053,EDS 128B,A01,895543,Pappas; Elizabeth,44,0,45,1
1745812860081,EDS 139,A00,897203,Pappas; Elizabeth,44,0,45,1
1745812860081,EDS 139,B00,897209,Fargason; Sharon Gayle,44,0,45,1
1745812861109,EDS 201,A00,895545,Staff,43,0,45,2
1745812862137,EDS 203,A01,895581,Halter; Christopher P.,43,0,45,2
1745812863167,EDS 204R,A01,895625,Heinzman; Erica M.,43,0,45,2
1745812863167,EDS 204R,B01,895693,Halter; Christopher P.,18,0,45,27
1745812864198,EDS 206R,A00,895694,Fargason; Sharon Gayle,9,0,30,21
1745812864198,EDS 206R,B00,895695,Choi; Bailey Miyeon,20,0,30,10
1745812865227,EDS 250,A00,895697,Hemans; Patricia Ann Benitez,43,0,45,2
1745812866255,EDS 281,A00,895701,Meyerott; Theresa Ann,15,0,15,0
1745812867284,EDS 284,A00,895736,Meyerott; Theresa Ann,15,0,15,0
1745812868309,EDS 286,A00,897210,Fine; Sarah,15,0,15,0
1745812869337,EDS 289C,A01,895770,Daly; Alan J.,15,0,15,0
1745812870362,EDS 290,A00,897211,Hofstetter; Carolyn,15,0,15,0
1745812871388,LIGM 5A,A00,896162,Fischer-Grunski; Eva K,15,0,20,5
1745812872417,LIGM 5B,A00,896260,Fischer-Grunski; Eva K,17,0,20,3
1745812873441,LIGM 5C,A00,896308,Fischer-Grunski; Eva K,18,0,20,2
1745812874472,LIIT 5AS,A00,896313,Carnelos; Chiara,18,0,20,2
1745812875497,LIIT 5BS,A00,896416,Carnelos; Chiara,20,0,20,0
1745812876525,LIIT 5CS,A00,896564,Carnelos; Chiara,20,0,20,0
1745812877555,LISP 5A,A00,896588,Munoz Sanchez; Alicia,4,0,20,16
1745812878579,LISP 5B,A00,896653,Munoz Sanchez; Alicia,10,0,20,10
1745812879603,LISP 5C,A00,896655,Munoz Sanchez; Alicia,4,0,20,16
1745812880632,MAE 197,001,957918,Kleissl; Jan,9998,0,9999,1
1745812881659,MATH 2,A01,957937,Staff,34,0,35,1
1745812882683,MATH 197,001,957876,Kedlaya; Kiran S.,9993,0,9999,6
1745812883710,MCWP 40,A00,892729,Duru; Nur,13,0,20,7
1745812883710,MCWP 40,B00,893304,Montejo; Carolina,20,0,20,0
1745812884740,MCWP 40R,A00,893757,Redela; Pamela Morgan,0,7,20,20
1745812885766,MCWP 50,A00,893758,Morshed; Michael James,2,0,20,18
1745812885766,MCWP 50,B00,893761,Bartulis; Jason Michael,17,0,20,3
1745812886798,MCWP 50R,A00,893766,Compas; Sean Matthew,0,1,20,20
1745812886798,MCWP 50R,B00,893769,Carter; Jennifer A,0,0,20,20
1745812886798,MCWP 50R,C00,893771,Krone; Jarret,0,3,20,20
1745812886798,MCWP 50R,D00,893772,Miller; Elizabeth Deen,3,0,20,17
1745812886798,MCWP 50R,E00,893775,Carter; Andrea L,0,0,20,20
1745812887824,MMW 11R,A01,892721,Herbst; Matthew,11,0,27,16
1745812887824,MMW 11R,A02,892722,Herbst; Matthew,0,0,0,3
1745812888852,MMW 12R,A01,892724,Herbst; Matthew,0,9,16,16
1745812888852,MMW 12R,A02,892725,Herbst; Matthew,0,9,16,16
1745812889876,MMW 13R,A01,892727,Staff,0,4,16,16
1745812889876,MMW 13R,A02,892728,Staff,0,4,16,16
1745812889876,MMW 13R,A03,958032,Staff,0,3,16,16
1745812889876,MMW 13R,A04,958033,Staff,0,2,16,16
1745812889876,MMW 13R,A05,958034,Staff,0,3,16,16
1745812890901,SIO 295LS,A00,894015,Staff,7,0,25,18
1745812891930,SIO 295S,A00,894020,Staff,7,0,25,18
1745812892957,SIOC 290S,B01,958918,Staff,0,0,0,0
1745812893983,SIOC 291S,B01,958922,Staff,0,0,0,0
1745812895009,SOCI 117,A01,895339,Staff,4,0,5,1
1745812896037,WES 237B,A00,894149,Staff,11,0,20,9
1745812898095,AESE 279B,A00,891859,Staff,13,0,35,22
1745812899121,AIP 197,001,891854,Staff,70,0,70,0
1745812900169,ANTH 289S,A00,891856,Gagneux; Pascal,12,0,12,0
1745812901193,BENG 196,001,957946,Engler; Adam J.,9996,0,9999,3
1745812902220,CAT 124RS,A01,956906,Staff,8,0,25,17
1745812903247,CAT 125RS,A01,922013,Staff,8,0,25,17
1745812904271,CLRE 250,A00,891860,Morris; Sheldon,9995,0,9999,4
1745812906320,CLRE 251R,A00,907817,Mehta; Ravindra L.,9994,0,9999,5
1745812907347,CLRE 252,A00,891864,Cuomo; Raphael Eduardo,9993,0,9999,6
1745812908374,CLRE 253,A00,891867,Vaida; Florin,9994,0,9999,5
1745812908374,CLRE 253,B00,907819,Staff,9999,0,9999,0
1745812909401,CLRE 259,A00,891868,Patel; Hemal,9998,0,9999,1
1745812910425,CLRE 260,A00,891872,Cuomo; Raphael Eduardo,9999,0,9999,0
1745812911450,CLRE 297,001,891888,Cuomo; Raphael Eduardo,9999,0,9999,0
1745812912473,CSE 191,A00,958773,Minnes Kemp; Mor Mia,9999,0,9999,0
1745812913497,CSS 201S,A01,892054,Mignozzetti; Umberto,30,0,30,0
1745812914528,CSS 202S,A01,892056,Mignozzetti; Umberto,30,0,30,0
1745812915554,DSC 197,001,956898,Eldridge; Justin Matthew,9998,0,9999,1
1745812916579,DSC 297,001,958000,Mazumdar; Arya,9998,0,9999,1
1745812917606,EAP 100,A00,905686,Staff,9776,0,9999,223
1745812918633,ECE 45,A01,892618,Staff,0,12,50,50
1745812919665,ECE 109,A01,892620,Staff,0,44,0,0
1745812920695,ECE 111,A01,892719,Staff,0,8,50,50
1745812921721,ECE 197,001,957920,Mercier; Patrick Philip,9992,0,9999,7
1745812922749,ECON 178,A01,907814,Zhu; Ying,28,0,35,7
1745812923778,EDS 115,A00,895312,Staff,41,0,45,4
1745812924815,EDS 117,A01,895337,Staff,30,0,30,0
1745812925844,EDS 125,A00,895341,Jones; Gabrielle Anastasia,43,0,45,2
1745812926868,EDS 128A,A01,895459,Fargason; Sharon Gayle,44,0,45,1
1745812927895,EDS 128B,A01,895543,Pappas; Elizabeth,44,0,45,1
1745812928920,EDS 139,A00,897203,Pappas; Elizabeth,44,0,45,1
1745812928920,EDS 139,B00,897209,Fargason; Sharon Gayle,44,0,45,1
1745812929947,EDS 201,A00,895545,Staff,43,0,45,2
1745812930978,EDS 203,A01,895581,Halter; Christopher P.,43,0,45,2
1745812932004,EDS 204R,A01,895625,Heinzman; Erica M.,43,0,45,2
1745812932004,EDS 204R,B01,895693,Halter; Christopher P.,18,0,45,27
1745812933033,EDS 206R,A00,895694,Fargason; Sharon Gayle,9,0,30,21
1745812933033,EDS 206R,B00,895695,Choi; Bailey Miyeon,20,0,30,10
1745812934058,EDS 250,A00,895697,Hemans; Patricia Ann Benitez,43,0,45,2
1745812935085,EDS 281,A00,895701,Meyerott; Theresa Ann,15,0,15,0
1745812936114,EDS 284,A00,895736,Meyerott; Theresa Ann,15,0,15,0
1745812937144,EDS 286,A00,897210,Fine; Sarah,15,0,15,0
1745812938174,EDS 289C,A01,895770,Daly; Alan J.,15,0,15,0
1745812939204,EDS 290,A00,897211,Hofstetter; Carolyn,15,0,15,0
1745812940231,LIGM 5A,A00,896162,Fischer-Grunski; Eva K,15,0,20,5
1745812941261,LIGM 5B,A00,896260,Fischer-Grunski; Eva K,17,0,20,3
1745812942290,LIGM 5C,A00,896308,Fischer-Grunski; Eva K,18,0,20,2
1745812943333,LIIT 5AS,A00,896313,Carnelos; Chiara,18,0,20,2
1745812944359,LIIT 5BS,A00,896416,Carnelos; Chiara,20,0,20,0
1745812945386,LIIT 5CS,A00,896564,Carnelos; Chiara,20,0,20,0
1745812946410,LISP 5A,A00,896588,Munoz Sanchez; Alicia,4,0,20,16
1745812947464,LISP 5B,A00,896653,Munoz Sanchez; Alicia,10,0,20,10
1745812948487,LISP 5C,A00,896655,Munoz Sanchez; Alicia,4,0,20,16
1745812949516,MAE 197,001,957918,Kleissl; Jan,9998,0,9999,1
1745812950544,MATH 2,A01,957937,Staff,34,0,35,1
1745812951570,MATH 197,001,957876,Kedlaya; Kiran S.,9993,0,9999,6
1745812952598,MCWP 40,A00,892729,Duru; Nur,13,0,20,7
1745812952598,MCWP 40,B00,893304,Montejo; Carolina,20,0,20,0
1745812953648,MCWP 40R,A00,893757,Redela; Pamela Morgan,0,7,20,20
1745812954677,MCWP 50,A00,893758,Morshed; Michael James,2,0,20,18
1745812954677,MCWP 50,B00,893761,Bartulis; Jason Michael,17,0,20,3
1745812955704,MCWP 50R,A00,893766,Compas; Sean Matthew,0,1,20,20
1745812955704,MCWP 50R,B00,893769,Carter; Jennifer A,0,0,20,20
1745812955704,MCWP 50R,C00,893771,Krone; Jarret,0,3,20,20
1745812955704,MCWP 50R,D00,893772,Miller; Elizabeth Deen,3,0,20,17
1745812955704,MCWP 50R,E00,893775,Carter; Andrea L,0,0,20,20
1745812956727,MMW 11R,A01,892721,Herbst; Matthew,11,0,27,16
1745812956727,MMW 11R,A02,892722,Herbst; Matthew,0,0,0,3
1745812957753,MMW 12R,A01,892724,Herbst; Matthew,0,9,16,16
1745812957753,MMW 12R,A02,892725,Herbst; Matthew,0,9,16,16
1745812958778,MMW 13R,A01,892727,Staff,0,4,16,16
1745812958778,MMW 13R,A02,892728,Staff,0,4,16,16
1745812958778,MMW 13R,A03,958032,Staff,0,3,16,16
1745812958778,MMW 13R,A04,958033,Staff,0,2,16,16
1745812958778,MMW 13R,A05,958034,Staff,0,3,16,16
1745812959804,SIO 295LS,A00,894015,Staff,7,0,25,18
1745812960833,SIO 295S,A00,894020,Staff,7,0,25,18
1745812961860,SIOC 290S,B01,958918,Staff,0,0,0,0
1745812962885,SIOC 291S,B01,958922,Staff,0,0,0,0
1745812963912,SOCI 117,A01,895339,Staff,4,0,5,1
1745812964939,WES 237B,A00,894149,Staff,11,0,20,9
1745812967003,AESE 279B,A00,891859,Staff,13,0,35,22
1745812968029,AIP 197,001,891854,Staff,70,0,70,0
1745812969053,ANTH 289S,A00,891856,Gagneux; Pascal,12,0,12,0
1745812970078,BENG 196,001,957946,Engler; Adam J.,9996,0,9999,3
1745812971106,CAT 124RS,A01,956906,Staff,8,0,25,17
1745812972131,CAT 125RS,A01,922013,Staff,8,0,25,17
1745812973157,CLRE 250,A00,891860,Morris; Sheldon,9995,0,9999,4
1745812975214,CLRE 251R,A00,907817,Mehta; Ravindra L.,9994,0,9999,5
1745812976241,CLRE 252,A00,891864,Cuomo; Raphael Eduardo,9993,0,9999,6
1745812977268,CLRE 253,A00,891867,Vaida; Florin,9994,0,9999,5
1745812977268,CLRE 253,B00,907819,Staff,9999,0,9999,0
1745812978296,CLRE 259,A00,891868,Patel; Hemal,9998,0,9999,1
1745812979325,CLRE 260,A00,891872,Cuomo; Raphael Eduardo,9999,0,9999,0
1745812980353,CLRE 297,001,891888,Cuomo; Raphael Eduardo,9999,0,9999,0
1745812981379,CSE 191,A00,958773,Minnes Kemp; Mor Mia,9999,0,9999,0
1745812982405,CSS 201S,A01,892054,Mignozzetti; Umberto,30,0,30,0
1745812983430,CSS 202S,A01,892056,Mignozzetti; Umberto,30,0,30,0
1745812984463,DSC 197,001,956898,Eldridge; Justin Matthew,9998,0,9999,1
1745812985518,DSC 297,001,958000,Mazumdar; Arya,9998,0,9999,1
1745812986544,EAP 100,A00,905686,Staff,9776,0,9999,223
1745812987572,ECE 45,A01,892618,Staff,0,12,50,50
1745812988597,ECE 109,A01,892620,Staff,0,44,0,0
1745812989624,ECE 111,A01,892719,Staff,0,8,50,50
1745812990650,ECE 197,001,957920,Mercier; Patrick Philip,9992,0,9999,7
1745812991677,ECON 178,A01,907814,Zhu; Ying,28,0,35,7
1745812992705,EDS 115,A00,895312,Staff,41,0,45,4
1745812993729,EDS 117,A01,895337,Staff,30,0,30,0
1745812994758,EDS 125,A00,895341,Jones; Gabrielle Anastasia,43,0,45,2
1745812995782,EDS 128A,A01,895459,Fargason; Sharon Gayle,44,0,45,1
1745812996810,EDS 128B,A01,895543,Pappas; Elizabeth,44,0,45,1
1745812997837,EDS 139,A00,897203,Pappas; Elizabeth,44,0,45,1
1745812997837,EDS 139,B00,897209,Fargason; Sharon Gayle,44,0,45,1
1745812998863,EDS 201,A00,895545,Staff,43,0,45,2
1745812999890,EDS 203,A01,895581,Halter; Christopher P.,43,0,45,2
1745813000917,EDS 204R,A01,895625,Heinzman; Erica M.,43,0,45,2
1745813000917,EDS 204R,B01,895693,Halter; Christopher P.,18,0,45,27
1745813001945,EDS 206R,A00,895694,Fargason; Sharon Gayle,9,0,30,21
1745813001945,EDS 206R,B00,895695,Choi; Bailey Miyeon,20,0,30,10
1745813002972,EDS 250,A00,895697,Hemans; Patricia Ann Benitez,43,0,45,2
1745813003999,EDS 281,A00,895701,Meyerott; Theresa Ann,15,0,15,0
1745813005030,EDS 284,A00,895736,Meyerott; Theresa Ann,15,0,15,0
1745813006058,EDS 286,A00,897210,Fine; Sarah,15,0,15,0
1745813007086,EDS 289C,A01,895770,Daly; Alan J.,15,0,15,0
1745813008115,EDS 290,A00,897211,Hofstetter; Carolyn,15,0,15,0
1745813009141,LIGM 5A,A00,896162,Fischer-Grunski; Eva K,15,0,20,5
1745813010169,LIGM 5B,A00,896260,Fischer-Grunski; Eva K,17,0,20,3
1745813011199,LIGM 5C,A00,896308,Fischer-Grunski; Eva K,18,0,20,2
1745813012226,LIIT 5AS,A00,896313,Carnelos; Chiara,18,0,20,2
1745813013257,LIIT 5BS,A00,896416,Carnelos; Chiara,20,0,20,0
1745813014284,LIIT 5CS,A00,896564,Carnelos; Chiara,20,0,20,0
1745813015311,LISP 5A,A00,896588,Munoz Sanchez; Alicia,4,0,20,16
1745813016339,LISP 5B,A00,896653,Munoz Sanchez; Alicia,10,0,20,10
1745813017365,LISP 5C,A00,896655,Munoz Sanchez; Alicia,4,0,20,16
1745813018390,MAE 197,001,957918,Kleissl; Jan,9998,0,9999,1
1745813019418,MATH 2,A01,957937,Staff,34,0,35,1
1745813020445,MATH 197,001,957876,Kedlaya; Kiran S.,9993,0,9999,6
1745813021476,MCWP 40,A00,892729,Duru; Nur,13,0,20,7
1745813021476,MCWP 40,B00,893304,Montejo; Carolina,20,0,20,0
1745813022502,MCWP 40R,A00,893757,Redela; Pamela Morgan,0,7,20,20
1745813023532,MCWP 50,A00,893758,Morshed; Michael James,2,0,20,18
1745813023532,MCWP 50,B00,893761,Bartulis; Jason Michael,17,0,20,3
1745813024561,MCWP 50R,A00,893766,Compas; Sean Matthew,0,1,20,20
1745813024561,MCWP 50R,B00,893769,Carter; Jennifer A,0,0,20,20
1745813024561,MCWP 50R,C00,893771,Krone; Jarret,0,3,20,20
1745813024561,MCWP 50R,D00,893772,Miller; Elizabeth Deen,3,0,20,17
1745813024561,MCWP 50R,E00,893775,Carter; Andrea L,0,0,20,20
1745813025591,MMW 11R,A01,892721,Herbst; Matthew,11,0,27,16
1745813025591,MMW 11R,A02,892722,Herbst; Matthew,0,0,0,3
1745813026619,MMW 12R,A01,892724,Herbst; Matthew,0,9,16,16
1745813026619,MMW 12R,A02,892725,Herbst; Matthew,0,9,16,16
1745813027647,MMW 13R,A01,892727,Staff,0,4,16,16
1745813027647,MMW 13R,A02,892728,Staff,0,4,16,16
1745813027647,MMW 13R,A03,958032,Staff,0,3,16,16
1745813027647,MMW 13R,A04,958033,Staff,0,2,16,16
1745813027647,MMW 13R,A05,958034,Staff,0,3,16,16
1745813028673,SIO 295LS,A00,894015,Staff,7,0,25,18
1745813029700,SIO 295S,A00,894020,Staff,7,0,25,18
1745813030730,SIOC 290S,B01,958918,Staff,0,0,0,0
1745813031758,SIOC 291S,B01,958922,Staff,0,0,0,0
1745813032783,SOCI 117,A01,895339,Staff,4,0,5,1
1745813033813,WES 237B,A00,894149,Staff,11,0,20,9
1745813035872,AESE 279B,A00,891859,Staff,13,0,35,22
1745813036898,AIP 197,001,891854,Staff,70,0,70,0
1745813037928,ANTH 289S,A00,891856,Gagneux; Pascal,12,0,12,0
1745813038958,BENG 196,001,957946,Engler; Adam J.,9996,0,9999,3
1745813039985,CAT 124RS,A01,956906,Staff,8,0,25,17
1745813041014,CAT 125RS,A01,922013,Staff,8,0,25,17
1745813042044,CLRE 250,A00,891860,Morris; Sheldon,9995,0,9999,4
1745813044102,CLRE 251R,A00,907817,Mehta; Ravindra L.,9994,0,9999,5
1745813045127,CLRE 252,A00,891864,Cuomo; Raphael Eduardo,9993,0,9999,6
1745813046156,CLRE 253,A00,891867,Vaida; Florin,9994,0,9999,5
1745813046156,CLRE 253,B00,907819,Staff,9999,0,9999,0
1745813047182,CLRE 259,A00,891868,Patel; Hemal,9998,0,9999,1
1745813048207,CLRE 260,A00,891872,Cuomo; Raphael Eduardo,9999,0,9999,0
1745813049235,CLRE 297,001,891888,Cuomo; Raphael Eduardo,9999,0,9999,0
1745813050264,CSE 191,A00,958773,Minnes Kemp; Mor Mia,9999,0,9999,0
1745813051292,CSS 201S,A01,892054,Mignozzetti; Umberto,30,0,30,0
1745813052317,CSS 202S,A01,892056,Mignozzetti; Umberto,30,0,30,0
1745813053370,DSC 197,001,956898,Eldridge; Justin Matthew,9998,0,9999,1
1745813054396,DSC 297,001,958000,Mazumdar; Arya,9998,0,9999,1
1745813055423,EAP 100,A00,905686,Staff,9776,0,9999,223
1745813056450,ECE 45,A01,892618,Staff,0,12,50,50
1745813057477,ECE 109,A01,892620,Staff,0,44,0,0
1745813058502,ECE 111,A01,892719,Staff,0,8,50,50
1745813059527,ECE 197,001,957920,Mercier; Patrick Philip,9992,0,9999,7
1745813060552,ECON 178,A01,907814,Zhu; Ying,28,0,35,7
1745813061579,EDS 115,A00,895312,Staff,41,0,45,4
1745813062602,EDS 117,A01,895337,Staff,30,0,30,0
1745813063629,EDS 125,A00,895341,Jones; Gabrielle Anastasia,43,0,45,2
1745813064654,EDS 128A,A01,895459,Fargason; Sharon Gayle,44,0,45,1
1745813065679,EDS 128B,A01,895543,Pappas; Elizabeth,44,0,45,1
1745813066705,EDS 139,A00,897203,Pappas; Elizabeth,44,0,45,1
1745813066705,EDS 139,B00,897209,Fargason; Sharon Gayle,44,0,45,1
1745813067730,EDS 201,A00,895545,Staff,43,0,45,2
1745813068758,EDS 203,A01,895581,Halter; Christopher P.,43,0,45,2
1745813069786,EDS 204R,A01,895625,Heinzman; Erica M.,43,0,45,2
1745813069786,EDS 204R,B01,895693,Halter; Christopher P.,18,0,45,27
1745813070811,EDS 206R,A00,895694,Fargason; Sharon Gayle,9,0,30,21
1745813070811,EDS 206R,B00,895695,Choi; Bailey Miyeon,20,0,30,10
1745813071836,EDS 250,A00,895697,Hemans; Patricia Ann Benitez,43,0,45,2
1745813072860,EDS 281,A00,895701,Meyerott; Theresa Ann,15,0,15,0
1745813073887,EDS 284,A00,895736,Meyerott; Theresa Ann,15,0,15,0
1745813074915,EDS 286,A00,897210,Fine; Sarah,15,0,15,0
1745813075943,EDS 289C,A01,895770,Daly; Alan J.,15,0,15,0
1745813076970,EDS 290,A00,897211,Hofstetter; Carolyn,15,0,15,0
1745813077997,LIGM 5A,A00,896162,Fischer-Grunski; Eva K,15,0,20,5
1745813079026,LIGM 5B,A00,896260,Fischer-Grunski; Eva K,17,0,20,3
1745813080054,LIGM 5C,A00,896308,Fischer-Grunski; Eva K,18,0,20,2
1745813081084,LIIT 5AS,A00,896313,Carnelos; Chiara,18,0,20,2
1745813082108,LIIT 5BS,A00,896416,Carnelos; Chiara,20,0,20,0
1745813083135,LIIT 5CS,A00,896564,Carnelos; Chiara,20,0,20,0
1745813084163,LISP 5A,A00,896588,Munoz Sanchez; Alicia,4,0,20,16
1745813085191,LISP 5B,A00,896653,Munoz Sanchez; Alicia,10,0,20,10
1745813086226,LISP 5C,A00,896655,Munoz Sanchez; Alicia,4,0,20,16
1745813087251,MAE 197,001,957918,Kleissl; Jan,9998,0,9999,1
1745813088276,MATH 2,A01,957937,Staff,34,0,35,1
1745813089300,MATH 197,001,957876,Kedlaya; Kiran S.,9993,0,9999,6
1745813090326,MCWP 40,A00,892729,Duru; Nur,13,0,20,7
1745813090326,MCWP 40,B00,893304,Montejo; Carolina,20,0,20,0
1745813091352,MCWP 40R,A00,893757,Redela; Pamela Morgan,0,7,20,20
1745813092378,MCWP 50,A00,893758,Morshed; Michael James,2,0,20,18
1745813092378,MCWP 50,B00,893761,Bartulis; Jason Michael,17,0,20,3
1745813093404,MCWP 50R,A00,893766,Compas; Sean Matthew,0,1,20,20
1745813093404,MCWP 50R,B00,893769,Carter; Jennifer A,0,0,20,20
1745813093404,MCWP 50R,C00,893771,Krone; Jarret,0,3,20,20
1745813093404,MCWP 50R,D00,893772,Miller; Elizabeth Deen,3,0,20,17
1745813093404,MCWP 50R,E00,893775,Carter; Andrea L,0,0,20,20
1745813094430,MMW 11R,A01,892721,Herbst; Matthew,11,0,27,16
1745813094430,MMW 11R,A02,892722,Herbst; Matthew,0,0,0,3
1745813095456,MMW 12R,A01,892724,Herbst; Matthew,0,9,16,16
1745813095456,MMW 12R,A02,892725,Herbst; Matthew,0,9,16,16
1745813096485,MMW 13R,A01,892727,Staff,0,4,16,16
1745813096485,MMW 13R,A02,892728,Staff,0,4,16,16
1745813096485,MMW 13R,A03,958032,Staff,0,3,16,16
1745813096485,MMW 13R,A04,958033,Staff,0,2,16,16
1745813096485,MMW 13R,A05,958034,Staff,0,3,16,16
1745813097510,SIO 295LS,A00,894015,Staff,7,0,25,18
1745813098537,SIO 295S,A00,894020,Staff,7,0,25,18
1745813099563,SIOC 290S,B01,958918,Staff,0,0,0,0
1745813100591,SIOC 291S,B01,958922,Staff,0,0,0,0
1745813101620,SOCI 117,A01,895339,Staff,4,0,5,1
1745813102648,WES 237B,A00,894149,Staff,11,0,20,9
1745813104719,AESE 279B,A00,891859,Staff,13,0,35,22
1745813105745,AIP 197,001,891854,Staff,70,0,70,0
1745813106773,ANTH 289S,A00,891856,Gagneux; Pascal,12,0,12,0
1745813107798,BENG 196,001,957946,Engler; Adam J.,9996,0,9999,3
1745813108823,CAT 124RS,A01,956906,Staff,8,0,25,17
1745813109849,CAT 125RS,A01,922013,Staff,8,0,25,17
1745813110876,CLRE 250,A00,891860,Morris; Sheldon,9995,0,9999,4
1745813112928,CLRE 251R,A00,907817,Mehta; Ravindra L.,9994,0,9999,5
1745813113956,CLRE 252,A00,891864,Cuomo; Raphael Eduardo,9993,0,9999,6
1745813114987,CLRE 253,A00,891867,Vaida; Florin,9994,0,9999,5
1745813114987,CLRE 253,B00,907819,Staff,9999,0,9999,0
1745813116012,CLRE 259,A00,891868,Patel; Hemal,9998,0,9999,1
1745813117044,CLRE 260,A00,891872,Cuomo; Raphael Eduardo,9999,0,9999,0
1745813118071,CLRE 297,001,891888,Cuomo; Raphael Eduardo,9999,0,9999,0
1745813119099,CSE 191,A00,958773,Minnes Kemp; Mor Mia,9999,0,9999,0
1745813120135,CSS 201S,A01,892054,Mignozzetti; Umberto,30,0,30,0
1745813121160,CSS 202S,A01,892056,Mignozzetti; Umberto,30,0,30,0
1745813122185,DSC 197,001,956898,Eldridge; Justin Matthew,9998,0,9999,1
1745813123213,DSC 297,001,958000,Mazumdar; Arya,9998,0,9999,1
1745813124244,EAP 100,A00,905686,Staff,9776,0,9999,223
1745813125271,ECE 45,A01,892618,Staff,0,12,50,50
1745813126298,ECE 109,A01,892620,Staff,0,44,0,0
1745813127359,ECE 111,A01,892719,Staff,0,8,50,50
1745813128385,ECE 197,001,957920,Mercier; Patrick Philip,9992,0,9999,7
1745813129412,ECON 178,A01,907814,Zhu; Ying,28,0,35,7
1745813130440,EDS 115,A00,895312,Staff,41,0,45,4
1745813131469,EDS 117,A01,895337,Staff,30,0,30,0
1745813132518,EDS 125,A00,895341,Jones; Gabrielle Anastasia,43,0,45,2
1745813133544,EDS 128A,A01,895459,Fargason; Sharon Gayle,44,0,45,1
1745813134568,EDS 128B,A01,895543,Pappas; Elizabeth,44,0,45,1
1745813135593,EDS 139,A00,897203,Pappas; Elizabeth,44,0,45,1
1745813135593,EDS 139,B00,897209,Fargason; Sharon Gayle,44,0,45,1
1745813136620,EDS 201,A00,895545,Staff,43,0,45,2
1745813137644,EDS 203,A01,895581,Halter; Christopher P.,43,0,45,2
1745813138670,EDS 204R,A01,895625,Heinzman; Erica M.,43,0,45,2
1745813138670,EDS 204R,B01,895693,Halter; Christopher P.,18,0,45,27
1745813139726,EDS 206R,A00,895694,Fargason; Sharon Gayle,9,0,30,21
1745813139726,EDS 206R,B00,895695,Choi; Bailey Miyeon,20,0,30,10
1745813140756,EDS 250,A00,895697,Hemans; Patricia Ann Benitez,43,0,45,2
1745813141784,EDS 281,A00,895701,Meyerott; Theresa Ann,15,0,15,0
1745813142810,EDS 284,A00,895736,Meyerott; Theresa Ann,15,0,15,0
1745813143839,EDS 286,A00,897210,Fine; Sarah,15,0,15,0
1745813144866,EDS 289C,A01,895770,Daly; Alan J.,15,0,15,0
1745813145891,EDS 290,A00,897211,Hofstetter; Carolyn,15,0,15,0
1745813146919,LIGM 5A,A00,896162,Fischer-Grunski; Eva K,15,0,20,5
1745813147948,LIGM 5B,A00,896260,Fischer-Grunski; Eva K,17,0,20,3
1745813148974,LIGM 5C,A00,896308,Fischer-Grunski; Eva K,18,0,20,2
1745813150003,LIIT 5AS,A00,896313,Carnelos; Chiara,18,0,20,2
1745813151030,LIIT 5BS,A00,896416,Carnelos; Chiara,20,0,20,0
1745813152061,LIIT 5CS,A00,896564,Carnelos; Chiara,20,0,20,0
1745813153088,LISP 5A,A00,896588,Munoz Sanchez; Alicia,4,0,20,16
1745813154119,LISP 5B,A00,896653,Munoz Sanchez; Alicia,10,0,20,10
1745813155146,LISP 5C,A00,896655,Munoz Sanchez; Alicia,4,0,20,16
1745813156172,MAE 197,001,957918,Kleissl; Jan,9998,0,9999,1
1745813157197,MATH 2,A01,957937,Staff,34,0,35,1
1745813158223,MATH 197,001,957876,Kedlaya; Kiran S.,9993,0,9999,6
1745813159250,MCWP 40,A00,892729,Duru; Nur,13,0,20,7
1745813159250,MCWP 40,B00,893304,Montejo; Carolina,20,0,20,0
1745813160305,MCWP 40R,A00,893757,Redela; Pamela Morgan,0,7,20,20
1745813161334,MCWP 50,A00,893758,Morshed; Michael James,2,0,20,18
1745813161334,MCWP 50,B00,893761,Bartulis; Jason Michael,17,0,20,3
1745813162366,MCWP 50R,A00,893766,Compas; Sean Matthew,0,1,20,20
1745813162366,MCWP 50R,B00,893769,Carter; Jennifer A,0,0,20,20
1745813162366,MCWP 50R,C00,893771,Krone; Jarret,0,3,20,20
1745813162366,MCWP 50R,D00,893772,Miller; Elizabeth Deen,3,0,20,17
1745813162366,MCWP 50R,E00,893775,Carter; Andrea L,0,0,20,20
1745813163394,MMW 11R,A01,892721,Herbst; Matthew,11,0,27,16
1745813163394,MMW 11R,A02,892722,Herbst; Matthew,0,0,0,3
1745813164422,MMW 12R,A01,892724,Herbst; Matthew,0,9,16,16
1745813164422,MMW 12R,A02,892725,Herbst; Matthew,0,9,16,16
1745813165448,MMW 13R,A01,892727,Staff,0,4,16,16
1745813165448,MMW 13R,A02,892728,Staff,0,4,16,16
1745813165448,MMW 13R,A03,958032,Staff,0,3,16,16
1745813165448,MMW 13R,A04,958033,Staff,0,2,16,16
1745813165448,MMW 13R,A05,958034,Staff,0,3,16,16
1745813166477,SIO 295LS,A00,894015,Staff,7,0,25,18
1745813167501,SIO 295S,A00,894020,Staff,7,0,25,18
1745813168527,SIOC 290S,B01,958918,Staff,0,0,0,0
1745813169555,SIOC 291S,B01,958922,Staff,0,0,0,0
1745813170582,SOCI 117,A01,895339,Staff,4,0,5,1
1745813171607,WES 237B,A00,894149,Staff,11,0,20,9
1745813173676,AESE 279B,A00,891859,Staff,13,0,35,22
1745813174701,AIP 197,001,891854,Staff,70,0,70,0
1745813175728,ANTH 289S,A00,891856,Gagneux; Pascal,12,0,12,0
1745813176755,BENG 196,001,957946,Engler; Adam J.,9996,0,9999,3
1745813177782,CAT 124RS,A01,956906,Staff,8,0,25,17
1745813178811,CAT 125RS,A01,922013,Staff,8,0,25,17
1745813179840,CLRE 250,A00,891860,Morris; Sheldon,9995,0,9999,4
1745813181896,CLRE 251R,A00,907817,Mehta; Ravindra L.,9994,0,9999,5
1745813182925,CLRE 252,A00,891864,Cuomo; Raphael Eduardo,9993,0,9999,6
1745813183950,CLRE 253,A00,891867,Vaida; Florin,9994,0,9999,5
1745813183950,CLRE 253,B00,907819,Staff,9999,0,9999,0
1745813184976,CLRE 259,A00,891868,Patel; Hemal,9998,0,9999,1
1745813186002,CLRE 260,A00,891872,Cuomo; Raphael Eduardo,9999,0,9999,0
1745813187029,CLRE 297,001,891888,Cuomo; Raphael Eduardo,9999,0,9999,0
1745813188057,CSE 191,A00,958773,Minnes Kemp; Mor Mia,9999,0,9999,0
1745813189088,CSS 201S,A01,892054,Mignozzetti; Umberto,30,0,30,0
1745813190115,CSS 202S,A01,892056,Mignozzetti; Umberto,30,0,30,0
1745813191140,DSC 197,001,956898,Eldridge; Justin Matthew,9998,0,9999,1
1745813192164,DSC 297,001,958000,Mazumdar; Arya,9998,0,9999,1
1745813193192,EAP 100,A00,905686,Staff,9776,0,9999,223
1745813194223,ECE 45,A01,892618,Staff,0,12,50,50
1745813195251,ECE 109,A01,892620,Staff,0,44,0,0
1745813196281,ECE 111,A01,892719,Staff,0,8,50,50
1745813197310,ECE 197,001,957920,Mercier; Patrick Philip,9992,0,9999,7
1745813198340,ECON 178,A01,907814,Zhu; Ying,28,0,35,7
1745813199366,EDS 115,A00,895312,Staff,41,0,45,4
1745813200391,EDS 117,A01,895337,Staff,30,0,30,0
1745813201416,EDS 125,A00,895341,Jones; Gabrielle Anastasia,43,0,45,2
1745813202442,EDS 128A,A01,895459,Fargason; Sharon Gayle,44,0,45,1
1745813203468,EDS 128B,A01,895543,Pappas; Elizabeth,44,0,45,1
1745813204493,EDS 139,A00,897203,Pappas; Elizabeth,44,0,45,1
1745813204493,EDS 139,B00,897209,Fargason; Sharon Gayle,44,0,45,1
1745813205518,EDS 201,A00,895545,Staff,43,0,45,2
1745813206547,EDS 203,A01,895581,Halter; Christopher P.,43,0,45,2
1745813207573,EDS 204R,A01,895625,Heinzman; Erica M.,43,0,45,2
1745813207573,EDS 204R,B01,895693,Halter; Christopher P.,18,0,45,27
1745813208599,EDS 206R,A00,895694,Fargason; Sharon Gayle,9,0,30,21
1745813208599,EDS 206R,B00,895695,Choi; Bailey Miyeon,20,0,30,10
1745813209623,EDS 250,A00,895697,Hemans; Patricia Ann Benitez,43,0,45,2
1745813210649,EDS 281,A00,895701,Meyerott; Theresa Ann,15,0,15,0
1745813211678,EDS 284,A00,895736,Meyerott; Theresa Ann,15,0,15,0
1745813212707,EDS 286,A00,897210,Fine; Sarah,15,0,15,0
1745813213735,EDS 289C,A01,895770,Daly; Alan J.,15,0,15,0
1745813214763,EDS 290,A00,897211,Hofstetter; Carolyn,15,0,15,0
1745813215794,LIGM 5A,A00,896162,Fischer-Grunski; Eva K,15,0,20,5
1745813216824,LIGM 5B,A00,896260,Fischer-Grunski; Eva K,17,0,20,3
1745813217853,LIGM 5C,A00,896308,Fischer-Grunski; Eva K,18,0,20,2
1745813218880,LIIT 5AS,A00,896313,Carnelos; Chiara,18,0,20,2
1745813219907,LIIT 5BS,A00,896416,Carnelos; Chiara,20,0,20,0
1745813220934,LIIT 5CS,A00,896564,Carnelos; Chiara,20,0,20,0
1745813221958,LISP 5A,A00,896588,Munoz Sanchez; Alicia,4,0,20,16
1745813222988,LISP 5B,A00,896653,Munoz Sanchez; Alicia,10,0,20,10
1745813224014,LISP 5C,A00,896655,Munoz Sanchez; Alicia,4,0,20,16
1745813225042,MAE 197,001,957918,Kleissl; Jan,9998,0,9999,1
1745813226069,MATH 2,A01,957937,Staff,34,0,35,1
1745813227096,MATH 197,001,957876,Kedlaya; Kiran S.,9993,0,9999,6
1745813228125,MCWP 40,A00,892729,Duru; Nur,13,0,20,7
1745813228125,MCWP 40,B00,893304,Montejo; Carolina,20,0,20,0
1745813229150,MCWP 40R,A00,893757,Redela; Pamela Morgan,0,7,20,20
1745813230179,MCWP 50,A00,893758,Morshed; Michael James,2,0,20,18
1745813230179,MCWP 50,B00,893761,Bartulis; Jason Michael,17,0,20,3
1745813231210,MCWP 50R,A00,893766,Compas; Sean Matthew,0,1,20,20
1745813231210,MCWP 50R,B00,893769,Carter; Jennifer A,0,0,20,20
1745813231210,MCWP 50R,C00,893771,Krone; Jarret,0,3,20,20
1745813231210,MCWP 50R,D00,893772,Miller; Elizabeth Deen,3,0,20,17
1745813231210,MCWP 50R,E00,893775,Carter; Andrea L,0,0,20,20
1745813232238,MMW 11R,A01,892721,Herbst; Matthew,11,0,27,16
1745813232238,MMW 11R,A02,892722,Herbst; Matthew,0,0,0,3
1745813233265,MMW 12R,A01,892724,Herbst; Matthew,0,9,16,16
1745813233265,MMW 12R,A02,892725,Herbst; Matthew,0,9,16,16
1745813234292,MMW 13R,A01,892727,Staff,0,4,16,16
1745813234292,MMW 13R,A02,892728,Staff,0,4,16,16
1745813234292,MMW 13R,A03,958032,Staff,0,3,16,16
1745813234292,MMW 13R,A04,958033,Staff,0,2,16,16
1745813234292,MMW 13R,A05,958034,Staff,0,3,16,16
1745813235320,SIO 295LS,A00,894015,Staff,7,0,25,18
1745813236346,SIO 295S,A00,894020,Staff,7,0,25,18
1745813237375,SIOC 290S,B01,958918,Staff,0,0,0,0
1745813238406,SIOC 291S,B01,958922,Staff,0,0,0,0
1745813239433,SOCI 117,A01,895339,Staff,4,0,5,1
1745813240460,WES 237B,A00,894149,Staff,11,0,20,9
1745813242518,AESE 279B,A00,891859,Staff,13,0,35,22
1745813243546,AIP 197,001,891854,Staff,70,0,70,0
1745813244572,ANTH 289S,A00,891856,Gagneux; Pascal,12,0,12,0
1745813245598,BENG 196,001,957946,Engler; Adam J.,9996,0,9999,3
1745813246623,CAT 124RS,A01,956906,Staff,8,0,25,17
1745813247650,CAT 125RS,A01,922013,Staff,8,0,25,17
1745813248676,CLRE 250,A00,891860,Morris; Sheldon,9995,0,9999,4
1745813250728,CLRE 251R,A00,907817,Mehta; Ravindra L.,9994,0,9999,5
1745813251756,CLRE 252,A00,891864,Cuomo; Raphael Eduardo,9993,0,9999,6
1745813252786,CLRE 253,A00,891867,Vaida; Florin,9994,0,9999,5
1745813252786,CLRE 253,B00,907819,Staff,9999,0,9999,0
1745813253813,CLRE 259,A00,891868,Patel; Hemal,9998,0,9999,1
1745813254839,CLRE 260,A00,891872,Cuomo; Raphael Eduardo,9999,0,9999,0
1745813255867,CLRE 297,001,891888,Cuomo; Raphael Eduardo,9999,0,9999,0
1745813256891,CSE 191,A00,958773,Minnes Kemp; Mor Mia,9999,0,9999,0
1745813257917,CSS 201S,A01,892054,Mignozzetti; Umberto,30,0,30,0
1745813258947,CSS 202S,A01,892056,Mignozzetti; Umberto,30,0,30,0
1745813259976,DSC 197,001,956898,Eldridge; Justin Matthew,9998,0,9999,1
1745813261002,DSC 297,001,958000,Mazumdar; Arya,9998,0,9999,1
1745813262028,EAP 100,A00,905686,Staff,9776,0,9999,223
1745813263054,ECE 45,A01,892618,Staff,0,12,50,50
1745813264082,ECE 109,A01,892620,Staff,0,44,0,0
1745813265108,ECE 111,A01,892719,Staff,0,8,50,50
1745813266133,ECE 197,001,957920,Mercier; Patrick Philip,9992,0,9999,7
1745813267161,ECON 178,A01,907814,Zhu; Ying,28,0,35,7
1745813268187,EDS 115,A00,895312,Staff,41,0,45,4
1745813269211,EDS 117,A01,895337,Staff,30,0,30,0
1745813270235,EDS 125,A00,895341,Jones; Gabrielle Anastasia,43,0,45,2
1745813271261,EDS 128A,A01,895459,Fargason; Sharon Gayle,44,0,45,1
1745813272288,EDS 128B,A01,895543,Pappas; Elizabeth,44,0,45,1
1745813273313,EDS 139,A00,897203,Pappas; Elizabeth,44,0,45,1
1745813273313,EDS 139,B00,897209,Fargason; Sharon Gayle,44,0,45,1
1745813274343,EDS 201,A00,895545,Staff,43,0,45,2
1745813275371,EDS 203,A01,895581,Halter; Christopher P.,43,0,45,2
1745813276399,EDS 204R,A01,895625,Heinzman; Erica M.,43,0,45,2
1745813276399,EDS 204R,B01,895693,Halter; Christopher P.,18,0,45,27
1745813277427,EDS 206R,A00,895694,Fargason; Sharon Gayle,9,0,30,21
1745813277427,EDS 206R,B00,895695,Choi; Bailey Miyeon,20,0,30,10
1745813278454,EDS 250,A00,895697,Hemans; Patricia Ann Benitez,43,0,45,2
1745813279479,EDS 281,A00,895701,Meyerott; Theresa Ann,15,0,15,0
1745813280505,EDS 284,A00,895736,Meyerott; Theresa Ann,15,0,15,0
1745813281531,EDS 286,A00,897210,Fine; Sarah,15,0,15,0
1745813282557,EDS 289C,A01,895770,Daly; Alan J.,15,0,15,0
1745813283583,EDS 290,A00,897211,Hofstetter; Carolyn,15,0,15,0
1745813284609,LIGM 5A,A00,896162,Fischer-Grunski; Eva K,15,0,20,5
1745813285640,LIGM 5B,A00,896260,Fischer-Grunski; Eva K,17,0,20,3
1745813286669,LIGM 5C,A00,896308,Fischer-Grunski; Eva K,18,0,20,2
1745813287699,LIIT 5AS,A00,896313,Carnelos; Chiara,18,0,20,2
1745813288729,LIIT 5BS,A00,896416,Carnelos; Chiara,20,0,20,0
1745813289754,LIIT 5CS,A00,896564,Carnelos; Chiara,20,0,20,0
1745813290780,LISP 5A,A00,896588,Munoz Sanchez; Alicia,4,0,20,16
1745813291809,LISP 5B,A00,896653,Munoz Sanchez; Alicia,10,0,20,10
1745813292835,LISP 5C,A00,896655,Munoz Sanchez; Alicia,4,0,20,16
1745813293865,MAE 197,001,957918,Kleissl; Jan,9998,0,9999,1
1745813294896,MATH 2,A01,957937,Staff,34,0,35,1
1745813295926,MATH 197,001,957876,Kedlaya; Kiran S.,9993,0,9999,6
1745813296952,MCWP 40,A00,892729,Duru; Nur,13,0,20,7
1745813296952,MCWP 40,B00,893304,Montejo; Carolina,20,0,20,0
1745813297978,MCWP 40R,A00,893757,Redela; Pamela Morgan,0,7,20,20
1745813299005,MCWP 50,A00,893758,Morshed; Michael James,2,0,20,18
1745813299005,MCWP 50,B00,893761,Bartulis; Jason Michael,17,0,20,3
1745813300039,MCWP 50R,A00,893766,Compas; Sean Matthew,0,1,20,20
1745813300039,MCWP 50R,B00,893769,Carter; Jennifer A,0,0,20,20
1745813300039,MCWP 50R,C00,893771,Krone; Jarret,0,3,20,20
1745813300039,MCWP 50R,D00,893772,Miller; Elizabeth Deen,3,0,20,17
1745813300039,MCWP 50R,E00,893775,Carter; Andrea L,0,0,20,20
1745813301067,MMW 11R,A01,892721,Herbst; Matthew,11,0,27,16
1745813301067,MMW 11R,A02,892722,Herbst; Matthew,0,0,0,3
1745813302091,MMW 12R,A01,892724,Herbst; Matthew,0,9,16,16
1745813302091,MMW 12R,A02,892725,Herbst; Matthew,0,9,16,16
1745813303119,MMW 13R,A01,892727,Staff,0,4,16,16
1745813303119,MMW 13R,A02,892728,Staff,0,4,16,16
1745813303119,MMW 13R,A03,958032,Staff,0,3,16,16
1745813303119,MMW 13R,A04,958033,Staff,0,2,16,16
1745813303119,MMW 13R,A05,958034,Staff,0,3,16,16
1745813304148,SIO 295LS,A00,894015,Staff,7,0,25,18
1745813305175,SIO 295S,A00,894020,Staff,7,0,25,18
1745813306206,SIOC 290S,B01,958918,Staff,0,0,0,0
1745813307239,SIOC 291S,B01,958922,Staff,0,0,0,0
1745813308268,SOCI 117,A01,895339,Staff,4,0,5,1
1745813309296,WES 237B,A00,894149,Staff,11,0,20,9
1745813311357,AESE 279B,A00,891859,Staff,13,0,35,22
1745813312394,AIP 197,001,891854,Staff,70,0,70,0
1745813313419,ANTH 289S,A00,891856,Gagneux; Pascal,12,0,12,0
1745813314450,BENG 196,001,957946,Engler; Adam J.,9996,0,9999,3
1745813315475,CAT 124RS,A01,956906,Staff,8,0,25,17
1745813316501,CAT 125RS,A01,922013,Staff,8,0,25,17
1745813317528,CLRE 250,A00,891860,Morris; Sheldon,9995,0,9999,4
1745813319585,CLRE 251R,A00,907817,Mehta; Ravindra L.,9994,0,9999,5
1745813320611,CLRE 252,A00,891864,Cuomo; Raphael Eduardo,9993,0,9999,6
1745813321640,CLRE 253,A00,891867,Vaida; Florin,9994,0,9999,5
1745813321640,CLRE 253,B00,907819,Staff,9999,0,9999,0
1745813322668,CLRE 259,A00,891868,Patel; Hemal,9998,0,9999,1
1745813323695,CLRE 260,A00,891872,Cuomo; Raphael Eduardo,9999,0,9999,0
1745813324721,CLRE 297,001,891888,Cuomo; Raphael Eduardo,9999,0,9999,0
1745813325750,CSE 191,A00,958773,Minnes Kemp; Mor Mia,9999,0,9999,0
1745813326775,CSS 201S,A01,892054,Mignozzetti; Umberto,30,0,30,0
1745813327800,CSS 202S,A01,892056,Mignozzetti; Umberto,30,0,30,0
1745813328825,DSC 197,001,956898,Eldridge; Justin Matthew,9998,0,9999,1
1745813329854,DSC 297,001,958000,Mazumdar; Arya,9998,0,9999,1
1745813330880,EAP 100,A00,905686,Staff,9776,0,9999,223
1745813331908,ECE 45,A01,892618,Staff,0,12,50,50
1745813332935,ECE 109,A01,892620,Staff,0,44,0,0
1745813333960,ECE 111,A01,892719,Staff,0,8,50,50
1745813334987,ECE 197,001,957920,Mercier; Patrick Philip,9992,0,9999,7
1745813336014,ECON 178,A01,907814,Zhu; Ying,28,0,35,7
1745813337041,EDS 115,A00,895312,Staff,41,0,45,4
1745813338065,EDS 117,A01,895337,Staff,30,0,30,0
1745813339093,EDS 125,A00,895341,Jones; Gabrielle Anastasia,43,0,45,2
1745813340121,EDS 128A,A01,895459,Fargason; Sharon Gayle,44,0,45,1
1745813341151,EDS 128B,A01,895543,Pappas; Elizabeth,44,0,45,1
1745813342181,EDS 139,A00,897203,Pappas; Elizabeth,44,0,45,1
1745813342181,EDS 139,B00,897209,Fargason; Sharon Gayle,44,0,45,1
1745813343212,EDS 201,A00,895545,Staff,43,0,45,2
1745813344243,EDS 203,A01,895581,Halter; Christopher P.,43,0,45,2
1745813345277,EDS 204R,A01,895625,Heinzman; Erica M.,43,0,45,2
1745813345277,EDS 204R,B01,895693,Halter; Christopher P.,18,0,45,27
1745813346308,EDS 206R,A00,895694,Fargason; Sharon Gayle,9,0,30,21
1745813346308,EDS 206R,B00,895695,Choi; Bailey Miyeon,20,0,30,10
1745813347335,EDS 250,A00,895697,Hemans; Patricia Ann Benitez,43,0,45,2
1745813348364,EDS 281,A00,895701,Meyerott; Theresa Ann,15,0,15,0
1745813349390,EDS 284,A00,895736,Meyerott; Theresa Ann,15,0,15,0
1745813350419,EDS 286,A00,897210,Fine; Sarah,15,0,15,0
1745813351445,EDS 289C,A01,895770,Daly; Alan J.,15,0,15,0
1745813352473,EDS 290,A00,897211,Hofstetter; Carolyn,15,0,15,0
1745813353501,LIGM 5A,A00,896162,Fischer-Grunski; Eva K,15,0,20,5
1745813354528,LIGM 5B,A00,896260,Fischer-Grunski; Eva K,17,0,20,3
1745813355556,LIGM 5C,A00,896308,Fischer-Grunski; Eva K,18,0,20,2
1745813356583,LIIT 5AS,A00,896313,Carnelos; Chiara,18,0,20,2
1745813357614,LIIT 5BS,A00,896416,Carnelos; Chiara,20,0,20,0
1745813358642,LIIT 5CS,A00,896564,Carnelos; Chiara,20,0,20,0
1745813359668,LISP 5A,A00,896588,Munoz Sanchez; Alicia,4,0,20,16
1745813360697,LISP 5B,A00,896653,Munoz Sanchez; Alicia,10,0,20,10
1745813361721,LISP 5C,A00,896655,Munoz Sanchez; Alicia,4,0,20,16
1745813362749,MAE 197,001,957918,Kleissl; Jan,9998,0,9999,1
1745813363778,MATH 2,A01,957937,Staff,34,0,35,1
1745813364804,MATH 197,001,957876,Kedlaya; Kiran S.,9993,0,9999,6
1745813365831,MCWP 40,A00,892729,Duru; Nur,13,0,20,7
1745813365831,MCWP 40,B00,893304,Montejo; Carolina,20,0,20,0
1745813366855,MCWP 40R,A00,893757,Redela; Pamela Morgan,0,7,20,20
1745813367881,MCWP 50,A00,893758,Morshed; Michael James,2,0,20,18
1745813367881,MCWP 50,B00,893761,Bartulis; Jason Michael,17,0,20,3
1745813368912,MCWP 50R,A00,893766,Compas; Sean Matthew,0,1,20,20
1745813368912,MCWP 50R,B00,893769,Carter; Jennifer A,0,0,20,20
1745813368912,MCWP 50R,C00,893771,Krone; Jarret,0,3,20,20
1745813368912,MCWP 50R,D00,893772,Miller; Elizabeth Deen,3,0,20,17
1745813368912,MCWP 50R,E00,893775,Carter; Andrea L,0,0,20,20
1745813369937,MMW 11R,A01,892721,Herbst; Matthew,11,0,27,16
1745813369937,MMW 11R,A02,892722,Herbst; Matthew,0,0,0,3
1745813370965,MMW 12R,A01,892724,Herbst; Matthew,0,9,16,16
1745813370965,MMW 12R,A02,892725,Herbst; Matthew,0,9,16,16
1745813371992,MMW 13R,A01,892727,Staff,0,4,16,16
1745813371992,MMW 13R,A02,892728,Staff,0,4,16,16
1745813371992,MMW 13R,A03,958032,Staff,0,3,16,16
1745813371992,MMW 13R,A04,958033,Staff,0,2,16,16
1745813371992,MMW 13R,A05,958034,Staff,0,3,16,16
1745813373021,SIO 295LS,A00,894015,Staff,7,0,25,18
1745813374049,SIO 295S,A00,894020,Staff,7,0,25,18
1745813375079,SIOC 290S,B01,958918,Staff,0,0,0,0
1745813376103,SIOC 291S,B01,958922,Staff,0,0,0,0
1745813377128,SOCI 117,A01,895339,Staff,4,0,5,1
1745813378152,WES 237B,A00,894149,Staff,11,0,20,9
1745813380210,AESE 279B,A00,891859,Staff,13,0,35,22
1745813381236,AIP 197,001,891854,Staff,70,0,70,0
1745813382262,ANTH 289S,A00,891856,Gagneux; Pascal,12,0,12,0
1745813383288,BENG 196,001,957946,Engler; Adam J.,9996,0,9999,3
1745813384311,CAT 124RS,A01,956906,Staff,8,0,25,17
1745813385340,CAT 125RS,A01,922013,Staff,8,0,25,17
1745813386368,CLRE 250,A00,891860,Morris; Sheldon,9995,0,9999,4
1745813388447,CLRE 251R,A00,907817,Mehta; Ravindra L.,9994,0,9999,5
1745813389472,CLRE 252,A00,891864,Cuomo; Raphael Eduardo,9993,0,9999,6
1745813390505,CLRE 253,A00,891867,Vaida; Florin,9994,0,9999,5
1745813390505,CLRE 253,B00,907819,Staff,9999,0,9999,0
1745813391531,CLRE 259,A00,891868,Patel; Hemal,9998,0,9999,1
1745813392554,CLRE 260,A00,891872,Cuomo; Raphael Eduardo,9999,0,9999,0
1745813393582,CLRE 297,001,891888,Cuomo; Raphael Eduardo,9999,0,9999,0
1745813394608,CSE 191,A00,958773,Minnes Kemp; Mor Mia,9999,0,9999,0
1745813395634,CSS 201S,A01,892054,Mignozzetti; Umberto,30,0,30,0
1745813396662,CSS 202S,A01,892056,Mignozzetti; Umberto,30,0,30,0
1745813397685,DSC 197,001,956898,Eldridge; Justin Matthew,9998,0,9999,1
1745813398710,DSC 297,001,958000,Mazumdar; Arya,9998,0,9999,1
1745813399738,EAP 100,A00,905686,Staff,9776,0,9999,223
1745813400764,ECE 45,A01,892618,Staff,0,12,50,50
1745813401790,ECE 109,A01,892620,Staff,0,44,0,0
1745813402815,ECE 111,A01,892719,Staff,0,8,50,50
1745813403843,ECE 197,001,957920,Mercier; Patrick Philip,9992,0,9999,7
1745813404870,ECON 178,A01,907814,Zhu; Ying,28,0,35,7
1745813405898,EDS 115,A00,895312,Staff,41,0,45,4
1745813406927,EDS 117,A01,895337,Staff,30,0,30,0
1745813407953,EDS 125,A00,895341,Jones; Gabrielle Anastasia,43,0,45,2
1745813408978,EDS 128A,A01,895459,Fargason; Sharon Gayle,44,0,45,1
1745813410009,EDS 128B,A01,895543,Pappas; Elizabeth,44,0,45,1
1745813411037,EDS 139,A00,897203,Pappas; Elizabeth,44,0,45,1
1745813411037,EDS 139,B00,897209,Fargason; Sharon Gayle,44,0,45,1
1745813412065,EDS 201,A00,895545,Staff,43,0,45,2
1745813413096,EDS 203,A01,895581,Halter; Christopher P.,43,0,45,2
1745813414128,EDS 204R,A01,895625,Heinzman; Erica M.,43,0,45,2
1745813414128,EDS 204R,B01,895693,Halter; Christopher P.,18,0,45,27
1745813415157,EDS 206R,A00,895694,Fargason; Sharon Gayle,9,0,30,21
1745813415157,EDS 206R,B00,895695,Choi; Bailey Miyeon,20,0,30,10
1745813416183,EDS 250,A00,895697,Hemans; Patricia Ann Benitez,43,0,45,2
1745813417210,EDS 281,A00,895701,Meyerott; Theresa Ann,15,0,15,0
1745813418237,EDS 284,A00,895736,Meyerott; Theresa Ann,15,0,15,0
1745813419263,EDS 286,A00,897210,Fine; Sarah,15,0,15,0
1745813420289,EDS 289C,A01,895770,Daly; Alan J.,15,0,15,0
1745813421314,EDS 290,A00,897211,Hofstetter; Carolyn,15,0,15,0
1745813422342,LIGM 5A,A00,896162,Fischer-Grunski; Eva K,15,0,20,5
1745813423368,LIGM 5B,A00,896260,Fischer-Grunski; Eva K,17,0,20,3
1745813424397,LIGM 5C,A00,896308,Fischer-Grunski; Eva K,18,0,20,2
1745813425422,LIIT 5AS,A00,896313,Carnelos; Chiara,18,0,20,2
1745813426449,LIIT 5BS,A00,896416,Carnelos; Chiara,20,0,20,0
1745813427475,LIIT 5CS,A00,896564,Carnelos; Chiara,20,0,20,0
1745813428501,LISP 5A,A00,896588,Munoz Sanchez; Alicia,4,0,20,16
1745813429532,LISP 5B,A00,896653,Munoz Sanchez; Alicia,10,0,20,10
1745813430560,LISP 5C,A00,896655,Munoz Sanchez; Alicia,4,0,20,16
1745813431585,MAE 197,001,957918,Kleissl; Jan,9998,0,9999,1
1745813432615,MATH 2,A01,957937,Staff,34,0,35,1
1745813433639,MATH 197,001,957876,Kedlaya; Kiran S.,9993,0,9999,6
1745813434666,MCWP 40,A00,892729,Duru; Nur,13,0,20,7
1745813434666,MCWP 40,B00,893304,Montejo; Carolina,20,0,20,0
1745813435693,MCWP 40R,A00,893757,Redela; Pamela Morgan,0,7,20,20
1745813436725,MCWP 50,A00,893758,Morshed; Michael James,2,0,20,18
1745813436725,MCWP 50,B00,893761,Bartulis; Jason Michael,17,0,20,3
1745813437753,MCWP 50R,A00,893766,Compas; Sean Matthew,0,1,20,20
1745813437753,MCWP 50R,B00,893769,Carter; Jennifer A,0,0,20,20
1745813437753,MCWP 50R,C00,893771,Krone; Jarret,0,3,20,20
1745813437753,MCWP 50R,D00,893772,Miller; Elizabeth Deen,3,0,20,17
1745813437753,MCWP 50R,E00,893775,Carter; Andrea L,0,0,20,20
1745813438778,MMW 11R,A01,892721,Herbst; Matthew,11,0,27,16
1745813438778,MMW 11R,A02,892722,Herbst; Matthew,0,0,0,3
1745813439806,MMW 12R,A01,892724,Herbst; Matthew,0,9,16,16
1745813439806,MMW 12R,A02,892725,Herbst; Matthew,0,9,16,16
1745813440833,MMW 13R,A01,892727,Staff,0,4,16,16
1745813440833,MMW 13R,A02,892728,Staff,0,4,16,16
1745813440833,MMW 13R,A03,958032,Staff,0,3,16,16
1745813440833,MMW 13R,A04,958033,Staff,0,2,16,16
1745813440833,MMW 13R,A05,958034,Staff,0,3,16,16
1745813441861,SIO 295LS,A00,894015,Staff,7,0,25,18
1745813442887,SIO 295S,A00,894020,Staff,7,0,25,18
1745813443911,SIOC 290S,B01,958918,Staff,0,0,0,0
1745813444936,SIOC 291S,B01,958922,Staff,0,0,0,0
1745813445964,SOCI 117,A01,895339,Staff,4,0,5,1
1745813446994,WES 237B,A00,894149,Staff,11,0,20,9
1745813449060,AESE 279B,A00,891859,Staff,13,0,35,22
1745813450087,AIP 197,001,891854,Staff,70,0,70,0
1745813451111,ANTH 289S,A00,891856,Gagneux; Pascal,12,0,12,0
1745813452137,BENG 196,001,957946,Engler; Adam J.,9996,0,9999,3
1745813453165,CAT 124RS,A01,956906,Staff,8,0,25,17
1745813454193,CAT 125RS,A01,922013,Staff,8,0,25,17
1745813455220,CLRE 250,A00,891860,Morris; Sheldon,9995,0,9999,4
1745813457278,CLRE 251R,A00,907817,Mehta; Ravindra L.,9994,0,9999,5
1745813458345,CLRE 252,A00,891864,Cuomo; Raphael Eduardo,9993,0,9999,6
1745813459376,CLRE 253,A00,891867,Vaida; Florin,9994,0,9999,5
1745813459376,CLRE 253,B00,907819,Staff,9999,0,9999,0
1745813460401,CLRE 259,A00,891868,Patel; Hemal,9998,0,9999,1
1745813461428,CLRE 260,A00,891872,Cuomo; Raphael Eduardo,9999,0,9999,0
1745813462456,CLRE 297,001,891888,Cuomo; Raphael Eduardo,9999,0,9999,0
1745813463483,CSE 191,A00,958773,Minnes Kemp; Mor Mia,9999,0,9999,0
1745813464512,CSS 201S,A01,892054,Mignozzetti; Umberto,30,0,30,0
1745813465544,CSS 202S,A01,892056,Mignozzetti; Umberto,30,0,30,0
1745813466571,DSC 197,001,956898,Eldridge; Justin Matthew,9998,0,9999,1
1745813467600,DSC 297,001,958000,Mazumdar; Arya,9998,0,9999,1
1745813468629,EAP 100,A00,905686,Staff,9776,0,9999,223
1745813469658,ECE 45,A01,892618,Staff,0,12,50,50
1745813470685,ECE 109,A01,892620,Staff,0,44,0,0
1745813471714,ECE 111,A01,892719,Staff,0,8,50,50
1745813472738,ECE 197,001,957920,Mercier; Patrick Philip,9992,0,9999,7
1745813473763,ECON 178,A01,907814,Zhu; Ying,28,0,35,7
1745813474791,EDS 115,A00,895312,Staff,41,0,45,4
1745813475816,EDS 117,A01,895337,Staff,30,0,30,0
1745813476841,EDS 125,A00,895341,Jones; Gabrielle Anastasia,43,0,45,2
1745813477868,EDS 128A,A01,895459,Fargason; Sharon Gayle,44,0,45,1
1745813478896,EDS 128B,A01,895543,Pappas; Elizabeth,44,0,45,1
1745813479924,EDS 139,A00,897203,Pappas; Elizabeth,44,0,45,1
1745813479924,EDS 139,B00,897209,Fargason; Sharon Gayle,44,0,45,1
1745813480950,EDS 201,A00,895545,Staff,43,0,45,2
1745813481980,EDS 203,A01,895581,Halter; Christopher P.,43,0,45,2
1745813483006,EDS 204R,A01,895625,Heinzman; Erica M.,43,0,45,2
1745813483006,EDS 204R,B01,895693,Halter; Christopher P.,18,0,45,27
1745813484033,EDS 206R,A00,895694,Fargason; Sharon Gayle,9,0,30,21
1745813484033,EDS 206R,B00,895695,Choi; Bailey Miyeon,20,0,30,10
1745813485061,EDS 250,A00,895697,Hemans; Patricia Ann Benitez,43,0,45,2
1745813486088,EDS 281,A00,895701,Meyerott; Theresa Ann,15,0,15,0
1745813487115,EDS 284,A00,895736,Meyerott; Theresa Ann,15,0,15,0
1745813488145,EDS 286,A00,897210,Fine; Sarah,15,0,15,0
1745813489170,EDS 289C,A01,895770,Daly; Alan J.,15,0,15,0
1745813490199,EDS 290,A00,897211,Hofstetter; Carolyn,15,0,15,0
1745813491229,LIGM 5A,A00,896162,Fischer-Grunski; Eva K,15,0,20,5
1745813492254,LIGM 5B,A00,896260,Fischer-Grunski; Eva K,17,0,20,3
1745813493284,LIGM 5C,A00,896308,Fischer-Grunski; Eva K,18,0,20,2
1745813494312,LIIT 5AS,A00,896313,Carnelos; Chiara,18,0,20,2
1745813495340,LIIT 5BS,A00,896416,Carnelos; Chiara,20,0,20,0
1745813496367,LIIT 5CS,A00,896564,Carnelos; Chiara,20,0,20,0
1745813497398,LISP 5A,A00,896588,Munoz Sanchez; Alicia,4,0,20,16
1745813498428,LISP 5B,A00,896653,Munoz Sanchez; Alicia,10,0,20,10
1745813499455,LISP 5C,A00,896655,Munoz Sanchez; Alicia,4,0,20,16
1745813500484,MAE 197,001,957918,Kleissl; Jan,9998,0,9999,1
1745813501513,MATH 2,A01,957937,Staff,34,0,35,1
1745813502540,MATH 197,001,957876,Kedlaya; Kiran S.,9993,0,9999,6
1745813503568,MCWP 40,A00,892729,Duru; Nur,13,0,20,7
1745813503568,MCWP 40,B00,893304,Montejo; Carolina,20,0,20,0
1745813504596,MCWP 40R,A00,893757,Redela; Pamela Morgan,0,7,20,20
1745813505624,MCWP 50,A00,893758,Morshed; Michael James,2,0,20,18
1745813505624,MCWP 50,B00,893761,Bartulis; Jason Michael,17,0,20,3
1745813506650,MCWP 50R,A00,893766,Compas; Sean Matthew,0,1,20,20
1745813506650,MCWP 50R,B00,893769,Carter; Jennifer A,0,0,20,20
1745813506650,MCWP 50R,C00,893771,Krone; Jarret,0,3,20,20
1745813506650,MCWP 50R,D00,893772,Miller; Elizabeth Deen,3,0,20,17
1745813506650,MCWP 50R,E00,893775,Carter; Andrea L,0,0,20,20
1745813507678,MMW 11R,A01,892721,Herbst; Matthew,11,0,27,16
1745813507678,MMW 11R,A02,892722,Herbst; Matthew,0,0,0,3
1745813508706,MMW 12R,A01,892724,Herbst; Matthew,0,9,16,16
1745813508706,MMW 12R,A02,892725,Herbst; Matthew,0,9,16,16
1745813509731,MMW 13R,A01,892727,Staff,0,4,16,16
1745813509731,MMW 13R,A02,892728,Staff,0,4,16,16
1745813509731,MMW 13R,A03,958032,Staff,0,3,16,16
1745813509731,MMW 13R,A04,958033,Staff,0,2,16,16
1745813509731,MMW 13R,A05,958034,Staff,0,3,16,16
1745813510756,SIO 295LS,A00,894015,Staff,7,0,25,18
1745813511783,SIO 295S,A00,894020,Staff,7,0,25,18
1745813512808,SIOC 290S,B01,958918,Staff,0,0,0,0
1745813513839,SIOC 291S,B01,958922,Staff,0,0,0,0
1745813514871,SOCI 117,A01,895339,Staff,4,0,5,1
1745813515898,WES 237B,A00,894149,Staff,11,0,20,9
1745813517967,AESE 279B,A00,891859,Staff,13,0,35,22
1745813518992,AIP 197,001,891854,Staff,70,0,70,0
1745813520026,ANTH 289S,A00,891856,Gagneux; Pascal,12,0,12,0
1745813521053,BENG 196,001,957946,Engler; Adam J.,9996,0,9999,3
1745813522079,CAT 124RS,A01,956906,Staff,8,0,25,17
1745813523107,CAT 125RS,A01,922013,Staff,8,0,25,17
1745813524136,CLRE 250,A00,891860,Morris; Sheldon,9995,0,9999,4
1745813526193,CLRE 251R,A00,907817,Mehta; Ravindra L.,9994,0,9999,5
1745813527222,CLRE 252,A00,891864,Cuomo; Raphael Eduardo,9993,0,9999,6
1745813528250,CLRE 253,A00,891867,Vaida; Florin,9994,0,9999,5
1745813528250,CLRE 253,B00,907819,Staff,9999,0,9999,0
1745813529275,CLRE 259,A00,891868,Patel; Hemal,9998,0,9999,1
1745813530300,CLRE 260,A00,891872,Cuomo; Raphael Eduardo,9999,0,9999,0
1745813531328,CLRE 297,001,891888,Cuomo; Raphael Eduardo,9999,0,9999,0
1745813532354,CSE 191,A00,958773,Minnes Kemp; Mor Mia,9999,0,9999,0
1745813533381,CSS 201S,A01,892054,Mignozzetti; Umberto,30,0,30,0
1745813534407,CSS 202S,A01,892056,Mignozzetti; Umberto,30,0,30,0
1745813535438,DSC 197,001,956898,Eldridge; Justin Matthew,9998,0,9999,1
1745813536465,DSC 297,001,958000,Mazumdar; Arya,9998,0,9999,1
1745813537488,EAP 100,A00,905686,Staff,9776,0,9999,223
1745813538516,ECE 45,A01,892618,Staff,0,12,50,50
1745813539541,ECE 109,A01,892620,Staff,0,44,0,0
1745813540570,ECE 111,A01,892719,Staff,0,8,50,50
1745813541597,ECE 197,001,957920,Mercier; Patrick Philip,9992,0,9999,7
1745813542625,ECON 178,A01,907814,Zhu; Ying,28,0,35,7
1745813543653,EDS 115,A00,895312,Staff,41,0,45,4
1745813544678,EDS 117,A01,895337,Staff,30,0,30,0
1745813545708,EDS 125,A00,895341,Jones; Gabrielle Anastasia,43,0,45,2
1745813546738,EDS 128A,A01,895459,Fargason; Sharon Gayle,44,0,45,1
1745813547768,EDS 128B,A01,895543,Pappas; Elizabeth,44,0,45,1
1745813548792,EDS 139,A00,897203,Pappas; Elizabeth,44,0,45,1
1745813548792,EDS 139,B00,897209,Fargason; Sharon Gayle,44,0,45,1
1745813549820,EDS 201,A00,895545,Staff,43,0,45,2
1745813550849,EDS 203,A01,895581,Halter; Christopher P.,43,0,45,2
1745813551874,EDS 204R,A01,895625,Heinzman; Erica M.,43,0,45,2
1745813551874,EDS 204R,B01,895693,Halter; Christopher P.,18,0,45,27
1745813552903,EDS 206R,A00,895694,Fargason; Sharon Gayle,9,0,30,21
1745813552903,EDS 206R,B00,895695,Choi; Bailey Miyeon,20,0,30,10
1745813553928,EDS 250,A00,895697,Hemans; Patricia Ann Benitez,43,0,45,2
1745813554954,EDS 281,A00,895701,Meyerott; Theresa Ann,15,0,15,0
1745813555980,EDS 284,A00,895736,Meyerott; Theresa Ann,15,0,15,0
1745813557007,EDS 286,A00,897210,Fine; Sarah,15,0,15,0
1745813558035,EDS 289C,A01,895770,Daly; Alan J.,15,0,15,0
1745813559065,EDS 290,A00,897211,Hofstetter; Carolyn,15,0,15,0
1745813560092,LIGM 5A,A00,896162,Fischer-Grunski; Eva K,15,0,20,5
1745813561119,LIGM 5B,A00,896260,Fischer-Grunski; Eva K,17,0,20,3
1745813562145,LIGM 5C,A00,896308,Fischer-Grunski; Eva K,18,0,20,2
1745813563176,LIIT 5AS,A00,896313,Carnelos; Chiara,18,0,20,2
1745813564202,LIIT 5BS,A00,896416,Carnelos; Chiara,20,0,20,0
1745813565237,LIIT 5CS,A00,896564,Carnelos; Chiara,20,0,20,0
1745813566265,LISP 5A,A00,896588,Munoz Sanchez; Alicia,4,0,20,16
1745813567290,LISP 5B,A00,896653,Munoz Sanchez; Alicia,10,0,20,10
1745813568332,LISP 5C,A00,896655,Munoz Sanchez; Alicia,4,0,20,16
1745813569359,MAE 197,001,957918,Kleissl; Jan,9998,0,9999,1
1745813570382,MATH 2,A01,957937,Staff,34,0,35,1
1745813571406,MATH 197,001,957876,Kedlaya; Kiran S.,9993,0,9999,6
1745813572431,MCWP 40,A00,892729,Duru; Nur,13,0,20,7
1745813572431,MCWP 40,B00,893304,Montejo; Carolina,20,0,20,0
1745813573457,MCWP 40R,A00,893757,Redela; Pamela Morgan,0,7,20,20
1745813574486,MCWP 50,A00,893758,Morshed; Michael James,2,0,20,18
1745813574486,MCWP 50,B00,893761,Bartulis; Jason Michael,17,0,20,3
1745813575513,MCWP 50R,A00,893766,Compas; Sean Matthew,0,1,20,20
1745813575513,MCWP 50R,B00,893769,Carter; Jennifer A,0,0,20,20
1745813575513,MCWP 50R,C00,893771,Krone; Jarret,0,3,20,20
1745813575513,MCWP 50R,D00,893772,Miller; Elizabeth Deen,3,0,20,17
1745813575513,MCWP 50R,E00,893775,Carter; Andrea L,0,0,20,20
1745813576541,MMW 11R,A01,892721,Herbst; Matthew,11,0,27,16
1745813576541,MMW 11R,A02,892722,Herbst; Matthew,0,0,0,3
1745813577566,MMW 12R,A01,892724,Herbst; Matthew,0,9,16,16
1745813577566,MMW 12R,A02,892725,Herbst; Matthew,0,9,16,16
1745813578591,MMW 13R,A01,892727,Staff,0,4,16,16
1745813578591,MMW 13R,A02,892728,Staff,0,4,16,16
1745813578591,MMW 13R,A03,958032,Staff,0,3,16,16
1745813578591,MMW 13R,A04,958033,Staff,0,2,16,16
1745813578591,MMW 13R,A05,958034,Staff,0,3,16,16
1745813579618,SIO 295LS,A00,894015,Staff,7,0,25,18
1745813580643,SIO 295S,A00,894020,Staff,7,0,25,18
1745813581670,SIOC 290S,B01,958918,Staff,0,0,0,0
1745813582696,SIOC 291S,B01,958922,Staff,0,0,0,0
1745813583725,SOCI 117,A01,895339,Staff,4,0,5,1
1745813584750,WES 237B,A00,894149,Staff,11,0,20,9
1745813586815,AESE 279B,A00,891859,Staff,13,0,35,22
1745813587840,AIP 197,001,891854,Staff,70,0,70,0
1745813588870,ANTH 289S,A00,891856,Gagneux; Pascal,12,0,12,0
1745813589896,BENG 196,001,957946,Engler; Adam J.,9996,0,9999,3
1745813590921,CAT 124RS,A01,956906,Staff,8,0,25,17
1745813591946,CAT 125RS,A01,922013,Staff,8,0,25,17
1745813592974,CLRE 250,A00,891860,Morris; Sheldon,9995,0,9999,4
1745813595030,CLRE 251R,A00,907817,Mehta; Ravindra L.,9994,0,9999,5
1745813596054,CLRE 252,A00,891864,Cuomo; Raphael Eduardo,9993,0,9999,6
1745813597077,CLRE 253,A00,891867,Vaida; Florin,9994,0,9999,5
1745813597077,CLRE 253,B00,907819,Staff,9999,0,9999,0
1745813598103,CLRE 259,A00,891868,Patel; Hemal,9998,0,9999,1
1745813599128,CLRE 260,A00,891872,Cuomo; Raphael Eduardo,9999,0,9999,0
1745813600178,CLRE 297,001,891888,Cuomo; Raphael Eduardo,9999,0,9999,0
1745813601210,CSE 191,A00,958773,Minnes Kemp; Mor Mia,9999,0,9999,0
1745813602237,CSS 201S,A01,892054,Mignozzetti; Umberto,30,0,30,0
1745813603265,CSS 202S,A01,892056,Mignozzetti; Umberto,30,0,30,0
1745813604293,DSC 197,001,956898,Eldridge; Justin Matthew,9998,0,9999,1
1745813605321,DSC 297,001,958000,Mazumdar; Arya,9998,0,9999,1
1745813606346,EAP 100,A00,905686,Staff,9776,0,9999,223
1745813607372,ECE 45,A01,892618,Staff,0,12,50,50
1745813608397,ECE 109,A01,892620,Staff,0,44,0,0
1745813609426,ECE 111,A01,892719,Staff,0,8,50,50
1745813610451,ECE 197,001,957920,Mercier; Patrick Philip,9992,0,9999,7
1745813611478,ECON 178,A01,907814,Zhu; Ying,28,0,35,7
1745813612503,EDS 115,A00,895312,Staff,41,0,45,4
1745813613528,EDS 117,A01,895337,Staff,30,0,30,0
1745813614553,EDS 125,A00,895341,Jones; Gabrielle Anastasia,43,0,45,2
1745813615578,EDS 128A,A01,895459,Fargason; Sharon Gayle,44,0,45,1
1745813616605,EDS 128B,A01,895543,Pappas; Elizabeth,44,0,45,1
1745813617628,EDS 139,A00,897203,Pappas; Elizabeth,44,0,45,1
1745813617628,EDS 139,B00,897209,Fargason; Sharon Gayle,44,0,45,1
1745813618657,EDS 201,A00,895545,Staff,43,0,45,2
1745813619684,EDS 203,A01,895581,Halter; Christopher P.,43,0,45,2
1745813620709,EDS 204R,A01,895625,Heinzman; Erica M.,43,0,45,2
1745813620709,EDS 204R,B01,895693,Halter; Christopher P.,18,0,45,27
1745813621732,EDS 206R,A00,895694,Fargason; Sharon Gayle,9,0,30,21
1745813621732,EDS 206R,B00,895695,Choi; Bailey Miyeon,20,0,30,10
1745813622757,EDS 250,A00,895697,Hemans; Patricia Ann Benitez,43,0,45,2
1745813623781,EDS 281,A00,895701,Meyerott; Theresa Ann,15,0,15,0
1745813624809,EDS 284,A00,895736,Meyerott; Theresa Ann,15,0,15,0
1745813625834,EDS 286,A00,897210,Fine; Sarah,15,0,15,0
1745813626859,EDS 289C,A01,895770,Daly; Alan J.,15,0,15,0
1745813627888,EDS 290,A00,897211,Hofstetter; Carolyn,15,0,15,0
1745813628915,LIGM 5A,A00,896162,Fischer-Grunski; Eva K,15,0,20,5
1745813629942,LIGM 5B,A00,896260,Fischer-Grunski; Eva K,17,0,20,3
1745813630972,LIGM 5C,A00,896308,Fischer-Grunski; Eva K,18,0,20,2
1745813631998,LIIT 5AS,A00,896313,Carnelos; Chiara,18,0,20,2
1745813633025,LIIT 5BS,A00,896416,Carnelos; Chiara,20,0,20,0
1745813634053,LIIT 5CS,A00,896564,Carnelos; Chiara,20,0,20,0
1745813635080,LISP 5A,A00,896588,Munoz Sanchez; Alicia,4,0,20,16
1745813636108,LISP 5B,A00,896653,Munoz Sanchez; Alicia,10,0,20,10
1745813637138,LISP 5C,A00,896655,Munoz Sanchez; Alicia,4,0,20,16
1745813638165,MAE 197,001,957918,Kleissl; Jan,9998,0,9999,1
1745813639192,MATH 2,A01,957937,Staff,34,0,35,1
1745813640218,MATH 197,001,957876,Kedlaya; Kiran S.,9993,0,9999,6
1745813641247,MCWP 40,A00,892729,Duru; Nur,13,0,20,7
1745813641247,MCWP 40,B00,893304,Montejo; Carolina,20,0,20,0
1745813642275,MCWP 40R,A00,893757,Redela; Pamela Morgan,0,7,20,20
1745813643302,MCWP 50,A00,893758,Morshed; Michael James,2,0,20,18
1745813643302,MCWP 50,B00,893761,Bartulis; Jason Michael,17,0,20,3
1745813644335,MCWP 50R,A00,893766,Compas; Sean Matthew,0,1,20,20
1745813644335,MCWP 50R,B00,893769,Carter; Jennifer A,0,0,20,20
1745813644335,MCWP 50R,C00,893771,Krone; Jarret,0,3,20,20
1745813644335,MCWP 50R,D00,893772,Miller; Elizabeth Deen,3,0,20,17
1745813644335,MCWP 50R,E00,893775,Carter; Andrea L,0,0,20,20
1745813645363,MMW 11R,A01,892721,Herbst; Matthew,11,0,27,16
1745813645363,MMW 11R,A02,892722,Herbst; Matthew,0,0,0,3
1745813646387,MMW 12R,A01,892724,Herbst; Matthew,0,9,16,16
1745813646387,MMW 12R,A02,892725,Herbst; Matthew,0,9,16,16
1745813647417,MMW 13R,A01,892727,Staff,0,4,16,16
1745813647417,MMW 13R,A02,892728,Staff,0,4,16,16
1745813647417,MMW 13R,A03,958032,Staff,0,3,16,16
1745813647417,MMW 13R,A04,958033,Staff,0,2,16,16
1745813647417,MMW 13R,A05,958034,Staff,0,3,16,16
1745813648442,SIO 295LS,A00,894015,Staff,7,0,25,18
1745813649471,SIO 295S,A00,894020,Staff,7,0,25,18
1745813650496,SIOC 290S,B01,958918,Staff,0,0,0,0
1745813651524,SIOC 291S,B01,958922,Staff,0,0,0,0
1745813652552,SOCI 117,A01,895339,Staff,4,0,5,1
1745813653581,WES 237B,A00,894149,Staff,11,0,20,9
1745813655645,AESE 279B,A00,891859,Staff,13,0,35,22
1745813656671,AIP 197,001,891854,Staff,70,0,70,0
1745813657694,ANTH 289S,A00,891856,Gagneux; Pascal,12,0,12,0
1745813658722,BENG 196,001,957946,Engler; Adam J.,9996,0,9999,3
1745813659749,CAT 124RS,A01,956906,Staff,8,0,25,17
1745813660773,CAT 125RS,A01,922013,Staff,8,0,25,17
1745813661800,CLRE 250,A00,891860,Morris; Sheldon,9995,0,9999,4
1745813663854,CLRE 251R,A00,907817,Mehta; Ravindra L.,9994,0,9999,5
1745813664882,CLRE 252,A00,891864,Cuomo; Raphael Eduardo,9993,0,9999,6
1745813665911,CLRE 253,A00,891867,Vaida; Florin,9994,0,9999,5
1745813665911,CLRE 253,B00,907819,Staff,9999,0,9999,0
1745813666954,CLRE 259,A00,891868,Patel; Hemal,9998,0,9999,1
1745813667978,CLRE 260,A00,891872,Cuomo; Raphael Eduardo,9999,0,9999,0
1745813669006,CLRE 297,001,891888,Cuomo; Raphael Eduardo,9999,0,9999,0
1745813670035,CSE 191,A00,958773,Minnes Kemp; Mor Mia,9999,0,9999,0
1745813671061,CSS 201S,A01,892054,Mignozzetti; Umberto,30,0,30,0
1745813672090,CSS 202S,A01,892056,Mignozzetti; Umberto,30,0,30,0
1745813673122,DSC 197,001,956898,Eldridge; Justin Matthew,9998,0,9999,1
1745813674148,DSC 297,001,958000,Mazumdar; Arya,9998,0,9999,1
1745813675175,EAP 100,A00,905686,Staff,9776,0,9999,223
1745813676203,ECE 45,A01,892618,Staff,0,12,50,50
1745813677231,ECE 109,A01,892620,Staff,0,43,0,0
1745813678258,ECE 111,A01,892719,Staff,0,8,50,50
1745813679310,ECE 197,001,957920,Mercier; Patrick Philip,9992,0,9999,7
1745813680338,ECON 178,A01,907814,Zhu; Ying,28,0,35,7
1745813681364,EDS 115,A00,895312,Staff,41,0,45,4
1745813682401,EDS 117,A01,895337,Staff,30,0,30,0
1745813683427,EDS 125,A00,895341,Jones; Gabrielle Anastasia,43,0,45,2
1745813684452,EDS 128A,A01,895459,Fargason; Sharon Gayle,44,0,45,1
1745813685481,EDS 128B,A01,895543,Pappas; Elizabeth,44,0,45,1
1745813686508,EDS 139,A00,897203,Pappas; Elizabeth,44,0,45,1
1745813686508,EDS 139,B00,897209,Fargason; Sharon Gayle,44,0,45,1
1745813687534,EDS 201,A00,895545,Staff,43,0,45,2
1745813688561,EDS 203,A01,895581,Halter; Christopher P.,43,0,45,2
1745813689590,EDS 204R,A01,895625,Heinzman; Erica M.,43,0,45,2
1745813689590,EDS 204R,B01,895693,Halter; Christopher P.,18,0,45,27
1745813690615,EDS 206R,A00,895694,Fargason; Sharon Gayle,9,0,30,21
1745813690615,EDS 206R,B00,895695,Choi; Bailey Miyeon,20,0,30,10
1745813691641,EDS 250,A00,895697,Hemans; Patricia Ann Benitez,43,0,45,2
1745813692667,EDS 281,A00,895701,Meyerott; Theresa Ann,15,0,15,0
1745813693693,EDS 284,A00,895736,Meyerott; Theresa Ann,15,0,15,0
1745813694722,EDS 286,A00,897210,Fine; Sarah,15,0,15,0
1745813695750,EDS 289C,A01,895770,Daly; Alan J.,15,0,15,0
1745813696780,EDS 290,A00,897211,Hofstetter; Carolyn,15,0,15,0
1745813697807,LIGM 5A,A00,896162,Fischer-Grunski; Eva K,15,0,20,5
1745813698836,LIGM 5B,A00,896260,Fischer-Grunski; Eva K,17,0,20,3
1745813699864,LIGM 5C,A00,896308,Fischer-Grunski; Eva K,18,0,20,2
1745813700889,LIIT 5AS,A00,896313,Carnelos; Chiara,18,0,20,2
1745813701916,LIIT 5BS,A00,896416,Carnelos; Chiara,20,0,20,0
1745813702944,LIIT 5CS,A00,896564,Carnelos; Chiara,20,0,20,0
1745813703975,LISP 5A,A00,896588,Munoz Sanchez; Alicia,4,0,20,16
1745813705003,LISP 5B,A00,896653,Munoz Sanchez; Alicia,10,0,20,10
1745813706030,LISP 5C,A00,896655,Munoz Sanchez; Alicia,4,0,20,16
1745813707058,MAE 197,001,957918,Kleissl; Jan,9998,0,9999,1
1745813708086,MATH 2,A01,957937,Staff,34,0,35,1
1745813709112,MATH 197,001,957876,Kedlaya; Kiran S.,9993,0,9999,6
1745813710162,MCWP 40,A00,892729,Duru; Nur,13,0,20,7
1745813710162,MCWP 40,B00,893304,Montejo; Carolina,20,0,20,0
1745813711191,MCWP 40R,A00,893757,Redela; Pamela Morgan,0,7,20,20
1745813712217,MCWP 50,A00,893758,Morshed; Michael James,2,0,20,18
1745813712217,MCWP 50,B00,893761,Bartulis; Jason Michael,17,0,20,3
1745813713251,MCWP 50R,A00,893766,Compas; Sean Matthew,0,1,20,20
1745813713251,MCWP 50R,B00,893769,Carter; Jennifer A,0,0,20,20
1745813713251,MCWP 50R,C00,893771,Krone; Jarret,0,3,20,20
1745813713251,MCWP 50R,D00,893772,Miller; Elizabeth Deen,3,0,20,17
1745813713251,MCWP 50R,E00,893775,Carter; Andrea L,0,0,20,20
1745813714278,MMW 11R,A01,892721,Herbst; Matthew,11,0,27,16
1745813714278,MMW 11R,A02,892722,Herbst; Matthew,0,0,0,3
1745813715310,MMW 12R,A01,892724,Herbst; Matthew,0,9,16,16
1745813715310,MMW 12R,A02,892725,Herbst; Matthew,0,9,16,16
1745813716343,MMW 13R,A01,892727,Staff,0,4,16,16
1745813716343,MMW 13R,A02,892728,Staff,0,4,16,16
1745813716343,MMW 13R,A03,958032,Staff,0,3,16,16
1745813716343,MMW 13R,A04,958033,Staff,0,2,16,16
1745813716343,MMW 13R,A05,958034,Staff,0,3,16,16
1745813717373,SIO 295LS,A00,894015,Staff,7,0,25,18
1745813718401,SIO 295S,A00,894020,Staff,7,0,25,18
1745813719428,SIOC 290S,B01,958918,Staff,0,0,0,0
1745813720457,SIOC 291S,B01,958922,Staff,0,0,0,0
1745813721484,SOCI 117,A01,895339,Staff,4,0,5,1
1745813722512,WES 237B,A00,894149,Staff,11,0,20,9
1745813724580,AESE 279B,A00,891859,Staff,13,0,35,22
1745813725603,AIP 197,001,891854,Staff,70,0,70,0
1745813726627,ANTH 289S,A00,891856,Gagneux; Pascal,12,0,12,0
1745813727657,BENG 196,001,957946,Engler; Adam J.,9996,0,9999,3
1745813728681,CAT 124RS,A01,956906,Staff,8,0,25,17
1745813729708,CAT 125RS,A01,922013,Staff,8,0,25,17
1745813730735,CLRE 250,A00,891860,Morris; Sheldon,9995,0,9999,4
1745813732792,CLRE 251R,A00,907817,Mehta; Ravindra L.,9994,0,9999,5
1745813733822,CLRE 252,A00,891864,Cuomo; Raphael Eduardo,9993,0,9999,6
1745813734848,CLRE 253,A00,891867,Vaida; Florin,9994,0,9999,5
1745813734848,CLRE 253,B00,907819,Staff,9999,0,9999,0
1745813735877,CLRE 259,A00,891868,Patel; Hemal,9998,0,9999,1
1745813736902,CLRE 260,A00,891872,Cuomo; Raphael Eduardo,9999,0,9999,0
1745813737928,CLRE 297,001,891888,Cuomo; Raphael Eduardo,9999,0,9999,0
1745813738957,CSE 191,A00,958773,Minnes Kemp; Mor Mia,9999,0,9999,0
1745813739987,CSS 201S,A01,892054,Mignozzetti; Umberto,30,0,30,0
1745813741016,CSS 202S,A01,892056,Mignozzetti; Umberto,30,0,30,0
1745813742042,DSC 197,001,956898,Eldridge; Justin Matthew,9998,0,9999,1
1745813743068,DSC 297,001,958000,Mazumdar; Arya,9998,0,9999,1
1745813744094,EAP 100,A00,905686,Staff,9776,0,9999,223
1745813745120,ECE 45,A01,892618,Staff,0,12,50,50
1745813746146,ECE 109,A01,892620,Staff,0,43,0,0
1745813747176,ECE 111,A01,892719,Staff,0,8,50,50
1745813748201,ECE 197,001,957920,Mercier; Patrick Philip,9992,0,9999,7
1745813749228,ECON 178,A01,907814,Zhu; Ying,28,0,35,7
1745813750255,EDS 115,A00,895312,Staff,41,0,45,4
1745813751283,EDS 117,A01,895337,Staff,30,0,30,0
1745813752312,EDS 125,A00,895341,Jones; Gabrielle Anastasia,43,0,45,2
1745813753341,EDS 128A,A01,895459,Fargason; Sharon Gayle,44,0,45,1
1745813754365,EDS 128B,A01,895543,Pappas; Elizabeth,44,0,45,1
1745813755394,EDS 139,A00,897203,Pappas; Elizabeth,44,0,45,1
1745813755394,EDS 139,B00,897209,Fargason; Sharon Gayle,44,0,45,1
1745813756421,EDS 201,A00,895545,Staff,43,0,45,2
1745813757447,EDS 203,A01,895581,Halter; Christopher P.,43,0,45,2
1745813758476,EDS 204R,A01,895625,Heinzman; Erica M.,43,0,45,2
1745813758476,EDS 204R,B01,895693,Halter; Christopher P.,18,0,45,27
1745813759507,EDS 206R,A00,895694,Fargason; Sharon Gayle,9,0,30,21
1745813759507,EDS 206R,B00,895695,Choi; Bailey Miyeon,20,0,30,10
1745813760532,EDS 250,A00,895697,Hemans; Patricia Ann Benitez,43,0,45,2
1745813761560,EDS 281,A00,895701,Meyerott; Theresa Ann,15,0,15,0
1745813762588,EDS 284,A00,895736,Meyerott; Theresa Ann,15,0,15,0
1745813763619,EDS 286,A00,897210,Fine; Sarah,15,0,15,0
1745813764649,EDS 289C,A01,895770,Daly; Alan J.,15,0,15,0
1745813765677,EDS 290,A00,897211,Hofstetter; Carolyn,15,0,15,0
1745813766702,LIGM 5A,A00,896162,Fischer-Grunski; Eva K,15,0,20,5
1745813767753,LIGM 5B,A00,896260,Fischer-Grunski; Eva K,17,0,20,3
1745813768778,LIGM 5C,A00,896308,Fischer-Grunski; Eva K,18,0,20,2
1745813769804,LIIT 5AS,A00,896313,Carnelos; Chiara,18,0,20,2
1745813770830,LIIT 5BS,A00,896416,Carnelos; Chiara,20,0,20,0
1745813771857,LIIT 5CS,A00,896564,Carnelos; Chiara,20,0,20,0
1745813772883,LISP 5A,A00,896588,Munoz Sanchez; Alicia,4,0,20,16
1745813773908,LISP 5B,A00,896653,Munoz Sanchez; Alicia,10,0,20,10
1745813774934,LISP 5C,A00,896655,Munoz Sanchez; Alicia,4,0,20,16
1745813775962,MAE 197,001,957918,Kleissl; Jan,9998,0,9999,1
1745813776988,MATH 2,A01,957937,Staff,34,0,35,1
1745813778015,MATH 197,001,957876,Kedlaya; Kiran S.,9993,0,9999,6
1745813779042,MCWP 40,A00,892729,Duru; Nur,13,0,20,7
1745813779042,MCWP 40,B00,893304,Montejo; Carolina,20,0,20,0
1745813780071,MCWP 40R,A00,893757,Redela; Pamela Morgan,0,7,20,20
1745813781097,MCWP 50,A00,893758,Morshed; Michael James,2,0,20,18
1745813781097,MCWP 50,B00,893761,Bartulis; Jason Michael,17,0,20,3
1745813782125,MCWP 50R,A00,893766,Compas; Sean Matthew,0,1,20,20
1745813782125,MCWP 50R,B00,893769,Carter; Jennifer A,0,0,20,20
1745813782125,MCWP 50R,C00,893771,Krone; Jarret,0,3,20,20
1745813782125,MCWP 50R,D00,893772,Miller; Elizabeth Deen,3,0,20,17
1745813782125,MCWP 50R,E00,893775,Carter; Andrea L,0,0,20,20
1745813783152,MMW 11R,A01,892721,Herbst; Matthew,11,0,27,16
1745813783152,MMW 11R,A02,892722,Herbst; Matthew,0,0,0,3
1745813784181,MMW 12R,A01,892724,Herbst; Matthew,0,9,16,16
1745813784181,MMW 12R,A02,892725,Herbst; Matthew,0,9,16,16
1745813785209,MMW 13R,A01,892727,Staff,0,4,16,16
1745813785209,MMW 13R,A02,892728,Staff,0,4,16,16
1745813785209,MMW 13R,A03,958032,Staff,0,3,16,16
1745813785209,MMW 13R,A04,958033,Staff,0,2,16,16
1745813785209,MMW 13R,A05,958034,Staff,0,3,16,16
1745813786236,SIO 295LS,A00,894015,Staff,7,0,25,18
1745813787266,SIO 295S,A00,894020,Staff,7,0,25,18
1745813788293,SIOC 290S,B01,958918,Staff,0,0,0,0
1745813789318,SIOC 291S,B01,958922,Staff,0,0,0,0
1745813790349,SOCI 117,A01,895339,Staff,4,0,5,1
1745813791375,WES 237B,A00,894149,Staff,11,0,20,9
1745813793442,AESE 279B,A00,891859,Staff,13,0,35,22
1745813794466,AIP 197,001,891854,Staff,70,0,70,0
1745813795492,ANTH 289S,A00,891856,Gagneux; Pascal,12,0,12,0
1745813796517,BENG 196,001,957946,Engler; Adam J.,9996,0,9999,3
1745813797544,CAT 124RS,A01,956906,Staff,8,0,25,17
1745813798569,CAT 125RS,A01,922013,Staff,8,0,25,17
1745813799596,CLRE 250,A00,891860,Morris; Sheldon,9995,0,9999,4
1745813801649,CLRE 251R,A00,907817,Mehta; Ravindra L.,9994,0,9999,5
1745813802681,CLRE 252,A00,891864,Cuomo; Raphael Eduardo,9993,0,9999,6
1745813803707,CLRE 253,A00,891867,Vaida; Florin,9994,0,9999,5
1745813803707,CLRE 253,B00,907819,Staff,9999,0,9999,0
1745813804739,CLRE 259,A00,891868,Patel; Hemal,9998,0,9999,1
1745813805765,CLRE 260,A00,891872,Cuomo; Raphael Eduardo,9999,0,9999,0
1745813806790,CLRE 297,001,891888,Cuomo; Raphael Eduardo,9999,0,9999,0
1745813807820,CSE 191,A00,958773,Minnes Kemp; Mor Mia,9999,0,9999,0
1745813808851,CSS 201S,A01,892054,Mignozzetti; Umberto,30,0,30,0
1745813809882,CSS 202S,A01,892056,Mignozzetti; Umberto,30,0,30,0
1745813810907,DSC 197,001,956898,Eldridge; Justin Matthew,9998,0,9999,1
1745813811934,DSC 297,001,958000,Mazumdar; Arya,9998,0,9999,1
1745813812966,EAP 100,A00,905686,Staff,9776,0,9999,223
1745813813994,ECE 45,A01,892618,Staff,0,12,50,50
1745813815025,ECE 109,A01,892620,Staff,0,43,0,0
1745813816052,ECE 111,A01,892719,Staff,0,8,50,50
1745813817081,ECE 197,001,957920,Mercier; Patrick Philip,9992,0,9999,7
1745813818107,ECON 178,A01,907814,Zhu; Ying,28,0,35,7
1745813819134,EDS 115,A00,895312,Staff,41,0,45,4
1745813820159,EDS 117,A01,895337,Staff,30,0,30,0
1745813821184,EDS 125,A00,895341,Jones; Gabrielle Anastasia,43,0,45,2
1745813822212,EDS 128A,A01,895459,Fargason; Sharon Gayle,44,0,45,1
1745813823243,EDS 128B,A01,895543,Pappas; Elizabeth,44,0,45,1
1745813824269,EDS 139,A00,897203,Pappas; Elizabeth,44,0,45,1
1745813824269,EDS 139,B00,897209,Fargason; Sharon Gayle,44,0,45,1
1745813825298,EDS 201,A00,895545,Staff,43,0,45,2
1745813826327,EDS 203,A01,895581,Halter; Christopher P.,43,0,45,2
1745813827356,EDS 204R,A01,895625,Heinzman; Erica M.,43,0,45,2
1745813827356,EDS 204R,B01,895693,Halter; Christopher P.,18,0,45,27
1745813828386,EDS 206R,A00,895694,Fargason; Sharon Gayle,9,0,30,21
1745813828386,EDS 206R,B00,895695,Choi; Bailey Miyeon,20,0,30,10
1745813829416,EDS 250,A00,895697,Hemans; Patricia Ann Benitez,43,0,45,2
1745813830447,EDS 281,A00,895701,Meyerott; Theresa Ann,15,0,15,0
1745813831477,EDS 284,A00,895736,Meyerott; Theresa Ann,15,0,15,0
1745813832505,EDS 286,A00,897210,Fine; Sarah,15,0,15,0
1745813833531,EDS 289C,A01,895770,Daly; Alan J.,15,0,15,0
1745813834556,EDS 290,A00,897211,Hofstetter; Carolyn,15,0,15,0
1745813835583,LIGM 5A,A00,896162,Fischer-Grunski; Eva K,15,0,20,5
1745813836609,LIGM 5B,A00,896260,Fischer-Grunski; Eva K,17,0,20,3
1745813837640,LIGM 5C,A00,896308,Fischer-Grunski; Eva K,18,0,20,2
1745813838672,LIIT 5AS,A00,896313,Carnelos; Chiara,18,0,20,2
1745813839697,LIIT 5BS,A00,896416,Carnelos; Chiara,20,0,20,0
1745813840730,LIIT 5CS,A00,896564,Carnelos; Chiara,20,0,20,0
1745813841759,LISP 5A,A00,896588,Munoz Sanchez; Alicia,4,0,20,16
1745813842787,LISP 5B,A00,896653,Munoz Sanchez; Alicia,10,0,20,10
1745813843814,LISP 5C,A00,896655,Munoz Sanchez; Alicia,4,0,20,16
1745813844841,MAE 197,001,957918,Kleissl; Jan,9998,0,9999,1
1745813845869,MATH 2,A01,957937,Staff,34,0,35,1
1745813846893,MATH 197,001,957876,Kedlaya; Kiran S.,9993,0,9999,6
1745813847924,MCWP 40,A00,892729,Duru; Nur,13,0,20,7
1745813847924,MCWP 40,B00,893304,Montejo; Carolina,20,0,20,0
1745813848952,MCWP 40R,A00,893757,Redela; Pamela Morgan,0,7,20,20
1745813849978,MCWP 50,A00,893758,Morshed; Michael James,2,0,20,18
1745813849978,MCWP 50,B00,893761,Bartulis; Jason Michael,17,0,20,3
1745813851006,MCWP 50R,A00,893766,Compas; Sean Matthew,0,1,20,20
1745813851006,MCWP 50R,B00,893769,Carter; Jennifer A,0,0,20,20
1745813851006,MCWP 50R,C00,893771,Krone; Jarret,0,3,20,20
1745813851006,MCWP 50R,D00,893772,Miller; Elizabeth Deen,3,0,20,17
1745813851006,MCWP 50R,E00,893775,Carter; Andrea L,0,0,20,20
1745813852033,MMW 11R,A01,892721,Herbst; Matthew,11,0,27,16
1745813852033,MMW 11R,A02,892722,Herbst; Matthew,0,0,0,3
1745813853062,MMW 12R,A01,892724,Herbst; Matthew,0,9,16,16
1745813853062,MMW 12R,A02,892725,Herbst; Matthew,0,9,16,16
1745813854090,MMW 13R,A01,892727,Staff,0,3,16,16
1745813854090,MMW 13R,A02,892728,Staff,0,4,16,16
1745813854090,MMW 13R,A03,958032,Staff,0,3,16,16
1745813854090,MMW 13R,A04,958033,Staff,0,2,16,16
1745813854090,MMW 13R,A05,958034,Staff,0,3,16,16
1745813855121,SIO 295LS,A00,894015,Staff,7,0,25,18
1745813856151,SIO 295S,A00,894020,Staff,7,0,25,18
1745813857174,SIOC 290S,B01,958918,Staff,0,0,0,0
1745813858204,SIOC 291S,B01,958922,Staff,0,0,0,0
1745813859230,SOCI 117,A01,895339,Staff,4,0,5,1
1745813860282,WES 237B,A00,894149,Staff,11,0,20,9
1745813862339,AESE 279B,A00,891859,Staff,13,0,35,22
1745813863362,AIP 197,001,891854,Staff,70,0,70,0
1745813864392,ANTH 289S,A00,891856,Gagneux; Pascal,12,0,12,0
1745813865420,BENG 196,001,957946,Engler; Adam J.,9996,0,9999,3
1745813866444,CAT 124RS,A01,956906,Staff,8,0,25,17
1745813867472,CAT 125RS,A01,922013,Staff,8,0,25,17
1745813868500,CLRE 250,A00,891860,Morris; Sheldon,9995,0,9999,4
1745813870552,CLRE 251R,A00,907817,Mehta; Ravindra L.,9994,0,9999,5
1745813871578,CLRE 252,A00,891864,Cuomo; Raphael Eduardo,9993,0,9999,6
1745813872603,CLRE 253,A00,891867,Vaida; Florin,9994,0,9999,5
1745813872603,CLRE 253,B00,907819,Staff,9999,0,9999,0
1745813873628,CLRE 259,A00,891868,Patel; Hemal,9998,0,9999,1
1745813874658,CLRE 260,A00,891872,Cuomo; Raphael Eduardo,9999,0,9999,0
1745813875686,CLRE 297,001,891888,Cuomo; Raphael Eduardo,9999,0,9999,0
1745813876711,CSE 191,A00,958773,Minnes Kemp; Mor Mia,9999,0,9999,0
1745813877740,CSS 201S,A01,892054,Mignozzetti; Umberto,30,0,30,0
1745813878766,CSS 202S,A01,892056,Mignozzetti; Umberto,30,0,30,0
1745813879792,DSC 197,001,956898,Eldridge; Justin Matthew,9998,0,9999,1
1745813880819,DSC 297,001,958000,Mazumdar; Arya,9998,0,9999,1
1745813881847,EAP 100,A00,905686,Staff,9776,0,9999,223
1745813882874,ECE 45,A01,892618,Staff,0,12,50,50
1745813883902,ECE 109,A01,892620,Staff,0,43,0,0
1745813884931,ECE 111,A01,892719,Staff,0,8,50,50
1745813885960,ECE 197,001,957920,Mercier; Patrick Philip,9992,0,9999,7
1745813886986,ECON 178,A01,907814,Zhu; Ying,28,0,35,7
1745813888013,EDS 115,A00,895312,Staff,41,0,45,4
1745813889040,EDS 117,A01,895337,Staff,30,0,30,0
1745813890067,EDS 125,A00,895341,Jones; Gabrielle Anastasia,43,0,45,2
1745813891095,EDS 128A,A01,895459,Fargason; Sharon Gayle,44,0,45,1
1745813892125,EDS 128B,A01,895543,Pappas; Elizabeth,44,0,45,1
1745813893153,EDS 139,A00,897203,Pappas; Elizabeth,44,0,45,1
1745813893153,EDS 139,B00,897209,Fargason; Sharon Gayle,44,0,45,1
1745813894180,EDS 201,A00,895545,Staff,43,0,45,2
1745813895209,EDS 203,A01,895581,Halter; Christopher P.,43,0,45,2
1745813896237,EDS 204R,A01,895625,Heinzman; Erica M.,43,0,45,2
1745813896237,EDS 204R,B01,895693,Halter; Christopher P.,18,0,45,27
1745813897266,EDS 206R,A00,895694,Fargason; Sharon Gayle,9,0,30,21
1745813897266,EDS 206R,B00,895695,Choi; Bailey Miyeon,20,0,30,10
1745813898291,EDS 250,A00,895697,Hemans; Patricia Ann Benitez,43,0,45,2
1745813899318,EDS 281,A00,895701,Meyerott; Theresa Ann,15,0,15,0
1745813900345,EDS 284,A00,895736,Meyerott; Theresa Ann,15,0,15,0
1745813901375,EDS 286,A00,897210,Fine; Sarah,15,0,15,0
1745813902406,EDS 289C,A01,895770,Daly; Alan J.,15,0,15,0
1745813903435,EDS 290,A00,897211,Hofstetter; Carolyn,15,0,15,0
1745813904465,LIGM 5A,A00,896162,Fischer-Grunski; Eva K,15,0,20,5
1745813905490,LIGM 5B,A00,896260,Fischer-Grunski; Eva K,17,0,20,3
1745813906520,LIGM 5C,A00,896308,Fischer-Grunski; Eva K,18,0,20,2
1745813907548,LIIT 5AS,A00,896313,Carnelos; Chiara,18,0,20,2
1745813908574,LIIT 5BS,A00,896416,Carnelos; Chiara,20,0,20,0
1745813909601,LIIT 5CS,A00,896564,Carnelos; Chiara,20,0,20,0
1745813910631,LISP 5A,A00,896588,Munoz Sanchez; Alicia,4,0,20,16
1745813911657,LISP 5B,A00,896653,Munoz Sanchez; Alicia,10,0,20,10
1745813912685,LISP 5C,A00,896655,Munoz Sanchez; Alicia,4,0,20,16
1745813913713,MAE 197,001,957918,Kleissl; Jan,9998,0,9999,1
1745813914740,MATH 2,A01,957937,Staff,34,0,35,1
1745813915768,MATH 197,001,957876,Kedlaya; Kiran S.,9993,0,9999,6
1745813916797,MCWP 40,A00,892729,Duru; Nur,13,0,20,7
1745813916797,MCWP 40,B00,893304,Montejo; Carolina,20,0,20,0
1745813917824,MCWP 40R,A00,893757,Redela; Pamela Morgan,0,7,20,20
1745813918850,MCWP 50,A00,893758,Morshed; Michael James,2,0,20,18
1745813918850,MCWP 50,B00,893761,Bartulis; Jason Michael,17,0,20,3
1745813919878,MCWP 50R,A00,893766,Compas; Sean Matthew,0,1,20,20
1745813919878,MCWP 50R,B00,893769,Carter; Jennifer A,0,0,20,20
1745813919878,MCWP 50R,C00,893771,Krone; Jarret,0,3,20,20
1745813919878,MCWP 50R,D00,893772,Miller; Elizabeth Deen,3,0,20,17
1745813919878,MCWP 50R,E00,893775,Carter; Andrea L,0,0,20,20
1745813920906,MMW 11R,A01,892721,Herbst; Matthew,11,0,27,16
1745813920906,MMW 11R,A02,892722,Herbst; Matthew,0,0,0,3
1745813921939,MMW 12R,A01,892724,Herbst; Matthew,0,9,16,16
1745813921939,MMW 12R,A02,892725,Herbst; Matthew,0,9,16,16
1745813922967,MMW 13R,A01,892727,Staff,0,3,16,16
1745813922967,MMW 13R,A02,892728,Staff,0,4,16,16
1745813922967,MMW 13R,A03,958032,Staff,0,3,16,16
1745813922967,MMW 13R,A04,958033,Staff,0,2,16,16
1745813922967,MMW 13R,A05,958034,Staff,0,3,16,16
1745813923996,SIO 295LS,A00,894015,Staff,7,0,25,18
1745813925022,SIO 295S,A00,894020,Staff,7,0,25,18
1745813926050,SIOC 290S,B01,958918,Staff,0,0,0,0
1745813927080,SIOC 291S,B01,958922,Staff,0,0,0,0
1745813928106,SOCI 117,A01,895339,Staff,4,0,5,1
1745813929132,WES 237B,A00,894149,Staff,11,0,20,9
1745813931193,AESE 279B,A00,891859,Staff,13,0,35,22
1745813932219,AIP 197,001,891854,Staff,70,0,70,0
1745813933244,ANTH 289S,A00,891856,Gagneux; Pascal,12,0,12,0
1745813934272,BENG 196,001,957946,Engler; Adam J.,9996,0,9999,3
1745813935300,CAT 124RS,A01,956906,Staff,8,0,25,17
1745813936329,CAT 125RS,A01,922013,Staff,8,0,25,17
1745813937358,CLRE 250,A00,891860,Morris; Sheldon,9995,0,9999,4
1745813939409,CLRE 251R,A00,907817,Mehta; Ravindra L.,9994,0,9999,5
1745813940439,CLRE 252,A00,891864,Cuomo; Raphael Eduardo,9993,0,9999,6
1745813941465,CLRE 253,A00,891867,Vaida; Florin,9994,0,9999,5
1745813941465,CLRE 253,B00,907819,Staff,9999,0,9999,0
1745813942494,CLRE 259,A00,891868,Patel; Hemal,9998,0,9999,1
1745813943521,CLRE 260,A00,891872,Cuomo; Raphael Eduardo,9999,0,9999,0
1745813944548,CLRE 297,001,891888,Cuomo; Raphael Eduardo,9999,0,9999,0
1745813945575,CSE 191,A00,958773,Minnes Kemp; Mor Mia,9999,0,9999,0
1745813946606,CSS 201S,A01,892054,Mignozzetti; Umberto,30,0,30,0
1745813947631,CSS 202S,A01,892056,Mignozzetti; Umberto,30,0,30,0
1745813948659,DSC 197,001,956898,Eldridge; Justin Matthew,9998,0,9999,1
1745813949685,DSC 297,001,958000,Mazumdar; Arya,9998,0,9999,1
1745813950718,EAP 100,A00,905686,Staff,9776,0,9999,223
1745813951747,ECE 45,A01,892618,Staff,0,12,50,50
1745813952777,ECE 109,A01,892620,Staff,0,43,0,0
1745813953806,ECE 111,A01,892719,Staff,0,8,50,50
1745813954832,ECE 197,001,957920,Mercier; Patrick Philip,9992,0,9999,7
1745813955858,ECON 178,A01,907814,Zhu; Ying,28,0,35,7
1745813956882,EDS 115,A00,895312,Staff,41,0,45,4
1745813957910,EDS 117,A01,895337,Staff,30,0,30,0
1745813958938,EDS 125,A00,895341,Jones; Gabrielle Anastasia,43,0,45,2
1745813959965,EDS 128A,A01,895459,Fargason; Sharon Gayle,44,0,45,1
1745813960996,EDS 128B,A01,895543,Pappas; Elizabeth,44,0,45,1
1745813962024,EDS 139,A00,897203,Pappas; Elizabeth,44,0,45,1
1745813962024,EDS 139,B00,897209,Fargason; Sharon Gayle,44,0,45,1
1745813963049,EDS 201,A00,895545,Staff,43,0,45,2
1745813964077,EDS 203,A01,895581,Halter; Christopher P.,43,0,45,2
1745813965106,EDS 204R,A01,895625,Heinzman; Erica M.,43,0,45,2
1745813965106,EDS 204R,B01,895693,Halter; Christopher P.,18,0,45,27
1745813966132,EDS 206R,A00,895694,Fargason; Sharon Gayle,9,0,30,21
1745813966132,EDS 206R,B00,895695,Choi; Bailey Miyeon,20,0,30,10
1745813967158,EDS 250,A00,895697,Hemans; Patricia Ann Benitez,43,0,45,2
1745813968184,EDS 281,A00,895701,Meyerott; Theresa Ann,15,0,15,0
1745813969209,EDS 284,A00,895736,Meyerott; Theresa Ann,15,0,15,0
1745813970237,EDS 286,A00,897210,Fine; Sarah,15,0,15,0
1745813971266,EDS 289C,A01,895770,Daly; Alan J.,15,0,15,0
1745813972292,EDS 290,A00,897211,Hofstetter; Carolyn,15,0,15,0
1745813973321,LIGM 5A,A00,896162,Fischer-Grunski; Eva K,15,0,20,5
1745813974350,LIGM 5B,A00,896260,Fischer-Grunski; Eva K,17,0,20,3
1745813975380,LIGM 5C,A00,896308,Fischer-Grunski; Eva K,18,0,20,2
1745813976409,LIIT 5AS,A00,896313,Carnelos; Chiara,18,0,20,2
1745813977437,LIIT 5BS,A00,896416,Carnelos; Chiara,20,0,20,0
1745813978467,LIIT 5CS,A00,896564,Carnelos; Chiara,20,0,20,0
1745813979493,LISP 5A,A00,896588,Munoz Sanchez; Alicia,4,0,20,16
1745813980525,LISP 5B,A00,896653,Munoz Sanchez; Alicia,10,0,20,10
1745813981550,LISP 5C,A00,896655,Munoz Sanchez; Alicia,4,0,20,16
1745813982578,MAE 197,001,957918,Kleissl; Jan,9998,0,9999,1
1745813983602,MATH 2,A01,957937,Staff,34,0,35,1
1745813984631,MATH 197,001,957876,Kedlaya; Kiran S.,9993,0,9999,6
1745813985659,MCWP 40,A00,892729,Duru; Nur,13,0,20,7
1745813985659,MCWP 40,B00,893304,Montejo; Carolina,20,0,20,0
1745813986688,MCWP 40R,A00,893757,Redela; Pamela Morgan,0,7,20,20
1745813987716,MCWP 50,A00,893758,Morshed; Michael James,2,0,20,18
1745813987716,MCWP 50,B00,893761,Bartulis; Jason Michael,17,0,20,3
1745813988746,MCWP 50R,A00,893766,Compas; Sean Matthew,0,1,20,20
1745813988746,MCWP 50R,B00,893769,Carter; Jennifer A,0,0,20,20
1745813988746,MCWP 50R,C00,893771,Krone; Jarret,0,3,20,20
1745813988746,MCWP 50R,D00,893772,Miller; Elizabeth Deen,3,0,20,17
1745813988746,MCWP 50R,E00,893775,Carter; Andrea L,0,0,20,20
1745813989772,MMW 11R,A01,892721,Herbst; Matthew,11,0,27,16
1745813989772,MMW 11R,A02,892722,Herbst; Matthew,0,0,0,3
1745813990802,MMW 12R,A01,892724,Herbst; Matthew,0,9,16,16
1745813990802,MMW 12R,A02,892725,Herbst; Matthew,0,9,16,16
1745813991828,MMW 13R,A01,892727,Staff,0,3,16,16
1745813991828,MMW 13R,A02,892728,Staff,0,4,16,16
1745813991828,MMW 13R,A03,958032,Staff,0,3,16,16
1745813991828,MMW 13R,A04,958033,Staff,0,2,16,16
1745813991828,MMW 13R,A05,958034,Staff,0,3,16,16
1745813992854,SIO 295LS,A00,894015,Staff,7,0,25,18
1745813993884,SIO 295S,A00,894020,Staff,7,0,25,18
1745813994913,SIOC 290S,B01,958918,Staff,0,0,0,0
1745813995940,SIOC 291S,B01,958922,Staff,0,0,0,0
1745813996967,SOCI 117,A01,895339,Staff,4,0,5,1
1745813997991,WES 237B,A00,894149,Staff,11,0,20,9
1745814000047,AESE 279B,A00,891859,Staff,13,0,35,22
1745814001074,AIP 197,001,891854,Staff,70,0,70,0
1745814002106,ANTH 289S,A00,891856,Gagneux; Pascal,12,0,12,0
1745814003134,BENG 196,001,957946,Engler; Adam J.,9996,0,9999,3
1745814004165,CAT 124RS,A01,956906,Staff,8,0,25,17
1745814005196,CAT 125RS,A01,922013,Staff,8,0,25,17
1745814006223,CLRE 250,A00,891860,Morris; Sheldon,9995,0,9999,4
1745814008280,CLRE 251R,A00,907817,Mehta; Ravindra L.,9994,0,9999,5
1745814009308,CLRE 252,A00,891864,Cuomo; Raphael Eduardo,9993,0,9999,6
1745814010334,CLRE 253,A00,891867,Vaida; Florin,9994,0,9999,5
1745814010334,CLRE 253,B00,907819,Staff,9999,0,9999,0
1745814011361,CLRE 259,A00,891868,Patel; Hemal,9998,0,9999,1
1745814012403,CLRE 260,A00,891872,Cuomo; Raphael Eduardo,9999,0,9999,0
1745814013426,CLRE 297,001,891888,Cuomo; Raphael Eduardo,9999,0,9999,0
1745814014452,CSE 191,A00,958773,Minnes Kemp; Mor Mia,9999,0,9999,0
1745814015481,CSS 201S,A01,892054,Mignozzetti; Umberto,30,0,30,0
1745814016508,CSS 202S,A01,892056,Mignozzetti; Umberto,30,0,30,0
1745814017540,DSC 197,001,956898,Eldridge; Justin Matthew,9998,0,9999,1
1745814018568,DSC 297,001,958000,Mazumdar; Arya,9998,0,9999,1
1745814019592,EAP 100,A00,905686,Staff,9776,0,9999,223
1745814020618,ECE 45,A01,892618,Staff,0,12,50,50
1745814021645,ECE 109,A01,892620,Staff,0,43,0,0
1745814022674,ECE 111,A01,892719,Staff,0,8,50,50
1745814023700,ECE 197,001,957920,Mercier; Patrick Philip,9992,0,9999,7
1745814024728,ECON 178,A01,907814,Zhu; Ying,28,0,35,7
1745814025754,EDS 115,A00,895312,Staff,41,0,45,4
1745814026783,EDS 117,A01,895337,Staff,30,0,30,0
1745814027809,EDS 125,A00,895341,Jones; Gabrielle Anastasia,43,0,45,2
1745814028837,EDS 128A,A01,895459,Fargason; Sharon Gayle,44,0,45,1
1745814029865,EDS 128B,A01,895543,Pappas; Elizabeth,44,0,45,1
1745814030892,EDS 139,A00,897203,Pappas; Elizabeth,44,0,45,1
1745814030892,EDS 139,B00,897209,Fargason; Sharon Gayle,44,0,45,1
1745814031918,EDS 201,A00,895545,Staff,43,0,45,2
1745814032944,EDS 203,A01,895581,Halter; Christopher P.,43,0,45,2
1745814033972,EDS 204R,A01,895625,Heinzman; Erica M.,43,0,45,2
1745814033972,EDS 204R,B01,895693,Halter; Christopher P.,18,0,45,27
1745814034999,EDS 206R,A00,895694,Fargason; Sharon Gayle,9,0,30,21
1745814034999,EDS 206R,B00,895695,Choi; Bailey Miyeon,20,0,30,10
1745814036028,EDS 250,A00,895697,Hemans; Patricia Ann Benitez,43,0,45,2
1745814037055,EDS 281,A00,895701,Meyerott; Theresa Ann,15,0,15,0
1745814038084,EDS 284,A00,895736,Meyerott; Theresa Ann,15,0,15,0
1745814039111,EDS 286,A00,897210,Fine; Sarah,15,0,15,0
1745814040138,EDS 289C,A01,895770,Daly; Alan J.,15,0,15,0
1745814041163,EDS 290,A00,897211,Hofstetter; Carolyn,15,0,15,0
1745814042191,LIGM 5A,A00,896162,Fischer-Grunski; Eva K,15,0,20,5
1745814043220,LIGM 5B,A00,896260,Fischer-Grunski; Eva K,17,0,20,3
1745814044248,LIGM 5C,A00,896308,Fischer-Grunski; Eva K,18,0,20,2
1745814045274,LIIT 5AS,A00,896313,Carnelos; Chiara,18,0,20,2
1745814046302,LIIT 5BS,A00,896416,Carnelos; Chiara,20,0,20,0
1745814047331,LIIT 5CS,A00,896564,Carnelos; Chiara,20,0,20,0
1745814048357,LISP 5A,A00,896588,Munoz Sanchez; Alicia,4,0,20,16
1745814049384,LISP 5B,A00,896653,Munoz Sanchez; Alicia,10,0,20,10
1745814050427,LISP 5C,A00,896655,Munoz Sanchez; Alicia,4,0,20,16
1745814051457,MAE 197,001,957918,Kleissl; Jan,9998,0,9999,1
1745814052482,MATH 2,A01,957937,Staff,34,0,35,1
1745814053510,MATH 197,001,957876,Kedlaya; Kiran S.,9993,0,9999,6
1745814054539,MCWP 40,A00,892729,Duru; Nur,13,0,20,7
1745814054539,MCWP 40,B00,893304,Montejo; Carolina,20,0,20,0
1745814055564,MCWP 40R,A00,893757,Redela; Pamela Morgan,0,7,20,20
1745814056589,MCWP 50,A00,893758,Morshed; Michael James,2,0,20,18
1745814056589,MCWP 50,B00,893761,Bartulis; Jason Michael,17,0,20,3
1745814057620,MCWP 50R,A00,893766,Compas; Sean Matthew,0,1,20,20
1745814057620,MCWP 50R,B00,893769,Carter; Jennifer A,0,0,20,20
1745814057620,MCWP 50R,C00,893771,Krone; Jarret,0,3,20,20
1745814057620,MCWP 50R,D00,893772,Miller; Elizabeth Deen,3,0,20,17
1745814057620,MCWP 50R,E00,893775,Carter; Andrea L,0,0,20,20
1745814058645,MMW 11R,A01,892721,Herbst; Matthew,11,0,27,16
1745814058645,MMW 11R,A02,892722,Herbst; Matthew,0,0,0,3
1745814059675,MMW 12R,A01,892724,Herbst; Matthew,0,9,16,16
1745814059675,MMW 12R,A02,892725,Herbst; Matthew,0,9,16,16
1745814060702,MMW 13R,A01,892727,Staff,0,3,16,16
1745814060702,MMW 13R,A02,892728,Staff,0,4,16,16
1745814060702,MMW 13R,A03,958032,Staff,0,3,16,16
1745814060702,MMW 13R,A04,958033,Staff,0,2,16,16
1745814060702,MMW 13R,A05,958034,Staff,0,3,16,16
1745814061729,SIO 295LS,A00,894015,Staff,7,0,25,18
1745814062758,SIO 295S,A00,894020,Staff,7,0,25,18
1745814063783,SIOC 290S,B01,958918,Staff,0,0,0,0
1745814064811,SIOC 291S,B01,958922,Staff,0,0,0,0
1745814065840,SOCI 117,A01,895339,Staff,4,0,5,1
1745814066868,WES 237B,A00,894149,Staff,11,0,20,9
1745814068935,AESE 279B,A00,891859,Staff,13,0,35,22
1745814069959,AIP 197,001,891854,Staff,70,0,70,0
1745814070984,ANTH 289S,A00,891856,Gagneux; Pascal,12,0,12,0
1745814072009,BENG 196,001,957946,Engler; Adam J.,9996,0,9999,3
1745814073037,CAT 124RS,A01,956906,Staff,8,0,25,17
1745814074062,CAT 125RS,A01,922013,Staff,8,0,25,17
1745814075090,CLRE 250,A00,891860,Morris; Sheldon,9995,0,9999,4
1745814077152,CLRE 251R,A00,907817,Mehta; Ravindra L.,9994,0,9999,5
1745814078178,CLRE 252,A00,891864,Cuomo; Raphael Eduardo,9993,0,9999,6
1745814079207,CLRE 253,A00,891867,Vaida; Florin,9994,0,9999,5
1745814079207,CLRE 253,B00,907819,Staff,9999,0,9999,0
1745814080232,CLRE 259,A00,891868,Patel; Hemal,9998,0,9999,1
1745814081258,CLRE 260,A00,891872,Cuomo; Raphael Eduardo,9999,0,9999,0
1745814082285,CLRE 297,001,891888,Cuomo; Raphael Eduardo,9999,0,9999,0
1745814083310,CSE 191,A00,958773,Minnes Kemp; Mor Mia,9999,0,9999,0
1745814084342,CSS 201S,A01,892054,Mignozzetti; Umberto,30,0,30,0
1745814085372,CSS 202S,A01,892056,Mignozzetti; Umberto,30,0,30,0
1745814086398,DSC 197,001,956898,Eldridge; Justin Matthew,9998,0,9999,1
1745814087423,DSC 297,001,958000,Mazumdar; Arya,9998,0,9999,1
1745814088450,EAP 100,A00,905686,Staff,9776,0,9999,223
1745814089473,ECE 45,A01,892618,Staff,0,12,50,50
1745814090499,ECE 109,A01,892620,Staff,0,43,0,0
1745814091524,ECE 111,A01,892719,Staff,0,8,50,50
1745814092550,ECE 197,001,957920,Mercier; Patrick Philip,9992,0,9999,7
1745814093580,ECON 178,A01,907814,Zhu; Ying,28,0,35,7
1745814094609,EDS 115,A00,895312,Staff,41,0,45,4
1745814095633,EDS 117,A01,895337,Staff,30,0,30,0
1745814096659,EDS 125,A00,895341,Jones; Gabrielle Anastasia,43,0,45,2
1745814097688,EDS 128A,A01,895459,Fargason; Sharon Gayle,44,0,45,1
1745814098712,EDS 128B,A01,895543,Pappas; Elizabeth,44,0,45,1
1745814099738,EDS 139,A00,897203,Pappas; Elizabeth,44,0,45,1
1745814099738,EDS 139,B00,897209,Fargason; Sharon Gayle,44,0,45,1
1745814100766,EDS 201,A00,895545,Staff,43,0,45,2
1745814101796,EDS 203,A01,895581,Halter; Christopher P.,43,0,45,2
1745814102824,EDS 204R,A01,895625,Heinzman; Erica M.,43,0,45,2
1745814102824,EDS 204R,B01,895693,Halter; Christopher P.,18,0,45,27
1745814103853,EDS 206R,A00,895694,Fargason; Sharon Gayle,9,0,30,21
1745814103853,EDS 206R,B00,895695,Choi; Bailey Miyeon,20,0,30,10
1745814104881,EDS 250,A00,895697,Hemans; Patricia Ann Benitez,43,0,45,2
1745814105907,EDS 281,A00,895701,Meyerott; Theresa Ann,15,0,15,0
1745814106935,EDS 284,A00,895736,Meyerott; Theresa Ann,15,0,15,0
1745814107962,EDS 286,A00,897210,Fine; Sarah,15,0,15,0
1745814108987,EDS 289C,A01,895770,Daly; Alan J.,15,0,15,0
1745814110014,EDS 290,A00,897211,Hofstetter; Carolyn,15,0,15,0
1745814111043,LIGM 5A,A00,896162,Fischer-Grunski; Eva K,15,0,20,5
1745814112074,LIGM 5B,A00,896260,Fischer-Grunski; Eva K,17,0,20,3
1745814113103,LIGM 5C,A00,896308,Fischer-Grunski; Eva K,18,0,20,2
1745814114129,LIIT 5AS,A00,896313,Carnelos; Chiara,18,0,20,2
1745814115156,LIIT 5BS,A00,896416,Carnelos; Chiara,20,0,20,0
1745814116185,LIIT 5CS,A00,896564,Carnelos; Chiara,20,0,20,0
1745814117213,LISP 5A,A00,896588,Munoz Sanchez; Alicia,4,0,20,16
1745814118242,LISP 5B,A00,896653,Munoz Sanchez; Alicia,10,0,20,10
1745814119269,LISP 5C,A00,896655,Munoz Sanchez; Alicia,4,0,20,16
1745814120295,MAE 197,001,957918,Kleissl; Jan,9998,0,9999,1
1745814121320,MATH 2,A01,957937,Staff,34,0,35,1
1745814122351,MATH 197,001,957876,Kedlaya; Kiran S.,9993,0,9999,6
1745814123378,MCWP 40,A00,892729,Duru; Nur,13,0,20,7
1745814123378,MCWP 40,B00,893304,Montejo; Carolina,20,0,20,0
1745814124406,MCWP 40R,A00,893757,Redela; Pamela Morgan,0,7,20,20
1745814125435,MCWP 50,A00,893758,Morshed; Michael James,2,0,20,18
1745814125435,MCWP 50,B00,893761,Bartulis; Jason Michael,17,0,20,3
1745814126461,MCWP 50R,A00,893766,Compas; Sean Matthew,0,1,20,20
1745814126461,MCWP 50R,B00,893769,Carter; Jennifer A,0,0,20,20
1745814126461,MCWP 50R,C00,893771,Krone; Jarret,0,3,20,20
1745814126461,MCWP 50R,D00,893772,Miller; Elizabeth Deen,3,0,20,17
1745814126461,MCWP 50R,E00,893775,Carter; Andrea L,0,0,20,20
1745814127487,MMW 11R,A01,892721,Herbst; Matthew,11,0,27,16
1745814127487,MMW 11R,A02,892722,Herbst; Matthew,0,0,0,3
1745814128517,MMW 12R,A01,892724,Herbst; Matthew,0,9,16,16
1745814128517,MMW 12R,A02,892725,Herbst; Matthew,0,9,16,16
1745814129545,MMW 13R,A01,892727,Staff,0,3,16,16
1745814129545,MMW 13R,A02,892728,Staff,0,4,16,16
1745814129545,MMW 13R,A03,958032,Staff,0,3,16,16
1745814129545,MMW 13R,A04,958033,Staff,0,2,16,16
1745814129545,MMW 13R,A05,958034,Staff,0,3,16,16
1745814130573,SIO 295LS,A00,894015,Staff,7,0,25,18
1745814131601,SIO 295S,A00,894020,Staff,7,0,25,18
1745814132631,SIOC 290S,B01,958918,Staff,0,0,0,0
1745814133661,SIOC 291S,B01,958922,Staff,0,0,0,0
1745814134699,SOCI 117,A01,895339,Staff,4,0,5,1
1745814135726,WES 237B,A00,894149,Staff,11,0,20,9
1745814137784,AESE 279B,A00,891859,Staff,13,0,35,22
1745814138810,AIP 197,001,891854,Staff,70,0,70,0
1745814139835,ANTH 289S,A00,891856,Gagneux; Pascal,12,0,12,0
1745814140862,BENG 196,001,957946,Engler; Adam J.,9996,0,9999,3
1745814141889,CAT 124RS,A01,956906,Staff,8,0,25,17
1745814142914,CAT 125RS,A01,922013,Staff,8,0,25,17
1745814143939,CLRE 250,A00,891860,Morris; Sheldon,9995,0,9999,4
1745814145994,CLRE 251R,A00,907817,Mehta; Ravindra L.,9994,0,9999,5
1745814147022,CLRE 252,A00,891864,Cuomo; Raphael Eduardo,9993,0,9999,6
1745814148050,CLRE 253,A00,891867,Vaida; Florin,9994,0,9999,5
1745814148050,CLRE 253,B00,907819,Staff,9999,0,9999,0
1745814149077,CLRE 259,A00,891868,Patel; Hemal,9998,0,9999,1
1745814150105,CLRE 260,A00,891872,Cuomo; Raphael Eduardo,9999,0,9999,0
1745814151130,CLRE 297,001,891888,Cuomo; Raphael Eduardo,9999,0,9999,0
1745814152158,CSE 191,A00,958773,Minnes Kemp; Mor Mia,9999,0,9999,0
1745814153187,CSS 201S,A01,892054,Mignozzetti; Umberto,30,0,30,0
1745814154217,CSS 202S,A01,892056,Mignozzetti; Umberto,30,0,30,0
1745814155243,DSC 197,001,956898,Eldridge; Justin Matthew,9998,0,9999,1
1745814156271,DSC 297,001,958000,Mazumdar; Arya,9998,0,9999,1
1745814157298,EAP 100,A00,905686,Staff,9776,0,9999,223
1745814158323,ECE 45,A01,892618,Staff,0,12,50,50
1745814159349,ECE 109,A01,892620,Staff,0,43,0,0
1745814160374,ECE 111,A01,892719,Staff,0,8,50,50
1745814161397,ECE 197,001,957920,Mercier; Patrick Philip,9992,0,9999,7
1745814162428,ECON 178,A01,907814,Zhu; Ying,28,0,35,7
1745814163451,EDS 115,A00,895312,Staff,41,0,45,4
1745814164477,EDS 117,A01,895337,Staff,30,0,30,0
1745814165504,EDS 125,A00,895341,Jones; Gabrielle Anastasia,43,0,45,2
1745814166534,EDS 128A,A01,895459,Fargason; Sharon Gayle,44,0,45,1
1745814167561,EDS 128B,A01,895543,Pappas; Elizabeth,44,0,45,1
1745814168588,EDS 139,A00,897203,Pappas; Elizabeth,44,0,45,1
1745814168588,EDS 139,B00,897209,Fargason; Sharon Gayle,44,0,45,1
1745814169614,EDS 201,A00,895545,Staff,43,0,45,2
1745814170639,EDS 203,A01,895581,Halter; Christopher P.,43,0,45,2
1745814171669,EDS 204R,A01,895625,Heinzman; Erica M.,43,0,45,2
1745814171669,EDS 204R,B01,895693,Halter; Christopher P.,18,0,45,27
1745814172697,EDS 206R,A00,895694,Fargason; Sharon Gayle,9,0,30,21
1745814172697,EDS 206R,B00,895695,Choi; Bailey Miyeon,20,0,30,10
1745814173722,EDS 250,A00,895697,Hemans; Patricia Ann Benitez,43,0,45,2
1745814174752,EDS 281,A00,895701,Meyerott; Theresa Ann,15,0,15,0
1745814175777,EDS 284,A00,895736,Meyerott; Theresa Ann,15,0,15,0
1745814176805,EDS 286,A00,897210,Fine; Sarah,15,0,15,0
1745814177832,EDS 289C,A01,895770,Daly; Alan J.,15,0,15,0
1745814178859,EDS 290,A00,897211,Hofstetter; Carolyn,15,0,15,0
1745814179887,LIGM 5A,A00,896162,Fischer-Grunski; Eva K,15,0,20,5
1745814180917,LIGM 5B,A00,896260,Fischer-Grunski; Eva K,17,0,20,3
1745814181947,LIGM 5C,A00,896308,Fischer-Grunski; Eva K,18,0,20,2
1745814182974,LIIT 5AS,A00,896313,Carnelos; Chiara,18,0,20,2
1745814184003,LIIT 5BS,A00,896416,Carnelos; Chiara,20,0,20,0
1745814185030,LIIT 5CS,A00,896564,Carnelos; Chiara,20,0,20,0
1745814186060,LISP 5A,A00,896588,Munoz Sanchez; Alicia,4,0,20,16
1745814187088,LISP 5B,A00,896653,Munoz Sanchez; Alicia,10,0,20,10
1745814188119,LISP 5C,A00,896655,Munoz Sanchez; Alicia,4,0,20,16
1745814189145,MAE 197,001,957918,Kleissl; Jan,9998,0,9999,1
1745814190173,MATH 2,A01,957937,Staff,34,0,35,1
1745814191200,MATH 197,001,957876,Kedlaya; Kiran S.,9993,0,9999,6
1745814192229,MCWP 40,A00,892729,Duru; Nur,13,0,20,7
1745814192229,MCWP 40,B00,893304,Montejo; Carolina,20,0,20,0
1745814193253,MCWP 40R,A00,893757,Redela; Pamela Morgan,0,7,20,20
1745814194278,MCWP 50,A00,893758,Morshed; Michael James,2,0,20,18
1745814194278,MCWP 50,B00,893761,Bartulis; Jason Michael,17,0,20,3
1745814195308,MCWP 50R,A00,893766,Compas; Sean Matthew,0,1,20,20
1745814195308,MCWP 50R,B00,893769,Carter; Jennifer A,0,0,20,20
1745814195308,MCWP 50R,C00,893771,Krone; Jarret,0,3,20,20
1745814195308,MCWP 50R,D00,893772,Miller; Elizabeth Deen,3,0,20,17
1745814195308,MCWP 50R,E00,893775,Carter; Andrea L,0,0,20,20
1745814196333,MMW 11R,A01,892721,Herbst; Matthew,11,0,27,16
1745814196333,MMW 11R,A02,892722,Herbst; Matthew,0,0,0,3
1745814197363,MMW 12R,A01,892724,Herbst; Matthew,0,9,16,16
1745814197363,MMW 12R,A02,892725,Herbst; Matthew,0,9,16,16
1745814198390,MMW 13R,A01,892727,Staff,0,3,16,16
1745814198390,MMW 13R,A02,892728,Staff,0,4,16,16
1745814198390,MMW 13R,A03,958032,Staff,0,3,16,16
1745814198390,MMW 13R,A04,958033,Staff,0,2,16,16
1745814198390,MMW 13R,A05,958034,Staff,0,3,16,16
1745814199418,SIO 295LS,A00,894015,Staff,7,0,25,18
1745814200445,SIO 295S,A00,894020,Staff,7,0,25,18
1745814201471,SIOC 290S,B01,958918,Staff,0,0,0,0
1745814202502,SIOC 291S,B01,958922,Staff,0,0,0,0
1745814203529,SOCI 117,A01,895339,Staff,4,0,5,1
1745814204555,WES 237B,A00,894149,Staff,11,0,20,9
1745814206626,AESE 279B,A00,891859,Staff,13,0,35,22
1745814207694,AIP 197,001,891854,Staff,70,0,70,0
1745814208722,ANTH 289S,A00,891856,Gagneux; Pascal,12,0,12,0
1745814209752,BENG 196,001,957946,Engler; Adam J.,9996,0,9999,3
1745814210779,CAT 124RS,A01,956906,Staff,8,0,25,17
1745814211805,CAT 125RS,A01,922013,Staff,8,0,25,17
1745814212833,CLRE 250,A00,891860,Morris; Sheldon,9995,0,9999,4
1745814214889,CLRE 251R,A00,907817,Mehta; Ravindra L.,9994,0,9999,5
1745814215916,CLRE 252,A00,891864,Cuomo; Raphael Eduardo,9993,0,9999,6
1745814216945,CLRE 253,A00,891867,Vaida; Florin,9994,0,9999,5
1745814216945,CLRE 253,B00,907819,Staff,9999,0,9999,0
1745814217969,CLRE 259,A00,891868,Patel; Hemal,9998,0,9999,1
1745814218994,CLRE 260,A00,891872,Cuomo; Raphael Eduardo,9999,0,9999,0
1745814220023,CLRE 297,001,891888,Cuomo; Raphael Eduardo,9999,0,9999,0
1745814221050,CSE 191,A00,958773,Minnes Kemp; Mor Mia,9999,0,9999,0
1745814222076,CSS 201S,A01,892054,Mignozzetti; Umberto,30,0,30,0
1745814223103,CSS 202S,A01,892056,Mignozzetti; Umberto,30,0,30,0
1745814224129,DSC 197,001,956898,Eldridge; Justin Matthew,9998,0,9999,1
1745814225155,DSC 297,001,958000,Mazumdar; Arya,9998,0,9999,1
1745814226181,EAP 100,A00,905686,Staff,9776,0,9999,223
1745814227209,ECE 45,A01,892618,Staff,0,12,50,50
1745814228239,ECE 109,A01,892620,Staff,0,43,0,0
1745814229269,ECE 111,A01,892719,Staff,0,8,50,50
1745814230298,ECE 197,001,957920,Mercier; Patrick Philip,9992,0,9999,7
1745814231325,ECON 178,A01,907814,Zhu; Ying,28,0,35,7
1745814232354,EDS 115,A00,895312,Staff,41,0,45,4
1745814233380,EDS 117,A01,895337,Staff,30,0,30,0
1745814234408,EDS 125,A00,895341,Jones; Gabrielle Anastasia,43,0,45,2
1745814235436,EDS 128A,A01,895459,Fargason; Sharon Gayle,44,0,45,1
1745814236463,EDS 128B,A01,895543,Pappas; Elizabeth,44,0,45,1
1745814237488,EDS 139,A00,897203,Pappas; Elizabeth,44,0,45,1
1745814237488,EDS 139,B00,897209,Fargason; Sharon Gayle,44,0,45,1
1745814238513,EDS 201,A00,895545,Staff,43,0,45,2
1745814239542,EDS 203,A01,895581,Halter; Christopher P.,43,0,45,2
1745814240571,EDS 204R,A01,895625,Heinzman; Erica M.,43,0,45,2
1745814240571,EDS 204R,B01,895693,Halter; Christopher P.,18,0,45,27
1745814241595,EDS 206R,A00,895694,Fargason; Sharon Gayle,9,0,30,21
1745814241595,EDS 206R,B00,895695,Choi; Bailey Miyeon,20,0,30,10
1745814242621,EDS 250,A00,895697,Hemans; Patricia Ann Benitez,43,0,45,2
1745814243648,EDS 281,A00,895701,Meyerott; Theresa Ann,15,0,15,0
1745814244677,EDS 284,A00,895736,Meyerott; Theresa Ann,15,0,15,0
1745814245704,EDS 286,A00,897210,Fine; Sarah,15,0,15,0
1745814246731,EDS 289C,A01,895770,Daly; Alan J.,15,0,15,0
1745814247759,EDS 290,A00,897211,Hofstetter; Carolyn,15,0,15,0
1745814248787,LIGM 5A,A00,896162,Fischer-Grunski; Eva K,15,0,20,5
1745814249813,LIGM 5B,A00,896260,Fischer-Grunski; Eva K,17,0,20,3
1745814250842,LIGM 5C,A00,896308,Fischer-Grunski; Eva K,18,0,20,2
1745814251868,LIIT 5AS,A00,896313,Carnelos; Chiara,18,0,20,2
1745814252893,LIIT 5BS,A00,896416,Carnelos; Chiara,20,0,20,0
1745814253920,LIIT 5CS,A00,896564,Carnelos; Chiara,20,0,20,0
1745814254952,LISP 5A,A00,896588,Munoz Sanchez; Alicia,4,0,20,16
1745814255980,LISP 5B,A00,896653,Munoz Sanchez; Alicia,10,0,20,10
1745814257011,LISP 5C,A00,896655,Munoz Sanchez; Alicia,4,0,20,16
1745814258037,MAE 197,001,957918,Kleissl; Jan,9998,0,9999,1
1745814259063,MATH 2,A01,957937,Staff,34,0,35,1
1745814260089,MATH 197,001,957876,Kedlaya; Kiran S.,9993,0,9999,6
1745814261117,MCWP 40,A00,892729,Duru; Nur,13,0,20,7
1745814261117,MCWP 40,B00,893304,Montejo; Carolina,20,0,20,0
1745814262143,MCWP 40R,A00,893757,Redela; Pamela Morgan,0,7,20,20
1745814263169,MCWP 50,A00,893758,Morshed; Michael James,2,0,20,18
1745814263169,MCWP 50,B00,893761,Bartulis; Jason Michael,17,0,20,3
1745814264201,MCWP 50R,A00,893766,Compas; Sean Matthew,0,1,20,20
1745814264201,MCWP 50R,B00,893769,Carter; Jennifer A,0,0,20,20
1745814264201,MCWP 50R,C00,893771,Krone; Jarret,0,3,20,20
1745814264201,MCWP 50R,D00,893772,Miller; Elizabeth Deen,3,0,20,17
1745814264201,MCWP 50R,E00,893775,Carter; Andrea L,0,0,20,20
1745814265226,MMW 11R,A01,892721,Herbst; Matthew,11,0,27,16
1745814265226,MMW 11R,A02,892722,Herbst; Matthew,0,0,0,3
1745814266251,MMW 12R,A01,892724,Herbst; Matthew,0,9,16,16
1745814266251,MMW 12R,A02,892725,Herbst; Matthew,0,9,16,16
1745814267281,MMW 13R,A01,892727,Staff,0,3,16,16
1745814267281,MMW 13R,A02,892728,Staff,0,4,16,16
1745814267281,MMW 13R,A03,958032,Staff,0,3,16,16
1745814267281,MMW 13R,A04,958033,Staff,0,2,16,16
1745814267281,MMW 13R,A05,958034,Staff,0,3,16,16
1745814268312,SIO 295LS,A00,894015,Staff,7,0,25,18
1745814269339,SIO 295S,A00,894020,Staff,7,0,25,18
1745814270366,SIOC 290S,B01,958918,Staff,0,0,0,0
1745814271396,SIOC 291S,B01,958922,Staff,0,0,0,0
1745814272422,SOCI 117,A01,895339,Staff,4,0,5,1
1745814273449,WES 237B,A00,894149,Staff,11,0,20,9
1745814275507,AESE 279B,A00,891859,Staff,13,0,35,22
1745814276534,AIP 197,001,891854,Staff,70,0,70,0
1745814277557,ANTH 289S,A00,891856,Gagneux; Pascal,12,0,12,0
1745814278584,BENG 196,001,957946,Engler; Adam J.,9996,0,9999,3
1745814279616,CAT 124RS,A01,956906,Staff,8,0,25,17
1745814280645,CAT 125RS,A01,922013,Staff,8,0,25,17
1745814281673,CLRE 250,A00,891860,Morris; Sheldon,9995,0,9999,4
1745814283726,CLRE 251R,A00,907817,Mehta; Ravindra L.,9994,0,9999,5
1745814284752,CLRE 252,A00,891864,Cuomo; Raphael Eduardo,9993,0,9999,6
1745814285779,CLRE 253,A00,891867,Vaida; Florin,9994,0,9999,5
1745814285779,CLRE 253,B00,907819,Staff,9999,0,9999,0
1745814286806,CLRE 259,A00,891868,Patel; Hemal,9998,0,9999,1
1745814287832,CLRE 260,A00,891872,Cuomo; Raphael Eduardo,9999,0,9999,0
1745814288861,CLRE 297,001,891888,Cuomo; Raphael Eduardo,9999,0,9999,0
1745814289887,CSE 191,A00,958773,Minnes Kemp; Mor Mia,9999,0,9999,0
1745814290913,CSS 201S,A01,892054,Mignozzetti; Umberto,30,0,30,0
1745814291945,CSS 202S,A01,892056,Mignozzetti; Umberto,30,0,30,0
1745814292973,DSC 197,001,956898,Eldridge; Justin Matthew,9998,0,9999,1
1745814294003,DSC 297,001,958000,Mazumdar; Arya,9998,0,9999,1
1745814295031,EAP 100,A00,905686,Staff,9776,0,9999,223
1745814296096,ECE 45,A01,892618,Staff,0,12,50,50
1745814297125,ECE 109,A01,892620,Staff,0,43,0,0
1745814298153,ECE 111,A01,892719,Staff,0,8,50,50
1745814299179,ECE 197,001,957920,Mercier; Patrick Philip,9992,0,9999,7
1745814300205,ECON 178,A01,907814,Zhu; Ying,28,0,35,7
1745814301232,EDS 115,A00,895312,Staff,41,0,45,4
1745814302257,EDS 117,A01,895337,Staff,30,0,30,0
1745814303289,EDS 125,A00,895341,Jones; Gabrielle Anastasia,43,0,45,2
1745814304319,EDS 128A,A01,895459,Fargason; Sharon Gayle,44,0,45,1
1745814305346,EDS 128B,A01,895543,Pappas; Elizabeth,44,0,45,1
1745814306379,EDS 139,A00,897203,Pappas; Elizabeth,44,0,45,1
1745814306379,EDS 139,B00,897209,Fargason; Sharon Gayle,44,0,45,1
1745814307405,EDS 201,A00,895545,Staff,43,0,45,2
1745814308431,EDS 203,A01,895581,Halter; Christopher P.,43,0,45,2
1745814309457,EDS 204R,A01,895625,Heinzman; Erica M.,43,0,45,2
1745814309457,EDS 204R,B01,895693,Halter; Christopher P.,18,0,45,27
1745814310486,EDS 206R,A00,895694,Fargason; Sharon Gayle,9,0,30,21
1745814310486,EDS 206R,B00,895695,Choi; Bailey Miyeon,20,0,30,10
1745814311512,EDS 250,A00,895697,Hemans; Patricia Ann Benitez,43,0,45,2
1745814312540,EDS 281,A00,895701,Meyerott; Theresa Ann,15,0,15,0
1745814313565,EDS 284,A00,895736,Meyerott; Theresa Ann,15,0,15,0
1745814314592,EDS 286,A00,897210,Fine; Sarah,15,0,15,0
1745814315618,EDS 289C,A01,895770,Daly; Alan J.,15,0,15,0
1745814316646,EDS 290,A00,897211,Hofstetter; Carolyn,15,0,15,0
1745814317672,LIGM 5A,A00,896162,Fischer-Grunski; Eva K,15,0,20,5
1745814318700,LIGM 5B,A00,896260,Fischer-Grunski; Eva K,17,0,20,3
1745814319728,LIGM 5C,A00,896308,Fischer-Grunski; Eva K,18,0,20,2
1745814320758,LIIT 5AS,A00,896313,Carnelos; Chiara,18,0,20,2
1745814321785,LIIT 5BS,A00,896416,Carnelos; Chiara,20,0,20,0
1745814322815,LIIT 5CS,A00,896564,Carnelos; Chiara,20,0,20,0
1745814323845,LISP 5A,A00,896588,Munoz Sanchez; Alicia,4,0,20,16
1745814324874,LISP 5B,A00,896653,Munoz Sanchez; Alicia,10,0,20,10
1745814325903,LISP 5C,A00,896655,Munoz Sanchez; Alicia,4,0,20,16
1745814326928,MAE 197,001,957918,Kleissl; Jan,9998,0,9999,1
1745814327954,MATH 2,A01,957937,Staff,34,0,35,1
1745814328981,MATH 197,001,957876,Kedlaya; Kiran S.,9993,0,9999,6
1745814330008,MCWP 40,A00,892729,Duru; Nur,13,0,20,7
1745814330008,MCWP 40,B00,893304,Montejo; Carolina,20,0,20,0
1745814331035,MCWP 40R,A00,893757,Redela; Pamela Morgan,0,7,20,20
1745814332061,MCWP 50,A00,893758,Morshed; Michael James,2,0,20,18
1745814332061,MCWP 50,B00,893761,Bartulis; Jason Michael,17,0,20,3
1745814333088,MCWP 50R,A00,893766,Compas; Sean Matthew,0,1,20,20
1745814333088,MCWP 50R,B00,893769,Carter; Jennifer A,0,0,20,20
1745814333088,MCWP 50R,C00,893771,Krone; Jarret,0,3,20,20
1745814333088,MCWP 50R,D00,893772,Miller; Elizabeth Deen,3,0,20,17
1745814333088,MCWP 50R,E00,893775,Carter; Andrea L,0,0,20,20
1745814334114,MMW 11R,A01,892721,Herbst; Matthew,11,0,27,16
1745814334114,MMW 11R,A02,892722,Herbst; Matthew,0,0,0,3
1745814335139,MMW 12R,A01,892724,Herbst; Matthew,0,9,16,16
1745814335139,MMW 12R,A02,892725,Herbst; Matthew,0,9,16,16
1745814336169,MMW 13R,A01,892727,Staff,0,3,16,16
1745814336169,MMW 13R,A02,892728,Staff,0,4,16,16
1745814336169,MMW 13R,A03,958032,Staff,0,3,16,16
1745814336169,MMW 13R,A04,958033,Staff,0,2,16,16
1745814336169,MMW 13R,A05,958034,Staff,0,3,16,16
1745814337195,SIO 295LS,A00,894015,Staff,7,0,25,18
1745814338222,SIO 295S,A00,894020,Staff,7,0,25,18
1745814339248,SIOC 290S,B01,958918,Staff,0,0,0,0
1745814340279,SIOC 291S,B01,958922,Staff,0,0,0,0
1745814341306,SOCI 117,A01,895339,Staff,4,0,5,1
1745814342331,WES 237B,A00,894149,Staff,11,0,20,9
1745814344391,AESE 279B,A00,891859,Staff,13,0,35,22
1745814345417,AIP 197,001,891854,Staff,70,0,70,0
1745814346442,ANTH 289S,A00,891856,Gagneux; Pascal,12,0,12,0
1745814347470,BENG 196,001,957946,Engler; Adam J.,9996,0,9999,3
1745814348496,CAT 124RS,A01,956906,Staff,8,0,25,17
1745814349522,CAT 125RS,A01,922013,Staff,8,0,25,17
1745814350553,CLRE 250,A00,891860,Morris; Sheldon,9995,0,9999,4
1745814352611,CLRE 251R,A00,907817,Mehta; Ravindra L.,9994,0,9999,5
1745814353639,CLRE 252,A00,891864,Cuomo; Raphael Eduardo,9993,0,9999,6
1745814354666,CLRE 253,A00,891867,Vaida; Florin,9994,0,9999,5
1745814354666,CLRE 253,B00,907819,Staff,9999,0,9999,0
1745814355691,CLRE 259,A00,891868,Patel; Hemal,9998,0,9999,1
1745814356721,CLRE 260,A00,891872,Cuomo; Raphael Eduardo,9999,0,9999,0
1745814357750,CLRE 297,001,891888,Cuomo; Raphael Eduardo,9999,0,9999,0
1745814358775,CSE 191,A00,958773,Minnes Kemp; Mor Mia,9999,0,9999,0
1745814359801,CSS 201S,A01,892054,Mignozzetti; Umberto,30,0,30,0
1745814360827,CSS 202S,A01,892056,Mignozzetti; Umberto,30,0,30,0
1745814361856,DSC 197,001,956898,Eldridge; Justin Matthew,9998,0,9999,1
1745814362881,DSC 297,001,958000,Mazumdar; Arya,9998,0,9999,1
1745814363907,EAP 100,A00,905686,Staff,9776,0,9999,223
1745814364935,ECE 45,A01,892618,Staff,0,12,50,50
1745814366001,ECE 109,A01,892620,Staff,0,43,0,0
1745814367026,ECE 111,A01,892719,Staff,0,8,50,50
1745814368053,ECE 197,001,957920,Mercier; Patrick Philip,9992,0,9999,7
1745814369080,ECON 178,A01,907814,Zhu; Ying,28,0,35,7
1745814370107,EDS 115,A00,895312,Staff,41,0,45,4
1745814371133,EDS 117,A01,895337,Staff,30,0,30,0
1745814372159,EDS 125,A00,895341,Jones; Gabrielle Anastasia,43,0,45,2
1745814373187,EDS 128A,A01,895459,Fargason; Sharon Gayle,44,0,45,1
1745814374212,EDS 128B,A01,895543,Pappas; Elizabeth,44,0,45,1
1745814375242,EDS 139,A00,897203,Pappas; Elizabeth,44,0,45,1
1745814375242,EDS 139,B00,897209,Fargason; Sharon Gayle,44,0,45,1
1745814376268,EDS 201,A00,895545,Staff,43,0,45,2
1745814377294,EDS 203,A01,895581,Halter; Christopher P.,43,0,45,2
1745814378319,EDS 204R,A01,895625,Heinzman; Erica M.,43,0,45,2
1745814378319,EDS 204R,B01,895693,Halter; Christopher P.,18,0,45,27
1745814379344,EDS 206R,A00,895694,Fargason; Sharon Gayle,9,0,30,21
1745814379344,EDS 206R,B00,895695,Choi; Bailey Miyeon,20,0,30,10
1745814380370,EDS 250,A00,895697,Hemans; Patricia Ann Benitez,43,0,45,2
1745814381399,EDS 281,A00,895701,Meyerott; Theresa Ann,15,0,15,0
1745814382425,EDS 284,A00,895736,Meyerott; Theresa Ann,15,0,15,0
1745814383451,EDS 286,A00,897210,Fine; Sarah,15,0,15,0
1745814384477,EDS 289C,A01,895770,Daly; Alan J.,15,0,15,0
1745814385503,EDS 290,A00,897211,Hofstetter; Carolyn,15,0,15,0
1745814386533,LIGM 5A,A00,896162,Fischer-Grunski; Eva K,15,0,20,5
1745814387562,LIGM 5B,A00,896260,Fischer-Grunski; Eva K,17,0,20,3
1745814388590,LIGM 5C,A00,896308,Fischer-Grunski; Eva K,18,0,20,2
1745814389626,LIIT 5AS,A00,896313,Carnelos; Chiara,18,0,20,2
1745814390656,LIIT 5BS,A00,896416,Carnelos; Chiara,20,0,20,0
1745814391682,LIIT 5CS,A00,896564,Carnelos; Chiara,20,0,20,0
1745814392707,LISP 5A,A00,896588,Munoz Sanchez; Alicia,4,0,20,16
1745814393733,LISP 5B,A00,896653,Munoz Sanchez; Alicia,10,0,20,10
1745814394760,LISP 5C,A00,896655,Munoz Sanchez; Alicia,4,0,20,16
1745814395785,MAE 197,001,957918,Kleissl; Jan,9998,0,9999,1
1745814396811,MATH 2,A01,957937,Staff,34,0,35,1
1745814397838,MATH 197,001,957876,Kedlaya; Kiran S.,9993,0,9999,6
1745814398863,MCWP 40,A00,892729,Duru; Nur,13,0,20,7
1745814398863,MCWP 40,B00,893304,Montejo; Carolina,20,0,20,0
1745814399889,MCWP 40R,A00,893757,Redela; Pamela Morgan,0,7,20,20
1745814400919,MCWP 50,A00,893758,Morshed; Michael James,2,0,20,18
1745814400919,MCWP 50,B00,893761,Bartulis; Jason Michael,17,0,20,3
1745814401946,MCWP 50R,A00,893766,Compas; Sean Matthew,0,1,20,20
1745814401946,MCWP 50R,B00,893769,Carter; Jennifer A,0,0,20,20
1745814401946,MCWP 50R,C00,893771,Krone; Jarret,0,3,20,20
1745814401946,MCWP 50R,D00,893772,Miller; Elizabeth Deen,3,0,20,17
1745814401946,MCWP 50R,E00,893775,Carter; Andrea L,0,0,20,20
1745814402970,MMW 11R,A01,892721,Herbst; Matthew,11,0,27,16
1745814402970,MMW 11R,A02,892722,Herbst; Matthew,0,0,0,3
1745814403996,MMW 12R,A01,892724,Herbst; Matthew,0,9,16,16
1745814403996,MMW 12R,A02,892725,Herbst; Matthew,0,9,16,16
1745814405022,MMW 13R,A01,892727,Staff,0,3,16,16
1745814405022,MMW 13R,A02,892728,Staff,0,4,16,16
1745814405022,MMW 13R,A03,958032,Staff,0,3,16,16
1745814405022,MMW 13R,A04,958033,Staff,0,2,16,16
1745814405022,MMW 13R,A05,958034,Staff,0,3,16,16
1745814406050,SIO 295LS,A00,894015,Staff,7,0,25,18
1745814407076,SIO 295S,A00,894020,Staff,7,0,25,18
1745814408102,SIOC 290S,B01,958918,Staff,0,0,0,0
1745814409128,SIOC 291S,B01,958922,Staff,0,0,0,0
1745814410154,SOCI 117,A01,895339,Staff,4,0,5,1
1745814411179,WES 237B,A00,894149,Staff,11,0,20,9
1745814413256,AESE 279B,A00,891859,Staff,13,0,35,22
1745814414336,AIP 197,001,891854,Staff,70,0,70,0
1745814415361,ANTH 289S,A00,891856,Gagneux; Pascal,12,0,12,0
1745814416389,BENG 196,001,957946,Engler; Adam J.,9996,0,9999,3
1745814417417,CAT 124RS,A01,956906,Staff,8,0,25,17
1745814418441,CAT 125RS,A01,922013,Staff,8,0,25,17
1745814419467,CLRE 250,A00,891860,Morris; Sheldon,9995,0,9999,4
1745814421520,CLRE 251R,A00,907817,Mehta; Ravindra L.,9994,0,9999,5
1745814422550,CLRE 252,A00,891864,Cuomo; Raphael Eduardo,9993,0,9999,6
1745814423579,CLRE 253,A00,891867,Vaida; Florin,9994,0,9999,5
1745814423579,CLRE 253,B00,907819,Staff,9999,0,9999,0
1745814424606,CLRE 259,A00,891868,Patel; Hemal,9998,0,9999,1
1745814425631,CLRE 260,A00,891872,Cuomo; Raphael Eduardo,9999,0,9999,0
1745814426658,CLRE 297,001,891888,Cuomo; Raphael Eduardo,9999,0,9999,0
1745814427686,CSE 191,A00,958773,Minnes Kemp; Mor Mia,9999,0,9999,0
1745814428713,CSS 201S,A01,892054,Mignozzetti; Umberto,30,0,30,0
1745814429738,CSS 202S,A01,892056,Mignozzetti; Umberto,30,0,30,0
1745814430769,DSC 197,001,956898,Eldridge; Justin Matthew,9998,0,9999,1
1745814431798,DSC 297,001,958000,Mazumdar; Arya,9998,0,9999,1
1745814432827,EAP 100,A00,905686,Staff,9776,0,9999,223
1745814433854,ECE 45,A01,892618,Staff,0,12,50,50
1745814434884,ECE 109,A01,892620,Staff,0,43,0,0
1745814435911,ECE 111,A01,892719,Staff,0,8,50,50
1745814436937,ECE 197,001,957920,Mercier; Patrick Philip,9992,0,9999,7
1745814437964,ECON 178,A01,907814,Zhu; Ying,28,0,35,7
1745814438994,EDS 115,A00,895312,Staff,41,0,45,4
1745814440022,EDS 117,A01,895337,Staff,30,0,30,0
1745814441047,EDS 125,A00,895341,Jones; Gabrielle Anastasia,43,0,45,2
1745814442076,EDS 128A,A01,895459,Fargason; Sharon Gayle,44,0,45,1
1745814443104,EDS 128B,A01,895543,Pappas; Elizabeth,44,0,45,1
1745814444131,EDS 139,A00,897203,Pappas; Elizabeth,44,0,45,1
1745814444131,EDS 139,B00,897209,Fargason; Sharon Gayle,44,0,45,1
1745814445159,EDS 201,A00,895545,Staff,43,0,45,2
1745814446188,EDS 203,A01,895581,Halter; Christopher P.,43,0,45,2
1745814447212,EDS 204R,A01,895625,Heinzman; Erica M.,43,0,45,2
1745814447212,EDS 204R,B01,895693,Halter; Christopher P.,18,0,45,27
1745814448238,EDS 206R,A00,895694,Fargason; Sharon Gayle,9,0,30,21
1745814448238,EDS 206R,B00,895695,Choi; Bailey Miyeon,20,0,30,10
1745814449266,EDS 250,A00,895697,Hemans; Patricia Ann Benitez,43,0,45,2
1745814450291,EDS 281,A00,895701,Meyerott; Theresa Ann,15,0,15,0
1745814451319,EDS 284,A00,895736,Meyerott; Theresa Ann,15,0,15,0
1745814452349,EDS 286,A00,897210,Fine; Sarah,15,0,15,0
1745814453374,EDS 289C,A01,895770,Daly; Alan J.,15,0,15,0
1745814454403,EDS 290,A00,897211,Hofstetter; Carolyn,15,0,15,0
1745814455433,LIGM 5A,A00,896162,Fischer-Grunski; Eva K,15,0,20,5
1745814456463,LIGM 5B,A00,896260,Fischer-Grunski; Eva K,17,0,20,3
1745814457487,LIGM 5C,A00,896308,Fischer-Grunski; Eva K,18,0,20,2
1745814458515,LIIT 5AS,A00,896313,Carnelos; Chiara,18,0,20,2
1745814459544,LIIT 5BS,A00,896416,Carnelos; Chiara,20,0,20,0
1745814460569,LIIT 5CS,A00,896564,Carnelos; Chiara,20,0,20,0
1745814461598,LISP 5A,A00,896588,Munoz Sanchez; Alicia,4,0,20,16
1745814462643,LISP 5B,A00,896653,Munoz Sanchez; Alicia,10,0,20,10
1745814463670,LISP 5C,A00,896655,Munoz Sanchez; Alicia,4,0,20,16
1745814464699,MAE 197,001,957918,Kleissl; Jan,9998,0,9999,1
1745814465730,MATH 2,A01,957937,Staff,34,0,35,1
1745814466758,MATH 197,001,957876,Kedlaya; Kiran S.,9993,0,9999,6
1745814467784,MCWP 40,A00,892729,Duru; Nur,13,0,20,7
1745814467784,MCWP 40,B00,893304,Montejo; Carolina,20,0,20,0
1745814468810,MCWP 40R,A00,893757,Redela; Pamela Morgan,0,7,20,20
1745814469838,MCWP 50,A00,893758,Morshed; Michael James,2,0,20,18
1745814469838,MCWP 50,B00,893761,Bartulis; Jason Michael,17,0,20,3
1745814470864,MCWP 50R,A00,893766,Compas; Sean Matthew,0,1,20,20
1745814470864,MCWP 50R,B00,893769,Carter; Jennifer A,0,0,20,20
1745814470864,MCWP 50R,C00,893771,Krone; Jarret,0,3,20,20
1745814470864,MCWP 50R,D00,893772,Miller; Elizabeth Deen,3,0,20,17
1745814470864,MCWP 50R,E00,893775,Carter; Andrea L,0,0,20,20
1745814471892,MMW 11R,A01,892721,Herbst; Matthew,11,0,27,16
1745814471892,MMW 11R,A02,892722,Herbst; Matthew,0,0,0,3
1745814472919,MMW 12R,A01,892724,Herbst; Matthew,0,9,16,16
1745814472919,MMW 12R,A02,892725,Herbst; Matthew,0,9,16,16
1745814473947,MMW 13R,A01,892727,Staff,0,3,16,16
1745814473947,MMW 13R,A02,892728,Staff,0,4,16,16
1745814473947,MMW 13R,A03,958032,Staff,0,3,16,16
1745814473947,MMW 13R,A04,958033,Staff,0,2,16,16
1745814473947,MMW 13R,A05,958034,Staff,0,3,16,16
1745814474977,SIO 295LS,A00,894015,Staff,7,0,25,18
1745814476005,SIO 295S,A00,894020,Staff,7,0,25,18
1745814477032,SIOC 290S,B01,958918,Staff,0,0,0,0
1745814478058,SIOC 291S,B01,958922,Staff,0,0,0,0
1745814479089,SOCI 117,A01,895339,Staff,4,0,5,1
1745814480139,WES 237B,A00,894149,Staff,11,0,20,9
1745814482194,AESE 279B,A00,891859,Staff,13,0,35,22
1745814483220,AIP 197,001,891854,Staff,70,0,70,0
1745814484245,ANTH 289S,A00,891856,Gagneux; Pascal,12,0,12,0
1745814485270,BENG 196,001,957946,Engler; Adam J.,9996,0,9999,3
1745814486296,CAT 124RS,A01,956906,Staff,8,0,25,17
1745814487322,CAT 125RS,A01,922013,Staff,8,0,25,17
1745814488347,CLRE 250,A00,891860,Morris; Sheldon,9995,0,9999,4
1745814490398,CLRE 251R,A00,907817,Mehta; Ravindra L.,9994,0,9999,5
1745814491425,CLRE 252,A00,891864,Cuomo; Raphael Eduardo,9993,0,9999,6
1745814492454,CLRE 253,A00,891867,Vaida; Florin,9994,0,9999,5
1745814492454,CLRE 253,B00,907819,Staff,9999,0,9999,0
1745814493480,CLRE 259,A00,891868,Patel; Hemal,9998,0,9999,1
1745814494506,CLRE 260,A00,891872,Cuomo; Raphael Eduardo,9999,0,9999,0
1745814495531,CLRE 297,001,891888,Cuomo; Raphael Eduardo,9999,0,9999,0
1745814496560,CSE 191,A00,958773,Minnes Kemp; Mor Mia,9999,0,9999,0
1745814497585,CSS 201S,A01,892054,Mignozzetti; Umberto,30,0,30,0
1745814498610,CSS 202S,A01,892056,Mignozzetti; Umberto,30,0,30,0
1745814499637,DSC 197,001,956898,Eldridge; Justin Matthew,9998,0,9999,1
1745814500662,DSC 297,001,958000,Mazumdar; Arya,9998,0,9999,1
1745814501690,EAP 100,A00,905686,Staff,9776,0,9999,223
1745814502714,ECE 45,A01,892618,Staff,0,12,50,50
1745814503744,ECE 109,A01,892620,Staff,0,43,0,0
1745814504770,ECE 111,A01,892719,Staff,0,8,50,50
1745814505797,ECE 197,001,957920,Mercier; Patrick Philip,9992,0,9999,7
1745814506822,ECON 178,A01,907814,Zhu; Ying,28,0,35,7
1745814507850,EDS 115,A00,895312,Staff,41,0,45,4
1745814508874,EDS 117,A01,895337,Staff,30,0,30,0
1745814509899,EDS 125,A00,895341,Jones; Gabrielle Anastasia,43,0,45,2
1745814510924,EDS 128A,A01,895459,Fargason; Sharon Gayle,44,0,45,1
1745814511951,EDS 128B,A01,895543,Pappas; Elizabeth,44,0,45,1
1745814512982,EDS 139,A00,897203,Pappas; Elizabeth,44,0,45,1
1745814512982,EDS 139,B00,897209,Fargason; Sharon Gayle,44,0,45,1
1745814514006,EDS 201,A00,895545,Staff,43,0,45,2
1745814515030,EDS 203,A01,895581,Halter; Christopher P.,43,0,45,2
1745814516055,EDS 204R,A01,895625,Heinzman; Erica M.,43,0,45,2
1745814516055,EDS 204R,B01,895693,Halter; Christopher P.,18,0,45,27
1745814517083,EDS 206R,A00,895694,Fargason; Sharon Gayle,9,0,30,21
1745814517083,EDS 206R,B00,895695,Choi; Bailey Miyeon,20,0,30,10
1745814518107,EDS 250,A00,895697,Hemans; Patricia Ann Benitez,43,0,45,2
1745814519133,EDS 281,A00,895701,Meyerott; Theresa Ann,15,0,15,0
1745814520162,EDS 284,A00,895736,Meyerott; Theresa Ann,15,0,15,0
1745814521189,EDS 286,A00,897210,Fine; Sarah,15,0,15,0
1745814522215,EDS 289C,A01,895770,Daly; Alan J.,15,0,15,0
1745814523241,EDS 290,A00,897211,Hofstetter; Carolyn,15,0,15,0
1745814524268,LIGM 5A,A00,896162,Fischer-Grunski; Eva K,15,0,20,5
1745814525294,LIGM 5B,A00,896260,Fischer-Grunski; Eva K,17,0,20,3
1745814526325,LIGM 5C,A00,896308,Fischer-Grunski; Eva K,18,0,20,2
1745814527352,LIIT 5AS,A00,896313,Carnelos; Chiara,18,0,20,2
1745814528404,LIIT 5BS,A00,896416,Carnelos; Chiara,20,0,20,0
1745814529430,LIIT 5CS,A00,896564,Carnelos; Chiara,20,0,20,0
1745814530455,LISP 5A,A00,896588,Munoz Sanchez; Alicia,4,0,20,16
1745814531481,LISP 5B,A00,896653,Munoz Sanchez; Alicia,10,0,20,10
1745814532510,LISP 5C,A00,896655,Munoz Sanchez; Alicia,4,0,20,16
1745814533536,MAE 197,001,957918,Kleissl; Jan,9998,0,9999,1
1745814534563,MATH 2,A01,957937,Staff,34,0,35,1
1745814535589,MATH 197,001,957876,Kedlaya; Kiran S.,9993,0,9999,6
1745814536637,MCWP 40,A00,892729,Duru; Nur,13,0,20,7
1745814536637,MCWP 40,B00,893304,Montejo; Carolina,20,0,20,0
1745814537661,MCWP 40R,A00,893757,Redela; Pamela Morgan,0,7,20,20
1745814538684,MCWP 50,A00,893758,Morshed; Michael James,2,0,20,18
1745814538684,MCWP 50,B00,893761,Bartulis; Jason Michael,17,0,20,3
1745814539711,MCWP 50R,A00,893766,Compas; Sean Matthew,0,1,20,20
1745814539711,MCWP 50R,B00,893769,Carter; Jennifer A,0,0,20,20
1745814539711,MCWP 50R,C00,893771,Krone; Jarret,0,3,20,20
1745814539711,MCWP 50R,D00,893772,Miller; Elizabeth Deen,3,0,20,17
1745814539711,MCWP 50R,E00,893775,Carter; Andrea L,0,0,20,20
1745814540741,MMW 11R,A01,892721,Herbst; Matthew,11,0,27,16
1745814540741,MMW 11R,A02,892722,Herbst; Matthew,0,0,0,3
1745814541771,MMW 12R,A01,892724,Herbst; Matthew,0,9,16,16
1745814541771,MMW 12R,A02,892725,Herbst; Matthew,0,9,16,16
1745814542800,MMW 13R,A01,892727,Staff,0,3,16,16
1745814542800,MMW 13R,A02,892728,Staff,0,4,16,16
1745814542800,MMW 13R,A03,958032,Staff,0,3,16,16
1745814542800,MMW 13R,A04,958033,Staff,0,2,16,16
1745814542800,MMW 13R,A05,958034,Staff,0,3,16,16
1745814543831,SIO 295LS,A00,894015,Staff,7,0,25,18
1745814544859,SIO 295S,A00,894020,Staff,7,0,25,18
1745814545885,SIOC 290S,B01,958918,Staff,0,0,0,0
1745814546912,SIOC 291S,B01,958922,Staff,0,0,0,0
1745814547939,SOCI 117,A01,895339,Staff,4,0,5,1
1745814548965,WES 237B,A00,894149,Staff,11,0,20,9
1745814551050,AESE 279B,A00,891859,Staff,13,0,35,22
1745814552077,AIP 197,001,891854,Staff,70,0,70,0
1745814553102,ANTH 289S,A00,891856,Gagneux; Pascal,12,0,12,0
1745814554126,BENG 196,001,957946,Engler; Adam J.,9996,0,9999,3
1745814555154,CAT 124RS,A01,956906,Staff,8,0,25,17
1745814556182,CAT 125RS,A01,922013,Staff,8,0,25,17
1745814557207,CLRE 250,A00,891860,Morris; Sheldon,9995,0,9999,4
1745814559262,CLRE 251R,A00,907817,Mehta; Ravindra L.,9994,0,9999,5
1745814560287,CLRE 252,A00,891864,Cuomo; Raphael Eduardo,9993,0,9999,6
1745814561316,CLRE 253,A00,891867,Vaida; Florin,9994,0,9999,5
1745814561316,CLRE 253,B00,907819,Staff,9999,0,9999,0
1745814562343,CLRE 259,A00,891868,Patel; Hemal,9998,0,9999,1
1745814563368,CLRE 260,A00,891872,Cuomo; Raphael Eduardo,9999,0,9999,0
1745814564392,CLRE 297,001,891888,Cuomo; Raphael Eduardo,9999,0,9999,0
1745814565419,CSE 191,A00,958773,Minnes Kemp; Mor Mia,9999,0,9999,0
1745814566445,CSS 201S,A01,892054,Mignozzetti; Umberto,30,0,30,0
1745814567474,CSS 202S,A01,892056,Mignozzetti; Umberto,30,0,30,0
1745814568498,DSC 197,001,956898,Eldridge; Justin Matthew,9998,0,9999,1
1745814569524,DSC 297,001,958000,Mazumdar; Arya,9998,0,9999,1
1745814570553,EAP 100,A00,905686,Staff,9776,0,9999,223
1745814571579,ECE 45,A01,892618,Staff,0,12,50,50
1745814572606,ECE 109,A01,892620,Staff,0,43,0,0
1745814573634,ECE 111,A01,892719,Staff,0,8,50,50
1745814574662,ECE 197,001,957920,Mercier; Patrick Philip,9992,0,9999,7
1745814575688,ECON 178,A01,907814,Zhu; Ying,28,0,35,7
1745814576714,EDS 115,A00,895312,Staff,41,0,45,4
1745814577743,EDS 117,A01,895337,Staff,30,0,30,0
1745814578768,EDS 125,A00,895341,Jones; Gabrielle Anastasia,43,0,45,2
1745814579798,EDS 128A,A01,895459,Fargason; Sharon Gayle,44,0,45,1
1745814580823,EDS 128B,A01,895543,Pappas; Elizabeth,44,0,45,1
1745814581892,EDS 139,A00,897203,Pappas; Elizabeth,44,0,45,1
1745814581892,EDS 139,B00,897209,Fargason; Sharon Gayle,44,0,45,1
1745814582918,EDS 201,A00,895545,Staff,43,0,45,2
1745814583944,EDS 203,A01,895581,Halter; Christopher P.,43,0,45,2
1745814584969,EDS 204R,A01,895625,Heinzman; Erica M.,43,0,45,2
1745814584969,EDS 204R,B01,895693,Halter; Christopher P.,18,0,45,27
1745814585995,EDS 206R,A00,895694,Fargason; Sharon Gayle,9,0,30,21
1745814585995,EDS 206R,B00,895695,Choi; Bailey Miyeon,20,0,30,10
1745814587020,EDS 250,A00,895697,Hemans; Patricia Ann Benitez,43,0,45,2
1745814588046,EDS 281,A00,895701,Meyerott; Theresa Ann,15,0,15,0
1745814589075,EDS 284,A00,895736,Meyerott; Theresa Ann,15,0,15,0
1745814590101,EDS 286,A00,897210,Fine; Sarah,15,0,15,0
1745814591127,EDS 289C,A01,895770,Daly; Alan J.,15,0,15,0
1745814592155,EDS 290,A00,897211,Hofstetter; Carolyn,15,0,15,0
1745814593183,LIGM 5A,A00,896162,Fischer-Grunski; Eva K,15,0,20,5
1745814594208,LIGM 5B,A00,896260,Fischer-Grunski; Eva K,17,0,20,3
1745814595233,LIGM 5C,A00,896308,Fischer-Grunski; Eva K,18,0,20,2
1745814596259,LIIT 5AS,A00,896313,Carnelos; Chiara,18,0,20,2
1745814597287,LIIT 5BS,A00,896416,Carnelos; Chiara,20,0,20,0
1745814598313,LIIT 5CS,A00,896564,Carnelos; Chiara,20,0,20,0
1745814599339,LISP 5A,A00,896588,Munoz Sanchez; Alicia,4,0,20,16
1745814600365,LISP 5B,A00,896653,Munoz Sanchez; Alicia,10,0,20,10
1745814601395,LISP 5C,A00,896655,Munoz Sanchez; Alicia,4,0,20,16
1745814602422,MAE 197,001,957918,Kleissl; Jan,9998,0,9999,1
1745814603448,MATH 2,A01,957937,Staff,34,0,35,1
1745814604476,MATH 197,001,957876,Kedlaya; Kiran S.,9993,0,9999,6
1745814605501,MCWP 40,A00,892729,Duru; Nur,13,0,20,7
1745814605501,MCWP 40,B00,893304,Montejo; Carolina,20,0,20,0
1745814606525,MCWP 40R,A00,893757,Redela; Pamela Morgan,0,7,20,20
1745814607551,MCWP 50,A00,893758,Morshed; Michael James,2,0,20,18
1745814607551,MCWP 50,B00,893761,Bartulis; Jason Michael,17,0,20,3
1745814608575,MCWP 50R,A00,893766,Compas; Sean Matthew,0,1,20,20
1745814608575,MCWP 50R,B00,893769,Carter; Jennifer A,0,0,20,20
1745814608575,MCWP 50R,C00,893771,Krone; Jarret,0,3,20,20
1745814608575,MCWP 50R,D00,893772,Miller; Elizabeth Deen,3,0,20,17
1745814608575,MCWP 50R,E00,893775,Carter; Andrea L,0,0,20,20
1745814609602,MMW 11R,A01,892721,Herbst; Matthew,11,0,27,16
1745814609602,MMW 11R,A02,892722,Herbst; Matthew,0,0,0,3
1745814610631,MMW 12R,A01,892724,Herbst; Matthew,0,9,16,16
1745814610631,MMW 12R,A02,892725,Herbst; Matthew,0,9,16,16
1745814611656,MMW 13R,A01,892727,Staff,0,3,16,16
1745814611656,MMW 13R,A02,892728,Staff,0,4,16,16
1745814611656,MMW 13R,A03,958032,Staff,0,3,16,16
1745814611656,MMW 13R,A04,958033,Staff,0,2,16,16
1745814611656,MMW 13R,A05,958034,Staff,0,3,16,16
1745814612683,SIO 295LS,A00,894015,Staff,7,0,25,18
1745814613709,SIO 295S,A00,894020,Staff,7,0,25,18
1745814614735,SIOC 290S,B01,958918,Staff,0,0,0,0
1745814615760,SIOC 291S,B01,958922,Staff,0,0,0,0
1745814616822,SOCI 117,A01,895339,Staff,4,0,5,1
1745814617849,WES 237B,A00,894149,Staff,11,0,20,9
1745814619917,AESE 279B,A00,891859,Staff,13,0,35,22
1745814620945,AIP 197,001,891854,Staff,70,0,70,0
1745814621975,ANTH 289S,A00,891856,Gagneux; Pascal,12,0,12,0
1745814623006,BENG 196,001,957946,Engler; Adam J.,9996,0,9999,3
1745814624031,CAT 124RS,A01,956906,Staff,8,0,25,17
1745814625060,CAT 125RS,A01,922013,Staff,8,0,25,17
1745814626086,CLRE 250,A00,891860,Morris; Sheldon,9995,0,9999,4
1745814628139,CLRE 251R,A00,907817,Mehta; Ravindra L.,9994,0,9999,5
1745814629167,CLRE 252,A00,891864,Cuomo; Raphael Eduardo,9993,0,9999,6
1745814630192,CLRE 253,A00,891867,Vaida; Florin,9994,0,9999,5
1745814630192,CLRE 253,B00,907819,Staff,9999,0,9999,0
1745814631218,CLRE 259,A00,891868,Patel; Hemal,9998,0,9999,1
1745814632243,CLRE 260,A00,891872,Cuomo; Raphael Eduardo,9999,0,9999,0
1745814633269,CLRE 297,001,891888,Cuomo; Raphael Eduardo,9999,0,9999,0
1745814634295,CSE 191,A00,958773,Minnes Kemp; Mor Mia,9999,0,9999,0
1745814635326,CSS 201S,A01,892054,Mignozzetti; Umberto,30,0,30,0
1745814636351,CSS 202S,A01,892056,Mignozzetti; Umberto,30,0,30,0
1745814637379,DSC 197,001,956898,Eldridge; Justin Matthew,9998,0,9999,1
1745814638406,DSC 297,001,958000,Mazumdar; Arya,9998,0,9999,1
1745814639434,EAP 100,A00,905686,Staff,9776,0,9999,223
1745814640462,ECE 45,A01,892618,Staff,0,12,50,50
1745814641492,ECE 109,A01,892620,Staff,0,43,0,0
1745814642520,ECE 111,A01,892719,Staff,0,8,50,50
1745814643552,ECE 197,001,957920,Mercier; Patrick Philip,9992,0,9999,7
1745814644581,ECON 178,A01,907814,Zhu; Ying,28,0,35,7
1745814645607,EDS 115,A00,895312,Staff,41,0,45,4
1745814646632,EDS 117,A01,895337,Staff,30,0,30,0
1745814647658,EDS 125,A00,895341,Jones; Gabrielle Anastasia,43,0,45,2
1745814648686,EDS 128A,A01,895459,Fargason; Sharon Gayle,44,0,45,1
1745814649713,EDS 128B,A01,895543,Pappas; Elizabeth,44,0,45,1
1745814650738,EDS 139,A00,897203,Pappas; Elizabeth,44,0,45,1
1745814650738,EDS 139,B00,897209,Fargason; Sharon Gayle,44,0,45,1
1745814651767,EDS 201,A00,895545,Staff,43,0,45,2
1745814652794,EDS 203,A01,895581,Halter; Christopher P.,43,0,45,2
1745814653825,EDS 204R,A01,895625,Heinzman; Erica M.,43,0,45,2
1745814653825,EDS 204R,B01,895693,Halter; Christopher P.,18,0,45,27
1745814654850,EDS 206R,A00,895694,Fargason; Sharon Gayle,9,0,30,21
1745814654850,EDS 206R,B00,895695,Choi; Bailey Miyeon,20,0,30,10
1745814655876,EDS 250,A00,895697,Hemans; Patricia Ann Benitez,43,0,45,2
1745814656903,EDS 281,A00,895701,Meyerott; Theresa Ann,15,0,15,0
1745814657930,EDS 284,A00,895736,Meyerott; Theresa Ann,15,0,15,0
1745814658960,EDS 286,A00,897210,Fine; Sarah,15,0,15,0
1745814659989,EDS 289C,A01,895770,Daly; Alan J.,15,0,15,0
1745814661016,EDS 290,A00,897211,Hofstetter; Carolyn,15,0,15,0
1745814662041,LIGM 5A,A00,896162,Fischer-Grunski; Eva K,15,0,20,5
1745814663069,LIGM 5B,A00,896260,Fischer-Grunski; Eva K,17,0,20,3
1745814664098,LIGM 5C,A00,896308,Fischer-Grunski; Eva K,18,0,20,2
1745814665125,LIIT 5AS,A00,896313,Carnelos; Chiara,18,0,20,2
1745814666152,LIIT 5BS,A00,896416,Carnelos; Chiara,20,0,20,0
1745814667177,LIIT 5CS,A00,896564,Carnelos; Chiara,20,0,20,0
1745814668206,LISP 5A,A00,896588,Munoz Sanchez; Alicia,4,0,20,16
1745814669234,LISP 5B,A00,896653,Munoz Sanchez; Alicia,10,0,20,10
1745814670260,LISP 5C,A00,896655,Munoz Sanchez; Alicia,4,0,20,16
1745814671292,MAE 197,001,957918,Kleissl; Jan,9998,0,9999,1
1745814672320,MATH 2,A01,957937,Staff,34,0,35,1
1745814673345,MATH 197,001,957876,Kedlaya; Kiran S.,9993,0,9999,6
1745814674371,MCWP 40,A00,892729,Duru; Nur,13,0,20,7
1745814674371,MCWP 40,B00,893304,Montejo; Carolina,20,0,20,0
1745814675402,MCWP 40R,A00,893757,Redela; Pamela Morgan,0,7,20,20
1745814676433,MCWP 50,A00,893758,Morshed; Michael James,2,0,20,18
1745814676433,MCWP 50,B00,893761,Bartulis; Jason Michael,17,0,20,3
1745814677465,MCWP 50R,A00,893766,Compas; Sean Matthew,0,1,20,20
1745814677465,MCWP 50R,B00,893769,Carter; Jennifer A,0,0,20,20
1745814677465,MCWP 50R,C00,893771,Krone; Jarret,0,3,20,20
1745814677465,MCWP 50R,D00,893772,Miller; Elizabeth Deen,3,0,20,17
1745814677465,MCWP 50R,E00,893775,Carter; Andrea L,0,0,20,20
1745814678491,MMW 11R,A01,892721,Herbst; Matthew,11,0,27,16
1745814678491,MMW 11R,A02,892722,Herbst; Matthew,0,0,0,3
1745814679519,MMW 12R,A01,892724,Herbst; Matthew,0,9,16,16
1745814679519,MMW 12R,A02,892725,Herbst; Matthew,0,9,16,16
1745814680547,MMW 13R,A01,892727,Staff,0,3,16,16
1745814680547,MMW 13R,A02,892728,Staff,0,4,16,16
1745814680547,MMW 13R,A03,958032,Staff,0,3,16,16
1745814680547,MMW 13R,A04,958033,Staff,0,2,16,16
1745814680547,MMW 13R,A05,958034,Staff,0,3,16,16
1745814681576,SIO 295LS,A00,894015,Staff,7,0,25,18
1745814682606,SIO 295S,A00,894020,Staff,7,0,25,18
1745814683634,SIOC 290S,B01,958918,Staff,0,0,0,0
1745814684662,SIOC 291S,B01,958922,Staff,0,0,0,0
1745814685689,SOCI 117,A01,895339,Staff,4,0,5,1
1745814686718,WES 237B,A00,894149,Staff,11,0,20,9
1745814688779,AESE 279B,A00,891859,Staff,13,0,35,22
1745814689810,AIP 197,001,891854,Staff,70,0,70,0
1745814690836,ANTH 289S,A00,891856,Gagneux; Pascal,12,0,12,0
1745814691867,BENG 196,001,957946,Engler; Adam J.,9996,0,9999,3
1745814692897,CAT 124RS,A01,956906,Staff,8,0,25,17
1745814693925,CAT 125RS,A01,922013,Staff,8,0,25,17
1745814694957,CLRE 250,A00,891860,Morris; Sheldon,9995,0,9999,4
1745814697010,CLRE 251R,A00,907817,Mehta; Ravindra L.,9994,0,9999,5
1745814698036,CLRE 252,A00,891864,Cuomo; Raphael Eduardo,9993,0,9999,6
1745814699062,CLRE 253,A00,891867,Vaida; Florin,9994,0,9999,5
1745814699062,CLRE 253,B00,907819,Staff,9999,0,9999,0
1745814700090,CLRE 259,A00,891868,Patel; Hemal,9998,0,9999,1
1745814701116,CLRE 260,A00,891872,Cuomo; Raphael Eduardo,9999,0,9999,0
1745814702143,CLRE 297,001,891888,Cuomo; Raphael Eduardo,9999,0,9999,0
1745814703173,CSE 191,A00,958773,Minnes Kemp; Mor Mia,9999,0,9999,0
1745814704200,CSS 201S,A01,892054,Mignozzetti; Umberto,30,0,30,0
1745814705228,CSS 202S,A01,892056,Mignozzetti; Umberto,30,0,30,0
1745814706254,DSC 197,001,956898,Eldridge; Justin Matthew,9998,0,9999,1
1745814707280,DSC 297,001,958000,Mazumdar; Arya,9998,0,9999,1
1745814708310,EAP 100,A00,905686,Staff,9776,0,9999,223
1745814709341,ECE 45,A01,892618,Staff,0,12,50,50
1745814710367,ECE 109,A01,892620,Staff,0,43,0,0
1745814711393,ECE 111,A01,892719,Staff,0,8,50,50
1745814712420,ECE 197,001,957920,Mercier; Patrick Philip,9992,0,9999,7
1745814713446,ECON 178,A01,907814,Zhu; Ying,28,0,35,7
1745814714475,EDS 115,A00,895312,Staff,41,0,45,4
1745814715500,EDS 117,A01,895337,Staff,30,0,30,0
1745814716527,EDS 125,A00,895341,Jones; Gabrielle Anastasia,43,0,45,2
1745814717557,EDS 128A,A01,895459,Fargason; Sharon Gayle,44,0,45,1
1745814718583,EDS 128B,A01,895543,Pappas; Elizabeth,44,0,45,1
1745814719612,EDS 139,A00,897203,Pappas; Elizabeth,44,0,45,1
1745814719612,EDS 139,B00,897209,Fargason; Sharon Gayle,44,0,45,1
1745814720642,EDS 201,A00,895545,Staff,43,0,45,2
1745814721667,EDS 203,A01,895581,Halter; Christopher P.,43,0,45,2
1745814722692,EDS 204R,A01,895625,Heinzman; Erica M.,43,0,45,2
1745814722692,EDS 204R,B01,895693,Halter; Christopher P.,18,0,45,27
1745814723724,EDS 206R,A00,895694,Fargason; Sharon Gayle,9,0,30,21
1745814723724,EDS 206R,B00,895695,Choi; Bailey Miyeon,20,0,30,10
1745814724753,EDS 250,A00,895697,Hemans; Patricia Ann Benitez,43,0,45,2
1745814725778,EDS 281,A00,895701,Meyerott; Theresa Ann,15,0,15,0
1745814726806,EDS 284,A00,895736,Meyerott; Theresa Ann,15,0,15,0
1745814727833,EDS 286,A00,897210,Fine; Sarah,15,0,15,0
1745814728861,EDS 289C,A01,895770,Daly; Alan J.,15,0,15,0
1745814729888,EDS 290,A00,897211,Hofstetter; Carolyn,15,0,15,0
1745814730919,LIGM 5A,A00,896162,Fischer-Grunski; Eva K,15,0,20,5
1745814731945,LIGM 5B,A00,896260,Fischer-Grunski; Eva K,17,0,20,3
1745814732976,LIGM 5C,A00,896308,Fischer-Grunski; Eva K,18,0,20,2
1745814734006,LIIT 5AS,A00,896313,Carnelos; Chiara,18,0,20,2
1745814735047,LIIT 5BS,A00,896416,Carnelos; Chiara,20,0,20,0
1745814736072,LIIT 5CS,A00,896564,Carnelos; Chiara,20,0,20,0
1745814737102,LISP 5A,A00,896588,Munoz Sanchez; Alicia,4,0,20,16
1745814738129,LISP 5B,A00,896653,Munoz Sanchez; Alicia,10,0,20,10
1745814739157,LISP 5C,A00,896655,Munoz Sanchez; Alicia,4,0,20,16
1745814740185,MAE 197,001,957918,Kleissl; Jan,9998,0,9999,1
1745814741211,MATH 2,A01,957937,Staff,34,0,35,1
1745814742239,MATH 197,001,957876,Kedlaya; Kiran S.,9993,0,9999,6
1745814743265,MCWP 40,A00,892729,Duru; Nur,13,0,20,7
1745814743265,MCWP 40,B00,893304,Montejo; Carolina,20,0,20,0
1745814744292,MCWP 40R,A00,893757,Redela; Pamela Morgan,0,7,20,20
1745814745523,MCWP 50,A00,893758,Morshed; Michael James,2,0,20,18
1745814745523,MCWP 50,B00,893761,Bartulis; Jason Michael,17,0,20,3
1745814746556,MCWP 50R,A00,893766,Compas; Sean Matthew,0,1,20,20
1745814746556,MCWP 50R,B00,893769,Carter; Jennifer A,0,0,20,20
1745814746556,MCWP 50R,C00,893771,Krone; Jarret,0,3,20,20
1745814746556,MCWP 50R,D00,893772,Miller; Elizabeth Deen,3,0,20,17
1745814746556,MCWP 50R,E00,893775,Carter; Andrea L,0,0,20,20
1745814747585,MMW 11R,A01,892721,Herbst; Matthew,11,0,27,16
1745814747585,MMW 11R,A02,892722,Herbst; Matthew,0,0,0,3
1745814748609,MMW 12R,A01,892724,Herbst; Matthew,0,10,16,16
1745814748609,MMW 12R,A02,892725,Herbst; Matthew,0,9,16,16
1745814749639,MMW 13R,A01,892727,Staff,0,3,16,16
1745814749639,MMW 13R,A02,892728,Staff,0,4,16,16
1745814749639,MMW 13R,A03,958032,Staff,0,3,16,16
1745814749639,MMW 13R,A04,958033,Staff,0,2,16,16
1745814749639,MMW 13R,A05,958034,Staff,0,3,16,16
1745814750665,SIO 295LS,A00,894015,Staff,7,0,25,18
1745814751694,SIO 295S,A00,894020,Staff,7,0,25,18
1745814752723,SIOC 290S,B01,958918,Staff,0,0,0,0
1745814753750,SIOC 291S,B01,958922,Staff,0,0,0,0
1745814754779,SOCI 117,A01,895339,Staff,4,0,5,1
1745814755809,WES 237B,A00,894149,Staff,11,0,20,9
1745814757886,AESE 279B,A00,891859,Staff,13,0,35,22
1745814758912,AIP 197,001,891854,Staff,70,0,70,0
1745814759943,ANTH 289S,A00,891856,Gagneux; Pascal,12,0,12,0
1745814760972,BENG 196,001,957946,Engler; Adam J.,9996,0,9999,3
1745814761998,CAT 124RS,A01,956906,Staff,8,0,25,17
1745814763025,CAT 125RS,A01,922013,Staff,8,0,25,17
1745814764050,CLRE 250,A00,891860,Morris; Sheldon,9995,0,9999,4
1745814766103,CLRE 251R,A00,907817,Mehta; Ravindra L.,9994,0,9999,5
1745814767129,CLRE 252,A00,891864,Cuomo; Raphael Eduardo,9993,0,9999,6
1745814768156,CLRE 253,A00,891867,Vaida; Florin,9994,0,9999,5
1745814768156,CLRE 253,B00,907819,Staff,9999,0,9999,0
1745814769181,CLRE 259,A00,891868,Patel; Hemal,9998,0,9999,1
1745814770211,CLRE 260,A00,891872,Cuomo; Raphael Eduardo,9999,0,9999,0
1745814771235,CLRE 297,001,891888,Cuomo; Raphael Eduardo,9999,0,9999,0
1745814772264,CSE 191,A00,958773,Minnes Kemp; Mor Mia,9999,0,9999,0
1745814773291,CSS 201S,A01,892054,Mignozzetti; Umberto,30,0,30,0
1745814774317,CSS 202S,A01,892056,Mignozzetti; Umberto,30,0,30,0
1745814775348,DSC 197,001,956898,Eldridge; Justin Matthew,9998,0,9999,1
1745814776378,DSC 297,001,958000,Mazumdar; Arya,9998,0,9999,1
1745814777404,EAP 100,A00,905686,Staff,9776,0,9999,223
1745814778431,ECE 45,A01,892618,Staff,0,12,50,50
1745814779457,ECE 109,A01,892620,Staff,0,43,0,0
1745814780481,ECE 111,A01,892719,Staff,0,8,50,50
1745814781508,ECE 197,001,957920,Mercier; Patrick Philip,9992,0,9999,7
1745814782533,ECON 178,A01,907814,Zhu; Ying,28,0,35,7
1745814783559,EDS 115,A00,895312,Staff,41,0,45,4
1745814784590,EDS 117,A01,895337,Staff,30,0,30,0
1745814785617,EDS 125,A00,895341,Jones; Gabrielle Anastasia,43,0,45,2
1745814786644,EDS 128A,A01,895459,Fargason; Sharon Gayle,44,0,45,1
1745814787673,EDS 128B,A01,895543,Pappas; Elizabeth,44,0,45,1
1745814788700,EDS 139,A00,897203,Pappas; Elizabeth,44,0,45,1
1745814788700,EDS 139,B00,897209,Fargason; Sharon Gayle,44,0,45,1
1745814789726,EDS 201,A00,895545,Staff,43,0,45,2
1745814790755,EDS 203,A01,895581,Halter; Christopher P.,43,0,45,2
1745814791786,EDS 204R,A01,895625,Heinzman; Erica M.,43,0,45,2
1745814791786,EDS 204R,B01,895693,Halter; Christopher P.,18,0,45,27
1745814792812,EDS 206R,A00,895694,Fargason; Sharon Gayle,9,0,30,21
1745814792812,EDS 206R,B00,895695,Choi; Bailey Miyeon,20,0,30,10
1745814793839,EDS 250,A00,895697,Hemans; Patricia Ann Benitez,43,0,45,2
1745814794868,EDS 281,A00,895701,Meyerott; Theresa Ann,15,0,15,0
1745814795896,EDS 284,A00,895736,Meyerott; Theresa Ann,15,0,15,0
1745814796926,EDS 286,A00,897210,Fine; Sarah,15,0,15,0
1745814797952,EDS 289C,A01,895770,Daly; Alan J.,15,0,15,0
1745814798978,EDS 290,A00,897211,Hofstetter; Carolyn,15,0,15,0
1745814800005,LIGM 5A,A00,896162,Fischer-Grunski; Eva K,15,0,20,5
1745814801032,LIGM 5B,A00,896260,Fischer-Grunski; Eva K,17,0,20,3
1745814802059,LIGM 5C,A00,896308,Fischer-Grunski; Eva K,18,0,20,2
1745814803083,LIIT 5AS,A00,896313,Carnelos; Chiara,18,0,20,2
1745814804112,LIIT 5BS,A00,896416,Carnelos; Chiara,20,0,20,0
1745814805139,LIIT 5CS,A00,896564,Carnelos; Chiara,20,0,20,0
1745814806164,LISP 5A,A00,896588,Munoz Sanchez; Alicia,4,0,20,16
1745814807190,LISP 5B,A00,896653,Munoz Sanchez; Alicia,10,0,20,10
1745814808218,LISP 5C,A00,896655,Munoz Sanchez; Alicia,4,0,20,16
1745814809242,MAE 197,001,957918,Kleissl; Jan,9998,0,9999,1
1745814810269,MATH 2,A01,957937,Staff,34,0,35,1
1745814811297,MATH 197,001,957876,Kedlaya; Kiran S.,9993,0,9999,6
1745814812324,MCWP 40,A00,892729,Duru; Nur,13,0,20,7
1745814812324,MCWP 40,B00,893304,Montejo; Carolina,20,0,20,0
1745814813350,MCWP 40R,A00,893757,Redela; Pamela Morgan,0,7,20,20
1745814814376,MCWP 50,A00,893758,Morshed; Michael James,2,0,20,18
1745814814376,MCWP 50,B00,893761,Bartulis; Jason Michael,17,0,20,3
1745814815408,MCWP 50R,A00,893766,Compas; Sean Matthew,0,1,20,20
1745814815408,MCWP 50R,B00,893769,Carter; Jennifer A,0,0,20,20
1745814815408,MCWP 50R,C00,893771,Krone; Jarret,0,3,20,20
1745814815408,MCWP 50R,D00,893772,Miller; Elizabeth Deen,3,0,20,17
1745814815408,MCWP 50R,E00,893775,Carter; Andrea L,0,0,20,20
1745814816433,MMW 11R,A01,892721,Herbst; Matthew,11,0,27,16
1745814816433,MMW 11R,A02,892722,Herbst; Matthew,0,0,0,3
1745814817508,MMW 12R,A01,892724,Herbst; Matthew,0,10,16,16
1745814817508,MMW 12R,A02,892725,Herbst; Matthew,0,9,16,16
1745814818536,MMW 13R,A01,892727,Staff,0,3,16,16
1745814818536,MMW 13R,A02,892728,Staff,0,4,16,16
1745814818536,MMW 13R,A03,958032,Staff,0,3,16,16
1745814818536,MMW 13R,A04,958033,Staff,0,2,16,16
1745814818536,MMW 13R,A05,958034,Staff,0,3,16,16
1745814819568,SIO 295LS,A00,894015,Staff,7,0,25,18
1745814820594,SIO 295S,A00,894020,Staff,7,0,25,18
1745814821622,SIOC 290S,B01,958918,Staff,0,0,0,0
1745814822648,SIOC 291S,B01,958922,Staff,0,0,0,0
1745814823676,SOCI 117,A01,895339,Staff,4,0,5,1
1745814824706,WES 237B,A00,894149,Staff,11,0,20,9
1745814826774,AESE 279B,A00,891859,Staff,13,0,35,22
1745814827804,AIP 197,001,891854,Staff,70,0,70,0
1745814828834,ANTH 289S,A00,891856,Gagneux; Pascal,12,0,12,0
1745814829861,BENG 196,001,957946,Engler; Adam J.,9996,0,9999,3
1745814830889,CAT 124RS,A01,956906,Staff,8,0,25,17
1745814831915,CAT 125RS,A01,922013,Staff,8,0,25,17
1745814832942,CLRE 250,A00,891860,Morris; Sheldon,9995,0,9999,4
1745814835017,CLRE 251R,A00,907817,Mehta; Ravindra L.,9994,0,9999,5
1745814836046,CLRE 252,A00,891864,Cuomo; Raphael Eduardo,9993,0,9999,6
1745814837073,CLRE 253,A00,891867,Vaida; Florin,9994,0,9999,5
1745814837073,CLRE 253,B00,907819,Staff,9999,0,9999,0
1745814838097,CLRE 259,A00,891868,Patel; Hemal,9998,0,9999,1
1745814839127,CLRE 260,A00,891872,Cuomo; Raphael Eduardo,9999,0,9999,0
1745814840153,CLRE 297,001,891888,Cuomo; Raphael Eduardo,9999,0,9999,0
1745814841180,CSE 191,A00,958773,Minnes Kemp; Mor Mia,9999,0,9999,0
1745814842205,CSS 201S,A01,892054,Mignozzetti; Umberto,30,0,30,0
1745814843238,CSS 202S,A01,892056,Mignozzetti; Umberto,30,0,30,0
1745814844267,DSC 197,001,956898,Eldridge; Justin Matthew,9998,0,9999,1
1745814845294,DSC 297,001,958000,Mazumdar; Arya,9998,0,9999,1
1745814846324,EAP 100,A00,905686,Staff,9776,0,9999,223
1745814847351,ECE 45,A01,892618,Staff,0,12,50,50
1745814848377,ECE 109,A01,892620,Staff,0,43,0,0
1745814849404,ECE 111,A01,892719,Staff,0,8,50,50
1745814850431,ECE 197,001,957920,Mercier; Patrick Philip,9992,0,9999,7
1745814851460,ECON 178,A01,907814,Zhu; Ying,28,0,35,7
1745814852488,EDS 115,A00,895312,Staff,41,0,45,4
1745814853521,EDS 117,A01,895337,Staff,30,0,30,0
1745814854549,EDS 125,A00,895341,Jones; Gabrielle Anastasia,43,0,45,2
1745814855579,EDS 128A,A01,895459,Fargason; Sharon Gayle,44,0,45,1
1745814856605,EDS 128B,A01,895543,Pappas; Elizabeth,44,0,45,1
1745814857633,EDS 139,A00,897203,Pappas; Elizabeth,44,0,45,1
1745814857633,EDS 139,B00,897209,Fargason; Sharon Gayle,44,0,45,1
1745814858658,EDS 201,A00,895545,Staff,43,0,45,2
1745814859685,EDS 203,A01,895581,Halter; Christopher P.,43,0,45,2
1745814860712,EDS 204R,A01,895625,Heinzman; Erica M.,43,0,45,2
1745814860712,EDS 204R,B01,895693,Halter; Christopher P.,18,0,45,27
1745814861746,EDS 206R,A00,895694,Fargason; Sharon Gayle,9,0,30,21
1745814861746,EDS 206R,B00,895695,Choi; Bailey Miyeon,20,0,30,10
1745814862774,EDS 250,A00,895697,Hemans; Patricia Ann Benitez,43,0,45,2
1745814863799,EDS 281,A00,895701,Meyerott; Theresa Ann,15,0,15,0
1745814864829,EDS 284,A00,895736,Meyerott; Theresa Ann,15,0,15,0
1745814865855,EDS 286,A00,897210,Fine; Sarah,15,0,15,0
1745814866886,EDS 289C,A01,895770,Daly; Alan J.,15,0,15,0
1745814867913,EDS 290,A00,897211,Hofstetter; Carolyn,15,0,15,0
1745814868939,LIGM 5A,A00,896162,Fischer-Grunski; Eva K,15,0,20,5
1745814869970,LIGM 5B,A00,896260,Fischer-Grunski; Eva K,17,0,20,3
1745814870997,LIGM 5C,A00,896308,Fischer-Grunski; Eva K,18,0,20,2
1745814872028,LIIT 5AS,A00,896313,Carnelos; Chiara,18,0,20,2
1745814873052,LIIT 5BS,A00,896416,Carnelos; Chiara,20,0,20,0
1745814874078,LIIT 5CS,A00,896564,Carnelos; Chiara,20,0,20,0
1745814875104,LISP 5A,A00,896588,Munoz Sanchez; Alicia,4,0,20,16
1745814876135,LISP 5B,A00,896653,Munoz Sanchez; Alicia,10,0,20,10
1745814877163,LISP 5C,A00,896655,Munoz Sanchez; Alicia,4,0,20,16
1745814878189,MAE 197,001,957918,Kleissl; Jan,9998,0,9999,1
1745814879216,MATH 2,A01,957937,Staff,34,0,35,1
1745814880242,MATH 197,001,957876,Kedlaya; Kiran S.,9993,0,9999,6
1745814881267,MCWP 40,A00,892729,Duru; Nur,13,0,20,7
1745814881267,MCWP 40,B00,893304,Montejo; Carolina,20,0,20,0
1745814882296,MCWP 40R,A00,893757,Redela; Pamela Morgan,0,7,20,20
1745814883324,MCWP 50,A00,893758,Morshed; Michael James,2,0,20,18
1745814883324,MCWP 50,B00,893761,Bartulis; Jason Michael,17,0,20,3
1745814884353,MCWP 50R,A00,893766,Compas; Sean Matthew,0,1,20,20
1745814884353,MCWP 50R,B00,893769,Carter; Jennifer A,0,0,20,20
1745814884353,MCWP 50R,C00,893771,Krone; Jarret,0,3,20,20
1745814884353,MCWP 50R,D00,893772,Miller; Elizabeth Deen,3,0,20,17
1745814884353,MCWP 50R,E00,893775,Carter; Andrea L,0,0,20,20
1745814885385,MMW 11R,A01,892721,Herbst; Matthew,11,0,27,16
1745814885385,MMW 11R,A02,892722,Herbst; Matthew,0,0,0,3
1745814886413,MMW 12R,A01,892724,Herbst; Matthew,0,10,16,16
1745814886413,MMW 12R,A02,892725,Herbst; Matthew,0,9,16,16
1745814887443,MMW 13R,A01,892727,Staff,0,3,16,16
1745814887443,MMW 13R,A02,892728,Staff,0,4,16,16
1745814887443,MMW 13R,A03,958032,Staff,0,3,16,16
1745814887443,MMW 13R,A04,958033,Staff,0,2,16,16
1745814887443,MMW 13R,A05,958034,Staff,0,3,16,16
1745814888470,SIO 295LS,A00,894015,Staff,7,0,25,18
1745814889497,SIO 295S,A00,894020,Staff,7,0,25,18
1745814890523,SIOC 290S,B01,958918,Staff,0,0,0,0
1745814891551,SIOC 291S,B01,958922,Staff,0,0,0,0
1745814892580,SOCI 117,A01,895339,Staff,4,0,5,1
1745814893607,WES 237B,A00,894149,Staff,11,0,20,9
1745814895680,AESE 279B,A00,891859,Staff,13,0,35,22
1745814896707,AIP 197,001,891854,Staff,70,0,70,0
1745814897734,ANTH 289S,A00,891856,Gagneux; Pascal,12,0,12,0
1745814898759,BENG 196,001,957946,Engler; Adam J.,9996,0,9999,3
1745814899787,CAT 124RS,A01,956906,Staff,8,0,25,17
1745814900816,CAT 125RS,A01,922013,Staff,8,0,25,17
1745814901843,CLRE 250,A00,891860,Morris; Sheldon,9995,0,9999,4
1745814903895,CLRE 251R,A00,907817,Mehta; Ravindra L.,9994,0,9999,5
1745814904925,CLRE 252,A00,891864,Cuomo; Raphael Eduardo,9993,0,9999,6
1745814905956,CLRE 253,A00,891867,Vaida; Florin,9994,0,9999,5
1745814905956,CLRE 253,B00,907819,Staff,9999,0,9999,0
1745814906984,CLRE 259,A00,891868,Patel; Hemal,9998,0,9999,1
1745814908014,CLRE 260,A00,891872,Cuomo; Raphael Eduardo,9999,0,9999,0
1745814909039,CLRE 297,001,891888,Cuomo; Raphael Eduardo,9999,0,9999,0
1745814910067,CSE 191,A00,958773,Minnes Kemp; Mor Mia,9999,0,9999,0
1745814911093,CSS 201S,A01,892054,Mignozzetti; Umberto,30,0,30,0
1745814912121,CSS 202S,A01,892056,Mignozzetti; Umberto,30,0,30,0
1745814913147,DSC 197,001,956898,Eldridge; Justin Matthew,9998,0,9999,1
1745814914174,DSC 297,001,958000,Mazumdar; Arya,9998,0,9999,1
1745814915205,EAP 100,A00,905686,Staff,9776,0,9999,223
1745814916257,ECE 45,A01,892618,Staff,0,12,50,50
1745814917286,ECE 109,A01,892620,Staff,0,43,0,0
1745814918315,ECE 111,A01,892719,Staff,0,8,50,50
1745814919341,ECE 197,001,957920,Mercier; Patrick Philip,9992,0,9999,7
1745814920374,ECON 178,A01,907814,Zhu; Ying,28,0,35,7
1745814921400,EDS 115,A00,895312,Staff,41,0,45,4
1745814922429,EDS 117,A01,895337,Staff,30,0,30,0
1745814923460,EDS 125,A00,895341,Jones; Gabrielle Anastasia,43,0,45,2
1745814924488,EDS 128A,A01,895459,Fargason; Sharon Gayle,44,0,45,1
1745814925518,EDS 128B,A01,895543,Pappas; Elizabeth,44,0,45,1
1745814926544,EDS 139,A00,897203,Pappas; Elizabeth,44,0,45,1
1745814926544,EDS 139,B00,897209,Fargason; Sharon Gayle,44,0,45,1
1745814927570,EDS 201,A00,895545,Staff,43,0,45,2
1745814928595,EDS 203,A01,895581,Halter; Christopher P.,43,0,45,2
1745814929626,EDS 204R,A01,895625,Heinzman; Erica M.,43,0,45,2
1745814929626,EDS 204R,B01,895693,Halter; Christopher P.,18,0,45,27
1745814930653,EDS 206R,A00,895694,Fargason; Sharon Gayle,9,0,30,21
1745814930653,EDS 206R,B00,895695,Choi; Bailey Miyeon,20,0,30,10
1745814931679,EDS 250,A00,895697,Hemans; Patricia Ann Benitez,43,0,45,2
1745814932710,EDS 281,A00,895701,Meyerott; Theresa Ann,15,0,15,0
1745814933735,EDS 284,A00,895736,Meyerott; Theresa Ann,15,0,15,0
1745814934764,EDS 286,A00,897210,Fine; Sarah,15,0,15,0
1745814935790,EDS 289C,A01,895770,Daly; Alan J.,15,0,15,0
1745814936815,EDS 290,A00,897211,Hofstetter; Carolyn,15,0,15,0
1745814937842,LIGM 5A,A00,896162,Fischer-Grunski; Eva K,15,0,20,5
1745814938868,LIGM 5B,A00,896260,Fischer-Grunski; Eva K,17,0,20,3
1745814939900,LIGM 5C,A00,896308,Fischer-Grunski; Eva K,18,0,20,2
1745814940928,LIIT 5AS,A00,896313,Carnelos; Chiara,18,0,20,2
1745814941954,LIIT 5BS,A00,896416,Carnelos; Chiara,20,0,20,0
1745814942987,LIIT 5CS,A00,896564,Carnelos; Chiara,20,0,20,0
1745814944013,LISP 5A,A00,896588,Munoz Sanchez; Alicia,4,0,20,16
1745814945042,LISP 5B,A00,896653,Munoz Sanchez; Alicia,10,0,20,10
1745814946068,LISP 5C,A00,896655,Munoz Sanchez; Alicia,4,0,20,16
1745814947097,MAE 197,001,957918,Kleissl; Jan,9998,0,9999,1
1745814948127,MATH 2,A01,957937,Staff,34,0,35,1
1745814949153,MATH 197,001,957876,Kedlaya; Kiran S.,9993,0,9999,6
1745814950181,MCWP 40,A00,892729,Duru; Nur,13,0,20,7
1745814950181,MCWP 40,B00,893304,Montejo; Carolina,20,0,20,0
1745814951206,MCWP 40R,A00,893757,Redela; Pamela Morgan,0,7,20,20
1745814952236,MCWP 50,A00,893758,Morshed; Michael James,2,0,20,18
1745814952236,MCWP 50,B00,893761,Bartulis; Jason Michael,17,0,20,3
1745814953265,MCWP 50R,A00,893766,Compas; Sean Matthew,0,1,20,20
1745814953265,MCWP 50R,B00,893769,Carter; Jennifer A,0,0,20,20
1745814953265,MCWP 50R,C00,893771,Krone; Jarret,0,3,20,20
1745814953265,MCWP 50R,D00,893772,Miller; Elizabeth Deen,3,0,20,17
1745814953265,MCWP 50R,E00,893775,Carter; Andrea L,0,0,20,20
1745814954295,MMW 11R,A01,892721,Herbst; Matthew,11,0,27,16
1745814954295,MMW 11R,A02,892722,Herbst; Matthew,0,0,0,3
1745814955322,MMW 12R,A01,892724,Herbst; Matthew,0,10,16,16
1745814955322,MMW 12R,A02,892725,Herbst; Matthew,0,9,16,16
1745814956349,MMW 13R,A01,892727,Staff,0,3,16,16
1745814956349,MMW 13R,A02,892728,Staff,0,4,16,16
1745814956349,MMW 13R,A03,958032,Staff,0,3,16,16
1745814956349,MMW 13R,A04,958033,Staff,0,2,16,16
1745814956349,MMW 13R,A05,958034,Staff,0,3,16,16
1745814957376,SIO 295LS,A00,894015,Staff,7,0,25,18
1745814958403,SIO 295S,A00,894020,Staff,7,0,25,18
1745814959431,SIOC 290S,B01,958918,Staff,0,0,0,0
1745814960459,SIOC 291S,B01,958922,Staff,0,0,0,0
1745814961484,SOCI 117,A01,895339,Staff,4,0,5,1
1745814962514,WES 237B,A00,894149,Staff,11,0,20,9
1745814964575,AESE 279B,A00,891859,Staff,13,0,35,22
1745814965601,AIP 197,001,891854,Staff,70,0,70,0
1745814966630,ANTH 289S,A00,891856,Gagneux; Pascal,12,0,12,0
1745814967661,BENG 196,001,957946,Engler; Adam J.,9996,0,9999,3
1745814968690,CAT 124RS,A01,956906,Staff,8,0,25,17
1745814969718,CAT 125RS,A01,922013,Staff,8,0,25,17
1745814970749,CLRE 250,A00,891860,Morris; Sheldon,9995,0,9999,4
1745814972806,CLRE 251R,A00,907817,Mehta; Ravindra L.,9994,0,9999,5
1745814973836,CLRE 252,A00,891864,Cuomo; Raphael Eduardo,9993,0,9999,6
1745814974866,CLRE 253,A00,891867,Vaida; Florin,9994,0,9999,5
1745814974866,CLRE 253,B00,907819,Staff,9999,0,9999,0
1745814975896,CLRE 259,A00,891868,Patel; Hemal,9998,0,9999,1
1745814976923,CLRE 260,A00,891872,Cuomo; Raphael Eduardo,9999,0,9999,0
1745814977948,CLRE 297,001,891888,Cuomo; Raphael Eduardo,9999,0,9999,0
1745814978973,CSE 191,A00,958773,Minnes Kemp; Mor Mia,9999,0,9999,0
1745814980000,CSS 201S,A01,892054,Mignozzetti; Umberto,30,0,30,0
1745814981027,CSS 202S,A01,892056,Mignozzetti; Umberto,30,0,30,0
1745814982053,DSC 197,001,956898,Eldridge; Justin Matthew,9998,0,9999,1
1745814983078,DSC 297,001,958000,Mazumdar; Arya,9998,0,9999,1
1745814984104,EAP 100,A00,905686,Staff,9776,0,9999,223
1745814985137,ECE 45,A01,892618,Staff,0,12,50,50
1745814986164,ECE 109,A01,892620,Staff,0,43,0,0
1745814987196,ECE 111,A01,892719,Staff,0,8,50,50
1745814988223,ECE 197,001,957920,Mercier; Patrick Philip,9992,0,9999,7
1745814989252,ECON 178,A01,907814,Zhu; Ying,28,0,35,7
1745814990279,EDS 115,A00,895312,Staff,41,0,45,4
1745814991305,EDS 117,A01,895337,Staff,30,0,30,0
1745814992335,EDS 125,A00,895341,Jones; Gabrielle Anastasia,43,0,45,2
1745814993362,EDS 128A,A01,895459,Fargason; Sharon Gayle,44,0,45,1
1745814994392,EDS 128B,A01,895543,Pappas; Elizabeth,44,0,45,1
1745814995421,EDS 139,A00,897203,Pappas; Elizabeth,44,0,45,1
1745814995421,EDS 139,B00,897209,Fargason; Sharon Gayle,44,0,45,1
1745814996448,EDS 201,A00,895545,Staff,43,0,45,2
1745814997473,EDS 203,A01,895581,Halter; Christopher P.,43,0,45,2
1745814998504,EDS 204R,A01,895625,Heinzman; Erica M.,43,0,45,2
1745814998504,EDS 204R,B01,895693,Halter; Christopher P.,18,0,45,27
1745814999535,EDS 206R,A00,895694,Fargason; Sharon Gayle,9,0,30,21
1745814999535,EDS 206R,B00,895695,Choi; Bailey Miyeon,20,0,30,10
1745815000561,EDS 250,A00,895697,Hemans; Patricia Ann Benitez,43,0,45,2
1745815001588,EDS 281,A00,895701,Meyerott; Theresa Ann,15,0,15,0
1745815002616,EDS 284,A00,895736,Meyerott; Theresa Ann,15,0,15,0
1745815003644,EDS 286,A00,897210,Fine; Sarah,15,0,15,0
1745815004672,EDS 289C,A01,895770,Daly; Alan J.,15,0,15,0
1745815005700,EDS 290,A00,897211,Hofstetter; Carolyn,15,0,15,0
1745815006729,LIGM 5A,A00,896162,Fischer-Grunski; Eva K,15,0,20,5
1745815007757,LIGM 5B,A00,896260,Fischer-Grunski; Eva K,17,0,20,3
1745815008787,LIGM 5C,A00,896308,Fischer-Grunski; Eva K,18,0,20,2
1745815009817,LIIT 5AS,A00,896313,Carnelos; Chiara,18,0,20,2
1745815010844,LIIT 5BS,A00,896416,Carnelos; Chiara,20,0,20,0
1745815011872,LIIT 5CS,A00,896564,Carnelos; Chiara,20,0,20,0
1745815012898,LISP 5A,A00,896588,Munoz Sanchez; Alicia,4,0,20,16
1745815013923,LISP 5B,A00,896653,Munoz Sanchez; Alicia,10,0,20,10
1745815014948,LISP 5C,A00,896655,Munoz Sanchez; Alicia,4,0,20,16
1745815015974,MAE 197,001,957918,Kleissl; Jan,9998,0,9999,1
1745815017002,MATH 2,A01,957937,Staff,34,0,35,1
1745815018031,MATH 197,001,957876,Kedlaya; Kiran S.,9993,0,9999,6
1745815019061,MCWP 40,A00,892729,Duru; Nur,13,0,20,7
1745815019061,MCWP 40,B00,893304,Montejo; Carolina,20,0,20,0
1745815020091,MCWP 40R,A00,893757,Redela; Pamela Morgan,0,7,20,20
1745815021118,MCWP 50,A00,893758,Morshed; Michael James,2,0,20,18
1745815021118,MCWP 50,B00,893761,Bartulis; Jason Michael,17,0,20,3
1745815022147,MCWP 50R,A00,893766,Compas; Sean Matthew,0,1,20,20
1745815022147,MCWP 50R,B00,893769,Carter; Jennifer A,0,0,20,20
1745815022147,MCWP 50R,C00,893771,Krone; Jarret,0,3,20,20
1745815022147,MCWP 50R,D00,893772,Miller; Elizabeth Deen,3,0,20,17
1745815022147,MCWP 50R,E00,893775,Carter; Andrea L,0,0,20,20
1745815023179,MMW 11R,A01,892721,Herbst; Matthew,11,0,27,16
1745815023179,MMW 11R,A02,892722,Herbst; Matthew,0,0,0,3
1745815024205,MMW 12R,A01,892724,Herbst; Matthew,0,10,16,16
1745815024205,MMW 12R,A02,892725,Herbst; Matthew,0,9,16,16
1745815025235,MMW 13R,A01,892727,Staff,0,3,16,16
1745815025235,MMW 13R,A02,892728,Staff,0,4,16,16
1745815025235,MMW 13R,A03,958032,Staff,0,3,16,16
1745815025235,MMW 13R,A04,958033,Staff,0,2,16,16
1745815025235,MMW 13R,A05,958034,Staff,0,3,16,16
1745815026264,SIO 295LS,A00,894015,Staff,7,0,25,18
1745815027289,SIO 295S,A00,894020,Staff,7,0,25,18
1745815028316,SIOC 290S,B01,958918,Staff,0,0,0,0
1745815029345,SIOC 291S,B01,958922,Staff,0,0,0,0
1745815030370,SOCI 117,A01,895339,Staff,4,0,5,1
1745815031399,WES 237B,A00,894149,Staff,11,0,20,9
1745815033465,AESE 279B,A00,891859,Staff,13,0,35,22
1745815034490,AIP 197,001,891854,Staff,70,0,70,0
1745815035520,ANTH 289S,A00,891856,Gagneux; Pascal,12,0,12,0
1745815036546,BENG 196,001,957946,Engler; Adam J.,9996,0,9999,3
1745815037572,CAT 124RS,A01,956906,Staff,8,0,25,17
1745815038600,CAT 125RS,A01,922013,Staff,8,0,25,17
1745815039625,CLRE 250,A00,891860,Morris; Sheldon,9995,0,9999,4
1745815041680,CLRE 251R,A00,907817,Mehta; Ravindra L.,9994,0,9999,5
1745815042706,CLRE 252,A00,891864,Cuomo; Raphael Eduardo,9993,0,9999,6
1745815043737,CLRE 253,A00,891867,Vaida; Florin,9994,0,9999,5
1745815043737,CLRE 253,B00,907819,Staff,9999,0,9999,0
1745815044762,CLRE 259,A00,891868,Patel; Hemal,9998,0,9999,1
1745815045788,CLRE 260,A00,891872,Cuomo; Raphael Eduardo,9999,0,9999,0
1745815046817,CLRE 297,001,891888,Cuomo; Raphael Eduardo,9999,0,9999,0
1745815047845,CSE 191,A00,958773,Minnes Kemp; Mor Mia,9999,0,9999,0
1745815048873,CSS 201S,A01,892054,Mignozzetti; Umberto,30,0,30,0
1745815049899,CSS 202S,A01,892056,Mignozzetti; Umberto,30,0,30,0
1745815050926,DSC 197,001,956898,Eldridge; Justin Matthew,9998,0,9999,1
1745815051953,DSC 297,001,958000,Mazumdar; Arya,9998,0,9999,1
1745815052978,EAP 100,A00,905686,Staff,9776,0,9999,223
1745815054008,ECE 45,A01,892618,Staff,0,12,50,50
1745815055039,ECE 109,A01,892620,Staff,0,43,0,0
1745815056069,ECE 111,A01,892719,Staff,0,8,50,50
1745815057094,ECE 197,001,957920,Mercier; Patrick Philip,9992,0,9999,7
1745815058126,ECON 178,A01,907814,Zhu; Ying,28,0,35,7
1745815059153,EDS 115,A00,895312,Staff,41,0,45,4
1745815060178,EDS 117,A01,895337,Staff,30,0,30,0
1745815061206,EDS 125,A00,895341,Jones; Gabrielle Anastasia,43,0,45,2
1745815062231,EDS 128A,A01,895459,Fargason; Sharon Gayle,44,0,45,1
1745815063260,EDS 128B,A01,895543,Pappas; Elizabeth,44,0,45,1
1745815064287,EDS 139,A00,897203,Pappas; Elizabeth,44,0,45,1
1745815064287,EDS 139,B00,897209,Fargason; Sharon Gayle,44,0,45,1
1745815065314,EDS 201,A00,895545,Staff,43,0,45,2
1745815066344,EDS 203,A01,895581,Halter; Christopher P.,43,0,45,2
1745815067373,EDS 204R,A01,895625,Heinzman; Erica M.,43,0,45,2
1745815067373,EDS 204R,B01,895693,Halter; Christopher P.,18,0,45,27
1745815068400,EDS 206R,A00,895694,Fargason; Sharon Gayle,9,0,30,21
1745815068400,EDS 206R,B00,895695,Choi; Bailey Miyeon,20,0,30,10
1745815069432,EDS 250,A00,895697,Hemans; Patricia Ann Benitez,43,0,45,2
1745815070456,EDS 281,A00,895701,Meyerott; Theresa Ann,15,0,15,0
1745815071482,EDS 284,A00,895736,Meyerott; Theresa Ann,15,0,15,0
1745815072511,EDS 286,A00,897210,Fine; Sarah,15,0,15,0
1745815073540,EDS 289C,A01,895770,Daly; Alan J.,15,0,15,0
1745815074569,EDS 290,A00,897211,Hofstetter; Carolyn,15,0,15,0
1745815075614,LIGM 5A,A00,896162,Fischer-Grunski; Eva K,15,0,20,5
1745815076642,LIGM 5B,A00,896260,Fischer-Grunski; Eva K,17,0,20,3
1745815077668,LIGM 5C,A00,896308,Fischer-Grunski; Eva K,18,0,20,2
1745815078692,LIIT 5AS,A00,896313,Carnelos; Chiara,18,0,20,2
1745815079716,LIIT 5BS,A00,896416,Carnelos; Chiara,20,0,20,0
1745815080744,LIIT 5CS,A00,896564,Carnelos; Chiara,20,0,20,0
1745815081769,LISP 5A,A00,896588,Munoz Sanchez; Alicia,4,0,20,16
1745815082799,LISP 5B,A00,896653,Munoz Sanchez; Alicia,10,0,20,10
1745815083825,LISP 5C,A00,896655,Munoz Sanchez; Alicia,4,0,20,16
1745815084850,MAE 197,001,957918,Kleissl; Jan,9998,0,9999,1
1745815085877,MATH 2,A01,957937,Staff,34,0,35,1
1745815086901,MATH 197,001,957876,Kedlaya; Kiran S.,9993,0,9999,6
1745815087926,MCWP 40,A00,892729,Duru; Nur,13,0,20,7
1745815087926,MCWP 40,B00,893304,Montejo; Carolina,20,0,20,0
1745815088950,MCWP 40R,A00,893757,Redela; Pamela Morgan,0,7,20,20
1745815089975,MCWP 50,A00,893758,Morshed; Michael James,2,0,20,18
1745815089975,MCWP 50,B00,893761,Bartulis; Jason Michael,17,0,20,3
1745815091003,MCWP 50R,A00,893766,Compas; Sean Matthew,0,1,20,20
1745815091003,MCWP 50R,B00,893769,Carter; Jennifer A,0,0,20,20
1745815091003,MCWP 50R,C00,893771,Krone; Jarret,0,3,20,20
1745815091003,MCWP 50R,D00,893772,Miller; Elizabeth Deen,3,0,20,17
1745815091003,MCWP 50R,E00,893775,Carter; Andrea L,0,0,20,20
1745815092032,MMW 11R,A01,892721,Herbst; Matthew,11,0,27,16
1745815092032,MMW 11R,A02,892722,Herbst; Matthew,0,0,0,3
1745815093057,MMW 12R,A01,892724,Herbst; Matthew,0,10,16,16
1745815093057,MMW 12R,A02,892725,Herbst; Matthew,0,9,16,16
1745815094084,MMW 13R,A01,892727,Staff,0,3,16,16
1745815094084,MMW 13R,A02,892728,Staff,0,4,16,16
1745815094084,MMW 13R,A03,958032,Staff,0,3,16,16
1745815094084,MMW 13R,A04,958033,Staff,0,2,16,16
1745815094084,MMW 13R,A05,958034,Staff,0,3,16,16
1745815095127,SIO 295LS,A00,894015,Staff,7,0,25,18
1745815096154,SIO 295S,A00,894020,Staff,7,0,25,18
1745815097180,SIOC 290S,B01,958918,Staff,0,0,0,0
1745815098204,SIOC 291S,B01,958922,Staff,0,0,0,0
1745815099229,SOCI 117,A01,895339,Staff,4,0,5,1
1745815100258,WES 237B,A00,894149,Staff,11,0,20,9
1745815102323,AESE 279B,A00,891859,Staff,13,0,35,22
1745815103350,AIP 197,001,891854,Staff,70,0,70,0
1745815104378,ANTH 289S,A00,891856,Gagneux; Pascal,12,0,12,0
1745815105405,BENG 196,001,957946,Engler; Adam J.,9996,0,9999,3
1745815106431,CAT 124RS,A01,956906,Staff,8,0,25,17
1745815107459,CAT 125RS,A01,922013,Staff,8,0,25,17
1745815108485,CLRE 250,A00,891860,Morris; Sheldon,9995,0,9999,4
1745815110543,CLRE 251R,A00,907817,Mehta; Ravindra L.,9994,0,9999,5
1745815111567,CLRE 252,A00,891864,Cuomo; Raphael Eduardo,9993,0,9999,6
1745815112596,CLRE 253,A00,891867,Vaida; Florin,9994,0,9999,5
1745815112596,CLRE 253,B00,907819,Staff,9999,0,9999,0
1745815113624,CLRE 259,A00,891868,Patel; Hemal,9998,0,9999,1
1745815114651,CLRE 260,A00,891872,Cuomo; Raphael Eduardo,9999,0,9999,0
1745815115677,CLRE 297,001,891888,Cuomo; Raphael Eduardo,9999,0,9999,0
1745815116705,CSE 191,A00,958773,Minnes Kemp; Mor Mia,9999,0,9999,0
1745815117732,CSS 201S,A01,892054,Mignozzetti; Umberto,30,0,30,0
1745815118761,CSS 202S,A01,892056,Mignozzetti; Umberto,30,0,30,0
1745815119789,DSC 197,001,956898,Eldridge; Justin Matthew,9998,0,9999,1
1745815120818,DSC 297,001,958000,Mazumdar; Arya,9998,0,9999,1
1745815121846,EAP 100,A00,905686,Staff,9776,0,9999,223
1745815122876,ECE 45,A01,892618,Staff,0,12,50,50
1745815123904,ECE 109,A01,892620,Staff,0,43,0,0
1745815124934,ECE 111,A01,892719,Staff,0,8,50,50
1745815125964,ECE 197,001,957920,Mercier; Patrick Philip,9992,0,9999,7
1745815126995,ECON 178,A01,907814,Zhu; Ying,28,0,35,7
1745815128022,EDS 115,A00,895312,Staff,41,0,45,4
1745815138246,EDS 117,A01,895337,Staff,30,0,30,0
1745815139272,EDS 125,A00,895341,Jones; Gabrielle Anastasia,43,0,45,2
1745815140300,EDS 128A,A01,895459,Fargason; Sharon Gayle,44,0,45,1
1745815141339,EDS 128B,A01,895543,Pappas; Elizabeth,44,0,45,1
1745815142369,EDS 139,A00,897203,Pappas; Elizabeth,44,0,45,1
1745815142369,EDS 139,B00,897209,Fargason; Sharon Gayle,44,0,45,1
1745815143397,EDS 201,A00,895545,Staff,43,0,45,2
1745815144429,EDS 203,A01,895581,Halter; Christopher P.,43,0,45,2
1745815145455,EDS 204R,A01,895625,Heinzman; Erica M.,43,0,45,2
1745815145455,EDS 204R,B01,895693,Halter; Christopher P.,18,0,45,27
1745815146487,EDS 206R,A00,895694,Fargason; Sharon Gayle,9,0,30,21
1745815146487,EDS 206R,B00,895695,Choi; Bailey Miyeon,20,0,30,10
1745815147516,EDS 250,A00,895697,Hemans; Patricia Ann Benitez,43,0,45,2
1745815148545,EDS 281,A00,895701,Meyerott; Theresa Ann,15,0,15,0
1745815149571,EDS 284,A00,895736,Meyerott; Theresa Ann,15,0,15,0
1745815150597,EDS 286,A00,897210,Fine; Sarah,15,0,15,0
1745815151623,EDS 289C,A01,895770,Daly; Alan J.,15,0,15,0
1745815152652,EDS 290,A00,897211,Hofstetter; Carolyn,15,0,15,0
1745815153681,LIGM 5A,A00,896162,Fischer-Grunski; Eva K,15,0,20,5
1745815154710,LIGM 5B,A00,896260,Fischer-Grunski; Eva K,17,0,20,3
1745815155738,LIGM 5C,A00,896308,Fischer-Grunski; Eva K,18,0,20,2
1745815156769,LIIT 5AS,A00,896313,Carnelos; Chiara,18,0,20,2
1745815157800,LIIT 5BS,A00,896416,Carnelos; Chiara,20,0,20,0
1745815158827,LIIT 5CS,A00,896564,Carnelos; Chiara,20,0,20,0
1745815159858,LISP 5A,A00,896588,Munoz Sanchez; Alicia,4,0,20,16
1745815160887,LISP 5B,A00,896653,Munoz Sanchez; Alicia,10,0,20,10
1745815161917,LISP 5C,A00,896655,Munoz Sanchez; Alicia,4,0,20,16
1745815162948,MAE 197,001,957918,Kleissl; Jan,9998,0,9999,1
1745815163975,MATH 2,A01,957937,Staff,34,0,35,1
1745815165011,MATH 197,001,957876,Kedlaya; Kiran S.,9993,0,9999,6
1745815166037,MCWP 40,A00,892729,Duru; Nur,13,0,20,7
1745815166037,MCWP 40,B00,893304,Montejo; Carolina,20,0,20,0
1745815167063,MCWP 40R,A00,893757,Redela; Pamela Morgan,0,7,20,20
1745815168091,MCWP 50,A00,893758,Morshed; Michael James,2,0,20,18
1745815168091,MCWP 50,B00,893761,Bartulis; Jason Michael,17,0,20,3
1745815169120,MCWP 50R,A00,893766,Compas; Sean Matthew,0,1,20,20
1745815169120,MCWP 50R,B00,893769,Carter; Jennifer A,0,0,20,20
1745815169120,MCWP 50R,C00,893771,Krone; Jarret,0,3,20,20
1745815169120,MCWP 50R,D00,893772,Miller; Elizabeth Deen,3,0,20,17
1745815169120,MCWP 50R,E00,893775,Carter; Andrea L,0,0,20,20
1745815170146,MMW 11R,A01,892721,Herbst; Matthew,11,0,27,16
1745815170146,MMW 11R,A02,892722,Herbst; Matthew,0,0,0,3
1745815171172,MMW 12R,A01,892724,Herbst; Matthew,0,10,16,16
1745815171172,MMW 12R,A02,892725,Herbst; Matthew,0,9,16,16
1745815172221,MMW 13R,A01,892727,Staff,0,3,16,16
1745815172221,MMW 13R,A02,892728,Staff,0,4,16,16
1745815172221,MMW 13R,A03,958032,Staff,0,3,16,16
1745815172221,MMW 13R,A04,958033,Staff,0,2,16,16
1745815172221,MMW 13R,A05,958034,Staff,0,3,16,16
1745815173252,SIO 295LS,A00,894015,Staff,7,0,25,18
1745815174276,SIO 295S,A00,894020,Staff,7,0,25,18
1745815175306,SIOC 290S,B01,958918,Staff,0,0,0,0
1745815176332,SIOC 291S,B01,958922,Staff,0,0,0,0
1745815177355,SOCI 117,A01,895339,Staff,4,0,5,1
1745815178383,WES 237B,A00,894149,Staff,11,0,20,9
1745815180448,AESE 279B,A00,891859,Staff,13,0,35,22
1745815181472,AIP 197,001,891854,Staff,70,0,70,0
1745815182498,ANTH 289S,A00,891856,Gagneux; Pascal,12,0,12,0
1745815183524,BENG 196,001,957946,Engler; Adam J.,9996,0,9999,3
1745815184549,CAT 124RS,A01,956906,Staff,8,0,25,17
1745815185600,CAT 125RS,A01,922013,Staff,8,0,25,17
1745815186624,CLRE 250,A00,891860,Morris; Sheldon,9995,0,9999,4
1745815188674,CLRE 251R,A00,907817,Mehta; Ravindra L.,9994,0,9999,5
1745815189702,CLRE 252,A00,891864,Cuomo; Raphael Eduardo,9993,0,9999,6
1745815190727,CLRE 253,A00,891867,Vaida; Florin,9994,0,9999,5
1745815190727,CLRE 253,B00,907819,Staff,9999,0,9999,0
1745815191752,CLRE 259,A00,891868,Patel; Hemal,9998,0,9999,1
1745815192777,CLRE 260,A00,891872,Cuomo; Raphael Eduardo,9999,0,9999,0
1745815193802,CLRE 297,001,891888,Cuomo; Raphael Eduardo,9999,0,9999,0
1745815194830,CSE 191,A00,958773,Minnes Kemp; Mor Mia,9999,0,9999,0
1745815195856,CSS 201S,A01,892054,Mignozzetti; Umberto,30,0,30,0
1745815196882,CSS 202S,A01,892056,Mignozzetti; Umberto,30,0,30,0
1745815197911,DSC 197,001,956898,Eldridge; Justin Matthew,9998,0,9999,1
1745815198936,DSC 297,001,958000,Mazumdar; Arya,9998,0,9999,1
1745815199988,EAP 100,A00,905686,Staff,9776,0,9999,223
1745815201014,ECE 45,A01,892618,Staff,0,12,50,50
1745815202042,ECE 109,A01,892620,Staff,0,43,0,0
1745815203067,ECE 111,A01,892719,Staff,0,8,50,50
1745815204094,ECE 197,001,957920,Mercier; Patrick Philip,9992,0,9999,7
1745815205125,ECON 178,A01,907814,Zhu; Ying,28,0,35,7
1745815206150,EDS 115,A00,895312,Staff,41,0,45,4
1745815207178,EDS 117,A01,895337,Staff,30,0,30,0
1745815208202,EDS 125,A00,895341,Jones; Gabrielle Anastasia,43,0,45,2
1745815209231,EDS 128A,A01,895459,Fargason; Sharon Gayle,44,0,45,1
1745815210258,EDS 128B,A01,895543,Pappas; Elizabeth,44,0,45,1
1745815211287,EDS 139,A00,897203,Pappas; Elizabeth,44,0,45,1
1745815211287,EDS 139,B00,897209,Fargason; Sharon Gayle,44,0,45,1
1745815212316,EDS 201,A00,895545,Staff,43,0,45,2
1745815213339,EDS 203,A01,895581,Halter; Christopher P.,43,0,45,2
1745815214364,EDS 204R,A01,895625,Heinzman; Erica M.,43,0,45,2
1745815214364,EDS 204R,B01,895693,Halter; Christopher P.,18,0,45,27
1745815215390,EDS 206R,A00,895694,Fargason; Sharon Gayle,9,0,30,21
1745815215390,EDS 206R,B00,895695,Choi; Bailey Miyeon,20,0,30,10
1745815216417,EDS 250,A00,895697,Hemans; Patricia Ann Benitez,43,0,45,2
1745815217445,EDS 281,A00,895701,Meyerott; Theresa Ann,15,0,15,0
1745815218474,EDS 284,A00,895736,Meyerott; Theresa Ann,15,0,15,0
1745815219501,EDS 286,A00,897210,Fine; Sarah,15,0,15,0
1745815220524,EDS 289C,A01,895770,Daly; Alan J.,15,0,15,0
1745815221555,EDS 290,A00,897211,Hofstetter; Carolyn,15,0,15,0
1745815222582,LIGM 5A,A00,896162,Fischer-Grunski; Eva K,15,0,20,5
1745815223617,LIGM 5B,A00,896260,Fischer-Grunski; Eva K,17,0,20,3
1745815224641,LIGM 5C,A00,896308,Fischer-Grunski; Eva K,18,0,20,2
1745815225671,LIIT 5AS,A00,896313,Carnelos; Chiara,18,0,20,2
1745815226699,LIIT 5BS,A00,896416,Carnelos; Chiara,20,0,20,0
1745815227724,LIIT 5CS,A00,896564,Carnelos; Chiara,20,0,20,0
1745815228749,LISP 5A,A00,896588,Munoz Sanchez; Alicia,4,0,20,16
1745815229777,LISP 5B,A00,896653,Munoz Sanchez; Alicia,10,0,20,10
1745815230803,LISP 5C,A00,896655,Munoz Sanchez; Alicia,4,0,20,16
1745815231828,MAE 197,001,957918,Kleissl; Jan,9998,0,9999,1
1745815232853,MATH 2,A01,957937,Staff,34,0,35,1
1745815233881,MATH 197,001,957876,Kedlaya; Kiran S.,9993,0,9999,6
1745815234905,MCWP 40,A00,892729,Duru; Nur,13,0,20,7
1745815234905,MCWP 40,B00,893304,Montejo; Carolina,20,0,20,0
1745815235931,MCWP 40R,A00,893757,Redela; Pamela Morgan,0,7,20,20
1745815236960,MCWP 50,A00,893758,Morshed; Michael James,2,0,20,18
1745815236960,MCWP 50,B00,893761,Bartulis; Jason Michael,17,0,20,3
1745815237987,MCWP 50R,A00,893766,Compas; Sean Matthew,0,1,20,20
1745815237987,MCWP 50R,B00,893769,Carter; Jennifer A,0,0,20,20
1745815237987,MCWP 50R,C00,893771,Krone; Jarret,0,3,20,20
1745815237987,MCWP 50R,D00,893772,Miller; Elizabeth Deen,3,0,20,17
1745815237987,MCWP 50R,E00,893775,Carter; Andrea L,0,0,20,20
1745815239013,MMW 11R,A01,892721,Herbst; Matthew,11,0,27,16
1745815239013,MMW 11R,A02,892722,Herbst; Matthew,0,0,0,3
1745815240039,MMW 12R,A01,892724,Herbst; Matthew,0,10,16,16
1745815240039,MMW 12R,A02,892725,Herbst; Matthew,0,9,16,16
1745815241066,MMW 13R,A01,892727,Staff,0,3,16,16
1745815241066,MMW 13R,A02,892728,Staff,0,4,16,16
1745815241066,MMW 13R,A03,958032,Staff,0,3,16,16
1745815241066,MMW 13R,A04,958033,Staff,0,2,16,16
1745815241066,MMW 13R,A05,958034,Staff,0,3,16,16
1745815242095,SIO 295LS,A00,894015,Staff,7,0,25,18
1745815243123,SIO 295S,A00,894020,Staff,7,0,25,18
1745815244153,SIOC 290S,B01,958918,Staff,0,0,0,0
1745815245180,SIOC 291S,B01,958922,Staff,0,0,0,0
1745815246206,SOCI 117,A01,895339,Staff,4,0,5,1
1745815247380,WES 237B,A00,894149,Staff,11,0,20,9
1745815249436,AESE 279B,A00,891859,Staff,13,0,35,22
1745815250460,AIP 197,001,891854,Staff,70,0,70,0
1745815251487,ANTH 289S,A00,891856,Gagneux; Pascal,12,0,12,0
1745815252511,BENG 196,001,957946,Engler; Adam J.,9996,0,9999,3
1745815253535,CAT 124RS,A01,956906,Staff,8,0,25,17
1745815254563,CAT 125RS,A01,922013,Staff,8,0,25,17
1745815255588,CLRE 250,A00,891860,Morris; Sheldon,9995,0,9999,4
1745815257642,CLRE 251R,A00,907817,Mehta; Ravindra L.,9994,0,9999,5
1745815258669,CLRE 252,A00,891864,Cuomo; Raphael Eduardo,9993,0,9999,6
1745815259696,CLRE 253,A00,891867,Vaida; Florin,9994,0,9999,5
1745815259696,CLRE 253,B00,907819,Staff,9999,0,9999,0
1745815260722,CLRE 259,A00,891868,Patel; Hemal,9998,0,9999,1
1745815261747,CLRE 260,A00,891872,Cuomo; Raphael Eduardo,9999,0,9999,0
1745815262774,CLRE 297,001,891888,Cuomo; Raphael Eduardo,9999,0,9999,0
1745815263804,CSE 191,A00,958773,Minnes Kemp; Mor Mia,9999,0,9999,0
1745815264840,CSS 201S,A01,892054,Mignozzetti; Umberto,30,0,30,0
1745815265869,CSS 202S,A01,892056,Mignozzetti; Umberto,30,0,30,0
1745815266896,DSC 197,001,956898,Eldridge; Justin Matthew,9998,0,9999,1
1745815267926,DSC 297,001,958000,Mazumdar; Arya,9998,0,9999,1
1745815268954,EAP 100,A00,905686,Staff,9776,0,9999,223
1745815269981,ECE 45,A01,892618,Staff,0,12,50,50
1745815271010,ECE 109,A01,892620,Staff,0,43,0,0
1745815272033,ECE 111,A01,892719,Staff,0,8,50,50
1745815273061,ECE 197,001,957920,Mercier; Patrick Philip,9992,0,9999,7
1745815274088,ECON 178,A01,907814,Zhu; Ying,28,0,35,7
1745815275116,EDS 115,A00,895312,Staff,41,0,45,4
1745815276141,EDS 117,A01,895337,Staff,30,0,30,0
1745815277169,EDS 125,A00,895341,Jones; Gabrielle Anastasia,43,0,45,2
1745815278193,EDS 128A,A01,895459,Fargason; Sharon Gayle,44,0,45,1
1745815279219,EDS 128B,A01,895543,Pappas; Elizabeth,44,0,45,1
1745815280250,EDS 139,A00,897203,Pappas; Elizabeth,44,0,45,1
1745815280250,EDS 139,B00,897209,Fargason; Sharon Gayle,44,0,45,1
1745815281277,EDS 201,A00,895545,Staff,43,0,45,2
1745815282309,EDS 203,A01,895581,Halter; Christopher P.,43,0,45,2
1745815283339,EDS 204R,A01,895625,Heinzman; Erica M.,43,0,45,2
1745815283339,EDS 204R,B01,895693,Halter; Christopher P.,18,0,45,27
1745815284368,EDS 206R,A00,895694,Fargason; Sharon Gayle,9,0,30,21
1745815284368,EDS 206R,B00,895695,Choi; Bailey Miyeon,20,0,30,10
1745815285398,EDS 250,A00,895697,Hemans; Patricia Ann Benitez,43,0,45,2
1745815286424,EDS 281,A00,895701,Meyerott; Theresa Ann,15,0,15,0
1745815287453,EDS 284,A00,895736,Meyerott; Theresa Ann,15,0,15,0
1745815288480,EDS 286,A00,897210,Fine; Sarah,15,0,15,0
1745815289507,EDS 289C,A01,895770,Daly; Alan J.,15,0,15,0
1745815290534,EDS 290,A00,897211,Hofstetter; Carolyn,15,0,15,0
1745815291557,LIGM 5A,A00,896162,Fischer-Grunski; Eva K,15,0,20,5
1745815292585,LIGM 5B,A00,896260,Fischer-Grunski; Eva K,17,0,20,3
1745815293616,LIGM 5C,A00,896308,Fischer-Grunski; Eva K,18,0,20,2
1745815294643,LIIT 5AS,A00,896313,Carnelos; Chiara,18,0,20,2
1745815295674,LIIT 5BS,A00,896416,Carnelos; Chiara,20,0,20,0
1745815296700,LIIT 5CS,A00,896564,Carnelos; Chiara,20,0,20,0
1745815297730,LISP 5A,A00,896588,Munoz Sanchez; Alicia,4,0,20,16
1745815298760,LISP 5B,A00,896653,Munoz Sanchez; Alicia,10,0,20,10
1745815299791,LISP 5C,A00,896655,Munoz Sanchez; Alicia,4,0,20,16
1745815300820,MAE 197,001,957918,Kleissl; Jan,9998,0,9999,1
1745815301846,MATH 2,A01,957937,Staff,34,0,35,1
1745815302875,MATH 197,001,957876,Kedlaya; Kiran S.,9993,0,9999,6
1745815303903,MCWP 40,A00,892729,Duru; Nur,13,0,20,7
1745815303903,MCWP 40,B00,893304,Montejo; Carolina,20,0,20,0
1745815304931,MCWP 40R,A00,893757,Redela; Pamela Morgan,0,7,20,20
1745815305957,MCWP 50,A00,893758,Morshed; Michael James,2,0,20,18
1745815305957,MCWP 50,B00,893761,Bartulis; Jason Michael,17,0,20,3
1745815306981,MCWP 50R,A00,893766,Compas; Sean Matthew,0,1,20,20
1745815306981,MCWP 50R,B00,893769,Carter; Jennifer A,0,0,20,20
1745815306981,MCWP 50R,C00,893771,Krone; Jarret,0,3,20,20
1745815306981,MCWP 50R,D00,893772,Miller; Elizabeth Deen,3,0,20,17
1745815306981,MCWP 50R,E00,893775,Carter; Andrea L,0,0,20,20
1745815308010,MMW 11R,A01,892721,Herbst; Matthew,11,0,27,16
1745815308010,MMW 11R,A02,892722,Herbst; Matthew,0,0,0,3
1745815309041,MMW 12R,A01,892724,Herbst; Matthew,0,10,16,16
1745815309041,MMW 12R,A02,892725,Herbst; Matthew,0,9,16,16
1745815310064,MMW 13R,A01,892727,Staff,0,3,16,16
1745815310064,MMW 13R,A02,892728,Staff,0,4,16,16
1745815310064,MMW 13R,A03,958032,Staff,0,3,16,16
1745815310064,MMW 13R,A04,958033,Staff,0,2,16,16
1745815310064,MMW 13R,A05,958034,Staff,0,3,16,16
1745815311094,SIO 295LS,A00,894015,Staff,7,0,25,18
1745815312123,SIO 295S,A00,894020,Staff,7,0,25,18
1745815313150,SIOC 290S,B01,958918,Staff,0,0,0,0
1745815314177,SIOC 291S,B01,958922,Staff,0,0,0,0
1745815315202,SOCI 117,A01,895339,Staff,4,0,5,1
1745815316234,WES 237B,A00,894149,Staff,11,0,20,9
1745815318298,AESE 279B,A00,891859,Staff,13,0,35,22
1745815319323,AIP 197,001,891854,Staff,70,0,70,0
1745815320349,ANTH 289S,A00,891856,Gagneux; Pascal,12,0,12,0
1745815321376,BENG 196,001,957946,Engler; Adam J.,9996,0,9999,3
1745815322409,CAT 124RS,A01,956906,Staff,8,0,25,17
1745815323436,CAT 125RS,A01,922013,Staff,8,0,25,17
1745815324464,CLRE 250,A00,891860,Morris; Sheldon,9995,0,9999,4
1745815326519,CLRE 251R,A00,907817,Mehta; Ravindra L.,9994,0,9999,5
1745815327549,CLRE 252,A00,891864,Cuomo; Raphael Eduardo,9993,0,9999,6
1745815328579,CLRE 253,A00,891867,Vaida; Florin,9994,0,9999,5
1745815328579,CLRE 253,B00,907819,Staff,9999,0,9999,0
1745815329605,CLRE 259,A00,891868,Patel; Hemal,9998,0,9999,1
1745815330629,CLRE 260,A00,891872,Cuomo; Raphael Eduardo,9999,0,9999,0
1745815331657,CLRE 297,001,891888,Cuomo; Raphael Eduardo,9999,0,9999,0
1745815332685,CSE 191,A00,958773,Minnes Kemp; Mor Mia,9999,0,9999,0
1745815333759,CSS 201S,A01,892054,Mignozzetti; Umberto,30,0,30,0
1745815334788,CSS 202S,A01,892056,Mignozzetti; Umberto,30,0,30,0
1745815335814,DSC 197,001,956898,Eldridge; Justin Matthew,9998,0,9999,1
1745815336840,DSC 297,001,958000,Mazumdar; Arya,9998,0,9999,1
1745815337867,EAP 100,A00,905686,Staff,9776,0,9999,223
1745815338893,ECE 45,A01,892618,Staff,0,12,50,50
1745815339916,ECE 109,A01,892620,Staff,0,43,0,0
1745815340942,ECE 111,A01,892719,Staff,0,8,50,50
1745815341967,ECE 197,001,957920,Mercier; Patrick Philip,9992,0,9999,7
1745815342992,ECON 178,A01,907814,Zhu; Ying,28,0,35,7
1745815344017,EDS 115,A00,895312,Staff,41,0,45,4
1745815345043,EDS 117,A01,895337,Staff,30,0,30,0
1745815346074,EDS 125,A00,895341,Jones; Gabrielle Anastasia,43,0,45,2
1745815347100,EDS 128A,A01,895459,Fargason; Sharon Gayle,44,0,45,1
1745815348129,EDS 128B,A01,895543,Pappas; Elizabeth,44,0,45,1
1745815349156,EDS 139,A00,897203,Pappas; Elizabeth,44,0,45,1
1745815349156,EDS 139,B00,897209,Fargason; Sharon Gayle,44,0,45,1
1745815350184,EDS 201,A00,895545,Staff,43,0,45,2
1745815351209,EDS 203,A01,895581,Halter; Christopher P.,43,0,45,2
1745815352239,EDS 204R,A01,895625,Heinzman; Erica M.,43,0,45,2
1745815352239,EDS 204R,B01,895693,Halter; Christopher P.,18,0,45,27
1745815353267,EDS 206R,A00,895694,Fargason; Sharon Gayle,9,0,30,21
1745815353267,EDS 206R,B00,895695,Choi; Bailey Miyeon,20,0,30,10
1745815354293,EDS 250,A00,895697,Hemans; Patricia Ann Benitez,43,0,45,2
1745815355323,EDS 281,A00,895701,Meyerott; Theresa Ann,15,0,15,0
1745815356351,EDS 284,A00,895736,Meyerott; Theresa Ann,15,0,15,0
1745815357378,EDS 286,A00,897210,Fine; Sarah,15,0,15,0
1745815358407,EDS 289C,A01,895770,Daly; Alan J.,15,0,15,0
1745815359434,EDS 290,A00,897211,Hofstetter; Carolyn,15,0,15,0
1745815360460,LIGM 5A,A00,896162,Fischer-Grunski; Eva K,15,0,20,5
1745815361491,LIGM 5B,A00,896260,Fischer-Grunski; Eva K,17,0,20,3
1745815362522,LIGM 5C,A00,896308,Fischer-Grunski; Eva K,18,0,20,2
1745815363551,LIIT 5AS,A00,896313,Carnelos; Chiara,18,0,20,2
1745815364576,LIIT 5BS,A00,896416,Carnelos; Chiara,20,0,20,0
1745815365605,LIIT 5CS,A00,896564,Carnelos; Chiara,20,0,20,0
1745815366631,LISP 5A,A00,896588,Munoz Sanchez; Alicia,4,0,20,16
1745815367658,LISP 5B,A00,896653,Munoz Sanchez; Alicia,10,0,20,10
1745815368683,LISP 5C,A00,896655,Munoz Sanchez; Alicia,4,0,20,16
1745815369709,MAE 197,001,957918,Kleissl; Jan,9998,0,9999,1
1745815370737,MATH 2,A01,957937,Staff,34,0,35,1
1745815371762,MATH 197,001,957876,Kedlaya; Kiran S.,9993,0,9999,6
1745815372786,MCWP 40,A00,892729,Duru; Nur,13,0,20,7
1745815372786,MCWP 40,B00,893304,Montejo; Carolina,20,0,20,0
1745815373813,MCWP 40R,A00,893757,Redela; Pamela Morgan,0,7,20,20
1745815374842,MCWP 50,A00,893758,Morshed; Michael James,2,0,20,18
1745815374842,MCWP 50,B00,893761,Bartulis; Jason Michael,17,0,20,3
1745815375869,MCWP 50R,A00,893766,Compas; Sean Matthew,0,1,20,20
1745815375869,MCWP 50R,B00,893769,Carter; Jennifer A,0,0,20,20
1745815375869,MCWP 50R,C00,893771,Krone; Jarret,0,3,20,20
1745815375869,MCWP 50R,D00,893772,Miller; Elizabeth Deen,3,0,20,17
1745815375869,MCWP 50R,E00,893775,Carter; Andrea L,0,0,20,20
1745815376896,MMW 11R,A01,892721,Herbst; Matthew,11,0,27,16
1745815376896,MMW 11R,A02,892722,Herbst; Matthew,0,0,0,3
1745815377925,MMW 12R,A01,892724,Herbst; Matthew,0,10,16,16
1745815377925,MMW 12R,A02,892725,Herbst; Matthew,0,9,16,16
1745815378969,MMW 13R,A01,892727,Staff,0,3,16,16
1745815378969,MMW 13R,A02,892728,Staff,0,4,16,16
1745815378969,MMW 13R,A03,958032,Staff,0,3,16,16
1745815378969,MMW 13R,A04,958033,Staff,0,2,16,16
1745815378969,MMW 13R,A05,958034,Staff,0,3,16,16
1745815379997,SIO 295LS,A00,894015,Staff,7,0,25,18
1745815381022,SIO 295S,A00,894020,Staff,7,0,25,18
1745815382046,SIOC 290S,B01,958918,Staff,0,0,0,0
1745815383077,SIOC 291S,B01,958922,Staff,0,0,0,0
1745815384102,SOCI 117,A01,895339,Staff,4,0,5,1
1745815385127,WES 237B,A00,894149,Staff,11,0,20,9
1745815387182,AESE 279B,A00,891859,Staff,13,0,35,22
1745815388210,AIP 197,001,891854,Staff,70,0,70,0
1745815389237,ANTH 289S,A00,891856,Gagneux; Pascal,12,0,12,0
1745815390262,BENG 196,001,957946,Engler; Adam J.,9996,0,9999,3
1745815391289,CAT 124RS,A01,956906,Staff,8,0,25,17
1745815392314,CAT 125RS,A01,922013,Staff,8,0,25,17
1745815393337,CLRE 250,A00,891860,Morris; Sheldon,9995,0,9999,4
1745815395385,CLRE 251R,A00,907817,Mehta; Ravindra L.,9994,0,9999,5
1745815396413,CLRE 252,A00,891864,Cuomo; Raphael Eduardo,9993,0,9999,6
1745815397437,CLRE 253,A00,891867,Vaida; Florin,9994,0,9999,5
1745815397437,CLRE 253,B00,907819,Staff,9999,0,9999,0
1745815398465,CLRE 259,A00,891868,Patel; Hemal,9998,0,9999,1
1745815399489,CLRE 260,A00,891872,Cuomo; Raphael Eduardo,9999,0,9999,0
1745815400514,CLRE 297,001,891888,Cuomo; Raphael Eduardo,9999,0,9999,0
1745815401539,CSE 191,A00,958773,Minnes Kemp; Mor Mia,9999,0,9999,0
1745815402571,CSS 201S,A01,892054,Mignozzetti; Umberto,30,0,30,0
1745815403596,CSS 202S,A01,892056,Mignozzetti; Umberto,30,0,30,0
1745815404623,DSC 197,001,956898,Eldridge; Justin Matthew,9998,0,9999,1
1745815405649,DSC 297,001,958000,Mazumdar; Arya,9998,0,9999,1
1745815406677,EAP 100,A00,905686,Staff,9776,0,9999,223
1745815407705,ECE 45,A01,892618,Staff,0,12,50,50
1745815408732,ECE 109,A01,892620,Staff,0,43,0,0
1745815409764,ECE 111,A01,892719,Staff,0,8,50,50
1745815410792,ECE 197,001,957920,Mercier; Patrick Philip,9992,0,9999,7
1745815411820,ECON 178,A01,907814,Zhu; Ying,28,0,35,7
1745815412846,EDS 115,A00,895312,Staff,41,0,45,4
1745815413873,EDS 117,A01,895337,Staff,30,0,30,0
1745815414898,EDS 125,A00,895341,Jones; Gabrielle Anastasia,43,0,45,2
1745815415924,EDS 128A,A01,895459,Fargason; Sharon Gayle,44,0,45,1
1745815416952,EDS 128B,A01,895543,Pappas; Elizabeth,44,0,45,1
1745815417978,EDS 139,A00,897203,Pappas; Elizabeth,44,0,45,1
1745815417978,EDS 139,B00,897209,Fargason; Sharon Gayle,44,0,45,1
1745815419007,EDS 201,A00,895545,Staff,43,0,45,2
1745815420033,EDS 203,A01,895581,Halter; Christopher P.,43,0,45,2
1745815421060,EDS 204R,A01,895625,Heinzman; Erica M.,43,0,45,2
1745815421060,EDS 204R,B01,895693,Halter; Christopher P.,18,0,45,27
1745815422090,EDS 206R,A00,895694,Fargason; Sharon Gayle,9,0,30,21
1745815422090,EDS 206R,B00,895695,Choi; Bailey Miyeon,20,0,30,10
1745815423117,EDS 250,A00,895697,Hemans; Patricia Ann Benitez,43,0,45,2
1745815424144,EDS 281,A00,895701,Meyerott; Theresa Ann,15,0,15,0
1745815425171,EDS 284,A00,895736,Meyerott; Theresa Ann,15,0,15,0
1745815426196,EDS 286,A00,897210,Fine; Sarah,15,0,15,0
1745815427223,EDS 289C,A01,895770,Daly; Alan J.,15,0,15,0
1745815428252,EDS 290,A00,897211,Hofstetter; Carolyn,15,0,15,0
1745815429281,LIGM 5A,A00,896162,Fischer-Grunski; Eva K,15,0,20,5
1745815430309,LIGM 5B,A00,896260,Fischer-Grunski; Eva K,17,0,20,3
1745815431338,LIGM 5C,A00,896308,Fischer-Grunski; Eva K,18,0,20,2
1745815432366,LIIT 5AS,A00,896313,Carnelos; Chiara,18,0,20,2
1745815433394,LIIT 5BS,A00,896416,Carnelos; Chiara,20,0,20,0
1745815434420,LIIT 5CS,A00,896564,Carnelos; Chiara,20,0,20,0
1745815435450,LISP 5A,A00,896588,Munoz Sanchez; Alicia,4,0,20,16
1745815436496,LISP 5B,A00,896653,Munoz Sanchez; Alicia,10,0,20,10
1745815437521,LISP 5C,A00,896655,Munoz Sanchez; Alicia,4,0,20,16
1745815438547,MAE 197,001,957918,Kleissl; Jan,9998,0,9999,1
1745815439572,MATH 2,A01,957937,Staff,34,0,35,1
1745815440599,MATH 197,001,957876,Kedlaya; Kiran S.,9993,0,9999,6
1745815441625,MCWP 40,A00,892729,Duru; Nur,13,0,20,7
1745815441625,MCWP 40,B00,893304,Montejo; Carolina,20,0,20,0
1745815442652,MCWP 40R,A00,893757,Redela; Pamela Morgan,0,7,20,20
1745815443677,MCWP 50,A00,893758,Morshed; Michael James,2,0,20,18
1745815443677,MCWP 50,B00,893761,Bartulis; Jason Michael,17,0,20,3
1745815444705,MCWP 50R,A00,893766,Compas; Sean Matthew,0,1,20,20
1745815444705,MCWP 50R,B00,893769,Carter; Jennifer A,0,0,20,20
1745815444705,MCWP 50R,C00,893771,Krone; Jarret,0,3,20,20
1745815444705,MCWP 50R,D00,893772,Miller; Elizabeth Deen,3,0,20,17
1745815444705,MCWP 50R,E00,893775,Carter; Andrea L,0,0,20,20
1745815445734,MMW 11R,A01,892721,Herbst; Matthew,11,0,27,16
1745815445734,MMW 11R,A02,892722,Herbst; Matthew,0,0,0,3
1745815446759,MMW 12R,A01,892724,Herbst; Matthew,0,10,16,16
1745815446759,MMW 12R,A02,892725,Herbst; Matthew,0,9,16,16
1745815447786,MMW 13R,A01,892727,Staff,0,3,16,16
1745815447786,MMW 13R,A02,892728,Staff,0,4,16,16
1745815447786,MMW 13R,A03,958032,Staff,0,3,16,16
1745815447786,MMW 13R,A04,958033,Staff,0,2,16,16
1745815447786,MMW 13R,A05,958034,Staff,0,3,16,16
1745815448811,SIO 295LS,A00,894015,Staff,7,0,25,18
1745815449836,SIO 295S,A00,894020,Staff,7,0,25,18
1745815450861,SIOC 290S,B01,958918,Staff,0,0,0,0
1745815451886,SIOC 291S,B01,958922,Staff,0,0,0,0
1745815452913,SOCI 117,A01,895339,Staff,4,0,5,1
1745815453938,WES 237B,A00,894149,Staff,11,0,20,9
1745815455996,AESE 279B,A00,891859,Staff,13,0,35,22
1745815457020,AIP 197,001,891854,Staff,70,0,70,0
1745815458046,ANTH 289S,A00,891856,Gagneux; Pascal,12,0,12,0
1745815459070,BENG 196,001,957946,Engler; Adam J.,9996,0,9999,3
1745815460095,CAT 124RS,A01,956906,Staff,8,0,25,17
1745815461123,CAT 125RS,A01,922013,Staff,8,0,25,17
1745815462150,CLRE 250,A00,891860,Morris; Sheldon,9995,0,9999,4
1745815464207,CLRE 251R,A00,907817,Mehta; Ravindra L.,9994,0,9999,5
1745815465235,CLRE 252,A00,891864,Cuomo; Raphael Eduardo,9993,0,9999,6
1745815466261,CLRE 253,A00,891867,Vaida; Florin,9994,0,9999,5
1745815466261,CLRE 253,B00,907819,Staff,9999,0,9999,0
1745815467289,CLRE 259,A00,891868,Patel; Hemal,9998,0,9999,1
1745815468316,CLRE 260,A00,891872,Cuomo; Raphael Eduardo,9999,0,9999,0
1745815469342,CLRE 297,001,891888,Cuomo; Raphael Eduardo,9999,0,9999,0
1745815470371,CSE 191,A00,958773,Minnes Kemp; Mor Mia,9999,0,9999,0
1745815471400,CSS 201S,A01,892054,Mignozzetti; Umberto,30,0,30,0
1745815472427,CSS 202S,A01,892056,Mignozzetti; Umberto,30,0,30,0
1745815473451,DSC 197,001,956898,Eldridge; Justin Matthew,9998,0,9999,1
1745815474478,DSC 297,001,958000,Mazumdar; Arya,9998,0,9999,1
1745815475503,EAP 100,A00,905686,Staff,9776,0,9999,223
1745815476534,ECE 45,A01,892618,Staff,0,12,50,50
1745815477562,ECE 109,A01,892620,Staff,0,43,0,0
1745815478590,ECE 111,A01,892719,Staff,0,8,50,50
1745815479615,ECE 197,001,957920,Mercier; Patrick Philip,9992,0,9999,7
1745815480641,ECON 178,A01,907814,Zhu; Ying,28,0,35,7
1745815481669,EDS 115,A00,895312,Staff,41,0,45,4
1745815482694,EDS 117,A01,895337,Staff,30,0,30,0
1745815483738,EDS 125,A00,895341,Jones; Gabrielle Anastasia,43,0,45,2
1745815484764,EDS 128A,A01,895459,Fargason; Sharon Gayle,44,0,45,1
1745815485792,EDS 128B,A01,895543,Pappas; Elizabeth,44,0,45,1
1745815486818,EDS 139,A00,897203,Pappas; Elizabeth,44,0,45,1
1745815486818,EDS 139,B00,897209,Fargason; Sharon Gayle,44,0,45,1
1745815487844,EDS 201,A00,895545,Staff,43,0,45,2
1745815488872,EDS 203,A01,895581,Halter; Christopher P.,43,0,45,2
1745815489902,EDS 204R,A01,895625,Heinzman; Erica M.,43,0,45,2
1745815489902,EDS 204R,B01,895693,Halter; Christopher P.,18,0,45,27
1745815490926,EDS 206R,A00,895694,Fargason; Sharon Gayle,9,0,30,21
1745815490926,EDS 206R,B00,895695,Choi; Bailey Miyeon,20,0,30,10
1745815491951,EDS 250,A00,895697,Hemans; Patricia Ann Benitez,43,0,45,2
1745815492981,EDS 281,A00,895701,Meyerott; Theresa Ann,15,0,15,0
1745815494009,EDS 284,A00,895736,Meyerott; Theresa Ann,15,0,15,0
1745815495036,EDS 286,A00,897210,Fine; Sarah,15,0,15,0
1745815496061,EDS 289C,A01,895770,Daly; Alan J.,15,0,15,0
1745815497089,EDS 290,A00,897211,Hofstetter; Carolyn,15,0,15,0
1745815498116,LIGM 5A,A00,896162,Fischer-Grunski; Eva K,15,0,20,5
1745815499142,LIGM 5B,A00,896260,Fischer-Grunski; Eva K,17,0,20,3
1745815500170,LIGM 5C,A00,896308,Fischer-Grunski; Eva K,18,0,20,2
1745815501197,LIIT 5AS,A00,896313,Carnelos; Chiara,18,0,20,2
1745815502224,LIIT 5BS,A00,896416,Carnelos; Chiara,20,0,20,0
1745815503254,LIIT 5CS,A00,896564,Carnelos; Chiara,20,0,20,0
1745815504280,LISP 5A,A00,896588,Munoz Sanchez; Alicia,4,0,20,16
1745815505306,LISP 5B,A00,896653,Munoz Sanchez; Alicia,10,0,20,10
1745815506334,LISP 5C,A00,896655,Munoz Sanchez; Alicia,4,0,20,16
1745815507360,MAE 197,001,957918,Kleissl; Jan,9998,0,9999,1
1745815508387,MATH 2,A01,957937,Staff,34,0,35,1
1745815509415,MATH 197,001,957876,Kedlaya; Kiran S.,9993,0,9999,6
1745815510442,MCWP 40,A00,892729,Duru; Nur,13,0,20,7
1745815510442,MCWP 40,B00,893304,Montejo; Carolina,20,0,20,0
1745815511468,MCWP 40R,A00,893757,Redela; Pamela Morgan,0,7,20,20
1745815512496,MCWP 50,A00,893758,Morshed; Michael James,2,0,20,18
1745815512496,MCWP 50,B00,893761,Bartulis; Jason Michael,17,0,20,3
1745815513527,MCWP 50R,A00,893766,Compas; Sean Matthew,0,1,20,20
1745815513527,MCWP 50R,B00,893769,Carter; Jennifer A,0,0,20,20
1745815513527,MCWP 50R,C00,893771,Krone; Jarret,0,3,20,20
1745815513527,MCWP 50R,D00,893772,Miller; Elizabeth Deen,3,0,20,17
1745815513527,MCWP 50R,E00,893775,Carter; Andrea L,0,0,20,20
1745815514557,MMW 11R,A01,892721,Herbst; Matthew,11,0,27,16
1745815514557,MMW 11R,A02,892722,Herbst; Matthew,0,0,0,3
1745815515583,MMW 12R,A01,892724,Herbst; Matthew,0,10,16,16
1745815515583,MMW 12R,A02,892725,Herbst; Matthew,0,9,16,16
1745815516613,MMW 13R,A01,892727,Staff,0,3,16,16
1745815516613,MMW 13R,A02,892728,Staff,0,4,16,16
1745815516613,MMW 13R,A03,958032,Staff,0,3,16,16
1745815516613,MMW 13R,A04,958033,Staff,0,2,16,16
1745815516613,MMW 13R,A05,958034,Staff,0,3,16,16
1745815517642,SIO 295LS,A00,894015,Staff,7,0,25,18
1745815518671,SIO 295S,A00,894020,Staff,7,0,25,18
1745815519700,SIOC 290S,B01,958918,Staff,0,0,0,0
1745815520726,SIOC 291S,B01,958922,Staff,0,0,0,0
1745815521753,SOCI 117,A01,895339,Staff,4,0,5,1
1745815522777,WES 237B,A00,894149,Staff,11,0,20,9
1745815524848,AESE 279B,A00,891859,Staff,13,0,35,22
1745815525874,AIP 197,001,891854,Staff,70,0,70,0
1745815526898,ANTH 289S,A00,891856,Gagneux; Pascal,12,0,12,0
1745815527922,BENG 196,001,957946,Engler; Adam J.,9996,0,9999,3
1745815528952,CAT 124RS,A01,956906,Staff,8,0,25,17
1745815529977,CAT 125RS,A01,922013,Staff,8,0,25,17
1745815531002,CLRE 250,A00,891860,Morris; Sheldon,9995,0,9999,4
1745815533058,CLRE 251R,A00,907817,Mehta; Ravindra L.,9994,0,9999,5
1745815534084,CLRE 252,A00,891864,Cuomo; Raphael Eduardo,9993,0,9999,6
1745815535109,CLRE 253,A00,891867,Vaida; Florin,9994,0,9999,5
1745815535109,CLRE 253,B00,907819,Staff,9999,0,9999,0
1745815536135,CLRE 259,A00,891868,Patel; Hemal,9998,0,9999,1
1745815537163,CLRE 260,A00,891872,Cuomo; Raphael Eduardo,9999,0,9999,0
1745815538187,CLRE 297,001,891888,Cuomo; Raphael Eduardo,9999,0,9999,0
1745815539213,CSE 191,A00,958773,Minnes Kemp; Mor Mia,9999,0,9999,0
1745815540237,CSS 201S,A01,892054,Mignozzetti; Umberto,30,0,30,0
1745815541269,CSS 202S,A01,892056,Mignozzetti; Umberto,30,0,30,0
1745815542296,DSC 197,001,956898,Eldridge; Justin Matthew,9998,0,9999,1
1745815543326,DSC 297,001,958000,Mazumdar; Arya,9998,0,9999,1
1745815544353,EAP 100,A00,905686,Staff,9776,0,9999,223
1745815545380,ECE 45,A01,892618,Staff,0,12,50,50
1745815546411,ECE 109,A01,892620,Staff,0,43,0,0
1745815547441,ECE 111,A01,892719,Staff,0,8,50,50
1745815548469,ECE 197,001,957920,Mercier; Patrick Philip,9992,0,9999,7
1745815549496,ECON 178,A01,907814,Zhu; Ying,28,0,35,7
1745815550520,EDS 115,A00,895312,Staff,41,0,45,4
1745815551546,EDS 117,A01,895337,Staff,30,0,30,0
1745815552572,EDS 125,A00,895341,Jones; Gabrielle Anastasia,43,0,45,2
1745815553604,EDS 128A,A01,895459,Fargason; Sharon Gayle,44,0,45,1
1745815554632,EDS 128B,A01,895543,Pappas; Elizabeth,44,0,45,1
1745815555660,EDS 139,A00,897203,Pappas; Elizabeth,44,0,45,1
1745815555660,EDS 139,B00,897209,Fargason; Sharon Gayle,44,0,45,1
1745815556687,EDS 201,A00,895545,Staff,43,0,45,2
1745815557746,EDS 203,A01,895581,Halter; Christopher P.,43,0,45,2
1745815558778,EDS 204R,A01,895625,Heinzman; Erica M.,43,0,45,2
1745815558778,EDS 204R,B01,895693,Halter; Christopher P.,18,0,45,27
1745815559805,EDS 206R,A00,895694,Fargason; Sharon Gayle,9,0,30,21
1745815559805,EDS 206R,B00,895695,Choi; Bailey Miyeon,20,0,30,10
1745815560835,EDS 250,A00,895697,Hemans; Patricia Ann Benitez,43,0,45,2
1745815561861,EDS 281,A00,895701,Meyerott; Theresa Ann,15,0,15,0
1745815562886,EDS 284,A00,895736,Meyerott; Theresa Ann,15,0,15,0
1745815563914,EDS 286,A00,897210,Fine; Sarah,15,0,15,0
1745815564947,EDS 289C,A01,895770,Daly; Alan J.,15,0,15,0
1745815565972,EDS 290,A00,897211,Hofstetter; Carolyn,15,0,15,0
1745815566999,LIGM 5A,A00,896162,Fischer-Grunski; Eva K,15,0,20,5
1745815568025,LIGM 5B,A00,896260,Fischer-Grunski; Eva K,17,0,20,3
1745815569052,LIGM 5C,A00,896308,Fischer-Grunski; Eva K,18,0,20,2
1745815570083,LIIT 5AS,A00,896313,Carnelos; Chiara,18,0,20,2
1745815571113,LIIT 5BS,A00,896416,Carnelos; Chiara,20,0,20,0
1745815572144,LIIT 5CS,A00,896564,Carnelos; Chiara,20,0,20,0
1745815573174,LISP 5A,A00,896588,Munoz Sanchez; Alicia,4,0,20,16
1745815574201,LISP 5B,A00,896653,Munoz Sanchez; Alicia,10,0,20,10
1745815575227,LISP 5C,A00,896655,Munoz Sanchez; Alicia,4,0,20,16
1745815576256,MAE 197,001,957918,Kleissl; Jan,9998,0,9999,1
1745815577282,MATH 2,A01,957937,Staff,34,0,35,1
1745815578307,MATH 197,001,957876,Kedlaya; Kiran S.,9993,0,9999,6
1745815579333,MCWP 40,A00,892729,Duru; Nur,13,0,20,7
1745815579333,MCWP 40,B00,893304,Montejo; Carolina,20,0,20,0
1745815580363,MCWP 40R,A00,893757,Redela; Pamela Morgan,0,7,20,20
1745815581389,MCWP 50,A00,893758,Morshed; Michael James,2,0,20,18
1745815581389,MCWP 50,B00,893761,Bartulis; Jason Michael,17,0,20,3
1745815582415,MCWP 50R,A00,893766,Compas; Sean Matthew,0,1,20,20
1745815582415,MCWP 50R,B00,893769,Carter; Jennifer A,0,0,20,20
1745815582415,MCWP 50R,C00,893771,Krone; Jarret,0,3,20,20
1745815582415,MCWP 50R,D00,893772,Miller; Elizabeth Deen,3,0,20,17
1745815582415,MCWP 50R,E00,893775,Carter; Andrea L,0,0,20,20
1745815583441,MMW 11R,A01,892721,Herbst; Matthew,11,0,27,16
1745815583441,MMW 11R,A02,892722,Herbst; Matthew,0,0,0,3
1745815584469,MMW 12R,A01,892724,Herbst; Matthew,0,10,16,16
1745815584469,MMW 12R,A02,892725,Herbst; Matthew,0,9,16,16
1745815585500,MMW 13R,A01,892727,Staff,0,3,16,16
1745815585500,MMW 13R,A02,892728,Staff,0,4,16,16
1745815585500,MMW 13R,A03,958032,Staff,0,3,16,16
1745815585500,MMW 13R,A04,958033,Staff,0,2,16,16
1745815585500,MMW 13R,A05,958034,Staff,0,3,16,16
1745815586529,SIO 295LS,A00,894015,Staff,7,0,25,18
1745815587556,SIO 295S,A00,894020,Staff,7,0,25,18
1745815588585,SIOC 290S,B01,958918,Staff,0,0,0,0
1745815589611,SIOC 291S,B01,958922,Staff,0,0,0,0
1745815590635,SOCI 117,A01,895339,Staff,4,0,5,1
1745815591661,WES 237B,A00,894149,Staff,11,0,20,9
1745815593718,AESE 279B,A00,891859,Staff,13,0,35,22
1745815594743,AIP 197,001,891854,Staff,70,0,70,0
1745815595769,ANTH 289S,A00,891856,Gagneux; Pascal,12,0,12,0
1745815596797,BENG 196,001,957946,Engler; Adam J.,9996,0,9999,3
1745815597825,CAT 124RS,A01,956906,Staff,8,0,25,17
1745815598850,CAT 125RS,A01,922013,Staff,8,0,25,17
1745815599881,CLRE 250,A00,891860,Morris; Sheldon,9995,0,9999,4
1745815601933,CLRE 251R,A00,907817,Mehta; Ravindra L.,9994,0,9999,5
1745815602959,CLRE 252,A00,891864,Cuomo; Raphael Eduardo,9993,0,9999,6
1745815603985,CLRE 253,A00,891867,Vaida; Florin,9994,0,9999,5
1745815603985,CLRE 253,B00,907819,Staff,9999,0,9999,0
1745815605010,CLRE 259,A00,891868,Patel; Hemal,9998,0,9999,1
1745815606034,CLRE 260,A00,891872,Cuomo; Raphael Eduardo,9999,0,9999,0
1745815607105,CLRE 297,001,891888,Cuomo; Raphael Eduardo,9999,0,9999,0
1745815608134,CSE 191,A00,958773,Minnes Kemp; Mor Mia,9999,0,9999,0
1745815609161,CSS 201S,A01,892054,Mignozzetti; Umberto,30,0,30,0
1745815610187,CSS 202S,A01,892056,Mignozzetti; Umberto,30,0,30,0
1745815611217,DSC 197,001,956898,Eldridge; Justin Matthew,9998,0,9999,1
1745815612243,DSC 297,001,958000,Mazumdar; Arya,9998,0,9999,1
1745815613269,EAP 100,A00,905686,Staff,9776,0,9999,223
1745815614298,ECE 45,A01,892618,Staff,0,12,50,50
1745815615323,ECE 109,A01,892620,Staff,0,43,0,0
1745815616350,ECE 111,A01,892719,Staff,0,8,50,50
1745815617376,ECE 197,001,957920,Mercier; Patrick Philip,9992,0,9999,7
1745815618403,ECON 178,A01,907814,Zhu; Ying,28,0,35,7
1745815619431,EDS 115,A00,895312,Staff,41,0,45,4
1745815620455,EDS 117,A01,895337,Staff,30,0,30,0
1745815621483,EDS 125,A00,895341,Jones; Gabrielle Anastasia,43,0,45,2
1745815622511,EDS 128A,A01,895459,Fargason; Sharon Gayle,44,0,45,1
1745815623537,EDS 128B,A01,895543,Pappas; Elizabeth,44,0,45,1
1745815624566,EDS 139,A00,897203,Pappas; Elizabeth,44,0,45,1
1745815624566,EDS 139,B00,897209,Fargason; Sharon Gayle,44,0,45,1
1745815625592,EDS 201,A00,895545,Staff,43,0,45,2
1745815626617,EDS 203,A01,895581,Halter; Christopher P.,43,0,45,2
1745815627642,EDS 204R,A01,895625,Heinzman; Erica M.,43,0,45,2
1745815627642,EDS 204R,B01,895693,Halter; Christopher P.,18,0,45,27
1745815628670,EDS 206R,A00,895694,Fargason; Sharon Gayle,9,0,30,21
1745815628670,EDS 206R,B00,895695,Choi; Bailey Miyeon,20,0,30,10
1745815629697,EDS 250,A00,895697,Hemans; Patricia Ann Benitez,43,0,45,2
1745815630725,EDS 281,A00,895701,Meyerott; Theresa Ann,15,0,15,0
1745815631751,EDS 284,A00,895736,Meyerott; Theresa Ann,15,0,15,0
1745815632776,EDS 286,A00,897210,Fine; Sarah,15,0,15,0
1745815633804,EDS 289C,A01,895770,Daly; Alan J.,15,0,15,0
1745815634832,EDS 290,A00,897211,Hofstetter; Carolyn,15,0,15,0
1745815635862,LIGM 5A,A00,896162,Fischer-Grunski; Eva K,15,0,20,5
1745815636897,LIGM 5B,A00,896260,Fischer-Grunski; Eva K,17,0,20,3
1745815637924,LIGM 5C,A00,896308,Fischer-Grunski; Eva K,18,0,20,2
1745815638952,LIIT 5AS,A00,896313,Carnelos; Chiara,18,0,20,2
1745815639999,LIIT 5BS,A00,896416,Carnelos; Chiara,20,0,20,0
1745815641027,LIIT 5CS,A00,896564,Carnelos; Chiara,20,0,20,0
1745815642054,LISP 5A,A00,896588,Munoz Sanchez; Alicia,4,0,20,16
1745815643101,LISP 5B,A00,896653,Munoz Sanchez; Alicia,10,0,20,10
1745815644132,LISP 5C,A00,896655,Munoz Sanchez; Alicia,4,0,20,16
1745815645162,MAE 197,001,957918,Kleissl; Jan,9998,0,9999,1
1745815646190,MATH 2,A01,957937,Staff,34,0,35,1
1745815647215,MATH 197,001,957876,Kedlaya; Kiran S.,9993,0,9999,6
1745815648241,MCWP 40,A00,892729,Duru; Nur,13,0,20,7
1745815648241,MCWP 40,B00,893304,Montejo; Carolina,20,0,20,0
1745815649267,MCWP 40R,A00,893757,Redela; Pamela Morgan,0,7,20,20
1745815650296,MCWP 50,A00,893758,Morshed; Michael James,2,0,20,18
1745815650296,MCWP 50,B00,893761,Bartulis; Jason Michael,17,0,20,3
1745815651323,MCWP 50R,A00,893766,Compas; Sean Matthew,0,1,20,20
1745815651323,MCWP 50R,B00,893769,Carter; Jennifer A,0,0,20,20
1745815651323,MCWP 50R,C00,893771,Krone; Jarret,0,3,20,20
1745815651323,MCWP 50R,D00,893772,Miller; Elizabeth Deen,3,0,20,17
1745815651323,MCWP 50R,E00,893775,Carter; Andrea L,0,0,20,20
1745815652348,MMW 11R,A01,892721,Herbst; Matthew,11,0,27,16
1745815652348,MMW 11R,A02,892722,Herbst; Matthew,0,0,0,3
1745815653375,MMW 12R,A01,892724,Herbst; Matthew,0,10,16,16
1745815653375,MMW 12R,A02,892725,Herbst; Matthew,0,9,16,16
1745815654400,MMW 13R,A01,892727,Staff,0,3,16,16
1745815654400,MMW 13R,A02,892728,Staff,0,4,16,16
1745815654400,MMW 13R,A03,958032,Staff,0,3,16,16
1745815654400,MMW 13R,A04,958033,Staff,0,2,16,16
1745815654400,MMW 13R,A05,958034,Staff,0,3,16,16
1745815655428,SIO 295LS,A00,894015,Staff,7,0,25,18
1745815656454,SIO 295S,A00,894020,Staff,7,0,25,18
1745815657478,SIOC 290S,B01,958918,Staff,0,0,0,0
1745815658504,SIOC 291S,B01,958922,Staff,0,0,0,0
1745815659530,SOCI 117,A01,895339,Staff,4,0,5,1
1745815660554,WES 237B,A00,894149,Staff,11,0,20,9
1745815662614,AESE 279B,A00,891859,Staff,13,0,35,22
1745815663638,AIP 197,001,891854,Staff,70,0,70,0
1745815664662,ANTH 289S,A00,891856,Gagneux; Pascal,12,0,12,0
1745815665687,BENG 196,001,957946,Engler; Adam J.,9996,0,9999,3
1745815666715,CAT 124RS,A01,956906,Staff,8,0,25,17
1745815667743,CAT 125RS,A01,922013,Staff,8,0,25,17
1745815668766,CLRE 250,A00,891860,Morris; Sheldon,9995,0,9999,4
1745815670828,CLRE 251R,A00,907817,Mehta; Ravindra L.,9994,0,9999,5
1745815671857,CLRE 252,A00,891864,Cuomo; Raphael Eduardo,9993,0,9999,6
1745815672884,CLRE 253,A00,891867,Vaida; Florin,9994,0,9999,5
1745815672884,CLRE 253,B00,907819,Staff,9999,0,9999,0
1745815673911,CLRE 259,A00,891868,Patel; Hemal,9998,0,9999,1
1745815674935,CLRE 260,A00,891872,Cuomo; Raphael Eduardo,9999,0,9999,0
1745815675963,CLRE 297,001,891888,Cuomo; Raphael Eduardo,9999,0,9999,0
1745815676988,CSE 191,A00,958773,Minnes Kemp; Mor Mia,9999,0,9999,0
1745815678013,CSS 201S,A01,892054,Mignozzetti; Umberto,30,0,30,0
1745815679039,CSS 202S,A01,892056,Mignozzetti; Umberto,30,0,30,0
1745815680065,DSC 197,001,956898,Eldridge; Justin Matthew,9998,0,9999,1
1745815681089,DSC 297,001,958000,Mazumdar; Arya,9998,0,9999,1
1745815682116,EAP 100,A00,905686,Staff,9776,0,9999,223
1745815683142,ECE 45,A01,892618,Staff,0,12,50,50
1745815684169,ECE 109,A01,892620,Staff,0,43,0,0
1745815685195,ECE 111,A01,892719,Staff,0,8,50,50
1745815686221,ECE 197,001,957920,Mercier; Patrick Philip,9992,0,9999,7
1745815687249,ECON 178,A01,907814,Zhu; Ying,28,0,35,7
1745815688275,EDS 115,A00,895312,Staff,41,0,45,4
1745815689303,EDS 117,A01,895337,Staff,30,0,30,0
1745815690327,EDS 125,A00,895341,Jones; Gabrielle Anastasia,43,0,45,2
1745815691357,EDS 128A,A01,895459,Fargason; Sharon Gayle,44,0,45,1
1745815692383,EDS 128B,A01,895543,Pappas; Elizabeth,44,0,45,1
1745815693411,EDS 139,A00,897203,Pappas; Elizabeth,44,0,45,1
1745815693411,EDS 139,B00,897209,Fargason; Sharon Gayle,44,0,45,1
1745815694436,EDS 201,A00,895545,Staff,43,0,45,2
1745815695466,EDS 203,A01,895581,Halter; Christopher P.,43,0,45,2
1745815696490,EDS 204R,A01,895625,Heinzman; Erica M.,43,0,45,2
1745815696490,EDS 204R,B01,895693,Halter; Christopher P.,18,0,45,27
1745815697519,EDS 206R,A00,895694,Fargason; Sharon Gayle,9,0,30,21
1745815697519,EDS 206R,B00,895695,Choi; Bailey Miyeon,20,0,30,10
1745815698549,EDS 250,A00,895697,Hemans; Patricia Ann Benitez,43,0,45,2
1745815699581,EDS 281,A00,895701,Meyerott; Theresa Ann,15,0,15,0
1745815700610,EDS 284,A00,895736,Meyerott; Theresa Ann,15,0,15,0
1745815701638,EDS 286,A00,897210,Fine; Sarah,15,0,15,0
1745815702662,EDS 289C,A01,895770,Daly; Alan J.,15,0,15,0
1745815703690,EDS 290,A00,897211,Hofstetter; Carolyn,15,0,15,0
1745815704720,LIGM 5A,A00,896162,Fischer-Grunski; Eva K,15,0,20,5
1745815705746,LIGM 5B,A00,896260,Fischer-Grunski; Eva K,17,0,20,3
1745815706772,LIGM 5C,A00,896308,Fischer-Grunski; Eva K,18,0,20,2
1745815707802,LIIT 5AS,A00,896313,Carnelos; Chiara,18,0,20,2
1745815708830,LIIT 5BS,A00,896416,Carnelos; Chiara,20,0,20,0
1745815709858,LIIT 5CS,A00,896564,Carnelos; Chiara,20,0,20,0
1745815710883,LISP 5A,A00,896588,Munoz Sanchez; Alicia,4,0,20,16
1745815711910,LISP 5B,A00,896653,Munoz Sanchez; Alicia,10,0,20,10
1745815712940,LISP 5C,A00,896655,Munoz Sanchez; Alicia,4,0,20,16
1745815713967,MAE 197,001,957918,Kleissl; Jan,9998,0,9999,1
1745815714994,MATH 2,A01,957937,Staff,34,0,35,1
1745815716021,MATH 197,001,957876,Kedlaya; Kiran S.,9993,0,9999,6
1745815717047,MCWP 40,A00,892729,Duru; Nur,13,0,20,7
1745815717047,MCWP 40,B00,893304,Montejo; Carolina,20,0,20,0
1745815718073,MCWP 40R,A00,893757,Redela; Pamela Morgan,0,7,20,20
1745815719103,MCWP 50,A00,893758,Morshed; Michael James,2,0,20,18
1745815719103,MCWP 50,B00,893761,Bartulis; Jason Michael,17,0,20,3
1745815720129,MCWP 50R,A00,893766,Compas; Sean Matthew,0,1,20,20
1745815720129,MCWP 50R,B00,893769,Carter; Jennifer A,0,0,20,20
1745815720129,MCWP 50R,C00,893771,Krone; Jarret,0,3,20,20
1745815720129,MCWP 50R,D00,893772,Miller; Elizabeth Deen,3,0,20,17
1745815720129,MCWP 50R,E00,893775,Carter; Andrea L,0,0,20,20
1745815721159,MMW 11R,A01,892721,Herbst; Matthew,11,0,27,16
1745815721159,MMW 11R,A02,892722,Herbst; Matthew,0,0,0,3
1745815722185,MMW 12R,A01,892724,Herbst; Matthew,0,10,16,16
1745815722185,MMW 12R,A02,892725,Herbst; Matthew,0,9,16,16
1745815723212,MMW 13R,A01,892727,Staff,0,3,16,16
1745815723212,MMW 13R,A02,892728,Staff,0,4,16,16
1745815723212,MMW 13R,A03,958032,Staff,0,3,16,16
1745815723212,MMW 13R,A04,958033,Staff,0,2,16,16
1745815723212,MMW 13R,A05,958034,Staff,0,3,16,16
1745815724238,SIO 295LS,A00,894015,Staff,7,0,25,18
1745815725268,SIO 295S,A00,894020,Staff,7,0,25,18
1745815726317,SIOC 290S,B01,958918,Staff,0,0,0,0
1745815727345,SIOC 291S,B01,958922,Staff,0,0,0,0
1745815728372,SOCI 117,A01,895339,Staff,4,0,5,1
1745815729398,WES 237B,A00,894149,Staff,11,0,20,9
1745815731470,AESE 279B,A00,891859,Staff,13,0,35,22
1745815732495,AIP 197,001,891854,Staff,70,0,70,0
1745815733523,ANTH 289S,A00,891856,Gagneux; Pascal,12,0,12,0
1745815734552,BENG 196,001,957946,Engler; Adam J.,9996,0,9999,3
1745815735575,CAT 124RS,A01,956906,Staff,8,0,25,17
1745815736601,CAT 125RS,A01,922013,Staff,8,0,25,17
1745815737627,CLRE 250,A00,891860,Morris; Sheldon,9995,0,9999,4
1745815739677,CLRE 251R,A00,907817,Mehta; Ravindra L.,9994,0,9999,5
1745815740703,CLRE 252,A00,891864,Cuomo; Raphael Eduardo,9993,0,9999,6
1745815741737,CLRE 253,A00,891867,Vaida; Florin,9994,0,9999,5
1745815741737,CLRE 253,B00,907819,Staff,9999,0,9999,0
1745815742763,CLRE 259,A00,891868,Patel; Hemal,9998,0,9999,1
1745815743789,CLRE 260,A00,891872,Cuomo; Raphael Eduardo,9999,0,9999,0
1745815744817,CLRE 297,001,891888,Cuomo; Raphael Eduardo,9999,0,9999,0
1745815745843,CSE 191,A00,958773,Minnes Kemp; Mor Mia,9999,0,9999,0
1745815746868,CSS 201S,A01,892054,Mignozzetti; Umberto,30,0,30,0
1745815747894,CSS 202S,A01,892056,Mignozzetti; Umberto,30,0,30,0
1745815748921,DSC 197,001,956898,Eldridge; Justin Matthew,9998,0,9999,1
1745815749946,DSC 297,001,958000,Mazumdar; Arya,9998,0,9999,1
1745815750973,EAP 100,A00,905686,Staff,9776,0,9999,223
1745815752008,ECE 45,A01,892618,Staff,0,12,50,50
1745815753037,ECE 109,A01,892620,Staff,0,43,0,0
1745815754064,ECE 111,A01,892719,Staff,0,8,50,50
1745815755090,ECE 197,001,957920,Mercier; Patrick Philip,9992,0,9999,7
1745815756116,ECON 178,A01,907814,Zhu; Ying,28,0,35,7
1745815757140,EDS 115,A00,895312,Staff,41,0,45,4
1745815758165,EDS 117,A01,895337,Staff,30,0,30,0
1745815759195,EDS 125,A00,895341,Jones; Gabrielle Anastasia,43,0,45,2
1745815760221,EDS 128A,A01,895459,Fargason; Sharon Gayle,44,0,45,1
1745815761249,EDS 128B,A01,895543,Pappas; Elizabeth,44,0,45,1
1745815762280,EDS 139,A00,897203,Pappas; Elizabeth,44,0,45,1
1745815762280,EDS 139,B00,897209,Fargason; Sharon Gayle,44,0,45,1
1745815763306,EDS 201,A00,895545,Staff,43,0,45,2
1745815764335,EDS 203,A01,895581,Halter; Christopher P.,43,0,45,2
1745815765362,EDS 204R,A01,895625,Heinzman; Erica M.,43,0,45,2
1745815765362,EDS 204R,B01,895693,Halter; Christopher P.,18,0,45,27
1745815766392,EDS 206R,A00,895694,Fargason; Sharon Gayle,9,0,30,21
1745815766392,EDS 206R,B00,895695,Choi; Bailey Miyeon,20,0,30,10
1745815767419,EDS 250,A00,895697,Hemans; Patricia Ann Benitez,43,0,45,2
1745815768443,EDS 281,A00,895701,Meyerott; Theresa Ann,15,0,15,0
1745815769469,EDS 284,A00,895736,Meyerott; Theresa Ann,15,0,15,0
1745815770498,EDS 286,A00,897210,Fine; Sarah,15,0,15,0
1745815771551,EDS 289C,A01,895770,Daly; Alan J.,15,0,15,0
1745815772578,EDS 290,A00,897211,Hofstetter; Carolyn,15,0,15,0
1745815773603,LIGM 5A,A00,896162,Fischer-Grunski; Eva K,15,0,20,5
1745815774632,LIGM 5B,A00,896260,Fischer-Grunski; Eva K,17,0,20,3
1745815775657,LIGM 5C,A00,896308,Fischer-Grunski; Eva K,18,0,20,2
1745815776684,LIIT 5AS,A00,896313,Carnelos; Chiara,18,0,20,2
1745815777709,LIIT 5BS,A00,896416,Carnelos; Chiara,20,0,20,0
1745815778735,LIIT 5CS,A00,896564,Carnelos; Chiara,20,0,20,0
1745815779761,LISP 5A,A00,896588,Munoz Sanchez; Alicia,4,0,20,16
1745815780789,LISP 5B,A00,896653,Munoz Sanchez; Alicia,10,0,20,10
1745815781821,LISP 5C,A00,896655,Munoz Sanchez; Alicia,4,0,20,16
1745815782847,MAE 197,001,957918,Kleissl; Jan,9998,0,9999,1
1745815783873,MATH 2,A01,957937,Staff,34,0,35,1
1745815784900,MATH 197,001,957876,Kedlaya; Kiran S.,9993,0,9999,6
1745815785931,MCWP 40,A00,892729,Duru; Nur,13,0,20,7
1745815785931,MCWP 40,B00,893304,Montejo; Carolina,20,0,20,0
1745815786955,MCWP 40R,A00,893757,Redela; Pamela Morgan,0,7,20,20
1745815787983,MCWP 50,A00,893758,Morshed; Michael James,2,0,20,18
1745815787983,MCWP 50,B00,893761,Bartulis; Jason Michael,17,0,20,3
1745815789011,MCWP 50R,A00,893766,Compas; Sean Matthew,0,1,20,20
1745815789011,MCWP 50R,B00,893769,Carter; Jennifer A,0,0,20,20
1745815789011,MCWP 50R,C00,893771,Krone; Jarret,0,3,20,20
1745815789011,MCWP 50R,D00,893772,Miller; Elizabeth Deen,3,0,20,17
1745815789011,MCWP 50R,E00,893775,Carter; Andrea L,0,0,20,20
1745815790047,MMW 11R,A01,892721,Herbst; Matthew,11,0,27,16
1745815790047,MMW 11R,A02,892722,Herbst; Matthew,0,0,0,3
1745815791073,MMW 12R,A01,892724,Herbst; Matthew,0,10,16,16
1745815791073,MMW 12R,A02,892725,Herbst; Matthew,0,9,16,16
1745815792103,MMW 13R,A01,892727,Staff,0,3,16,16
1745815792103,MMW 13R,A02,892728,Staff,0,4,16,16
1745815792103,MMW 13R,A03,958032,Staff,0,3,16,16
1745815792103,MMW 13R,A04,958033,Staff,0,2,16,16
1745815792103,MMW 13R,A05,958034,Staff,0,3,16,16
1745815793132,SIO 295LS,A00,894015,Staff,7,0,25,18
1745815794162,SIO 295S,A00,894020,Staff,7,0,25,18
1745815795192,SIOC 290S,B01,958918,Staff,0,0,0,0
1745815796218,SIOC 291S,B01,958922,Staff,0,0,0,0
1745815797246,SOCI 117,A01,895339,Staff,4,0,5,1
1745815798274,WES 237B,A00,894149,Staff,11,0,20,9
1745815800335,AESE 279B,A00,891859,Staff,13,0,35,22
1745815801362,AIP 197,001,891854,Staff,70,0,70,0
1745815802404,ANTH 289S,A00,891856,Gagneux; Pascal,12,0,12,0
1745815803432,BENG 196,001,957946,Engler; Adam J.,9996,0,9999,3
1745815804459,CAT 124RS,A01,956906,Staff,8,0,25,17
1745815805484,CAT 125RS,A01,922013,Staff,8,0,25,17
1745815806512,CLRE 250,A00,891860,Morris; Sheldon,9995,0,9999,4
1745815808563,CLRE 251R,A00,907817,Mehta; Ravindra L.,9994,0,9999,5
1745815809590,CLRE 252,A00,891864,Cuomo; Raphael Eduardo,9993,0,9999,6
1745815810617,CLRE 253,A00,891867,Vaida; Florin,9994,0,9999,5
1745815810617,CLRE 253,B00,907819,Staff,9999,0,9999,0
1745815811643,CLRE 259,A00,891868,Patel; Hemal,9998,0,9999,1
1745815812671,CLRE 260,A00,891872,Cuomo; Raphael Eduardo,9999,0,9999,0
1745815813697,CLRE 297,001,891888,Cuomo; Raphael Eduardo,9999,0,9999,0
1745815814723,CSE 191,A00,958773,Minnes Kemp; Mor Mia,9999,0,9999,0
1745815815751,CSS 201S,A01,892054,Mignozzetti; Umberto,30,0,30,0
1745815816777,CSS 202S,A01,892056,Mignozzetti; Umberto,30,0,30,0
1745815817805,DSC 197,001,956898,Eldridge; Justin Matthew,9998,0,9999,1
1745815818831,DSC 297,001,958000,Mazumdar; Arya,9998,0,9999,1
1745815819859,EAP 100,A00,905686,Staff,9776,0,9999,223
1745815820886,ECE 45,A01,892618,Staff,0,12,50,50
1745815821915,ECE 109,A01,892620,Staff,0,43,0,0
1745815822941,ECE 111,A01,892719,Staff,0,8,50,50
1745815823967,ECE 197,001,957920,Mercier; Patrick Philip,9992,0,9999,7
1745815824998,ECON 178,A01,907814,Zhu; Ying,28,0,35,7
1745815826026,EDS 115,A00,895312,Staff,41,0,45,4
1745815827052,EDS 117,A01,895337,Staff,30,0,30,0
1745815828102,EDS 125,A00,895341,Jones; Gabrielle Anastasia,43,0,45,2
1745815829137,EDS 128A,A01,895459,Fargason; Sharon Gayle,44,0,45,1
1745815830163,EDS 128B,A01,895543,Pappas; Elizabeth,44,0,45,1
1745815831189,EDS 139,A00,897203,Pappas; Elizabeth,44,0,45,1
1745815831189,EDS 139,B00,897209,Fargason; Sharon Gayle,44,0,45,1
1745815832214,EDS 201,A00,895545,Staff,43,0,45,2
1745815833243,EDS 203,A01,895581,Halter; Christopher P.,43,0,45,2
1745815834268,EDS 204R,A01,895625,Heinzman; Erica M.,43,0,45,2
1745815834268,EDS 204R,B01,895693,Halter; Christopher P.,18,0,45,27
1745815835293,EDS 206R,A00,895694,Fargason; Sharon Gayle,9,0,30,21
1745815835293,EDS 206R,B00,895695,Choi; Bailey Miyeon,20,0,30,10
1745815836318,EDS 250,A00,895697,Hemans; Patricia Ann Benitez,43,0,45,2
1745815837345,EDS 281,A00,895701,Meyerott; Theresa Ann,15,0,15,0
1745815838370,EDS 284,A00,895736,Meyerott; Theresa Ann,15,0,15,0
1745815839397,EDS 286,A00,897210,Fine; Sarah,15,0,15,0
1745815840423,EDS 289C,A01,895770,Daly; Alan J.,15,0,15,0
1745815841450,EDS 290,A00,897211,Hofstetter; Carolyn,15,0,15,0
1745815842475,LIGM 5A,A00,896162,Fischer-Grunski; Eva K,15,0,20,5
1745815843504,LIGM 5B,A00,896260,Fischer-Grunski; Eva K,17,0,20,3
1745815844531,LIGM 5C,A00,896308,Fischer-Grunski; Eva K,18,0,20,2
1745815845560,LIIT 5AS,A00,896313,Carnelos; Chiara,18,0,20,2
1745815846588,LIIT 5BS,A00,896416,Carnelos; Chiara,20,0,20,0
1745815847612,LIIT 5CS,A00,896564,Carnelos; Chiara,20,0,20,0
1745815848639,LISP 5A,A00,896588,Munoz Sanchez; Alicia,4,0,20,16
1745815849667,LISP 5B,A00,896653,Munoz Sanchez; Alicia,10,0,20,10
1745815850695,LISP 5C,A00,896655,Munoz Sanchez; Alicia,4,0,20,16
1745815851722,MAE 197,001,957918,Kleissl; Jan,9998,0,9999,1
1745815852749,MATH 2,A01,957937,Staff,34,0,35,1
1745815853774,MATH 197,001,957876,Kedlaya; Kiran S.,9993,0,9999,6
1745815854803,MCWP 40,A00,892729,Duru; Nur,13,0,20,7
1745815854803,MCWP 40,B00,893304,Montejo; Carolina,20,0,20,0
1745815855828,MCWP 40R,A00,893757,Redela; Pamela Morgan,0,7,20,20
1745815856857,MCWP 50,A00,893758,Morshed; Michael James,2,0,20,18
1745815856857,MCWP 50,B00,893761,Bartulis; Jason Michael,17,0,20,3
1745815857885,MCWP 50R,A00,893766,Compas; Sean Matthew,0,1,20,20
1745815857885,MCWP 50R,B00,893769,Carter; Jennifer A,0,0,20,20
1745815857885,MCWP 50R,C00,893771,Krone; Jarret,0,3,20,20
1745815857885,MCWP 50R,D00,893772,Miller; Elizabeth Deen,3,0,20,17
1745815857885,MCWP 50R,E00,893775,Carter; Andrea L,0,0,20,20
1745815858914,MMW 11R,A01,892721,Herbst; Matthew,11,0,27,16
1745815858914,MMW 11R,A02,892722,Herbst; Matthew,0,0,0,3
1745815859938,MMW 12R,A01,892724,Herbst; Matthew,0,10,16,16
1745815859938,MMW 12R,A02,892725,Herbst; Matthew,0,9,16,16
1745815860963,MMW 13R,A01,892727,Staff,0,3,16,16
1745815860963,MMW 13R,A02,892728,Staff,0,4,16,16
1745815860963,MMW 13R,A03,958032,Staff,0,3,16,16
1745815860963,MMW 13R,A04,958033,Staff,0,2,16,16
1745815860963,MMW 13R,A05,958034,Staff,0,3,16,16
1745815861993,SIO 295LS,A00,894015,Staff,7,0,25,18
1745815863019,SIO 295S,A00,894020,Staff,7,0,25,18
1745815864045,SIOC 290S,B01,958918,Staff,0,0,0,0
1745815865080,SIOC 291S,B01,958922,Staff,0,0,0,0
1745815866104,SOCI 117,A01,895339,Staff,4,0,5,1
1745815867129,WES 237B,A00,894149,Staff,11,0,20,9
1745815869218,AESE 279B,A00,891859,Staff,13,0,35,22
1745815870242,AIP 197,001,891854,Staff,70,0,70,0
1745815871266,ANTH 289S,A00,891856,Gagneux; Pascal,12,0,12,0
1745815872291,BENG 196,001,957946,Engler; Adam J.,9996,0,9999,3
1745815873322,CAT 124RS,A01,956906,Staff,8,0,25,17
1745815874347,CAT 125RS,A01,922013,Staff,8,0,25,17
1745815875373,CLRE 250,A00,891860,Morris; Sheldon,9995,0,9999,4
1745815877422,CLRE 251R,A00,907817,Mehta; Ravindra L.,9994,0,9999,5
1745815878446,CLRE 252,A00,891864,Cuomo; Raphael Eduardo,9993,0,9999,6
1745815879473,CLRE 253,A00,891867,Vaida; Florin,9994,0,9999,5
1745815879473,CLRE 253,B00,907819,Staff,9999,0,9999,0
1745815880497,CLRE 259,A00,891868,Patel; Hemal,9998,0,9999,1
1745815881522,CLRE 260,A00,891872,Cuomo; Raphael Eduardo,9999,0,9999,0
1745815882547,CLRE 297,001,891888,Cuomo; Raphael Eduardo,9999,0,9999,0
1745815883575,CSE 191,A00,958773,Minnes Kemp; Mor Mia,9999,0,9999,0
1745815884607,CSS 201S,A01,892054,Mignozzetti; Umberto,30,0,30,0
1745815885632,CSS 202S,A01,892056,Mignozzetti; Umberto,30,0,30,0
1745815886663,DSC 197,001,956898,Eldridge; Justin Matthew,9998,0,9999,1
1745815887693,DSC 297,001,958000,Mazumdar; Arya,9998,0,9999,1
1745815888721,EAP 100,A00,905686,Staff,9776,0,9999,223
1745815889767,ECE 45,A01,892618,Staff,0,12,50,50
1745815890798,ECE 109,A01,892620,Staff,0,43,0,0
1745815891836,ECE 111,A01,892719,Staff,0,8,50,50
1745815892863,ECE 197,001,957920,Mercier; Patrick Philip,9992,0,9999,7
1745815893889,ECON 178,A01,907814,Zhu; Ying,28,0,35,7
1745815894918,EDS 115,A00,895312,Staff,41,0,45,4
1745815895945,EDS 117,A01,895337,Staff,30,0,30,0
1745815896970,EDS 125,A00,895341,Jones; Gabrielle Anastasia,43,0,45,2
1745815897997,EDS 128A,A01,895459,Fargason; Sharon Gayle,44,0,45,1
1745815899022,EDS 128B,A01,895543,Pappas; Elizabeth,44,0,45,1
1745815900047,EDS 139,A00,897203,Pappas; Elizabeth,44,0,45,1
1745815900047,EDS 139,B00,897209,Fargason; Sharon Gayle,44,0,45,1
1745815901072,EDS 201,A00,895545,Staff,43,0,45,2
1745815902097,EDS 203,A01,895581,Halter; Christopher P.,43,0,45,2
1745815903121,EDS 204R,A01,895625,Heinzman; Erica M.,43,0,45,2
1745815903121,EDS 204R,B01,895693,Halter; Christopher P.,18,0,45,27
1745815904149,EDS 206R,A00,895694,Fargason; Sharon Gayle,9,0,30,21
1745815904149,EDS 206R,B00,895695,Choi; Bailey Miyeon,20,0,30,10
1745815905176,EDS 250,A00,895697,Hemans; Patricia Ann Benitez,43,0,45,2
1745815906203,EDS 281,A00,895701,Meyerott; Theresa Ann,15,0,15,0
1745815907228,EDS 284,A00,895736,Meyerott; Theresa Ann,15,0,15,0
1745815908253,EDS 286,A00,897210,Fine; Sarah,15,0,15,0
1745815909277,EDS 289C,A01,895770,Daly; Alan J.,15,0,15,0
1745815910301,EDS 290,A00,897211,Hofstetter; Carolyn,15,0,15,0
1745815911329,LIGM 5A,A00,896162,Fischer-Grunski; Eva K,15,0,20,5
1745815912355,LIGM 5B,A00,896260,Fischer-Grunski; Eva K,17,0,20,3
1745815913378,LIGM 5C,A00,896308,Fischer-Grunski; Eva K,18,0,20,2
1745815914407,LIIT 5AS,A00,896313,Carnelos; Chiara,18,0,20,2
1745815915432,LIIT 5BS,A00,896416,Carnelos; Chiara,20,0,20,0
1745815916456,LIIT 5CS,A00,896564,Carnelos; Chiara,20,0,20,0
1745815917482,LISP 5A,A00,896588,Munoz Sanchez; Alicia,4,0,20,16
1745815918508,LISP 5B,A00,896653,Munoz Sanchez; Alicia,10,0,20,10
1745815919534,LISP 5C,A00,896655,Munoz Sanchez; Alicia,4,0,20,16
1745815920560,MAE 197,001,957918,Kleissl; Jan,9998,0,9999,1
1745815921587,MATH 2,A01,957937,Staff,34,0,35,1
1745815922613,MATH 197,001,957876,Kedlaya; Kiran S.,9993,0,9999,6
1745815923644,MCWP 40,A00,892729,Duru; Nur,13,0,20,7
1745815923644,MCWP 40,B00,893304,Montejo; Carolina,20,0,20,0
1745815924669,MCWP 40R,A00,893757,Redela; Pamela Morgan,0,7,20,20
1745815925695,MCWP 50,A00,893758,Morshed; Michael James,2,0,20,18
1745815925695,MCWP 50,B00,893761,Bartulis; Jason Michael,17,0,20,3
1745815926726,MCWP 50R,A00,893766,Compas; Sean Matthew,0,1,20,20
1745815926726,MCWP 50R,B00,893769,Carter; Jennifer A,0,0,20,20
1745815926726,MCWP 50R,C00,893771,Krone; Jarret,0,3,20,20
1745815926726,MCWP 50R,D00,893772,Miller; Elizabeth Deen,3,0,20,17
1745815926726,MCWP 50R,E00,893775,Carter; Andrea L,0,0,20,20
1745815927757,MMW 11R,A01,892721,Herbst; Matthew,11,0,27,16
1745815927757,MMW 11R,A02,892722,Herbst; Matthew,0,0,0,3
1745815928781,MMW 12R,A01,892724,Herbst; Matthew,0,10,16,16
1745815928781,MMW 12R,A02,892725,Herbst; Matthew,0,9,16,16
1745815929812,MMW 13R,A01,892727,Staff,0,3,16,16
1745815929812,MMW 13R,A02,892728,Staff,0,4,16,16
1745815929812,MMW 13R,A03,958032,Staff,0,3,16,16
1745815929812,MMW 13R,A04,958033,Staff,0,2,16,16
1745815929812,MMW 13R,A05,958034,Staff,0,3,16,16
1745815930839,SIO 295LS,A00,894015,Staff,7,0,25,18
1745815931868,SIO 295S,A00,894020,Staff,7,0,25,18
1745815932895,SIOC 290S,B01,958918,Staff,0,0,0,0
1745815933924,SIOC 291S,B01,958922,Staff,0,0,0,0
1745815934949,SOCI 117,A01,895339,Staff,4,0,5,1
1745815935974,WES 237B,A00,894149,Staff,11,0,20,9
1745815938033,AESE 279B,A00,891859,Staff,13,0,35,22
1745815939059,AIP 197,001,891854,Staff,70,0,70,0
1745815940085,ANTH 289S,A00,891856,Gagneux; Pascal,12,0,12,0
1745815941114,BENG 196,001,957946,Engler; Adam J.,9996,0,9999,3
1745815942141,CAT 124RS,A01,956906,Staff,8,0,25,17
1745815943167,CAT 125RS,A01,922013,Staff,8,0,25,17
1745815944196,CLRE 250,A00,891860,Morris; Sheldon,9995,0,9999,4
1745815946247,CLRE 251R,A00,907817,Mehta; Ravindra L.,9994,0,9999,5
1745815947272,CLRE 252,A00,891864,Cuomo; Raphael Eduardo,9993,0,9999,6
1745815948296,CLRE 253,A00,891867,Vaida; Florin,9994,0,9999,5
1745815948296,CLRE 253,B00,907819,Staff,9999,0,9999,0
1745815949322,CLRE 259,A00,891868,Patel; Hemal,9998,0,9999,1
1745815950347,CLRE 260,A00,891872,Cuomo; Raphael Eduardo,9999,0,9999,0
1745815951380,CLRE 297,001,891888,Cuomo; Raphael Eduardo,9999,0,9999,0
1745815952407,CSE 191,A00,958773,Minnes Kemp; Mor Mia,9999,0,9999,0
1745815953436,CSS 201S,A01,892054,Mignozzetti; Umberto,30,0,30,0
1745815954461,CSS 202S,A01,892056,Mignozzetti; Umberto,30,0,30,0
1745815955489,DSC 197,001,956898,Eldridge; Justin Matthew,9998,0,9999,1
1745815956520,DSC 297,001,958000,Mazumdar; Arya,9998,0,9999,1
1745815957547,EAP 100,A00,905686,Staff,9776,0,9999,223
1745815958572,ECE 45,A01,892618,Staff,0,12,50,50
1745815959602,ECE 109,A01,892620,Staff,0,43,0,0
1745815960627,ECE 111,A01,892719,Staff,0,8,50,50
1745815961654,ECE 197,001,957920,Mercier; Patrick Philip,9992,0,9999,7
1745815962681,ECON 178,A01,907814,Zhu; Ying,28,0,35,7
1745815963706,EDS 115,A00,895312,Staff,41,0,45,4
1745815964733,EDS 117,A01,895337,Staff,30,0,30,0
1745815965762,EDS 125,A00,895341,Jones; Gabrielle Anastasia,43,0,45,2
1745815966791,EDS 128A,A01,895459,Fargason; Sharon Gayle,44,0,45,1
1745815967815,EDS 128B,A01,895543,Pappas; Elizabeth,44,0,45,1
1745815968843,EDS 139,A00,897203,Pappas; Elizabeth,44,0,45,1
1745815968843,EDS 139,B00,897209,Fargason; Sharon Gayle,44,0,45,1
1745815969869,EDS 201,A00,895545,Staff,43,0,45,2
1745815970898,EDS 203,A01,895581,Halter; Christopher P.,43,0,45,2
1745815971926,EDS 204R,A01,895625,Heinzman; Erica M.,43,0,45,2
1745815971926,EDS 204R,B01,895693,Halter; Christopher P.,18,0,45,27
1745815972954,EDS 206R,A00,895694,Fargason; Sharon Gayle,9,0,30,21
1745815972954,EDS 206R,B00,895695,Choi; Bailey Miyeon,20,0,30,10
1745815973979,EDS 250,A00,895697,Hemans; Patricia Ann Benitez,43,0,45,2
1745815975005,EDS 281,A00,895701,Meyerott; Theresa Ann,15,0,15,0
1745815976034,EDS 284,A00,895736,Meyerott; Theresa Ann,15,0,15,0
1745815977062,EDS 286,A00,897210,Fine; Sarah,15,0,15,0
1745815978089,EDS 289C,A01,895770,Daly; Alan J.,15,0,15,0
1745815979120,EDS 290,A00,897211,Hofstetter; Carolyn,15,0,15,0
1745815980146,LIGM 5A,A00,896162,Fischer-Grunski; Eva K,15,0,20,5
1745815981175,LIGM 5B,A00,896260,Fischer-Grunski; Eva K,17,0,20,3
1745815982205,LIGM 5C,A00,896308,Fischer-Grunski; Eva K,18,0,20,2
1745815983235,LIIT 5AS,A00,896313,Carnelos; Chiara,18,0,20,2
1745815984262,LIIT 5BS,A00,896416,Carnelos; Chiara,20,0,20,0
1745815985288,LIIT 5CS,A00,896564,Carnelos; Chiara,20,0,20,0
1745815986318,LISP 5A,A00,896588,Munoz Sanchez; Alicia,4,0,20,16
1745815987344,LISP 5B,A00,896653,Munoz Sanchez; Alicia,10,0,20,10
1745815988374,LISP 5C,A00,896655,Munoz Sanchez; Alicia,4,0,20,16
1745815989400,MAE 197,001,957918,Kleissl; Jan,9998,0,9999,1
1745815990425,MATH 2,A01,957937,Staff,34,0,35,1
1745815991451,MATH 197,001,957876,Kedlaya; Kiran S.,9993,0,9999,6
1745815992479,MCWP 40,A00,892729,Duru; Nur,13,0,20,7
1745815992479,MCWP 40,B00,893304,Montejo; Carolina,20,0,20,0
1745815993504,MCWP 40R,A00,893757,Redela; Pamela Morgan,0,7,20,20
1745815994532,MCWP 50,A00,893758,Morshed; Michael James,2,0,20,18
1745815994532,MCWP 50,B00,893761,Bartulis; Jason Michael,17,0,20,3
1745815995559,MCWP 50R,A00,893766,Compas; Sean Matthew,0,1,20,20
1745815995559,MCWP 50R,B00,893769,Carter; Jennifer A,0,0,20,20
1745815995559,MCWP 50R,C00,893771,Krone; Jarret,0,3,20,20
1745815995559,MCWP 50R,D00,893772,Miller; Elizabeth Deen,3,0,20,17
1745815995559,MCWP 50R,E00,893775,Carter; Andrea L,0,0,20,20
1745815996583,MMW 11R,A01,892721,Herbst; Matthew,11,0,27,16
1745815996583,MMW 11R,A02,892722,Herbst; Matthew,0,0,0,3
1745815997610,MMW 12R,A01,892724,Herbst; Matthew,0,10,16,16
1745815997610,MMW 12R,A02,892725,Herbst; Matthew,0,9,16,16
1745815998635,MMW 13R,A01,892727,Staff,0,3,16,16
1745815998635,MMW 13R,A02,892728,Staff,0,4,16,16
1745815998635,MMW 13R,A03,958032,Staff,0,3,16,16
1745815998635,MMW 13R,A04,958033,Staff,0,2,16,16
1745815998635,MMW 13R,A05,958034,Staff,0,3,16,16
1745815999685,SIO 295LS,A00,894015,Staff,7,0,25,18
1745816000710,SIO 295S,A00,894020,Staff,7,0,25,18
1745816001740,SIOC 290S,B01,958918,Staff,0,0,0,0
1745816002769,SIOC 291S,B01,958922,Staff,0,0,0,0
1745816003796,SOCI 117,A01,895339,Staff,4,0,5,1
1745816004842,WES 237B,A00,894149,Staff,11,0,20,9
1745816006899,AESE 279B,A00,891859,Staff,13,0,35,22
1745816007924,AIP 197,001,891854,Staff,70,0,70,0
1745816008950,ANTH 289S,A00,891856,Gagneux; Pascal,12,0,12,0
1745816009976,BENG 196,001,957946,Engler; Adam J.,9996,0,9999,3
1745816011001,CAT 124RS,A01,956906,Staff,8,0,25,17
1745816012035,CAT 125RS,A01,922013,Staff,8,0,25,17
1745816013064,CLRE 250,A00,891860,Morris; Sheldon,9995,0,9999,4
1745816015119,CLRE 251R,A00,907817,Mehta; Ravindra L.,9994,0,9999,5
1745816016145,CLRE 252,A00,891864,Cuomo; Raphael Eduardo,9993,0,9999,6
1745816017170,CLRE 253,A00,891867,Vaida; Florin,9994,0,9999,5
1745816017170,CLRE 253,B00,907819,Staff,9999,0,9999,0
1745816018199,CLRE 259,A00,891868,Patel; Hemal,9998,0,9999,1
1745816019226,CLRE 260,A00,891872,Cuomo; Raphael Eduardo,9999,0,9999,0
1745816020253,CLRE 297,001,891888,Cuomo; Raphael Eduardo,9999,0,9999,0
1745816021278,CSE 191,A00,958773,Minnes Kemp; Mor Mia,9999,0,9999,0
1745816022304,CSS 201S,A01,892054,Mignozzetti; Umberto,30,0,30,0
1745816023331,CSS 202S,A01,892056,Mignozzetti; Umberto,30,0,30,0
1745816024357,DSC 197,001,956898,Eldridge; Justin Matthew,9998,0,9999,1
1745816025384,DSC 297,001,958000,Mazumdar; Arya,9998,0,9999,1
1745816026413,EAP 100,A00,905686,Staff,9776,0,9999,223
1745816027440,ECE 45,A01,892618,Staff,0,12,50,50
1745816028466,ECE 109,A01,892620,Staff,0,43,0,0
1745816029491,ECE 111,A01,892719,Staff,0,8,50,50
1745816030518,ECE 197,001,957920,Mercier; Patrick Philip,9992,0,9999,7
1745816031547,ECON 178,A01,907814,Zhu; Ying,28,0,35,7
1745816032574,EDS 115,A00,895312,Staff,41,0,45,4
1745816033602,EDS 117,A01,895337,Staff,30,0,30,0
1745816034626,EDS 125,A00,895341,Jones; Gabrielle Anastasia,43,0,45,2
1745816035654,EDS 128A,A01,895459,Fargason; Sharon Gayle,44,0,45,1
1745816036680,EDS 128B,A01,895543,Pappas; Elizabeth,44,0,45,1
1745816037705,EDS 139,A00,897203,Pappas; Elizabeth,44,0,45,1
1745816037705,EDS 139,B00,897209,Fargason; Sharon Gayle,44,0,45,1
1745816038732,EDS 201,A00,895545,Staff,43,0,45,2
1745816039757,EDS 203,A01,895581,Halter; Christopher P.,43,0,45,2
1745816040785,EDS 204R,A01,895625,Heinzman; Erica M.,43,0,45,2
1745816040785,EDS 204R,B01,895693,Halter; Christopher P.,18,0,45,27
1745816041813,EDS 206R,A00,895694,Fargason; Sharon Gayle,9,0,30,21
1745816041813,EDS 206R,B00,895695,Choi; Bailey Miyeon,20,0,30,10
1745816042839,EDS 250,A00,895697,Hemans; Patricia Ann Benitez,43,0,45,2
1745816043863,EDS 281,A00,895701,Meyerott; Theresa Ann,15,0,15,0
1745816044890,EDS 284,A00,895736,Meyerott; Theresa Ann,15,0,15,0
1745816045916,EDS 286,A00,897210,Fine; Sarah,15,0,15,0
1745816046945,EDS 289C,A01,895770,Daly; Alan J.,15,0,15,0
1745816047973,EDS 290,A00,897211,Hofstetter; Carolyn,15,0,15,0
1745816048999,LIGM 5A,A00,896162,Fischer-Grunski; Eva K,15,0,20,5
1745816050034,LIGM 5B,A00,896260,Fischer-Grunski; Eva K,17,0,20,3
1745816051064,LIGM 5C,A00,896308,Fischer-Grunski; Eva K,18,0,20,2
1745816052091,LIIT 5AS,A00,896313,Carnelos; Chiara,18,0,20,2
1745816053123,LIIT 5BS,A00,896416,Carnelos; Chiara,20,0,20,0
1745816054148,LIIT 5CS,A00,896564,Carnelos; Chiara,20,0,20,0
1745816055175,LISP 5A,A00,896588,Munoz Sanchez; Alicia,4,0,20,16
1745816056205,LISP 5B,A00,896653,Munoz Sanchez; Alicia,10,0,20,10
1745816057233,LISP 5C,A00,896655,Munoz Sanchez; Alicia,4,0,20,16
1745816058259,MAE 197,001,957918,Kleissl; Jan,9998,0,9999,1
1745816059285,MATH 2,A01,957937,Staff,34,0,35,1
1745816060310,MATH 197,001,957876,Kedlaya; Kiran S.,9993,0,9999,6
1745816061337,MCWP 40,A00,892729,Duru; Nur,13,0,20,7
1745816061337,MCWP 40,B00,893304,Montejo; Carolina,20,0,20,0
1745816062366,MCWP 40R,A00,893757,Redela; Pamela Morgan,0,7,20,20
1745816063391,MCWP 50,A00,893758,Morshed; Michael James,2,0,20,18
1745816063391,MCWP 50,B00,893761,Bartulis; Jason Michael,17,0,20,3
1745816064421,MCWP 50R,A00,893766,Compas; Sean Matthew,0,1,20,20
1745816064421,MCWP 50R,B00,893769,Carter; Jennifer A,0,0,20,20
1745816064421,MCWP 50R,C00,893771,Krone; Jarret,0,3,20,20
1745816064421,MCWP 50R,D00,893772,Miller; Elizabeth Deen,3,0,20,17
1745816064421,MCWP 50R,E00,893775,Carter; Andrea L,0,0,20,20
1745816065446,MMW 11R,A01,892721,Herbst; Matthew,11,0,27,16
1745816065446,MMW 11R,A02,892722,Herbst; Matthew,0,0,0,3
1745816066474,MMW 12R,A01,892724,Herbst; Matthew,0,10,16,16
1745816066474,MMW 12R,A02,892725,Herbst; Matthew,0,9,16,16
1745816067500,MMW 13R,A01,892727,Staff,0,3,16,16
1745816067500,MMW 13R,A02,892728,Staff,0,4,16,16
1745816067500,MMW 13R,A03,958032,Staff,0,3,16,16
1745816067500,MMW 13R,A04,958033,Staff,0,2,16,16
1745816067500,MMW 13R,A05,958034,Staff,0,3,16,16
1745816068525,SIO 295LS,A00,894015,Staff,7,0,25,18
1745816069553,SIO 295S,A00,894020,Staff,7,0,25,18
1745816070583,SIOC 290S,B01,958918,Staff,0,0,0,0
1745816071612,SIOC 291S,B01,958922,Staff,0,0,0,0
1745816072636,SOCI 117,A01,895339,Staff,4,0,5,1
1745816073663,WES 237B,A00,894149,Staff,11,0,20,9
1745816075723,AESE 279B,A00,891859,Staff,13,0,35,22
1745816076748,AIP 197,001,891854,Staff,70,0,70,0
1745816077777,ANTH 289S,A00,891856,Gagneux; Pascal,12,0,12,0
1745816078807,BENG 196,001,957946,Engler; Adam J.,9996,0,9999,3
1745816079833,CAT 124RS,A01,956906,Staff,8,0,25,17
1745816080857,CAT 125RS,A01,922013,Staff,8,0,25,17
1745816081885,CLRE 250,A00,891860,Morris; Sheldon,9995,0,9999,4
1745816083936,CLRE 251R,A00,907817,Mehta; Ravindra L.,9994,0,9999,5
1745816084963,CLRE 252,A00,891864,Cuomo; Raphael Eduardo,9993,0,9999,6
1745816085990,CLRE 253,A00,891867,Vaida; Florin,9994,0,9999,5
1745816085990,CLRE 253,B00,907819,Staff,9999,0,9999,0
1745816087018,CLRE 259,A00,891868,Patel; Hemal,9998,0,9999,1
1745816088046,CLRE 260,A00,891872,Cuomo; Raphael Eduardo,9999,0,9999,0
1745816089070,CLRE 297,001,891888,Cuomo; Raphael Eduardo,9999,0,9999,0
1745816090099,CSE 191,A00,958773,Minnes Kemp; Mor Mia,9999,0,9999,0
1745816091128,CSS 201S,A01,892054,Mignozzetti; Umberto,30,0,30,0
1745816092154,CSS 202S,A01,892056,Mignozzetti; Umberto,30,0,30,0
1745816093180,DSC 197,001,956898,Eldridge; Justin Matthew,9998,0,9999,1
1745816094206,DSC 297,001,958000,Mazumdar; Arya,9998,0,9999,1
1745816095234,EAP 100,A00,905686,Staff,9776,0,9999,223
1745816096260,ECE 45,A01,892618,Staff,0,12,50,50
1745816097286,ECE 109,A01,892620,Staff,0,43,0,0
1745816098313,ECE 111,A01,892719,Staff,0,8,50,50
1745816099342,ECE 197,001,957920,Mercier; Patrick Philip,9992,0,9999,7
1745816100372,ECON 178,A01,907814,Zhu; Ying,28,0,35,7
1745816101399,EDS 115,A00,895312,Staff,41,0,45,4
1745816102426,EDS 117,A01,895337,Staff,30,0,30,0
1745816103456,EDS 125,A00,895341,Jones; Gabrielle Anastasia,43,0,45,2
1745816104483,EDS 128A,A01,895459,Fargason; Sharon Gayle,44,0,45,1
1745816105511,EDS 128B,A01,895543,Pappas; Elizabeth,44,0,45,1
1745816106536,EDS 139,A00,897203,Pappas; Elizabeth,44,0,45,1
1745816106536,EDS 139,B00,897209,Fargason; Sharon Gayle,44,0,45,1
1745816107565,EDS 201,A00,895545,Staff,43,0,45,2
1745816108595,EDS 203,A01,895581,Halter; Christopher P.,43,0,45,2
1745816109621,EDS 204R,A01,895625,Heinzman; Erica M.,43,0,45,2
1745816109621,EDS 204R,B01,895693,Halter; Christopher P.,18,0,45,27
1745816110648,EDS 206R,A00,895694,Fargason; Sharon Gayle,9,0,30,21
1745816110648,EDS 206R,B00,895695,Choi; Bailey Miyeon,20,0,30,10
1745816111675,EDS 250,A00,895697,Hemans; Patricia Ann Benitez,43,0,45,2
1745816112701,EDS 281,A00,895701,Meyerott; Theresa Ann,15,0,15,0
1745816113727,EDS 284,A00,895736,Meyerott; Theresa Ann,15,0,15,0
1745816114753,EDS 286,A00,897210,Fine; Sarah,15,0,15,0
1745816115778,EDS 289C,A01,895770,Daly; Alan J.,15,0,15,0
1745816116803,EDS 290,A00,897211,Hofstetter; Carolyn,15,0,15,0
1745816117833,LIGM 5A,A00,896162,Fischer-Grunski; Eva K,15,0,20,5
1745816118859,LIGM 5B,A00,896260,Fischer-Grunski; Eva K,17,0,20,3
1745816119888,LIGM 5C,A00,896308,Fischer-Grunski; Eva K,18,0,20,2
1745816120914,LIIT 5AS,A00,896313,Carnelos; Chiara,18,0,20,2
1745816121942,LIIT 5BS,A00,896416,Carnelos; Chiara,20,0,20,0
1745816122970,LIIT 5CS,A00,896564,Carnelos; Chiara,20,0,20,0
1745816124002,LISP 5A,A00,896588,Munoz Sanchez; Alicia,4,0,20,16
1745816125028,LISP 5B,A00,896653,Munoz Sanchez; Alicia,10,0,20,10
1745816126054,LISP 5C,A00,896655,Munoz Sanchez; Alicia,4,0,20,16
1745816127080,MAE 197,001,957918,Kleissl; Jan,9998,0,9999,1
1745816128107,MATH 2,A01,957937,Staff,34,0,35,1
1745816129132,MATH 197,001,957876,Kedlaya; Kiran S.,9993,0,9999,6
1745816130163,MCWP 40,A00,892729,Duru; Nur,13,0,20,7
1745816130163,MCWP 40,B00,893304,Montejo; Carolina,20,0,20,0
1745816131189,MCWP 40R,A00,893757,Redela; Pamela Morgan,0,7,20,20
1745816132215,MCWP 50,A00,893758,Morshed; Michael James,2,0,20,18
1745816132215,MCWP 50,B00,893761,Bartulis; Jason Michael,17,0,20,3
1745816133240,MCWP 50R,A00,893766,Compas; Sean Matthew,0,1,20,20
1745816133240,MCWP 50R,B00,893769,Carter; Jennifer A,0,0,20,20
1745816133240,MCWP 50R,C00,893771,Krone; Jarret,0,3,20,20
1745816133240,MCWP 50R,D00,893772,Miller; Elizabeth Deen,3,0,20,17
1745816133240,MCWP 50R,E00,893775,Carter; Andrea L,0,0,20,20
1745816134265,MMW 11R,A01,892721,Herbst; Matthew,11,0,27,16
1745816134265,MMW 11R,A02,892722,Herbst; Matthew,0,0,0,3
1745816135290,MMW 12R,A01,892724,Herbst; Matthew,0,10,16,16
1745816135290,MMW 12R,A02,892725,Herbst; Matthew,0,9,16,16
1745816136320,MMW 13R,A01,892727,Staff,0,3,16,16
1745816136320,MMW 13R,A02,892728,Staff,0,4,16,16
1745816136320,MMW 13R,A03,958032,Staff,0,3,16,16
1745816136320,MMW 13R,A04,958033,Staff,0,2,16,16
1745816136320,MMW 13R,A05,958034,Staff,0,3,16,16
1745816137348,SIO 295LS,A00,894015,Staff,7,0,25,18
1745816138375,SIO 295S,A00,894020,Staff,7,0,25,18
1745816139405,SIOC 290S,B01,958918,Staff,0,0,0,0
1745816140434,SIOC 291S,B01,958922,Staff,0,0,0,0
1745816141460,SOCI 117,A01,895339,Staff,4,0,5,1
1745816142484,WES 237B,A00,894149,Staff,11,0,20,9
1745816144546,AESE 279B,A00,891859,Staff,13,0,35,22
1745816145574,AIP 197,001,891854,Staff,70,0,70,0
1745816146605,ANTH 289S,A00,891856,Gagneux; Pascal,12,0,12,0
1745816147633,BENG 196,001,957946,Engler; Adam J.,9996,0,9999,3
1745816148660,CAT 124RS,A01,956906,Staff,8,0,25,17
1745816149687,CAT 125RS,A01,922013,Staff,8,0,25,17
1745816150713,CLRE 250,A00,891860,Morris; Sheldon,9995,0,9999,4
1745816152765,CLRE 251R,A00,907817,Mehta; Ravindra L.,9994,0,9999,5
1745816153791,CLRE 252,A00,891864,Cuomo; Raphael Eduardo,9993,0,9999,6
1745816154820,CLRE 253,A00,891867,Vaida; Florin,9994,0,9999,5
1745816154820,CLRE 253,B00,907819,Staff,9999,0,9999,0
1745816155847,CLRE 259,A00,891868,Patel; Hemal,9998,0,9999,1
1745816156872,CLRE 260,A00,891872,Cuomo; Raphael Eduardo,9999,0,9999,0
1745816157898,CLRE 297,001,891888,Cuomo; Raphael Eduardo,9999,0,9999,0
1745816158926,CSE 191,A00,958773,Minnes Kemp; Mor Mia,9999,0,9999,0
1745816159951,CSS 201S,A01,892054,Mignozzetti; Umberto,30,0,30,0
1745816160977,CSS 202S,A01,892056,Mignozzetti; Umberto,30,0,30,0
1745816162003,DSC 197,001,956898,Eldridge; Justin Matthew,9998,0,9999,1
1745816163033,DSC 297,001,958000,Mazumdar; Arya,9998,0,9999,1
1745816164058,EAP 100,A00,905686,Staff,9776,0,9999,223
1745816165087,ECE 45,A01,892618,Staff,0,12,50,50
1745816166116,ECE 109,A01,892620,Staff,0,43,0,0
1745816167142,ECE 111,A01,892719,Staff,0,8,50,50
1745816168168,ECE 197,001,957920,Mercier; Patrick Philip,9992,0,9999,7
1745816169194,ECON 178,A01,907814,Zhu; Ying,28,0,35,7
1745816170219,EDS 115,A00,895312,Staff,41,0,45,4
1745816171247,EDS 117,A01,895337,Staff,30,0,30,0
1745816172275,EDS 125,A00,895341,Jones; Gabrielle Anastasia,43,0,45,2
1745816173304,EDS 128A,A01,895459,Fargason; Sharon Gayle,44,0,45,1
1745816174330,EDS 128B,A01,895543,Pappas; Elizabeth,44,0,45,1
1745816175358,EDS 139,A00,897203,Pappas; Elizabeth,44,0,45,1
1745816175358,EDS 139,B00,897209,Fargason; Sharon Gayle,44,0,45,1
1745816176384,EDS 201,A00,895545,Staff,43,0,45,2
1745816177410,EDS 203,A01,895581,Halter; Christopher P.,43,0,45,2
1745816178442,EDS 204R,A01,895625,Heinzman; Erica M.,43,0,45,2
1745816178442,EDS 204R,B01,895693,Halter; Christopher P.,18,0,45,27
1745816179467,EDS 206R,A00,895694,Fargason; Sharon Gayle,9,0,30,21
1745816179467,EDS 206R,B00,895695,Choi; Bailey Miyeon,20,0,30,10
1745816180497,EDS 250,A00,895697,Hemans; Patricia Ann Benitez,43,0,45,2
1745816181521,EDS 281,A00,895701,Meyerott; Theresa Ann,15,0,15,0
1745816182547,EDS 284,A00,895736,Meyerott; Theresa Ann,15,0,15,0
1745816183575,EDS 286,A00,897210,Fine; Sarah,15,0,15,0
1745816184601,EDS 289C,A01,895770,Daly; Alan J.,15,0,15,0
1745816185627,EDS 290,A00,897211,Hofstetter; Carolyn,15,0,15,0
1745816186656,LIGM 5A,A00,896162,Fischer-Grunski; Eva K,15,0,20,5
1745816187686,LIGM 5B,A00,896260,Fischer-Grunski; Eva K,17,0,20,3
1745816188709,LIGM 5C,A00,896308,Fischer-Grunski; Eva K,18,0,20,2
1745816189742,LIIT 5AS,A00,896313,Carnelos; Chiara,18,0,20,2
1745816190769,LIIT 5BS,A00,896416,Carnelos; Chiara,20,0,20,0
1745816191795,LIIT 5CS,A00,896564,Carnelos; Chiara,20,0,20,0
1745816192821,LISP 5A,A00,896588,Munoz Sanchez; Alicia,4,0,20,16
1745816193847,LISP 5B,A00,896653,Munoz Sanchez; Alicia,10,0,20,10
1745816194874,LISP 5C,A00,896655,Munoz Sanchez; Alicia,4,0,20,16
1745816195899,MAE 197,001,957918,Kleissl; Jan,9998,0,9999,1
1745816196925,MATH 2,A01,957937,Staff,34,0,35,1
1745816197949,MATH 197,001,957876,Kedlaya; Kiran S.,9993,0,9999,6
1745816198979,MCWP 40,A00,892729,Duru; Nur,13,0,20,7
1745816198979,MCWP 40,B00,893304,Montejo; Carolina,20,0,20,0
1745816200008,MCWP 40R,A00,893757,Redela; Pamela Morgan,0,7,20,20
1745816201036,MCWP 50,A00,893758,Morshed; Michael James,2,0,20,18
1745816201036,MCWP 50,B00,893761,Bartulis; Jason Michael,17,0,20,3
1745816202066,MCWP 50R,A00,893766,Compas; Sean Matthew,0,1,20,20
1745816202066,MCWP 50R,B00,893769,Carter; Jennifer A,0,0,20,20
1745816202066,MCWP 50R,C00,893771,Krone; Jarret,0,3,20,20
1745816202066,MCWP 50R,D00,893772,Miller; Elizabeth Deen,3,0,20,17
1745816202066,MCWP 50R,E00,893775,Carter; Andrea L,0,0,20,20
1745816203090,MMW 11R,A01,892721,Herbst; Matthew,11,0,27,16
1745816203090,MMW 11R,A02,892722,Herbst; Matthew,0,0,0,3
1745816204118,MMW 12R,A01,892724,Herbst; Matthew,0,10,16,16
1745816204118,MMW 12R,A02,892725,Herbst; Matthew,0,9,16,16
1745816205144,MMW 13R,A01,892727,Staff,0,3,16,16
1745816205144,MMW 13R,A02,892728,Staff,0,4,16,16
1745816205144,MMW 13R,A03,958032,Staff,0,3,16,16
1745816205144,MMW 13R,A04,958033,Staff,0,2,16,16
1745816205144,MMW 13R,A05,958034,Staff,0,3,16,16
1745816206170,SIO 295LS,A00,894015,Staff,7,0,25,18
1745816207196,SIO 295S,A00,894020,Staff,7,0,25,18
1745816208222,SIOC 290S,B01,958918,Staff,0,0,0,0
1745816209247,SIOC 291S,B01,958922,Staff,0,0,0,0
1745816210273,SOCI 117,A01,895339,Staff,4,0,5,1
1745816211300,WES 237B,A00,894149,Staff,11,0,20,9
1745816213368,AESE 279B,A00,891859,Staff,13,0,35,22
1745816214396,AIP 197,001,891854,Staff,70,0,70,0
1745816215421,ANTH 289S,A00,891856,Gagneux; Pascal,12,0,12,0
1745816216450,BENG 196,001,957946,Engler; Adam J.,9996,0,9999,3
1745816217478,CAT 124RS,A01,956906,Staff,8,0,25,17
1745816218505,CAT 125RS,A01,922013,Staff,8,0,25,17
1745816219530,CLRE 250,A00,891860,Morris; Sheldon,9995,0,9999,4
1745816221583,CLRE 251R,A00,907817,Mehta; Ravindra L.,9994,0,9999,5
1745816222631,CLRE 252,A00,891864,Cuomo; Raphael Eduardo,9993,0,9999,6
1745816223657,CLRE 253,A00,891867,Vaida; Florin,9994,0,9999,5
1745816223657,CLRE 253,B00,907819,Staff,9999,0,9999,0
1745816224681,CLRE 259,A00,891868,Patel; Hemal,9998,0,9999,1
1745816225710,CLRE 260,A00,891872,Cuomo; Raphael Eduardo,9999,0,9999,0
1745816226735,CLRE 297,001,891888,Cuomo; Raphael Eduardo,9999,0,9999,0
1745816227761,CSE 191,A00,958773,Minnes Kemp; Mor Mia,9999,0,9999,0
1745816228786,CSS 201S,A01,892054,Mignozzetti; Umberto,30,0,30,0
1745816229814,CSS 202S,A01,892056,Mignozzetti; Umberto,30,0,30,0
1745816230841,DSC 197,001,956898,Eldridge; Justin Matthew,9998,0,9999,1
1745816231868,DSC 297,001,958000,Mazumdar; Arya,9998,0,9999,1
1745816232895,EAP 100,A00,905686,Staff,9776,0,9999,223
1745816233921,ECE 45,A01,892618,Staff,0,12,50,50
1745816234947,ECE 109,A01,892620,Staff,0,43,0,0
1745816235974,ECE 111,A01,892719,Staff,0,8,50,50
1745816236999,ECE 197,001,957920,Mercier; Patrick Philip,9992,0,9999,7
1745816238023,ECON 178,A01,907814,Zhu; Ying,28,0,35,7
1745816239050,EDS 115,A00,895312,Staff,41,0,45,4
1745816240075,EDS 117,A01,895337,Staff,30,0,30,0
1745816241101,EDS 125,A00,895341,Jones; Gabrielle Anastasia,43,0,45,2
1745816242126,EDS 128A,A01,895459,Fargason; Sharon Gayle,44,0,45,1
1745816243154,EDS 128B,A01,895543,Pappas; Elizabeth,44,0,45,1
1745816244184,EDS 139,A00,897203,Pappas; Elizabeth,44,0,45,1
1745816244184,EDS 139,B00,897209,Fargason; Sharon Gayle,44,0,45,1
1745816245208,EDS 201,A00,895545,Staff,43,0,45,2
1745816246234,EDS 203,A01,895581,Halter; Christopher P.,43,0,45,2
1745816247262,EDS 204R,A01,895625,Heinzman; Erica M.,43,0,45,2
1745816247262,EDS 204R,B01,895693,Halter; Christopher P.,18,0,45,27
1745816248288,EDS 206R,A00,895694,Fargason; Sharon Gayle,9,0,30,21
1745816248288,EDS 206R,B00,895695,Choi; Bailey Miyeon,20,0,30,10
1745816249315,EDS 250,A00,895697,Hemans; Patricia Ann Benitez,43,0,45,2
1745816250342,EDS 281,A00,895701,Meyerott; Theresa Ann,15,0,15,0
1745816251370,EDS 284,A00,895736,Meyerott; Theresa Ann,15,0,15,0
1745816252406,EDS 286,A00,897210,Fine; Sarah,15,0,15,0
1745816253431,EDS 289C,A01,895770,Daly; Alan J.,15,0,15,0
1745816254459,EDS 290,A00,897211,Hofstetter; Carolyn,15,0,15,0
1745816255488,LIGM 5A,A00,896162,Fischer-Grunski; Eva K,15,0,20,5
1745816256512,LIGM 5B,A00,896260,Fischer-Grunski; Eva K,17,0,20,3
1745816257538,LIGM 5C,A00,896308,Fischer-Grunski; Eva K,18,0,20,2
1745816258562,LIIT 5AS,A00,896313,Carnelos; Chiara,18,0,20,2
1745816259589,LIIT 5BS,A00,896416,Carnelos; Chiara,20,0,20,0
1745816260616,LIIT 5CS,A00,896564,Carnelos; Chiara,20,0,20,0
1745816261641,LISP 5A,A00,896588,Munoz Sanchez; Alicia,4,0,20,16
1745816262676,LISP 5B,A00,896653,Munoz Sanchez; Alicia,10,0,20,10
1745816263704,LISP 5C,A00,896655,Munoz Sanchez; Alicia,4,0,20,16
1745816264728,MAE 197,001,957918,Kleissl; Jan,9998,0,9999,1
1745816265754,MATH 2,A01,957937,Staff,34,0,35,1
1745816266779,MATH 197,001,957876,Kedlaya; Kiran S.,9993,0,9999,6
1745816267804,MCWP 40,A00,892729,Duru; Nur,13,0,20,7
1745816267804,MCWP 40,B00,893304,Montejo; Carolina,20,0,20,0
1745816268829,MCWP 40R,A00,893757,Redela; Pamela Morgan,0,7,20,20
1745816269856,MCWP 50,A00,893758,Morshed; Michael James,2,0,20,18
1745816269856,MCWP 50,B00,893761,Bartulis; Jason Michael,17,0,20,3
1745816270884,MCWP 50R,A00,893766,Compas; Sean Matthew,0,1,20,20
1745816270884,MCWP 50R,B00,893769,Carter; Jennifer A,0,0,20,20
1745816270884,MCWP 50R,C00,893771,Krone; Jarret,0,3,20,20
1745816270884,MCWP 50R,D00,893772,Miller; Elizabeth Deen,3,0,20,17
1745816270884,MCWP 50R,E00,893775,Carter; Andrea L,0,0,20,20
1745816271909,MMW 11R,A01,892721,Herbst; Matthew,11,0,27,16
1745816271909,MMW 11R,A02,892722,Herbst; Matthew,0,0,0,3
1745816272937,MMW 12R,A01,892724,Herbst; Matthew,0,10,16,16
1745816272937,MMW 12R,A02,892725,Herbst; Matthew,0,9,16,16
1745816273966,MMW 13R,A01,892727,Staff,0,3,16,16
1745816273966,MMW 13R,A02,892728,Staff,0,4,16,16
1745816273966,MMW 13R,A03,958032,Staff,0,3,16,16
1745816273966,MMW 13R,A04,958033,Staff,0,2,16,16
1745816273966,MMW 13R,A05,958034,Staff,0,3,16,16
1745816274992,SIO 295LS,A00,894015,Staff,7,0,25,18
1745816276017,SIO 295S,A00,894020,Staff,7,0,25,18
1745816277046,SIOC 290S,B01,958918,Staff,0,0,0,0
1745816278078,SIOC 291S,B01,958922,Staff,0,0,0,0
1745816279105,SOCI 117,A01,895339,Staff,4,0,5,1
1745816280134,WES 237B,A00,894149,Staff,11,0,20,9
1745816282200,AESE 279B,A00,891859,Staff,13,0,35,22
1745816283226,AIP 197,001,891854,Staff,70,0,70,0
1745816284256,ANTH 289S,A00,891856,Gagneux; Pascal,12,0,12,0
1745816285281,BENG 196,001,957946,Engler; Adam J.,9996,0,9999,3
1745816286308,CAT 124RS,A01,956906,Staff,8,0,25,17
1745816287334,CAT 125RS,A01,922013,Staff,8,0,25,17
1745816288359,CLRE 250,A00,891860,Morris; Sheldon,9995,0,9999,4
1745816290413,CLRE 251R,A00,907817,Mehta; Ravindra L.,9994,0,9999,5
1745816291438,CLRE 252,A00,891864,Cuomo; Raphael Eduardo,9993,0,9999,6
1745816292665,CLRE 253,A00,891867,Vaida; Florin,9994,0,9999,5
1745816292665,CLRE 253,B00,907819,Staff,9999,0,9999,0
1745816293691,CLRE 259,A00,891868,Patel; Hemal,9998,0,9999,1
1745816294717,CLRE 260,A00,891872,Cuomo; Raphael Eduardo,9999,0,9999,0
1745816295747,CLRE 297,001,891888,Cuomo; Raphael Eduardo,9999,0,9999,0
1745816296773,CSE 191,A00,958773,Minnes Kemp; Mor Mia,9999,0,9999,0
1745816297800,CSS 201S,A01,892054,Mignozzetti; Umberto,30,0,30,0
1745816298825,CSS 202S,A01,892056,Mignozzetti; Umberto,30,0,30,0
1745816299851,DSC 197,001,956898,Eldridge; Justin Matthew,9998,0,9999,1
1745816300876,DSC 297,001,958000,Mazumdar; Arya,9998,0,9999,1
1745816301906,EAP 100,A00,905686,Staff,9776,0,9999,223
1745816302932,ECE 45,A01,892618,Staff,0,12,50,50
1745816303961,ECE 109,A01,892620,Staff,0,43,0,0
1745816304988,ECE 111,A01,892719,Staff,0,8,50,50
1745816306013,ECE 197,001,957920,Mercier; Patrick Philip,9992,0,9999,7
1745816307043,ECON 178,A01,907814,Zhu; Ying,28,0,35,7
1745816308070,EDS 115,A00,895312,Staff,41,0,45,4
1745816309096,EDS 117,A01,895337,Staff,30,0,30,0
1745816310127,EDS 125,A00,895341,Jones; Gabrielle Anastasia,43,0,45,2
1745816311157,EDS 128A,A01,895459,Fargason; Sharon Gayle,44,0,45,1
1745816312199,EDS 128B,A01,895543,Pappas; Elizabeth,44,0,45,1
1745816313226,EDS 139,A00,897203,Pappas; Elizabeth,44,0,45,1
1745816313226,EDS 139,B00,897209,Fargason; Sharon Gayle,44,0,45,1
1745816314255,EDS 201,A00,895545,Staff,43,0,45,2
1745816315281,EDS 203,A01,895581,Halter; Christopher P.,43,0,45,2
1745816316307,EDS 204R,A01,895625,Heinzman; Erica M.,43,0,45,2
1745816316307,EDS 204R,B01,895693,Halter; Christopher P.,18,0,45,27
1745816317334,EDS 206R,A00,895694,Fargason; Sharon Gayle,9,0,30,21
1745816317334,EDS 206R,B00,895695,Choi; Bailey Miyeon,20,0,30,10
1745816318358,EDS 250,A00,895697,Hemans; Patricia Ann Benitez,43,0,45,2
1745816319386,EDS 281,A00,895701,Meyerott; Theresa Ann,15,0,15,0
1745816320410,EDS 284,A00,895736,Meyerott; Theresa Ann,15,0,15,0
1745816321438,EDS 286,A00,897210,Fine; Sarah,15,0,15,0
1745816322465,EDS 289C,A01,895770,Daly; Alan J.,15,0,15,0
1745816323490,EDS 290,A00,897211,Hofstetter; Carolyn,15,0,15,0
1745816324517,LIGM 5A,A00,896162,Fischer-Grunski; Eva K,15,0,20,5
1745816325544,LIGM 5B,A00,896260,Fischer-Grunski; Eva K,17,0,20,3
1745816326571,LIGM 5C,A00,896308,Fischer-Grunski; Eva K,18,0,20,2
1745816327597,LIIT 5AS,A00,896313,Carnelos; Chiara,18,0,20,2
1745816328623,LIIT 5BS,A00,896416,Carnelos; Chiara,20,0,20,0
1745816329651,LIIT 5CS,A00,896564,Carnelos; Chiara,20,0,20,0
1745816330680,LISP 5A,A00,896588,Munoz Sanchez; Alicia,4,0,20,16
1745816331710,LISP 5B,A00,896653,Munoz Sanchez; Alicia,10,0,20,10
1745816332736,LISP 5C,A00,896655,Munoz Sanchez; Alicia,4,0,20,16
1745816333764,MAE 197,001,957918,Kleissl; Jan,9998,0,9999,1
1745816334791,MATH 2,A01,957937,Staff,34,0,35,1
1745816335817,MATH 197,001,957876,Kedlaya; Kiran S.,9993,0,9999,6
1745816336845,MCWP 40,A00,892729,Duru; Nur,13,0,20,7
1745816336845,MCWP 40,B00,893304,Montejo; Carolina,20,0,20,0
1745816337872,MCWP 40R,A00,893757,Redela; Pamela Morgan,0,7,20,20
1745816338899,MCWP 50,A00,893758,Morshed; Michael James,2,0,20,18
1745816338899,MCWP 50,B00,893761,Bartulis; Jason Michael,17,0,20,3
1745816339925,MCWP 50R,A00,893766,Compas; Sean Matthew,0,1,20,20
1745816339925,MCWP 50R,B00,893769,Carter; Jennifer A,0,0,20,20
1745816339925,MCWP 50R,C00,893771,Krone; Jarret,0,3,20,20
1745816339925,MCWP 50R,D00,893772,Miller; Elizabeth Deen,3,0,20,17
1745816339925,MCWP 50R,E00,893775,Carter; Andrea L,0,0,20,20
1745816340953,MMW 11R,A01,892721,Herbst; Matthew,11,0,27,16
1745816340953,MMW 11R,A02,892722,Herbst; Matthew,0,0,0,3
1745816341978,MMW 12R,A01,892724,Herbst; Matthew,0,10,16,16
1745816341978,MMW 12R,A02,892725,Herbst; Matthew,0,9,16,16
1745816343009,MMW 13R,A01,892727,Staff,0,3,16,16
1745816343009,MMW 13R,A02,892728,Staff,0,4,16,16
1745816343009,MMW 13R,A03,958032,Staff,0,3,16,16
1745816343009,MMW 13R,A04,958033,Staff,0,2,16,16
1745816343009,MMW 13R,A05,958034,Staff,0,3,16,16
1745816344035,SIO 295LS,A00,894015,Staff,7,0,25,18
1745816345065,SIO 295S,A00,894020,Staff,7,0,25,18
1745816346095,SIOC 290S,B01,958918,Staff,0,0,0,0
1745816347125,SIOC 291S,B01,958922,Staff,0,0,0,0
1745816348152,SOCI 117,A01,895339,Staff,4,0,5,1
1745816349179,WES 237B,A00,894149,Staff,11,0,20,9
1745816351246,AESE 279B,A00,891859,Staff,13,0,35,22
1745816352271,AIP 197,001,891854,Staff,70,0,70,0
1745816353297,ANTH 289S,A00,891856,Gagneux; Pascal,12,0,12,0
1745816354322,BENG 196,001,957946,Engler; Adam J.,9996,0,9999,3
1745816355347,CAT 124RS,A01,956906,Staff,8,0,25,17
1745816356377,CAT 125RS,A01,922013,Staff,8,0,25,17
1745816357403,CLRE 250,A00,891860,Morris; Sheldon,9995,0,9999,4
1745816359460,CLRE 251R,A00,907817,Mehta; Ravindra L.,9994,0,9999,5
1745816360489,CLRE 252,A00,891864,Cuomo; Raphael Eduardo,9993,0,9999,6
1745816361516,CLRE 253,A00,891867,Vaida; Florin,9994,0,9999,5
1745816361516,CLRE 253,B00,907819,Staff,9999,0,9999,0
1745816362541,CLRE 259,A00,891868,Patel; Hemal,9998,0,9999,1
1745816363568,CLRE 260,A00,891872,Cuomo; Raphael Eduardo,9999,0,9999,0
1745816364593,CLRE 297,001,891888,Cuomo; Raphael Eduardo,9999,0,9999,0
1745816365620,CSE 191,A00,958773,Minnes Kemp; Mor Mia,9999,0,9999,0
1745816366651,CSS 201S,A01,892054,Mignozzetti; Umberto,30,0,30,0
1745816367678,CSS 202S,A01,892056,Mignozzetti; Umberto,30,0,30,0
1745816368701,DSC 197,001,956898,Eldridge; Justin Matthew,9998,0,9999,1
1745816369728,DSC 297,001,958000,Mazumdar; Arya,9998,0,9999,1
1745816370754,EAP 100,A00,905686,Staff,9776,0,9999,223
1745816371780,ECE 45,A01,892618,Staff,0,12,50,50
1745816372805,ECE 109,A01,892620,Staff,0,43,0,0
1745816373830,ECE 111,A01,892719,Staff,0,8,50,50
1745816374857,ECE 197,001,957920,Mercier; Patrick Philip,9992,0,9999,7
1745816375882,ECON 178,A01,907814,Zhu; Ying,28,0,35,7
1745816376910,EDS 115,A00,895312,Staff,41,0,45,4
1745816377935,EDS 117,A01,895337,Staff,30,0,30,0
1745816378961,EDS 125,A00,895341,Jones; Gabrielle Anastasia,43,0,45,2
1745816379987,EDS 128A,A01,895459,Fargason; Sharon Gayle,44,0,45,1
1745816381013,EDS 128B,A01,895543,Pappas; Elizabeth,44,0,45,1
1745816382036,EDS 139,A00,897203,Pappas; Elizabeth,44,0,45,1
1745816382036,EDS 139,B00,897209,Fargason; Sharon Gayle,44,0,45,1
1745816383065,EDS 201,A00,895545,Staff,43,0,45,2
1745816384094,EDS 203,A01,895581,Halter; Christopher P.,43,0,45,2
1745816385121,EDS 204R,A01,895625,Heinzman; Erica M.,43,0,45,2
1745816385121,EDS 204R,B01,895693,Halter; Christopher P.,18,0,45,27
1745816386146,EDS 206R,A00,895694,Fargason; Sharon Gayle,9,0,30,21
1745816386146,EDS 206R,B00,895695,Choi; Bailey Miyeon,20,0,30,10
1745816387171,EDS 250,A00,895697,Hemans; Patricia Ann Benitez,43,0,45,2
1745816388200,EDS 281,A00,895701,Meyerott; Theresa Ann,15,0,15,0
1745816389225,EDS 284,A00,895736,Meyerott; Theresa Ann,15,0,15,0
1745816390254,EDS 286,A00,897210,Fine; Sarah,15,0,15,0
1745816391281,EDS 289C,A01,895770,Daly; Alan J.,15,0,15,0
1745816392307,EDS 290,A00,897211,Hofstetter; Carolyn,15,0,15,0
1745816393334,LIGM 5A,A00,896162,Fischer-Grunski; Eva K,15,0,20,5
1745816394362,LIGM 5B,A00,896260,Fischer-Grunski; Eva K,17,0,20,3
1745816395388,LIGM 5C,A00,896308,Fischer-Grunski; Eva K,18,0,20,2
1745816396419,LIIT 5AS,A00,896313,Carnelos; Chiara,18,0,20,2
1745816397448,LIIT 5BS,A00,896416,Carnelos; Chiara,20,0,20,0
1745816398477,LIIT 5CS,A00,896564,Carnelos; Chiara,20,0,20,0
1745816399506,LISP 5A,A00,896588,Munoz Sanchez; Alicia,4,0,20,16
1745816400534,LISP 5B,A00,896653,Munoz Sanchez; Alicia,10,0,20,10
1745816401559,LISP 5C,A00,896655,Munoz Sanchez; Alicia,4,0,20,16
1745816402587,MAE 197,001,957918,Kleissl; Jan,9998,0,9999,1
1745816403615,MATH 2,A01,957937,Staff,34,0,35,1
1745816404642,MATH 197,001,957876,Kedlaya; Kiran S.,9993,0,9999,6
1745816405670,MCWP 40,A00,892729,Duru; Nur,13,0,20,7
1745816405670,MCWP 40,B00,893304,Montejo; Carolina,20,0,20,0
1745816406697,MCWP 40R,A00,893757,Redela; Pamela Morgan,0,7,20,20
1745816407723,MCWP 50,A00,893758,Morshed; Michael James,2,0,20,18
1745816407723,MCWP 50,B00,893761,Bartulis; Jason Michael,17,0,20,3
1745816408748,MCWP 50R,A00,893766,Compas; Sean Matthew,0,1,20,20
1745816408748,MCWP 50R,B00,893769,Carter; Jennifer A,0,0,20,20
1745816408748,MCWP 50R,C00,893771,Krone; Jarret,0,3,20,20
1745816408748,MCWP 50R,D00,893772,Miller; Elizabeth Deen,3,0,20,17
1745816408748,MCWP 50R,E00,893775,Carter; Andrea L,0,0,20,20
1745816409776,MMW 11R,A01,892721,Herbst; Matthew,11,0,27,16
1745816409776,MMW 11R,A02,892722,Herbst; Matthew,0,0,0,3
1745816410801,MMW 12R,A01,892724,Herbst; Matthew,0,10,16,16
1745816410801,MMW 12R,A02,892725,Herbst; Matthew,0,9,16,16
1745816411827,MMW 13R,A01,892727,Staff,0,3,16,16
1745816411827,MMW 13R,A02,892728,Staff,0,4,16,16
1745816411827,MMW 13R,A03,958032,Staff,0,3,16,16
1745816411827,MMW 13R,A04,958033,Staff,0,2,16,16
1745816411827,MMW 13R,A05,958034,Staff,0,3,16,16
1745816412856,SIO 295LS,A00,894015,Staff,7,0,25,18
1745816413887,SIO 295S,A00,894020,Staff,7,0,25,18
1745816414911,SIOC 290S,B01,958918,Staff,0,0,0,0
1745816415936,SIOC 291S,B01,958922,Staff,0,0,0,0
1745816416962,SOCI 117,A01,895339,Staff,4,0,5,1
1745816417990,WES 237B,A00,894149,Staff,11,0,20,9
1745816420052,AESE 279B,A00,891859,Staff,13,0,35,22
1745816421080,AIP 197,001,891854,Staff,70,0,70,0
1745816422110,ANTH 289S,A00,891856,Gagneux; Pascal,12,0,12,0
1745816423138,BENG 196,001,957946,Engler; Adam J.,9996,0,9999,3
1745816424165,CAT 124RS,A01,956906,Staff,8,0,25,17
1745816425195,CAT 125RS,A01,922013,Staff,8,0,25,17
1745816426219,CLRE 250,A00,891860,Morris; Sheldon,9995,0,9999,4
1745816428273,CLRE 251R,A00,907817,Mehta; Ravindra L.,9994,0,9999,5
1745816429300,CLRE 252,A00,891864,Cuomo; Raphael Eduardo,9993,0,9999,6
1745816430325,CLRE 253,A00,891867,Vaida; Florin,9994,0,9999,5
1745816430325,CLRE 253,B00,907819,Staff,9999,0,9999,0
1745816431355,CLRE 259,A00,891868,Patel; Hemal,9998,0,9999,1
1745816432395,CLRE 260,A00,891872,Cuomo; Raphael Eduardo,9999,0,9999,0
1745816433420,CLRE 297,001,891888,Cuomo; Raphael Eduardo,9999,0,9999,0
1745816434448,CSE 191,A00,958773,Minnes Kemp; Mor Mia,9999,0,9999,0
1745816435475,CSS 201S,A01,892054,Mignozzetti; Umberto,30,0,30,0
1745816436501,CSS 202S,A01,892056,Mignozzetti; Umberto,30,0,30,0
1745816437527,DSC 197,001,956898,Eldridge; Justin Matthew,9998,0,9999,1
1745816438551,DSC 297,001,958000,Mazumdar; Arya,9998,0,9999,1
1745816439579,EAP 100,A00,905686,Staff,9776,0,9999,223
1745816440606,ECE 45,A01,892618,Staff,0,12,50,50
1745816441632,ECE 109,A01,892620,Staff,0,43,0,0
1745816442659,ECE 111,A01,892719,Staff,0,8,50,50
1745816443688,ECE 197,001,957920,Mercier; Patrick Philip,9992,0,9999,7
1745816444713,ECON 178,A01,907814,Zhu; Ying,28,0,35,7
1745816445739,EDS 115,A00,895312,Staff,41,0,45,4
1745816446767,EDS 117,A01,895337,Staff,30,0,30,0
1745816447797,EDS 125,A00,895341,Jones; Gabrielle Anastasia,43,0,45,2
1745816448821,EDS 128A,A01,895459,Fargason; Sharon Gayle,44,0,45,1
1745816449847,EDS 128B,A01,895543,Pappas; Elizabeth,44,0,45,1
1745816450874,EDS 139,A00,897203,Pappas; Elizabeth,44,0,45,1
1745816450874,EDS 139,B00,897209,Fargason; Sharon Gayle,44,0,45,1
1745816451900,EDS 201,A00,895545,Staff,43,0,45,2
1745816452928,EDS 203,A01,895581,Halter; Christopher P.,43,0,45,2
1745816453955,EDS 204R,A01,895625,Heinzman; Erica M.,43,0,45,2
1745816453955,EDS 204R,B01,895693,Halter; Christopher P.,18,0,45,27
1745816454982,EDS 206R,A00,895694,Fargason; Sharon Gayle,9,0,30,21
1745816454982,EDS 206R,B00,895695,Choi; Bailey Miyeon,20,0,30,10
1745816456007,EDS 250,A00,895697,Hemans; Patricia Ann Benitez,43,0,45,2
1745816457034,EDS 281,A00,895701,Meyerott; Theresa Ann,15,0,15,0
1745816458061,EDS 284,A00,895736,Meyerott; Theresa Ann,15,0,15,0
1745816459087,EDS 286,A00,897210,Fine; Sarah,15,0,15,0
1745816460116,EDS 289C,A01,895770,Daly; Alan J.,15,0,15,0
1745816461143,EDS 290,A00,897211,Hofstetter; Carolyn,15,0,15,0
1745816462168,LIGM 5A,A00,896162,Fischer-Grunski; Eva K,15,0,20,5
1745816463196,LIGM 5B,A00,896260,Fischer-Grunski; Eva K,17,0,20,3
1745816464222,LIGM 5C,A00,896308,Fischer-Grunski; Eva K,18,0,20,2
1745816465252,LIIT 5AS,A00,896313,Carnelos; Chiara,18,0,20,2
1745816466283,LIIT 5BS,A00,896416,Carnelos; Chiara,20,0,20,0
1745816467313,LIIT 5CS,A00,896564,Carnelos; Chiara,20,0,20,0
1745816468341,LISP 5A,A00,896588,Munoz Sanchez; Alicia,4,0,20,16
1745816469368,LISP 5B,A00,896653,Munoz Sanchez; Alicia,10,0,20,10
1745816470394,LISP 5C,A00,896655,Munoz Sanchez; Alicia,4,0,20,16
1745816471423,MAE 197,001,957918,Kleissl; Jan,9998,0,9999,1
1745816472496,MATH 2,A01,957937,Staff,34,0,35,1
1745816473526,MATH 197,001,957876,Kedlaya; Kiran S.,9993,0,9999,6
1745816474555,MCWP 40,A00,892729,Duru; Nur,13,0,20,7
1745816474555,MCWP 40,B00,893304,Montejo; Carolina,20,0,20,0
1745816475584,MCWP 40R,A00,893757,Redela; Pamela Morgan,0,7,20,20
1745816476610,MCWP 50,A00,893758,Morshed; Michael James,2,0,20,18
1745816476610,MCWP 50,B00,893761,Bartulis; Jason Michael,17,0,20,3
1745816477639,MCWP 50R,A00,893766,Compas; Sean Matthew,0,1,20,20
1745816477639,MCWP 50R,B00,893769,Carter; Jennifer A,0,0,20,20
1745816477639,MCWP 50R,C00,893771,Krone; Jarret,0,3,20,20
1745816477639,MCWP 50R,D00,893772,Miller; Elizabeth Deen,3,0,20,17
1745816477639,MCWP 50R,E00,893775,Carter; Andrea L,0,0,20,20
1745816478667,MMW 11R,A01,892721,Herbst; Matthew,11,0,27,16
1745816478667,MMW 11R,A02,892722,Herbst; Matthew,0,0,0,3
1745816479692,MMW 12R,A01,892724,Herbst; Matthew,0,10,16,16
1745816479692,MMW 12R,A02,892725,Herbst; Matthew,0,9,16,16
1745816480717,MMW 13R,A01,892727,Staff,0,3,16,16
1745816480717,MMW 13R,A02,892728,Staff,0,4,16,16
1745816480717,MMW 13R,A03,958032,Staff,0,3,16,16
1745816480717,MMW 13R,A04,958033,Staff,0,2,16,16
1745816480717,MMW 13R,A05,958034,Staff,0,3,16,16
1745816481742,SIO 295LS,A00,894015,Staff,7,0,25,18
1745816482770,SIO 295S,A00,894020,Staff,7,0,25,18
1745816483795,SIOC 290S,B01,958918,Staff,0,0,0,0
1745816484821,SIOC 291S,B01,958922,Staff,0,0,0,0
1745816485847,SOCI 117,A01,895339,Staff,4,0,5,1
1745816486874,WES 237B,A00,894149,Staff,11,0,20,9
1745816488940,AESE 279B,A00,891859,Staff,13,0,35,22
1745816489965,AIP 197,001,891854,Staff,70,0,70,0
1745816490990,ANTH 289S,A00,891856,Gagneux; Pascal,12,0,12,0
1745816492019,BENG 196,001,957946,Engler; Adam J.,9996,0,9999,3
1745816493045,CAT 124RS,A01,956906,Staff,8,0,25,17
1745816494075,CAT 125RS,A01,922013,Staff,8,0,25,17
1745816495105,CLRE 250,A00,891860,Morris; Sheldon,9995,0,9999,4
1745816497168,CLRE 251R,A00,907817,Mehta; Ravindra L.,9994,0,9999,5
1745816498194,CLRE 252,A00,891864,Cuomo; Raphael Eduardo,9993,0,9999,6
1745816499224,CLRE 253,A00,891867,Vaida; Florin,9994,0,9999,5
1745816499224,CLRE 253,B00,907819,Staff,9999,0,9999,0
1745816500250,CLRE 259,A00,891868,Patel; Hemal,9998,0,9999,1
1745816501276,CLRE 260,A00,891872,Cuomo; Raphael Eduardo,9999,0,9999,0
1745816502304,CLRE 297,001,891888,Cuomo; Raphael Eduardo,9999,0,9999,0
1745816503331,CSE 191,A00,958773,Minnes Kemp; Mor Mia,9999,0,9999,0
1745816504360,CSS 201S,A01,892054,Mignozzetti; Umberto,30,0,30,0
1745816505389,CSS 202S,A01,892056,Mignozzetti; Umberto,30,0,30,0
1745816506412,DSC 197,001,956898,Eldridge; Justin Matthew,9998,0,9999,1
1745816507440,DSC 297,001,958000,Mazumdar; Arya,9998,0,9999,1
1745816508465,EAP 100,A00,905686,Staff,9776,0,9999,223
1745816509495,ECE 45,A01,892618,Staff,0,12,50,50
1745816510521,ECE 109,A01,892620,Staff,0,43,0,0
1745816511547,ECE 111,A01,892719,Staff,0,8,50,50
1745816512573,ECE 197,001,957920,Mercier; Patrick Philip,9992,0,9999,7
1745816513602,ECON 178,A01,907814,Zhu; Ying,28,0,35,7
1745816514628,EDS 115,A00,895312,Staff,41,0,45,4
1745816515656,EDS 117,A01,895337,Staff,30,0,30,0
1745816516685,EDS 125,A00,895341,Jones; Gabrielle Anastasia,43,0,45,2
1745816517713,EDS 128A,A01,895459,Fargason; Sharon Gayle,44,0,45,1
1745816518740,EDS 128B,A01,895543,Pappas; Elizabeth,44,0,45,1
1745816519766,EDS 139,A00,897203,Pappas; Elizabeth,44,0,45,1
1745816519766,EDS 139,B00,897209,Fargason; Sharon Gayle,44,0,45,1
1745816520794,EDS 201,A00,895545,Staff,43,0,45,2
1745816521820,EDS 203,A01,895581,Halter; Christopher P.,43,0,45,2
1745816522849,EDS 204R,A01,895625,Heinzman; Erica M.,43,0,45,2
1745816522849,EDS 204R,B01,895693,Halter; Christopher P.,18,0,45,27
1745816523875,EDS 206R,A00,895694,Fargason; Sharon Gayle,9,0,30,21
1745816523875,EDS 206R,B00,895695,Choi; Bailey Miyeon,20,0,30,10
1745816524905,EDS 250,A00,895697,Hemans; Patricia Ann Benitez,43,0,45,2
1745816525932,EDS 281,A00,895701,Meyerott; Theresa Ann,15,0,15,0
1745816526957,EDS 284,A00,895736,Meyerott; Theresa Ann,15,0,15,0
1745816527983,EDS 286,A00,897210,Fine; Sarah,15,0,15,0
1745816529008,EDS 289C,A01,895770,Daly; Alan J.,15,0,15,0
1745816530034,EDS 290,A00,897211,Hofstetter; Carolyn,15,0,15,0
1745816531061,LIGM 5A,A00,896162,Fischer-Grunski; Eva K,15,0,20,5
1745816532087,LIGM 5B,A00,896260,Fischer-Grunski; Eva K,17,0,20,3
1745816533114,LIGM 5C,A00,896308,Fischer-Grunski; Eva K,18,0,20,2
1745816534139,LIIT 5AS,A00,896313,Carnelos; Chiara,18,0,20,2
1745816535163,LIIT 5BS,A00,896416,Carnelos; Chiara,20,0,20,0
1745816536193,LIIT 5CS,A00,896564,Carnelos; Chiara,20,0,20,0
1745816537219,LISP 5A,A00,896588,Munoz Sanchez; Alicia,4,0,20,16
1745816538248,LISP 5B,A00,896653,Munoz Sanchez; Alicia,10,0,20,10
1745816539276,LISP 5C,A00,896655,Munoz Sanchez; Alicia,4,0,20,16
1745816540301,MAE 197,001,957918,Kleissl; Jan,9998,0,9999,1
1745816541329,MATH 2,A01,957937,Staff,34,0,35,1
1745816542398,MATH 197,001,957876,Kedlaya; Kiran S.,9993,0,9999,6
1745816543423,MCWP 40,A00,892729,Duru; Nur,13,0,20,7
1745816543423,MCWP 40,B00,893304,Montejo; Carolina,20,0,20,0
1745816544449,MCWP 40R,A00,893757,Redela; Pamela Morgan,0,7,20,20
1745816545475,MCWP 50,A00,893758,Morshed; Michael James,2,0,20,18
1745816545475,MCWP 50,B00,893761,Bartulis; Jason Michael,17,0,20,3
1745816546502,MCWP 50R,A00,893766,Compas; Sean Matthew,0,1,20,20
1745816546502,MCWP 50R,B00,893769,Carter; Jennifer A,0,0,20,20
1745816546502,MCWP 50R,C00,893771,Krone; Jarret,0,3,20,20
1745816546502,MCWP 50R,D00,893772,Miller; Elizabeth Deen,3,0,20,17
1745816546502,MCWP 50R,E00,893775,Carter; Andrea L,0,0,20,20
1745816547530,MMW 11R,A01,892721,Herbst; Matthew,11,0,27,16
1745816547530,MMW 11R,A02,892722,Herbst; Matthew,0,0,0,3
1745816548555,MMW 12R,A01,892724,Herbst; Matthew,0,10,16,16
1745816548555,MMW 12R,A02,892725,Herbst; Matthew,0,9,16,16
1745816549582,MMW 13R,A01,892727,Staff,0,3,16,16
1745816549582,MMW 13R,A02,892728,Staff,0,4,16,16
1745816549582,MMW 13R,A03,958032,Staff,0,3,16,16
1745816549582,MMW 13R,A04,958033,Staff,0,2,16,16
1745816549582,MMW 13R,A05,958034,Staff,0,3,16,16
1745816550610,SIO 295LS,A00,894015,Staff,7,0,25,18
1745816551634,SIO 295S,A00,894020,Staff,7,0,25,18
1745816552665,SIOC 290S,B01,958918,Staff,0,0,0,0
1745816553695,SIOC 291S,B01,958922,Staff,0,0,0,0
1745816554722,SOCI 117,A01,895339,Staff,4,0,5,1
1745816555745,WES 237B,A00,894149,Staff,11,0,20,9
1745816557819,AESE 279B,A00,891859,Staff,13,0,35,22
1745816558846,AIP 197,001,891854,Staff,70,0,70,0
1745816559871,ANTH 289S,A00,891856,Gagneux; Pascal,12,0,12,0
1745816560900,BENG 196,001,957946,Engler; Adam J.,9996,0,9999,3
1745816561927,CAT 124RS,A01,956906,Staff,8,0,25,17
1745816562956,CAT 125RS,A01,922013,Staff,8,0,25,17
1745816563984,CLRE 250,A00,891860,Morris; Sheldon,9995,0,9999,4
1745816566041,CLRE 251R,A00,907817,Mehta; Ravindra L.,9994,0,9999,5
1745816567067,CLRE 252,A00,891864,Cuomo; Raphael Eduardo,9993,0,9999,6
1745816568095,CLRE 253,A00,891867,Vaida; Florin,9994,0,9999,5
1745816568095,CLRE 253,B00,907819,Staff,9999,0,9999,0
1745816569120,CLRE 259,A00,891868,Patel; Hemal,9998,0,9999,1
1745816570147,CLRE 260,A00,891872,Cuomo; Raphael Eduardo,9999,0,9999,0
1745816571176,CLRE 297,001,891888,Cuomo; Raphael Eduardo,9999,0,9999,0
1745816572209,CSE 191,A00,958773,Minnes Kemp; Mor Mia,9999,0,9999,0
1745816573235,CSS 201S,A01,892054,Mignozzetti; Umberto,30,0,30,0
1745816574262,CSS 202S,A01,892056,Mignozzetti; Umberto,30,0,30,0
1745816575289,DSC 197,001,956898,Eldridge; Justin Matthew,9998,0,9999,1
1745816576316,DSC 297,001,958000,Mazumdar; Arya,9998,0,9999,1
1745816577344,EAP 100,A00,905686,Staff,9776,0,9999,223
1745816578371,ECE 45,A01,892618,Staff,0,12,50,50
1745816579397,ECE 109,A01,892620,Staff,0,43,0,0
1745816580423,ECE 111,A01,892719,Staff,0,8,50,50
1745816581449,ECE 197,001,957920,Mercier; Patrick Philip,9992,0,9999,7
1745816582479,ECON 178,A01,907814,Zhu; Ying,28,0,35,7
1745816583506,EDS 115,A00,895312,Staff,41,0,45,4
1745816584533,EDS 117,A01,895337,Staff,30,0,30,0
1745816585560,EDS 125,A00,895341,Jones; Gabrielle Anastasia,43,0,45,2
1745816586586,EDS 128A,A01,895459,Fargason; Sharon Gayle,44,0,45,1
1745816587613,EDS 128B,A01,895543,Pappas; Elizabeth,44,0,45,1
1745816588642,EDS 139,A00,897203,Pappas; Elizabeth,44,0,45,1
1745816588642,EDS 139,B00,897209,Fargason; Sharon Gayle,44,0,45,1
1745816589666,EDS 201,A00,895545,Staff,43,0,45,2
1745816590696,EDS 203,A01,895581,Halter; Christopher P.,43,0,45,2
1745816591725,EDS 204R,A01,895625,Heinzman; Erica M.,43,0,45,2
1745816591725,EDS 204R,B01,895693,Halter; Christopher P.,18,0,45,27
1745816592755,EDS 206R,A00,895694,Fargason; Sharon Gayle,9,0,30,21
1745816592755,EDS 206R,B00,895695,Choi; Bailey Miyeon,20,0,30,10
1745816593781,EDS 250,A00,895697,Hemans; Patricia Ann Benitez,43,0,45,2
1745816594807,EDS 281,A00,895701,Meyerott; Theresa Ann,15,0,15,0
1745816595832,EDS 284,A00,895736,Meyerott; Theresa Ann,15,0,15,0
1745816596857,EDS 286,A00,897210,Fine; Sarah,15,0,15,0
1745816597882,EDS 289C,A01,895770,Daly; Alan J.,15,0,15,0
1745816598908,EDS 290,A00,897211,Hofstetter; Carolyn,15,0,15,0
1745816599934,LIGM 5A,A00,896162,Fischer-Grunski; Eva K,15,0,20,5
1745816600962,LIGM 5B,A00,896260,Fischer-Grunski; Eva K,17,0,20,3
1745816601989,LIGM 5C,A00,896308,Fischer-Grunski; Eva K,18,0,20,2
1745816603017,LIIT 5AS,A00,896313,Carnelos; Chiara,18,0,20,2
1745816604042,LIIT 5BS,A00,896416,Carnelos; Chiara,20,0,20,0
1745816605073,LIIT 5CS,A00,896564,Carnelos; Chiara,20,0,20,0
1745816606100,LISP 5A,A00,896588,Munoz Sanchez; Alicia,4,0,20,16
1745816607127,LISP 5B,A00,896653,Munoz Sanchez; Alicia,10,0,20,10
1745816608155,LISP 5C,A00,896655,Munoz Sanchez; Alicia,4,0,20,16
1745816609184,MAE 197,001,957918,Kleissl; Jan,9998,0,9999,1
1745816610210,MATH 2,A01,957937,Staff,34,0,35,1
1745816611237,MATH 197,001,957876,Kedlaya; Kiran S.,9993,0,9999,6
1745816612262,MCWP 40,A00,892729,Duru; Nur,13,0,20,7
1745816612262,MCWP 40,B00,893304,Montejo; Carolina,20,0,20,0
1745816613291,MCWP 40R,A00,893757,Redela; Pamela Morgan,0,7,20,20
1745816614323,MCWP 50,A00,893758,Morshed; Michael James,2,0,20,18
1745816614323,MCWP 50,B00,893761,Bartulis; Jason Michael,17,0,20,3
1745816615350,MCWP 50R,A00,893766,Compas; Sean Matthew,0,1,20,20
1745816615350,MCWP 50R,B00,893769,Carter; Jennifer A,0,0,20,20
1745816615350,MCWP 50R,C00,893771,Krone; Jarret,0,3,20,20
1745816615350,MCWP 50R,D00,893772,Miller; Elizabeth Deen,3,0,20,17
1745816615350,MCWP 50R,E00,893775,Carter; Andrea L,0,0,20,20
1745816616376,MMW 11R,A01,892721,Herbst; Matthew,11,0,27,16
1745816616376,MMW 11R,A02,892722,Herbst; Matthew,0,0,0,3
1745816617401,MMW 12R,A01,892724,Herbst; Matthew,0,10,16,16
1745816617401,MMW 12R,A02,892725,Herbst; Matthew,0,9,16,16
1745816618428,MMW 13R,A01,892727,Staff,0,3,16,16
1745816618428,MMW 13R,A02,892728,Staff,0,4,16,16
1745816618428,MMW 13R,A03,958032,Staff,0,3,16,16
1745816618428,MMW 13R,A04,958033,Staff,0,2,16,16
1745816618428,MMW 13R,A05,958034,Staff,0,3,16,16
1745816619455,SIO 295LS,A00,894015,Staff,7,0,25,18
1745816620480,SIO 295S,A00,894020,Staff,7,0,25,18
1745816621508,SIOC 290S,B01,958918,Staff,0,0,0,0
1745816622538,SIOC 291S,B01,958922,Staff,0,0,0,0
1745816623564,SOCI 117,A01,895339,Staff,4,0,5,1
1745816624594,WES 237B,A00,894149,Staff,11,0,20,9
1745816626652,AESE 279B,A00,891859,Staff,13,0,35,22
1745816627677,AIP 197,001,891854,Staff,70,0,70,0
1745816628704,ANTH 289S,A00,891856,Gagneux; Pascal,12,0,12,0
1745816629732,BENG 196,001,957946,Engler; Adam J.,9996,0,9999,3
1745816630758,CAT 124RS,A01,956906,Staff,8,0,25,17
1745816631786,CAT 125RS,A01,922013,Staff,8,0,25,17
1745816632813,CLRE 250,A00,891860,Morris; Sheldon,9995,0,9999,4
1745816634871,CLRE 251R,A00,907817,Mehta; Ravindra L.,9994,0,9999,5
1745816635898,CLRE 252,A00,891864,Cuomo; Raphael Eduardo,9993,0,9999,6
1745816636927,CLRE 253,A00,891867,Vaida; Florin,9994,0,9999,5
1745816636927,CLRE 253,B00,907819,Staff,9999,0,9999,0
1745816637955,CLRE 259,A00,891868,Patel; Hemal,9998,0,9999,1
1745816638984,CLRE 260,A00,891872,Cuomo; Raphael Eduardo,9999,0,9999,0
1745816640016,CLRE 297,001,891888,Cuomo; Raphael Eduardo,9999,0,9999,0
1745816641042,CSE 191,A00,958773,Minnes Kemp; Mor Mia,9999,0,9999,0
1745816642069,CSS 201S,A01,892054,Mignozzetti; Umberto,30,0,30,0
1745816643098,CSS 202S,A01,892056,Mignozzetti; Umberto,30,0,30,0
1745816644127,DSC 197,001,956898,Eldridge; Justin Matthew,9998,0,9999,1
1745816645156,DSC 297,001,958000,Mazumdar; Arya,9998,0,9999,1
1745816646185,EAP 100,A00,905686,Staff,9776,0,9999,223
1745816647211,ECE 45,A01,892618,Staff,0,12,50,50
1745816648238,ECE 109,A01,892620,Staff,0,43,0,0
1745816649268,ECE 111,A01,892719,Staff,0,8,50,50
1745816650293,ECE 197,001,957920,Mercier; Patrick Philip,9992,0,9999,7
1745816651323,ECON 178,A01,907814,Zhu; Ying,28,0,35,7
1745816652352,EDS 115,A00,895312,Staff,41,0,45,4
1745816653380,EDS 117,A01,895337,Staff,30,0,30,0
1745816654409,EDS 125,A00,895341,Jones; Gabrielle Anastasia,43,0,45,2
1745816655439,EDS 128A,A01,895459,Fargason; Sharon Gayle,44,0,45,1
1745816656463,EDS 128B,A01,895543,Pappas; Elizabeth,44,0,45,1
1745816657489,EDS 139,A00,897203,Pappas; Elizabeth,44,0,45,1
1745816657489,EDS 139,B00,897209,Fargason; Sharon Gayle,44,0,45,1
1745816658516,EDS 201,A00,895545,Staff,43,0,45,2
1745816659543,EDS 203,A01,895581,Halter; Christopher P.,43,0,45,2
1745816660570,EDS 204R,A01,895625,Heinzman; Erica M.,43,0,45,2
1745816660570,EDS 204R,B01,895693,Halter; Christopher P.,18,0,45,27
1745816661596,EDS 206R,A00,895694,Fargason; Sharon Gayle,9,0,30,21
1745816661596,EDS 206R,B00,895695,Choi; Bailey Miyeon,20,0,30,10
1745816662624,EDS 250,A00,895697,Hemans; Patricia Ann Benitez,43,0,45,2
1745816663649,EDS 281,A00,895701,Meyerott; Theresa Ann,15,0,15,0
1745816664678,EDS 284,A00,895736,Meyerott; Theresa Ann,15,0,15,0
1745816665708,EDS 286,A00,897210,Fine; Sarah,15,0,15,0
1745816666737,EDS 289C,A01,895770,Daly; Alan J.,15,0,15,0
1745816667762,EDS 290,A00,897211,Hofstetter; Carolyn,15,0,15,0
1745816668790,LIGM 5A,A00,896162,Fischer-Grunski; Eva K,15,0,20,5
1745816669816,LIGM 5B,A00,896260,Fischer-Grunski; Eva K,17,0,20,3
1745816670841,LIGM 5C,A00,896308,Fischer-Grunski; Eva K,18,0,20,2
1745816671869,LIIT 5AS,A00,896313,Carnelos; Chiara,18,0,20,2
1745816672894,LIIT 5BS,A00,896416,Carnelos; Chiara,20,0,20,0
1745816673921,LIIT 5CS,A00,896564,Carnelos; Chiara,20,0,20,0
1745816674948,LISP 5A,A00,896588,Munoz Sanchez; Alicia,4,0,20,16
1745816675974,LISP 5B,A00,896653,Munoz Sanchez; Alicia,10,0,20,10
1745816677003,LISP 5C,A00,896655,Munoz Sanchez; Alicia,4,0,20,16
1745816678033,MAE 197,001,957918,Kleissl; Jan,9998,0,9999,1
1745816679060,MATH 2,A01,957937,Staff,34,0,35,1
1745816680087,MATH 197,001,957876,Kedlaya; Kiran S.,9993,0,9999,6
1745816681113,MCWP 40,A00,892729,Duru; Nur,13,0,20,7
1745816681113,MCWP 40,B00,893304,Montejo; Carolina,20,0,20,0
1745816682138,MCWP 40R,A00,893757,Redela; Pamela Morgan,0,7,20,20
1745816683166,MCWP 50,A00,893758,Morshed; Michael James,2,0,20,18
1745816683166,MCWP 50,B00,893761,Bartulis; Jason Michael,17,0,20,3
1745816684198,MCWP 50R,A00,893766,Compas; Sean Matthew,0,1,20,20
1745816684198,MCWP 50R,B00,893769,Carter; Jennifer A,0,0,20,20
1745816684198,MCWP 50R,C00,893771,Krone; Jarret,0,3,20,20
1745816684198,MCWP 50R,D00,893772,Miller; Elizabeth Deen,3,0,20,17
1745816684198,MCWP 50R,E00,893775,Carter; Andrea L,0,0,20,20
1745816685229,MMW 11R,A01,892721,Herbst; Matthew,11,0,27,16
1745816685229,MMW 11R,A02,892722,Herbst; Matthew,0,0,0,3
1745816686257,MMW 12R,A01,892724,Herbst; Matthew,0,10,16,16
1745816686257,MMW 12R,A02,892725,Herbst; Matthew,0,9,16,16
1745816687285,MMW 13R,A01,892727,Staff,0,3,16,16
1745816687285,MMW 13R,A02,892728,Staff,0,4,16,16
1745816687285,MMW 13R,A03,958032,Staff,0,3,16,16
1745816687285,MMW 13R,A04,958033,Staff,0,2,16,16
1745816687285,MMW 13R,A05,958034,Staff,0,3,16,16
1745816688311,SIO 295LS,A00,894015,Staff,7,0,25,18
1745816689337,SIO 295S,A00,894020,Staff,7,0,25,18
1745816690367,SIOC 290S,B01,958918,Staff,0,0,0,0
1745816691397,SIOC 291S,B01,958922,Staff,0,0,0,0
1745816692423,SOCI 117,A01,895339,Staff,4,0,5,1
1745816693450,WES 237B,A00,894149,Staff,11,0,20,9
1745816695508,AESE 279B,A00,891859,Staff,13,0,35,22
1745816696534,AIP 197,001,891854,Staff,70,0,70,0
1745816697560,ANTH 289S,A00,891856,Gagneux; Pascal,12,0,12,0
1745816698584,BENG 196,001,957946,Engler; Adam J.,9996,0,9999,3
1745816699612,CAT 124RS,A01,956906,Staff,8,0,25,17
1745816700639,CAT 125RS,A01,922013,Staff,8,0,25,17
1745816701665,CLRE 250,A00,891860,Morris; Sheldon,9995,0,9999,4
1745816703769,CLRE 251R,A00,907817,Mehta; Ravindra L.,9994,0,9999,5
1745816704795,CLRE 252,A00,891864,Cuomo; Raphael Eduardo,9993,0,9999,6
1745816705821,CLRE 253,A00,891867,Vaida; Florin,9994,0,9999,5
1745816705821,CLRE 253,B00,907819,Staff,9999,0,9999,0
1745816706846,CLRE 259,A00,891868,Patel; Hemal,9998,0,9999,1
1745816707876,CLRE 260,A00,891872,Cuomo; Raphael Eduardo,9999,0,9999,0
1745816708905,CLRE 297,001,891888,Cuomo; Raphael Eduardo,9999,0,9999,0
1745816709935,CSE 191,A00,958773,Minnes Kemp; Mor Mia,9999,0,9999,0
1745816710964,CSS 201S,A01,892054,Mignozzetti; Umberto,30,0,30,0
1745816711990,CSS 202S,A01,892056,Mignozzetti; Umberto,30,0,30,0
1745816713016,DSC 197,001,956898,Eldridge; Justin Matthew,9998,0,9999,1
1745816714046,DSC 297,001,958000,Mazumdar; Arya,9998,0,9999,1
1745816715073,EAP 100,A00,905686,Staff,9776,0,9999,223
1745816716100,ECE 45,A01,892618,Staff,0,12,50,50
1745816717131,ECE 109,A01,892620,Staff,0,43,0,0
1745816718159,ECE 111,A01,892719,Staff,0,8,50,50
1745816719187,ECE 197,001,957920,Mercier; Patrick Philip,9992,0,9999,7
1745816720219,ECON 178,A01,907814,Zhu; Ying,28,0,35,7
1745816721248,EDS 115,A00,895312,Staff,41,0,45,4
1745816722273,EDS 117,A01,895337,Staff,30,0,30,0
1745816723302,EDS 125,A00,895341,Jones; Gabrielle Anastasia,43,0,45,2
1745816724332,EDS 128A,A01,895459,Fargason; Sharon Gayle,44,0,45,1
1745816725359,EDS 128B,A01,895543,Pappas; Elizabeth,44,0,45,1
1745816726386,EDS 139,A00,897203,Pappas; Elizabeth,44,0,45,1
1745816726386,EDS 139,B00,897209,Fargason; Sharon Gayle,44,0,45,1
1745816727413,EDS 201,A00,895545,Staff,43,0,45,2
1745816728440,EDS 203,A01,895581,Halter; Christopher P.,43,0,45,2
1745816729468,EDS 204R,A01,895625,Heinzman; Erica M.,43,0,45,2
1745816729468,EDS 204R,B01,895693,Halter; Christopher P.,18,0,45,27
1745816730498,EDS 206R,A00,895694,Fargason; Sharon Gayle,9,0,30,21
1745816730498,EDS 206R,B00,895695,Choi; Bailey Miyeon,20,0,30,10
1745816731523,EDS 250,A00,895697,Hemans; Patricia Ann Benitez,43,0,45,2
1745816732551,EDS 281,A00,895701,Meyerott; Theresa Ann,15,0,15,0
1745816733577,EDS 284,A00,895736,Meyerott; Theresa Ann,15,0,15,0
1745816734605,EDS 286,A00,897210,Fine; Sarah,15,0,15,0
1745816735631,EDS 289C,A01,895770,Daly; Alan J.,15,0,15,0
1745816736661,EDS 290,A00,897211,Hofstetter; Carolyn,15,0,15,0
1745816737686,LIGM 5A,A00,896162,Fischer-Grunski; Eva K,15,0,20,5
1745816738710,LIGM 5B,A00,896260,Fischer-Grunski; Eva K,17,0,20,3
1745816739741,LIGM 5C,A00,896308,Fischer-Grunski; Eva K,18,0,20,2
1745816740770,LIIT 5AS,A00,896313,Carnelos; Chiara,18,0,20,2
1745816741795,LIIT 5BS,A00,896416,Carnelos; Chiara,20,0,20,0
1745816742819,LIIT 5CS,A00,896564,Carnelos; Chiara,20,0,20,0
1745816743844,LISP 5A,A00,896588,Munoz Sanchez; Alicia,4,0,20,16
1745816744872,LISP 5B,A00,896653,Munoz Sanchez; Alicia,10,0,20,10
1745816745901,LISP 5C,A00,896655,Munoz Sanchez; Alicia,4,0,20,16
1745816746928,MAE 197,001,957918,Kleissl; Jan,9998,0,9999,1
1745816747954,MATH 2,A01,957937,Staff,34,0,35,1
1745816748979,MATH 197,001,957876,Kedlaya; Kiran S.,9993,0,9999,6
1745816750006,MCWP 40,A00,892729,Duru; Nur,13,0,20,7
1745816750006,MCWP 40,B00,893304,Montejo; Carolina,20,0,20,0
1745816751032,MCWP 40R,A00,893757,Redela; Pamela Morgan,0,7,20,20
1745816752059,MCWP 50,A00,893758,Morshed; Michael James,2,0,20,18
1745816752059,MCWP 50,B00,893761,Bartulis; Jason Michael,17,0,20,3
1745816753090,MCWP 50R,A00,893766,Compas; Sean Matthew,0,1,20,20
1745816753090,MCWP 50R,B00,893769,Carter; Jennifer A,0,0,20,20
1745816753090,MCWP 50R,C00,893771,Krone; Jarret,0,3,20,20
1745816753090,MCWP 50R,D00,893772,Miller; Elizabeth Deen,3,0,20,17
1745816753090,MCWP 50R,E00,893775,Carter; Andrea L,0,0,20,20
1745816754115,MMW 11R,A01,892721,Herbst; Matthew,11,0,27,16
1745816754115,MMW 11R,A02,892722,Herbst; Matthew,0,0,0,3
1745816755141,MMW 12R,A01,892724,Herbst; Matthew,0,10,16,16
1745816755141,MMW 12R,A02,892725,Herbst; Matthew,0,9,16,16
1745816756167,MMW 13R,A01,892727,Staff,0,3,16,16
1745816756167,MMW 13R,A02,892728,Staff,0,4,16,16
1745816756167,MMW 13R,A03,958032,Staff,0,3,16,16
1745816756167,MMW 13R,A04,958033,Staff,0,2,16,16
1745816756167,MMW 13R,A05,958034,Staff,0,3,16,16
1745816757195,SIO 295LS,A00,894015,Staff,7,0,25,18
1745816758221,SIO 295S,A00,894020,Staff,7,0,25,18
1745816759250,SIOC 290S,B01,958918,Staff,0,0,0,0
1745816760275,SIOC 291S,B01,958922,Staff,0,0,0,0
1745816761300,SOCI 117,A01,895339,Staff,4,0,5,1
1745816762325,WES 237B,A00,894149,Staff,11,0,20,9
1745816764380,AESE 279B,A00,891859,Staff,13,0,35,22
1745816765406,AIP 197,001,891854,Staff,70,0,70,0
1745816766652,ANTH 289S,A00,891856,Gagneux; Pascal,12,0,12,0
1745816767685,BENG 196,001,957946,Engler; Adam J.,9996,0,9999,3
1745816768711,CAT 124RS,A01,956906,Staff,8,0,25,17
1745816769740,CAT 125RS,A01,922013,Staff,8,0,25,17
1745816770766,CLRE 250,A00,891860,Morris; Sheldon,9995,0,9999,4
1745816772816,CLRE 251R,A00,907817,Mehta; Ravindra L.,9994,0,9999,5
1745816773846,CLRE 252,A00,891864,Cuomo; Raphael Eduardo,9993,0,9999,6
1745816774874,CLRE 253,A00,891867,Vaida; Florin,9994,0,9999,5
1745816774874,CLRE 253,B00,907819,Staff,9999,0,9999,0
1745816775899,CLRE 259,A00,891868,Patel; Hemal,9998,0,9999,1
1745816776925,CLRE 260,A00,891872,Cuomo; Raphael Eduardo,9999,0,9999,0
1745816777954,CLRE 297,001,891888,Cuomo; Raphael Eduardo,9999,0,9999,0
1745816778982,CSE 191,A00,958773,Minnes Kemp; Mor Mia,9999,0,9999,0
1745816780009,CSS 201S,A01,892054,Mignozzetti; Umberto,30,0,30,0
1745816781035,CSS 202S,A01,892056,Mignozzetti; Umberto,30,0,30,0
1745816782064,DSC 197,001,956898,Eldridge; Justin Matthew,9998,0,9999,1
1745816783091,DSC 297,001,958000,Mazumdar; Arya,9998,0,9999,1
1745816784115,EAP 100,A00,905686,Staff,9776,0,9999,223
1745816785142,ECE 45,A01,892618,Staff,0,12,50,50
1745816786167,ECE 109,A01,892620,Staff,0,43,0,0
1745816787197,ECE 111,A01,892719,Staff,0,8,50,50
1745816788221,ECE 197,001,957920,Mercier; Patrick Philip,9992,0,9999,7
1745816789273,ECON 178,A01,907814,Zhu; Ying,28,0,35,7
1745816790298,EDS 115,A00,895312,Staff,41,0,45,4
1745816791324,EDS 117,A01,895337,Staff,30,0,30,0
1745816792350,EDS 125,A00,895341,Jones; Gabrielle Anastasia,43,0,45,2
1745816793376,EDS 128A,A01,895459,Fargason; Sharon Gayle,44,0,45,1
1745816794406,EDS 128B,A01,895543,Pappas; Elizabeth,44,0,45,1
1745816795433,EDS 139,A00,897203,Pappas; Elizabeth,44,0,45,1
1745816795433,EDS 139,B00,897209,Fargason; Sharon Gayle,44,0,45,1
1745816796458,EDS 201,A00,895545,Staff,43,0,45,2
1745816797485,EDS 203,A01,895581,Halter; Christopher P.,43,0,45,2
1745816798512,EDS 204R,A01,895625,Heinzman; Erica M.,43,0,45,2
1745816798512,EDS 204R,B01,895693,Halter; Christopher P.,18,0,45,27
1745816799541,EDS 206R,A00,895694,Fargason; Sharon Gayle,9,0,30,21
1745816799541,EDS 206R,B00,895695,Choi; Bailey Miyeon,20,0,30,10
1745816800566,EDS 250,A00,895697,Hemans; Patricia Ann Benitez,43,0,45,2
1745816801592,EDS 281,A00,895701,Meyerott; Theresa Ann,15,0,15,0
1745816802618,EDS 284,A00,895736,Meyerott; Theresa Ann,15,0,15,0
1745816803646,EDS 286,A00,897210,Fine; Sarah,15,0,15,0
1745816804672,EDS 289C,A01,895770,Daly; Alan J.,15,0,15,0
1745816805698,EDS 290,A00,897211,Hofstetter; Carolyn,15,0,15,0
1745816806725,LIGM 5A,A00,896162,Fischer-Grunski; Eva K,15,0,20,5
1745816807754,LIGM 5B,A00,896260,Fischer-Grunski; Eva K,17,0,20,3
1745816808783,LIGM 5C,A00,896308,Fischer-Grunski; Eva K,18,0,20,2
1745816809811,LIIT 5AS,A00,896313,Carnelos; Chiara,18,0,20,2
1745816810840,LIIT 5BS,A00,896416,Carnelos; Chiara,20,0,20,0
1745816811866,LIIT 5CS,A00,896564,Carnelos; Chiara,20,0,20,0
1745816812895,LISP 5A,A00,896588,Munoz Sanchez; Alicia,4,0,20,16
1745816813923,LISP 5B,A00,896653,Munoz Sanchez; Alicia,10,0,20,10
1745816814949,LISP 5C,A00,896655,Munoz Sanchez; Alicia,4,0,20,16
1745816815977,MAE 197,001,957918,Kleissl; Jan,9998,0,9999,1
1745816817004,MATH 2,A01,957937,Staff,34,0,35,1
1745816818032,MATH 197,001,957876,Kedlaya; Kiran S.,9993,0,9999,6
1745816819058,MCWP 40,A00,892729,Duru; Nur,13,0,20,7
1745816819058,MCWP 40,B00,893304,Montejo; Carolina,20,0,20,0
1745816820083,MCWP 40R,A00,893757,Redela; Pamela Morgan,0,7,20,20
1745816821110,MCWP 50,A00,893758,Morshed; Michael James,2,0,20,18
1745816821110,MCWP 50,B00,893761,Bartulis; Jason Michael,17,0,20,3
1745816822140,MCWP 50R,A00,893766,Compas; Sean Matthew,0,1,20,20
1745816822140,MCWP 50R,B00,893769,Carter; Jennifer A,0,0,20,20
1745816822140,MCWP 50R,C00,893771,Krone; Jarret,0,3,20,20
1745816822140,MCWP 50R,D00,893772,Miller; Elizabeth Deen,3,0,20,17
1745816822140,MCWP 50R,E00,893775,Carter; Andrea L,0,0,20,20
1745816823166,MMW 11R,A01,892721,Herbst; Matthew,11,0,27,16
1745816823166,MMW 11R,A02,892722,Herbst; Matthew,0,0,0,3
1745816824196,MMW 12R,A01,892724,Herbst; Matthew,0,10,16,16
1745816824196,MMW 12R,A02,892725,Herbst; Matthew,0,9,16,16
1745816825222,MMW 13R,A01,892727,Staff,0,3,16,16
1745816825222,MMW 13R,A02,892728,Staff,0,4,16,16
1745816825222,MMW 13R,A03,958032,Staff,0,3,16,16
1745816825222,MMW 13R,A04,958033,Staff,0,2,16,16
1745816825222,MMW 13R,A05,958034,Staff,0,3,16,16
1745816826249,SIO 295LS,A00,894015,Staff,7,0,25,18
1745816827273,SIO 295S,A00,894020,Staff,7,0,25,18
1745816828303,SIOC 290S,B01,958918,Staff,0,0,0,0
1745816829330,SIOC 291S,B01,958922,Staff,0,0,0,0
1745816830356,SOCI 117,A01,895339,Staff,4,0,5,1
1745816831386,WES 237B,A00,894149,Staff,11,0,20,9
1745816833442,AESE 279B,A00,891859,Staff,13,0,35,22
1745816834470,AIP 197,001,891854,Staff,70,0,70,0
1745816835496,ANTH 289S,A00,891856,Gagneux; Pascal,12,0,12,0
1745816836521,BENG 196,001,957946,Engler; Adam J.,9996,0,9999,3
1745816837549,CAT 124RS,A01,956906,Staff,8,0,25,17
1745816838573,CAT 125RS,A01,922013,Staff,8,0,25,17
1745816839597,CLRE 250,A00,891860,Morris; Sheldon,9995,0,9999,4
1745816841650,CLRE 251R,A00,907817,Mehta; Ravindra L.,9994,0,9999,5
1745816842677,CLRE 252,A00,891864,Cuomo; Raphael Eduardo,9993,0,9999,6
1745816843707,CLRE 253,A00,891867,Vaida; Florin,9994,0,9999,5
1745816843707,CLRE 253,B00,907819,Staff,9999,0,9999,0
1745816844732,CLRE 259,A00,891868,Patel; Hemal,9998,0,9999,1
1745816845758,CLRE 260,A00,891872,Cuomo; Raphael Eduardo,9999,0,9999,0
1745816846785,CLRE 297,001,891888,Cuomo; Raphael Eduardo,9999,0,9999,0
1745816847814,CSE 191,A00,958773,Minnes Kemp; Mor Mia,9999,0,9999,0
1745816848839,CSS 201S,A01,892054,Mignozzetti; Umberto,30,0,30,0
1745816849868,CSS 202S,A01,892056,Mignozzetti; Umberto,30,0,30,0
1745816850896,DSC 197,001,956898,Eldridge; Justin Matthew,9998,0,9999,1
1745816851924,DSC 297,001,958000,Mazumdar; Arya,9998,0,9999,1
1745816852951,EAP 100,A00,905686,Staff,9776,0,9999,223
1745816853976,ECE 45,A01,892618,Staff,0,12,50,50
1745816855002,ECE 109,A01,892620,Staff,0,43,0,0
1745816856028,ECE 111,A01,892719,Staff,0,9,50,50
1745816857055,ECE 197,001,957920,Mercier; Patrick Philip,9992,0,9999,7
1745816858084,ECON 178,A01,907814,Zhu; Ying,28,0,35,7
1745816859111,EDS 115,A00,895312,Staff,41,0,45,4
1745816860140,EDS 117,A01,895337,Staff,30,0,30,0
1745816861168,EDS 125,A00,895341,Jones; Gabrielle Anastasia,43,0,45,2
1745816862194,EDS 128A,A01,895459,Fargason; Sharon Gayle,44,0,45,1
1745816863224,EDS 128B,A01,895543,Pappas; Elizabeth,44,0,45,1
1745816864249,EDS 139,A00,897203,Pappas; Elizabeth,44,0,45,1
1745816864249,EDS 139,B00,897209,Fargason; Sharon Gayle,44,0,45,1
1745816865274,EDS 201,A00,895545,Staff,43,0,45,2
1745816866299,EDS 203,A01,895581,Halter; Christopher P.,43,0,45,2
1745816867326,EDS 204R,A01,895625,Heinzman; Erica M.,43,0,45,2
1745816867326,EDS 204R,B01,895693,Halter; Christopher P.,18,0,45,27
1745816868354,EDS 206R,A00,895694,Fargason; Sharon Gayle,9,0,30,21
1745816868354,EDS 206R,B00,895695,Choi; Bailey Miyeon,20,0,30,10
1745816869382,EDS 250,A00,895697,Hemans; Patricia Ann Benitez,43,0,45,2
1745816870408,EDS 281,A00,895701,Meyerott; Theresa Ann,15,0,15,0
1745816871433,EDS 284,A00,895736,Meyerott; Theresa Ann,15,0,15,0
1745816872459,EDS 286,A00,897210,Fine; Sarah,15,0,15,0
1745816873483,EDS 289C,A01,895770,Daly; Alan J.,15,0,15,0
1745816874511,EDS 290,A00,897211,Hofstetter; Carolyn,15,0,15,0
1745816875540,LIGM 5A,A00,896162,Fischer-Grunski; Eva K,15,0,20,5
1745816876569,LIGM 5B,A00,896260,Fischer-Grunski; Eva K,17,0,20,3
1745816877597,LIGM 5C,A00,896308,Fischer-Grunski; Eva K,18,0,20,2
1745816878620,LIIT 5AS,A00,896313,Carnelos; Chiara,18,0,20,2
1745816879648,LIIT 5BS,A00,896416,Carnelos; Chiara,20,0,20,0
1745816880676,LIIT 5CS,A00,896564,Carnelos; Chiara,20,0,20,0
1745816881701,LISP 5A,A00,896588,Munoz Sanchez; Alicia,4,0,20,16
1745816882731,LISP 5B,A00,896653,Munoz Sanchez; Alicia,10,0,20,10
1745816883757,LISP 5C,A00,896655,Munoz Sanchez; Alicia,4,0,20,16
1745816884783,MAE 197,001,957918,Kleissl; Jan,9998,0,9999,1
1745816885808,MATH 2,A01,957937,Staff,34,0,35,1
1745816886833,MATH 197,001,957876,Kedlaya; Kiran S.,9993,0,9999,6
1745816887862,MCWP 40,A00,892729,Duru; Nur,13,0,20,7
1745816887862,MCWP 40,B00,893304,Montejo; Carolina,20,0,20,0
1745816888886,MCWP 40R,A00,893757,Redela; Pamela Morgan,0,7,20,20
1745816889915,MCWP 50,A00,893758,Morshed; Michael James,2,0,20,18
1745816889915,MCWP 50,B00,893761,Bartulis; Jason Michael,17,0,20,3
1745816890940,MCWP 50R,A00,893766,Compas; Sean Matthew,0,1,20,20
1745816890940,MCWP 50R,B00,893769,Carter; Jennifer A,0,0,20,20
1745816890940,MCWP 50R,C00,893771,Krone; Jarret,0,3,20,20
1745816890940,MCWP 50R,D00,893772,Miller; Elizabeth Deen,3,0,20,17
1745816890940,MCWP 50R,E00,893775,Carter; Andrea L,0,0,20,20
1745816891964,MMW 11R,A01,892721,Herbst; Matthew,11,0,27,16
1745816891964,MMW 11R,A02,892722,Herbst; Matthew,0,0,0,3
1745816892992,MMW 12R,A01,892724,Herbst; Matthew,0,10,16,16
1745816892992,MMW 12R,A02,892725,Herbst; Matthew,0,9,16,16
1745816894020,MMW 13R,A01,892727,Staff,0,3,16,16
1745816894020,MMW 13R,A02,892728,Staff,0,4,16,16
1745816894020,MMW 13R,A03,958032,Staff,0,3,16,16
1745816894020,MMW 13R,A04,958033,Staff,0,2,16,16
1745816894020,MMW 13R,A05,958034,Staff,0,3,16,16
1745816895044,SIO 295LS,A00,894015,Staff,7,0,25,18
1745816896073,SIO 295S,A00,894020,Staff,7,0,25,18
1745816897098,SIOC 290S,B01,958918,Staff,0,0,0,0
1745816898124,SIOC 291S,B01,958922,Staff,0,0,0,0
1745816899150,SOCI 117,A01,895339,Staff,4,0,5,1
1745816900175,WES 237B,A00,894149,Staff,11,0,20,9
1745816902234,AESE 279B,A00,891859,Staff,13,0,35,22
1745816903262,AIP 197,001,891854,Staff,70,0,70,0
1745816904290,ANTH 289S,A00,891856,Gagneux; Pascal,12,0,12,0
1745816905319,BENG 196,001,957946,Engler; Adam J.,9996,0,9999,3
1745816906344,CAT 124RS,A01,956906,Staff,8,0,25,17
1745816907370,CAT 125RS,A01,922013,Staff,8,0,25,17
1745816908398,CLRE 250,A00,891860,Morris; Sheldon,9995,0,9999,4
1745816910450,CLRE 251R,A00,907817,Mehta; Ravindra L.,9994,0,9999,5
1745816911477,CLRE 252,A00,891864,Cuomo; Raphael Eduardo,9993,0,9999,6
1745816912507,CLRE 253,A00,891867,Vaida; Florin,9994,0,9999,5
1745816912507,CLRE 253,B00,907819,Staff,9999,0,9999,0
1745816913534,CLRE 259,A00,891868,Patel; Hemal,9998,0,9999,1
1745816914558,CLRE 260,A00,891872,Cuomo; Raphael Eduardo,9999,0,9999,0
1745816915583,CLRE 297,001,891888,Cuomo; Raphael Eduardo,9999,0,9999,0
1745816916610,CSE 191,A00,958773,Minnes Kemp; Mor Mia,9999,0,9999,0
1745816917635,CSS 201S,A01,892054,Mignozzetti; Umberto,30,0,30,0
1745816918666,CSS 202S,A01,892056,Mignozzetti; Umberto,30,0,30,0
1745816919723,DSC 197,001,956898,Eldridge; Justin Matthew,9998,0,9999,1
1745816920752,DSC 297,001,958000,Mazumdar; Arya,9998,0,9999,1
1745816921777,EAP 100,A00,905686,Staff,9776,0,9999,223
1745816922802,ECE 45,A01,892618,Staff,0,12,50,50
1745816923831,ECE 109,A01,892620,Staff,0,43,0,0
1745816924859,ECE 111,A01,892719,Staff,0,9,50,50
1745816925885,ECE 197,001,957920,Mercier; Patrick Philip,9992,0,9999,7
1745816926910,ECON 178,A01,907814,Zhu; Ying,28,0,35,7
1745816927938,EDS 115,A00,895312,Staff,41,0,45,4
1745816928963,EDS 117,A01,895337,Staff,30,0,30,0
1745816929990,EDS 125,A00,895341,Jones; Gabrielle Anastasia,43,0,45,2
1745816931020,EDS 128A,A01,895459,Fargason; Sharon Gayle,44,0,45,1
1745816932045,EDS 128B,A01,895543,Pappas; Elizabeth,44,0,45,1
1745816933075,EDS 139,A00,897203,Pappas; Elizabeth,44,0,45,1
1745816933075,EDS 139,B00,897209,Fargason; Sharon Gayle,44,0,45,1
1745816934100,EDS 201,A00,895545,Staff,43,0,45,2
1745816935127,EDS 203,A01,895581,Halter; Christopher P.,43,0,45,2
1745816936152,EDS 204R,A01,895625,Heinzman; Erica M.,43,0,45,2
1745816936152,EDS 204R,B01,895693,Halter; Christopher P.,18,0,45,27
1745816937180,EDS 206R,A00,895694,Fargason; Sharon Gayle,9,0,30,21
1745816937180,EDS 206R,B00,895695,Choi; Bailey Miyeon,20,0,30,10
1745816938206,EDS 250,A00,895697,Hemans; Patricia Ann Benitez,43,0,45,2
1745816939232,EDS 281,A00,895701,Meyerott; Theresa Ann,15,0,15,0
1745816940260,EDS 284,A00,895736,Meyerott; Theresa Ann,15,0,15,0
1745816941286,EDS 286,A00,897210,Fine; Sarah,15,0,15,0
1745816942313,EDS 289C,A01,895770,Daly; Alan J.,15,0,15,0
1745816943339,EDS 290,A00,897211,Hofstetter; Carolyn,15,0,15,0
1745816944365,LIGM 5A,A00,896162,Fischer-Grunski; Eva K,15,0,20,5
1745816945396,LIGM 5B,A00,896260,Fischer-Grunski; Eva K,17,0,20,3
1745816946422,LIGM 5C,A00,896308,Fischer-Grunski; Eva K,18,0,20,2
1745816947446,LIIT 5AS,A00,896313,Carnelos; Chiara,18,0,20,2
1745816948473,LIIT 5BS,A00,896416,Carnelos; Chiara,20,0,20,0
1745816949501,LIIT 5CS,A00,896564,Carnelos; Chiara,20,0,20,0
1745816950526,LISP 5A,A00,896588,Munoz Sanchez; Alicia,4,0,20,16
1745816951550,LISP 5B,A00,896653,Munoz Sanchez; Alicia,10,0,20,10
1745816952579,LISP 5C,A00,896655,Munoz Sanchez; Alicia,4,0,20,16
1745816953605,MAE 197,001,957918,Kleissl; Jan,9998,0,9999,1
1745816954632,MATH 2,A01,957937,Staff,34,0,35,1
1745816955658,MATH 197,001,957876,Kedlaya; Kiran S.,9993,0,9999,6
1745816956683,MCWP 40,A00,892729,Duru; Nur,13,0,20,7
1745816956683,MCWP 40,B00,893304,Montejo; Carolina,20,0,20,0
1745816957708,MCWP 40R,A00,893757,Redela; Pamela Morgan,0,7,20,20
1745816958734,MCWP 50,A00,893758,Morshed; Michael James,2,0,20,18
1745816958734,MCWP 50,B00,893761,Bartulis; Jason Michael,17,0,20,3
1745816959761,MCWP 50R,A00,893766,Compas; Sean Matthew,0,1,20,20
1745816959761,MCWP 50R,B00,893769,Carter; Jennifer A,0,0,20,20
1745816959761,MCWP 50R,C00,893771,Krone; Jarret,0,3,20,20
1745816959761,MCWP 50R,D00,893772,Miller; Elizabeth Deen,3,0,20,17
1745816959761,MCWP 50R,E00,893775,Carter; Andrea L,0,0,20,20
1745816960786,MMW 11R,A01,892721,Herbst; Matthew,11,0,27,16
1745816960786,MMW 11R,A02,892722,Herbst; Matthew,0,0,0,3
1745816961812,MMW 12R,A01,892724,Herbst; Matthew,0,10,16,16
1745816961812,MMW 12R,A02,892725,Herbst; Matthew,0,9,16,16
1745816962842,MMW 13R,A01,892727,Staff,0,3,16,16
1745816962842,MMW 13R,A02,892728,Staff,0,4,16,16
1745816962842,MMW 13R,A03,958032,Staff,0,3,16,16
1745816962842,MMW 13R,A04,958033,Staff,0,2,16,16
1745816962842,MMW 13R,A05,958034,Staff,0,3,16,16
1745816963868,SIO 295LS,A00,894015,Staff,7,0,25,18
1745816964897,SIO 295S,A00,894020,Staff,7,0,25,18
1745816965922,SIOC 290S,B01,958918,Staff,0,0,0,0
1745816966952,SIOC 291S,B01,958922,Staff,0,0,0,0
1745816967981,SOCI 117,A01,895339,Staff,4,0,5,1
1745816969007,WES 237B,A00,894149,Staff,11,0,20,9
1745816971067,AESE 279B,A00,891859,Staff,13,0,35,22
1745816972093,AIP 197,001,891854,Staff,70,0,70,0
1745816973119,ANTH 289S,A00,891856,Gagneux; Pascal,12,0,12,0
1745816974147,BENG 196,001,957946,Engler; Adam J.,9996,0,9999,3
1745816975174,CAT 124RS,A01,956906,Staff,8,0,25,17
1745816976200,CAT 125RS,A01,922013,Staff,8,0,25,17
1745816977228,CLRE 250,A00,891860,Morris; Sheldon,9995,0,9999,4
1745816979280,CLRE 251R,A00,907817,Mehta; Ravindra L.,9994,0,9999,5
1745816980304,CLRE 252,A00,891864,Cuomo; Raphael Eduardo,9993,0,9999,6
1745816981330,CLRE 253,A00,891867,Vaida; Florin,9994,0,9999,5
1745816981330,CLRE 253,B00,907819,Staff,9999,0,9999,0
1745816982354,CLRE 259,A00,891868,Patel; Hemal,9998,0,9999,1
1745816983383,CLRE 260,A00,891872,Cuomo; Raphael Eduardo,9999,0,9999,0
1745816984411,CLRE 297,001,891888,Cuomo; Raphael Eduardo,9999,0,9999,0
1745816985438,CSE 191,A00,958773,Minnes Kemp; Mor Mia,9999,0,9999,0
1745816986466,CSS 201S,A01,892054,Mignozzetti; Umberto,30,0,30,0
1745816987495,CSS 202S,A01,892056,Mignozzetti; Umberto,30,0,30,0
1745816988522,DSC 197,001,956898,Eldridge; Justin Matthew,9998,0,9999,1
1745816989547,DSC 297,001,958000,Mazumdar; Arya,9998,0,9999,1
1745816990571,EAP 100,A00,905686,Staff,9776,0,9999,223
1745816991596,ECE 45,A01,892618,Staff,0,12,50,50
1745816992621,ECE 109,A01,892620,Staff,0,43,0,0
1745816993646,ECE 111,A01,892719,Staff,0,9,50,50
1745816994669,ECE 197,001,957920,Mercier; Patrick Philip,9992,0,9999,7
1745816995696,ECON 178,A01,907814,Zhu; Ying,28,0,35,7
1745816996721,EDS 115,A00,895312,Staff,41,0,45,4
1745816997747,EDS 117,A01,895337,Staff,30,0,30,0
1745816998772,EDS 125,A00,895341,Jones; Gabrielle Anastasia,43,0,45,2
1745816999800,EDS 128A,A01,895459,Fargason; Sharon Gayle,44,0,45,1
1745817000829,EDS 128B,A01,895543,Pappas; Elizabeth,44,0,45,1
1745817001856,EDS 139,A00,897203,Pappas; Elizabeth,44,0,45,1
1745817001856,EDS 139,B00,897209,Fargason; Sharon Gayle,44,0,45,1
1745817002884,EDS 201,A00,895545,Staff,43,0,45,2
1745817003920,EDS 203,A01,895581,Halter; Christopher P.,43,0,45,2
1745817004947,EDS 204R,A01,895625,Heinzman; Erica M.,43,0,45,2
1745817004947,EDS 204R,B01,895693,Halter; Christopher P.,18,0,45,27
1745817005975,EDS 206R,A00,895694,Fargason; Sharon Gayle,9,0,30,21
1745817005975,EDS 206R,B00,895695,Choi; Bailey Miyeon,20,0,30,10
1745817007004,EDS 250,A00,895697,Hemans; Patricia Ann Benitez,43,0,45,2
1745817008030,EDS 281,A00,895701,Meyerott; Theresa Ann,15,0,15,0
1745817009055,EDS 284,A00,895736,Meyerott; Theresa Ann,15,0,15,0
1745817010082,EDS 286,A00,897210,Fine; Sarah,15,0,15,0
1745817011111,EDS 289C,A01,895770,Daly; Alan J.,15,0,15,0
1745817012137,EDS 290,A00,897211,Hofstetter; Carolyn,15,0,15,0
1745817013163,LIGM 5A,A00,896162,Fischer-Grunski; Eva K,15,0,20,5
1745817014191,LIGM 5B,A00,896260,Fischer-Grunski; Eva K,17,0,20,3
1745817015222,LIGM 5C,A00,896308,Fischer-Grunski; Eva K,18,0,20,2
1745817016248,LIIT 5AS,A00,896313,Carnelos; Chiara,18,0,20,2
1745817017273,LIIT 5BS,A00,896416,Carnelos; Chiara,20,0,20,0
1745817018301,LIIT 5CS,A00,896564,Carnelos; Chiara,20,0,20,0
1745817019326,LISP 5A,A00,896588,Munoz Sanchez; Alicia,4,0,20,16
1745817020351,LISP 5B,A00,896653,Munoz Sanchez; Alicia,10,0,20,10
1745817021377,LISP 5C,A00,896655,Munoz Sanchez; Alicia,4,0,20,16
1745817022401,MAE 197,001,957918,Kleissl; Jan,9998,0,9999,1
1745817023429,MATH 2,A01,957937,Staff,34,0,35,1
1745817024454,MATH 197,001,957876,Kedlaya; Kiran S.,9993,0,9999,6
1745817025479,MCWP 40,A00,892729,Duru; Nur,13,0,20,7
1745817025479,MCWP 40,B00,893304,Montejo; Carolina,20,0,20,0
1745817026505,MCWP 40R,A00,893757,Redela; Pamela Morgan,0,7,20,20
1745817027530,MCWP 50,A00,893758,Morshed; Michael James,2,0,20,18
1745817027530,MCWP 50,B00,893761,Bartulis; Jason Michael,17,0,20,3
1745817028560,MCWP 50R,A00,893766,Compas; Sean Matthew,0,1,20,20
1745817028560,MCWP 50R,B00,893769,Carter; Jennifer A,0,0,20,20
1745817028560,MCWP 50R,C00,893771,Krone; Jarret,0,3,20,20
1745817028560,MCWP 50R,D00,893772,Miller; Elizabeth Deen,3,0,20,17
1745817028560,MCWP 50R,E00,893775,Carter; Andrea L,0,0,20,20
1745817029587,MMW 11R,A01,892721,Herbst; Matthew,11,0,27,16
1745817029587,MMW 11R,A02,892722,Herbst; Matthew,0,0,0,3
1745817030615,MMW 12R,A01,892724,Herbst; Matthew,0,10,16,16
1745817030615,MMW 12R,A02,892725,Herbst; Matthew,0,9,16,16
1745817031640,MMW 13R,A01,892727,Staff,0,3,16,16
1745817031640,MMW 13R,A02,892728,Staff,0,4,16,16
1745817031640,MMW 13R,A03,958032,Staff,0,3,16,16
1745817031640,MMW 13R,A04,958033,Staff,0,2,16,16
1745817031640,MMW 13R,A05,958034,Staff,0,3,16,16
1745817032669,SIO 295LS,A00,894015,Staff,7,0,25,18
1745817033697,SIO 295S,A00,894020,Staff,7,0,25,18
1745817034723,SIOC 290S,B01,958918,Staff,0,0,0,0
1745817035753,SIOC 291S,B01,958922,Staff,0,0,0,0
1745817036779,SOCI 117,A01,895339,Staff,4,0,5,1
1745817037804,WES 237B,A00,894149,Staff,11,0,20,9
1745817039871,AESE 279B,A00,891859,Staff,13,0,35,22
1745817040898,AIP 197,001,891854,Staff,70,0,70,0
1745817041924,ANTH 289S,A00,891856,Gagneux; Pascal,12,0,12,0
1745817042951,BENG 196,001,957946,Engler; Adam J.,9996,0,9999,3
1745817043981,CAT 124RS,A01,956906,Staff,8,0,25,17
1745817045006,CAT 125RS,A01,922013,Staff,8,0,25,17
1745817046034,CLRE 250,A00,891860,Morris; Sheldon,9995,0,9999,4
1745817048087,CLRE 251R,A00,907817,Mehta; Ravindra L.,9994,0,9999,5
1745817049118,CLRE 252,A00,891864,Cuomo; Raphael Eduardo,9993,0,9999,6
1745817050144,CLRE 253,A00,891867,Vaida; Florin,9994,0,9999,5
1745817050144,CLRE 253,B00,907819,Staff,9999,0,9999,0
1745817051172,CLRE 259,A00,891868,Patel; Hemal,9998,0,9999,1
1745817052197,CLRE 260,A00,891872,Cuomo; Raphael Eduardo,9999,0,9999,0
1745817053221,CLRE 297,001,891888,Cuomo; Raphael Eduardo,9999,0,9999,0
1745817054246,CSE 191,A00,958773,Minnes Kemp; Mor Mia,9999,0,9999,0
1745817055273,CSS 201S,A01,892054,Mignozzetti; Umberto,30,0,30,0
1745817056299,CSS 202S,A01,892056,Mignozzetti; Umberto,30,0,30,0
1745817057324,DSC 197,001,956898,Eldridge; Justin Matthew,9998,0,9999,1
1745817058349,DSC 297,001,958000,Mazumdar; Arya,9998,0,9999,1
1745817059377,EAP 100,A00,905686,Staff,9776,0,9999,223
1745817060405,ECE 45,A01,892618,Staff,0,12,50,50
1745817061431,ECE 109,A01,892620,Staff,0,43,0,0
1745817062459,ECE 111,A01,892719,Staff,0,9,50,50
1745817063485,ECE 197,001,957920,Mercier; Patrick Philip,9992,0,9999,7
1745817064511,ECON 178,A01,907814,Zhu; Ying,28,0,35,7
1745817065539,EDS 115,A00,895312,Staff,41,0,45,4
1745817066565,EDS 117,A01,895337,Staff,30,0,30,0
1745817067590,EDS 125,A00,895341,Jones; Gabrielle Anastasia,43,0,45,2
1745817068614,EDS 128A,A01,895459,Fargason; Sharon Gayle,44,0,45,1
1745817069642,EDS 128B,A01,895543,Pappas; Elizabeth,44,0,45,1
1745817070666,EDS 139,A00,897203,Pappas; Elizabeth,44,0,45,1
1745817070666,EDS 139,B00,897209,Fargason; Sharon Gayle,44,0,45,1
1745817071693,EDS 201,A00,895545,Staff,43,0,45,2
1745817072721,EDS 203,A01,895581,Halter; Christopher P.,43,0,45,2
1745817073749,EDS 204R,A01,895625,Heinzman; Erica M.,43,0,45,2
1745817073749,EDS 204R,B01,895693,Halter; Christopher P.,18,0,45,27
1745817074777,EDS 206R,A00,895694,Fargason; Sharon Gayle,9,0,30,21
1745817074777,EDS 206R,B00,895695,Choi; Bailey Miyeon,20,0,30,10
1745817075802,EDS 250,A00,895697,Hemans; Patricia Ann Benitez,43,0,45,2
1745817076827,EDS 281,A00,895701,Meyerott; Theresa Ann,15,0,15,0
1745817077850,EDS 284,A00,895736,Meyerott; Theresa Ann,15,0,15,0
1745817078875,EDS 286,A00,897210,Fine; Sarah,15,0,15,0
1745817079903,EDS 289C,A01,895770,Daly; Alan J.,15,0,15,0
1745817080929,EDS 290,A00,897211,Hofstetter; Carolyn,15,0,15,0
1745817081953,LIGM 5A,A00,896162,Fischer-Grunski; Eva K,15,0,20,5
1745817082982,LIGM 5B,A00,896260,Fischer-Grunski; Eva K,17,0,20,3
1745817084006,LIGM 5C,A00,896308,Fischer-Grunski; Eva K,18,0,20,2
1745817085036,LIIT 5AS,A00,896313,Carnelos; Chiara,18,0,20,2
1745817086065,LIIT 5BS,A00,896416,Carnelos; Chiara,20,0,20,0
1745817087090,LIIT 5CS,A00,896564,Carnelos; Chiara,20,0,20,0
1745817088118,LISP 5A,A00,896588,Munoz Sanchez; Alicia,4,0,20,16
1745817089141,LISP 5B,A00,896653,Munoz Sanchez; Alicia,10,0,20,10
1745817090170,LISP 5C,A00,896655,Munoz Sanchez; Alicia,4,0,20,16
1745817091198,MAE 197,001,957918,Kleissl; Jan,9998,0,9999,1
1745817092225,MATH 2,A01,957937,Staff,34,0,35,1
1745817093252,MATH 197,001,957876,Kedlaya; Kiran S.,9993,0,9999,6
1745817094279,MCWP 40,A00,892729,Duru; Nur,13,0,20,7
1745817094279,MCWP 40,B00,893304,Montejo; Carolina,20,0,20,0
1745817095303,MCWP 40R,A00,893757,Redela; Pamela Morgan,0,7,20,20
1745817096331,MCWP 50,A00,893758,Morshed; Michael James,2,0,20,18
1745817096331,MCWP 50,B00,893761,Bartulis; Jason Michael,17,0,20,3
1745817097359,MCWP 50R,A00,893766,Compas; Sean Matthew,0,1,20,20
1745817097359,MCWP 50R,B00,893769,Carter; Jennifer A,0,0,20,20
1745817097359,MCWP 50R,C00,893771,Krone; Jarret,0,3,20,20
1745817097359,MCWP 50R,D00,893772,Miller; Elizabeth Deen,3,0,20,17
1745817097359,MCWP 50R,E00,893775,Carter; Andrea L,0,0,20,20
1745817098388,MMW 11R,A01,892721,Herbst; Matthew,11,0,27,16
1745817098388,MMW 11R,A02,892722,Herbst; Matthew,0,0,0,3
1745817099437,MMW 12R,A01,892724,Herbst; Matthew,0,10,16,16
1745817099437,MMW 12R,A02,892725,Herbst; Matthew,0,9,16,16
1745817100460,MMW 13R,A01,892727,Staff,0,3,16,16
1745817100460,MMW 13R,A02,892728,Staff,0,4,16,16
1745817100460,MMW 13R,A03,958032,Staff,0,3,16,16
1745817100460,MMW 13R,A04,958033,Staff,0,2,16,16
1745817100460,MMW 13R,A05,958034,Staff,0,3,16,16
1745817101486,SIO 295LS,A00,894015,Staff,7,0,25,18
1745817102511,SIO 295S,A00,894020,Staff,7,0,25,18
1745817103539,SIOC 290S,B01,958918,Staff,0,0,0,0
1745817104565,SIOC 291S,B01,958922,Staff,0,0,0,0
1745817105592,SOCI 117,A01,895339,Staff,4,0,5,1
1745817106617,WES 237B,A00,894149,Staff,11,0,20,9
1745817108673,AESE 279B,A00,891859,Staff,13,0,35,22
1745817109705,AIP 197,001,891854,Staff,70,0,70,0
1745817110734,ANTH 289S,A00,891856,Gagneux; Pascal,12,0,12,0
1745817111761,BENG 196,001,957946,Engler; Adam J.,9996,0,9999,3
1745817112787,CAT 124RS,A01,956906,Staff,8,0,25,17
1745817113813,CAT 125RS,A01,922013,Staff,8,0,25,17
1745817114841,CLRE 250,A00,891860,Morris; Sheldon,9995,0,9999,4
1745817116894,CLRE 251R,A00,907817,Mehta; Ravindra L.,9994,0,9999,5
1745817117919,CLRE 252,A00,891864,Cuomo; Raphael Eduardo,9993,0,9999,6
1745817118948,CLRE 253,A00,891867,Vaida; Florin,9994,0,9999,5
1745817118948,CLRE 253,B00,907819,Staff,9999,0,9999,0
1745817119973,CLRE 259,A00,891868,Patel; Hemal,9998,0,9999,1
1745817120998,CLRE 260,A00,891872,Cuomo; Raphael Eduardo,9999,0,9999,0
1745817122024,CLRE 297,001,891888,Cuomo; Raphael Eduardo,9999,0,9999,0
1745817123049,CSE 191,A00,958773,Minnes Kemp; Mor Mia,9999,0,9999,0
1745817124078,CSS 201S,A01,892054,Mignozzetti; Umberto,30,0,30,0
1745817125106,CSS 202S,A01,892056,Mignozzetti; Umberto,30,0,30,0
1745817126132,DSC 197,001,956898,Eldridge; Justin Matthew,9998,0,9999,1
1745817127157,DSC 297,001,958000,Mazumdar; Arya,9998,0,9999,1
1745817128183,EAP 100,A00,905686,Staff,9776,0,9999,223
1745817129210,ECE 45,A01,892618,Staff,0,12,50,50
1745817130236,ECE 109,A01,892620,Staff,0,43,0,0
1745817131263,ECE 111,A01,892719,Staff,0,9,50,50
1745817132287,ECE 197,001,957920,Mercier; Patrick Philip,9992,0,9999,7
1745817133312,ECON 178,A01,907814,Zhu; Ying,28,0,35,7
1745817134337,EDS 115,A00,895312,Staff,41,0,45,4
1745817135365,EDS 117,A01,895337,Staff,30,0,30,0
1745817136393,EDS 125,A00,895341,Jones; Gabrielle Anastasia,43,0,45,2
1745817137423,EDS 128A,A01,895459,Fargason; Sharon Gayle,44,0,45,1
1745817138452,EDS 128B,A01,895543,Pappas; Elizabeth,44,0,45,1
1745817139477,EDS 139,A00,897203,Pappas; Elizabeth,44,0,45,1
1745817139477,EDS 139,B00,897209,Fargason; Sharon Gayle,44,0,45,1
1745817140506,EDS 201,A00,895545,Staff,43,0,45,2
1745817141531,EDS 203,A01,895581,Halter; Christopher P.,43,0,45,2
1745817142558,EDS 204R,A01,895625,Heinzman; Erica M.,43,0,45,2
1745817142558,EDS 204R,B01,895693,Halter; Christopher P.,18,0,45,27
1745817143584,EDS 206R,A00,895694,Fargason; Sharon Gayle,9,0,30,21
1745817143584,EDS 206R,B00,895695,Choi; Bailey Miyeon,20,0,30,10
1745817144613,EDS 250,A00,895697,Hemans; Patricia Ann Benitez,43,0,45,2
1745817145638,EDS 281,A00,895701,Meyerott; Theresa Ann,15,0,15,0
1745817146664,EDS 284,A00,895736,Meyerott; Theresa Ann,15,0,15,0
1745817147690,EDS 286,A00,897210,Fine; Sarah,15,0,15,0
1745817148714,EDS 289C,A01,895770,Daly; Alan J.,15,0,15,0
1745817149739,EDS 290,A00,897211,Hofstetter; Carolyn,15,0,15,0
1745817150764,LIGM 5A,A00,896162,Fischer-Grunski; Eva K,15,0,20,5
1745817151791,LIGM 5B,A00,896260,Fischer-Grunski; Eva K,17,0,20,3
1745817152817,LIGM 5C,A00,896308,Fischer-Grunski; Eva K,18,0,20,2
1745817153850,LIIT 5AS,A00,896313,Carnelos; Chiara,18,0,20,2
1745817154875,LIIT 5BS,A00,896416,Carnelos; Chiara,20,0,20,0
1745817155901,LIIT 5CS,A00,896564,Carnelos; Chiara,20,0,20,0
1745817156930,LISP 5A,A00,896588,Munoz Sanchez; Alicia,4,0,20,16
1745817157960,LISP 5B,A00,896653,Munoz Sanchez; Alicia,10,0,20,10
1745817158989,LISP 5C,A00,896655,Munoz Sanchez; Alicia,4,0,20,16
1745817160015,MAE 197,001,957918,Kleissl; Jan,9998,0,9999,1
1745817161045,MATH 2,A01,957937,Staff,34,0,35,1
1745817162072,MATH 197,001,957876,Kedlaya; Kiran S.,9993,0,9999,6
1745817163100,MCWP 40,A00,892729,Duru; Nur,13,0,20,7
1745817163100,MCWP 40,B00,893304,Montejo; Carolina,20,0,20,0
1745817164128,MCWP 40R,A00,893757,Redela; Pamela Morgan,0,7,20,20
1745817165156,MCWP 50,A00,893758,Morshed; Michael James,2,0,20,18
1745817165156,MCWP 50,B00,893761,Bartulis; Jason Michael,17,0,20,3
1745817166183,MCWP 50R,A00,893766,Compas; Sean Matthew,0,1,20,20
1745817166183,MCWP 50R,B00,893769,Carter; Jennifer A,0,0,20,20
1745817166183,MCWP 50R,C00,893771,Krone; Jarret,0,3,20,20
1745817166183,MCWP 50R,D00,893772,Miller; Elizabeth Deen,3,0,20,17
1745817166183,MCWP 50R,E00,893775,Carter; Andrea L,0,0,20,20
1745817167211,MMW 11R,A01,892721,Herbst; Matthew,11,0,27,16
1745817167211,MMW 11R,A02,892722,Herbst; Matthew,0,0,0,3
1745817168237,MMW 12R,A01,892724,Herbst; Matthew,0,10,16,16
1745817168237,MMW 12R,A02,892725,Herbst; Matthew,0,9,16,16
1745817169264,MMW 13R,A01,892727,Staff,0,3,16,16
1745817169264,MMW 13R,A02,892728,Staff,0,4,16,16
1745817169264,MMW 13R,A03,958032,Staff,0,3,16,16
1745817169264,MMW 13R,A04,958033,Staff,0,2,16,16
1745817169264,MMW 13R,A05,958034,Staff,0,3,16,16
1745817170290,SIO 295LS,A00,894015,Staff,7,0,25,18
1745817171317,SIO 295S,A00,894020,Staff,7,0,25,18
1745817172346,SIOC 290S,B01,958918,Staff,0,0,0,0
1745817173373,SIOC 291S,B01,958922,Staff,0,0,0,0
1745817174403,SOCI 117,A01,895339,Staff,4,0,5,1
1745817175467,WES 237B,A00,894149,Staff,11,0,20,9
1745817177527,AESE 279B,A00,891859,Staff,13,0,35,22
1745817178551,AIP 197,001,891854,Staff,70,0,70,0
1745817179576,ANTH 289S,A00,891856,Gagneux; Pascal,12,0,12,0
1745817180603,BENG 196,001,957946,Engler; Adam J.,9996,0,9999,3
1745817181627,CAT 124RS,A01,956906,Staff,8,0,25,17
1745817182656,CAT 125RS,A01,922013,Staff,8,0,25,17
1745817183691,CLRE 250,A00,891860,Morris; Sheldon,9995,0,9999,4
1745817185748,CLRE 251R,A00,907817,Mehta; Ravindra L.,9994,0,9999,5
1745817186773,CLRE 252,A00,891864,Cuomo; Raphael Eduardo,9993,0,9999,6
1745817187803,CLRE 253,A00,891867,Vaida; Florin,9994,0,9999,5
1745817187803,CLRE 253,B00,907819,Staff,9999,0,9999,0
1745817188826,CLRE 259,A00,891868,Patel; Hemal,9998,0,9999,1
1745817189852,CLRE 260,A00,891872,Cuomo; Raphael Eduardo,9999,0,9999,0
1745817190879,CLRE 297,001,891888,Cuomo; Raphael Eduardo,9999,0,9999,0
1745817191909,CSE 191,A00,958773,Minnes Kemp; Mor Mia,9999,0,9999,0
1745817192942,CSS 201S,A01,892054,Mignozzetti; Umberto,30,0,30,0
1745817193973,CSS 202S,A01,892056,Mignozzetti; Umberto,30,0,30,0
1745817194998,DSC 197,001,956898,Eldridge; Justin Matthew,9998,0,9999,1
1745817196026,DSC 297,001,958000,Mazumdar; Arya,9998,0,9999,1
1745817197053,EAP 100,A00,905686,Staff,9776,0,9999,223
1745817198079,ECE 45,A01,892618,Staff,0,12,50,50
1745817199106,ECE 109,A01,892620,Staff,0,43,0,0
1745817200136,ECE 111,A01,892719,Staff,0,9,50,50
1745817201162,ECE 197,001,957920,Mercier; Patrick Philip,9992,0,9999,7
1745817202189,ECON 178,A01,907814,Zhu; Ying,28,0,35,7
1745817203218,EDS 115,A00,895312,Staff,41,0,45,4
1745817204243,EDS 117,A01,895337,Staff,30,0,30,0
1745817205272,EDS 125,A00,895341,Jones; Gabrielle Anastasia,43,0,45,2
1745817206297,EDS 128A,A01,895459,Fargason; Sharon Gayle,44,0,45,1
1745817207323,EDS 128B,A01,895543,Pappas; Elizabeth,44,0,45,1
1745817208348,EDS 139,A00,897203,Pappas; Elizabeth,44,0,45,1
1745817208348,EDS 139,B00,897209,Fargason; Sharon Gayle,44,0,45,1
1745817209375,EDS 201,A00,895545,Staff,43,0,45,2
1745817210404,EDS 203,A01,895581,Halter; Christopher P.,43,0,45,2
1745817211434,EDS 204R,A01,895625,Heinzman; Erica M.,43,0,45,2
1745817211434,EDS 204R,B01,895693,Halter; Christopher P.,18,0,45,27
1745817212460,EDS 206R,A00,895694,Fargason; Sharon Gayle,9,0,30,21
1745817212460,EDS 206R,B00,895695,Choi; Bailey Miyeon,20,0,30,10
1745817213489,EDS 250,A00,895697,Hemans; Patricia Ann Benitez,43,0,45,2
1745817214514,EDS 281,A00,895701,Meyerott; Theresa Ann,15,0,15,0
1745817215542,EDS 284,A00,895736,Meyerott; Theresa Ann,15,0,15,0
1745817216569,EDS 286,A00,897210,Fine; Sarah,15,0,15,0
1745817217595,EDS 289C,A01,895770,Daly; Alan J.,15,0,15,0
1745817218622,EDS 290,A00,897211,Hofstetter; Carolyn,15,0,15,0
1745817219646,LIGM 5A,A00,896162,Fischer-Grunski; Eva K,15,0,20,5
1745817220673,LIGM 5B,A00,896260,Fischer-Grunski; Eva K,17,0,20,3
1745817221700,LIGM 5C,A00,896308,Fischer-Grunski; Eva K,18,0,20,2
1745817222726,LIIT 5AS,A00,896313,Carnelos; Chiara,18,0,20,2
1745817223751,LIIT 5BS,A00,896416,Carnelos; Chiara,20,0,20,0
1745817224780,LIIT 5CS,A00,896564,Carnelos; Chiara,20,0,20,0
1745817225809,LISP 5A,A00,896588,Munoz Sanchez; Alicia,4,0,20,16
1745817226834,LISP 5B,A00,896653,Munoz Sanchez; Alicia,10,0,20,10
1745817227861,LISP 5C,A00,896655,Munoz Sanchez; Alicia,4,0,20,16
1745817228890,MAE 197,001,957918,Kleissl; Jan,9998,0,9999,1
1745817229915,MATH 2,A01,957937,Staff,34,0,35,1
1745817230940,MATH 197,001,957876,Kedlaya; Kiran S.,9993,0,9999,6
1745817231966,MCWP 40,A00,892729,Duru; Nur,13,0,20,7
1745817231966,MCWP 40,B00,893304,Montejo; Carolina,20,0,20,0
1745817232991,MCWP 40R,A00,893757,Redela; Pamela Morgan,0,7,20,20
1745817234021,MCWP 50,A00,893758,Morshed; Michael James,2,0,20,18
1745817234021,MCWP 50,B00,893761,Bartulis; Jason Michael,17,0,20,3
1745817235047,MCWP 50R,A00,893766,Compas; Sean Matthew,0,1,20,20
1745817235047,MCWP 50R,B00,893769,Carter; Jennifer A,0,0,20,20
1745817235047,MCWP 50R,C00,893771,Krone; Jarret,0,3,20,20
1745817235047,MCWP 50R,D00,893772,Miller; Elizabeth Deen,3,0,20,17
1745817235047,MCWP 50R,E00,893775,Carter; Andrea L,0,0,20,20
1745817236074,MMW 11R,A01,892721,Herbst; Matthew,11,0,27,16
1745817236074,MMW 11R,A02,892722,Herbst; Matthew,0,0,0,3
1745817237102,MMW 12R,A01,892724,Herbst; Matthew,0,10,16,16
1745817237102,MMW 12R,A02,892725,Herbst; Matthew,0,9,16,16
1745817238131,MMW 13R,A01,892727,Staff,0,3,16,16
1745817238131,MMW 13R,A02,892728,Staff,0,4,16,16
1745817238131,MMW 13R,A03,958032,Staff,0,3,16,16
1745817238131,MMW 13R,A04,958033,Staff,0,2,16,16
1745817238131,MMW 13R,A05,958034,Staff,0,3,16,16
1745817239160,SIO 295LS,A00,894015,Staff,7,0,25,18
1745817240188,SIO 295S,A00,894020,Staff,7,0,25,18
1745817241217,SIOC 290S,B01,958918,Staff,0,0,0,0
1745817242249,SIOC 291S,B01,958922,Staff,0,0,0,0
1745817243276,SOCI 117,A01,895339,Staff,4,0,5,1
1745817244308,WES 237B,A00,894149,Staff,11,0,20,9
1745817246398,AESE 279B,A00,891859,Staff,13,0,35,22
1745817247424,AIP 197,001,891854,Staff,70,0,70,0
1745817248452,ANTH 289S,A00,891856,Gagneux; Pascal,12,0,12,0
1745817249481,BENG 196,001,957946,Engler; Adam J.,9996,0,9999,3
1745817250507,CAT 124RS,A01,956906,Staff,8,0,25,17
1745817251533,CAT 125RS,A01,922013,Staff,8,0,25,17
1745817252560,CLRE 250,A00,891860,Morris; Sheldon,9995,0,9999,4
1745817254612,CLRE 251R,A00,907817,Mehta; Ravindra L.,9994,0,9999,5
1745817255639,CLRE 252,A00,891864,Cuomo; Raphael Eduardo,9993,0,9999,6
1745817256663,CLRE 253,A00,891867,Vaida; Florin,9994,0,9999,5
1745817256663,CLRE 253,B00,907819,Staff,9999,0,9999,0
1745817257690,CLRE 259,A00,891868,Patel; Hemal,9998,0,9999,1
1745817258718,CLRE 260,A00,891872,Cuomo; Raphael Eduardo,9999,0,9999,0
1745817259743,CLRE 297,001,891888,Cuomo; Raphael Eduardo,9999,0,9999,0
1745817260768,CSE 191,A00,958773,Minnes Kemp; Mor Mia,9999,0,9999,0
1745817261793,CSS 201S,A01,892054,Mignozzetti; Umberto,30,0,30,0
1745817262822,CSS 202S,A01,892056,Mignozzetti; Umberto,30,0,30,0
1745817263846,DSC 197,001,956898,Eldridge; Justin Matthew,9998,0,9999,1
1745817264870,DSC 297,001,958000,Mazumdar; Arya,9998,0,9999,1
1745817265895,EAP 100,A00,905686,Staff,9776,0,9999,223
1745817266920,ECE 45,A01,892618,Staff,0,12,50,50
1745817267946,ECE 109,A01,892620,Staff,0,43,0,0
1745817268971,ECE 111,A01,892719,Staff,0,9,50,50
1745817269998,ECE 197,001,957920,Mercier; Patrick Philip,9992,0,9999,7
1745817271024,ECON 178,A01,907814,Zhu; Ying,28,0,35,7
1745817272050,EDS 115,A00,895312,Staff,41,0,45,4
1745817273077,EDS 117,A01,895337,Staff,30,0,30,0
1745817274106,EDS 125,A00,895341,Jones; Gabrielle Anastasia,43,0,45,2
1745817275133,EDS 128A,A01,895459,Fargason; Sharon Gayle,44,0,45,1
1745817276157,EDS 128B,A01,895543,Pappas; Elizabeth,44,0,45,1
1745817277183,EDS 139,A00,897203,Pappas; Elizabeth,44,0,45,1
1745817277183,EDS 139,B00,897209,Fargason; Sharon Gayle,44,0,45,1
1745817278209,EDS 201,A00,895545,Staff,43,0,45,2
1745817279237,EDS 203,A01,895581,Halter; Christopher P.,43,0,45,2
1745817280267,EDS 204R,A01,895625,Heinzman; Erica M.,43,0,45,2
1745817280267,EDS 204R,B01,895693,Halter; Christopher P.,18,0,45,27
1745817281295,EDS 206R,A00,895694,Fargason; Sharon Gayle,9,0,30,21
1745817281295,EDS 206R,B00,895695,Choi; Bailey Miyeon,20,0,30,10
1745817282322,EDS 250,A00,895697,Hemans; Patricia Ann Benitez,43,0,45,2
1745817283347,EDS 281,A00,895701,Meyerott; Theresa Ann,15,0,15,0
1745817284376,EDS 284,A00,895736,Meyerott; Theresa Ann,15,0,15,0
1745817285402,EDS 286,A00,897210,Fine; Sarah,15,0,15,0
1745817286430,EDS 289C,A01,895770,Daly; Alan J.,15,0,15,0
1745817287455,EDS 290,A00,897211,Hofstetter; Carolyn,15,0,15,0
1745817288482,LIGM 5A,A00,896162,Fischer-Grunski; Eva K,15,0,20,5
1745817289508,LIGM 5B,A00,896260,Fischer-Grunski; Eva K,17,0,20,3
1745817290534,LIGM 5C,A00,896308,Fischer-Grunski; Eva K,18,0,20,2
1745817291561,LIIT 5AS,A00,896313,Carnelos; Chiara,18,0,20,2
1745817292589,LIIT 5BS,A00,896416,Carnelos; Chiara,20,0,20,0
1745817293615,LIIT 5CS,A00,896564,Carnelos; Chiara,20,0,20,0
1745817294641,LISP 5A,A00,896588,Munoz Sanchez; Alicia,4,0,20,16
1745817295666,LISP 5B,A00,896653,Munoz Sanchez; Alicia,10,0,20,10
1745817296697,LISP 5C,A00,896655,Munoz Sanchez; Alicia,4,0,20,16
1745817297724,MAE 197,001,957918,Kleissl; Jan,9998,0,9999,1
1745817298753,MATH 2,A01,957937,Staff,34,0,35,1
1745817299778,MATH 197,001,957876,Kedlaya; Kiran S.,9993,0,9999,6
1745817300805,MCWP 40,A00,892729,Duru; Nur,13,0,20,7
1745817300805,MCWP 40,B00,893304,Montejo; Carolina,20,0,20,0
1745817301833,MCWP 40R,A00,893757,Redela; Pamela Morgan,0,7,20,20
1745817302865,MCWP 50,A00,893758,Morshed; Michael James,2,0,20,18
1745817302865,MCWP 50,B00,893761,Bartulis; Jason Michael,17,0,20,3
1745817303895,MCWP 50R,A00,893766,Compas; Sean Matthew,0,1,20,20
1745817303895,MCWP 50R,B00,893769,Carter; Jennifer A,0,0,20,20
1745817303895,MCWP 50R,C00,893771,Krone; Jarret,0,3,20,20
1745817303895,MCWP 50R,D00,893772,Miller; Elizabeth Deen,3,0,20,17
1745817303895,MCWP 50R,E00,893775,Carter; Andrea L,0,0,20,20
1745817304921,MMW 11R,A01,892721,Herbst; Matthew,11,0,27,16
1745817304921,MMW 11R,A02,892722,Herbst; Matthew,0,0,0,3
1745817305947,MMW 12R,A01,892724,Herbst; Matthew,0,10,16,16
1745817305947,MMW 12R,A02,892725,Herbst; Matthew,0,9,16,16
1745817306973,MMW 13R,A01,892727,Staff,0,3,16,16
1745817306973,MMW 13R,A02,892728,Staff,0,4,16,16
1745817306973,MMW 13R,A03,958032,Staff,0,3,16,16
1745817306973,MMW 13R,A04,958033,Staff,0,2,16,16
1745817306973,MMW 13R,A05,958034,Staff,0,3,16,16
1745817308001,SIO 295LS,A00,894015,Staff,7,0,25,18
1745817309030,SIO 295S,A00,894020,Staff,7,0,25,18
1745817310057,SIOC 290S,B01,958918,Staff,0,0,0,0
1745817311088,SIOC 291S,B01,958922,Staff,0,0,0,0
1745817312115,SOCI 117,A01,895339,Staff,4,0,5,1
1745817313140,WES 237B,A00,894149,Staff,11,0,20,9
1745817315202,AESE 279B,A00,891859,Staff,13,0,35,22
1745817316228,AIP 197,001,891854,Staff,70,0,70,0
1745817317252,ANTH 289S,A00,891856,Gagneux; Pascal,12,0,12,0
1745817318279,BENG 196,001,957946,Engler; Adam J.,9996,0,9999,3
1745817319306,CAT 124RS,A01,956906,Staff,8,0,25,17
1745817320332,CAT 125RS,A01,922013,Staff,8,0,25,17
1745817321361,CLRE 250,A00,891860,Morris; Sheldon,9995,0,9999,4
1745817323420,CLRE 251R,A00,907817,Mehta; Ravindra L.,9994,0,9999,5
1745817324449,CLRE 252,A00,891864,Cuomo; Raphael Eduardo,9993,0,9999,6
1745817325479,CLRE 253,A00,891867,Vaida; Florin,9994,0,9999,5
1745817325479,CLRE 253,B00,907819,Staff,9999,0,9999,0
1745817326505,CLRE 259,A00,891868,Patel; Hemal,9998,0,9999,1
1745817327533,CLRE 260,A00,891872,Cuomo; Raphael Eduardo,9999,0,9999,0
1745817328561,CLRE 297,001,891888,Cuomo; Raphael Eduardo,9999,0,9999,0
1745817329591,CSE 191,A00,958773,Minnes Kemp; Mor Mia,9999,0,9999,0
1745817330621,CSS 201S,A01,892054,Mignozzetti; Umberto,30,0,30,0
1745817331649,CSS 202S,A01,892056,Mignozzetti; Umberto,30,0,30,0
1745817332675,DSC 197,001,956898,Eldridge; Justin Matthew,9998,0,9999,1
1745817333701,DSC 297,001,958000,Mazumdar; Arya,9998,0,9999,1
1745817334727,EAP 100,A00,905686,Staff,9776,0,9999,223
1745817335752,ECE 45,A01,892618,Staff,0,12,50,50
1745817336780,ECE 109,A01,892620,Staff,0,43,0,0
1745817337808,ECE 111,A01,892719,Staff,0,9,50,50
1745817338835,ECE 197,001,957920,Mercier; Patrick Philip,9992,0,9999,7
1745817339860,ECON 178,A01,907814,Zhu; Ying,28,0,35,7
1745817340887,EDS 115,A00,895312,Staff,41,0,45,4
1745817341913,EDS 117,A01,895337,Staff,30,0,30,0
1745817342941,EDS 125,A00,895341,Jones; Gabrielle Anastasia,43,0,45,2
1745817343967,EDS 128A,A01,895459,Fargason; Sharon Gayle,44,0,45,1
1745817344993,EDS 128B,A01,895543,Pappas; Elizabeth,44,0,45,1
1745817346022,EDS 139,A00,897203,Pappas; Elizabeth,44,0,45,1
1745817346022,EDS 139,B00,897209,Fargason; Sharon Gayle,44,0,45,1
1745817347047,EDS 201,A00,895545,Staff,43,0,45,2
1745817348076,EDS 203,A01,895581,Halter; Christopher P.,43,0,45,2
1745817349101,EDS 204R,A01,895625,Heinzman; Erica M.,43,0,45,2
1745817349101,EDS 204R,B01,895693,Halter; Christopher P.,18,0,45,27
1745817350126,EDS 206R,A00,895694,Fargason; Sharon Gayle,9,0,30,21
1745817350126,EDS 206R,B00,895695,Choi; Bailey Miyeon,20,0,30,10
1745817351153,EDS 250,A00,895697,Hemans; Patricia Ann Benitez,43,0,45,2
1745817352179,EDS 281,A00,895701,Meyerott; Theresa Ann,15,0,15,0
1745817353206,EDS 284,A00,895736,Meyerott; Theresa Ann,15,0,15,0
1745817354231,EDS 286,A00,897210,Fine; Sarah,15,0,15,0
1745817355258,EDS 289C,A01,895770,Daly; Alan J.,15,0,15,0
1745817356284,EDS 290,A00,897211,Hofstetter; Carolyn,15,0,15,0
1745817357312,LIGM 5A,A00,896162,Fischer-Grunski; Eva K,15,0,20,5
1745817358342,LIGM 5B,A00,896260,Fischer-Grunski; Eva K,17,0,20,3
1745817359371,LIGM 5C,A00,896308,Fischer-Grunski; Eva K,18,0,20,2
1745817360398,LIIT 5AS,A00,896313,Carnelos; Chiara,18,0,20,2
1745817361423,LIIT 5BS,A00,896416,Carnelos; Chiara,20,0,20,0
1745817362454,LIIT 5CS,A00,896564,Carnelos; Chiara,20,0,20,0
1745817363478,LISP 5A,A00,896588,Munoz Sanchez; Alicia,4,0,20,16
1745817364505,LISP 5B,A00,896653,Munoz Sanchez; Alicia,10,0,20,10
1745817365531,LISP 5C,A00,896655,Munoz Sanchez; Alicia,4,0,20,16
1745817366557,MAE 197,001,957918,Kleissl; Jan,9998,0,9999,1
1745817367583,MATH 2,A01,957937,Staff,34,0,35,1
1745817368607,MATH 197,001,957876,Kedlaya; Kiran S.,9993,0,9999,6
1745817369633,MCWP 40,A00,892729,Duru; Nur,13,0,20,7
1745817369633,MCWP 40,B00,893304,Montejo; Carolina,20,0,20,0
1745817370660,MCWP 40R,A00,893757,Redela; Pamela Morgan,0,7,20,20
1745817371686,MCWP 50,A00,893758,Morshed; Michael James,2,0,20,18
1745817371686,MCWP 50,B00,893761,Bartulis; Jason Michael,17,0,20,3
1745817372710,MCWP 50R,A00,893766,Compas; Sean Matthew,0,1,20,20
1745817372710,MCWP 50R,B00,893769,Carter; Jennifer A,0,0,20,20
1745817372710,MCWP 50R,C00,893771,Krone; Jarret,0,3,20,20
1745817372710,MCWP 50R,D00,893772,Miller; Elizabeth Deen,3,0,20,17
1745817372710,MCWP 50R,E00,893775,Carter; Andrea L,0,0,20,20
1745817373739,MMW 11R,A01,892721,Herbst; Matthew,11,0,27,16
1745817373739,MMW 11R,A02,892722,Herbst; Matthew,0,0,0,3
1745817374769,MMW 12R,A01,892724,Herbst; Matthew,0,10,16,16
1745817374769,MMW 12R,A02,892725,Herbst; Matthew,0,9,16,16
1745817375796,MMW 13R,A01,892727,Staff,0,3,16,16
1745817375796,MMW 13R,A02,892728,Staff,0,4,16,16
1745817375796,MMW 13R,A03,958032,Staff,0,3,16,16
1745817375796,MMW 13R,A04,958033,Staff,0,2,16,16
1745817375796,MMW 13R,A05,958034,Staff,0,3,16,16
1745817376823,SIO 295LS,A00,894015,Staff,7,0,25,18
1745817377849,SIO 295S,A00,894020,Staff,7,0,25,18
1745817378876,SIOC 290S,B01,958918,Staff,0,0,0,0
1745817379905,SIOC 291S,B01,958922,Staff,0,0,0,0
1745817380933,SOCI 117,A01,895339,Staff,4,0,5,1
1745817381960,WES 237B,A00,894149,Staff,11,0,20,9
1745817384039,AESE 279B,A00,891859,Staff,13,0,35,22
1745817385063,AIP 197,001,891854,Staff,70,0,70,0
1745817386092,ANTH 289S,A00,891856,Gagneux; Pascal,12,0,12,0
1745817387117,BENG 196,001,957946,Engler; Adam J.,9996,0,9999,3
1745817388143,CAT 124RS,A01,956906,Staff,8,0,25,17
1745817389169,CAT 125RS,A01,922013,Staff,8,0,25,17
1745817390193,CLRE 250,A00,891860,Morris; Sheldon,9995,0,9999,4
1745817392249,CLRE 251R,A00,907817,Mehta; Ravindra L.,9994,0,9999,5
1745817393272,CLRE 252,A00,891864,Cuomo; Raphael Eduardo,9993,0,9999,6
1745817394299,CLRE 253,A00,891867,Vaida; Florin,9994,0,9999,5
1745817394299,CLRE 253,B00,907819,Staff,9999,0,9999,0
1745817395323,CLRE 259,A00,891868,Patel; Hemal,9998,0,9999,1
1745817396349,CLRE 260,A00,891872,Cuomo; Raphael Eduardo,9999,0,9999,0
1745817397438,CLRE 297,001,891888,Cuomo; Raphael Eduardo,9999,0,9999,0
1745817398461,CSE 191,A00,958773,Minnes Kemp; Mor Mia,9999,0,9999,0
1745817399488,CSS 201S,A01,892054,Mignozzetti; Umberto,30,0,30,0
1745817400513,CSS 202S,A01,892056,Mignozzetti; Umberto,30,0,30,0
1745817401541,DSC 197,001,956898,Eldridge; Justin Matthew,9998,0,9999,1
1745817402570,DSC 297,001,958000,Mazumdar; Arya,9998,0,9999,1
1745817403596,EAP 100,A00,905686,Staff,9776,0,9999,223
1745817404625,ECE 45,A01,892618,Staff,0,12,50,50
1745817405655,ECE 109,A01,892620,Staff,0,43,0,0
1745817406679,ECE 111,A01,892719,Staff,0,9,50,50
1745817407704,ECE 197,001,957920,Mercier; Patrick Philip,9992,0,9999,7
1745817408731,ECON 178,A01,907814,Zhu; Ying,28,0,35,7
1745817409756,EDS 115,A00,895312,Staff,41,0,45,4
1745817410783,EDS 117,A01,895337,Staff,30,0,30,0
1745817411811,EDS 125,A00,895341,Jones; Gabrielle Anastasia,43,0,45,2
1745817412838,EDS 128A,A01,895459,Fargason; Sharon Gayle,44,0,45,1
1745817413864,EDS 128B,A01,895543,Pappas; Elizabeth,44,0,45,1
1745817414893,EDS 139,A00,897203,Pappas; Elizabeth,44,0,45,1
1745817414893,EDS 139,B00,897209,Fargason; Sharon Gayle,44,0,45,1
1745817415921,EDS 201,A00,895545,Staff,43,0,45,2
1745817416948,EDS 203,A01,895581,Halter; Christopher P.,43,0,45,2
1745817417974,EDS 204R,A01,895625,Heinzman; Erica M.,43,0,45,2
1745817417974,EDS 204R,B01,895693,Halter; Christopher P.,18,0,45,27
1745817419003,EDS 206R,A00,895694,Fargason; Sharon Gayle,9,0,30,21
1745817419003,EDS 206R,B00,895695,Choi; Bailey Miyeon,20,0,30,10
1745817420038,EDS 250,A00,895697,Hemans; Patricia Ann Benitez,43,0,45,2
1745817421062,EDS 281,A00,895701,Meyerott; Theresa Ann,15,0,15,0
1745817422087,EDS 284,A00,895736,Meyerott; Theresa Ann,15,0,15,0
1745817423117,EDS 286,A00,897210,Fine; Sarah,15,0,15,0
1745817424148,EDS 289C,A01,895770,Daly; Alan J.,15,0,15,0
1745817425170,EDS 290,A00,897211,Hofstetter; Carolyn,15,0,15,0
1745817426196,LIGM 5A,A00,896162,Fischer-Grunski; Eva K,15,0,20,5
1745817427224,LIGM 5B,A00,896260,Fischer-Grunski; Eva K,17,0,20,3
1745817428250,LIGM 5C,A00,896308,Fischer-Grunski; Eva K,18,0,20,2
1745817429292,LIIT 5AS,A00,896313,Carnelos; Chiara,18,0,20,2
1745817430319,LIIT 5BS,A00,896416,Carnelos; Chiara,20,0,20,0
1745817431348,LIIT 5CS,A00,896564,Carnelos; Chiara,20,0,20,0
1745817432376,LISP 5A,A00,896588,Munoz Sanchez; Alicia,4,0,20,16
1745817433402,LISP 5B,A00,896653,Munoz Sanchez; Alicia,10,0,20,10
1745817434431,LISP 5C,A00,896655,Munoz Sanchez; Alicia,4,0,20,16
1745817435460,MAE 197,001,957918,Kleissl; Jan,9998,0,9999,1
1745817436486,MATH 2,A01,957937,Staff,34,0,35,1
1745817437514,MATH 197,001,957876,Kedlaya; Kiran S.,9993,0,9999,6
1745817438543,MCWP 40,A00,892729,Duru; Nur,13,0,20,7
1745817438543,MCWP 40,B00,893304,Montejo; Carolina,20,0,20,0
1745817439570,MCWP 40R,A00,893757,Redela; Pamela Morgan,0,7,20,20
1745817440598,MCWP 50,A00,893758,Morshed; Michael James,2,0,20,18
1745817440598,MCWP 50,B00,893761,Bartulis; Jason Michael,17,0,20,3
1745817441623,MCWP 50R,A00,893766,Compas; Sean Matthew,0,1,20,20
1745817441623,MCWP 50R,B00,893769,Carter; Jennifer A,0,0,20,20
1745817441623,MCWP 50R,C00,893771,Krone; Jarret,0,3,20,20
1745817441623,MCWP 50R,D00,893772,Miller; Elizabeth Deen,3,0,20,17
1745817441623,MCWP 50R,E00,893775,Carter; Andrea L,0,0,20,20
1745817442650,MMW 11R,A01,892721,Herbst; Matthew,11,0,27,16
1745817442650,MMW 11R,A02,892722,Herbst; Matthew,0,0,0,3
1745817443676,MMW 12R,A01,892724,Herbst; Matthew,0,10,16,16
1745817443676,MMW 12R,A02,892725,Herbst; Matthew,0,9,16,16
1745817444705,MMW 13R,A01,892727,Staff,0,3,16,16
1745817444705,MMW 13R,A02,892728,Staff,0,4,16,16
1745817444705,MMW 13R,A03,958032,Staff,0,3,16,16
1745817444705,MMW 13R,A04,958033,Staff,0,2,16,16
1745817444705,MMW 13R,A05,958034,Staff,0,3,16,16
1745817445732,SIO 295LS,A00,894015,Staff,7,0,25,18
1745817446757,SIO 295S,A00,894020,Staff,7,0,25,18
1745817447782,SIOC 290S,B01,958918,Staff,0,0,0,0
1745817448808,SIOC 291S,B01,958922,Staff,0,0,0,0
1745817449833,SOCI 117,A01,895339,Staff,4,0,5,1
1745817450860,WES 237B,A00,894149,Staff,11,0,20,9
1745817452921,AESE 279B,A00,891859,Staff,13,0,35,22
1745817453946,AIP 197,001,891854,Staff,70,0,70,0
1745817454971,ANTH 289S,A00,891856,Gagneux; Pascal,12,0,12,0
1745817455995,BENG 196,001,957946,Engler; Adam J.,9996,0,9999,3
1745817457019,CAT 124RS,A01,956906,Staff,8,0,25,17
1745817458044,CAT 125RS,A01,922013,Staff,8,0,25,17
1745817459074,CLRE 250,A00,891860,Morris; Sheldon,9995,0,9999,4
1745817461125,CLRE 251R,A00,907817,Mehta; Ravindra L.,9994,0,9999,5
1745817462150,CLRE 252,A00,891864,Cuomo; Raphael Eduardo,9993,0,9999,6
1745817463173,CLRE 253,A00,891867,Vaida; Florin,9994,0,9999,5
1745817463173,CLRE 253,B00,907819,Staff,9999,0,9999,0
1745817464200,CLRE 259,A00,891868,Patel; Hemal,9998,0,9999,1
1745817465224,CLRE 260,A00,891872,Cuomo; Raphael Eduardo,9999,0,9999,0
1745817466249,CLRE 297,001,891888,Cuomo; Raphael Eduardo,9999,0,9999,0
1745817467276,CSE 191,A00,958773,Minnes Kemp; Mor Mia,9999,0,9999,0
1745817468308,CSS 201S,A01,892054,Mignozzetti; Umberto,30,0,30,0
1745817469335,CSS 202S,A01,892056,Mignozzetti; Umberto,30,0,30,0
1745817470363,DSC 197,001,956898,Eldridge; Justin Matthew,9998,0,9999,1
1745817471389,DSC 297,001,958000,Mazumdar; Arya,9998,0,9999,1
1745817472442,EAP 100,A00,905686,Staff,9776,0,9999,223
1745817473468,ECE 45,A01,892618,Staff,0,12,50,50
1745817474494,ECE 109,A01,892620,Staff,0,43,0,0
1745817475521,ECE 111,A01,892719,Staff,0,9,50,50
1745817476551,ECE 197,001,957920,Mercier; Patrick Philip,9992,0,9999,7
1745817477578,ECON 178,A01,907814,Zhu; Ying,28,0,35,7
1745817478606,EDS 115,A00,895312,Staff,41,0,45,4
1745817479634,EDS 117,A01,895337,Staff,30,0,30,0
1745817480662,EDS 125,A00,895341,Jones; Gabrielle Anastasia,43,0,45,2
1745817481689,EDS 128A,A01,895459,Fargason; Sharon Gayle,44,0,45,1
1745817482719,EDS 128B,A01,895543,Pappas; Elizabeth,44,0,45,1
1745817483744,EDS 139,A00,897203,Pappas; Elizabeth,44,0,45,1
1745817483744,EDS 139,B00,897209,Fargason; Sharon Gayle,44,0,45,1
1745817484770,EDS 201,A00,895545,Staff,43,0,45,2
1745817485805,EDS 203,A01,895581,Halter; Christopher P.,43,0,45,2
1745817486832,EDS 204R,A01,895625,Heinzman; Erica M.,43,0,45,2
1745817486832,EDS 204R,B01,895693,Halter; Christopher P.,18,0,45,27
1745817487857,EDS 206R,A00,895694,Fargason; Sharon Gayle,9,0,30,21
1745817487857,EDS 206R,B00,895695,Choi; Bailey Miyeon,20,0,30,10
1745817488883,EDS 250,A00,895697,Hemans; Patricia Ann Benitez,43,0,45,2
1745817489911,EDS 281,A00,895701,Meyerott; Theresa Ann,15,0,15,0
1745817490939,EDS 284,A00,895736,Meyerott; Theresa Ann,15,0,15,0
1745817491971,EDS 286,A00,897210,Fine; Sarah,15,0,15,0
1745817492995,EDS 289C,A01,895770,Daly; Alan J.,15,0,15,0
1745817494021,EDS 290,A00,897211,Hofstetter; Carolyn,15,0,15,0
1745817495047,LIGM 5A,A00,896162,Fischer-Grunski; Eva K,15,0,20,5
1745817496074,LIGM 5B,A00,896260,Fischer-Grunski; Eva K,17,0,20,3
1745817497105,LIGM 5C,A00,896308,Fischer-Grunski; Eva K,18,0,20,2
1745817498129,LIIT 5AS,A00,896313,Carnelos; Chiara,18,0,20,2
1745817499157,LIIT 5BS,A00,896416,Carnelos; Chiara,20,0,20,0
1745817500185,LIIT 5CS,A00,896564,Carnelos; Chiara,20,0,20,0
1745817501215,LISP 5A,A00,896588,Munoz Sanchez; Alicia,4,0,20,16
1745817502246,LISP 5B,A00,896653,Munoz Sanchez; Alicia,10,0,20,10
1745817503276,LISP 5C,A00,896655,Munoz Sanchez; Alicia,4,0,20,16
1745817504303,MAE 197,001,957918,Kleissl; Jan,9998,0,9999,1
1745817505328,MATH 2,A01,957937,Staff,34,0,35,1
1745817506354,MATH 197,001,957876,Kedlaya; Kiran S.,9993,0,9999,6
1745817507380,MCWP 40,A00,892729,Duru; Nur,13,0,20,7
1745817507380,MCWP 40,B00,893304,Montejo; Carolina,20,0,20,0
1745817508408,MCWP 40R,A00,893757,Redela; Pamela Morgan,0,7,20,20
1745817509436,MCWP 50,A00,893758,Morshed; Michael James,2,0,20,18
1745817509436,MCWP 50,B00,893761,Bartulis; Jason Michael,17,0,20,3
1745817510464,MCWP 50R,A00,893766,Compas; Sean Matthew,0,1,20,20
1745817510464,MCWP 50R,B00,893769,Carter; Jennifer A,0,0,20,20
1745817510464,MCWP 50R,C00,893771,Krone; Jarret,0,3,20,20
1745817510464,MCWP 50R,D00,893772,Miller; Elizabeth Deen,3,0,20,17
1745817510464,MCWP 50R,E00,893775,Carter; Andrea L,0,0,20,20
1745817511492,MMW 11R,A01,892721,Herbst; Matthew,11,0,27,16
1745817511492,MMW 11R,A02,892722,Herbst; Matthew,0,0,0,3
1745817512517,MMW 12R,A01,892724,Herbst; Matthew,0,10,16,16
1745817512517,MMW 12R,A02,892725,Herbst; Matthew,0,9,16,16
1745817513544,MMW 13R,A01,892727,Staff,0,3,16,16
1745817513544,MMW 13R,A02,892728,Staff,0,4,16,16
1745817513544,MMW 13R,A03,958032,Staff,0,3,16,16
1745817513544,MMW 13R,A04,958033,Staff,0,2,16,16
1745817513544,MMW 13R,A05,958034,Staff,0,3,16,16
1745817514572,SIO 295LS,A00,894015,Staff,7,0,25,18
1745817515600,SIO 295S,A00,894020,Staff,7,0,25,18
1745817516627,SIOC 290S,B01,958918,Staff,0,0,0,0
1745817517651,SIOC 291S,B01,958922,Staff,0,0,0,0
1745817518681,SOCI 117,A01,895339,Staff,4,0,5,1
1745817519707,WES 237B,A00,894149,Staff,11,0,20,9
1745817521781,AESE 279B,A00,891859,Staff,13,0,35,22
1745817522806,AIP 197,001,891854,Staff,70,0,70,0
1745817523832,ANTH 289S,A00,891856,Gagneux; Pascal,12,0,12,0
1745817524859,BENG 196,001,957946,Engler; Adam J.,9996,0,9999,3
1745817525886,CAT 124RS,A01,956906,Staff,8,0,25,17
1745817526912,CAT 125RS,A01,922013,Staff,8,0,25,17
1745817527937,CLRE 250,A00,891860,Morris; Sheldon,9995,0,9999,4
1745817529986,CLRE 251R,A00,907817,Mehta; Ravindra L.,9994,0,9999,5
1745817531014,CLRE 252,A00,891864,Cuomo; Raphael Eduardo,9993,0,9999,6
1745817532039,CLRE 253,A00,891867,Vaida; Florin,9994,0,9999,5
1745817532039,CLRE 253,B00,907819,Staff,9999,0,9999,0
1745817533064,CLRE 259,A00,891868,Patel; Hemal,9998,0,9999,1
1745817534092,CLRE 260,A00,891872,Cuomo; Raphael Eduardo,9999,0,9999,0
1745817535122,CLRE 297,001,891888,Cuomo; Raphael Eduardo,9999,0,9999,0
1745817536148,CSE 191,A00,958773,Minnes Kemp; Mor Mia,9999,0,9999,0
1745817537174,CSS 201S,A01,892054,Mignozzetti; Umberto,30,0,30,0
1745817538199,CSS 202S,A01,892056,Mignozzetti; Umberto,30,0,30,0
1745817539226,DSC 197,001,956898,Eldridge; Justin Matthew,9998,0,9999,1
1745817540254,DSC 297,001,958000,Mazumdar; Arya,9998,0,9999,1
1745817541283,EAP 100,A00,905686,Staff,9776,0,9999,223
1745817542312,ECE 45,A01,892618,Staff,0,12,50,50
1745817543341,ECE 109,A01,892620,Staff,0,43,0,0
1745817544368,ECE 111,A01,892719,Staff,0,9,50,50
1745817545393,ECE 197,001,957920,Mercier; Patrick Philip,9992,0,9999,7
1745817546420,ECON 178,A01,907814,Zhu; Ying,28,0,35,7
1745817547447,EDS 115,A00,895312,Staff,41,0,45,4
1745817548472,EDS 117,A01,895337,Staff,30,0,30,0
1745817549499,EDS 125,A00,895341,Jones; Gabrielle Anastasia,43,0,45,2
1745817550528,EDS 128A,A01,895459,Fargason; Sharon Gayle,44,0,45,1
1745817551558,EDS 128B,A01,895543,Pappas; Elizabeth,44,0,45,1
1745817552587,EDS 139,A00,897203,Pappas; Elizabeth,44,0,45,1
1745817552587,EDS 139,B00,897209,Fargason; Sharon Gayle,44,0,45,1
1745817553614,EDS 201,A00,895545,Staff,43,0,45,2
1745817554641,EDS 203,A01,895581,Halter; Christopher P.,43,0,45,2
1745817555671,EDS 204R,A01,895625,Heinzman; Erica M.,43,0,45,2
1745817555671,EDS 204R,B01,895693,Halter; Christopher P.,18,0,45,27
1745817556698,EDS 206R,A00,895694,Fargason; Sharon Gayle,9,0,30,21
1745817556698,EDS 206R,B00,895695,Choi; Bailey Miyeon,20,0,30,10
1745817557727,EDS 250,A00,895697,Hemans; Patricia Ann Benitez,43,0,45,2
1745817558752,EDS 281,A00,895701,Meyerott; Theresa Ann,15,0,15,0
1745817559779,EDS 284,A00,895736,Meyerott; Theresa Ann,15,0,15,0
1745817560807,EDS 286,A00,897210,Fine; Sarah,15,0,15,0
1745817561833,EDS 289C,A01,895770,Daly; Alan J.,15,0,15,0
1745817562862,EDS 290,A00,897211,Hofstetter; Carolyn,15,0,15,0
1745817563891,LIGM 5A,A00,896162,Fischer-Grunski; Eva K,15,0,20,5
1745817564917,LIGM 5B,A00,896260,Fischer-Grunski; Eva K,17,0,20,3
1745817565945,LIGM 5C,A00,896308,Fischer-Grunski; Eva K,18,0,20,2
1745817566974,LIIT 5AS,A00,896313,Carnelos; Chiara,18,0,20,2
1745817568005,LIIT 5BS,A00,896416,Carnelos; Chiara,20,0,20,0
1745817569031,LIIT 5CS,A00,896564,Carnelos; Chiara,20,0,20,0
1745817570060,LISP 5A,A00,896588,Munoz Sanchez; Alicia,4,0,20,16
1745817571090,LISP 5B,A00,896653,Munoz Sanchez; Alicia,10,0,20,10
1745817572117,LISP 5C,A00,896655,Munoz Sanchez; Alicia,4,0,20,16
1745817573159,MAE 197,001,957918,Kleissl; Jan,9998,0,9999,1
1745817574185,MATH 2,A01,957937,Staff,34,0,35,1
1745817575210,MATH 197,001,957876,Kedlaya; Kiran S.,9993,0,9999,6
1745817576238,MCWP 40,A00,892729,Duru; Nur,13,0,20,7
1745817576238,MCWP 40,B00,893304,Montejo; Carolina,20,0,20,0
1745817577266,MCWP 40R,A00,893757,Redela; Pamela Morgan,0,7,20,20
1745817578293,MCWP 50,A00,893758,Morshed; Michael James,2,0,20,18
1745817578293,MCWP 50,B00,893761,Bartulis; Jason Michael,17,0,20,3
1745817579321,MCWP 50R,A00,893766,Compas; Sean Matthew,0,1,20,20
1745817579321,MCWP 50R,B00,893769,Carter; Jennifer A,0,0,20,20
1745817579321,MCWP 50R,C00,893771,Krone; Jarret,0,3,20,20
1745817579321,MCWP 50R,D00,893772,Miller; Elizabeth Deen,3,0,20,17
1745817579321,MCWP 50R,E00,893775,Carter; Andrea L,0,0,20,20
1745817580349,MMW 11R,A01,892721,Herbst; Matthew,11,0,27,16
1745817580349,MMW 11R,A02,892722,Herbst; Matthew,0,0,0,3
1745817581379,MMW 12R,A01,892724,Herbst; Matthew,0,10,16,16
1745817581379,MMW 12R,A02,892725,Herbst; Matthew,0,9,16,16
1745817582405,MMW 13R,A01,892727,Staff,0,3,16,16
1745817582405,MMW 13R,A02,892728,Staff,0,4,16,16
1745817582405,MMW 13R,A03,958032,Staff,0,3,16,16
1745817582405,MMW 13R,A04,958033,Staff,0,2,16,16
1745817582405,MMW 13R,A05,958034,Staff,0,3,16,16
1745817583431,SIO 295LS,A00,894015,Staff,7,0,25,18
1745817584458,SIO 295S,A00,894020,Staff,7,0,25,18
1745817585485,SIOC 290S,B01,958918,Staff,0,0,0,0
1745817586513,SIOC 291S,B01,958922,Staff,0,0,0,0
1745817587539,SOCI 117,A01,895339,Staff,4,0,5,1
1745817588565,WES 237B,A00,894149,Staff,11,0,20,9
1745817590626,AESE 279B,A00,891859,Staff,13,0,35,22
1745817591653,AIP 197,001,891854,Staff,70,0,70,0
1745817592677,ANTH 289S,A00,891856,Gagneux; Pascal,12,0,12,0
1745817593703,BENG 196,001,957946,Engler; Adam J.,9996,0,9999,3
1745817594733,CAT 124RS,A01,956906,Staff,8,0,25,17
1745817595757,CAT 125RS,A01,922013,Staff,8,0,25,17
1745817596785,CLRE 250,A00,891860,Morris; Sheldon,9995,0,9999,4
1745817598840,CLRE 251R,A00,907817,Mehta; Ravindra L.,9994,0,9999,5
1745817599866,CLRE 252,A00,891864,Cuomo; Raphael Eduardo,9993,0,9999,6
1745817600891,CLRE 253,A00,891867,Vaida; Florin,9994,0,9999,5
1745817600891,CLRE 253,B00,907819,Staff,9999,0,9999,0
1745817601920,CLRE 259,A00,891868,Patel; Hemal,9998,0,9999,1
1745817602945,CLRE 260,A00,891872,Cuomo; Raphael Eduardo,9999,0,9999,0
1745817603974,CLRE 297,001,891888,Cuomo; Raphael Eduardo,9999,0,9999,0
1745817605007,CSE 191,A00,958773,Minnes Kemp; Mor Mia,9999,0,9999,0
1745817606032,CSS 201S,A01,892054,Mignozzetti; Umberto,30,0,30,0
1745817607061,CSS 202S,A01,892056,Mignozzetti; Umberto,30,0,30,0
1745817608091,DSC 197,001,956898,Eldridge; Justin Matthew,9998,0,9999,1
1745817609117,DSC 297,001,958000,Mazumdar; Arya,9998,0,9999,1
1745817610143,EAP 100,A00,905686,Staff,9776,0,9999,223
1745817611173,ECE 45,A01,892618,Staff,0,12,50,50
1745817612199,ECE 109,A01,892620,Staff,0,43,0,0
1745817613228,ECE 111,A01,892719,Staff,0,9,50,50
1745817614252,ECE 197,001,957920,Mercier; Patrick Philip,9992,0,9999,7
1745817615277,ECON 178,A01,907814,Zhu; Ying,28,0,35,7
1745817616305,EDS 115,A00,895312,Staff,41,0,45,4
1745817617335,EDS 117,A01,895337,Staff,30,0,30,0
1745817618361,EDS 125,A00,895341,Jones; Gabrielle Anastasia,43,0,45,2
1745817619391,EDS 128A,A01,895459,Fargason; Sharon Gayle,44,0,45,1
1745817620417,EDS 128B,A01,895543,Pappas; Elizabeth,44,0,45,1
1745817621443,EDS 139,A00,897203,Pappas; Elizabeth,44,0,45,1
1745817621443,EDS 139,B00,897209,Fargason; Sharon Gayle,44,0,45,1
1745817622468,EDS 201,A00,895545,Staff,43,0,45,2
1745817623494,EDS 203,A01,895581,Halter; Christopher P.,43,0,45,2
1745817624518,EDS 204R,A01,895625,Heinzman; Erica M.,43,0,45,2
1745817624518,EDS 204R,B01,895693,Halter; Christopher P.,18,0,45,27
1745817625547,EDS 206R,A00,895694,Fargason; Sharon Gayle,9,0,30,21
1745817625547,EDS 206R,B00,895695,Choi; Bailey Miyeon,20,0,30,10
1745817626573,EDS 250,A00,895697,Hemans; Patricia Ann Benitez,43,0,45,2
1745817627600,EDS 281,A00,895701,Meyerott; Theresa Ann,15,0,15,0
1745817628626,EDS 284,A00,895736,Meyerott; Theresa Ann,15,0,15,0
1745817629656,EDS 286,A00,897210,Fine; Sarah,15,0,15,0
1745817630705,EDS 289C,A01,895770,Daly; Alan J.,15,0,15,0
1745817631731,EDS 290,A00,897211,Hofstetter; Carolyn,15,0,15,0
1745817632757,LIGM 5A,A00,896162,Fischer-Grunski; Eva K,15,0,20,5
1745817633781,LIGM 5B,A00,896260,Fischer-Grunski; Eva K,17,0,20,3
1745817634809,LIGM 5C,A00,896308,Fischer-Grunski; Eva K,18,0,20,2
1745817635833,LIIT 5AS,A00,896313,Carnelos; Chiara,18,0,20,2
1745817636857,LIIT 5BS,A00,896416,Carnelos; Chiara,20,0,20,0
1745817637882,LIIT 5CS,A00,896564,Carnelos; Chiara,20,0,20,0
1745817638907,LISP 5A,A00,896588,Munoz Sanchez; Alicia,4,0,20,16
1745817639934,LISP 5B,A00,896653,Munoz Sanchez; Alicia,10,0,20,10
1745817640965,LISP 5C,A00,896655,Munoz Sanchez; Alicia,4,0,20,16
1745817641989,MAE 197,001,957918,Kleissl; Jan,9998,0,9999,1
1745817643016,MATH 2,A01,957937,Staff,34,0,35,1
1745817644041,MATH 197,001,957876,Kedlaya; Kiran S.,9993,0,9999,6
1745817645066,MCWP 40,A00,892729,Duru; Nur,13,0,20,7
1745817645066,MCWP 40,B00,893304,Montejo; Carolina,20,0,20,0
1745817646092,MCWP 40R,A00,893757,Redela; Pamela Morgan,0,7,20,20
1745817647123,MCWP 50,A00,893758,Morshed; Michael James,2,0,20,18
1745817647123,MCWP 50,B00,893761,Bartulis; Jason Michael,17,0,20,3
1745817648149,MCWP 50R,A00,893766,Compas; Sean Matthew,0,1,20,20
1745817648149,MCWP 50R,B00,893769,Carter; Jennifer A,0,0,20,20
1745817648149,MCWP 50R,C00,893771,Krone; Jarret,0,3,20,20
1745817648149,MCWP 50R,D00,893772,Miller; Elizabeth Deen,3,0,20,17
1745817648149,MCWP 50R,E00,893775,Carter; Andrea L,0,0,20,20
1745817649176,MMW 11R,A01,892721,Herbst; Matthew,11,0,27,16
1745817649176,MMW 11R,A02,892722,Herbst; Matthew,0,0,0,3
1745817650204,MMW 12R,A01,892724,Herbst; Matthew,0,10,16,16
1745817650204,MMW 12R,A02,892725,Herbst; Matthew,0,9,16,16
1745817651231,MMW 13R,A01,892727,Staff,0,3,16,16
1745817651231,MMW 13R,A02,892728,Staff,0,4,16,16
1745817651231,MMW 13R,A03,958032,Staff,0,3,16,16
1745817651231,MMW 13R,A04,958033,Staff,0,2,16,16
1745817651231,MMW 13R,A05,958034,Staff,0,3,16,16
1745817652258,SIO 295LS,A00,894015,Staff,7,0,25,18
1745817653285,SIO 295S,A00,894020,Staff,7,0,25,18
1745817654313,SIOC 290S,B01,958918,Staff,0,0,0,0
1745817655345,SIOC 291S,B01,958922,Staff,0,0,0,0
1745817656374,SOCI 117,A01,895339,Staff,4,0,5,1
1745817657404,WES 237B,A00,894149,Staff,11,0,20,9
1745817659468,AESE 279B,A00,891859,Staff,13,0,35,22
1745817660491,AIP 197,001,891854,Staff,70,0,70,0
1745817661537,ANTH 289S,A00,891856,Gagneux; Pascal,12,0,12,0
1745817662563,BENG 196,001,957946,Engler; Adam J.,9996,0,9999,3
1745817663588,CAT 124RS,A01,956906,Staff,8,0,25,17
1745817664618,CAT 125RS,A01,922013,Staff,8,0,25,17
1745817665647,CLRE 250,A00,891860,Morris; Sheldon,9995,0,9999,4
1745817667702,CLRE 251R,A00,907817,Mehta; Ravindra L.,9994,0,9999,5
1745817668728,CLRE 252,A00,891864,Cuomo; Raphael Eduardo,9993,0,9999,6
1745817669757,CLRE 253,A00,891867,Vaida; Florin,9994,0,9999,5
1745817669757,CLRE 253,B00,907819,Staff,9999,0,9999,0
1745817670785,CLRE 259,A00,891868,Patel; Hemal,9998,0,9999,1
1745817671811,CLRE 260,A00,891872,Cuomo; Raphael Eduardo,9999,0,9999,0
1745817672839,CLRE 297,001,891888,Cuomo; Raphael Eduardo,9999,0,9999,0
1745817673863,CSE 191,A00,958773,Minnes Kemp; Mor Mia,9999,0,9999,0
1745817674890,CSS 201S,A01,892054,Mignozzetti; Umberto,30,0,30,0
1745817675917,CSS 202S,A01,892056,Mignozzetti; Umberto,30,0,30,0
1745817676941,DSC 197,001,956898,Eldridge; Justin Matthew,9998,0,9999,1
1745817677966,DSC 297,001,958000,Mazumdar; Arya,9998,0,9999,1
1745817678992,EAP 100,A00,905686,Staff,9776,0,9999,223
1745817680019,ECE 45,A01,892618,Staff,0,12,50,50
1745817681047,ECE 109,A01,892620,Staff,0,43,0,0
1745817682073,ECE 111,A01,892719,Staff,0,9,50,50
1745817683099,ECE 197,001,957920,Mercier; Patrick Philip,9992,0,9999,7
1745817684125,ECON 178,A01,907814,Zhu; Ying,28,0,35,7
1745817685150,EDS 115,A00,895312,Staff,41,0,45,4
1745817686178,EDS 117,A01,895337,Staff,30,0,30,0
1745817687207,EDS 125,A00,895341,Jones; Gabrielle Anastasia,43,0,45,2
1745817688249,EDS 128A,A01,895459,Fargason; Sharon Gayle,44,0,45,1
1745817689280,EDS 128B,A01,895543,Pappas; Elizabeth,44,0,45,1
1745817690310,EDS 139,A00,897203,Pappas; Elizabeth,44,0,45,1
1745817690310,EDS 139,B00,897209,Fargason; Sharon Gayle,44,0,45,1
1745817691336,EDS 201,A00,895545,Staff,43,0,45,2
1745817692367,EDS 203,A01,895581,Halter; Christopher P.,43,0,45,2
1745817693395,EDS 204R,A01,895625,Heinzman; Erica M.,43,0,45,2
1745817693395,EDS 204R,B01,895693,Halter; Christopher P.,18,0,45,27
1745817694425,EDS 206R,A00,895694,Fargason; Sharon Gayle,9,0,30,21
1745817694425,EDS 206R,B00,895695,Choi; Bailey Miyeon,20,0,30,10
1745817695452,EDS 250,A00,895697,Hemans; Patricia Ann Benitez,43,0,45,2
1745817696480,EDS 281,A00,895701,Meyerott; Theresa Ann,15,0,15,0
1745817697507,EDS 284,A00,895736,Meyerott; Theresa Ann,15,0,15,0
1745817698532,EDS 286,A00,897210,Fine; Sarah,15,0,15,0
1745817699561,EDS 289C,A01,895770,Daly; Alan J.,15,0,15,0
1745817700587,EDS 290,A00,897211,Hofstetter; Carolyn,15,0,15,0
1745817701614,LIGM 5A,A00,896162,Fischer-Grunski; Eva K,15,0,20,5
1745817702640,LIGM 5B,A00,896260,Fischer-Grunski; Eva K,17,0,20,3
1745817703665,LIGM 5C,A00,896308,Fischer-Grunski; Eva K,18,0,20,2
1745817704692,LIIT 5AS,A00,896313,Carnelos; Chiara,18,0,20,2
1745817705719,LIIT 5BS,A00,896416,Carnelos; Chiara,20,0,20,0
1745817706743,LIIT 5CS,A00,896564,Carnelos; Chiara,20,0,20,0
1745817707772,LISP 5A,A00,896588,Munoz Sanchez; Alicia,4,0,20,16
1745817708801,LISP 5B,A00,896653,Munoz Sanchez; Alicia,10,0,20,10
1745817709826,LISP 5C,A00,896655,Munoz Sanchez; Alicia,4,0,20,16
1745817710855,MAE 197,001,957918,Kleissl; Jan,9998,0,9999,1
1745817711879,MATH 2,A01,957937,Staff,34,0,35,1
1745817712907,MATH 197,001,957876,Kedlaya; Kiran S.,9993,0,9999,6
1745817713936,MCWP 40,A00,892729,Duru; Nur,13,0,20,7
1745817713936,MCWP 40,B00,893304,Montejo; Carolina,20,0,20,0
1745817714964,MCWP 40R,A00,893757,Redela; Pamela Morgan,0,7,20,20
1745817715992,MCWP 50,A00,893758,Morshed; Michael James,2,0,20,18
1745817715992,MCWP 50,B00,893761,Bartulis; Jason Michael,17,0,20,3
1745817717018,MCWP 50R,A00,893766,Compas; Sean Matthew,0,1,20,20
1745817717018,MCWP 50R,B00,893769,Carter; Jennifer A,0,0,20,20
1745817717018,MCWP 50R,C00,893771,Krone; Jarret,0,3,20,20
1745817717018,MCWP 50R,D00,893772,Miller; Elizabeth Deen,3,0,20,17
1745817717018,MCWP 50R,E00,893775,Carter; Andrea L,0,0,20,20
1745817718046,MMW 11R,A01,892721,Herbst; Matthew,11,0,27,16
1745817718046,MMW 11R,A02,892722,Herbst; Matthew,0,0,0,3
1745817719071,MMW 12R,A01,892724,Herbst; Matthew,0,10,16,16
1745817719071,MMW 12R,A02,892725,Herbst; Matthew,0,9,16,16
1745817720095,MMW 13R,A01,892727,Staff,0,3,16,16
1745817720095,MMW 13R,A02,892728,Staff,0,4,16,16
1745817720095,MMW 13R,A03,958032,Staff,0,3,16,16
1745817720095,MMW 13R,A04,958033,Staff,0,2,16,16
1745817720095,MMW 13R,A05,958034,Staff,0,3,16,16
1745817721122,SIO 295LS,A00,894015,Staff,7,0,25,18
1745817722146,SIO 295S,A00,894020,Staff,7,0,25,18
1745817723176,SIOC 290S,B01,958918,Staff,0,0,0,0
1745817724202,SIOC 291S,B01,958922,Staff,0,0,0,0
1745817725229,SOCI 117,A01,895339,Staff,4,0,5,1
1745817726257,WES 237B,A00,894149,Staff,11,0,20,9
1745817728324,AESE 279B,A00,891859,Staff,13,0,35,22
1745817729352,AIP 197,001,891854,Staff,70,0,70,0
1745817730380,ANTH 289S,A00,891856,Gagneux; Pascal,12,0,12,0
1745817731406,BENG 196,001,957946,Engler; Adam J.,9996,0,9999,3
1745817732433,CAT 124RS,A01,956906,Staff,8,0,25,17
1745817733460,CAT 125RS,A01,922013,Staff,8,0,25,17
1745817734490,CLRE 250,A00,891860,Morris; Sheldon,9995,0,9999,4
1745817736542,CLRE 251R,A00,907817,Mehta; Ravindra L.,9994,0,9999,5
1745817737570,CLRE 252,A00,891864,Cuomo; Raphael Eduardo,9993,0,9999,6
1745817738597,CLRE 253,A00,891867,Vaida; Florin,9994,0,9999,5
1745817738597,CLRE 253,B00,907819,Staff,9999,0,9999,0
1745817739624,CLRE 259,A00,891868,Patel; Hemal,9998,0,9999,1
1745817740650,CLRE 260,A00,891872,Cuomo; Raphael Eduardo,9999,0,9999,0
1745817741678,CLRE 297,001,891888,Cuomo; Raphael Eduardo,9999,0,9999,0
1745817742703,CSE 191,A00,958773,Minnes Kemp; Mor Mia,9999,0,9999,0
1745817743728,CSS 201S,A01,892054,Mignozzetti; Umberto,30,0,30,0
1745817744753,CSS 202S,A01,892056,Mignozzetti; Umberto,30,0,30,0
1745817745781,DSC 197,001,956898,Eldridge; Justin Matthew,9998,0,9999,1
1745817746809,DSC 297,001,958000,Mazumdar; Arya,9998,0,9999,1
1745817747834,EAP 100,A00,905686,Staff,9776,0,9999,223
1745817748859,ECE 45,A01,892618,Staff,0,12,50,50
1745817749885,ECE 109,A01,892620,Staff,0,43,0,0
1745817750916,ECE 111,A01,892719,Staff,0,9,50,50
1745817751945,ECE 197,001,957920,Mercier; Patrick Philip,9992,0,9999,7
1745817752976,ECON 178,A01,907814,Zhu; Ying,28,0,35,7
1745817754001,EDS 115,A00,895312,Staff,41,0,45,4
1745817755029,EDS 117,A01,895337,Staff,30,0,30,0
1745817756054,EDS 125,A00,895341,Jones; Gabrielle Anastasia,43,0,45,2
1745817757083,EDS 128A,A01,895459,Fargason; Sharon Gayle,44,0,45,1
1745817758128,EDS 128B,A01,895543,Pappas; Elizabeth,44,0,45,1
1745817759153,EDS 139,A00,897203,Pappas; Elizabeth,44,0,45,1
1745817759153,EDS 139,B00,897209,Fargason; Sharon Gayle,44,0,45,1
1745817760177,EDS 201,A00,895545,Staff,43,0,45,2
1745817761204,EDS 203,A01,895581,Halter; Christopher P.,43,0,45,2
1745817762231,EDS 204R,A01,895625,Heinzman; Erica M.,43,0,45,2
1745817762231,EDS 204R,B01,895693,Halter; Christopher P.,18,0,45,27
1745817763258,EDS 206R,A00,895694,Fargason; Sharon Gayle,9,0,30,21
1745817763258,EDS 206R,B00,895695,Choi; Bailey Miyeon,20,0,30,10
1745817764287,EDS 250,A00,895697,Hemans; Patricia Ann Benitez,43,0,45,2
1745817765311,EDS 281,A00,895701,Meyerott; Theresa Ann,15,0,15,0
1745817766336,EDS 284,A00,895736,Meyerott; Theresa Ann,15,0,15,0
1745817767360,EDS 286,A00,897210,Fine; Sarah,15,0,15,0
1745817768386,EDS 289C,A01,895770,Daly; Alan J.,15,0,15,0
1745817769410,EDS 290,A00,897211,Hofstetter; Carolyn,15,0,15,0
1745817770438,LIGM 5A,A00,896162,Fischer-Grunski; Eva K,15,0,20,5
1745817771462,LIGM 5B,A00,896260,Fischer-Grunski; Eva K,17,0,20,3
1745817772488,LIGM 5C,A00,896308,Fischer-Grunski; Eva K,18,0,20,2
1745817773514,LIIT 5AS,A00,896313,Carnelos; Chiara,18,0,20,2
1745817774537,LIIT 5BS,A00,896416,Carnelos; Chiara,20,0,20,0
1745817775563,LIIT 5CS,A00,896564,Carnelos; Chiara,20,0,20,0
1745817776589,LISP 5A,A00,896588,Munoz Sanchez; Alicia,4,0,20,16
1745817777617,LISP 5B,A00,896653,Munoz Sanchez; Alicia,10,0,20,10
1745817778643,LISP 5C,A00,896655,Munoz Sanchez; Alicia,4,0,20,16
1745817779668,MAE 197,001,957918,Kleissl; Jan,9998,0,9999,1
1745817780694,MATH 2,A01,957937,Staff,34,0,35,1
1745817781720,MATH 197,001,957876,Kedlaya; Kiran S.,9993,0,9999,6
1745817782748,MCWP 40,A00,892729,Duru; Nur,13,0,20,7
1745817782748,MCWP 40,B00,893304,Montejo; Carolina,20,0,20,0
1745817783776,MCWP 40R,A00,893757,Redela; Pamela Morgan,0,7,20,20
1745817784802,MCWP 50,A00,893758,Morshed; Michael James,2,0,20,18
1745817784802,MCWP 50,B00,893761,Bartulis; Jason Michael,17,0,20,3
1745817785827,MCWP 50R,A00,893766,Compas; Sean Matthew,0,1,20,20
1745817785827,MCWP 50R,B00,893769,Carter; Jennifer A,0,0,20,20
1745817785827,MCWP 50R,C00,893771,Krone; Jarret,0,3,20,20
1745817785827,MCWP 50R,D00,893772,Miller; Elizabeth Deen,3,0,20,17
1745817785827,MCWP 50R,E00,893775,Carter; Andrea L,0,0,20,20
1745817786857,MMW 11R,A01,892721,Herbst; Matthew,11,0,27,16
1745817786857,MMW 11R,A02,892722,Herbst; Matthew,0,0,0,3
1745817787883,MMW 12R,A01,892724,Herbst; Matthew,0,10,16,16
1745817787883,MMW 12R,A02,892725,Herbst; Matthew,0,9,16,16
1745817788932,MMW 13R,A01,892727,Staff,0,3,16,16
1745817788932,MMW 13R,A02,892728,Staff,0,4,16,16
1745817788932,MMW 13R,A03,958032,Staff,0,3,16,16
1745817788932,MMW 13R,A04,958033,Staff,0,2,16,16
1745817788932,MMW 13R,A05,958034,Staff,0,3,16,16
1745817789958,SIO 295LS,A00,894015,Staff,7,0,25,18
1745817790984,SIO 295S,A00,894020,Staff,7,0,25,18
1745817792009,SIOC 290S,B01,958918,Staff,0,0,0,0
1745817793037,SIOC 291S,B01,958922,Staff,0,0,0,0
1745817794062,SOCI 117,A01,895339,Staff,4,0,5,1
1745817795088,WES 237B,A00,894149,Staff,11,0,20,9
1745817797148,AESE 279B,A00,891859,Staff,13,0,35,22
1745817798172,AIP 197,001,891854,Staff,70,0,70,0
1745817799201,ANTH 289S,A00,891856,Gagneux; Pascal,12,0,12,0
1745817800226,BENG 196,001,957946,Engler; Adam J.,9996,0,9999,3
1745817801251,CAT 124RS,A01,956906,Staff,8,0,25,17
1745817802281,CAT 125RS,A01,922013,Staff,8,0,25,17
1745817803316,CLRE 250,A00,891860,Morris; Sheldon,9995,0,9999,4
1745817805369,CLRE 251R,A00,907817,Mehta; Ravindra L.,9994,0,9999,5
1745817806394,CLRE 252,A00,891864,Cuomo; Raphael Eduardo,9993,0,9999,6
1745817807421,CLRE 253,A00,891867,Vaida; Florin,9994,0,9999,5
1745817807421,CLRE 253,B00,907819,Staff,9999,0,9999,0
1745817808445,CLRE 259,A00,891868,Patel; Hemal,9998,0,9999,1
1745817809470,CLRE 260,A00,891872,Cuomo; Raphael Eduardo,9999,0,9999,0
1745817810495,CLRE 297,001,891888,Cuomo; Raphael Eduardo,9999,0,9999,0
1745817811518,CSE 191,A00,958773,Minnes Kemp; Mor Mia,9999,0,9999,0
1745817812546,CSS 201S,A01,892054,Mignozzetti; Umberto,30,0,30,0
1745817813570,CSS 202S,A01,892056,Mignozzetti; Umberto,30,0,30,0
1745817814599,DSC 197,001,956898,Eldridge; Justin Matthew,9998,0,9999,1
1745817815627,DSC 297,001,958000,Mazumdar; Arya,9998,0,9999,1
1745817816652,EAP 100,A00,905686,Staff,9776,0,9999,223
1745817817676,ECE 45,A01,892618,Staff,0,12,50,50
1745817818706,ECE 109,A01,892620,Staff,0,43,0,0
1745817819733,ECE 111,A01,892719,Staff,0,9,50,50
1745817820757,ECE 197,001,957920,Mercier; Patrick Philip,9992,0,9999,7
1745817821788,ECON 178,A01,907814,Zhu; Ying,28,0,35,7
1745817822812,EDS 115,A00,895312,Staff,41,0,45,4
1745817823837,EDS 117,A01,895337,Staff,30,0,30,0
1745817824864,EDS 125,A00,895341,Jones; Gabrielle Anastasia,43,0,45,2
1745817825893,EDS 128A,A01,895459,Fargason; Sharon Gayle,44,0,45,1
1745817826922,EDS 128B,A01,895543,Pappas; Elizabeth,44,0,45,1
1745817827950,EDS 139,A00,897203,Pappas; Elizabeth,44,0,45,1
1745817827950,EDS 139,B00,897209,Fargason; Sharon Gayle,44,0,45,1
1745817828976,EDS 201,A00,895545,Staff,43,0,45,2
1745817830026,EDS 203,A01,895581,Halter; Christopher P.,43,0,45,2
1745817831054,EDS 204R,A01,895625,Heinzman; Erica M.,43,0,45,2
1745817831054,EDS 204R,B01,895693,Halter; Christopher P.,18,0,45,27
1745817832079,EDS 206R,A00,895694,Fargason; Sharon Gayle,9,0,30,21
1745817832079,EDS 206R,B00,895695,Choi; Bailey Miyeon,20,0,30,10
1745817833107,EDS 250,A00,895697,Hemans; Patricia Ann Benitez,43,0,45,2
1745817834134,EDS 281,A00,895701,Meyerott; Theresa Ann,15,0,15,0
1745817835158,EDS 284,A00,895736,Meyerott; Theresa Ann,15,0,15,0
1745817836182,EDS 286,A00,897210,Fine; Sarah,15,0,15,0
1745817837208,EDS 289C,A01,895770,Daly; Alan J.,15,0,15,0
1745817838236,EDS 290,A00,897211,Hofstetter; Carolyn,15,0,15,0
1745817839282,LIGM 5A,A00,896162,Fischer-Grunski; Eva K,15,0,20,5
1745817840308,LIGM 5B,A00,896260,Fischer-Grunski; Eva K,17,0,20,3
1745817841334,LIGM 5C,A00,896308,Fischer-Grunski; Eva K,18,0,20,2
1745817842359,LIIT 5AS,A00,896313,Carnelos; Chiara,18,0,20,2
1745817843392,LIIT 5BS,A00,896416,Carnelos; Chiara,20,0,20,0
1745817844421,LIIT 5CS,A00,896564,Carnelos; Chiara,20,0,20,0
1745817845449,LISP 5A,A00,896588,Munoz Sanchez; Alicia,4,0,20,16
1745817846476,LISP 5B,A00,896653,Munoz Sanchez; Alicia,10,0,20,10
1745817847504,LISP 5C,A00,896655,Munoz Sanchez; Alicia,4,0,20,16
1745817848530,MAE 197,001,957918,Kleissl; Jan,9998,0,9999,1
1745817849555,MATH 2,A01,957937,Staff,34,0,35,1
1745817850581,MATH 197,001,957876,Kedlaya; Kiran S.,9993,0,9999,6
1745817851608,MCWP 40,A00,892729,Duru; Nur,13,0,20,7
1745817851608,MCWP 40,B00,893304,Montejo; Carolina,20,0,20,0
1745817852635,MCWP 40R,A00,893757,Redela; Pamela Morgan,0,7,20,20
1745817853665,MCWP 50,A00,893758,Morshed; Michael James,2,0,20,18
1745817853665,MCWP 50,B00,893761,Bartulis; Jason Michael,17,0,20,3
1745817854694,MCWP 50R,A00,893766,Compas; Sean Matthew,0,1,20,20
1745817854694,MCWP 50R,B00,893769,Carter; Jennifer A,0,0,20,20
1745817854694,MCWP 50R,C00,893771,Krone; Jarret,0,3,20,20
1745817854694,MCWP 50R,D00,893772,Miller; Elizabeth Deen,3,0,20,17
1745817854694,MCWP 50R,E00,893775,Carter; Andrea L,0,0,20,20
1745817855723,MMW 11R,A01,892721,Herbst; Matthew,11,0,27,16
1745817855723,MMW 11R,A02,892722,Herbst; Matthew,0,0,0,3
1745817856752,MMW 12R,A01,892724,Herbst; Matthew,0,10,16,16
1745817856752,MMW 12R,A02,892725,Herbst; Matthew,0,9,16,16
1745817857778,MMW 13R,A01,892727,Staff,0,3,16,16
1745817857778,MMW 13R,A02,892728,Staff,0,4,16,16
1745817857778,MMW 13R,A03,958032,Staff,0,3,16,16
1745817857778,MMW 13R,A04,958033,Staff,0,2,16,16
1745817857778,MMW 13R,A05,958034,Staff,0,3,16,16
1745817858802,SIO 295LS,A00,894015,Staff,7,0,25,18
1745817859828,SIO 295S,A00,894020,Staff,7,0,25,18
1745817860859,SIOC 290S,B01,958918,Staff,0,0,0,0
1745817861885,SIOC 291S,B01,958922,Staff,0,0,0,0
1745817862912,SOCI 117,A01,895339,Staff,4,0,5,1
1745817863940,WES 237B,A00,894149,Staff,11,0,20,9
1745817865997,AESE 279B,A00,891859,Staff,13,0,35,22
1745817867022,AIP 197,001,891854,Staff,70,0,70,0
1745817868049,ANTH 289S,A00,891856,Gagneux; Pascal,12,0,12,0
1745817869076,BENG 196,001,957946,Engler; Adam J.,9996,0,9999,3
1745817870102,CAT 124RS,A01,956906,Staff,8,0,25,17
1745817871131,CAT 125RS,A01,922013,Staff,8,0,25,17
1745817872159,CLRE 250,A00,891860,Morris; Sheldon,9995,0,9999,4
1745817874214,CLRE 251R,A00,907817,Mehta; Ravindra L.,9994,0,9999,5
1745817875240,CLRE 252,A00,891864,Cuomo; Raphael Eduardo,9993,0,9999,6
1745817876266,CLRE 253,A00,891867,Vaida; Florin,9994,0,9999,5
1745817876266,CLRE 253,B00,907819,Staff,9999,0,9999,0
1745817877293,CLRE 259,A00,891868,Patel; Hemal,9998,0,9999,1
1745817878319,CLRE 260,A00,891872,Cuomo; Raphael Eduardo,9999,0,9999,0
1745817879346,CLRE 297,001,891888,Cuomo; Raphael Eduardo,9999,0,9999,0
1745817880373,CSE 191,A00,958773,Minnes Kemp; Mor Mia,9999,0,9999,0
1745817881400,CSS 201S,A01,892054,Mignozzetti; Umberto,30,0,30,0
1745817882426,CSS 202S,A01,892056,Mignozzetti; Umberto,30,0,30,0
1745817883450,DSC 197,001,956898,Eldridge; Justin Matthew,9998,0,9999,1
1745817884481,DSC 297,001,958000,Mazumdar; Arya,9998,0,9999,1
1745817885507,EAP 100,A00,905686,Staff,9776,0,9999,223
1745817886535,ECE 45,A01,892618,Staff,0,12,50,50
1745817887562,ECE 109,A01,892620,Staff,0,43,0,0
1745817888590,ECE 111,A01,892719,Staff,0,9,50,50
1745817889618,ECE 197,001,957920,Mercier; Patrick Philip,9992,0,9999,7
1745817890645,ECON 178,A01,907814,Zhu; Ying,28,0,35,7
1745817891672,EDS 115,A00,895312,Staff,41,0,45,4
1745817892701,EDS 117,A01,895337,Staff,30,0,30,0
1745817893729,EDS 125,A00,895341,Jones; Gabrielle Anastasia,43,0,45,2
1745817894754,EDS 128A,A01,895459,Fargason; Sharon Gayle,44,0,45,1
1745817895780,EDS 128B,A01,895543,Pappas; Elizabeth,44,0,45,1
1745817896809,EDS 139,A00,897203,Pappas; Elizabeth,44,0,45,1
1745817896809,EDS 139,B00,897209,Fargason; Sharon Gayle,44,0,45,1
1745817897835,EDS 201,A00,895545,Staff,43,0,45,2
1745817898861,EDS 203,A01,895581,Halter; Christopher P.,43,0,45,2
1745817899891,EDS 204R,A01,895625,Heinzman; Erica M.,43,0,45,2
1745817899891,EDS 204R,B01,895693,Halter; Christopher P.,18,0,45,27
1745817900918,EDS 206R,A00,895694,Fargason; Sharon Gayle,9,0,30,21
1745817900918,EDS 206R,B00,895695,Choi; Bailey Miyeon,20,0,30,10
1745817901949,EDS 250,A00,895697,Hemans; Patricia Ann Benitez,43,0,45,2
1745817902977,EDS 281,A00,895701,Meyerott; Theresa Ann,15,0,15,0
1745817904002,EDS 284,A00,895736,Meyerott; Theresa Ann,15,0,15,0
1745817905041,EDS 286,A00,897210,Fine; Sarah,15,0,15,0
1745817906069,EDS 289C,A01,895770,Daly; Alan J.,15,0,15,0
1745817907099,EDS 290,A00,897211,Hofstetter; Carolyn,15,0,15,0
1745817908126,LIGM 5A,A00,896162,Fischer-Grunski; Eva K,15,0,20,5
1745817909153,LIGM 5B,A00,896260,Fischer-Grunski; Eva K,17,0,20,3
1745817910181,LIGM 5C,A00,896308,Fischer-Grunski; Eva K,18,0,20,2
1745817911212,LIIT 5AS,A00,896313,Carnelos; Chiara,18,0,20,2
1745817912238,LIIT 5BS,A00,896416,Carnelos; Chiara,20,0,20,0
1745817913263,LIIT 5CS,A00,896564,Carnelos; Chiara,20,0,20,0
1745817914290,LISP 5A,A00,896588,Munoz Sanchez; Alicia,4,0,20,16
1745817915317,LISP 5B,A00,896653,Munoz Sanchez; Alicia,10,0,20,10
1745817916346,LISP 5C,A00,896655,Munoz Sanchez; Alicia,4,0,20,16
1745817917373,MAE 197,001,957918,Kleissl; Jan,9998,0,9999,1
1745817918399,MATH 2,A01,957937,Staff,34,0,35,1
1745817919427,MATH 197,001,957876,Kedlaya; Kiran S.,9993,0,9999,6
1745817920454,MCWP 40,A00,892729,Duru; Nur,13,0,20,7
1745817920454,MCWP 40,B00,893304,Montejo; Carolina,20,0,20,0
1745817921481,MCWP 40R,A00,893757,Redela; Pamela Morgan,0,7,20,20
1745817922509,MCWP 50,A00,893758,Morshed; Michael James,2,0,20,18
1745817922509,MCWP 50,B00,893761,Bartulis; Jason Michael,17,0,20,3
1745817923538,MCWP 50R,A00,893766,Compas; Sean Matthew,0,1,20,20
1745817923538,MCWP 50R,B00,893769,Carter; Jennifer A,0,0,20,20
1745817923538,MCWP 50R,C00,893771,Krone; Jarret,0,3,20,20
1745817923538,MCWP 50R,D00,893772,Miller; Elizabeth Deen,3,0,20,17
1745817923538,MCWP 50R,E00,893775,Carter; Andrea L,0,0,20,20
1745817924563,MMW 11R,A01,892721,Herbst; Matthew,11,0,27,16
1745817924563,MMW 11R,A02,892722,Herbst; Matthew,0,0,0,3
1745817925587,MMW 12R,A01,892724,Herbst; Matthew,0,10,16,16
1745817925587,MMW 12R,A02,892725,Herbst; Matthew,0,9,16,16
1745817926614,MMW 13R,A01,892727,Staff,0,3,16,16
1745817926614,MMW 13R,A02,892728,Staff,0,4,16,16
1745817926614,MMW 13R,A03,958032,Staff,0,3,16,16
1745817926614,MMW 13R,A04,958033,Staff,0,2,16,16
1745817926614,MMW 13R,A05,958034,Staff,0,3,16,16
1745817927643,SIO 295LS,A00,894015,Staff,7,0,25,18
1745817928671,SIO 295S,A00,894020,Staff,7,0,25,18
1745817929697,SIOC 290S,B01,958918,Staff,0,0,0,0
1745817930726,SIOC 291S,B01,958922,Staff,0,0,0,0
1745817931753,SOCI 117,A01,895339,Staff,4,0,5,1
1745817932778,WES 237B,A00,894149,Staff,11,0,20,9
1745817934837,AESE 279B,A00,891859,Staff,13,0,35,22
1745817935861,AIP 197,001,891854,Staff,70,0,70,0
1745817936886,ANTH 289S,A00,891856,Gagneux; Pascal,12,0,12,0
1745817937912,BENG 196,001,957946,Engler; Adam J.,9996,0,9999,3
1745817938940,CAT 124RS,A01,956906,Staff,8,0,25,17
1745817939969,CAT 125RS,A01,922013,Staff,8,0,25,17
1745817940994,CLRE 250,A00,891860,Morris; Sheldon,9995,0,9999,4
1745817943049,CLRE 251R,A00,907817,Mehta; Ravindra L.,9994,0,9999,5
1745817944075,CLRE 252,A00,891864,Cuomo; Raphael Eduardo,9993,0,9999,6
1745817945101,CLRE 253,A00,891867,Vaida; Florin,9994,0,9999,5
1745817945101,CLRE 253,B00,907819,Staff,9999,0,9999,0
1745817946129,CLRE 259,A00,891868,Patel; Hemal,9998,0,9999,1
1745817947156,CLRE 260,A00,891872,Cuomo; Raphael Eduardo,9999,0,9999,0
1745817948181,CLRE 297,001,891888,Cuomo; Raphael Eduardo,9999,0,9999,0
1745817949207,CSE 191,A00,958773,Minnes Kemp; Mor Mia,9999,0,9999,0
1745817950233,CSS 201S,A01,892054,Mignozzetti; Umberto,30,0,30,0
1745817951260,CSS 202S,A01,892056,Mignozzetti; Umberto,30,0,30,0
1745817952286,DSC 197,001,956898,Eldridge; Justin Matthew,9998,0,9999,1
1745817953311,DSC 297,001,958000,Mazumdar; Arya,9998,0,9999,1
1745817954336,EAP 100,A00,905686,Staff,9776,0,9999,223
1745817955365,ECE 45,A01,892618,Staff,0,12,50,50
1745817956389,ECE 109,A01,892620,Staff,0,43,0,0
1745817957415,ECE 111,A01,892719,Staff,0,9,50,50
1745817958440,ECE 197,001,957920,Mercier; Patrick Philip,9992,0,9999,7
1745817959470,ECON 178,A01,907814,Zhu; Ying,28,0,35,7
1745817960497,EDS 115,A00,895312,Staff,41,0,45,4
1745817961523,EDS 117,A01,895337,Staff,30,0,30,0
1745817962549,EDS 125,A00,895341,Jones; Gabrielle Anastasia,43,0,45,2
1745817963575,EDS 128A,A01,895459,Fargason; Sharon Gayle,44,0,45,1
1745817964605,EDS 128B,A01,895543,Pappas; Elizabeth,44,0,45,1
1745817965630,EDS 139,A00,897203,Pappas; Elizabeth,44,0,45,1
1745817965630,EDS 139,B00,897209,Fargason; Sharon Gayle,44,0,45,1
1745817966658,EDS 201,A00,895545,Staff,43,0,45,2
1745817967684,EDS 203,A01,895581,Halter; Christopher P.,43,0,45,2
1745817968709,EDS 204R,A01,895625,Heinzman; Erica M.,43,0,45,2
1745817968709,EDS 204R,B01,895693,Halter; Christopher P.,18,0,45,27
1745817969735,EDS 206R,A00,895694,Fargason; Sharon Gayle,9,0,30,21
1745817969735,EDS 206R,B00,895695,Choi; Bailey Miyeon,20,0,30,10
1745817970761,EDS 250,A00,895697,Hemans; Patricia Ann Benitez,43,0,45,2
1745817971786,EDS 281,A00,895701,Meyerott; Theresa Ann,15,0,15,0
1745817972810,EDS 284,A00,895736,Meyerott; Theresa Ann,15,0,15,0
1745817973839,EDS 286,A00,897210,Fine; Sarah,15,0,15,0
1745817974866,EDS 289C,A01,895770,Daly; Alan J.,15,0,15,0
1745817975891,EDS 290,A00,897211,Hofstetter; Carolyn,15,0,15,0
1745817976920,LIGM 5A,A00,896162,Fischer-Grunski; Eva K,15,0,20,5
1745817977949,LIGM 5B,A00,896260,Fischer-Grunski; Eva K,17,0,20,3
1745817978977,LIGM 5C,A00,896308,Fischer-Grunski; Eva K,18,0,20,2
1745817980007,LIIT 5AS,A00,896313,Carnelos; Chiara,18,0,20,2
1745817981032,LIIT 5BS,A00,896416,Carnelos; Chiara,20,0,20,0
1745817982058,LIIT 5CS,A00,896564,Carnelos; Chiara,20,0,20,0
1745817983087,LISP 5A,A00,896588,Munoz Sanchez; Alicia,4,0,20,16
1745817984112,LISP 5B,A00,896653,Munoz Sanchez; Alicia,10,0,20,10
1745817985138,LISP 5C,A00,896655,Munoz Sanchez; Alicia,4,0,20,16
1745817986166,MAE 197,001,957918,Kleissl; Jan,9998,0,9999,1
1745817987195,MATH 2,A01,957937,Staff,34,0,35,1
1745817988219,MATH 197,001,957876,Kedlaya; Kiran S.,9993,0,9999,6
1745817989245,MCWP 40,A00,892729,Duru; Nur,13,0,20,7
1745817989245,MCWP 40,B00,893304,Montejo; Carolina,20,0,20,0
1745817990269,MCWP 40R,A00,893757,Redela; Pamela Morgan,0,7,20,20
1745817991295,MCWP 50,A00,893758,Morshed; Michael James,2,0,20,18
1745817991295,MCWP 50,B00,893761,Bartulis; Jason Michael,17,0,20,3
1745817992322,MCWP 50R,A00,893766,Compas; Sean Matthew,0,1,20,20
1745817992322,MCWP 50R,B00,893769,Carter; Jennifer A,0,0,20,20
1745817992322,MCWP 50R,C00,893771,Krone; Jarret,0,3,20,20
1745817992322,MCWP 50R,D00,893772,Miller; Elizabeth Deen,3,0,20,17
1745817992322,MCWP 50R,E00,893775,Carter; Andrea L,0,0,20,20
1745817993348,MMW 11R,A01,892721,Herbst; Matthew,11,0,27,16
1745817993348,MMW 11R,A02,892722,Herbst; Matthew,0,0,0,3
1745817994374,MMW 12R,A01,892724,Herbst; Matthew,0,10,16,16
1745817994374,MMW 12R,A02,892725,Herbst; Matthew,0,9,16,16
1745817995401,MMW 13R,A01,892727,Staff,0,3,16,16
1745817995401,MMW 13R,A02,892728,Staff,0,4,16,16
1745817995401,MMW 13R,A03,958032,Staff,0,3,16,16
1745817995401,MMW 13R,A04,958033,Staff,0,2,16,16
1745817995401,MMW 13R,A05,958034,Staff,0,3,16,16
1745817996431,SIO 295LS,A00,894015,Staff,7,0,25,18
1745817997457,SIO 295S,A00,894020,Staff,7,0,25,18
1745817998482,SIOC 290S,B01,958918,Staff,0,0,0,0
1745817999508,SIOC 291S,B01,958922,Staff,0,0,0,0
1745818000573,SOCI 117,A01,895339,Staff,4,0,5,1
1745818001597,WES 237B,A00,894149,Staff,11,0,20,9
1745818003656,AESE 279B,A00,891859,Staff,13,0,35,22
1745818004681,AIP 197,001,891854,Staff,70,0,70,0
1745818005710,ANTH 289S,A00,891856,Gagneux; Pascal,12,0,12,0
1745818006734,BENG 196,001,957946,Engler; Adam J.,9996,0,9999,3
1745818007760,CAT 124RS,A01,956906,Staff,8,0,25,17
1745818008786,CAT 125RS,A01,922013,Staff,8,0,25,17
1745818009811,CLRE 250,A00,891860,Morris; Sheldon,9995,0,9999,4
1745818011867,CLRE 251R,A00,907817,Mehta; Ravindra L.,9994,0,9999,5
1745818012893,CLRE 252,A00,891864,Cuomo; Raphael Eduardo,9993,0,9999,6
1745818013918,CLRE 253,A00,891867,Vaida; Florin,9994,0,9999,5
1745818013918,CLRE 253,B00,907819,Staff,9999,0,9999,0
1745818014946,CLRE 259,A00,891868,Patel; Hemal,9998,0,9999,1
1745818015972,CLRE 260,A00,891872,Cuomo; Raphael Eduardo,9999,0,9999,0
1745818016998,CLRE 297,001,891888,Cuomo; Raphael Eduardo,9999,0,9999,0
1745818018022,CSE 191,A00,958773,Minnes Kemp; Mor Mia,9999,0,9999,0
1745818019048,CSS 201S,A01,892054,Mignozzetti; Umberto,30,0,30,0
1745818020073,CSS 202S,A01,892056,Mignozzetti; Umberto,30,0,30,0
1745818021099,DSC 197,001,956898,Eldridge; Justin Matthew,9998,0,9999,1
1745818022124,DSC 297,001,958000,Mazumdar; Arya,9998,0,9999,1
1745818023152,EAP 100,A00,905686,Staff,9776,0,9999,223
1745818024179,ECE 45,A01,892618,Staff,0,12,50,50
1745818025205,ECE 109,A01,892620,Staff,0,43,0,0
1745818026234,ECE 111,A01,892719,Staff,0,9,50,50
1745818027259,ECE 197,001,957920,Mercier; Patrick Philip,9992,0,9999,7
1745818028286,ECON 178,A01,907814,Zhu; Ying,28,0,35,7
1745818029311,EDS 115,A00,895312,Staff,41,0,45,4
1745818030339,EDS 117,A01,895337,Staff,30,0,30,0
1745818031367,EDS 125,A00,895341,Jones; Gabrielle Anastasia,43,0,45,2
1745818032393,EDS 128A,A01,895459,Fargason; Sharon Gayle,44,0,45,1
1745818033419,EDS 128B,A01,895543,Pappas; Elizabeth,44,0,45,1
1745818034445,EDS 139,A00,897203,Pappas; Elizabeth,44,0,45,1
1745818034445,EDS 139,B00,897209,Fargason; Sharon Gayle,44,0,45,1
1745818035473,EDS 201,A00,895545,Staff,43,0,45,2
1745818036498,EDS 203,A01,895581,Halter; Christopher P.,43,0,45,2
1745818037525,EDS 204R,A01,895625,Heinzman; Erica M.,43,0,45,2
1745818037525,EDS 204R,B01,895693,Halter; Christopher P.,18,0,45,27
1745818038552,EDS 206R,A00,895694,Fargason; Sharon Gayle,9,0,30,21
1745818038552,EDS 206R,B00,895695,Choi; Bailey Miyeon,20,0,30,10
1745818039577,EDS 250,A00,895697,Hemans; Patricia Ann Benitez,43,0,45,2
1745818040603,EDS 281,A00,895701,Meyerott; Theresa Ann,15,0,15,0
1745818041630,EDS 284,A00,895736,Meyerott; Theresa Ann,15,0,15,0
1745818042656,EDS 286,A00,897210,Fine; Sarah,15,0,15,0
1745818043681,EDS 289C,A01,895770,Daly; Alan J.,15,0,15,0
1745818044705,EDS 290,A00,897211,Hofstetter; Carolyn,15,0,15,0
1745818045733,LIGM 5A,A00,896162,Fischer-Grunski; Eva K,15,0,20,5
1745818046758,LIGM 5B,A00,896260,Fischer-Grunski; Eva K,17,0,20,3
1745818047787,LIGM 5C,A00,896308,Fischer-Grunski; Eva K,18,0,20,2
1745818048813,LIIT 5AS,A00,896313,Carnelos; Chiara,18,0,20,2
1745818049841,LIIT 5BS,A00,896416,Carnelos; Chiara,20,0,20,0
1745818050866,LIIT 5CS,A00,896564,Carnelos; Chiara,20,0,20,0
1745818051891,LISP 5A,A00,896588,Munoz Sanchez; Alicia,4,0,20,16
1745818052921,LISP 5B,A00,896653,Munoz Sanchez; Alicia,10,0,20,10
1745818053947,LISP 5C,A00,896655,Munoz Sanchez; Alicia,4,0,20,16
1745818054971,MAE 197,001,957918,Kleissl; Jan,9998,0,9999,1
1745818056000,MATH 2,A01,957937,Staff,34,0,35,1
1745818057024,MATH 197,001,957876,Kedlaya; Kiran S.,9993,0,9999,6
1745818058048,MCWP 40,A00,892729,Duru; Nur,13,0,20,7
1745818058048,MCWP 40,B00,893304,Montejo; Carolina,20,0,20,0
1745818059071,MCWP 40R,A00,893757,Redela; Pamela Morgan,0,7,20,20
1745818060097,MCWP 50,A00,893758,Morshed; Michael James,2,0,20,18
1745818060097,MCWP 50,B00,893761,Bartulis; Jason Michael,17,0,20,3
1745818061123,MCWP 50R,A00,893766,Compas; Sean Matthew,0,1,20,20
1745818061123,MCWP 50R,B00,893769,Carter; Jennifer A,0,0,20,20
1745818061123,MCWP 50R,C00,893771,Krone; Jarret,0,3,20,20
1745818061123,MCWP 50R,D00,893772,Miller; Elizabeth Deen,3,0,20,17
1745818061123,MCWP 50R,E00,893775,Carter; Andrea L,0,0,20,20
1745818062147,MMW 11R,A01,892721,Herbst; Matthew,11,0,27,16
1745818062147,MMW 11R,A02,892722,Herbst; Matthew,0,0,0,3
1745818063173,MMW 12R,A01,892724,Herbst; Matthew,0,10,16,16
1745818063173,MMW 12R,A02,892725,Herbst; Matthew,0,9,16,16
1745818064201,MMW 13R,A01,892727,Staff,0,3,16,16
1745818064201,MMW 13R,A02,892728,Staff,0,4,16,16
1745818064201,MMW 13R,A03,958032,Staff,0,3,16,16
1745818064201,MMW 13R,A04,958033,Staff,0,2,16,16
1745818064201,MMW 13R,A05,958034,Staff,0,3,16,16
1745818065228,SIO 295LS,A00,894015,Staff,7,0,25,18
1745818066256,SIO 295S,A00,894020,Staff,7,0,25,18
1745818067284,SIOC 290S,B01,958918,Staff,0,0,0,0
1745818068312,SIOC 291S,B01,958922,Staff,0,0,0,0
1745818069340,SOCI 117,A01,895339,Staff,4,0,5,1
1745818070366,WES 237B,A00,894149,Staff,11,0,20,9
1745818072430,AESE 279B,A00,891859,Staff,13,0,35,22
1745818073457,AIP 197,001,891854,Staff,70,0,70,0
1745818074483,ANTH 289S,A00,891856,Gagneux; Pascal,12,0,12,0
1745818075508,BENG 196,001,957946,Engler; Adam J.,9996,0,9999,3
1745818076534,CAT 124RS,A01,956906,Staff,8,0,25,17
1745818077559,CAT 125RS,A01,922013,Staff,8,0,25,17
1745818078583,CLRE 250,A00,891860,Morris; Sheldon,9995,0,9999,4
1745818080633,CLRE 251R,A00,907817,Mehta; Ravindra L.,9994,0,9999,5
1745818081659,CLRE 252,A00,891864,Cuomo; Raphael Eduardo,9993,0,9999,6
1745818082687,CLRE 253,A00,891867,Vaida; Florin,9994,0,9999,5
1745818082687,CLRE 253,B00,907819,Staff,9999,0,9999,0
1745818083714,CLRE 259,A00,891868,Patel; Hemal,9998,0,9999,1
1745818084739,CLRE 260,A00,891872,Cuomo; Raphael Eduardo,9999,0,9999,0
1745818085764,CLRE 297,001,891888,Cuomo; Raphael Eduardo,9999,0,9999,0
1745818086792,CSE 191,A00,958773,Minnes Kemp; Mor Mia,9999,0,9999,0
1745818087821,CSS 201S,A01,892054,Mignozzetti; Umberto,30,0,30,0
1745818088846,CSS 202S,A01,892056,Mignozzetti; Umberto,30,0,30,0
1745818089875,DSC 197,001,956898,Eldridge; Justin Matthew,9998,0,9999,1
1745818090903,DSC 297,001,958000,Mazumdar; Arya,9998,0,9999,1
1745818091928,EAP 100,A00,905686,Staff,9776,0,9999,223
1745818092953,ECE 45,A01,892618,Staff,0,12,50,50
1745818093978,ECE 109,A01,892620,Staff,0,43,0,0
1745818095003,ECE 111,A01,892719,Staff,0,9,50,50
1745818096030,ECE 197,001,957920,Mercier; Patrick Philip,9992,0,9999,7
1745818097057,ECON 178,A01,907814,Zhu; Ying,28,0,35,7
1745818098082,EDS 115,A00,895312,Staff,41,0,45,4
1745818099108,EDS 117,A01,895337,Staff,30,0,30,0
1745818100132,EDS 125,A00,895341,Jones; Gabrielle Anastasia,43,0,45,2
1745818101161,EDS 128A,A01,895459,Fargason; Sharon Gayle,44,0,45,1
1745818102189,EDS 128B,A01,895543,Pappas; Elizabeth,44,0,45,1
1745818103217,EDS 139,A00,897203,Pappas; Elizabeth,44,0,45,1
1745818103217,EDS 139,B00,897209,Fargason; Sharon Gayle,44,0,45,1
1745818104282,EDS 201,A00,895545,Staff,43,0,45,2
1745818105309,EDS 203,A01,895581,Halter; Christopher P.,43,0,45,2
1745818106336,EDS 204R,A01,895625,Heinzman; Erica M.,43,0,45,2
1745818106336,EDS 204R,B01,895693,Halter; Christopher P.,18,0,45,27
1745818107364,EDS 206R,A00,895694,Fargason; Sharon Gayle,9,0,30,21
1745818107364,EDS 206R,B00,895695,Choi; Bailey Miyeon,20,0,30,10
1745818108392,EDS 250,A00,895697,Hemans; Patricia Ann Benitez,43,0,45,2
1745818109419,EDS 281,A00,895701,Meyerott; Theresa Ann,15,0,15,0
1745818110447,EDS 284,A00,895736,Meyerott; Theresa Ann,15,0,15,0
1745818111470,EDS 286,A00,897210,Fine; Sarah,15,0,15,0
1745818112499,EDS 289C,A01,895770,Daly; Alan J.,15,0,15,0
1745818113526,EDS 290,A00,897211,Hofstetter; Carolyn,15,0,15,0
1745818114550,LIGM 5A,A00,896162,Fischer-Grunski; Eva K,15,0,20,5
1745818115579,LIGM 5B,A00,896260,Fischer-Grunski; Eva K,17,0,20,3
1745818116608,LIGM 5C,A00,896308,Fischer-Grunski; Eva K,18,0,20,2
1745818117632,LIIT 5AS,A00,896313,Carnelos; Chiara,18,0,20,2
1745818118658,LIIT 5BS,A00,896416,Carnelos; Chiara,20,0,20,0
1745818119689,LIIT 5CS,A00,896564,Carnelos; Chiara,20,0,20,0
1745818120717,LISP 5A,A00,896588,Munoz Sanchez; Alicia,4,0,20,16
1745818121746,LISP 5B,A00,896653,Munoz Sanchez; Alicia,10,0,20,10
1745818122773,LISP 5C,A00,896655,Munoz Sanchez; Alicia,4,0,20,16
1745818123799,MAE 197,001,957918,Kleissl; Jan,9998,0,9999,1
1745818124830,MATH 2,A01,957937,Staff,34,0,35,1
1745818125853,MATH 197,001,957876,Kedlaya; Kiran S.,9993,0,9999,6
1745818126883,MCWP 40,A00,892729,Duru; Nur,13,0,20,7
1745818126883,MCWP 40,B00,893304,Montejo; Carolina,20,0,20,0
1745818127909,MCWP 40R,A00,893757,Redela; Pamela Morgan,0,7,20,20
1745818128937,MCWP 50,A00,893758,Morshed; Michael James,2,0,20,18
1745818128937,MCWP 50,B00,893761,Bartulis; Jason Michael,17,0,20,3
1745818129968,MCWP 50R,A00,893766,Compas; Sean Matthew,0,1,20,20
1745818129968,MCWP 50R,B00,893769,Carter; Jennifer A,0,0,20,20
1745818129968,MCWP 50R,C00,893771,Krone; Jarret,0,3,20,20
1745818129968,MCWP 50R,D00,893772,Miller; Elizabeth Deen,3,0,20,17
1745818129968,MCWP 50R,E00,893775,Carter; Andrea L,0,0,20,20
1745818130993,MMW 11R,A01,892721,Herbst; Matthew,11,0,27,16
1745818130993,MMW 11R,A02,892722,Herbst; Matthew,0,0,0,3
1745818132021,MMW 12R,A01,892724,Herbst; Matthew,0,10,16,16
1745818132021,MMW 12R,A02,892725,Herbst; Matthew,0,9,16,16
1745818133048,MMW 13R,A01,892727,Staff,0,3,16,16
1745818133048,MMW 13R,A02,892728,Staff,0,4,16,16
1745818133048,MMW 13R,A03,958032,Staff,0,3,16,16
1745818133048,MMW 13R,A04,958033,Staff,0,2,16,16
1745818133048,MMW 13R,A05,958034,Staff,0,3,16,16
1745818134074,SIO 295LS,A00,894015,Staff,7,0,25,18
1745818135099,SIO 295S,A00,894020,Staff,7,0,25,18
1745818136124,SIOC 290S,B01,958918,Staff,0,0,0,0
1745818137151,SIOC 291S,B01,958922,Staff,0,0,0,0
1745818138179,SOCI 117,A01,895339,Staff,4,0,5,1
1745818139217,WES 237B,A00,894149,Staff,11,0,20,9
1745818141284,AESE 279B,A00,891859,Staff,13,0,35,22
1745818142310,AIP 197,001,891854,Staff,70,0,70,0
1745818143335,ANTH 289S,A00,891856,Gagneux; Pascal,12,0,12,0
1745818144362,BENG 196,001,957946,Engler; Adam J.,9996,0,9999,3
1745818145387,CAT 124RS,A01,956906,Staff,8,0,25,17
1745818146416,CAT 125RS,A01,922013,Staff,8,0,25,17
1745818147440,CLRE 250,A00,891860,Morris; Sheldon,9995,0,9999,4
1745818149495,CLRE 251R,A00,907817,Mehta; Ravindra L.,9994,0,9999,5
1745818150521,CLRE 252,A00,891864,Cuomo; Raphael Eduardo,9993,0,9999,6
1745818151546,CLRE 253,A00,891867,Vaida; Florin,9994,0,9999,5
1745818151546,CLRE 253,B00,907819,Staff,9999,0,9999,0
1745818152570,CLRE 259,A00,891868,Patel; Hemal,9998,0,9999,1
1745818153600,CLRE 260,A00,891872,Cuomo; Raphael Eduardo,9999,0,9999,0
1745818154626,CLRE 297,001,891888,Cuomo; Raphael Eduardo,9999,0,9999,0
1745818155653,CSE 191,A00,958773,Minnes Kemp; Mor Mia,9999,0,9999,0
1745818156677,CSS 201S,A01,892054,Mignozzetti; Umberto,30,0,30,0
1745818157702,CSS 202S,A01,892056,Mignozzetti; Umberto,30,0,30,0
1745818158731,DSC 197,001,956898,Eldridge; Justin Matthew,9998,0,9999,1
1745818159759,DSC 297,001,958000,Mazumdar; Arya,9998,0,9999,1
1745818160786,EAP 100,A00,905686,Staff,9776,0,9999,223
1745818161813,ECE 45,A01,892618,Staff,0,12,50,50
1745818162842,ECE 109,A01,892620,Staff,0,43,0,0
1745818163867,ECE 111,A01,892719,Staff,0,9,50,50
1745818164892,ECE 197,001,957920,Mercier; Patrick Philip,9992,0,9999,7
1745818165922,ECON 178,A01,907814,Zhu; Ying,28,0,35,7
1745818166948,EDS 115,A00,895312,Staff,41,0,45,4
1745818167973,EDS 117,A01,895337,Staff,30,0,30,0
1745818169000,EDS 125,A00,895341,Jones; Gabrielle Anastasia,43,0,45,2
1745818170030,EDS 128A,A01,895459,Fargason; Sharon Gayle,44,0,45,1
1745818171059,EDS 128B,A01,895543,Pappas; Elizabeth,44,0,45,1
1745818172086,EDS 139,A00,897203,Pappas; Elizabeth,44,0,45,1
1745818172086,EDS 139,B00,897209,Fargason; Sharon Gayle,44,0,45,1
1745818173115,EDS 201,A00,895545,Staff,43,0,45,2
1745818174139,EDS 203,A01,895581,Halter; Christopher P.,43,0,45,2
1745818175166,EDS 204R,A01,895625,Heinzman; Erica M.,43,0,45,2
1745818175166,EDS 204R,B01,895693,Halter; Christopher P.,18,0,45,27
1745818176195,EDS 206R,A00,895694,Fargason; Sharon Gayle,9,0,30,21
1745818176195,EDS 206R,B00,895695,Choi; Bailey Miyeon,20,0,30,10
1745818177224,EDS 250,A00,895697,Hemans; Patricia Ann Benitez,43,0,45,2
1745818178254,EDS 281,A00,895701,Meyerott; Theresa Ann,15,0,15,0
1745818179281,EDS 284,A00,895736,Meyerott; Theresa Ann,15,0,15,0
1745818180307,EDS 286,A00,897210,Fine; Sarah,15,0,15,0
1745818181334,EDS 289C,A01,895770,Daly; Alan J.,15,0,15,0
1745818182363,EDS 290,A00,897211,Hofstetter; Carolyn,15,0,15,0
1745818183389,LIGM 5A,A00,896162,Fischer-Grunski; Eva K,15,0,20,5
1745818184417,LIGM 5B,A00,896260,Fischer-Grunski; Eva K,17,0,20,3
1745818185445,LIGM 5C,A00,896308,Fischer-Grunski; Eva K,18,0,20,2
1745818186474,LIIT 5AS,A00,896313,Carnelos; Chiara,18,0,20,2
1745818187500,LIIT 5BS,A00,896416,Carnelos; Chiara,20,0,20,0
1745818188528,LIIT 5CS,A00,896564,Carnelos; Chiara,20,0,20,0
1745818189557,LISP 5A,A00,896588,Munoz Sanchez; Alicia,4,0,20,16
1745818190587,LISP 5B,A00,896653,Munoz Sanchez; Alicia,10,0,20,10
1745818191613,LISP 5C,A00,896655,Munoz Sanchez; Alicia,4,0,20,16
1745818192640,MAE 197,001,957918,Kleissl; Jan,9998,0,9999,1
1745818193667,MATH 2,A01,957937,Staff,34,0,35,1
1745818194693,MATH 197,001,957876,Kedlaya; Kiran S.,9993,0,9999,6
1745818195721,MCWP 40,A00,892729,Duru; Nur,13,0,20,7
1745818195721,MCWP 40,B00,893304,Montejo; Carolina,20,0,20,0
1745818196751,MCWP 40R,A00,893757,Redela; Pamela Morgan,0,7,20,20
1745818197780,MCWP 50,A00,893758,Morshed; Michael James,2,0,20,18
1745818197780,MCWP 50,B00,893761,Bartulis; Jason Michael,17,0,20,3
1745818198806,MCWP 50R,A00,893766,Compas; Sean Matthew,0,1,20,20
1745818198806,MCWP 50R,B00,893769,Carter; Jennifer A,0,0,20,20
1745818198806,MCWP 50R,C00,893771,Krone; Jarret,0,3,20,20
1745818198806,MCWP 50R,D00,893772,Miller; Elizabeth Deen,3,0,20,17
1745818198806,MCWP 50R,E00,893775,Carter; Andrea L,0,0,20,20
1745818199835,MMW 11R,A01,892721,Herbst; Matthew,11,0,27,16
1745818199835,MMW 11R,A02,892722,Herbst; Matthew,0,0,0,3
1745818200862,MMW 12R,A01,892724,Herbst; Matthew,0,10,16,16
1745818200862,MMW 12R,A02,892725,Herbst; Matthew,0,9,16,16
1745818201889,MMW 13R,A01,892727,Staff,0,3,16,16
1745818201889,MMW 13R,A02,892728,Staff,0,4,16,16
1745818201889,MMW 13R,A03,958032,Staff,0,3,16,16
1745818201889,MMW 13R,A04,958033,Staff,0,2,16,16
1745818201889,MMW 13R,A05,958034,Staff,0,3,16,16
1745818202914,SIO 295LS,A00,894015,Staff,7,0,25,18
1745818203942,SIO 295S,A00,894020,Staff,7,0,25,18
1745818204973,SIOC 290S,B01,958918,Staff,0,0,0,0
1745818205999,SIOC 291S,B01,958922,Staff,0,0,0,0
1745818207027,SOCI 117,A01,895339,Staff,4,0,5,1
1745818208056,WES 237B,A00,894149,Staff,11,0,20,9
1745818210117,AESE 279B,A00,891859,Staff,13,0,35,22
1745818211143,AIP 197,001,891854,Staff,70,0,70,0
1745818212171,ANTH 289S,A00,891856,Gagneux; Pascal,12,0,12,0
1745818213198,BENG 196,001,957946,Engler; Adam J.,9996,0,9999,3
1745818214226,CAT 124RS,A01,956906,Staff,8,0,25,17
1745818215254,CAT 125RS,A01,922013,Staff,8,0,25,17
1745818216280,CLRE 250,A00,891860,Morris; Sheldon,9995,0,9999,4
1745818218330,CLRE 251R,A00,907817,Mehta; Ravindra L.,9994,0,9999,5
1745818219355,CLRE 252,A00,891864,Cuomo; Raphael Eduardo,9993,0,9999,6
1745818220384,CLRE 253,A00,891867,Vaida; Florin,9994,0,9999,5
1745818220384,CLRE 253,B00,907819,Staff,9999,0,9999,0
1745818221414,CLRE 259,A00,891868,Patel; Hemal,9998,0,9999,1
1745818222438,CLRE 260,A00,891872,Cuomo; Raphael Eduardo,9999,0,9999,0
1745818223464,CLRE 297,001,891888,Cuomo; Raphael Eduardo,9999,0,9999,0
1745818224492,CSE 191,A00,958773,Minnes Kemp; Mor Mia,9999,0,9999,0
1745818225519,CSS 201S,A01,892054,Mignozzetti; Umberto,30,0,30,0
1745818226543,CSS 202S,A01,892056,Mignozzetti; Umberto,30,0,30,0
1745818227568,DSC 197,001,956898,Eldridge; Justin Matthew,9998,0,9999,1
1745818228594,DSC 297,001,958000,Mazumdar; Arya,9998,0,9999,1
1745818229619,EAP 100,A00,905686,Staff,9776,0,9999,223
1745818230646,ECE 45,A01,892618,Staff,0,12,50,50
1745818231671,ECE 109,A01,892620,Staff,0,43,0,0
1745818232695,ECE 111,A01,892719,Staff,0,9,50,50
1745818233723,ECE 197,001,957920,Mercier; Patrick Philip,9992,0,9999,7
1745818234748,ECON 178,A01,907814,Zhu; Ying,28,0,35,7
1745818235775,EDS 115,A00,895312,Staff,41,0,45,4
1745818236802,EDS 117,A01,895337,Staff,30,0,30,0
1745818237826,EDS 125,A00,895341,Jones; Gabrielle Anastasia,43,0,45,2
1745818238854,EDS 128A,A01,895459,Fargason; Sharon Gayle,44,0,45,1
1745818239883,EDS 128B,A01,895543,Pappas; Elizabeth,44,0,45,1
1745818240909,EDS 139,A00,897203,Pappas; Elizabeth,44,0,45,1
1745818240909,EDS 139,B00,897209,Fargason; Sharon Gayle,44,0,45,1
1745818241934,EDS 201,A00,895545,Staff,43,0,45,2
1745818242987,EDS 203,A01,895581,Halter; Christopher P.,43,0,45,2
1745818244010,EDS 204R,A01,895625,Heinzman; Erica M.,43,0,45,2
1745818244010,EDS 204R,B01,895693,Halter; Christopher P.,18,0,45,27
1745818245034,EDS 206R,A00,895694,Fargason; Sharon Gayle,9,0,30,21
1745818245034,EDS 206R,B00,895695,Choi; Bailey Miyeon,20,0,30,10
1745818246057,EDS 250,A00,895697,Hemans; Patricia Ann Benitez,43,0,45,2
1745818247080,EDS 281,A00,895701,Meyerott; Theresa Ann,15,0,15,0
1745818248105,EDS 284,A00,895736,Meyerott; Theresa Ann,15,0,15,0
1745818249131,EDS 286,A00,897210,Fine; Sarah,15,0,15,0
1745818250157,EDS 289C,A01,895770,Daly; Alan J.,15,0,15,0
1745818251184,EDS 290,A00,897211,Hofstetter; Carolyn,15,0,15,0
1745818252212,LIGM 5A,A00,896162,Fischer-Grunski; Eva K,15,0,20,5
1745818253237,LIGM 5B,A00,896260,Fischer-Grunski; Eva K,17,0,20,3
1745818254263,LIGM 5C,A00,896308,Fischer-Grunski; Eva K,18,0,20,2
1745818255289,LIIT 5AS,A00,896313,Carnelos; Chiara,18,0,20,2
1745818256314,LIIT 5BS,A00,896416,Carnelos; Chiara,20,0,20,0
1745818257343,LIIT 5CS,A00,896564,Carnelos; Chiara,20,0,20,0
1745818258366,LISP 5A,A00,896588,Munoz Sanchez; Alicia,4,0,20,16
1745818259393,LISP 5B,A00,896653,Munoz Sanchez; Alicia,10,0,20,10
1745818260421,LISP 5C,A00,896655,Munoz Sanchez; Alicia,4,0,20,16
1745818261446,MAE 197,001,957918,Kleissl; Jan,9998,0,9999,1
1745818262473,MATH 2,A01,957937,Staff,34,0,35,1
1745818263501,MATH 197,001,957876,Kedlaya; Kiran S.,9993,0,9999,6
1745818264528,MCWP 40,A00,892729,Duru; Nur,13,0,20,7
1745818264528,MCWP 40,B00,893304,Montejo; Carolina,20,0,20,0
1745818265553,MCWP 40R,A00,893757,Redela; Pamela Morgan,0,7,20,20
1745818266580,MCWP 50,A00,893758,Morshed; Michael James,2,0,20,18
1745818266580,MCWP 50,B00,893761,Bartulis; Jason Michael,17,0,20,3
1745818267606,MCWP 50R,A00,893766,Compas; Sean Matthew,0,1,20,20
1745818267606,MCWP 50R,B00,893769,Carter; Jennifer A,0,0,20,20
1745818267606,MCWP 50R,C00,893771,Krone; Jarret,0,3,20,20
1745818267606,MCWP 50R,D00,893772,Miller; Elizabeth Deen,3,0,20,17
1745818267606,MCWP 50R,E00,893775,Carter; Andrea L,0,0,20,20
1745818268635,MMW 11R,A01,892721,Herbst; Matthew,11,0,27,16
1745818268635,MMW 11R,A02,892722,Herbst; Matthew,0,0,0,3
1745818269661,MMW 12R,A01,892724,Herbst; Matthew,0,10,16,16
1745818269661,MMW 12R,A02,892725,Herbst; Matthew,0,9,16,16
1745818270690,MMW 13R,A01,892727,Staff,0,3,16,16
1745818270690,MMW 13R,A02,892728,Staff,0,4,16,16
1745818270690,MMW 13R,A03,958032,Staff,0,3,16,16
1745818270690,MMW 13R,A04,958033,Staff,0,2,16,16
1745818270690,MMW 13R,A05,958034,Staff,0,3,16,16
1745818271713,SIO 295LS,A00,894015,Staff,7,0,25,18
1745818272743,SIO 295S,A00,894020,Staff,7,0,25,18
1745818273767,SIOC 290S,B01,958918,Staff,0,0,0,0
1745818274798,SIOC 291S,B01,958922,Staff,0,0,0,0
1745818275822,SOCI 117,A01,895339,Staff,4,0,5,1
1745818276850,WES 237B,A00,894149,Staff,11,0,20,9
1745818278911,AESE 279B,A00,891859,Staff,13,0,35,22
1745818279935,AIP 197,001,891854,Staff,70,0,70,0
1745818280959,ANTH 289S,A00,891856,Gagneux; Pascal,12,0,12,0
1745818281986,BENG 196,001,957946,Engler; Adam J.,9996,0,9999,3
1745818283011,CAT 124RS,A01,956906,Staff,8,0,25,17
1745818284038,CAT 125RS,A01,922013,Staff,8,0,25,17
1745818285065,CLRE 250,A00,891860,Morris; Sheldon,9995,0,9999,4
1745818287118,CLRE 251R,A00,907817,Mehta; Ravindra L.,9994,0,9999,5
1745818288144,CLRE 252,A00,891864,Cuomo; Raphael Eduardo,9993,0,9999,6
1745818289168,CLRE 253,A00,891867,Vaida; Florin,9994,0,9999,5
1745818289168,CLRE 253,B00,907819,Staff,9999,0,9999,0
1745818290198,CLRE 259,A00,891868,Patel; Hemal,9998,0,9999,1
1745818291224,CLRE 260,A00,891872,Cuomo; Raphael Eduardo,9999,0,9999,0
1745818292249,CLRE 297,001,891888,Cuomo; Raphael Eduardo,9999,0,9999,0
1745818293274,CSE 191,A00,958773,Minnes Kemp; Mor Mia,9999,0,9999,0
1745818294300,CSS 201S,A01,892054,Mignozzetti; Umberto,30,0,30,0
1745818295328,CSS 202S,A01,892056,Mignozzetti; Umberto,30,0,30,0
1745818296357,DSC 197,001,956898,Eldridge; Justin Matthew,9998,0,9999,1
1745818297383,DSC 297,001,958000,Mazumdar; Arya,9998,0,9999,1
1745818298409,EAP 100,A00,905686,Staff,9776,0,9999,223
1745818299439,ECE 45,A01,892618,Staff,0,12,50,50
1745818300465,ECE 109,A01,892620,Staff,0,43,0,0
1745818301490,ECE 111,A01,892719,Staff,0,9,50,50
1745818302518,ECE 197,001,957920,Mercier; Patrick Philip,9992,0,9999,7
1745818303544,ECON 178,A01,907814,Zhu; Ying,28,0,35,7
1745818304568,EDS 115,A00,895312,Staff,41,0,45,4
1745818305595,EDS 117,A01,895337,Staff,30,0,30,0
1745818306625,EDS 125,A00,895341,Jones; Gabrielle Anastasia,43,0,45,2
1745818307647,EDS 128A,A01,895459,Fargason; Sharon Gayle,44,0,45,1
1745818308674,EDS 128B,A01,895543,Pappas; Elizabeth,44,0,45,1
1745818309703,EDS 139,A00,897203,Pappas; Elizabeth,44,0,45,1
1745818309703,EDS 139,B00,897209,Fargason; Sharon Gayle,44,0,45,1
1745818310727,EDS 201,A00,895545,Staff,43,0,45,2
1745818311753,EDS 203,A01,895581,Halter; Christopher P.,43,0,45,2
1745818312783,EDS 204R,A01,895625,Heinzman; Erica M.,43,0,45,2
1745818312783,EDS 204R,B01,895693,Halter; Christopher P.,18,0,45,27
1745818313808,EDS 206R,A00,895694,Fargason; Sharon Gayle,9,0,30,21
1745818313808,EDS 206R,B00,895695,Choi; Bailey Miyeon,20,0,30,10
1745818314837,EDS 250,A00,895697,Hemans; Patricia Ann Benitez,43,0,45,2
1745818315863,EDS 281,A00,895701,Meyerott; Theresa Ann,15,0,15,0
1745818316887,EDS 284,A00,895736,Meyerott; Theresa Ann,15,0,15,0
1745818317913,EDS 286,A00,897210,Fine; Sarah,15,0,15,0
1745818318941,EDS 289C,A01,895770,Daly; Alan J.,15,0,15,0
1745818319967,EDS 290,A00,897211,Hofstetter; Carolyn,15,0,15,0
1745818320992,LIGM 5A,A00,896162,Fischer-Grunski; Eva K,15,0,20,5
1745818322020,LIGM 5B,A00,896260,Fischer-Grunski; Eva K,17,0,20,3
1745818323051,LIGM 5C,A00,896308,Fischer-Grunski; Eva K,18,0,20,2
1745818324079,LIIT 5AS,A00,896313,Carnelos; Chiara,18,0,20,2
1745818325104,LIIT 5BS,A00,896416,Carnelos; Chiara,20,0,20,0
1745818326130,LIIT 5CS,A00,896564,Carnelos; Chiara,20,0,20,0
1745818327160,LISP 5A,A00,896588,Munoz Sanchez; Alicia,4,0,20,16
1745818328191,LISP 5B,A00,896653,Munoz Sanchez; Alicia,10,0,20,10
1745818329221,LISP 5C,A00,896655,Munoz Sanchez; Alicia,4,0,20,16
1745818330247,MAE 197,001,957918,Kleissl; Jan,9998,0,9999,1
1745818331275,MATH 2,A01,957937,Staff,34,0,35,1
1745818332302,MATH 197,001,957876,Kedlaya; Kiran S.,9993,0,9999,6
1745818333330,MCWP 40,A00,892729,Duru; Nur,13,0,20,7
1745818333330,MCWP 40,B00,893304,Montejo; Carolina,20,0,20,0
1745818334359,MCWP 40R,A00,893757,Redela; Pamela Morgan,0,7,20,20
1745818335388,MCWP 50,A00,893758,Morshed; Michael James,2,0,20,18
1745818335388,MCWP 50,B00,893761,Bartulis; Jason Michael,17,0,20,3
1745818336417,MCWP 50R,A00,893766,Compas; Sean Matthew,0,1,20,20
1745818336417,MCWP 50R,B00,893769,Carter; Jennifer A,0,0,20,20
1745818336417,MCWP 50R,C00,893771,Krone; Jarret,0,3,20,20
1745818336417,MCWP 50R,D00,893772,Miller; Elizabeth Deen,3,0,20,17
1745818336417,MCWP 50R,E00,893775,Carter; Andrea L,0,0,20,20
1745818337444,MMW 11R,A01,892721,Herbst; Matthew,11,0,27,16
1745818337444,MMW 11R,A02,892722,Herbst; Matthew,0,0,0,3
1745818338472,MMW 12R,A01,892724,Herbst; Matthew,0,10,16,16
1745818338472,MMW 12R,A02,892725,Herbst; Matthew,0,9,16,16
1745818339500,MMW 13R,A01,892727,Staff,0,3,16,16
1745818339500,MMW 13R,A02,892728,Staff,0,4,16,16
1745818339500,MMW 13R,A03,958032,Staff,0,3,16,16
1745818339500,MMW 13R,A04,958033,Staff,0,2,16,16
1745818339500,MMW 13R,A05,958034,Staff,0,3,16,16
1745818340530,SIO 295LS,A00,894015,Staff,7,0,25,18
1745818341560,SIO 295S,A00,894020,Staff,7,0,25,18
1745818342588,SIOC 290S,B01,958918,Staff,0,0,0,0
1745818343612,SIOC 291S,B01,958922,Staff,0,0,0,0
1745818344642,SOCI 117,A01,895339,Staff,4,0,5,1
1745818345666,WES 237B,A00,894149,Staff,11,0,20,9
1745818347729,AESE 279B,A00,891859,Staff,13,0,35,22
1745818348754,AIP 197,001,891854,Staff,70,0,70,0
1745818349784,ANTH 289S,A00,891856,Gagneux; Pascal,12,0,12,0
1745818350814,BENG 196,001,957946,Engler; Adam J.,9996,0,9999,3
1745818352040,CAT 124RS,A01,956906,Staff,8,0,25,17
1745818353065,CAT 125RS,A01,922013,Staff,8,0,25,17
1745818354089,CLRE 250,A00,891860,Morris; Sheldon,9995,0,9999,4
1745818356141,CLRE 251R,A00,907817,Mehta; Ravindra L.,9994,0,9999,5
1745818357166,CLRE 252,A00,891864,Cuomo; Raphael Eduardo,9993,0,9999,6
1745818358191,CLRE 253,A00,891867,Vaida; Florin,9994,0,9999,5
1745818358191,CLRE 253,B00,907819,Staff,9999,0,9999,0
1745818359219,CLRE 259,A00,891868,Patel; Hemal,9998,0,9999,1
1745818360243,CLRE 260,A00,891872,Cuomo; Raphael Eduardo,9999,0,9999,0
1745818361270,CLRE 297,001,891888,Cuomo; Raphael Eduardo,9999,0,9999,0
1745818362298,CSE 191,A00,958773,Minnes Kemp; Mor Mia,9999,0,9999,0
1745818363324,CSS 201S,A01,892054,Mignozzetti; Umberto,30,0,30,0
1745818364354,CSS 202S,A01,892056,Mignozzetti; Umberto,30,0,30,0
1745818365379,DSC 197,001,956898,Eldridge; Justin Matthew,9998,0,9999,1
1745818366402,DSC 297,001,958000,Mazumdar; Arya,9998,0,9999,1
1745818367465,EAP 100,A00,905686,Staff,9776,0,9999,223
1745818368491,ECE 45,A01,892618,Staff,0,12,50,50
1745818369515,ECE 109,A01,892620,Staff,0,43,0,0
1745818370543,ECE 111,A01,892719,Staff,0,9,50,50
1745818371569,ECE 197,001,957920,Mercier; Patrick Philip,9992,0,9999,7
1745818372594,ECON 178,A01,907814,Zhu; Ying,28,0,35,7
1745818373619,EDS 115,A00,895312,Staff,41,0,45,4
1745818374645,EDS 117,A01,895337,Staff,30,0,30,0
1745818375669,EDS 125,A00,895341,Jones; Gabrielle Anastasia,43,0,45,2
1745818376695,EDS 128A,A01,895459,Fargason; Sharon Gayle,44,0,45,1
1745818377721,EDS 128B,A01,895543,Pappas; Elizabeth,44,0,45,1
1745818378746,EDS 139,A00,897203,Pappas; Elizabeth,44,0,45,1
1745818378746,EDS 139,B00,897209,Fargason; Sharon Gayle,44,0,45,1
1745818379771,EDS 201,A00,895545,Staff,43,0,45,2
1745818380799,EDS 203,A01,895581,Halter; Christopher P.,43,0,45,2
1745818381828,EDS 204R,A01,895625,Heinzman; Erica M.,43,0,45,2
1745818381828,EDS 204R,B01,895693,Halter; Christopher P.,18,0,45,27
1745818382857,EDS 206R,A00,895694,Fargason; Sharon Gayle,9,0,30,21
1745818382857,EDS 206R,B00,895695,Choi; Bailey Miyeon,20,0,30,10
1745818383880,EDS 250,A00,895697,Hemans; Patricia Ann Benitez,43,0,45,2
1745818385107,EDS 281,A00,895701,Meyerott; Theresa Ann,15,0,15,0
1745818386133,EDS 284,A00,895736,Meyerott; Theresa Ann,15,0,15,0
1745818387160,EDS 286,A00,897210,Fine; Sarah,15,0,15,0
1745818388186,EDS 289C,A01,895770,Daly; Alan J.,15,0,15,0
1745818389211,EDS 290,A00,897211,Hofstetter; Carolyn,15,0,15,0
1745818390240,LIGM 5A,A00,896162,Fischer-Grunski; Eva K,15,0,20,5
1745818391268,LIGM 5B,A00,896260,Fischer-Grunski; Eva K,17,0,20,3
1745818392294,LIGM 5C,A00,896308,Fischer-Grunski; Eva K,18,0,20,2
1745818393320,LIIT 5AS,A00,896313,Carnelos; Chiara,18,0,20,2
1745818394349,LIIT 5BS,A00,896416,Carnelos; Chiara,20,0,20,0
1745818395376,LIIT 5CS,A00,896564,Carnelos; Chiara,20,0,20,0
1745818396402,LISP 5A,A00,896588,Munoz Sanchez; Alicia,4,0,20,16
1745818397429,LISP 5B,A00,896653,Munoz Sanchez; Alicia,10,0,20,10
1745818398453,LISP 5C,A00,896655,Munoz Sanchez; Alicia,4,0,20,16
1745818399478,MAE 197,001,957918,Kleissl; Jan,9998,0,9999,1
1745818400504,MATH 2,A01,957937,Staff,34,0,35,1
1745818401534,MATH 197,001,957876,Kedlaya; Kiran S.,9993,0,9999,6
1745818402557,MCWP 40,A00,892729,Duru; Nur,13,0,20,7
1745818402557,MCWP 40,B00,893304,Montejo; Carolina,20,0,20,0
1745818403584,MCWP 40R,A00,893757,Redela; Pamela Morgan,0,7,20,20
1745818404611,MCWP 50,A00,893758,Morshed; Michael James,2,0,20,18
1745818404611,MCWP 50,B00,893761,Bartulis; Jason Michael,17,0,20,3
1745818405640,MCWP 50R,A00,893766,Compas; Sean Matthew,0,1,20,20
1745818405640,MCWP 50R,B00,893769,Carter; Jennifer A,0,0,20,20
1745818405640,MCWP 50R,C00,893771,Krone; Jarret,0,3,20,20
1745818405640,MCWP 50R,D00,893772,Miller; Elizabeth Deen,3,0,20,17
1745818405640,MCWP 50R,E00,893775,Carter; Andrea L,0,0,20,20
1745818406664,MMW 11R,A01,892721,Herbst; Matthew,11,0,27,16
1745818406664,MMW 11R,A02,892722,Herbst; Matthew,0,0,0,3
1745818407690,MMW 12R,A01,892724,Herbst; Matthew,0,10,16,16
1745818407690,MMW 12R,A02,892725,Herbst; Matthew,0,9,16,16
1745818408714,MMW 13R,A01,892727,Staff,0,3,16,16
1745818408714,MMW 13R,A02,892728,Staff,0,4,16,16
1745818408714,MMW 13R,A03,958032,Staff,0,3,16,16
1745818408714,MMW 13R,A04,958033,Staff,0,2,16,16
1745818408714,MMW 13R,A05,958034,Staff,0,3,16,16
1745818409739,SIO 295LS,A00,894015,Staff,7,0,25,18
1745818410766,SIO 295S,A00,894020,Staff,7,0,25,18
1745818411791,SIOC 290S,B01,958918,Staff,0,0,0,0
1745818412818,SIOC 291S,B01,958922,Staff,0,0,0,0
1745818413846,SOCI 117,A01,895339,Staff,4,0,5,1
1745818414871,WES 237B,A00,894149,Staff,11,0,20,9
1745818416928,AESE 279B,A00,891859,Staff,13,0,35,22
1745818417954,AIP 197,001,891854,Staff,70,0,70,0
1745818418982,ANTH 289S,A00,891856,Gagneux; Pascal,12,0,12,0
1745818420007,BENG 196,001,957946,Engler; Adam J.,9996,0,9999,3
1745818421032,CAT 124RS,A01,956906,Staff,8,0,25,17
1745818422060,CAT 125RS,A01,922013,Staff,8,0,25,17
1745818423085,CLRE 250,A00,891860,Morris; Sheldon,9995,0,9999,4
1745818425135,CLRE 251R,A00,907817,Mehta; Ravindra L.,9994,0,9999,5
1745818426161,CLRE 252,A00,891864,Cuomo; Raphael Eduardo,9993,0,9999,6
1745818427186,CLRE 253,A00,891867,Vaida; Florin,9994,0,9999,5
1745818427186,CLRE 253,B00,907819,Staff,9999,0,9999,0
1745818428211,CLRE 259,A00,891868,Patel; Hemal,9998,0,9999,1
1745818429236,CLRE 260,A00,891872,Cuomo; Raphael Eduardo,9999,0,9999,0
1745818430262,CLRE 297,001,891888,Cuomo; Raphael Eduardo,9999,0,9999,0
1745818431289,CSE 191,A00,958773,Minnes Kemp; Mor Mia,9999,0,9999,0
1745818432314,CSS 201S,A01,892054,Mignozzetti; Umberto,30,0,30,0
1745818433341,CSS 202S,A01,892056,Mignozzetti; Umberto,30,0,30,0
1745818434367,DSC 197,001,956898,Eldridge; Justin Matthew,9998,0,9999,1
1745818435397,DSC 297,001,958000,Mazumdar; Arya,9998,0,9999,1
1745818436425,EAP 100,A00,905686,Staff,9776,0,9999,223
1745818437450,ECE 45,A01,892618,Staff,0,12,50,50
1745818438475,ECE 109,A01,892620,Staff,0,43,0,0
1745818439503,ECE 111,A01,892719,Staff,0,9,50,50
1745818440528,ECE 197,001,957920,Mercier; Patrick Philip,9992,0,9999,7
1745818441553,ECON 178,A01,907814,Zhu; Ying,28,0,35,7
1745818442585,EDS 115,A00,895312,Staff,41,0,45,4
1745818443612,EDS 117,A01,895337,Staff,30,0,30,0
1745818444637,EDS 125,A00,895341,Jones; Gabrielle Anastasia,43,0,45,2
1745818445663,EDS 128A,A01,895459,Fargason; Sharon Gayle,44,0,45,1
1745818446689,EDS 128B,A01,895543,Pappas; Elizabeth,44,0,45,1
1745818447714,EDS 139,A00,897203,Pappas; Elizabeth,44,0,45,1
1745818447714,EDS 139,B00,897209,Fargason; Sharon Gayle,44,0,45,1
1745818448739,EDS 201,A00,895545,Staff,43,0,45,2
1745818449763,EDS 203,A01,895581,Halter; Christopher P.,43,0,45,2
1745818450789,EDS 204R,A01,895625,Heinzman; Erica M.,43,0,45,2
1745818450789,EDS 204R,B01,895693,Halter; Christopher P.,18,0,45,27
1745818451814,EDS 206R,A00,895694,Fargason; Sharon Gayle,9,0,30,21
1745818451814,EDS 206R,B00,895695,Choi; Bailey Miyeon,20,0,30,10
1745818452901,EDS 250,A00,895697,Hemans; Patricia Ann Benitez,43,0,45,2
1745818453930,EDS 281,A00,895701,Meyerott; Theresa Ann,15,0,15,0
1745818454956,EDS 284,A00,895736,Meyerott; Theresa Ann,15,0,15,0
1745818455981,EDS 286,A00,897210,Fine; Sarah,15,0,15,0
1745818457008,EDS 289C,A01,895770,Daly; Alan J.,15,0,15,0
1745818458037,EDS 290,A00,897211,Hofstetter; Carolyn,15,0,15,0
1745818459063,LIGM 5A,A00,896162,Fischer-Grunski; Eva K,15,0,20,5
1745818460093,LIGM 5B,A00,896260,Fischer-Grunski; Eva K,17,0,20,3
1745818461118,LIGM 5C,A00,896308,Fischer-Grunski; Eva K,18,0,20,2
1745818462143,LIIT 5AS,A00,896313,Carnelos; Chiara,18,0,20,2
1745818463170,LIIT 5BS,A00,896416,Carnelos; Chiara,20,0,20,0
1745818464195,LIIT 5CS,A00,896564,Carnelos; Chiara,20,0,20,0
1745818465223,LISP 5A,A00,896588,Munoz Sanchez; Alicia,4,0,20,16
1745818466252,LISP 5B,A00,896653,Munoz Sanchez; Alicia,10,0,20,10
1745818467278,LISP 5C,A00,896655,Munoz Sanchez; Alicia,4,0,20,16
1745818468307,MAE 197,001,957918,Kleissl; Jan,9998,0,9999,1
1745818469332,MATH 2,A01,957937,Staff,34,0,35,1
1745818470361,MATH 197,001,957876,Kedlaya; Kiran S.,9993,0,9999,6
1745818471389,MCWP 40,A00,892729,Duru; Nur,13,0,20,7
1745818471389,MCWP 40,B00,893304,Montejo; Carolina,20,0,20,0
1745818472417,MCWP 40R,A00,893757,Redela; Pamela Morgan,0,7,20,20
1745818473443,MCWP 50,A00,893758,Morshed; Michael James,2,0,20,18
1745818473443,MCWP 50,B00,893761,Bartulis; Jason Michael,17,0,20,3
1745818474470,MCWP 50R,A00,893766,Compas; Sean Matthew,0,1,20,20
1745818474470,MCWP 50R,B00,893769,Carter; Jennifer A,0,0,20,20
1745818474470,MCWP 50R,C00,893771,Krone; Jarret,0,3,20,20
1745818474470,MCWP 50R,D00,893772,Miller; Elizabeth Deen,3,0,20,17
1745818474470,MCWP 50R,E00,893775,Carter; Andrea L,0,0,20,20
1745818475499,MMW 11R,A01,892721,Herbst; Matthew,11,0,27,16
1745818475499,MMW 11R,A02,892722,Herbst; Matthew,0,0,0,3
1745818476526,MMW 12R,A01,892724,Herbst; Matthew,0,10,16,16
1745818476526,MMW 12R,A02,892725,Herbst; Matthew,0,9,16,16
1745818477552,MMW 13R,A01,892727,Staff,0,3,16,16
1745818477552,MMW 13R,A02,892728,Staff,0,4,16,16
1745818477552,MMW 13R,A03,958032,Staff,0,3,16,16
1745818477552,MMW 13R,A04,958033,Staff,0,2,16,16
1745818477552,MMW 13R,A05,958034,Staff,0,3,16,16
1745818478581,SIO 295LS,A00,894015,Staff,7,0,25,18
1745818479607,SIO 295S,A00,894020,Staff,7,0,25,18
1745818480636,SIOC 290S,B01,958918,Staff,0,0,0,0
1745818481666,SIOC 291S,B01,958922,Staff,0,0,0,0
1745818482694,SOCI 117,A01,895339,Staff,4,0,5,1
1745818483719,WES 237B,A00,894149,Staff,11,0,20,9
1745818485776,AESE 279B,A00,891859,Staff,13,0,35,22
1745818486802,AIP 197,001,891854,Staff,70,0,70,0
1745818487828,ANTH 289S,A00,891856,Gagneux; Pascal,12,0,12,0
1745818488856,BENG 196,001,957946,Engler; Adam J.,9996,0,9999,3
1745818489881,CAT 124RS,A01,956906,Staff,8,0,25,17
1745818490908,CAT 125RS,A01,922013,Staff,8,0,25,17
1745818491934,CLRE 250,A00,891860,Morris; Sheldon,9995,0,9999,4
1745818493988,CLRE 251R,A00,907817,Mehta; Ravindra L.,9994,0,9999,5
1745818495016,CLRE 252,A00,891864,Cuomo; Raphael Eduardo,9993,0,9999,6
1745818496042,CLRE 253,A00,891867,Vaida; Florin,9994,0,9999,5
1745818496042,CLRE 253,B00,907819,Staff,9999,0,9999,0
1745818497067,CLRE 259,A00,891868,Patel; Hemal,9998,0,9999,1
1745818498095,CLRE 260,A00,891872,Cuomo; Raphael Eduardo,9999,0,9999,0
1745818499124,CLRE 297,001,891888,Cuomo; Raphael Eduardo,9999,0,9999,0
1745818500152,CSE 191,A00,958773,Minnes Kemp; Mor Mia,9999,0,9999,0
1745818501183,CSS 201S,A01,892054,Mignozzetti; Umberto,30,0,30,0
1745818502212,CSS 202S,A01,892056,Mignozzetti; Umberto,30,0,30,0
1745818503241,DSC 197,001,956898,Eldridge; Justin Matthew,9998,0,9999,1
1745818504266,DSC 297,001,958000,Mazumdar; Arya,9998,0,9999,1
1745818505292,EAP 100,A00,905686,Staff,9776,0,9999,223
1745818506317,ECE 45,A01,892618,Staff,0,12,50,50
1745818507345,ECE 109,A01,892620,Staff,0,43,0,0
1745818508372,ECE 111,A01,892719,Staff,0,9,50,50
1745818509397,ECE 197,001,957920,Mercier; Patrick Philip,9992,0,9999,7
1745818510427,ECON 178,A01,907814,Zhu; Ying,28,0,35,7
1745818511453,EDS 115,A00,895312,Staff,41,0,45,4
1745818512482,EDS 117,A01,895337,Staff,30,0,30,0
1745818513506,EDS 125,A00,895341,Jones; Gabrielle Anastasia,43,0,45,2
1745818514532,EDS 128A,A01,895459,Fargason; Sharon Gayle,44,0,45,1
1745818515558,EDS 128B,A01,895543,Pappas; Elizabeth,44,0,45,1
1745818516583,EDS 139,A00,897203,Pappas; Elizabeth,44,0,45,1
1745818516583,EDS 139,B00,897209,Fargason; Sharon Gayle,44,0,45,1
1745818517612,EDS 201,A00,895545,Staff,43,0,45,2
1745818518638,EDS 203,A01,895581,Halter; Christopher P.,43,0,45,2
1745818519662,EDS 204R,A01,895625,Heinzman; Erica M.,43,0,45,2
1745818519662,EDS 204R,B01,895693,Halter; Christopher P.,18,0,45,27
1745818520692,EDS 206R,A00,895694,Fargason; Sharon Gayle,9,0,30,21
1745818520692,EDS 206R,B00,895695,Choi; Bailey Miyeon,20,0,30,10
1745818521720,EDS 250,A00,895697,Hemans; Patricia Ann Benitez,43,0,45,2
1745818522747,EDS 281,A00,895701,Meyerott; Theresa Ann,15,0,15,0
1745818523772,EDS 284,A00,895736,Meyerott; Theresa Ann,15,0,15,0
1745818524797,EDS 286,A00,897210,Fine; Sarah,15,0,15,0
1745818525826,EDS 289C,A01,895770,Daly; Alan J.,15,0,15,0
1745818526851,EDS 290,A00,897211,Hofstetter; Carolyn,15,0,15,0
1745818527877,LIGM 5A,A00,896162,Fischer-Grunski; Eva K,15,0,20,5
1745818528903,LIGM 5B,A00,896260,Fischer-Grunski; Eva K,17,0,20,3
1745818529928,LIGM 5C,A00,896308,Fischer-Grunski; Eva K,18,0,20,2
1745818530956,LIIT 5AS,A00,896313,Carnelos; Chiara,18,0,20,2
1745818531982,LIIT 5BS,A00,896416,Carnelos; Chiara,20,0,20,0
1745818533008,LIIT 5CS,A00,896564,Carnelos; Chiara,20,0,20,0
1745818534038,LISP 5A,A00,896588,Munoz Sanchez; Alicia,4,0,20,16
1745818535064,LISP 5B,A00,896653,Munoz Sanchez; Alicia,10,0,20,10
1745818536090,LISP 5C,A00,896655,Munoz Sanchez; Alicia,4,0,20,16
1745818537114,MAE 197,001,957918,Kleissl; Jan,9998,0,9999,1
1745818538138,MATH 2,A01,957937,Staff,34,0,35,1
1745818539162,MATH 197,001,957876,Kedlaya; Kiran S.,9993,0,9999,6
1745818540188,MCWP 40,A00,892729,Duru; Nur,13,0,20,7
1745818540188,MCWP 40,B00,893304,Montejo; Carolina,20,0,20,0
1745818541215,MCWP 40R,A00,893757,Redela; Pamela Morgan,0,7,20,20
1745818542241,MCWP 50,A00,893758,Morshed; Michael James,2,0,20,18
1745818542241,MCWP 50,B00,893761,Bartulis; Jason Michael,17,0,20,3
1745818543270,MCWP 50R,A00,893766,Compas; Sean Matthew,0,1,20,20
1745818543270,MCWP 50R,B00,893769,Carter; Jennifer A,0,0,20,20
1745818543270,MCWP 50R,C00,893771,Krone; Jarret,0,3,20,20
1745818543270,MCWP 50R,D00,893772,Miller; Elizabeth Deen,3,0,20,17
1745818543270,MCWP 50R,E00,893775,Carter; Andrea L,0,0,20,20
1745818544296,MMW 11R,A01,892721,Herbst; Matthew,11,0,27,16
1745818544296,MMW 11R,A02,892722,Herbst; Matthew,0,0,0,3
1745818545325,MMW 12R,A01,892724,Herbst; Matthew,0,10,16,16
1745818545325,MMW 12R,A02,892725,Herbst; Matthew,0,9,16,16
1745818546354,MMW 13R,A01,892727,Staff,0,3,16,16
1745818546354,MMW 13R,A02,892728,Staff,0,4,16,16
1745818546354,MMW 13R,A03,958032,Staff,0,3,16,16
1745818546354,MMW 13R,A04,958033,Staff,0,2,16,16
1745818546354,MMW 13R,A05,958034,Staff,0,3,16,16
1745818547383,SIO 295LS,A00,894015,Staff,7,0,25,18
1745818548408,SIO 295S,A00,894020,Staff,7,0,25,18
1745818549434,SIOC 290S,B01,958918,Staff,0,0,0,0
1745818550460,SIOC 291S,B01,958922,Staff,0,0,0,0
1745818551485,SOCI 117,A01,895339,Staff,4,0,5,1
1745818552512,WES 237B,A00,894149,Staff,11,0,20,9
1745818554572,AESE 279B,A00,891859,Staff,13,0,35,22
1745818555598,AIP 197,001,891854,Staff,70,0,70,0
1745818556663,ANTH 289S,A00,891856,Gagneux; Pascal,12,0,12,0
1745818557690,BENG 196,001,957946,Engler; Adam J.,9996,0,9999,3
1745818558715,CAT 124RS,A01,956906,Staff,8,0,25,17
1745818559742,CAT 125RS,A01,922013,Staff,8,0,25,17
1745818560770,CLRE 250,A00,891860,Morris; Sheldon,9995,0,9999,4
1745818562819,CLRE 251R,A00,907817,Mehta; Ravindra L.,9994,0,9999,5
1745818563845,CLRE 252,A00,891864,Cuomo; Raphael Eduardo,9993,0,9999,6
1745818564873,CLRE 253,A00,891867,Vaida; Florin,9994,0,9999,5
1745818564873,CLRE 253,B00,907819,Staff,9999,0,9999,0
1745818565898,CLRE 259,A00,891868,Patel; Hemal,9998,0,9999,1
1745818566923,CLRE 260,A00,891872,Cuomo; Raphael Eduardo,9999,0,9999,0
1745818567948,CLRE 297,001,891888,Cuomo; Raphael Eduardo,9999,0,9999,0
1745818568973,CSE 191,A00,958773,Minnes Kemp; Mor Mia,9999,0,9999,0
1745818570004,CSS 201S,A01,892054,Mignozzetti; Umberto,30,0,30,0
1745818571033,CSS 202S,A01,892056,Mignozzetti; Umberto,30,0,30,0
1745818572058,DSC 197,001,956898,Eldridge; Justin Matthew,9998,0,9999,1
1745818573084,DSC 297,001,958000,Mazumdar; Arya,9998,0,9999,1
1745818574112,EAP 100,A00,905686,Staff,9776,0,9999,223
1745818575137,ECE 45,A01,892618,Staff,0,12,50,50
1745818576162,ECE 109,A01,892620,Staff,0,43,0,0
1745818577189,ECE 111,A01,892719,Staff,0,9,50,50
1745818578215,ECE 197,001,957920,Mercier; Patrick Philip,9992,0,9999,7
1745818579242,ECON 178,A01,907814,Zhu; Ying,28,0,35,7
1745818580269,EDS 115,A00,895312,Staff,41,0,45,4
1745818581294,EDS 117,A01,895337,Staff,30,0,30,0
1745818582322,EDS 125,A00,895341,Jones; Gabrielle Anastasia,43,0,45,2
1745818583350,EDS 128A,A01,895459,Fargason; Sharon Gayle,44,0,45,1
1745818584375,EDS 128B,A01,895543,Pappas; Elizabeth,44,0,45,1
1745818585402,EDS 139,A00,897203,Pappas; Elizabeth,44,0,45,1
1745818585402,EDS 139,B00,897209,Fargason; Sharon Gayle,44,0,45,1
1745818586431,EDS 201,A00,895545,Staff,43,0,45,2
1745818587457,EDS 203,A01,895581,Halter; Christopher P.,43,0,45,2
1745818588484,EDS 204R,A01,895625,Heinzman; Erica M.,43,0,45,2
1745818588484,EDS 204R,B01,895693,Halter; Christopher P.,18,0,45,27
1745818589513,EDS 206R,A00,895694,Fargason; Sharon Gayle,9,0,30,21
1745818589513,EDS 206R,B00,895695,Choi; Bailey Miyeon,20,0,30,10
1745818590538,EDS 250,A00,895697,Hemans; Patricia Ann Benitez,43,0,45,2
1745818591565,EDS 281,A00,895701,Meyerott; Theresa Ann,15,0,15,0
1745818592591,EDS 284,A00,895736,Meyerott; Theresa Ann,15,0,15,0
1745818593618,EDS 286,A00,897210,Fine; Sarah,15,0,15,0
1745818594643,EDS 289C,A01,895770,Daly; Alan J.,15,0,15,0
1745818595667,EDS 290,A00,897211,Hofstetter; Carolyn,15,0,15,0
1745818596694,LIGM 5A,A00,896162,Fischer-Grunski; Eva K,15,0,20,5
1745818597723,LIGM 5B,A00,896260,Fischer-Grunski; Eva K,17,0,20,3
1745818598748,LIGM 5C,A00,896308,Fischer-Grunski; Eva K,18,0,20,2
1745818599773,LIIT 5AS,A00,896313,Carnelos; Chiara,18,0,20,2
1745818600800,LIIT 5BS,A00,896416,Carnelos; Chiara,20,0,20,0
1745818601828,LIIT 5CS,A00,896564,Carnelos; Chiara,20,0,20,0
1745818602853,LISP 5A,A00,896588,Munoz Sanchez; Alicia,4,0,20,16
1745818603882,LISP 5B,A00,896653,Munoz Sanchez; Alicia,10,0,20,10
1745818604912,LISP 5C,A00,896655,Munoz Sanchez; Alicia,4,0,20,16
1745818605938,MAE 197,001,957918,Kleissl; Jan,9998,0,9999,1
1745818606963,MATH 2,A01,957937,Staff,34,0,35,1
1745818607987,MATH 197,001,957876,Kedlaya; Kiran S.,9993,0,9999,6
1745818609015,MCWP 40,A00,892729,Duru; Nur,13,0,20,7
1745818609015,MCWP 40,B00,893304,Montejo; Carolina,20,0,20,0
1745818610044,MCWP 40R,A00,893757,Redela; Pamela Morgan,0,7,20,20
1745818611069,MCWP 50,A00,893758,Morshed; Michael James,2,0,20,18
1745818611069,MCWP 50,B00,893761,Bartulis; Jason Michael,17,0,20,3
1745818612095,MCWP 50R,A00,893766,Compas; Sean Matthew,0,1,20,20
1745818612095,MCWP 50R,B00,893769,Carter; Jennifer A,0,0,20,20
1745818612095,MCWP 50R,C00,893771,Krone; Jarret,0,3,20,20
1745818612095,MCWP 50R,D00,893772,Miller; Elizabeth Deen,3,0,20,17
1745818612095,MCWP 50R,E00,893775,Carter; Andrea L,0,0,20,20
1745818613123,MMW 11R,A01,892721,Herbst; Matthew,11,0,27,16
1745818613123,MMW 11R,A02,892722,Herbst; Matthew,0,0,0,3
1745818614148,MMW 12R,A01,892724,Herbst; Matthew,0,10,16,16
1745818614148,MMW 12R,A02,892725,Herbst; Matthew,0,9,16,16
1745818615174,MMW 13R,A01,892727,Staff,0,3,16,16
1745818615174,MMW 13R,A02,892728,Staff,0,4,16,16
1745818615174,MMW 13R,A03,958032,Staff,0,3,16,16
1745818615174,MMW 13R,A04,958033,Staff,0,2,16,16
1745818615174,MMW 13R,A05,958034,Staff,0,3,16,16
1745818616200,SIO 295LS,A00,894015,Staff,7,0,25,18
1745818617230,SIO 295S,A00,894020,Staff,7,0,25,18
1745818618255,SIOC 290S,B01,958918,Staff,0,0,0,0
1745818619285,SIOC 291S,B01,958922,Staff,0,0,0,0
1745818620311,SOCI 117,A01,895339,Staff,4,0,5,1
1745818621339,WES 237B,A00,894149,Staff,11,0,20,9
1745818623405,AESE 279B,A00,891859,Staff,13,0,35,22
1745818624429,AIP 197,001,891854,Staff,70,0,70,0
1745818625457,ANTH 289S,A00,891856,Gagneux; Pascal,12,0,12,0
1745818626482,BENG 196,001,957946,Engler; Adam J.,9996,0,9999,3
1745818627508,CAT 124RS,A01,956906,Staff,8,0,25,17
1745818628534,CAT 125RS,A01,922013,Staff,8,0,25,17
1745818629562,CLRE 250,A00,891860,Morris; Sheldon,9995,0,9999,4
1745818631615,CLRE 251R,A00,907817,Mehta; Ravindra L.,9994,0,9999,5
1745818632645,CLRE 252,A00,891864,Cuomo; Raphael Eduardo,9993,0,9999,6
1745818633671,CLRE 253,A00,891867,Vaida; Florin,9994,0,9999,5
1745818633671,CLRE 253,B00,907819,Staff,9999,0,9999,0
1745818634701,CLRE 259,A00,891868,Patel; Hemal,9998,0,9999,1
1745818635727,CLRE 260,A00,891872,Cuomo; Raphael Eduardo,9999,0,9999,0
1745818636754,CLRE 297,001,891888,Cuomo; Raphael Eduardo,9999,0,9999,0
1745818637780,CSE 191,A00,958773,Minnes Kemp; Mor Mia,9999,0,9999,0
1745818638809,CSS 201S,A01,892054,Mignozzetti; Umberto,30,0,30,0
1745818639835,CSS 202S,A01,892056,Mignozzetti; Umberto,30,0,30,0
1745818640864,DSC 197,001,956898,Eldridge; Justin Matthew,9998,0,9999,1
1745818641888,DSC 297,001,958000,Mazumdar; Arya,9998,0,9999,1
1745818642914,EAP 100,A00,905686,Staff,9776,0,9999,223
1745818643938,ECE 45,A01,892618,Staff,0,12,50,50
1745818644966,ECE 109,A01,892620,Staff,0,43,0,0
1745818645991,ECE 111,A01,892719,Staff,0,9,50,50
1745818647017,ECE 197,001,957920,Mercier; Patrick Philip,9992,0,9999,7
1745818648045,ECON 178,A01,907814,Zhu; Ying,28,0,35,7
1745818649071,EDS 115,A00,895312,Staff,41,0,45,4
1745818650099,EDS 117,A01,895337,Staff,30,0,30,0
1745818651124,EDS 125,A00,895341,Jones; Gabrielle Anastasia,43,0,45,2
1745818652149,EDS 128A,A01,895459,Fargason; Sharon Gayle,44,0,45,1
1745818653176,EDS 128B,A01,895543,Pappas; Elizabeth,44,0,45,1
1745818654201,EDS 139,A00,897203,Pappas; Elizabeth,44,0,45,1
1745818654201,EDS 139,B00,897209,Fargason; Sharon Gayle,44,0,45,1
1745818655226,EDS 201,A00,895545,Staff,43,0,45,2
1745818656251,EDS 203,A01,895581,Halter; Christopher P.,43,0,45,2
1745818657274,EDS 204R,A01,895625,Heinzman; Erica M.,43,0,45,2
1745818657274,EDS 204R,B01,895693,Halter; Christopher P.,18,0,45,27
1745818658300,EDS 206R,A00,895694,Fargason; Sharon Gayle,9,0,30,21
1745818658300,EDS 206R,B00,895695,Choi; Bailey Miyeon,20,0,30,10
1745818659326,EDS 250,A00,895697,Hemans; Patricia Ann Benitez,43,0,45,2
1745818660355,EDS 281,A00,895701,Meyerott; Theresa Ann,15,0,15,0
1745818661380,EDS 284,A00,895736,Meyerott; Theresa Ann,15,0,15,0
1745818662405,EDS 286,A00,897210,Fine; Sarah,15,0,15,0
1745818663434,EDS 289C,A01,895770,Daly; Alan J.,15,0,15,0
1745818664462,EDS 290,A00,897211,Hofstetter; Carolyn,15,0,15,0
1745818665488,LIGM 5A,A00,896162,Fischer-Grunski; Eva K,15,0,20,5
1745818666512,LIGM 5B,A00,896260,Fischer-Grunski; Eva K,17,0,20,3
1745818667539,LIGM 5C,A00,896308,Fischer-Grunski; Eva K,18,0,20,2
1745818668566,LIIT 5AS,A00,896313,Carnelos; Chiara,18,0,20,2
1745818669591,LIIT 5BS,A00,896416,Carnelos; Chiara,20,0,20,0
1745818670620,LIIT 5CS,A00,896564,Carnelos; Chiara,20,0,20,0
1745818671647,LISP 5A,A00,896588,Munoz Sanchez; Alicia,4,0,20,16
1745818672673,LISP 5B,A00,896653,Munoz Sanchez; Alicia,10,0,20,10
1745818673701,LISP 5C,A00,896655,Munoz Sanchez; Alicia,4,0,20,16
1745818674727,MAE 197,001,957918,Kleissl; Jan,9998,0,9999,1
1745818675752,MATH 2,A01,957937,Staff,34,0,35,1
1745818676777,MATH 197,001,957876,Kedlaya; Kiran S.,9993,0,9999,6
1745818677805,MCWP 40,A00,892729,Duru; Nur,13,0,20,7
1745818677805,MCWP 40,B00,893304,Montejo; Carolina,20,0,20,0
1745818678831,MCWP 40R,A00,893757,Redela; Pamela Morgan,0,7,20,20
1745818679861,MCWP 50,A00,893758,Morshed; Michael James,2,0,20,18
1745818679861,MCWP 50,B00,893761,Bartulis; Jason Michael,17,0,20,3
1745818680888,MCWP 50R,A00,893766,Compas; Sean Matthew,0,1,20,20
1745818680888,MCWP 50R,B00,893769,Carter; Jennifer A,0,0,20,20
1745818680888,MCWP 50R,C00,893771,Krone; Jarret,0,3,20,20
1745818680888,MCWP 50R,D00,893772,Miller; Elizabeth Deen,3,0,20,17
1745818680888,MCWP 50R,E00,893775,Carter; Andrea L,0,0,20,20
1745818681913,MMW 11R,A01,892721,Herbst; Matthew,11,0,27,16
1745818681913,MMW 11R,A02,892722,Herbst; Matthew,0,0,0,3
1745818682939,MMW 12R,A01,892724,Herbst; Matthew,0,10,16,16
1745818682939,MMW 12R,A02,892725,Herbst; Matthew,0,9,16,16
1745818683965,MMW 13R,A01,892727,Staff,0,3,16,16
1745818683965,MMW 13R,A02,892728,Staff,0,4,16,16
1745818683965,MMW 13R,A03,958032,Staff,0,3,16,16
1745818683965,MMW 13R,A04,958033,Staff,0,2,16,16
1745818683965,MMW 13R,A05,958034,Staff,0,3,16,16
1745818684994,SIO 295LS,A00,894015,Staff,7,0,25,18
1745818686023,SIO 295S,A00,894020,Staff,7,0,25,18
1745818687047,SIOC 290S,B01,958918,Staff,0,0,0,0
1745818688076,SIOC 291S,B01,958922,Staff,0,0,0,0
1745818689101,SOCI 117,A01,895339,Staff,4,0,5,1
1745818690126,WES 237B,A00,894149,Staff,11,0,20,9
1745818692194,AESE 279B,A00,891859,Staff,13,0,35,22
1745818693222,AIP 197,001,891854,Staff,70,0,70,0
1745818694248,ANTH 289S,A00,891856,Gagneux; Pascal,12,0,12,0
1745818695274,BENG 196,001,957946,Engler; Adam J.,9996,0,9999,3
1745818696301,CAT 124RS,A01,956906,Staff,8,0,25,17
1745818697326,CAT 125RS,A01,922013,Staff,8,0,25,17
1745818698352,CLRE 250,A00,891860,Morris; Sheldon,9995,0,9999,4
1745818700406,CLRE 251R,A00,907817,Mehta; Ravindra L.,9994,0,9999,5
1745818701431,CLRE 252,A00,891864,Cuomo; Raphael Eduardo,9993,0,9999,6
1745818702460,CLRE 253,A00,891867,Vaida; Florin,9994,0,9999,5
1745818702460,CLRE 253,B00,907819,Staff,9999,0,9999,0
1745818703485,CLRE 259,A00,891868,Patel; Hemal,9998,0,9999,1
1745818704511,CLRE 260,A00,891872,Cuomo; Raphael Eduardo,9999,0,9999,0
1745818705539,CLRE 297,001,891888,Cuomo; Raphael Eduardo,9999,0,9999,0
1745818706565,CSE 191,A00,958773,Minnes Kemp; Mor Mia,9999,0,9999,0
1745818707592,CSS 201S,A01,892054,Mignozzetti; Umberto,30,0,30,0
1745818708620,CSS 202S,A01,892056,Mignozzetti; Umberto,30,0,30,0
1745818709646,DSC 197,001,956898,Eldridge; Justin Matthew,9998,0,9999,1
1745818710673,DSC 297,001,958000,Mazumdar; Arya,9998,0,9999,1
1745818711697,EAP 100,A00,905686,Staff,9776,0,9999,223
1745818712724,ECE 45,A01,892618,Staff,0,12,50,50
1745818713749,ECE 109,A01,892620,Staff,0,43,0,0
1745818714776,ECE 111,A01,892719,Staff,0,9,50,50
1745818715802,ECE 197,001,957920,Mercier; Patrick Philip,9992,0,9999,7
1745818716830,ECON 178,A01,907814,Zhu; Ying,28,0,35,7
1745818717857,EDS 115,A00,895312,Staff,41,0,45,4
1745818718905,EDS 117,A01,895337,Staff,30,0,30,0
1745818719934,EDS 125,A00,895341,Jones; Gabrielle Anastasia,43,0,45,2
1745818720964,EDS 128A,A01,895459,Fargason; Sharon Gayle,44,0,45,1
1745818721990,EDS 128B,A01,895543,Pappas; Elizabeth,44,0,45,1
1745818723018,EDS 139,A00,897203,Pappas; Elizabeth,44,0,45,1
1745818723018,EDS 139,B00,897209,Fargason; Sharon Gayle,44,0,45,1
1745818724043,EDS 201,A00,895545,Staff,43,0,45,2
1745818725070,EDS 203,A01,895581,Halter; Christopher P.,43,0,45,2
1745818726098,EDS 204R,A01,895625,Heinzman; Erica M.,43,0,45,2
1745818726098,EDS 204R,B01,895693,Halter; Christopher P.,18,0,45,27
1745818727124,EDS 206R,A00,895694,Fargason; Sharon Gayle,9,0,30,21
1745818727124,EDS 206R,B00,895695,Choi; Bailey Miyeon,20,0,30,10
1745818728149,EDS 250,A00,895697,Hemans; Patricia Ann Benitez,43,0,45,2
1745818729175,EDS 281,A00,895701,Meyerott; Theresa Ann,15,0,15,0
1745818730201,EDS 284,A00,895736,Meyerott; Theresa Ann,15,0,15,0
1745818731226,EDS 286,A00,897210,Fine; Sarah,15,0,15,0
1745818732255,EDS 289C,A01,895770,Daly; Alan J.,15,0,15,0
1745818733283,EDS 290,A00,897211,Hofstetter; Carolyn,15,0,15,0
1745818734310,LIGM 5A,A00,896162,Fischer-Grunski; Eva K,15,0,20,5
1745818735340,LIGM 5B,A00,896260,Fischer-Grunski; Eva K,17,0,20,3
1745818736372,LIGM 5C,A00,896308,Fischer-Grunski; Eva K,18,0,20,2
1745818737399,LIIT 5AS,A00,896313,Carnelos; Chiara,18,0,20,2
1745818738425,LIIT 5BS,A00,896416,Carnelos; Chiara,20,0,20,0
1745818739451,LIIT 5CS,A00,896564,Carnelos; Chiara,20,0,20,0
1745818740477,LISP 5A,A00,896588,Munoz Sanchez; Alicia,4,0,20,16
1745818741514,LISP 5B,A00,896653,Munoz Sanchez; Alicia,10,0,20,10
1745818742543,LISP 5C,A00,896655,Munoz Sanchez; Alicia,4,0,20,16
1745818743569,MAE 197,001,957918,Kleissl; Jan,9998,0,9999,1
1745818744598,MATH 2,A01,957937,Staff,34,0,35,1
1745818745625,MATH 197,001,957876,Kedlaya; Kiran S.,9993,0,9999,6
1745818746651,MCWP 40,A00,892729,Duru; Nur,13,0,20,7
1745818746651,MCWP 40,B00,893304,Montejo; Carolina,20,0,20,0
1745818747677,MCWP 40R,A00,893757,Redela; Pamela Morgan,0,7,20,20
1745818748706,MCWP 50,A00,893758,Morshed; Michael James,2,0,20,18
1745818748706,MCWP 50,B00,893761,Bartulis; Jason Michael,17,0,20,3
1745818749734,MCWP 50R,A00,893766,Compas; Sean Matthew,0,1,20,20
1745818749734,MCWP 50R,B00,893769,Carter; Jennifer A,0,0,20,20
1745818749734,MCWP 50R,C00,893771,Krone; Jarret,0,3,20,20
1745818749734,MCWP 50R,D00,893772,Miller; Elizabeth Deen,3,0,20,17
1745818749734,MCWP 50R,E00,893775,Carter; Andrea L,0,0,20,20
1745818750759,MMW 11R,A01,892721,Herbst; Matthew,11,0,27,16
1745818750759,MMW 11R,A02,892722,Herbst; Matthew,0,0,0,3
1745818751785,MMW 12R,A01,892724,Herbst; Matthew,0,10,16,16
1745818751785,MMW 12R,A02,892725,Herbst; Matthew,0,9,16,16
1745818752811,MMW 13R,A01,892727,Staff,0,3,16,16
1745818752811,MMW 13R,A02,892728,Staff,0,4,16,16
1745818752811,MMW 13R,A03,958032,Staff,0,3,16,16
1745818752811,MMW 13R,A04,958033,Staff,0,2,16,16
1745818752811,MMW 13R,A05,958034,Staff,0,3,16,16
1745818753835,SIO 295LS,A00,894015,Staff,7,0,25,18
1745818754861,SIO 295S,A00,894020,Staff,7,0,25,18
1745818755886,SIOC 290S,B01,958918,Staff,0,0,0,0
1745818756912,SIOC 291S,B01,958922,Staff,0,0,0,0
1745818757940,SOCI 117,A01,895339,Staff,4,0,5,1
1745818758966,WES 237B,A00,894149,Staff,11,0,20,9
1745818761027,AESE 279B,A00,891859,Staff,13,0,35,22
1745818762053,AIP 197,001,891854,Staff,70,0,70,0
1745818763077,ANTH 289S,A00,891856,Gagneux; Pascal,12,0,12,0
1745818764106,BENG 196,001,957946,Engler; Adam J.,9996,0,9999,3
1745818765131,CAT 124RS,A01,956906,Staff,8,0,25,17
1745818766157,CAT 125RS,A01,922013,Staff,8,0,25,17
1745818767185,CLRE 250,A00,891860,Morris; Sheldon,9995,0,9999,4
1745818769239,CLRE 251R,A00,907817,Mehta; Ravindra L.,9994,0,9999,5
1745818770268,CLRE 252,A00,891864,Cuomo; Raphael Eduardo,9993,0,9999,6
1745818771296,CLRE 253,A00,891867,Vaida; Florin,9994,0,9999,5
1745818771296,CLRE 253,B00,907819,Staff,9999,0,9999,0
1745818772324,CLRE 259,A00,891868,Patel; Hemal,9998,0,9999,1
1745818773352,CLRE 260,A00,891872,Cuomo; Raphael Eduardo,9999,0,9999,0
1745818774381,CLRE 297,001,891888,Cuomo; Raphael Eduardo,9999,0,9999,0
1745818775406,CSE 191,A00,958773,Minnes Kemp; Mor Mia,9999,0,9999,0
1745818776432,CSS 201S,A01,892054,Mignozzetti; Umberto,30,0,30,0
1745818777461,CSS 202S,A01,892056,Mignozzetti; Umberto,30,0,30,0
1745818778487,DSC 197,001,956898,Eldridge; Justin Matthew,9998,0,9999,1
1745818779514,DSC 297,001,958000,Mazumdar; Arya,9998,0,9999,1
1745818780540,EAP 100,A00,905686,Staff,9776,0,9999,223
1745818781571,ECE 45,A01,892618,Staff,0,12,50,50
1745818782597,ECE 109,A01,892620,Staff,0,43,0,0
1745818783625,ECE 111,A01,892719,Staff,0,9,50,50
1745818784652,ECE 197,001,957920,Mercier; Patrick Philip,9992,0,9999,7
1745818785684,ECON 178,A01,907814,Zhu; Ying,28,0,35,7
1745818786710,EDS 115,A00,895312,Staff,41,0,45,4
1745818787737,EDS 117,A01,895337,Staff,30,0,30,0
1745818788766,EDS 125,A00,895341,Jones; Gabrielle Anastasia,43,0,45,2
1745818789791,EDS 128A,A01,895459,Fargason; Sharon Gayle,44,0,45,1
1745818790819,EDS 128B,A01,895543,Pappas; Elizabeth,44,0,45,1
1745818791870,EDS 139,A00,897203,Pappas; Elizabeth,44,0,45,1
1745818791870,EDS 139,B00,897209,Fargason; Sharon Gayle,44,0,45,1
1745818792898,EDS 201,A00,895545,Staff,43,0,45,2
1745818793926,EDS 203,A01,895581,Halter; Christopher P.,43,0,45,2
1745818794954,EDS 204R,A01,895625,Heinzman; Erica M.,43,0,45,2
1745818794954,EDS 204R,B01,895693,Halter; Christopher P.,18,0,45,27
1745818795983,EDS 206R,A00,895694,Fargason; Sharon Gayle,9,0,30,21
1745818795983,EDS 206R,B00,895695,Choi; Bailey Miyeon,20,0,30,10
1745818797009,EDS 250,A00,895697,Hemans; Patricia Ann Benitez,43,0,45,2
1745818798033,EDS 281,A00,895701,Meyerott; Theresa Ann,15,0,15,0
1745818799058,EDS 284,A00,895736,Meyerott; Theresa Ann,15,0,15,0
1745818800084,EDS 286,A00,897210,Fine; Sarah,15,0,15,0
1745818801111,EDS 289C,A01,895770,Daly; Alan J.,15,0,15,0
1745818802135,EDS 290,A00,897211,Hofstetter; Carolyn,15,0,15,0
1745818803169,LIGM 5A,A00,896162,Fischer-Grunski; Eva K,15,0,20,5
1745818804199,LIGM 5B,A00,896260,Fischer-Grunski; Eva K,17,0,20,3
1745818805228,LIGM 5C,A00,896308,Fischer-Grunski; Eva K,18,0,20,2
1745818806257,LIIT 5AS,A00,896313,Carnelos; Chiara,18,0,20,2
1745818807286,LIIT 5BS,A00,896416,Carnelos; Chiara,20,0,20,0
1745818808313,LIIT 5CS,A00,896564,Carnelos; Chiara,20,0,20,0
1745818809338,LISP 5A,A00,896588,Munoz Sanchez; Alicia,4,0,20,16
1745818810364,LISP 5B,A00,896653,Munoz Sanchez; Alicia,10,0,20,10
1745818811389,LISP 5C,A00,896655,Munoz Sanchez; Alicia,4,0,20,16
1745818812416,MAE 197,001,957918,Kleissl; Jan,9998,0,9999,1
1745818813444,MATH 2,A01,957937,Staff,34,0,35,1
1745818814469,MATH 197,001,957876,Kedlaya; Kiran S.,9993,0,9999,6
1745818815495,MCWP 40,A00,892729,Duru; Nur,13,0,20,7
1745818815495,MCWP 40,B00,893304,Montejo; Carolina,20,0,20,0
1745818816526,MCWP 40R,A00,893757,Redela; Pamela Morgan,0,7,20,20
1745818817566,MCWP 50,A00,893758,Morshed; Michael James,2,0,20,18
1745818817566,MCWP 50,B00,893761,Bartulis; Jason Michael,17,0,20,3
1745818818594,MCWP 50R,A00,893766,Compas; Sean Matthew,0,1,20,20
1745818818594,MCWP 50R,B00,893769,Carter; Jennifer A,0,0,20,20
1745818818594,MCWP 50R,C00,893771,Krone; Jarret,0,3,20,20
1745818818594,MCWP 50R,D00,893772,Miller; Elizabeth Deen,3,0,20,17
1745818818594,MCWP 50R,E00,893775,Carter; Andrea L,0,0,20,20
1745818819622,MMW 11R,A01,892721,Herbst; Matthew,11,0,27,16
1745818819622,MMW 11R,A02,892722,Herbst; Matthew,0,0,0,3
1745818820647,MMW 12R,A01,892724,Herbst; Matthew,0,10,16,16
1745818820647,MMW 12R,A02,892725,Herbst; Matthew,0,9,16,16
1745818821674,MMW 13R,A01,892727,Staff,0,3,16,16
1745818821674,MMW 13R,A02,892728,Staff,0,4,16,16
1745818821674,MMW 13R,A03,958032,Staff,0,3,16,16
1745818821674,MMW 13R,A04,958033,Staff,0,2,16,16
1745818821674,MMW 13R,A05,958034,Staff,0,3,16,16
1745818822702,SIO 295LS,A00,894015,Staff,7,0,25,18
1745818823727,SIO 295S,A00,894020,Staff,7,0,25,18
1745818824753,SIOC 290S,B01,958918,Staff,0,0,0,0
1745818825779,SIOC 291S,B01,958922,Staff,0,0,0,0
1745818826804,SOCI 117,A01,895339,Staff,4,0,5,1
1745818827830,WES 237B,A00,894149,Staff,11,0,20,9
1745818829885,AESE 279B,A00,891859,Staff,13,0,35,22
1745818830911,AIP 197,001,891854,Staff,70,0,70,0
1745818831939,ANTH 289S,A00,891856,Gagneux; Pascal,12,0,12,0
1745818832963,BENG 196,001,957946,Engler; Adam J.,9996,0,9999,3
1745818833991,CAT 124RS,A01,956906,Staff,8,0,25,17
1745818835017,CAT 125RS,A01,922013,Staff,8,0,25,17
1745818836044,CLRE 250,A00,891860,Morris; Sheldon,9995,0,9999,4
1745818838096,CLRE 251R,A00,907817,Mehta; Ravindra L.,9994,0,9999,5
1745818839124,CLRE 252,A00,891864,Cuomo; Raphael Eduardo,9993,0,9999,6
1745818840149,CLRE 253,A00,891867,Vaida; Florin,9994,0,9999,5
1745818840149,CLRE 253,B00,907819,Staff,9999,0,9999,0
1745818841176,CLRE 259,A00,891868,Patel; Hemal,9998,0,9999,1
1745818842203,CLRE 260,A00,891872,Cuomo; Raphael Eduardo,9999,0,9999,0
1745818843230,CLRE 297,001,891888,Cuomo; Raphael Eduardo,9999,0,9999,0
1745818844255,CSE 191,A00,958773,Minnes Kemp; Mor Mia,9999,0,9999,0
1745818845281,CSS 201S,A01,892054,Mignozzetti; Umberto,30,0,30,0
1745818846316,CSS 202S,A01,892056,Mignozzetti; Umberto,30,0,30,0
1745818847342,DSC 197,001,956898,Eldridge; Justin Matthew,9998,0,9999,1
1745818848366,DSC 297,001,958000,Mazumdar; Arya,9998,0,9999,1
1745818849391,EAP 100,A00,905686,Staff,9776,0,9999,223
1745818850416,ECE 45,A01,892618,Staff,0,12,50,50
1745818851444,ECE 109,A01,892620,Staff,0,43,0,0
1745818852470,ECE 111,A01,892719,Staff,0,9,50,50
1745818853494,ECE 197,001,957920,Mercier; Patrick Philip,9992,0,9999,7
1745818854520,ECON 178,A01,907814,Zhu; Ying,28,0,35,7
1745818855542,EDS 115,A00,895312,Staff,41,0,45,4
1745818856566,EDS 117,A01,895337,Staff,30,0,30,0
1745818857595,EDS 125,A00,895341,Jones; Gabrielle Anastasia,43,0,45,2
1745818858623,EDS 128A,A01,895459,Fargason; Sharon Gayle,44,0,45,1
1745818859651,EDS 128B,A01,895543,Pappas; Elizabeth,44,0,45,1
1745818860675,EDS 139,A00,897203,Pappas; Elizabeth,44,0,45,1
1745818860675,EDS 139,B00,897209,Fargason; Sharon Gayle,44,0,45,1
1745818861699,EDS 201,A00,895545,Staff,43,0,45,2
1745818862725,EDS 203,A01,895581,Halter; Christopher P.,43,0,45,2
1745818863753,EDS 204R,A01,895625,Heinzman; Erica M.,43,0,45,2
1745818863753,EDS 204R,B01,895693,Halter; Christopher P.,18,0,45,27
1745818864778,EDS 206R,A00,895694,Fargason; Sharon Gayle,9,0,30,21
1745818864778,EDS 206R,B00,895695,Choi; Bailey Miyeon,20,0,30,10
1745818865804,EDS 250,A00,895697,Hemans; Patricia Ann Benitez,43,0,45,2
1745818866829,EDS 281,A00,895701,Meyerott; Theresa Ann,15,0,15,0
1745818867855,EDS 284,A00,895736,Meyerott; Theresa Ann,15,0,15,0
1745818868880,EDS 286,A00,897210,Fine; Sarah,15,0,15,0
1745818869905,EDS 289C,A01,895770,Daly; Alan J.,15,0,15,0
1745818870931,EDS 290,A00,897211,Hofstetter; Carolyn,15,0,15,0
1745818871958,LIGM 5A,A00,896162,Fischer-Grunski; Eva K,15,0,20,5
1745818872984,LIGM 5B,A00,896260,Fischer-Grunski; Eva K,17,0,20,3
1745818874014,LIGM 5C,A00,896308,Fischer-Grunski; Eva K,18,0,20,2
1745818875045,LIIT 5AS,A00,896313,Carnelos; Chiara,18,0,20,2
1745818876071,LIIT 5BS,A00,896416,Carnelos; Chiara,20,0,20,0
1745818877101,LIIT 5CS,A00,896564,Carnelos; Chiara,20,0,20,0
1745818878127,LISP 5A,A00,896588,Munoz Sanchez; Alicia,4,0,20,16
1745818879155,LISP 5B,A00,896653,Munoz Sanchez; Alicia,10,0,20,10
1745818880182,LISP 5C,A00,896655,Munoz Sanchez; Alicia,4,0,20,16
1745818881207,MAE 197,001,957918,Kleissl; Jan,9998,0,9999,1
1745818882235,MATH 2,A01,957937,Staff,34,0,35,1
1745818883266,MATH 197,001,957876,Kedlaya; Kiran S.,9993,0,9999,6
1745818884296,MCWP 40,A00,892729,Duru; Nur,13,0,20,7
1745818884296,MCWP 40,B00,893304,Montejo; Carolina,20,0,20,0
1745818885324,MCWP 40R,A00,893757,Redela; Pamela Morgan,0,7,20,20
1745818886355,MCWP 50,A00,893758,Morshed; Michael James,2,0,20,18
1745818886355,MCWP 50,B00,893761,Bartulis; Jason Michael,17,0,20,3
1745818887383,MCWP 50R,A00,893766,Compas; Sean Matthew,0,1,20,20
1745818887383,MCWP 50R,B00,893769,Carter; Jennifer A,0,0,20,20
1745818887383,MCWP 50R,C00,893771,Krone; Jarret,0,3,20,20
1745818887383,MCWP 50R,D00,893772,Miller; Elizabeth Deen,3,0,20,17
1745818887383,MCWP 50R,E00,893775,Carter; Andrea L,0,0,20,20
1745818888411,MMW 11R,A01,892721,Herbst; Matthew,11,0,27,16
1745818888411,MMW 11R,A02,892722,Herbst; Matthew,0,0,0,3
1745818889438,MMW 12R,A01,892724,Herbst; Matthew,0,10,16,16
1745818889438,MMW 12R,A02,892725,Herbst; Matthew,0,9,16,16
1745818890464,MMW 13R,A01,892727,Staff,0,3,16,16
1745818890464,MMW 13R,A02,892728,Staff,0,4,16,16
1745818890464,MMW 13R,A03,958032,Staff,0,3,16,16
1745818890464,MMW 13R,A04,958033,Staff,0,2,16,16
1745818890464,MMW 13R,A05,958034,Staff,0,3,16,16
1745818891489,SIO 295LS,A00,894015,Staff,7,0,25,18
1745818892515,SIO 295S,A00,894020,Staff,7,0,25,18
1745818893543,SIOC 290S,B01,958918,Staff,0,0,0,0
1745818894571,SIOC 291S,B01,958922,Staff,0,0,0,0
1745818895597,SOCI 117,A01,895339,Staff,4,0,5,1
1745818896625,WES 237B,A00,894149,Staff,11,0,20,9
1745818898693,AESE 279B,A00,891859,Staff,13,0,35,22
1745818899721,AIP 197,001,891854,Staff,70,0,70,0
1745818900744,ANTH 289S,A00,891856,Gagneux; Pascal,12,0,12,0
1745818901772,BENG 196,001,957946,Engler; Adam J.,9996,0,9999,3
1745818902798,CAT 124RS,A01,956906,Staff,8,0,25,17
1745818903824,CAT 125RS,A01,922013,Staff,8,0,25,17
1745818904849,CLRE 250,A00,891860,Morris; Sheldon,9995,0,9999,4
1745818906901,CLRE 251R,A00,907817,Mehta; Ravindra L.,9994,0,9999,5
1745818907924,CLRE 252,A00,891864,Cuomo; Raphael Eduardo,9993,0,9999,6
1745818908948,CLRE 253,A00,891867,Vaida; Florin,9994,0,9999,5
1745818908948,CLRE 253,B00,907819,Staff,9999,0,9999,0
1745818909977,CLRE 259,A00,891868,Patel; Hemal,9998,0,9999,1
1745818911002,CLRE 260,A00,891872,Cuomo; Raphael Eduardo,9999,0,9999,0
1745818912027,CLRE 297,001,891888,Cuomo; Raphael Eduardo,9999,0,9999,0
1745818913053,CSE 191,A00,958773,Minnes Kemp; Mor Mia,9999,0,9999,0
1745818914082,CSS 201S,A01,892054,Mignozzetti; Umberto,30,0,30,0
1745818915107,CSS 202S,A01,892056,Mignozzetti; Umberto,30,0,30,0
1745818916136,DSC 197,001,956898,Eldridge; Justin Matthew,9998,0,9999,1
1745818917162,DSC 297,001,958000,Mazumdar; Arya,9998,0,9999,1
1745818918190,EAP 100,A00,905686,Staff,9776,0,9999,223
1745818919219,ECE 45,A01,892618,Staff,0,12,50,50
1745818920247,ECE 109,A01,892620,Staff,0,43,0,0
1745818921275,ECE 111,A01,892719,Staff,0,9,50,50
1745818922301,ECE 197,001,957920,Mercier; Patrick Philip,9992,0,9999,7
1745818923330,ECON 178,A01,907814,Zhu; Ying,28,0,35,7
1745818924354,EDS 115,A00,895312,Staff,41,0,45,4
1745818925383,EDS 117,A01,895337,Staff,30,0,30,0
1745818926409,EDS 125,A00,895341,Jones; Gabrielle Anastasia,43,0,45,2
1745818927435,EDS 128A,A01,895459,Fargason; Sharon Gayle,44,0,45,1
1745818928462,EDS 128B,A01,895543,Pappas; Elizabeth,44,0,45,1
1745818929489,EDS 139,A00,897203,Pappas; Elizabeth,44,0,45,1
1745818929489,EDS 139,B00,897209,Fargason; Sharon Gayle,44,0,45,1
1745818930515,EDS 201,A00,895545,Staff,43,0,45,2
1745818931541,EDS 203,A01,895581,Halter; Christopher P.,43,0,45,2
1745818932570,EDS 204R,A01,895625,Heinzman; Erica M.,43,0,45,2
1745818932570,EDS 204R,B01,895693,Halter; Christopher P.,18,0,45,27
1745818933595,EDS 206R,A00,895694,Fargason; Sharon Gayle,9,0,30,21
1745818933595,EDS 206R,B00,895695,Choi; Bailey Miyeon,20,0,30,10
1745818934623,EDS 250,A00,895697,Hemans; Patricia Ann Benitez,43,0,45,2
1745818935651,EDS 281,A00,895701,Meyerott; Theresa Ann,15,0,15,0
1745818936676,EDS 284,A00,895736,Meyerott; Theresa Ann,15,0,15,0
1745818937701,EDS 286,A00,897210,Fine; Sarah,15,0,15,0
1745818938728,EDS 289C,A01,895770,Daly; Alan J.,15,0,15,0
1745818939757,EDS 290,A00,897211,Hofstetter; Carolyn,15,0,15,0
1745818940785,LIGM 5A,A00,896162,Fischer-Grunski; Eva K,15,0,20,5
1745818941812,LIGM 5B,A00,896260,Fischer-Grunski; Eva K,17,0,20,3
1745818942842,LIGM 5C,A00,896308,Fischer-Grunski; Eva K,18,0,20,2
1745818943871,LIIT 5AS,A00,896313,Carnelos; Chiara,18,0,20,2
1745818944897,LIIT 5BS,A00,896416,Carnelos; Chiara,20,0,20,0
1745818945925,LIIT 5CS,A00,896564,Carnelos; Chiara,20,0,20,0
1745818946966,LISP 5A,A00,896588,Munoz Sanchez; Alicia,4,0,20,16
1745818947992,LISP 5B,A00,896653,Munoz Sanchez; Alicia,10,0,20,10
1745818949018,LISP 5C,A00,896655,Munoz Sanchez; Alicia,4,0,20,16
1745818950046,MAE 197,001,957918,Kleissl; Jan,9998,0,9999,1
1745818951070,MATH 2,A01,957937,Staff,34,0,35,1
1745818952096,MATH 197,001,957876,Kedlaya; Kiran S.,9993,0,9999,6
1745818953123,MCWP 40,A00,892729,Duru; Nur,13,0,20,7
1745818953123,MCWP 40,B00,893304,Montejo; Carolina,20,0,20,0
1745818954152,MCWP 40R,A00,893757,Redela; Pamela Morgan,0,7,20,20
1745818955182,MCWP 50,A00,893758,Morshed; Michael James,2,0,20,18
1745818955182,MCWP 50,B00,893761,Bartulis; Jason Michael,17,0,20,3
1745818956212,MCWP 50R,A00,893766,Compas; Sean Matthew,0,1,20,20
1745818956212,MCWP 50R,B00,893769,Carter; Jennifer A,0,0,20,20
1745818956212,MCWP 50R,C00,893771,Krone; Jarret,0,3,20,20
1745818956212,MCWP 50R,D00,893772,Miller; Elizabeth Deen,3,0,20,17
1745818956212,MCWP 50R,E00,893775,Carter; Andrea L,0,0,20,20
1745818957236,MMW 11R,A01,892721,Herbst; Matthew,11,0,27,16
1745818957236,MMW 11R,A02,892722,Herbst; Matthew,0,0,0,3
1745818958264,MMW 12R,A01,892724,Herbst; Matthew,0,10,16,16
1745818958264,MMW 12R,A02,892725,Herbst; Matthew,0,9,16,16
1745818959290,MMW 13R,A01,892727,Staff,0,3,16,16
1745818959290,MMW 13R,A02,892728,Staff,0,4,16,16
1745818959290,MMW 13R,A03,958032,Staff,0,3,16,16
1745818959290,MMW 13R,A04,958033,Staff,0,2,16,16
1745818959290,MMW 13R,A05,958034,Staff,0,3,16,16
1745818960319,SIO 295LS,A00,894015,Staff,7,0,25,18
1745818961345,SIO 295S,A00,894020,Staff,7,0,25,18
1745818962370,SIOC 290S,B01,958918,Staff,0,0,0,0
1745818963399,SIOC 291S,B01,958922,Staff,0,0,0,0
1745818964424,SOCI 117,A01,895339,Staff,4,0,5,1
1745818965448,WES 237B,A00,894149,Staff,11,0,20,9
1745818967506,AESE 279B,A00,891859,Staff,13,0,35,22
1745818968530,AIP 197,001,891854,Staff,70,0,70,0
1745818969556,ANTH 289S,A00,891856,Gagneux; Pascal,12,0,12,0
1745818970586,BENG 196,001,957946,Engler; Adam J.,9996,0,9999,3
1745818971613,CAT 124RS,A01,956906,Staff,8,0,25,17
1745818972639,CAT 125RS,A01,922013,Staff,8,0,25,17
1745818973667,CLRE 250,A00,891860,Morris; Sheldon,9995,0,9999,4
1745818975726,CLRE 251R,A00,907817,Mehta; Ravindra L.,9994,0,9999,5
1745818976756,CLRE 252,A00,891864,Cuomo; Raphael Eduardo,9993,0,9999,6
1745818977785,CLRE 253,A00,891867,Vaida; Florin,9994,0,9999,5
1745818977785,CLRE 253,B00,907819,Staff,9999,0,9999,0
1745818978815,CLRE 259,A00,891868,Patel; Hemal,9998,0,9999,1
1745818979840,CLRE 260,A00,891872,Cuomo; Raphael Eduardo,9999,0,9999,0
1745818980870,CLRE 297,001,891888,Cuomo; Raphael Eduardo,9999,0,9999,0
1745818981896,CSE 191,A00,958773,Minnes Kemp; Mor Mia,9999,0,9999,0
1745818982925,CSS 201S,A01,892054,Mignozzetti; Umberto,30,0,30,0
1745818983955,CSS 202S,A01,892056,Mignozzetti; Umberto,30,0,30,0
1745818984979,DSC 197,001,956898,Eldridge; Justin Matthew,9998,0,9999,1
1745818986007,DSC 297,001,958000,Mazumdar; Arya,9998,0,9999,1
1745818987032,EAP 100,A00,905686,Staff,9776,0,9999,223
1745818988062,ECE 45,A01,892618,Staff,0,12,50,50
1745818989089,ECE 109,A01,892620,Staff,0,43,0,0
1745818990120,ECE 111,A01,892719,Staff,0,9,50,50
1745818991147,ECE 197,001,957920,Mercier; Patrick Philip,9992,0,9999,7
1745818992174,ECON 178,A01,907814,Zhu; Ying,28,0,35,7
1745818993199,EDS 115,A00,895312,Staff,41,0,45,4
1745818994225,EDS 117,A01,895337,Staff,30,0,30,0
1745818995249,EDS 125,A00,895341,Jones; Gabrielle Anastasia,43,0,45,2
1745818996275,EDS 128A,A01,895459,Fargason; Sharon Gayle,44,0,45,1
1745818997305,EDS 128B,A01,895543,Pappas; Elizabeth,44,0,45,1
1745818998332,EDS 139,A00,897203,Pappas; Elizabeth,44,0,45,1
1745818998332,EDS 139,B00,897209,Fargason; Sharon Gayle,44,0,45,1
1745818999356,EDS 201,A00,895545,Staff,43,0,45,2
1745819000384,EDS 203,A01,895581,Halter; Christopher P.,43,0,45,2
1745819001413,EDS 204R,A01,895625,Heinzman; Erica M.,43,0,45,2
1745819001413,EDS 204R,B01,895693,Halter; Christopher P.,18,0,45,27
1745819002439,EDS 206R,A00,895694,Fargason; Sharon Gayle,9,0,30,21
1745819002439,EDS 206R,B00,895695,Choi; Bailey Miyeon,20,0,30,10
1745819003468,EDS 250,A00,895697,Hemans; Patricia Ann Benitez,43,0,45,2
1745819004494,EDS 281,A00,895701,Meyerott; Theresa Ann,15,0,15,0
1745819005520,EDS 284,A00,895736,Meyerott; Theresa Ann,15,0,15,0
1745819006547,EDS 286,A00,897210,Fine; Sarah,15,0,15,0
1745819007572,EDS 289C,A01,895770,Daly; Alan J.,15,0,15,0
1745819008595,EDS 290,A00,897211,Hofstetter; Carolyn,15,0,15,0
1745819009621,LIGM 5A,A00,896162,Fischer-Grunski; Eva K,15,0,20,5
1745819010649,LIGM 5B,A00,896260,Fischer-Grunski; Eva K,17,0,20,3
1745819011675,LIGM 5C,A00,896308,Fischer-Grunski; Eva K,18,0,20,2
1745819012699,LIIT 5AS,A00,896313,Carnelos; Chiara,18,0,20,2
1745819013726,LIIT 5BS,A00,896416,Carnelos; Chiara,20,0,20,0
1745819014750,LIIT 5CS,A00,896564,Carnelos; Chiara,20,0,20,0
1745819015778,LISP 5A,A00,896588,Munoz Sanchez; Alicia,4,0,20,16
1745819016808,LISP 5B,A00,896653,Munoz Sanchez; Alicia,10,0,20,10
1745819017832,LISP 5C,A00,896655,Munoz Sanchez; Alicia,4,0,20,16
1745819018860,MAE 197,001,957918,Kleissl; Jan,9998,0,9999,1
1745819019888,MATH 2,A01,957937,Staff,34,0,35,1
1745819020969,MATH 197,001,957876,Kedlaya; Kiran S.,9993,0,9999,6
1745819021994,MCWP 40,A00,892729,Duru; Nur,13,0,20,7
1745819021994,MCWP 40,B00,893304,Montejo; Carolina,20,0,20,0
1745819023023,MCWP 40R,A00,893757,Redela; Pamela Morgan,0,7,20,20
1745819024051,MCWP 50,A00,893758,Morshed; Michael James,2,0,20,18
1745819024051,MCWP 50,B00,893761,Bartulis; Jason Michael,17,0,20,3
1745819025081,MCWP 50R,A00,893766,Compas; Sean Matthew,0,1,20,20
1745819025081,MCWP 50R,B00,893769,Carter; Jennifer A,0,0,20,20
1745819025081,MCWP 50R,C00,893771,Krone; Jarret,0,3,20,20
1745819025081,MCWP 50R,D00,893772,Miller; Elizabeth Deen,3,0,20,17
1745819025081,MCWP 50R,E00,893775,Carter; Andrea L,0,0,20,20
1745819026110,MMW 11R,A01,892721,Herbst; Matthew,11,0,27,16
1745819026110,MMW 11R,A02,892722,Herbst; Matthew,0,0,0,3
1745819027133,MMW 12R,A01,892724,Herbst; Matthew,0,10,16,16
1745819027133,MMW 12R,A02,892725,Herbst; Matthew,0,9,16,16
1745819028163,MMW 13R,A01,892727,Staff,0,3,16,16
1745819028163,MMW 13R,A02,892728,Staff,0,4,16,16
1745819028163,MMW 13R,A03,958032,Staff,0,3,16,16
1745819028163,MMW 13R,A04,958033,Staff,0,2,16,16
1745819028163,MMW 13R,A05,958034,Staff,0,3,16,16
1745819029191,SIO 295LS,A00,894015,Staff,7,0,25,18
1745819030218,SIO 295S,A00,894020,Staff,7,0,25,18
1745819031270,SIOC 290S,B01,958918,Staff,0,0,0,0
1745819032296,SIOC 291S,B01,958922,Staff,0,0,0,0
1745819033321,SOCI 117,A01,895339,Staff,4,0,5,1
1745819034347,WES 237B,A00,894149,Staff,11,0,20,9
1745819036413,AESE 279B,A00,891859,Staff,13,0,35,22
1745819037439,AIP 197,001,891854,Staff,70,0,70,0
1745819038465,ANTH 289S,A00,891856,Gagneux; Pascal,12,0,12,0
1745819039492,BENG 196,001,957946,Engler; Adam J.,9996,0,9999,3
1745819040519,CAT 124RS,A01,956906,Staff,8,0,25,17
1745819041543,CAT 125RS,A01,922013,Staff,8,0,25,17
1745819042570,CLRE 250,A00,891860,Morris; Sheldon,9995,0,9999,4
1745819044620,CLRE 251R,A00,907817,Mehta; Ravindra L.,9994,0,9999,5
1745819045645,CLRE 252,A00,891864,Cuomo; Raphael Eduardo,9993,0,9999,6
1745819046669,CLRE 253,A00,891867,Vaida; Florin,9994,0,9999,5
1745819046669,CLRE 253,B00,907819,Staff,9999,0,9999,0
1745819047693,CLRE 259,A00,891868,Patel; Hemal,9998,0,9999,1
1745819048720,CLRE 260,A00,891872,Cuomo; Raphael Eduardo,9999,0,9999,0
1745819049745,CLRE 297,001,891888,Cuomo; Raphael Eduardo,9999,0,9999,0
1745819050772,CSE 191,A00,958773,Minnes Kemp; Mor Mia,9999,0,9999,0
1745819051797,CSS 201S,A01,892054,Mignozzetti; Umberto,30,0,30,0
1745819052822,CSS 202S,A01,892056,Mignozzetti; Umberto,30,0,30,0
1745819053851,DSC 197,001,956898,Eldridge; Justin Matthew,9998,0,9999,1
1745819054878,DSC 297,001,958000,Mazumdar; Arya,9998,0,9999,1
1745819055902,EAP 100,A00,905686,Staff,9776,0,9999,223
1745819056930,ECE 45,A01,892618,Staff,0,12,50,50
1745819057955,ECE 109,A01,892620,Staff,0,43,0,0
1745819058983,ECE 111,A01,892719,Staff,0,9,50,50
1745819060008,ECE 197,001,957920,Mercier; Patrick Philip,9992,0,9999,7
1745819061034,ECON 178,A01,907814,Zhu; Ying,28,0,35,7
1745819062081,EDS 115,A00,895312,Staff,41,0,45,4
1745819063107,EDS 117,A01,895337,Staff,30,0,30,0
1745819064133,EDS 125,A00,895341,Jones; Gabrielle Anastasia,43,0,45,2
1745819065158,EDS 128A,A01,895459,Fargason; Sharon Gayle,44,0,45,1
1745819066182,EDS 128B,A01,895543,Pappas; Elizabeth,44,0,45,1
1745819067206,EDS 139,A00,897203,Pappas; Elizabeth,44,0,45,1
1745819067206,EDS 139,B00,897209,Fargason; Sharon Gayle,44,0,45,1
1745819068234,EDS 201,A00,895545,Staff,43,0,45,2
1745819069261,EDS 203,A01,895581,Halter; Christopher P.,43,0,45,2
1745819070286,EDS 204R,A01,895625,Heinzman; Erica M.,43,0,45,2
1745819070286,EDS 204R,B01,895693,Halter; Christopher P.,18,0,45,27
1745819071314,EDS 206R,A00,895694,Fargason; Sharon Gayle,9,0,30,21
1745819071314,EDS 206R,B00,895695,Choi; Bailey Miyeon,20,0,30,10
1745819072338,EDS 250,A00,895697,Hemans; Patricia Ann Benitez,43,0,45,2
1745819073366,EDS 281,A00,895701,Meyerott; Theresa Ann,15,0,15,0
1745819074391,EDS 284,A00,895736,Meyerott; Theresa Ann,15,0,15,0
1745819075655,EDS 286,A00,897210,Fine; Sarah,15,0,15,0
1745819076684,EDS 289C,A01,895770,Daly; Alan J.,15,0,15,0
1745819077710,EDS 290,A00,897211,Hofstetter; Carolyn,15,0,15,0
1745819078737,LIGM 5A,A00,896162,Fischer-Grunski; Eva K,15,0,20,5
1745819079762,LIGM 5B,A00,896260,Fischer-Grunski; Eva K,17,0,20,3
1745819080791,LIGM 5C,A00,896308,Fischer-Grunski; Eva K,18,0,20,2
1745819081816,LIIT 5AS,A00,896313,Carnelos; Chiara,18,0,20,2
1745819082841,LIIT 5BS,A00,896416,Carnelos; Chiara,20,0,20,0
1745819083870,LIIT 5CS,A00,896564,Carnelos; Chiara,20,0,20,0
1745819084897,LISP 5A,A00,896588,Munoz Sanchez; Alicia,4,0,20,16
1745819085927,LISP 5B,A00,896653,Munoz Sanchez; Alicia,10,0,20,10
1745819086953,LISP 5C,A00,896655,Munoz Sanchez; Alicia,4,0,20,16
1745819087980,MAE 197,001,957918,Kleissl; Jan,9998,0,9999,1
1745819089009,MATH 2,A01,957937,Staff,34,0,35,1
1745819090034,MATH 197,001,957876,Kedlaya; Kiran S.,9993,0,9999,6
1745819091059,MCWP 40,A00,892729,Duru; Nur,13,0,20,7
1745819091059,MCWP 40,B00,893304,Montejo; Carolina,20,0,20,0
1745819092084,MCWP 40R,A00,893757,Redela; Pamela Morgan,0,7,20,20
1745819093109,MCWP 50,A00,893758,Morshed; Michael James,2,0,20,18
1745819093109,MCWP 50,B00,893761,Bartulis; Jason Michael,17,0,20,3
1745819094138,MCWP 50R,A00,893766,Compas; Sean Matthew,0,1,20,20
1745819094138,MCWP 50R,B00,893769,Carter; Jennifer A,0,0,20,20
1745819094138,MCWP 50R,C00,893771,Krone; Jarret,0,3,20,20
1745819094138,MCWP 50R,D00,893772,Miller; Elizabeth Deen,3,0,20,17
1745819094138,MCWP 50R,E00,893775,Carter; Andrea L,0,0,20,20
1745819095165,MMW 11R,A01,892721,Herbst; Matthew,11,0,27,16
1745819095165,MMW 11R,A02,892722,Herbst; Matthew,0,0,0,3
1745819096191,MMW 12R,A01,892724,Herbst; Matthew,0,10,16,16
1745819096191,MMW 12R,A02,892725,Herbst; Matthew,0,9,16,16
1745819097221,MMW 13R,A01,892727,Staff,0,3,16,16
1745819097221,MMW 13R,A02,892728,Staff,0,4,16,16
1745819097221,MMW 13R,A03,958032,Staff,0,3,16,16
1745819097221,MMW 13R,A04,958033,Staff,0,2,16,16
1745819097221,MMW 13R,A05,958034,Staff,0,3,16,16
1745819098250,SIO 295LS,A00,894015,Staff,7,0,25,18
1745819099278,SIO 295S,A00,894020,Staff,7,0,25,18
1745819100304,SIOC 290S,B01,958918,Staff,0,0,0,0
1745819101329,SIOC 291S,B01,958922,Staff,0,0,0,0
1745819102360,SOCI 117,A01,895339,Staff,4,0,5,1
1745819103385,WES 237B,A00,894149,Staff,11,0,20,9
1745819105492,AESE 279B,A00,891859,Staff,13,0,35,22
1745819106516,AIP 197,001,891854,Staff,70,0,70,0
1745819107541,ANTH 289S,A00,891856,Gagneux; Pascal,12,0,12,0
1745819108567,BENG 196,001,957946,Engler; Adam J.,9996,0,9999,3
1745819109591,CAT 124RS,A01,956906,Staff,8,0,25,17
1745819110617,CAT 125RS,A01,922013,Staff,8,0,25,17
1745819111643,CLRE 250,A00,891860,Morris; Sheldon,9995,0,9999,4
1745819113693,CLRE 251R,A00,907817,Mehta; Ravindra L.,9994,0,9999,5
1745819114717,CLRE 252,A00,891864,Cuomo; Raphael Eduardo,9993,0,9999,6
1745819115744,CLRE 253,A00,891867,Vaida; Florin,9994,0,9999,5
1745819115744,CLRE 253,B00,907819,Staff,9999,0,9999,0
1745819116770,CLRE 259,A00,891868,Patel; Hemal,9998,0,9999,1
1745819117794,CLRE 260,A00,891872,Cuomo; Raphael Eduardo,9999,0,9999,0
1745819118822,CLRE 297,001,891888,Cuomo; Raphael Eduardo,9999,0,9999,0
1745819119851,CSE 191,A00,958773,Minnes Kemp; Mor Mia,9999,0,9999,0
1745819120878,CSS 201S,A01,892054,Mignozzetti; Umberto,30,0,30,0
1745819121909,CSS 202S,A01,892056,Mignozzetti; Umberto,30,0,30,0
1745819122937,DSC 197,001,956898,Eldridge; Justin Matthew,9998,0,9999,1
1745819123964,DSC 297,001,958000,Mazumdar; Arya,9998,0,9999,1
1745819124990,EAP 100,A00,905686,Staff,9776,0,9999,223
1745819126017,ECE 45,A01,892618,Staff,0,12,50,50
1745819127044,ECE 109,A01,892620,Staff,0,43,0,0
1745819128073,ECE 111,A01,892719,Staff,0,9,50,50
1745819129098,ECE 197,001,957920,Mercier; Patrick Philip,9992,0,9999,7
1745819130126,ECON 178,A01,907814,Zhu; Ying,28,0,35,7
1745819131155,EDS 115,A00,895312,Staff,41,0,45,4
1745819132183,EDS 117,A01,895337,Staff,30,0,30,0
1745819133210,EDS 125,A00,895341,Jones; Gabrielle Anastasia,43,0,45,2
1745819134235,EDS 128A,A01,895459,Fargason; Sharon Gayle,44,0,45,1
1745819135266,EDS 128B,A01,895543,Pappas; Elizabeth,44,0,45,1
1745819136294,EDS 139,A00,897203,Pappas; Elizabeth,44,0,45,1
1745819136294,EDS 139,B00,897209,Fargason; Sharon Gayle,44,0,45,1
1745819137323,EDS 201,A00,895545,Staff,43,0,45,2
1745819138348,EDS 203,A01,895581,Halter; Christopher P.,43,0,45,2
1745819139373,EDS 204R,A01,895625,Heinzman; Erica M.,43,0,45,2
1745819139373,EDS 204R,B01,895693,Halter; Christopher P.,18,0,45,27
1745819140402,EDS 206R,A00,895694,Fargason; Sharon Gayle,9,0,30,21
1745819140402,EDS 206R,B00,895695,Choi; Bailey Miyeon,20,0,30,10
1745819141426,EDS 250,A00,895697,Hemans; Patricia Ann Benitez,43,0,45,2
1745819142450,EDS 281,A00,895701,Meyerott; Theresa Ann,15,0,15,0
1745819143474,EDS 284,A00,895736,Meyerott; Theresa Ann,15,0,15,0
1745819144500,EDS 286,A00,897210,Fine; Sarah,15,0,15,0
1745819145525,EDS 289C,A01,895770,Daly; Alan J.,15,0,15,0
1745819146551,EDS 290,A00,897211,Hofstetter; Carolyn,15,0,15,0
1745819147575,LIGM 5A,A00,896162,Fischer-Grunski; Eva K,15,0,20,5
1745819148603,LIGM 5B,A00,896260,Fischer-Grunski; Eva K,17,0,20,3
1745819149632,LIGM 5C,A00,896308,Fischer-Grunski; Eva K,18,0,20,2
1745819150660,LIIT 5AS,A00,896313,Carnelos; Chiara,18,0,20,2
1745819151687,LIIT 5BS,A00,896416,Carnelos; Chiara,20,0,20,0
1745819152715,LIIT 5CS,A00,896564,Carnelos; Chiara,20,0,20,0
1745819153744,LISP 5A,A00,896588,Munoz Sanchez; Alicia,4,0,20,16
1745819154774,LISP 5B,A00,896653,Munoz Sanchez; Alicia,10,0,20,10
1745819155803,LISP 5C,A00,896655,Munoz Sanchez; Alicia,4,0,20,16
1745819156828,MAE 197,001,957918,Kleissl; Jan,9998,0,9999,1
1745819157854,MATH 2,A01,957937,Staff,34,0,35,1
1745819158879,MATH 197,001,957876,Kedlaya; Kiran S.,9993,0,9999,6
1745819159906,MCWP 40,A00,892729,Duru; Nur,13,0,20,7
1745819159906,MCWP 40,B00,893304,Montejo; Carolina,20,0,20,0
1745819160931,MCWP 40R,A00,893757,Redela; Pamela Morgan,0,7,20,20
1745819161961,MCWP 50,A00,893758,Morshed; Michael James,2,0,20,18
1745819161961,MCWP 50,B00,893761,Bartulis; Jason Michael,17,0,20,3
1745819162992,MCWP 50R,A00,893766,Compas; Sean Matthew,0,1,20,20
1745819162992,MCWP 50R,B00,893769,Carter; Jennifer A,0,0,20,20
1745819162992,MCWP 50R,C00,893771,Krone; Jarret,0,3,20,20
1745819162992,MCWP 50R,D00,893772,Miller; Elizabeth Deen,3,0,20,17
1745819162992,MCWP 50R,E00,893775,Carter; Andrea L,0,0,20,20
1745819164022,MMW 11R,A01,892721,Herbst; Matthew,11,0,27,16
1745819164022,MMW 11R,A02,892722,Herbst; Matthew,0,0,0,3
1745819165050,MMW 12R,A01,892724,Herbst; Matthew,0,10,16,16
1745819165050,MMW 12R,A02,892725,Herbst; Matthew,0,9,16,16
1745819166078,MMW 13R,A01,892727,Staff,0,3,16,16
1745819166078,MMW 13R,A02,892728,Staff,0,4,16,16
1745819166078,MMW 13R,A03,958032,Staff,0,3,16,16
1745819166078,MMW 13R,A04,958033,Staff,0,2,16,16
1745819166078,MMW 13R,A05,958034,Staff,0,3,16,16
1745819167110,SIO 295LS,A00,894015,Staff,7,0,25,18
1745819168138,SIO 295S,A00,894020,Staff,7,0,25,18
1745819169163,SIOC 290S,B01,958918,Staff,0,0,0,0
1745819170190,SIOC 291S,B01,958922,Staff,0,0,0,0
1745819171239,SOCI 117,A01,895339,Staff,4,0,5,1
1745819172264,WES 237B,A00,894149,Staff,11,0,20,9
1745819174321,AESE 279B,A00,891859,Staff,13,0,35,22
1745819175349,AIP 197,001,891854,Staff,70,0,70,0
1745819176376,ANTH 289S,A00,891856,Gagneux; Pascal,12,0,12,0
1745819177402,BENG 196,001,957946,Engler; Adam J.,9996,0,9999,3
1745819178425,CAT 124RS,A01,956906,Staff,8,0,25,17
1745819179450,CAT 125RS,A01,922013,Staff,8,0,25,17
1745819180474,CLRE 250,A00,891860,Morris; Sheldon,9995,0,9999,4
1745819182528,CLRE 251R,A00,907817,Mehta; Ravindra L.,9994,0,9999,5
1745819183552,CLRE 252,A00,891864,Cuomo; Raphael Eduardo,9993,0,9999,6
1745819184581,CLRE 253,A00,891867,Vaida; Florin,9994,0,9999,5
1745819184581,CLRE 253,B00,907819,Staff,9999,0,9999,0
1745819185608,CLRE 259,A00,891868,Patel; Hemal,9998,0,9999,1
1745819186634,CLRE 260,A00,891872,Cuomo; Raphael Eduardo,9999,0,9999,0
1745819187660,CLRE 297,001,891888,Cuomo; Raphael Eduardo,9999,0,9999,0
1745819188688,CSE 191,A00,958773,Minnes Kemp; Mor Mia,9999,0,9999,0
1745819189713,CSS 201S,A01,892054,Mignozzetti; Umberto,30,0,30,0
1745819190739,CSS 202S,A01,892056,Mignozzetti; Umberto,30,0,30,0
1745819191765,DSC 197,001,956898,Eldridge; Justin Matthew,9998,0,9999,1
1745819192789,DSC 297,001,958000,Mazumdar; Arya,9998,0,9999,1
1745819193814,EAP 100,A00,905686,Staff,9776,0,9999,223
1745819194840,ECE 45,A01,892618,Staff,0,12,50,50
1745819195867,ECE 109,A01,892620,Staff,0,43,0,0
1745819196893,ECE 111,A01,892719,Staff,0,9,50,50
1745819197917,ECE 197,001,957920,Mercier; Patrick Philip,9992,0,9999,7
1745819198945,ECON 178,A01,907814,Zhu; Ying,28,0,35,7
1745819199971,EDS 115,A00,895312,Staff,41,0,45,4
1745819200997,EDS 117,A01,895337,Staff,30,0,30,0
1745819202024,EDS 125,A00,895341,Jones; Gabrielle Anastasia,43,0,45,2
1745819203049,EDS 128A,A01,895459,Fargason; Sharon Gayle,44,0,45,1
1745819204073,EDS 128B,A01,895543,Pappas; Elizabeth,44,0,45,1
1745819205097,EDS 139,A00,897203,Pappas; Elizabeth,44,0,45,1
1745819205097,EDS 139,B00,897209,Fargason; Sharon Gayle,44,0,45,1
1745819206121,EDS 201,A00,895545,Staff,43,0,45,2
1745819207148,EDS 203,A01,895581,Halter; Christopher P.,43,0,45,2
1745819208174,EDS 204R,A01,895625,Heinzman; Erica M.,43,0,45,2
1745819208174,EDS 204R,B01,895693,Halter; Christopher P.,18,0,45,27
1745819209198,EDS 206R,A00,895694,Fargason; Sharon Gayle,9,0,30,21
1745819209198,EDS 206R,B00,895695,Choi; Bailey Miyeon,20,0,30,10
1745819210222,EDS 250,A00,895697,Hemans; Patricia Ann Benitez,43,0,45,2
1745819211247,EDS 281,A00,895701,Meyerott; Theresa Ann,15,0,15,0
1745819212271,EDS 284,A00,895736,Meyerott; Theresa Ann,15,0,15,0
1745819213296,EDS 286,A00,897210,Fine; Sarah,15,0,15,0
1745819214321,EDS 289C,A01,895770,Daly; Alan J.,15,0,15,0
1745819215346,EDS 290,A00,897211,Hofstetter; Carolyn,15,0,15,0
1745819216370,LIGM 5A,A00,896162,Fischer-Grunski; Eva K,15,0,20,5
1745819217394,LIGM 5B,A00,896260,Fischer-Grunski; Eva K,17,0,20,3
1745819218421,LIGM 5C,A00,896308,Fischer-Grunski; Eva K,18,0,20,2
1745819219444,LIIT 5AS,A00,896313,Carnelos; Chiara,18,0,20,2
1745819220470,LIIT 5BS,A00,896416,Carnelos; Chiara,20,0,20,0
1745819221497,LIIT 5CS,A00,896564,Carnelos; Chiara,20,0,20,0
1745819222528,LISP 5A,A00,896588,Munoz Sanchez; Alicia,4,0,20,16
1745819223553,LISP 5B,A00,896653,Munoz Sanchez; Alicia,10,0,20,10
1745819224582,LISP 5C,A00,896655,Munoz Sanchez; Alicia,4,0,20,16
1745819225607,MAE 197,001,957918,Kleissl; Jan,9998,0,9999,1
1745819226634,MATH 2,A01,957937,Staff,34,0,35,1
1745819227658,MATH 197,001,957876,Kedlaya; Kiran S.,9993,0,9999,6
1745819228686,MCWP 40,A00,892729,Duru; Nur,13,0,20,7
1745819228686,MCWP 40,B00,893304,Montejo; Carolina,20,0,20,0
1745819229712,MCWP 40R,A00,893757,Redela; Pamela Morgan,0,7,20,20
1745819230737,MCWP 50,A00,893758,Morshed; Michael James,2,0,20,18
1745819230737,MCWP 50,B00,893761,Bartulis; Jason Michael,17,0,20,3
1745819231765,MCWP 50R,A00,893766,Compas; Sean Matthew,0,1,20,20
1745819231765,MCWP 50R,B00,893769,Carter; Jennifer A,0,0,20,20
1745819231765,MCWP 50R,C00,893771,Krone; Jarret,0,3,20,20
1745819231765,MCWP 50R,D00,893772,Miller; Elizabeth Deen,3,0,20,17
1745819231765,MCWP 50R,E00,893775,Carter; Andrea L,0,0,20,20
1745819232793,MMW 11R,A01,892721,Herbst; Matthew,11,0,27,16
1745819232793,MMW 11R,A02,892722,Herbst; Matthew,0,0,0,3
1745819233821,MMW 12R,A01,892724,Herbst; Matthew,0,10,16,16
1745819233821,MMW 12R,A02,892725,Herbst; Matthew,0,9,16,16
1745819234846,MMW 13R,A01,892727,Staff,0,3,16,16
1745819234846,MMW 13R,A02,892728,Staff,0,4,16,16
1745819234846,MMW 13R,A03,958032,Staff,0,3,16,16
1745819234846,MMW 13R,A04,958033,Staff,0,2,16,16
1745819234846,MMW 13R,A05,958034,Staff,0,3,16,16
1745819235870,SIO 295LS,A00,894015,Staff,7,0,25,18
1745819236900,SIO 295S,A00,894020,Staff,7,0,25,18
1745819237924,SIOC 290S,B01,958918,Staff,0,0,0,0
1745819238950,SIOC 291S,B01,958922,Staff,0,0,0,0
1745819239974,SOCI 117,A01,895339,Staff,4,0,5,1
1745819241002,WES 237B,A00,894149,Staff,11,0,20,9
1745819243067,AESE 279B,A00,891859,Staff,13,0,35,22
1745819244091,AIP 197,001,891854,Staff,70,0,70,0
1745819245120,ANTH 289S,A00,891856,Gagneux; Pascal,12,0,12,0
1745819246145,BENG 196,001,957946,Engler; Adam J.,9996,0,9999,3
1745819247172,CAT 124RS,A01,956906,Staff,8,0,25,17
1745819248198,CAT 125RS,A01,922013,Staff,8,0,25,17
1745819249224,CLRE 250,A00,891860,Morris; Sheldon,9995,0,9999,4
1745819251279,CLRE 251R,A00,907817,Mehta; Ravindra L.,9994,0,9999,5
1745819252307,CLRE 252,A00,891864,Cuomo; Raphael Eduardo,9993,0,9999,6
1745819253336,CLRE 253,A00,891867,Vaida; Florin,9994,0,9999,5
1745819253336,CLRE 253,B00,907819,Staff,9999,0,9999,0
1745819254362,CLRE 259,A00,891868,Patel; Hemal,9998,0,9999,1
1745819255388,CLRE 260,A00,891872,Cuomo; Raphael Eduardo,9999,0,9999,0
1745819256415,CLRE 297,001,891888,Cuomo; Raphael Eduardo,9999,0,9999,0
1745819257444,CSE 191,A00,958773,Minnes Kemp; Mor Mia,9999,0,9999,0
1745819258470,CSS 201S,A01,892054,Mignozzetti; Umberto,30,0,30,0
1745819259498,CSS 202S,A01,892056,Mignozzetti; Umberto,30,0,30,0
1745819260527,DSC 197,001,956898,Eldridge; Justin Matthew,9998,0,9999,1
1745819261552,DSC 297,001,958000,Mazumdar; Arya,9998,0,9999,1
1745819262581,EAP 100,A00,905686,Staff,9776,0,9999,223
1745819263609,ECE 45,A01,892618,Staff,0,12,50,50
1745819264636,ECE 109,A01,892620,Staff,0,43,0,0
1745819265664,ECE 111,A01,892719,Staff,0,9,50,50
1745819266692,ECE 197,001,957920,Mercier; Patrick Philip,9992,0,9999,7
1745819267719,ECON 178,A01,907814,Zhu; Ying,28,0,35,7
1745819268744,EDS 115,A00,895312,Staff,41,0,45,4
1745819269770,EDS 117,A01,895337,Staff,30,0,30,0
1745819270801,EDS 125,A00,895341,Jones; Gabrielle Anastasia,43,0,45,2
1745819271826,EDS 128A,A01,895459,Fargason; Sharon Gayle,44,0,45,1
1745819272854,EDS 128B,A01,895543,Pappas; Elizabeth,44,0,45,1
1745819273880,EDS 139,A00,897203,Pappas; Elizabeth,44,0,45,1
1745819273880,EDS 139,B00,897209,Fargason; Sharon Gayle,44,0,45,1
1745819274907,EDS 201,A00,895545,Staff,43,0,45,2
1745819275932,EDS 203,A01,895581,Halter; Christopher P.,43,0,45,2
1745819276957,EDS 204R,A01,895625,Heinzman; Erica M.,43,0,45,2
1745819276957,EDS 204R,B01,895693,Halter; Christopher P.,18,0,45,27
1745819277982,EDS 206R,A00,895694,Fargason; Sharon Gayle,9,0,30,21
1745819277982,EDS 206R,B00,895695,Choi; Bailey Miyeon,20,0,30,10
1745819279011,EDS 250,A00,895697,Hemans; Patricia Ann Benitez,43,0,45,2
1745819280036,EDS 281,A00,895701,Meyerott; Theresa Ann,15,0,15,0
1745819281061,EDS 284,A00,895736,Meyerott; Theresa Ann,15,0,15,0
1745819282088,EDS 286,A00,897210,Fine; Sarah,15,0,15,0
1745819283116,EDS 289C,A01,895770,Daly; Alan J.,15,0,15,0
1745819284144,EDS 290,A00,897211,Hofstetter; Carolyn,15,0,15,0
1745819285173,LIGM 5A,A00,896162,Fischer-Grunski; Eva K,15,0,20,5
1745819286203,LIGM 5B,A00,896260,Fischer-Grunski; Eva K,17,0,20,3
1745819287232,LIGM 5C,A00,896308,Fischer-Grunski; Eva K,18,0,20,2
1745819288260,LIIT 5AS,A00,896313,Carnelos; Chiara,18,0,20,2
1745819289288,LIIT 5BS,A00,896416,Carnelos; Chiara,20,0,20,0
1745819290312,LIIT 5CS,A00,896564,Carnelos; Chiara,20,0,20,0
1745819291336,LISP 5A,A00,896588,Munoz Sanchez; Alicia,4,0,20,16
1745819292362,LISP 5B,A00,896653,Munoz Sanchez; Alicia,10,0,20,10
1745819293390,LISP 5C,A00,896655,Munoz Sanchez; Alicia,4,0,20,16
1745819294416,MAE 197,001,957918,Kleissl; Jan,9998,0,9999,1
1745819295440,MATH 2,A01,957937,Staff,34,0,35,1
1745819296466,MATH 197,001,957876,Kedlaya; Kiran S.,9993,0,9999,6
1745819297495,MCWP 40,A00,892729,Duru; Nur,13,0,20,7
1745819297495,MCWP 40,B00,893304,Montejo; Carolina,20,0,20,0
1745819298521,MCWP 40R,A00,893757,Redela; Pamela Morgan,0,7,20,20
1745819299547,MCWP 50,A00,893758,Morshed; Michael James,2,0,20,18
1745819299547,MCWP 50,B00,893761,Bartulis; Jason Michael,17,0,20,3
1745819300573,MCWP 50R,A00,893766,Compas; Sean Matthew,0,1,20,20
1745819300573,MCWP 50R,B00,893769,Carter; Jennifer A,0,0,20,20
1745819300573,MCWP 50R,C00,893771,Krone; Jarret,0,3,20,20
1745819300573,MCWP 50R,D00,893772,Miller; Elizabeth Deen,3,0,20,17
1745819300573,MCWP 50R,E00,893775,Carter; Andrea L,0,0,20,20
1745819301597,MMW 11R,A01,892721,Herbst; Matthew,11,0,27,16
1745819301597,MMW 11R,A02,892722,Herbst; Matthew,0,0,0,3
1745819302623,MMW 12R,A01,892724,Herbst; Matthew,0,10,16,16
1745819302623,MMW 12R,A02,892725,Herbst; Matthew,0,9,16,16
1745819303649,MMW 13R,A01,892727,Staff,0,3,16,16
1745819303649,MMW 13R,A02,892728,Staff,0,4,16,16
1745819303649,MMW 13R,A03,958032,Staff,0,3,16,16
1745819303649,MMW 13R,A04,958033,Staff,0,2,16,16
1745819303649,MMW 13R,A05,958034,Staff,0,3,16,16
1745819304675,SIO 295LS,A00,894015,Staff,7,0,25,18
1745819305699,SIO 295S,A00,894020,Staff,7,0,25,18
1745819306730,SIOC 290S,B01,958918,Staff,0,0,0,0
1745819307757,SIOC 291S,B01,958922,Staff,0,0,0,0
1745819308783,SOCI 117,A01,895339,Staff,4,0,5,1
1745819309810,WES 237B,A00,894149,Staff,11,0,20,9
1745819311874,AESE 279B,A00,891859,Staff,13,0,35,22
1745819312939,AIP 197,001,891854,Staff,70,0,70,0
1745819313965,ANTH 289S,A00,891856,Gagneux; Pascal,12,0,12,0
1745819314990,BENG 196,001,957946,Engler; Adam J.,9996,0,9999,3
1745819316019,CAT 124RS,A01,956906,Staff,8,0,25,17
1745819317046,CAT 125RS,A01,922013,Staff,8,0,25,17
1745819318070,CLRE 250,A00,891860,Morris; Sheldon,9995,0,9999,4
1745819320121,CLRE 251R,A00,907817,Mehta; Ravindra L.,9994,0,9999,5
1745819321146,CLRE 252,A00,891864,Cuomo; Raphael Eduardo,9993,0,9999,6
1745819322172,CLRE 253,A00,891867,Vaida; Florin,9994,0,9999,5
1745819322172,CLRE 253,B00,907819,Staff,9999,0,9999,0
1745819323197,CLRE 259,A00,891868,Patel; Hemal,9998,0,9999,1
1745819324225,CLRE 260,A00,891872,Cuomo; Raphael Eduardo,9999,0,9999,0
1745819325251,CLRE 297,001,891888,Cuomo; Raphael Eduardo,9999,0,9999,0
1745819326277,CSE 191,A00,958773,Minnes Kemp; Mor Mia,9999,0,9999,0
1745819327304,CSS 201S,A01,892054,Mignozzetti; Umberto,30,0,30,0
1745819328328,CSS 202S,A01,892056,Mignozzetti; Umberto,30,0,30,0
1745819329352,DSC 197,001,956898,Eldridge; Justin Matthew,9998,0,9999,1
1745819330377,DSC 297,001,958000,Mazumdar; Arya,9998,0,9999,1
1745819331404,EAP 100,A00,905686,Staff,9776,0,9999,223
1745819332433,ECE 45,A01,892618,Staff,0,12,50,50
1745819333458,ECE 109,A01,892620,Staff,0,43,0,0
1745819334488,ECE 111,A01,892719,Staff,0,9,50,50
1745819335512,ECE 197,001,957920,Mercier; Patrick Philip,9992,0,9999,7
1745819336539,ECON 178,A01,907814,Zhu; Ying,28,0,35,7
1745819337567,EDS 115,A00,895312,Staff,41,0,45,4
1745819338595,EDS 117,A01,895337,Staff,30,0,30,0
1745819339619,EDS 125,A00,895341,Jones; Gabrielle Anastasia,43,0,45,2
1745819340644,EDS 128A,A01,895459,Fargason; Sharon Gayle,44,0,45,1
1745819341668,EDS 128B,A01,895543,Pappas; Elizabeth,44,0,45,1
1745819342693,EDS 139,A00,897203,Pappas; Elizabeth,44,0,45,1
1745819342693,EDS 139,B00,897209,Fargason; Sharon Gayle,44,0,45,1
1745819343719,EDS 201,A00,895545,Staff,43,0,45,2
1745819344748,EDS 203,A01,895581,Halter; Christopher P.,43,0,45,2
1745819345774,EDS 204R,A01,895625,Heinzman; Erica M.,43,0,45,2
1745819345774,EDS 204R,B01,895693,Halter; Christopher P.,18,0,45,27
1745819346857,EDS 206R,A00,895694,Fargason; Sharon Gayle,9,0,30,21
1745819346857,EDS 206R,B00,895695,Choi; Bailey Miyeon,20,0,30,10
1745819347884,EDS 250,A00,895697,Hemans; Patricia Ann Benitez,43,0,45,2
1745819348909,EDS 281,A00,895701,Meyerott; Theresa Ann,15,0,15,0
1745819349934,EDS 284,A00,895736,Meyerott; Theresa Ann,15,0,15,0
1745819350960,EDS 286,A00,897210,Fine; Sarah,15,0,15,0
1745819351986,EDS 289C,A01,895770,Daly; Alan J.,15,0,15,0
1745819353015,EDS 290,A00,897211,Hofstetter; Carolyn,15,0,15,0
1745819354042,LIGM 5A,A00,896162,Fischer-Grunski; Eva K,15,0,20,5
1745819355072,LIGM 5B,A00,896260,Fischer-Grunski; Eva K,17,0,20,3
1745819356098,LIGM 5C,A00,896308,Fischer-Grunski; Eva K,18,0,20,2
1745819357128,LIIT 5AS,A00,896313,Carnelos; Chiara,17,0,20,3
1745819358154,LIIT 5BS,A00,896416,Carnelos; Chiara,20,0,20,0
1745819359181,LIIT 5CS,A00,896564,Carnelos; Chiara,20,0,20,0
1745819360206,LISP 5A,A00,896588,Munoz Sanchez; Alicia,4,0,20,16
1745819361231,LISP 5B,A00,896653,Munoz Sanchez; Alicia,10,0,20,10
1745819362260,LISP 5C,A00,896655,Munoz Sanchez; Alicia,4,0,20,16
1745819363287,MAE 197,001,957918,Kleissl; Jan,9998,0,9999,1
1745819364314,MATH 2,A01,957937,Staff,34,0,35,1
1745819365341,MATH 197,001,957876,Kedlaya; Kiran S.,9993,0,9999,6
1745819366372,MCWP 40,A00,892729,Duru; Nur,13,0,20,7
1745819366372,MCWP 40,B00,893304,Montejo; Carolina,20,0,20,0
1745819367402,MCWP 40R,A00,893757,Redela; Pamela Morgan,0,7,20,20
1745819368431,MCWP 50,A00,893758,Morshed; Michael James,2,0,20,18
1745819368431,MCWP 50,B00,893761,Bartulis; Jason Michael,18,0,20,2
1745819369462,MCWP 50R,A00,893766,Compas; Sean Matthew,0,1,20,20
1745819369462,MCWP 50R,B00,893769,Carter; Jennifer A,0,0,20,20
1745819369462,MCWP 50R,C00,893771,Krone; Jarret,0,3,20,20
1745819369462,MCWP 50R,D00,893772,Miller; Elizabeth Deen,3,0,20,17
1745819369462,MCWP 50R,E00,893775,Carter; Andrea L,0,0,20,20
1745819370489,MMW 11R,A01,892721,Herbst; Matthew,11,0,27,16
1745819370489,MMW 11R,A02,892722,Herbst; Matthew,0,0,0,3
1745819371512,MMW 12R,A01,892724,Herbst; Matthew,0,10,16,16
1745819371512,MMW 12R,A02,892725,Herbst; Matthew,0,9,16,16
1745819372538,MMW 13R,A01,892727,Staff,0,3,16,16
1745819372538,MMW 13R,A02,892728,Staff,0,4,16,16
1745819372538,MMW 13R,A03,958032,Staff,0,3,16,16
1745819372538,MMW 13R,A04,958033,Staff,0,2,16,16
1745819372538,MMW 13R,A05,958034,Staff,0,3,16,16
1745819373562,SIO 295LS,A00,894015,Staff,7,0,25,18
1745819374587,SIO 295S,A00,894020,Staff,7,0,25,18
1745819375612,SIOC 290S,B01,958918,Staff,0,0,0,0
1745819376640,SIOC 291S,B01,958922,Staff,0,0,0,0
1745819377666,SOCI 117,A01,895339,Staff,4,0,5,1
1745819378692,WES 237B,A00,894149,Staff,11,0,20,9
1745819380745,AESE 279B,A00,891859,Staff,13,0,35,22
1745819381770,AIP 197,001,891854,Staff,70,0,70,0
1745819382796,ANTH 289S,A00,891856,Gagneux; Pascal,12,0,12,0
1745819383824,BENG 196,001,957946,Engler; Adam J.,9996,0,9999,3
1745819384851,CAT 124RS,A01,956906,Staff,8,0,25,17
1745819385876,CAT 125RS,A01,922013,Staff,8,0,25,17
1745819386904,CLRE 250,A00,891860,Morris; Sheldon,9995,0,9999,4
1745819388953,CLRE 251R,A00,907817,Mehta; Ravindra L.,9994,0,9999,5
1745819389981,CLRE 252,A00,891864,Cuomo; Raphael Eduardo,9993,0,9999,6
1745819391006,CLRE 253,A00,891867,Vaida; Florin,9994,0,9999,5
1745819391006,CLRE 253,B00,907819,Staff,9999,0,9999,0
1745819392030,CLRE 259,A00,891868,Patel; Hemal,9998,0,9999,1
1745819393056,CLRE 260,A00,891872,Cuomo; Raphael Eduardo,9999,0,9999,0
1745819394079,CLRE 297,001,891888,Cuomo; Raphael Eduardo,9999,0,9999,0
1745819395105,CSE 191,A00,958773,Minnes Kemp; Mor Mia,9999,0,9999,0
1745819396137,CSS 201S,A01,892054,Mignozzetti; Umberto,30,0,30,0
1745819397163,CSS 202S,A01,892056,Mignozzetti; Umberto,30,0,30,0
1745819398187,DSC 197,001,956898,Eldridge; Justin Matthew,9998,0,9999,1
1745819399212,DSC 297,001,958000,Mazumdar; Arya,9998,0,9999,1
1745819400238,EAP 100,A00,905686,Staff,9776,0,9999,223
1745819401266,ECE 45,A01,892618,Staff,0,12,50,50
1745819402294,ECE 109,A01,892620,Staff,0,43,0,0
1745819403324,ECE 111,A01,892719,Staff,0,9,50,50
1745819404348,ECE 197,001,957920,Mercier; Patrick Philip,9992,0,9999,7
1745819405377,ECON 178,A01,907814,Zhu; Ying,28,0,35,7
1745819406405,EDS 115,A00,895312,Staff,41,0,45,4
1745819407435,EDS 117,A01,895337,Staff,30,0,30,0
1745819408461,EDS 125,A00,895341,Jones; Gabrielle Anastasia,43,0,45,2
1745819409488,EDS 128A,A01,895459,Fargason; Sharon Gayle,44,0,45,1
1745819410519,EDS 128B,A01,895543,Pappas; Elizabeth,44,0,45,1
1745819411543,EDS 139,A00,897203,Pappas; Elizabeth,44,0,45,1
1745819411543,EDS 139,B00,897209,Fargason; Sharon Gayle,44,0,45,1
1745819412569,EDS 201,A00,895545,Staff,43,0,45,2
1745819413595,EDS 203,A01,895581,Halter; Christopher P.,43,0,45,2
1745819414623,EDS 204R,A01,895625,Heinzman; Erica M.,43,0,45,2
1745819414623,EDS 204R,B01,895693,Halter; Christopher P.,18,0,45,27
1745819415647,EDS 206R,A00,895694,Fargason; Sharon Gayle,9,0,30,21
1745819415647,EDS 206R,B00,895695,Choi; Bailey Miyeon,20,0,30,10
1745819416713,EDS 250,A00,895697,Hemans; Patricia Ann Benitez,43,0,45,2
1745819417737,EDS 281,A00,895701,Meyerott; Theresa Ann,15,0,15,0
1745819418767,EDS 284,A00,895736,Meyerott; Theresa Ann,15,0,15,0
1745819419794,EDS 286,A00,897210,Fine; Sarah,15,0,15,0
1745819420820,EDS 289C,A01,895770,Daly; Alan J.,15,0,15,0
1745819421848,EDS 290,A00,897211,Hofstetter; Carolyn,15,0,15,0
1745819422874,LIGM 5A,A00,896162,Fischer-Grunski; Eva K,15,0,20,5
1745819423900,LIGM 5B,A00,896260,Fischer-Grunski; Eva K,17,0,20,3
1745819424925,LIGM 5C,A00,896308,Fischer-Grunski; Eva K,18,0,20,2
1745819425954,LIIT 5AS,A00,896313,Carnelos; Chiara,17,0,20,3
1745819426979,LIIT 5BS,A00,896416,Carnelos; Chiara,20,0,20,0
1745819428005,LIIT 5CS,A00,896564,Carnelos; Chiara,20,0,20,0
1745819429032,LISP 5A,A00,896588,Munoz Sanchez; Alicia,4,0,20,16
1745819430063,LISP 5B,A00,896653,Munoz Sanchez; Alicia,10,0,20,10
1745819431090,LISP 5C,A00,896655,Munoz Sanchez; Alicia,4,0,20,16
1745819432117,MAE 197,001,957918,Kleissl; Jan,9998,0,9999,1
1745819433141,MATH 2,A01,957937,Staff,34,0,35,1
1745819434166,MATH 197,001,957876,Kedlaya; Kiran S.,9993,0,9999,6
1745819435195,MCWP 40,A00,892729,Duru; Nur,13,0,20,7
1745819435195,MCWP 40,B00,893304,Montejo; Carolina,20,0,20,0
1745819436220,MCWP 40R,A00,893757,Redela; Pamela Morgan,0,7,20,20
1745819437246,MCWP 50,A00,893758,Morshed; Michael James,2,0,20,18
1745819437246,MCWP 50,B00,893761,Bartulis; Jason Michael,18,0,20,2
1745819438271,MCWP 50R,A00,893766,Compas; Sean Matthew,0,1,20,20
1745819438271,MCWP 50R,B00,893769,Carter; Jennifer A,0,0,20,20
1745819438271,MCWP 50R,C00,893771,Krone; Jarret,0,3,20,20
1745819438271,MCWP 50R,D00,893772,Miller; Elizabeth Deen,3,0,20,17
1745819438271,MCWP 50R,E00,893775,Carter; Andrea L,0,0,20,20
1745819439296,MMW 11R,A01,892721,Herbst; Matthew,11,0,27,16
1745819439296,MMW 11R,A02,892722,Herbst; Matthew,0,0,0,3
1745819440322,MMW 12R,A01,892724,Herbst; Matthew,0,10,16,16
1745819440322,MMW 12R,A02,892725,Herbst; Matthew,0,9,16,16
1745819441347,MMW 13R,A01,892727,Staff,0,3,16,16
1745819441347,MMW 13R,A02,892728,Staff,0,4,16,16
1745819441347,MMW 13R,A03,958032,Staff,0,3,16,16
1745819441347,MMW 13R,A04,958033,Staff,0,2,16,16
1745819441347,MMW 13R,A05,958034,Staff,0,3,16,16
1745819442373,SIO 295LS,A00,894015,Staff,7,0,25,18
1745819443399,SIO 295S,A00,894020,Staff,7,0,25,18
1745819444423,SIOC 290S,B01,958918,Staff,0,0,0,0
1745819445449,SIOC 291S,B01,958922,Staff,0,0,0,0
1745819446678,SOCI 117,A01,895339,Staff,4,0,5,1
1745819447705,WES 237B,A00,894149,Staff,11,0,20,9
1745819449773,AESE 279B,A00,891859,Staff,13,0,35,22
1745819450801,AIP 197,001,891854,Staff,70,0,70,0
1745819451827,ANTH 289S,A00,891856,Gagneux; Pascal,12,0,12,0
1745819452855,BENG 196,001,957946,Engler; Adam J.,9996,0,9999,3
1745819453882,CAT 124RS,A01,956906,Staff,8,0,25,17
1745819454907,CAT 125RS,A01,922013,Staff,8,0,25,17
1745819455932,CLRE 250,A00,891860,Morris; Sheldon,9995,0,9999,4
1745819457983,CLRE 251R,A00,907817,Mehta; Ravindra L.,9994,0,9999,5
1745819459016,CLRE 252,A00,891864,Cuomo; Raphael Eduardo,9993,0,9999,6
1745819460041,CLRE 253,A00,891867,Vaida; Florin,9994,0,9999,5
1745819460041,CLRE 253,B00,907819,Staff,9999,0,9999,0
1745819461066,CLRE 259,A00,891868,Patel; Hemal,9998,0,9999,1
1745819462091,CLRE 260,A00,891872,Cuomo; Raphael Eduardo,9999,0,9999,0
1745819463117,CLRE 297,001,891888,Cuomo; Raphael Eduardo,9999,0,9999,0
1745819464143,CSE 191,A00,958773,Minnes Kemp; Mor Mia,9999,0,9999,0
1745819465171,CSS 201S,A01,892054,Mignozzetti; Umberto,30,0,30,0
1745819466196,CSS 202S,A01,892056,Mignozzetti; Umberto,30,0,30,0
1745819467222,DSC 197,001,956898,Eldridge; Justin Matthew,9998,0,9999,1
1745819468247,DSC 297,001,958000,Mazumdar; Arya,9998,0,9999,1
1745819469274,EAP 100,A00,905686,Staff,9776,0,9999,223
1745819470303,ECE 45,A01,892618,Staff,0,12,50,50
1745819471329,ECE 109,A01,892620,Staff,0,43,0,0
1745819472353,ECE 111,A01,892719,Staff,0,9,50,50
1745819473377,ECE 197,001,957920,Mercier; Patrick Philip,9992,0,9999,7
1745819474402,ECON 178,A01,907814,Zhu; Ying,28,0,35,7
1745819475431,EDS 115,A00,895312,Staff,41,0,45,4
1745819476456,EDS 117,A01,895337,Staff,30,0,30,0
1745819477481,EDS 125,A00,895341,Jones; Gabrielle Anastasia,43,0,45,2
1745819478505,EDS 128A,A01,895459,Fargason; Sharon Gayle,44,0,45,1
1745819479531,EDS 128B,A01,895543,Pappas; Elizabeth,44,0,45,1
1745819480555,EDS 139,A00,897203,Pappas; Elizabeth,44,0,45,1
1745819480555,EDS 139,B00,897209,Fargason; Sharon Gayle,44,0,45,1
1745819481580,EDS 201,A00,895545,Staff,43,0,45,2
1745819482607,EDS 203,A01,895581,Halter; Christopher P.,43,0,45,2
1745819483633,EDS 204R,A01,895625,Heinzman; Erica M.,43,0,45,2
1745819483633,EDS 204R,B01,895693,Halter; Christopher P.,18,0,45,27
1745819484656,EDS 206R,A00,895694,Fargason; Sharon Gayle,9,0,30,21
1745819484656,EDS 206R,B00,895695,Choi; Bailey Miyeon,20,0,30,10
1745819485679,EDS 250,A00,895697,Hemans; Patricia Ann Benitez,43,0,45,2
1745819486705,EDS 281,A00,895701,Meyerott; Theresa Ann,15,0,15,0
1745819487728,EDS 284,A00,895736,Meyerott; Theresa Ann,15,0,15,0
1745819488751,EDS 286,A00,897210,Fine; Sarah,15,0,15,0
1745819489780,EDS 289C,A01,895770,Daly; Alan J.,15,0,15,0
1745819490806,EDS 290,A00,897211,Hofstetter; Carolyn,15,0,15,0
1745819491831,LIGM 5A,A00,896162,Fischer-Grunski; Eva K,15,0,20,5
1745819492860,LIGM 5B,A00,896260,Fischer-Grunski; Eva K,17,0,20,3
1745819493888,LIGM 5C,A00,896308,Fischer-Grunski; Eva K,18,0,20,2
1745819494914,LIIT 5AS,A00,896313,Carnelos; Chiara,17,0,20,3
1745819495939,LIIT 5BS,A00,896416,Carnelos; Chiara,20,0,20,0
1745819496963,LIIT 5CS,A00,896564,Carnelos; Chiara,20,0,20,0
1745819497992,LISP 5A,A00,896588,Munoz Sanchez; Alicia,4,0,20,16
1745819499016,LISP 5B,A00,896653,Munoz Sanchez; Alicia,10,0,20,10
1745819500048,LISP 5C,A00,896655,Munoz Sanchez; Alicia,4,0,20,16
1745819501097,MAE 197,001,957918,Kleissl; Jan,9998,0,9999,1
1745819502125,MATH 2,A01,957937,Staff,34,0,35,1
1745819503149,MATH 197,001,957876,Kedlaya; Kiran S.,9993,0,9999,6
1745819504174,MCWP 40,A00,892729,Duru; Nur,13,0,20,7
1745819504174,MCWP 40,B00,893304,Montejo; Carolina,20,0,20,0
1745819505200,MCWP 40R,A00,893757,Redela; Pamela Morgan,0,7,20,20
1745819506224,MCWP 50,A00,893758,Morshed; Michael James,2,0,20,18
1745819506224,MCWP 50,B00,893761,Bartulis; Jason Michael,18,0,20,2
1745819507251,MCWP 50R,A00,893766,Compas; Sean Matthew,0,1,20,20
1745819507251,MCWP 50R,B00,893769,Carter; Jennifer A,0,0,20,20
1745819507251,MCWP 50R,C00,893771,Krone; Jarret,0,3,20,20
1745819507251,MCWP 50R,D00,893772,Miller; Elizabeth Deen,3,0,20,17
1745819507251,MCWP 50R,E00,893775,Carter; Andrea L,0,0,20,20
1745819508276,MMW 11R,A01,892721,Herbst; Matthew,11,0,27,16
1745819508276,MMW 11R,A02,892722,Herbst; Matthew,0,0,0,3
1745819509300,MMW 12R,A01,892724,Herbst; Matthew,0,10,16,16
1745819509300,MMW 12R,A02,892725,Herbst; Matthew,0,9,16,16
1745819510329,MMW 13R,A01,892727,Staff,0,3,16,16
1745819510329,MMW 13R,A02,892728,Staff,0,4,16,16
1745819510329,MMW 13R,A03,958032,Staff,0,3,16,16
1745819510329,MMW 13R,A04,958033,Staff,0,2,16,16
1745819510329,MMW 13R,A05,958034,Staff,0,3,16,16
1745819511358,SIO 295LS,A00,894015,Staff,7,0,25,18
1745819512392,SIO 295S,A00,894020,Staff,7,0,25,18
1745819513422,SIOC 290S,B01,958918,Staff,0,0,0,0
1745819514448,SIOC 291S,B01,958922,Staff,0,0,0,0
1745819515475,SOCI 117,A01,895339,Staff,4,0,5,1
1745819516501,WES 237B,A00,894149,Staff,11,0,20,9
1745819518554,AESE 279B,A00,891859,Staff,13,0,35,22
1745819519579,AIP 197,001,891854,Staff,70,0,70,0
1745819520604,ANTH 289S,A00,891856,Gagneux; Pascal,12,0,12,0
1745819521628,BENG 196,001,957946,Engler; Adam J.,9996,0,9999,3
1745819522656,CAT 124RS,A01,956906,Staff,8,0,25,17
1745819523681,CAT 125RS,A01,922013,Staff,8,0,25,17
1745819524707,CLRE 250,A00,891860,Morris; Sheldon,9995,0,9999,4
1745819526759,CLRE 251R,A00,907817,Mehta; Ravindra L.,9994,0,9999,5
1745819527784,CLRE 252,A00,891864,Cuomo; Raphael Eduardo,9993,0,9999,6
1745819528810,CLRE 253,A00,891867,Vaida; Florin,9994,0,9999,5
1745819528810,CLRE 253,B00,907819,Staff,9999,0,9999,0
1745819529837,CLRE 259,A00,891868,Patel; Hemal,9998,0,9999,1
1745819530863,CLRE 260,A00,891872,Cuomo; Raphael Eduardo,9999,0,9999,0
1745819531888,CLRE 297,001,891888,Cuomo; Raphael Eduardo,9999,0,9999,0
1745819532913,CSE 191,A00,958773,Minnes Kemp; Mor Mia,9999,0,9999,0
1745819533942,CSS 201S,A01,892054,Mignozzetti; Umberto,30,0,30,0
1745819534969,CSS 202S,A01,892056,Mignozzetti; Umberto,30,0,30,0
1745819535996,DSC 197,001,956898,Eldridge; Justin Matthew,9998,0,9999,1
1745819537019,DSC 297,001,958000,Mazumdar; Arya,9998,0,9999,1
1745819538045,EAP 100,A00,905686,Staff,9776,0,9999,223
1745819539073,ECE 45,A01,892618,Staff,0,12,50,50
1745819540122,ECE 109,A01,892620,Staff,0,43,0,0
1745819541150,ECE 111,A01,892719,Staff,0,9,50,50
1745819542175,ECE 197,001,957920,Mercier; Patrick Philip,9992,0,9999,7
1745819543205,ECON 178,A01,907814,Zhu; Ying,28,0,35,7
1745819544229,EDS 115,A00,895312,Staff,41,0,45,4
1745819545255,EDS 117,A01,895337,Staff,30,0,30,0
1745819546279,EDS 125,A00,895341,Jones; Gabrielle Anastasia,43,0,45,2
1745819547308,EDS 128A,A01,895459,Fargason; Sharon Gayle,44,0,45,1
1745819548333,EDS 128B,A01,895543,Pappas; Elizabeth,44,0,45,1
1745819549361,EDS 139,A00,897203,Pappas; Elizabeth,44,0,45,1
1745819549361,EDS 139,B00,897209,Fargason; Sharon Gayle,44,0,45,1
1745819550386,EDS 201,A00,895545,Staff,43,0,45,2
1745819551415,EDS 203,A01,895581,Halter; Christopher P.,43,0,45,2
1745819552441,EDS 204R,A01,895625,Heinzman; Erica M.,43,0,45,2
1745819552441,EDS 204R,B01,895693,Halter; Christopher P.,18,0,45,27
1745819553467,EDS 206R,A00,895694,Fargason; Sharon Gayle,9,0,30,21
1745819553467,EDS 206R,B00,895695,Choi; Bailey Miyeon,20,0,30,10
1745819554492,EDS 250,A00,895697,Hemans; Patricia Ann Benitez,43,0,45,2
1745819555521,EDS 281,A00,895701,Meyerott; Theresa Ann,15,0,15,0
1745819556546,EDS 284,A00,895736,Meyerott; Theresa Ann,15,0,15,0
1745819557572,EDS 286,A00,897210,Fine; Sarah,15,0,15,0
1745819558599,EDS 289C,A01,895770,Daly; Alan J.,15,0,15,0
1745819559625,EDS 290,A00,897211,Hofstetter; Carolyn,15,0,15,0
1745819560649,LIGM 5A,A00,896162,Fischer-Grunski; Eva K,15,0,20,5
1745819561676,LIGM 5B,A00,896260,Fischer-Grunski; Eva K,17,0,20,3
1745819562703,LIGM 5C,A00,896308,Fischer-Grunski; Eva K,18,0,20,2
1745819563732,LIIT 5AS,A00,896313,Carnelos; Chiara,17,0,20,3
1745819564759,LIIT 5BS,A00,896416,Carnelos; Chiara,20,0,20,0
1745819565790,LIIT 5CS,A00,896564,Carnelos; Chiara,20,0,20,0
1745819566815,LISP 5A,A00,896588,Munoz Sanchez; Alicia,4,0,20,16
1745819567866,LISP 5B,A00,896653,Munoz Sanchez; Alicia,10,0,20,10
1745819568897,LISP 5C,A00,896655,Munoz Sanchez; Alicia,4,0,20,16
1745819569924,MAE 197,001,957918,Kleissl; Jan,9998,0,9999,1
1745819570949,MATH 2,A01,957937,Staff,34,0,35,1
1745819571977,MATH 197,001,957876,Kedlaya; Kiran S.,9993,0,9999,6
1745819573003,MCWP 40,A00,892729,Duru; Nur,13,0,20,7
1745819573003,MCWP 40,B00,893304,Montejo; Carolina,20,0,20,0
1745819574028,MCWP 40R,A00,893757,Redela; Pamela Morgan,0,7,20,20
1745819575053,MCWP 50,A00,893758,Morshed; Michael James,2,0,20,18
1745819575053,MCWP 50,B00,893761,Bartulis; Jason Michael,18,0,20,2
1745819576081,MCWP 50R,A00,893766,Compas; Sean Matthew,0,1,20,20
1745819576081,MCWP 50R,B00,893769,Carter; Jennifer A,0,0,20,20
1745819576081,MCWP 50R,C00,893771,Krone; Jarret,0,3,20,20
1745819576081,MCWP 50R,D00,893772,Miller; Elizabeth Deen,3,0,20,17
1745819576081,MCWP 50R,E00,893775,Carter; Andrea L,0,0,20,20
1745819577110,MMW 11R,A01,892721,Herbst; Matthew,11,0,27,16
1745819577110,MMW 11R,A02,892722,Herbst; Matthew,0,0,0,3
1745819578134,MMW 12R,A01,892724,Herbst; Matthew,0,10,16,16
1745819578134,MMW 12R,A02,892725,Herbst; Matthew,0,9,16,16
1745819579161,MMW 13R,A01,892727,Staff,0,3,16,16
1745819579161,MMW 13R,A02,892728,Staff,0,4,16,16
1745819579161,MMW 13R,A03,958032,Staff,0,3,16,16
1745819579161,MMW 13R,A04,958033,Staff,0,2,16,16
1745819579161,MMW 13R,A05,958034,Staff,0,3,16,16
1745819580185,SIO 295LS,A00,894015,Staff,7,0,25,18
1745819581211,SIO 295S,A00,894020,Staff,7,0,25,18
1745819582239,SIOC 290S,B01,958918,Staff,0,0,0,0
1745819583265,SIOC 291S,B01,958922,Staff,0,0,0,0
1745819584289,SOCI 117,A01,895339,Staff,4,0,5,1
1745819585314,WES 237B,A00,894149,Staff,11,0,20,9
1745819587374,AESE 279B,A00,891859,Staff,13,0,35,22
1745819588402,AIP 197,001,891854,Staff,70,0,70,0
1745819589430,ANTH 289S,A00,891856,Gagneux; Pascal,12,0,12,0
1745819590454,BENG 196,001,957946,Engler; Adam J.,9996,0,9999,3
1745819591483,CAT 124RS,A01,956906,Staff,8,0,25,17
1745819592507,CAT 125RS,A01,922013,Staff,8,0,25,17
1745819593533,CLRE 250,A00,891860,Morris; Sheldon,9995,0,9999,4
1745819595586,CLRE 251R,A00,907817,Mehta; Ravindra L.,9994,0,9999,5
1745819596611,CLRE 252,A00,891864,Cuomo; Raphael Eduardo,9993,0,9999,6
1745819597640,CLRE 253,A00,891867,Vaida; Florin,9994,0,9999,5
1745819597640,CLRE 253,B00,907819,Staff,9999,0,9999,0
1745819598666,CLRE 259,A00,891868,Patel; Hemal,9998,0,9999,1
1745819599689,CLRE 260,A00,891872,Cuomo; Raphael Eduardo,9999,0,9999,0
1745819600715,CLRE 297,001,891888,Cuomo; Raphael Eduardo,9999,0,9999,0
1745819601745,CSE 191,A00,958773,Minnes Kemp; Mor Mia,9999,0,9999,0
1745819602773,CSS 201S,A01,892054,Mignozzetti; Umberto,30,0,30,0
1745819603800,CSS 202S,A01,892056,Mignozzetti; Umberto,30,0,30,0
1745819604827,DSC 197,001,956898,Eldridge; Justin Matthew,9998,0,9999,1
1745819605856,DSC 297,001,958000,Mazumdar; Arya,9998,0,9999,1
1745819606881,EAP 100,A00,905686,Staff,9776,0,9999,223
1745819607909,ECE 45,A01,892618,Staff,0,12,50,50
1745819608935,ECE 109,A01,892620,Staff,0,43,0,0
1745819609960,ECE 111,A01,892719,Staff,0,9,50,50
1745819610985,ECE 197,001,957920,Mercier; Patrick Philip,9992,0,9999,7
1745819612011,ECON 178,A01,907814,Zhu; Ying,28,0,35,7
1745819613035,EDS 115,A00,895312,Staff,41,0,45,4
1745819614062,EDS 117,A01,895337,Staff,30,0,30,0
1745819615087,EDS 125,A00,895341,Jones; Gabrielle Anastasia,43,0,45,2
1745819616116,EDS 128A,A01,895459,Fargason; Sharon Gayle,44,0,45,1
1745819617143,EDS 128B,A01,895543,Pappas; Elizabeth,44,0,45,1
1745819618169,EDS 139,A00,897203,Pappas; Elizabeth,44,0,45,1
1745819618169,EDS 139,B00,897209,Fargason; Sharon Gayle,44,0,45,1
1745819619194,EDS 201,A00,895545,Staff,43,0,45,2
1745819620218,EDS 203,A01,895581,Halter; Christopher P.,43,0,45,2
1745819621248,EDS 204R,A01,895625,Heinzman; Erica M.,43,0,45,2
1745819621248,EDS 204R,B01,895693,Halter; Christopher P.,18,0,45,27
1745819622394,EDS 206R,A00,895694,Fargason; Sharon Gayle,9,0,30,21
1745819622394,EDS 206R,B00,895695,Choi; Bailey Miyeon,20,0,30,10
1745819623418,EDS 250,A00,895697,Hemans; Patricia Ann Benitez,43,0,45,2
1745819624566,EDS 281,A00,895701,Meyerott; Theresa Ann,15,0,15,0
1745819625593,EDS 284,A00,895736,Meyerott; Theresa Ann,15,0,15,0
1745819626619,EDS 286,A00,897210,Fine; Sarah,15,0,15,0
1745819627648,EDS 289C,A01,895770,Daly; Alan J.,15,0,15,0
1745819628679,EDS 290,A00,897211,Hofstetter; Carolyn,15,0,15,0
1745819629707,LIGM 5A,A00,896162,Fischer-Grunski; Eva K,15,0,20,5
1745819630732,LIGM 5B,A00,896260,Fischer-Grunski; Eva K,17,0,20,3
1745819631761,LIGM 5C,A00,896308,Fischer-Grunski; Eva K,18,0,20,2
1745819632789,LIIT 5AS,A00,896313,Carnelos; Chiara,17,0,20,3
1745819633815,LIIT 5BS,A00,896416,Carnelos; Chiara,20,0,20,0
1745819634841,LIIT 5CS,A00,896564,Carnelos; Chiara,20,0,20,0
1745819635867,LISP 5A,A00,896588,Munoz Sanchez; Alicia,4,0,20,16
1745819636893,LISP 5B,A00,896653,Munoz Sanchez; Alicia,10,0,20,10
1745819637918,LISP 5C,A00,896655,Munoz Sanchez; Alicia,4,0,20,16
1745819638944,MAE 197,001,957918,Kleissl; Jan,9998,0,9999,1
1745819639970,MATH 2,A01,957937,Staff,34,0,35,1
1745819641054,MATH 197,001,957876,Kedlaya; Kiran S.,9993,0,9999,6
1745819642080,MCWP 40,A00,892729,Duru; Nur,13,0,20,7
1745819642080,MCWP 40,B00,893304,Montejo; Carolina,20,0,20,0
1745819643106,MCWP 40R,A00,893757,Redela; Pamela Morgan,0,7,20,20
1745819644135,MCWP 50,A00,893758,Morshed; Michael James,2,0,20,18
1745819644135,MCWP 50,B00,893761,Bartulis; Jason Michael,18,0,20,2
1745819645164,MCWP 50R,A00,893766,Compas; Sean Matthew,0,1,20,20
1745819645164,MCWP 50R,B00,893769,Carter; Jennifer A,0,0,20,20
1745819645164,MCWP 50R,C00,893771,Krone; Jarret,0,3,20,20
1745819645164,MCWP 50R,D00,893772,Miller; Elizabeth Deen,3,0,20,17
1745819645164,MCWP 50R,E00,893775,Carter; Andrea L,0,0,20,20
1745819646190,MMW 11R,A01,892721,Herbst; Matthew,11,0,27,16
1745819646190,MMW 11R,A02,892722,Herbst; Matthew,0,0,0,3
1745819647218,MMW 12R,A01,892724,Herbst; Matthew,0,10,16,16
1745819647218,MMW 12R,A02,892725,Herbst; Matthew,0,9,16,16
1745819648243,MMW 13R,A01,892727,Staff,0,3,16,16
1745819648243,MMW 13R,A02,892728,Staff,0,4,16,16
1745819648243,MMW 13R,A03,958032,Staff,0,3,16,16
1745819648243,MMW 13R,A04,958033,Staff,0,2,16,16
1745819648243,MMW 13R,A05,958034,Staff,0,3,16,16
1745819649269,SIO 295LS,A00,894015,Staff,7,0,25,18
1745819650299,SIO 295S,A00,894020,Staff,7,0,25,18
1745819651325,SIOC 290S,B01,958918,Staff,0,0,0,0
1745819652355,SIOC 291S,B01,958922,Staff,0,0,0,0
1745819653381,SOCI 117,A01,895339,Staff,4,0,5,1
1745819654406,WES 237B,A00,894149,Staff,11,0,20,9
1745819656474,AESE 279B,A00,891859,Staff,13,0,35,22
1745819657499,AIP 197,001,891854,Staff,70,0,70,0
1745819658524,ANTH 289S,A00,891856,Gagneux; Pascal,12,0,12,0
1745819659550,BENG 196,001,957946,Engler; Adam J.,9996,0,9999,3
1745819660577,CAT 124RS,A01,956906,Staff,8,0,25,17
1745819661603,CAT 125RS,A01,922013,Staff,8,0,25,17
1745819662628,CLRE 250,A00,891860,Morris; Sheldon,9995,0,9999,4
1745819664681,CLRE 251R,A00,907817,Mehta; Ravindra L.,9994,0,9999,5
1745819665706,CLRE 252,A00,891864,Cuomo; Raphael Eduardo,9993,0,9999,6
1745819666735,CLRE 253,A00,891867,Vaida; Florin,9994,0,9999,5
1745819666735,CLRE 253,B00,907819,Staff,9999,0,9999,0
1745819667761,CLRE 259,A00,891868,Patel; Hemal,9998,0,9999,1
1745819668784,CLRE 260,A00,891872,Cuomo; Raphael Eduardo,9999,0,9999,0
1745819669809,CLRE 297,001,891888,Cuomo; Raphael Eduardo,9999,0,9999,0
1745819670835,CSE 191,A00,958773,Minnes Kemp; Mor Mia,9999,0,9999,0
1745819671866,CSS 201S,A01,892054,Mignozzetti; Umberto,30,0,30,0
1745819672896,CSS 202S,A01,892056,Mignozzetti; Umberto,30,0,30,0
1745819673923,DSC 197,001,956898,Eldridge; Justin Matthew,9998,0,9999,1
1745819674948,DSC 297,001,958000,Mazumdar; Arya,9998,0,9999,1
1745819675974,EAP 100,A00,905686,Staff,9776,0,9999,223
1745819676999,ECE 45,A01,892618,Staff,0,12,50,50
1745819678026,ECE 109,A01,892620,Staff,0,43,0,0
1745819679049,ECE 111,A01,892719,Staff,0,9,50,50
1745819680075,ECE 197,001,957920,Mercier; Patrick Philip,9992,0,9999,7
1745819681103,ECON 178,A01,907814,Zhu; Ying,28,0,35,7
1745819682129,EDS 115,A00,895312,Staff,41,0,45,4
1745819683156,EDS 117,A01,895337,Staff,30,0,30,0
1745819684181,EDS 125,A00,895341,Jones; Gabrielle Anastasia,43,0,45,2
1745819685209,EDS 128A,A01,895459,Fargason; Sharon Gayle,44,0,45,1
1745819686237,EDS 128B,A01,895543,Pappas; Elizabeth,44,0,45,1
1745819687263,EDS 139,A00,897203,Pappas; Elizabeth,44,0,45,1
1745819687263,EDS 139,B00,897209,Fargason; Sharon Gayle,44,0,45,1
1745819688291,EDS 201,A00,895545,Staff,43,0,45,2
1745819689320,EDS 203,A01,895581,Halter; Christopher P.,43,0,45,2
1745819690347,EDS 204R,A01,895625,Heinzman; Erica M.,43,0,45,2
1745819690347,EDS 204R,B01,895693,Halter; Christopher P.,18,0,45,27
1745819691374,EDS 206R,A00,895694,Fargason; Sharon Gayle,9,0,30,21
1745819691374,EDS 206R,B00,895695,Choi; Bailey Miyeon,20,0,30,10
1745819692401,EDS 250,A00,895697,Hemans; Patricia Ann Benitez,43,0,45,2
1745819693466,EDS 281,A00,895701,Meyerott; Theresa Ann,15,0,15,0
1745819694491,EDS 284,A00,895736,Meyerott; Theresa Ann,15,0,15,0
1745819695516,EDS 286,A00,897210,Fine; Sarah,15,0,15,0
1745819696543,EDS 289C,A01,895770,Daly; Alan J.,15,0,15,0
1745819697569,EDS 290,A00,897211,Hofstetter; Carolyn,15,0,15,0
1745819698593,LIGM 5A,A00,896162,Fischer-Grunski; Eva K,15,0,20,5
1745819699621,LIGM 5B,A00,896260,Fischer-Grunski; Eva K,17,0,20,3
1745819700646,LIGM 5C,A00,896308,Fischer-Grunski; Eva K,18,0,20,2
1745819701673,LIIT 5AS,A00,896313,Carnelos; Chiara,17,0,20,3
1745819702698,LIIT 5BS,A00,896416,Carnelos; Chiara,20,0,20,0
1745819703731,LIIT 5CS,A00,896564,Carnelos; Chiara,20,0,20,0
1745819704760,LISP 5A,A00,896588,Munoz Sanchez; Alicia,4,0,20,16
1745819705786,LISP 5B,A00,896653,Munoz Sanchez; Alicia,10,0,20,10
1745819706814,LISP 5C,A00,896655,Munoz Sanchez; Alicia,4,0,20,16
1745819707841,MAE 197,001,957918,Kleissl; Jan,9998,0,9999,1
1745819708868,MATH 2,A01,957937,Staff,34,0,35,1
1745819709897,MATH 197,001,957876,Kedlaya; Kiran S.,9993,0,9999,6
1745819710921,MCWP 40,A00,892729,Duru; Nur,13,0,20,7
1745819710921,MCWP 40,B00,893304,Montejo; Carolina,20,0,20,0
1745819711946,MCWP 40R,A00,893757,Redela; Pamela Morgan,0,7,20,20
1745819712973,MCWP 50,A00,893758,Morshed; Michael James,2,0,20,18
1745819712973,MCWP 50,B00,893761,Bartulis; Jason Michael,18,0,20,2
1745819713998,MCWP 50R,A00,893766,Compas; Sean Matthew,0,1,20,20
1745819713998,MCWP 50R,B00,893769,Carter; Jennifer A,0,0,20,20
1745819713998,MCWP 50R,C00,893771,Krone; Jarret,0,3,20,20
1745819713998,MCWP 50R,D00,893772,Miller; Elizabeth Deen,3,0,20,17
1745819713998,MCWP 50R,E00,893775,Carter; Andrea L,0,0,20,20
1745819715028,MMW 11R,A01,892721,Herbst; Matthew,11,0,27,16
1745819715028,MMW 11R,A02,892722,Herbst; Matthew,0,0,0,3
1745819716055,MMW 12R,A01,892724,Herbst; Matthew,0,10,16,16
1745819716055,MMW 12R,A02,892725,Herbst; Matthew,0,9,16,16
1745819717080,MMW 13R,A01,892727,Staff,0,3,16,16
1745819717080,MMW 13R,A02,892728,Staff,0,4,16,16
1745819717080,MMW 13R,A03,958032,Staff,0,3,16,16
1745819717080,MMW 13R,A04,958033,Staff,0,2,16,16
1745819717080,MMW 13R,A05,958034,Staff,0,3,16,16
1745819718104,SIO 295LS,A00,894015,Staff,7,0,25,18
1745819719129,SIO 295S,A00,894020,Staff,7,0,25,18
1745819720162,SIOC 290S,B01,958918,Staff,0,0,0,0
1745819721187,SIOC 291S,B01,958922,Staff,0,0,0,0
1745819722213,SOCI 117,A01,895339,Staff,4,0,5,1
1745819723237,WES 237B,A00,894149,Staff,11,0,20,9
1745819725294,AESE 279B,A00,891859,Staff,13,0,35,22
1745819726320,AIP 197,001,891854,Staff,70,0,70,0
1745819727345,ANTH 289S,A00,891856,Gagneux; Pascal,12,0,12,0
1745819728400,BENG 196,001,957946,Engler; Adam J.,9996,0,9999,3
1745819729425,CAT 124RS,A01,956906,Staff,8,0,25,17
1745819730450,CAT 125RS,A01,922013,Staff,8,0,25,17
1745819731477,CLRE 250,A00,891860,Morris; Sheldon,9995,0,9999,4
1745819733527,CLRE 251R,A00,907817,Mehta; Ravindra L.,9994,0,9999,5
1745819734551,CLRE 252,A00,891864,Cuomo; Raphael Eduardo,9993,0,9999,6
1745819735578,CLRE 253,A00,891867,Vaida; Florin,9994,0,9999,5
1745819735578,CLRE 253,B00,907819,Staff,9999,0,9999,0
1745819736605,CLRE 259,A00,891868,Patel; Hemal,9998,0,9999,1
1745819737630,CLRE 260,A00,891872,Cuomo; Raphael Eduardo,9999,0,9999,0
1745819738658,CLRE 297,001,891888,Cuomo; Raphael Eduardo,9999,0,9999,0
1745819739683,CSE 191,A00,958773,Minnes Kemp; Mor Mia,9999,0,9999,0
1745819740714,CSS 201S,A01,892054,Mignozzetti; Umberto,30,0,30,0
1745819741739,CSS 202S,A01,892056,Mignozzetti; Umberto,30,0,30,0
1745819742766,DSC 197,001,956898,Eldridge; Justin Matthew,9998,0,9999,1
1745819743795,DSC 297,001,958000,Mazumdar; Arya,9998,0,9999,1
1745819744821,EAP 100,A00,905686,Staff,9776,0,9999,223
1745819745850,ECE 45,A01,892618,Staff,0,12,50,50
1745819746874,ECE 109,A01,892620,Staff,0,43,0,0
1745819747904,ECE 111,A01,892719,Staff,0,9,50,50
1745819748931,ECE 197,001,957920,Mercier; Patrick Philip,9992,0,9999,7
1745819749955,ECON 178,A01,907814,Zhu; Ying,28,0,35,7
1745819750979,EDS 115,A00,895312,Staff,41,0,45,4
1745819752004,EDS 117,A01,895337,Staff,30,0,30,0
1745819753030,EDS 125,A00,895341,Jones; Gabrielle Anastasia,43,0,45,2
1745819754058,EDS 128A,A01,895459,Fargason; Sharon Gayle,44,0,45,1
1745819755084,EDS 128B,A01,895543,Pappas; Elizabeth,44,0,45,1
1745819756113,EDS 139,A00,897203,Pappas; Elizabeth,44,0,45,1
1745819756113,EDS 139,B00,897209,Fargason; Sharon Gayle,44,0,45,1
1745819757139,EDS 201,A00,895545,Staff,43,0,45,2
1745819758165,EDS 203,A01,895581,Halter; Christopher P.,43,0,45,2
1745819759191,EDS 204R,A01,895625,Heinzman; Erica M.,43,0,45,2
1745819759191,EDS 204R,B01,895693,Halter; Christopher P.,18,0,45,27
1745819760218,EDS 206R,A00,895694,Fargason; Sharon Gayle,9,0,30,21
1745819760218,EDS 206R,B00,895695,Choi; Bailey Miyeon,20,0,30,10
1745819761247,EDS 250,A00,895697,Hemans; Patricia Ann Benitez,43,0,45,2
1745819762274,EDS 281,A00,895701,Meyerott; Theresa Ann,15,0,15,0
1745819763303,EDS 284,A00,895736,Meyerott; Theresa Ann,15,0,15,0
1745819764331,EDS 286,A00,897210,Fine; Sarah,15,0,15,0
1745819765357,EDS 289C,A01,895770,Daly; Alan J.,15,0,15,0
1745819766384,EDS 290,A00,897211,Hofstetter; Carolyn,15,0,15,0
1745819767409,LIGM 5A,A00,896162,Fischer-Grunski; Eva K,15,0,20,5
1745819768434,LIGM 5B,A00,896260,Fischer-Grunski; Eva K,17,0,20,3
1745819769461,LIGM 5C,A00,896308,Fischer-Grunski; Eva K,18,0,20,2
1745819770486,LIIT 5AS,A00,896313,Carnelos; Chiara,17,0,20,3
1745819771514,LIIT 5BS,A00,896416,Carnelos; Chiara,20,0,20,0
1745819772540,LIIT 5CS,A00,896564,Carnelos; Chiara,20,0,20,0
1745819773570,LISP 5A,A00,896588,Munoz Sanchez; Alicia,4,0,20,16
1745819774599,LISP 5B,A00,896653,Munoz Sanchez; Alicia,10,0,20,10
1745819775623,LISP 5C,A00,896655,Munoz Sanchez; Alicia,4,0,20,16
1745819776649,MAE 197,001,957918,Kleissl; Jan,9998,0,9999,1
1745819777674,MATH 2,A01,957937,Staff,34,0,35,1
1745819778698,MATH 197,001,957876,Kedlaya; Kiran S.,9993,0,9999,6
1745819779725,MCWP 40,A00,892729,Duru; Nur,13,0,20,7
1745819779725,MCWP 40,B00,893304,Montejo; Carolina,20,0,20,0
1745819780750,MCWP 40R,A00,893757,Redela; Pamela Morgan,0,7,20,20
1745819781781,MCWP 50,A00,893758,Morshed; Michael James,2,0,20,18
1745819781781,MCWP 50,B00,893761,Bartulis; Jason Michael,18,0,20,2
1745819782812,MCWP 50R,A00,893766,Compas; Sean Matthew,0,1,20,20
1745819782812,MCWP 50R,B00,893769,Carter; Jennifer A,0,0,20,20
1745819782812,MCWP 50R,C00,893771,Krone; Jarret,0,3,20,20
1745819782812,MCWP 50R,D00,893772,Miller; Elizabeth Deen,3,0,20,17
1745819782812,MCWP 50R,E00,893775,Carter; Andrea L,0,0,20,20
1745819783837,MMW 11R,A01,892721,Herbst; Matthew,11,0,27,16
1745819783837,MMW 11R,A02,892722,Herbst; Matthew,0,0,0,3
1745819784865,MMW 12R,A01,892724,Herbst; Matthew,0,10,16,16
1745819784865,MMW 12R,A02,892725,Herbst; Matthew,0,9,16,16
1745819785894,MMW 13R,A01,892727,Staff,0,3,16,16
1745819785894,MMW 13R,A02,892728,Staff,0,4,16,16
1745819785894,MMW 13R,A03,958032,Staff,0,3,16,16
1745819785894,MMW 13R,A04,958033,Staff,0,2,16,16
1745819785894,MMW 13R,A05,958034,Staff,0,3,16,16
1745819786920,SIO 295LS,A00,894015,Staff,7,0,25,18
1745819787947,SIO 295S,A00,894020,Staff,7,0,25,18
1745819788978,SIOC 290S,B01,958918,Staff,0,0,0,0
1745819790012,SIOC 291S,B01,958922,Staff,0,0,0,0
1745819791040,SOCI 117,A01,895339,Staff,4,0,5,1
1745819792065,WES 237B,A00,894149,Staff,11,0,20,9
1745819794132,AESE 279B,A00,891859,Staff,13,0,35,22
1745819795159,AIP 197,001,891854,Staff,70,0,70,0
1745819796185,ANTH 289S,A00,891856,Gagneux; Pascal,12,0,12,0
1745819797211,BENG 196,001,957946,Engler; Adam J.,9996,0,9999,3
1745819798239,CAT 124RS,A01,956906,Staff,8,0,25,17
1745819799308,CAT 125RS,A01,922013,Staff,8,0,25,17
1745819800334,CLRE 250,A00,891860,Morris; Sheldon,9995,0,9999,4
1745819802401,CLRE 251R,A00,907817,Mehta; Ravindra L.,9994,0,9999,5
1745819803430,CLRE 252,A00,891864,Cuomo; Raphael Eduardo,9993,0,9999,6
1745819804457,CLRE 253,A00,891867,Vaida; Florin,9994,0,9999,5
1745819804457,CLRE 253,B00,907819,Staff,9999,0,9999,0
1745819805482,CLRE 259,A00,891868,Patel; Hemal,9998,0,9999,1
1745819806510,CLRE 260,A00,891872,Cuomo; Raphael Eduardo,9999,0,9999,0
1745819807535,CLRE 297,001,891888,Cuomo; Raphael Eduardo,9999,0,9999,0
1745819808561,CSE 191,A00,958773,Minnes Kemp; Mor Mia,9999,0,9999,0
1745819809585,CSS 201S,A01,892054,Mignozzetti; Umberto,30,0,30,0
1745819810614,CSS 202S,A01,892056,Mignozzetti; Umberto,30,0,30,0
1745819811642,DSC 197,001,956898,Eldridge; Justin Matthew,9998,0,9999,1
1745819812671,DSC 297,001,958000,Mazumdar; Arya,9998,0,9999,1
1745819813696,EAP 100,A00,905686,Staff,9776,0,9999,223
1745819814721,ECE 45,A01,892618,Staff,0,12,50,50
1745819815747,ECE 109,A01,892620,Staff,0,43,0,0
1745819816774,ECE 111,A01,892719,Staff,0,9,50,50
1745819817799,ECE 197,001,957920,Mercier; Patrick Philip,9992,0,9999,7
1745819818825,ECON 178,A01,907814,Zhu; Ying,28,0,35,7
1745819819850,EDS 115,A00,895312,Staff,41,0,45,4
1745819820876,EDS 117,A01,895337,Staff,30,0,30,0
1745819821902,EDS 125,A00,895341,Jones; Gabrielle Anastasia,43,0,45,2
1745819822930,EDS 128A,A01,895459,Fargason; Sharon Gayle,44,0,45,1
1745819823954,EDS 128B,A01,895543,Pappas; Elizabeth,44,0,45,1
1745819824979,EDS 139,A00,897203,Pappas; Elizabeth,44,0,45,1
1745819824979,EDS 139,B00,897209,Fargason; Sharon Gayle,44,0,45,1
1745819826003,EDS 201,A00,895545,Staff,43,0,45,2
1745819827029,EDS 203,A01,895581,Halter; Christopher P.,43,0,45,2
1745819828053,EDS 204R,A01,895625,Heinzman; Erica M.,43,0,45,2
1745819828053,EDS 204R,B01,895693,Halter; Christopher P.,18,0,45,27
1745819829078,EDS 206R,A00,895694,Fargason; Sharon Gayle,9,0,30,21
1745819829078,EDS 206R,B00,895695,Choi; Bailey Miyeon,20,0,30,10
1745819830105,EDS 250,A00,895697,Hemans; Patricia Ann Benitez,43,0,45,2
1745819831131,EDS 281,A00,895701,Meyerott; Theresa Ann,15,0,15,0
1745819832155,EDS 284,A00,895736,Meyerott; Theresa Ann,15,0,15,0
1745819833181,EDS 286,A00,897210,Fine; Sarah,15,0,15,0
1745819834210,EDS 289C,A01,895770,Daly; Alan J.,15,0,15,0
1745819835242,EDS 290,A00,897211,Hofstetter; Carolyn,15,0,15,0
1745819836266,LIGM 5A,A00,896162,Fischer-Grunski; Eva K,15,0,20,5
1745819837291,LIGM 5B,A00,896260,Fischer-Grunski; Eva K,17,0,20,3
1745819838317,LIGM 5C,A00,896308,Fischer-Grunski; Eva K,18,0,20,2
1745819839342,LIIT 5AS,A00,896313,Carnelos; Chiara,17,0,20,3
1745819840369,LIIT 5BS,A00,896416,Carnelos; Chiara,20,0,20,0
1745819841394,LIIT 5CS,A00,896564,Carnelos; Chiara,20,0,20,0
1745819842442,LISP 5A,A00,896588,Munoz Sanchez; Alicia,4,0,20,16
1745819843470,LISP 5B,A00,896653,Munoz Sanchez; Alicia,10,0,20,10
1745819844498,LISP 5C,A00,896655,Munoz Sanchez; Alicia,4,0,20,16
1745819845523,MAE 197,001,957918,Kleissl; Jan,9998,0,9999,1
1745819846548,MATH 2,A01,957937,Staff,34,0,35,1
1745819847575,MATH 197,001,957876,Kedlaya; Kiran S.,9993,0,9999,6
1745819848598,MCWP 40,A00,892729,Duru; Nur,13,0,20,7
1745819848598,MCWP 40,B00,893304,Montejo; Carolina,20,0,20,0
1745819849623,MCWP 40R,A00,893757,Redela; Pamela Morgan,0,7,20,20
1745819850650,MCWP 50,A00,893758,Morshed; Michael James,2,0,20,18
1745819850650,MCWP 50,B00,893761,Bartulis; Jason Michael,18,0,20,2
1745819851678,MCWP 50R,A00,893766,Compas; Sean Matthew,0,1,20,20
1745819851678,MCWP 50R,B00,893769,Carter; Jennifer A,0,0,20,20
1745819851678,MCWP 50R,C00,893771,Krone; Jarret,0,3,20,20
1745819851678,MCWP 50R,D00,893772,Miller; Elizabeth Deen,3,0,20,17
1745819851678,MCWP 50R,E00,893775,Carter; Andrea L,0,0,20,20
1745819852706,MMW 11R,A01,892721,Herbst; Matthew,11,0,27,16
1745819852706,MMW 11R,A02,892722,Herbst; Matthew,0,0,0,3
1745819853730,MMW 12R,A01,892724,Herbst; Matthew,0,10,16,16
1745819853730,MMW 12R,A02,892725,Herbst; Matthew,0,9,16,16
1745819854757,MMW 13R,A01,892727,Staff,0,3,16,16
1745819854757,MMW 13R,A02,892728,Staff,0,4,16,16
1745819854757,MMW 13R,A03,958032,Staff,0,3,16,16
1745819854757,MMW 13R,A04,958033,Staff,0,2,16,16
1745819854757,MMW 13R,A05,958034,Staff,0,3,16,16
1745819855782,SIO 295LS,A00,894015,Staff,7,0,25,18
1745819856809,SIO 295S,A00,894020,Staff,7,0,25,18
1745819857837,SIOC 290S,B01,958918,Staff,0,0,0,0
1745819858863,SIOC 291S,B01,958922,Staff,0,0,0,0
1745819859891,SOCI 117,A01,895339,Staff,4,0,5,1
1745819860917,WES 237B,A00,894149,Staff,11,0,20,9
1745819862981,AESE 279B,A00,891859,Staff,13,0,35,22
1745819864009,AIP 197,001,891854,Staff,70,0,70,0
1745819865034,ANTH 289S,A00,891856,Gagneux; Pascal,12,0,12,0
1745819866060,BENG 196,001,957946,Engler; Adam J.,9996,0,9999,3
1745819867087,CAT 124RS,A01,956906,Staff,8,0,25,17
1745819868115,CAT 125RS,A01,922013,Staff,8,0,25,17
1745819869141,CLRE 250,A00,891860,Morris; Sheldon,9995,0,9999,4
1745819871196,CLRE 251R,A00,907817,Mehta; Ravindra L.,9994,0,9999,5
1745819872221,CLRE 252,A00,891864,Cuomo; Raphael Eduardo,9993,0,9999,6
1745819873249,CLRE 253,A00,891867,Vaida; Florin,9994,0,9999,5
1745819873249,CLRE 253,B00,907819,Staff,9999,0,9999,0
1745819874272,CLRE 259,A00,891868,Patel; Hemal,9998,0,9999,1
1745819875299,CLRE 260,A00,891872,Cuomo; Raphael Eduardo,9999,0,9999,0
1745819876322,CLRE 297,001,891888,Cuomo; Raphael Eduardo,9999,0,9999,0
1745819877345,CSE 191,A00,958773,Minnes Kemp; Mor Mia,9999,0,9999,0
1745819878372,CSS 201S,A01,892054,Mignozzetti; Umberto,30,0,30,0
1745819879396,CSS 202S,A01,892056,Mignozzetti; Umberto,30,0,30,0
1745819880424,DSC 197,001,956898,Eldridge; Justin Matthew,9998,0,9999,1
1745819881450,DSC 297,001,958000,Mazumdar; Arya,9998,0,9999,1
1745819882476,EAP 100,A00,905686,Staff,9776,0,9999,223
1745819883501,ECE 45,A01,892618,Staff,0,12,50,50
1745819884525,ECE 109,A01,892620,Staff,0,43,0,0
1745819885549,ECE 111,A01,892719,Staff,0,9,50,50
1745819886574,ECE 197,001,957920,Mercier; Patrick Philip,9992,0,9999,7
1745819887601,ECON 178,A01,907814,Zhu; Ying,28,0,35,7
1745819888627,EDS 115,A00,895312,Staff,41,0,45,4
1745819889652,EDS 117,A01,895337,Staff,30,0,30,0
1745819890678,EDS 125,A00,895341,Jones; Gabrielle Anastasia,43,0,45,2
1745819891703,EDS 128A,A01,895459,Fargason; Sharon Gayle,44,0,45,1
1745819892729,EDS 128B,A01,895543,Pappas; Elizabeth,44,0,45,1
1745819893755,EDS 139,A00,897203,Pappas; Elizabeth,44,0,45,1
1745819893755,EDS 139,B00,897209,Fargason; Sharon Gayle,44,0,45,1
1745819894782,EDS 201,A00,895545,Staff,43,0,45,2
1745819895809,EDS 203,A01,895581,Halter; Christopher P.,43,0,45,2
1745819896833,EDS 204R,A01,895625,Heinzman; Erica M.,43,0,45,2
1745819896833,EDS 204R,B01,895693,Halter; Christopher P.,18,0,45,27
1745819897858,EDS 206R,A00,895694,Fargason; Sharon Gayle,9,0,30,21
1745819897858,EDS 206R,B00,895695,Choi; Bailey Miyeon,20,0,30,10
1745819898886,EDS 250,A00,895697,Hemans; Patricia Ann Benitez,43,0,45,2
1745819899913,EDS 281,A00,895701,Meyerott; Theresa Ann,15,0,15,0
1745819900939,EDS 284,A00,895736,Meyerott; Theresa Ann,15,0,15,0
1745819901965,EDS 286,A00,897210,Fine; Sarah,15,0,15,0
1745819902992,EDS 289C,A01,895770,Daly; Alan J.,15,0,15,0
1745819904017,EDS 290,A00,897211,Hofstetter; Carolyn,15,0,15,0
1745819905048,LIGM 5A,A00,896162,Fischer-Grunski; Eva K,15,0,20,5
1745819906073,LIGM 5B,A00,896260,Fischer-Grunski; Eva K,17,0,20,3
1745819907100,LIGM 5C,A00,896308,Fischer-Grunski; Eva K,18,0,20,2
1745819908129,LIIT 5AS,A00,896313,Carnelos; Chiara,17,0,20,3
1745819909153,LIIT 5BS,A00,896416,Carnelos; Chiara,20,0,20,0
1745819910178,LIIT 5CS,A00,896564,Carnelos; Chiara,20,0,20,0
1745819911204,LISP 5A,A00,896588,Munoz Sanchez; Alicia,4,0,20,16
1745819912228,LISP 5B,A00,896653,Munoz Sanchez; Alicia,10,0,20,10
1745819913255,LISP 5C,A00,896655,Munoz Sanchez; Alicia,4,0,20,16
1745819914281,MAE 197,001,957918,Kleissl; Jan,9998,0,9999,1
1745819915309,MATH 2,A01,957937,Staff,34,0,35,1
1745819916334,MATH 197,001,957876,Kedlaya; Kiran S.,9993,0,9999,6
1745819917359,MCWP 40,A00,892729,Duru; Nur,13,0,20,7
1745819917359,MCWP 40,B00,893304,Montejo; Carolina,20,0,20,0
1745819918383,MCWP 40R,A00,893757,Redela; Pamela Morgan,0,7,20,20
1745819919411,MCWP 50,A00,893758,Morshed; Michael James,2,0,20,18
1745819919411,MCWP 50,B00,893761,Bartulis; Jason Michael,18,0,20,2
1745819920441,MCWP 50R,A00,893766,Compas; Sean Matthew,0,1,20,20
1745819920441,MCWP 50R,B00,893769,Carter; Jennifer A,0,0,20,20
1745819920441,MCWP 50R,C00,893771,Krone; Jarret,0,3,20,20
1745819920441,MCWP 50R,D00,893772,Miller; Elizabeth Deen,3,0,20,17
1745819920441,MCWP 50R,E00,893775,Carter; Andrea L,0,0,20,20
1745819921466,MMW 11R,A01,892721,Herbst; Matthew,11,0,27,16
1745819921466,MMW 11R,A02,892722,Herbst; Matthew,0,0,0,3
1745819922496,MMW 12R,A01,892724,Herbst; Matthew,0,10,16,16
1745819922496,MMW 12R,A02,892725,Herbst; Matthew,0,9,16,16
1745819923520,MMW 13R,A01,892727,Staff,0,3,16,16
1745819923520,MMW 13R,A02,892728,Staff,0,4,16,16
1745819923520,MMW 13R,A03,958032,Staff,0,3,16,16
1745819923520,MMW 13R,A04,958033,Staff,0,2,16,16
1745819923520,MMW 13R,A05,958034,Staff,0,3,16,16
1745819924569,SIO 295LS,A00,894015,Staff,7,0,25,18
1745819925594,SIO 295S,A00,894020,Staff,7,0,25,18
1745819926620,SIOC 290S,B01,958918,Staff,0,0,0,0
1745819927648,SIOC 291S,B01,958922,Staff,0,0,0,0
1745819928675,SOCI 117,A01,895339,Staff,4,0,5,1
1745819929701,WES 237B,A00,894149,Staff,11,0,20,9
1745819931759,AESE 279B,A00,891859,Staff,13,0,35,22
1745819932785,AIP 197,001,891854,Staff,70,0,70,0
1745819933812,ANTH 289S,A00,891856,Gagneux; Pascal,12,0,12,0
1745819934838,BENG 196,001,957946,Engler; Adam J.,9996,0,9999,3
1745819935864,CAT 124RS,A01,956906,Staff,8,0,25,17
1745819936888,CAT 125RS,A01,922013,Staff,8,0,25,17
1745819937912,CLRE 250,A00,891860,Morris; Sheldon,9995,0,9999,4
1745819939963,CLRE 251R,A00,907817,Mehta; Ravindra L.,9994,0,9999,5
1745819940989,CLRE 252,A00,891864,Cuomo; Raphael Eduardo,9993,0,9999,6
1745819942015,CLRE 253,A00,891867,Vaida; Florin,9994,0,9999,5
1745819942015,CLRE 253,B00,907819,Staff,9999,0,9999,0
1745819943041,CLRE 259,A00,891868,Patel; Hemal,9998,0,9999,1
1745819944066,CLRE 260,A00,891872,Cuomo; Raphael Eduardo,9999,0,9999,0
1745819945094,CLRE 297,001,891888,Cuomo; Raphael Eduardo,9999,0,9999,0
1745819946123,CSE 191,A00,958773,Minnes Kemp; Mor Mia,9999,0,9999,0
1745819947148,CSS 201S,A01,892054,Mignozzetti; Umberto,30,0,30,0
1745819948174,CSS 202S,A01,892056,Mignozzetti; Umberto,30,0,30,0
1745819949203,DSC 197,001,956898,Eldridge; Justin Matthew,9998,0,9999,1
1745819950252,DSC 297,001,958000,Mazumdar; Arya,9998,0,9999,1
1745819951278,EAP 100,A00,905686,Staff,9776,0,9999,223
1745819952304,ECE 45,A01,892618,Staff,0,12,50,50
1745819953332,ECE 109,A01,892620,Staff,0,43,0,0
1745819954358,ECE 111,A01,892719,Staff,0,9,50,50
1745819955385,ECE 197,001,957920,Mercier; Patrick Philip,9992,0,9999,7
1745819956413,ECON 178,A01,907814,Zhu; Ying,28,0,35,7
1745819957440,EDS 115,A00,895312,Staff,41,0,45,4
1745819958464,EDS 117,A01,895337,Staff,30,0,30,0
1745819959489,EDS 125,A00,895341,Jones; Gabrielle Anastasia,43,0,45,2
1745819960514,EDS 128A,A01,895459,Fargason; Sharon Gayle,44,0,45,1
1745819961542,EDS 128B,A01,895543,Pappas; Elizabeth,44,0,45,1
1745819962567,EDS 139,A00,897203,Pappas; Elizabeth,44,0,45,1
1745819962567,EDS 139,B00,897209,Fargason; Sharon Gayle,44,0,45,1
1745819963592,EDS 201,A00,895545,Staff,43,0,45,2
1745819964618,EDS 203,A01,895581,Halter; Christopher P.,43,0,45,2
1745819965642,EDS 204R,A01,895625,Heinzman; Erica M.,43,0,45,2
1745819965642,EDS 204R,B01,895693,Halter; Christopher P.,18,0,45,27
1745819966669,EDS 206R,A00,895694,Fargason; Sharon Gayle,9,0,30,21
1745819966669,EDS 206R,B00,895695,Choi; Bailey Miyeon,20,0,30,10
1745819967694,EDS 250,A00,895697,Hemans; Patricia Ann Benitez,43,0,45,2
1745819968719,EDS 281,A00,895701,Meyerott; Theresa Ann,15,0,15,0
1745819969743,EDS 284,A00,895736,Meyerott; Theresa Ann,15,0,15,0
1745819970769,EDS 286,A00,897210,Fine; Sarah,15,0,15,0
1745819971794,EDS 289C,A01,895770,Daly; Alan J.,15,0,15,0
1745819972821,EDS 290,A00,897211,Hofstetter; Carolyn,15,0,15,0
1745819973846,LIGM 5A,A00,896162,Fischer-Grunski; Eva K,15,0,20,5
1745819974874,LIGM 5B,A00,896260,Fischer-Grunski; Eva K,17,0,20,3
1745819975899,LIGM 5C,A00,896308,Fischer-Grunski; Eva K,18,0,20,2
1745819976924,LIIT 5AS,A00,896313,Carnelos; Chiara,17,0,20,3
1745819977953,LIIT 5BS,A00,896416,Carnelos; Chiara,20,0,20,0
1745819978981,LIIT 5CS,A00,896564,Carnelos; Chiara,20,0,20,0
1745819980008,LISP 5A,A00,896588,Munoz Sanchez; Alicia,4,0,20,16
1745819981036,LISP 5B,A00,896653,Munoz Sanchez; Alicia,10,0,20,10
1745819982060,LISP 5C,A00,896655,Munoz Sanchez; Alicia,4,0,20,16
1745819983088,MAE 197,001,957918,Kleissl; Jan,9998,0,9999,1
1745819984117,MATH 2,A01,957937,Staff,34,0,35,1
1745819985141,MATH 197,001,957876,Kedlaya; Kiran S.,9993,0,9999,6
1745819986168,MCWP 40,A00,892729,Duru; Nur,13,0,20,7
1745819986168,MCWP 40,B00,893304,Montejo; Carolina,20,0,20,0
1745819987196,MCWP 40R,A00,893757,Redela; Pamela Morgan,0,7,20,20
1745819988223,MCWP 50,A00,893758,Morshed; Michael James,2,0,20,18
1745819988223,MCWP 50,B00,893761,Bartulis; Jason Michael,18,0,20,2
1745819989253,MCWP 50R,A00,893766,Compas; Sean Matthew,0,1,20,20
1745819989253,MCWP 50R,B00,893769,Carter; Jennifer A,0,0,20,20
1745819989253,MCWP 50R,C00,893771,Krone; Jarret,0,3,20,20
1745819989253,MCWP 50R,D00,893772,Miller; Elizabeth Deen,3,0,20,17
1745819989253,MCWP 50R,E00,893775,Carter; Andrea L,0,0,20,20
1745819990277,MMW 11R,A01,892721,Herbst; Matthew,11,0,27,16
1745819990277,MMW 11R,A02,892722,Herbst; Matthew,0,0,0,3
1745819991302,MMW 12R,A01,892724,Herbst; Matthew,0,10,16,16
1745819991302,MMW 12R,A02,892725,Herbst; Matthew,0,9,16,16
1745819992328,MMW 13R,A01,892727,Staff,0,3,16,16
1745819992328,MMW 13R,A02,892728,Staff,0,4,16,16
1745819992328,MMW 13R,A03,958032,Staff,0,3,16,16
1745819992328,MMW 13R,A04,958033,Staff,0,2,16,16
1745819992328,MMW 13R,A05,958034,Staff,0,3,16,16
1745819993355,SIO 295LS,A00,894015,Staff,7,0,25,18
1745819994383,SIO 295S,A00,894020,Staff,7,0,25,18
1745819995410,SIOC 290S,B01,958918,Staff,0,0,0,0
1745819996438,SIOC 291S,B01,958922,Staff,0,0,0,0
1745819997463,SOCI 117,A01,895339,Staff,4,0,5,1
1745819998486,WES 237B,A00,894149,Staff,11,0,20,9
1745820000543,AESE 279B,A00,891859,Staff,13,0,35,22
1745820001566,AIP 197,001,891854,Staff,70,0,70,0
1745820002594,ANTH 289S,A00,891856,Gagneux; Pascal,12,0,12,0
1745820003619,BENG 196,001,957946,Engler; Adam J.,9996,0,9999,3
1745820004647,CAT 124RS,A01,956906,Staff,8,0,25,17
1745820005674,CAT 125RS,A01,922013,Staff,8,0,25,17
1745820006700,CLRE 250,A00,891860,Morris; Sheldon,9995,0,9999,4
1745820008752,CLRE 251R,A00,907817,Mehta; Ravindra L.,9994,0,9999,5
1745820009780,CLRE 252,A00,891864,Cuomo; Raphael Eduardo,9993,0,9999,6
1745820010808,CLRE 253,A00,891867,Vaida; Florin,9994,0,9999,5
1745820010808,CLRE 253,B00,907819,Staff,9999,0,9999,0
1745820011836,CLRE 259,A00,891868,Patel; Hemal,9998,0,9999,1
1745820012880,CLRE 260,A00,891872,Cuomo; Raphael Eduardo,9999,0,9999,0
1745820013916,CLRE 297,001,891888,Cuomo; Raphael Eduardo,9999,0,9999,0
1745820014943,CSE 191,A00,958773,Minnes Kemp; Mor Mia,9999,0,9999,0
1745820015990,CSS 201S,A01,892054,Mignozzetti; Umberto,30,0,30,0
1745820017045,CSS 202S,A01,892056,Mignozzetti; Umberto,30,0,30,0
1745820018074,DSC 197,001,956898,Eldridge; Justin Matthew,9998,0,9999,1
1745820019102,DSC 297,001,958000,Mazumdar; Arya,9998,0,9999,1
1745820020129,EAP 100,A00,905686,Staff,9776,0,9999,223
1745820021181,ECE 45,A01,892618,Staff,0,12,50,50
1745820022208,ECE 109,A01,892620,Staff,0,43,0,0
1745820023247,ECE 111,A01,892719,Staff,0,9,50,50
1745820024296,ECE 197,001,957920,Mercier; Patrick Philip,9992,0,9999,7
1745820025336,ECON 178,A01,907814,Zhu; Ying,28,0,35,7
1745820026371,EDS 115,A00,895312,Staff,41,0,45,4
1745820027399,EDS 117,A01,895337,Staff,30,0,30,0
1745820028435,EDS 125,A00,895341,Jones; Gabrielle Anastasia,43,0,45,2
1745820029464,EDS 128A,A01,895459,Fargason; Sharon Gayle,44,0,45,1
1745820030505,EDS 128B,A01,895543,Pappas; Elizabeth,44,0,45,1
1745820031533,EDS 139,A00,897203,Pappas; Elizabeth,44,0,45,1
1745820031533,EDS 139,B00,897209,Fargason; Sharon Gayle,44,0,45,1
1745820032557,EDS 201,A00,895545,Staff,43,0,45,2
1745820033585,EDS 203,A01,895581,Halter; Christopher P.,43,0,45,2
1745820034615,EDS 204R,A01,895625,Heinzman; Erica M.,43,0,45,2
1745820034615,EDS 204R,B01,895693,Halter; Christopher P.,18,0,45,27
1745820035641,EDS 206R,A00,895694,Fargason; Sharon Gayle,9,0,30,21
1745820035641,EDS 206R,B00,895695,Choi; Bailey Miyeon,20,0,30,10
1745820036667,EDS 250,A00,895697,Hemans; Patricia Ann Benitez,43,0,45,2
1745820037710,EDS 281,A00,895701,Meyerott; Theresa Ann,15,0,15,0
1745820038742,EDS 284,A00,895736,Meyerott; Theresa Ann,15,0,15,0
1745820039775,EDS 286,A00,897210,Fine; Sarah,15,0,15,0
1745820040860,EDS 289C,A01,895770,Daly; Alan J.,15,0,15,0
1745820041886,EDS 290,A00,897211,Hofstetter; Carolyn,15,0,15,0
1745820042938,LIGM 5A,A00,896162,Fischer-Grunski; Eva K,15,0,20,5
1745820043971,LIGM 5B,A00,896260,Fischer-Grunski; Eva K,17,0,20,3
1745820044998,LIGM 5C,A00,896308,Fischer-Grunski; Eva K,18,0,20,2
1745820046032,LIIT 5AS,A00,896313,Carnelos; Chiara,17,0,20,3
1745820047063,LIIT 5BS,A00,896416,Carnelos; Chiara,20,0,20,0
1745820048089,LIIT 5CS,A00,896564,Carnelos; Chiara,20,0,20,0
1745820049132,LISP 5A,A00,896588,Munoz Sanchez; Alicia,4,0,20,16
1745820050214,LISP 5B,A00,896653,Munoz Sanchez; Alicia,10,0,20,10
1745820051238,LISP 5C,A00,896655,Munoz Sanchez; Alicia,4,0,20,16
1745820052263,MAE 197,001,957918,Kleissl; Jan,9998,0,9999,1
1745820053289,MATH 2,A01,957937,Staff,34,0,35,1
1745820054316,MATH 197,001,957876,Kedlaya; Kiran S.,9993,0,9999,6
1745820055343,MCWP 40,A00,892729,Duru; Nur,13,0,20,7
1745820055343,MCWP 40,B00,893304,Montejo; Carolina,20,0,20,0
1745820056374,MCWP 40R,A00,893757,Redela; Pamela Morgan,0,7,20,20
1745820057403,MCWP 50,A00,893758,Morshed; Michael James,2,0,20,18
1745820057403,MCWP 50,B00,893761,Bartulis; Jason Michael,18,0,20,2
1745820058431,MCWP 50R,A00,893766,Compas; Sean Matthew,0,1,20,20
1745820058431,MCWP 50R,B00,893769,Carter; Jennifer A,0,0,20,20
1745820058431,MCWP 50R,C00,893771,Krone; Jarret,0,3,20,20
1745820058431,MCWP 50R,D00,893772,Miller; Elizabeth Deen,3,0,20,17
1745820058431,MCWP 50R,E00,893775,Carter; Andrea L,0,0,20,20
1745820059457,MMW 11R,A01,892721,Herbst; Matthew,11,0,27,16
1745820059457,MMW 11R,A02,892722,Herbst; Matthew,0,0,0,3
1745820060487,MMW 12R,A01,892724,Herbst; Matthew,0,10,16,16
1745820060487,MMW 12R,A02,892725,Herbst; Matthew,0,9,16,16
1745820061513,MMW 13R,A01,892727,Staff,0,3,16,16
1745820061513,MMW 13R,A02,892728,Staff,0,4,16,16
1745820061513,MMW 13R,A03,958032,Staff,0,3,16,16
1745820061513,MMW 13R,A04,958033,Staff,0,2,16,16
1745820061513,MMW 13R,A05,958034,Staff,0,3,16,16
1745820062549,SIO 295LS,A00,894015,Staff,7,0,25,18
1745820063575,SIO 295S,A00,894020,Staff,7,0,25,18
1745820064609,SIOC 290S,B01,958918,Staff,0,0,0,0
1745820065635,SIOC 291S,B01,958922,Staff,0,0,0,0
1745820066662,SOCI 117,A01,895339,Staff,4,0,5,1
1745820067687,WES 237B,A00,894149,Staff,11,0,20,9
1745820069805,AESE 279B,A00,891859,Staff,13,0,35,22
1745820070831,AIP 197,001,891854,Staff,70,0,70,0
1745820071857,ANTH 289S,A00,891856,Gagneux; Pascal,12,0,12,0
1745820072883,BENG 196,001,957946,Engler; Adam J.,9996,0,9999,3
1745820073908,CAT 124RS,A01,956906,Staff,8,0,25,17
1745820074935,CAT 125RS,A01,922013,Staff,8,0,25,17
1745820075961,CLRE 250,A00,891860,Morris; Sheldon,9995,0,9999,4
1745820078013,CLRE 251R,A00,907817,Mehta; Ravindra L.,9994,0,9999,5
1745820079040,CLRE 252,A00,891864,Cuomo; Raphael Eduardo,9993,0,9999,6
1745820080067,CLRE 253,A00,891867,Vaida; Florin,9994,0,9999,5
1745820080067,CLRE 253,B00,907819,Staff,9999,0,9999,0
1745820081094,CLRE 259,A00,891868,Patel; Hemal,9998,0,9999,1
1745820082119,CLRE 260,A00,891872,Cuomo; Raphael Eduardo,9999,0,9999,0
1745820083145,CLRE 297,001,891888,Cuomo; Raphael Eduardo,9999,0,9999,0
1745820084171,CSE 191,A00,958773,Minnes Kemp; Mor Mia,9999,0,9999,0
1745820085201,CSS 201S,A01,892054,Mignozzetti; Umberto,30,0,30,0
1745820086228,CSS 202S,A01,892056,Mignozzetti; Umberto,30,0,30,0
1745820087259,DSC 197,001,956898,Eldridge; Justin Matthew,9998,0,9999,1
1745820088284,DSC 297,001,958000,Mazumdar; Arya,9998,0,9999,1
1745820089313,EAP 100,A00,905686,Staff,9776,0,9999,223
1745820090344,ECE 45,A01,892618,Staff,0,12,50,50
1745820091371,ECE 109,A01,892620,Staff,0,43,0,0
1745820092399,ECE 111,A01,892719,Staff,0,9,50,50
1745820093425,ECE 197,001,957920,Mercier; Patrick Philip,9992,0,9999,7
1745820094450,ECON 178,A01,907814,Zhu; Ying,28,0,35,7
1745820095478,EDS 115,A00,895312,Staff,41,0,45,4
1745820096505,EDS 117,A01,895337,Staff,30,0,30,0
1745820097532,EDS 125,A00,895341,Jones; Gabrielle Anastasia,43,0,45,2
1745820098559,EDS 128A,A01,895459,Fargason; Sharon Gayle,44,0,45,1
1745820099587,EDS 128B,A01,895543,Pappas; Elizabeth,44,0,45,1
1745820100617,EDS 139,A00,897203,Pappas; Elizabeth,44,0,45,1
1745820100617,EDS 139,B00,897209,Fargason; Sharon Gayle,44,0,45,1
1745820101641,EDS 201,A00,895545,Staff,43,0,45,2
1745820102666,EDS 203,A01,895581,Halter; Christopher P.,43,0,45,2
1745820103692,EDS 204R,A01,895625,Heinzman; Erica M.,43,0,45,2
1745820103692,EDS 204R,B01,895693,Halter; Christopher P.,18,0,45,27
1745820104720,EDS 206R,A00,895694,Fargason; Sharon Gayle,9,0,30,21
1745820104720,EDS 206R,B00,895695,Choi; Bailey Miyeon,20,0,30,10
1745820105747,EDS 250,A00,895697,Hemans; Patricia Ann Benitez,43,0,45,2
1745820106773,EDS 281,A00,895701,Meyerott; Theresa Ann,15,0,15,0
1745820107799,EDS 284,A00,895736,Meyerott; Theresa Ann,15,0,15,0
1745820108829,EDS 286,A00,897210,Fine; Sarah,15,0,15,0
1745820109854,EDS 289C,A01,895770,Daly; Alan J.,15,0,15,0
1745820110882,EDS 290,A00,897211,Hofstetter; Carolyn,15,0,15,0
1745820111909,LIGM 5A,A00,896162,Fischer-Grunski; Eva K,15,0,20,5
1745820112936,LIGM 5B,A00,896260,Fischer-Grunski; Eva K,17,0,20,3
1745820113962,LIGM 5C,A00,896308,Fischer-Grunski; Eva K,18,0,20,2
1745820114988,LIIT 5AS,A00,896313,Carnelos; Chiara,17,0,20,3
1745820116017,LIIT 5BS,A00,896416,Carnelos; Chiara,20,0,20,0
1745820117042,LIIT 5CS,A00,896564,Carnelos; Chiara,20,0,20,0
1745820118072,LISP 5A,A00,896588,Munoz Sanchez; Alicia,4,0,20,16
1745820119099,LISP 5B,A00,896653,Munoz Sanchez; Alicia,10,0,20,10
1745820120124,LISP 5C,A00,896655,Munoz Sanchez; Alicia,4,0,20,16
1745820121149,MAE 197,001,957918,Kleissl; Jan,9998,0,9999,1
1745820122174,MATH 2,A01,957937,Staff,34,0,35,1
1745820123201,MATH 197,001,957876,Kedlaya; Kiran S.,9993,0,9999,6
1745820124231,MCWP 40,A00,892729,Duru; Nur,13,0,20,7
1745820124231,MCWP 40,B00,893304,Montejo; Carolina,20,0,20,0
1745820125258,MCWP 40R,A00,893757,Redela; Pamela Morgan,0,7,20,20
1745820126285,MCWP 50,A00,893758,Morshed; Michael James,2,0,20,18
1745820126285,MCWP 50,B00,893761,Bartulis; Jason Michael,18,0,20,2
1745820127313,MCWP 50R,A00,893766,Compas; Sean Matthew,0,1,20,20
1745820127313,MCWP 50R,B00,893769,Carter; Jennifer A,0,0,20,20
1745820127313,MCWP 50R,C00,893771,Krone; Jarret,0,3,20,20
1745820127313,MCWP 50R,D00,893772,Miller; Elizabeth Deen,3,0,20,17
1745820127313,MCWP 50R,E00,893775,Carter; Andrea L,0,0,20,20
1745820128339,MMW 11R,A01,892721,Herbst; Matthew,11,0,27,16
1745820128339,MMW 11R,A02,892722,Herbst; Matthew,0,0,0,3
1745820129368,MMW 12R,A01,892724,Herbst; Matthew,0,10,16,16
1745820129368,MMW 12R,A02,892725,Herbst; Matthew,0,9,16,16
1745820130395,MMW 13R,A01,892727,Staff,0,3,16,16
1745820130395,MMW 13R,A02,892728,Staff,0,4,16,16
1745820130395,MMW 13R,A03,958032,Staff,0,3,16,16
1745820130395,MMW 13R,A04,958033,Staff,0,2,16,16
1745820130395,MMW 13R,A05,958034,Staff,0,3,16,16
1745820131425,SIO 295LS,A00,894015,Staff,7,0,25,18
1745820132454,SIO 295S,A00,894020,Staff,7,0,25,18
1745820133481,SIOC 290S,B01,958918,Staff,0,0,0,0
1745820134507,SIOC 291S,B01,958922,Staff,0,0,0,0
1745820135533,SOCI 117,A01,895339,Staff,4,0,5,1
1745820136557,WES 237B,A00,894149,Staff,11,0,20,9
1745820138624,AESE 279B,A00,891859,Staff,13,0,35,22
1745820139689,AIP 197,001,891854,Staff,70,0,70,0
1745820140715,ANTH 289S,A00,891856,Gagneux; Pascal,12,0,12,0
1745820141742,BENG 196,001,957946,Engler; Adam J.,9996,0,9999,3
1745820142770,CAT 124RS,A01,956906,Staff,8,0,25,17
1745820143799,CAT 125RS,A01,922013,Staff,8,0,25,17
1745820144828,CLRE 250,A00,891860,Morris; Sheldon,9995,0,9999,4
1745820146881,CLRE 251R,A00,907817,Mehta; Ravindra L.,9994,0,9999,5
1745820147908,CLRE 252,A00,891864,Cuomo; Raphael Eduardo,9993,0,9999,6
1745820148937,CLRE 253,A00,891867,Vaida; Florin,9994,0,9999,5
1745820148937,CLRE 253,B00,907819,Staff,9999,0,9999,0
1745820149968,CLRE 259,A00,891868,Patel; Hemal,9998,0,9999,1
1745820150997,CLRE 260,A00,891872,Cuomo; Raphael Eduardo,9999,0,9999,0
1745820152026,CLRE 297,001,891888,Cuomo; Raphael Eduardo,9999,0,9999,0
1745820153054,CSE 191,A00,958773,Minnes Kemp; Mor Mia,9999,0,9999,0
1745820154088,CSS 201S,A01,892054,Mignozzetti; Umberto,30,0,30,0
1745820155115,CSS 202S,A01,892056,Mignozzetti; Umberto,30,0,30,0
1745820156140,DSC 197,001,956898,Eldridge; Justin Matthew,9998,0,9999,1
1745820157170,DSC 297,001,958000,Mazumdar; Arya,9998,0,9999,1
1745820158203,EAP 100,A00,905686,Staff,9776,0,9999,223
1745820159230,ECE 45,A01,892618,Staff,0,12,50,50
1745820160257,ECE 109,A01,892620,Staff,0,43,0,0
1745820161282,ECE 111,A01,892719,Staff,0,9,50,50
1745820162308,ECE 197,001,957920,Mercier; Patrick Philip,9992,0,9999,7
1745820163339,ECON 178,A01,907814,Zhu; Ying,28,0,35,7
1745820164373,EDS 115,A00,895312,Staff,41,0,45,4
1745820165398,EDS 117,A01,895337,Staff,30,0,30,0
1745820166424,EDS 125,A00,895341,Jones; Gabrielle Anastasia,43,0,45,2
1745820167453,EDS 128A,A01,895459,Fargason; Sharon Gayle,44,0,45,1
1745820168483,EDS 128B,A01,895543,Pappas; Elizabeth,44,0,45,1
1745820169513,EDS 139,A00,897203,Pappas; Elizabeth,44,0,45,1
1745820169513,EDS 139,B00,897209,Fargason; Sharon Gayle,44,0,45,1
1745820170539,EDS 201,A00,895545,Staff,43,0,45,2
1745820171569,EDS 203,A01,895581,Halter; Christopher P.,43,0,45,2
1745820172594,EDS 204R,A01,895625,Heinzman; Erica M.,43,0,45,2
1745820172594,EDS 204R,B01,895693,Halter; Christopher P.,18,0,45,27
1745820173623,EDS 206R,A00,895694,Fargason; Sharon Gayle,9,0,30,21
1745820173623,EDS 206R,B00,895695,Choi; Bailey Miyeon,20,0,30,10
1745820174649,EDS 250,A00,895697,Hemans; Patricia Ann Benitez,43,0,45,2
1745820175673,EDS 281,A00,895701,Meyerott; Theresa Ann,15,0,15,0
1745820176698,EDS 284,A00,895736,Meyerott; Theresa Ann,15,0,15,0
1745820177727,EDS 286,A00,897210,Fine; Sarah,15,0,15,0
1745820178757,EDS 289C,A01,895770,Daly; Alan J.,15,0,15,0
1745820179794,EDS 290,A00,897211,Hofstetter; Carolyn,15,0,15,0
1745820180820,LIGM 5A,A00,896162,Fischer-Grunski; Eva K,15,0,20,5
1745820181847,LIGM 5B,A00,896260,Fischer-Grunski; Eva K,17,0,20,3
1745820182874,LIGM 5C,A00,896308,Fischer-Grunski; Eva K,18,0,20,2
1745820183904,LIIT 5AS,A00,896313,Carnelos; Chiara,17,0,20,3
1745820184930,LIIT 5BS,A00,896416,Carnelos; Chiara,20,0,20,0
1745820185957,LIIT 5CS,A00,896564,Carnelos; Chiara,20,0,20,0
1745820186984,LISP 5A,A00,896588,Munoz Sanchez; Alicia,4,0,20,16
1745820188010,LISP 5B,A00,896653,Munoz Sanchez; Alicia,10,0,20,10
1745820189037,LISP 5C,A00,896655,Munoz Sanchez; Alicia,4,0,20,16
1745820190072,MAE 197,001,957918,Kleissl; Jan,9998,0,9999,1
1745820191101,MATH 2,A01,957937,Staff,34,0,35,1
1745820192126,MATH 197,001,957876,Kedlaya; Kiran S.,9993,0,9999,6
1745820193153,MCWP 40,A00,892729,Duru; Nur,13,0,20,7
1745820193153,MCWP 40,B00,893304,Montejo; Carolina,20,0,20,0
1745820194179,MCWP 40R,A00,893757,Redela; Pamela Morgan,0,7,20,20
1745820195222,MCWP 50,A00,893758,Morshed; Michael James,2,0,20,18
1745820195222,MCWP 50,B00,893761,Bartulis; Jason Michael,18,0,20,2
1745820196249,MCWP 50R,A00,893766,Compas; Sean Matthew,0,1,20,20
1745820196249,MCWP 50R,B00,893769,Carter; Jennifer A,0,0,20,20
1745820196249,MCWP 50R,C00,893771,Krone; Jarret,0,3,20,20
1745820196249,MCWP 50R,D00,893772,Miller; Elizabeth Deen,3,0,20,17
1745820196249,MCWP 50R,E00,893775,Carter; Andrea L,0,0,20,20
1745820197276,MMW 11R,A01,892721,Herbst; Matthew,11,0,27,16
1745820197276,MMW 11R,A02,892722,Herbst; Matthew,0,0,0,3
1745820198301,MMW 12R,A01,892724,Herbst; Matthew,0,10,16,16
1745820198301,MMW 12R,A02,892725,Herbst; Matthew,0,9,16,16
1745820199330,MMW 13R,A01,892727,Staff,0,3,16,16
1745820199330,MMW 13R,A02,892728,Staff,0,4,16,16
1745820199330,MMW 13R,A03,958032,Staff,0,3,16,16
1745820199330,MMW 13R,A04,958033,Staff,0,2,16,16
1745820199330,MMW 13R,A05,958034,Staff,0,3,16,16
1745820200356,SIO 295LS,A00,894015,Staff,7,0,25,18
1745820201399,SIO 295S,A00,894020,Staff,7,0,25,18
1745820202434,SIOC 290S,B01,958918,Staff,0,0,0,0
1745820203463,SIOC 291S,B01,958922,Staff,0,0,0,0
1745820204489,SOCI 117,A01,895339,Staff,4,0,5,1
1745820205513,WES 237B,A00,894149,Staff,11,0,20,9
1745820207570,AESE 279B,A00,891859,Staff,13,0,35,22
1745820208594,AIP 197,001,891854,Staff,70,0,70,0
1745820209620,ANTH 289S,A00,891856,Gagneux; Pascal,12,0,12,0
1745820210650,BENG 196,001,957946,Engler; Adam J.,9996,0,9999,3
1745820211676,CAT 124RS,A01,956906,Staff,8,0,25,17
1745820212701,CAT 125RS,A01,922013,Staff,8,0,25,17
1745820213727,CLRE 250,A00,891860,Morris; Sheldon,9995,0,9999,4
1745820215778,CLRE 251R,A00,907817,Mehta; Ravindra L.,9994,0,9999,5
1745820216809,CLRE 252,A00,891864,Cuomo; Raphael Eduardo,9993,0,9999,6
1745820217839,CLRE 253,A00,891867,Vaida; Florin,9994,0,9999,5
1745820217839,CLRE 253,B00,907819,Staff,9999,0,9999,0
1745820218870,CLRE 259,A00,891868,Patel; Hemal,9998,0,9999,1
1745820219899,CLRE 260,A00,891872,Cuomo; Raphael Eduardo,9999,0,9999,0
1745820220922,CLRE 297,001,891888,Cuomo; Raphael Eduardo,9999,0,9999,0
1745820221949,CSE 191,A00,958773,Minnes Kemp; Mor Mia,9999,0,9999,0
1745820222975,CSS 201S,A01,892054,Mignozzetti; Umberto,30,0,30,0
1745820224006,CSS 202S,A01,892056,Mignozzetti; Umberto,30,0,30,0
1745820225033,DSC 197,001,956898,Eldridge; Justin Matthew,9998,0,9999,1
1745820226057,DSC 297,001,958000,Mazumdar; Arya,9998,0,9999,1
1745820227085,EAP 100,A00,905686,Staff,9776,0,9999,223
1745820228116,ECE 45,A01,892618,Staff,0,12,50,50
1745820229144,ECE 109,A01,892620,Staff,0,43,0,0
1745820230174,ECE 111,A01,892719,Staff,0,9,50,50
1745820231199,ECE 197,001,957920,Mercier; Patrick Philip,9992,0,9999,7
1745820232230,ECON 178,A01,907814,Zhu; Ying,28,0,35,7
1745820233255,EDS 115,A00,895312,Staff,41,0,45,4
1745820234281,EDS 117,A01,895337,Staff,30,0,30,0
1745820235314,EDS 125,A00,895341,Jones; Gabrielle Anastasia,43,0,45,2
1745820236340,EDS 128A,A01,895459,Fargason; Sharon Gayle,44,0,45,1
1745820237372,EDS 128B,A01,895543,Pappas; Elizabeth,44,0,45,1
1745820238400,EDS 139,A00,897203,Pappas; Elizabeth,44,0,45,1
1745820238400,EDS 139,B00,897209,Fargason; Sharon Gayle,44,0,45,1
1745820239425,EDS 201,A00,895545,Staff,43,0,45,2
1745820240453,EDS 203,A01,895581,Halter; Christopher P.,43,0,45,2
1745820241483,EDS 204R,A01,895625,Heinzman; Erica M.,43,0,45,2
1745820241483,EDS 204R,B01,895693,Halter; Christopher P.,18,0,45,27
1745820242511,EDS 206R,A00,895694,Fargason; Sharon Gayle,9,0,30,21
1745820242511,EDS 206R,B00,895695,Choi; Bailey Miyeon,20,0,30,10
1745820243586,EDS 250,A00,895697,Hemans; Patricia Ann Benitez,43,0,45,2
1745820244611,EDS 281,A00,895701,Meyerott; Theresa Ann,15,0,15,0
1745820245637,EDS 284,A00,895736,Meyerott; Theresa Ann,15,0,15,0
1745820246663,EDS 286,A00,897210,Fine; Sarah,15,0,15,0
1745820247693,EDS 289C,A01,895770,Daly; Alan J.,15,0,15,0
1745820248722,EDS 290,A00,897211,Hofstetter; Carolyn,15,0,15,0
1745820249757,LIGM 5A,A00,896162,Fischer-Grunski; Eva K,15,0,20,5
1745820250790,LIGM 5B,A00,896260,Fischer-Grunski; Eva K,17,0,20,3
1745820251813,LIGM 5C,A00,896308,Fischer-Grunski; Eva K,18,0,20,2
1745820252839,LIIT 5AS,A00,896313,Carnelos; Chiara,17,0,20,3
1745820253864,LIIT 5BS,A00,896416,Carnelos; Chiara,20,0,20,0
1745820254887,LIIT 5CS,A00,896564,Carnelos; Chiara,20,0,20,0
1745820255917,LISP 5A,A00,896588,Munoz Sanchez; Alicia,4,0,20,16
1745820256942,LISP 5B,A00,896653,Munoz Sanchez; Alicia,10,0,20,10
1745820257966,LISP 5C,A00,896655,Munoz Sanchez; Alicia,4,0,20,16
1745820258991,MAE 197,001,957918,Kleissl; Jan,9998,0,9999,1
1745820260029,MATH 2,A01,957937,Staff,34,0,35,1
1745820261054,MATH 197,001,957876,Kedlaya; Kiran S.,9993,0,9999,6
1745820262080,MCWP 40,A00,892729,Duru; Nur,13,0,20,7
1745820262080,MCWP 40,B00,893304,Montejo; Carolina,20,0,20,0
1745820263105,MCWP 40R,A00,893757,Redela; Pamela Morgan,0,7,20,20
1745820264129,MCWP 50,A00,893758,Morshed; Michael James,2,0,20,18
1745820264129,MCWP 50,B00,893761,Bartulis; Jason Michael,18,0,20,2
1745820265163,MCWP 50R,A00,893766,Compas; Sean Matthew,0,1,20,20
1745820265163,MCWP 50R,B00,893769,Carter; Jennifer A,0,0,20,20
1745820265163,MCWP 50R,C00,893771,Krone; Jarret,0,3,20,20
1745820265163,MCWP 50R,D00,893772,Miller; Elizabeth Deen,3,0,20,17
1745820265163,MCWP 50R,E00,893775,Carter; Andrea L,0,0,20,20
1745820266188,MMW 11R,A01,892721,Herbst; Matthew,11,0,27,16
1745820266188,MMW 11R,A02,892722,Herbst; Matthew,0,0,0,3
1745820267216,MMW 12R,A01,892724,Herbst; Matthew,0,10,16,16
1745820267216,MMW 12R,A02,892725,Herbst; Matthew,0,9,16,16
1745820268245,MMW 13R,A01,892727,Staff,0,3,16,16
1745820268245,MMW 13R,A02,892728,Staff,0,4,16,16
1745820268245,MMW 13R,A03,958032,Staff,0,3,16,16
1745820268245,MMW 13R,A04,958033,Staff,0,2,16,16
1745820268245,MMW 13R,A05,958034,Staff,0,3,16,16
1745820269273,SIO 295LS,A00,894015,Staff,7,0,25,18
1745820270302,SIO 295S,A00,894020,Staff,7,0,25,18
1745820271333,SIOC 290S,B01,958918,Staff,0,0,0,0
1745820272363,SIOC 291S,B01,958922,Staff,0,0,0,0
1745820273391,SOCI 117,A01,895339,Staff,4,0,5,1
1745820274419,WES 237B,A00,894149,Staff,11,0,20,9
1745820276495,AESE 279B,A00,891859,Staff,13,0,35,22
1745820277521,AIP 197,001,891854,Staff,70,0,70,0
1745820278546,ANTH 289S,A00,891856,Gagneux; Pascal,12,0,12,0
1745820279570,BENG 196,001,957946,Engler; Adam J.,9996,0,9999,3
1745820280595,CAT 124RS,A01,956906,Staff,8,0,25,17
1745820281623,CAT 125RS,A01,922013,Staff,8,0,25,17
1745820282650,CLRE 250,A00,891860,Morris; Sheldon,9995,0,9999,4
1745820284702,CLRE 251R,A00,907817,Mehta; Ravindra L.,9994,0,9999,5
1745820285728,CLRE 252,A00,891864,Cuomo; Raphael Eduardo,9993,0,9999,6
1745820286756,CLRE 253,A00,891867,Vaida; Florin,9994,0,9999,5
1745820286756,CLRE 253,B00,907819,Staff,9999,0,9999,0
1745820287784,CLRE 259,A00,891868,Patel; Hemal,9998,0,9999,1
1745820288811,CLRE 260,A00,891872,Cuomo; Raphael Eduardo,9999,0,9999,0
1745820289837,CLRE 297,001,891888,Cuomo; Raphael Eduardo,9999,0,9999,0
1745820290868,CSE 191,A00,958773,Minnes Kemp; Mor Mia,9999,0,9999,0
1745820291898,CSS 201S,A01,892054,Mignozzetti; Umberto,30,0,30,0
1745820292924,CSS 202S,A01,892056,Mignozzetti; Umberto,30,0,30,0
1745820293949,DSC 197,001,956898,Eldridge; Justin Matthew,9998,0,9999,1
1745820294975,DSC 297,001,958000,Mazumdar; Arya,9998,0,9999,1
1745820296000,EAP 100,A00,905686,Staff,9776,0,9999,223
1745820297028,ECE 45,A01,892618,Staff,0,12,50,50
1745820298055,ECE 109,A01,892620,Staff,0,43,0,0
1745820299081,ECE 111,A01,892719,Staff,0,9,50,50
1745820300109,ECE 197,001,957920,Mercier; Patrick Philip,9992,0,9999,7
1745820301134,ECON 178,A01,907814,Zhu; Ying,28,0,35,7
1745820302165,EDS 115,A00,895312,Staff,41,0,45,4
1745820303192,EDS 117,A01,895337,Staff,30,0,30,0
1745820304222,EDS 125,A00,895341,Jones; Gabrielle Anastasia,43,0,45,2
1745820305254,EDS 128A,A01,895459,Fargason; Sharon Gayle,44,0,45,1
1745820306279,EDS 128B,A01,895543,Pappas; Elizabeth,44,0,45,1
1745820307311,EDS 139,A00,897203,Pappas; Elizabeth,44,0,45,1
1745820307311,EDS 139,B00,897209,Fargason; Sharon Gayle,44,0,45,1
1745820308340,EDS 201,A00,895545,Staff,43,0,45,2
1745820309369,EDS 203,A01,895581,Halter; Christopher P.,43,0,45,2
1745820310399,EDS 204R,A01,895625,Heinzman; Erica M.,43,0,45,2
1745820310399,EDS 204R,B01,895693,Halter; Christopher P.,18,0,45,27
1745820311429,EDS 206R,A00,895694,Fargason; Sharon Gayle,9,0,30,21
1745820311429,EDS 206R,B00,895695,Choi; Bailey Miyeon,20,0,30,10
1745820312454,EDS 250,A00,895697,Hemans; Patricia Ann Benitez,43,0,45,2
1745820313480,EDS 281,A00,895701,Meyerott; Theresa Ann,15,0,15,0
1745820314509,EDS 284,A00,895736,Meyerott; Theresa Ann,15,0,15,0
1745820315535,EDS 286,A00,897210,Fine; Sarah,15,0,15,0
1745820316562,EDS 289C,A01,895770,Daly; Alan J.,15,0,15,0
1745820317588,EDS 290,A00,897211,Hofstetter; Carolyn,15,0,15,0
1745820318614,LIGM 5A,A00,896162,Fischer-Grunski; Eva K,15,0,20,5
1745820319637,LIGM 5B,A00,896260,Fischer-Grunski; Eva K,17,0,20,3
1745820320671,LIGM 5C,A00,896308,Fischer-Grunski; Eva K,18,0,20,2
1745820321697,LIIT 5AS,A00,896313,Carnelos; Chiara,17,0,20,3
1745820322724,LIIT 5BS,A00,896416,Carnelos; Chiara,20,0,20,0
1745820323752,LIIT 5CS,A00,896564,Carnelos; Chiara,20,0,20,0
1745820324778,LISP 5A,A00,896588,Munoz Sanchez; Alicia,4,0,20,16
1745820325809,LISP 5B,A00,896653,Munoz Sanchez; Alicia,10,0,20,10
1745820326833,LISP 5C,A00,896655,Munoz Sanchez; Alicia,4,0,20,16
1745820327862,MAE 197,001,957918,Kleissl; Jan,9998,0,9999,1
1745820328890,MATH 2,A01,957937,Staff,34,0,35,1
1745820329923,MATH 197,001,957876,Kedlaya; Kiran S.,9993,0,9999,6
1745820330950,MCWP 40,A00,892729,Duru; Nur,13,0,20,7
1745820330950,MCWP 40,B00,893304,Montejo; Carolina,20,0,20,0
1745820331978,MCWP 40R,A00,893757,Redela; Pamela Morgan,0,7,20,20
1745820333004,MCWP 50,A00,893758,Morshed; Michael James,2,0,20,18
1745820333004,MCWP 50,B00,893761,Bartulis; Jason Michael,18,0,20,2
1745820334030,MCWP 50R,A00,893766,Compas; Sean Matthew,0,1,20,20
1745820334030,MCWP 50R,B00,893769,Carter; Jennifer A,0,0,20,20
1745820334030,MCWP 50R,C00,893771,Krone; Jarret,0,3,20,20
1745820334030,MCWP 50R,D00,893772,Miller; Elizabeth Deen,3,0,20,17
1745820334030,MCWP 50R,E00,893775,Carter; Andrea L,0,0,20,20
1745820335059,MMW 11R,A01,892721,Herbst; Matthew,11,0,27,16
1745820335059,MMW 11R,A02,892722,Herbst; Matthew,0,0,0,3
1745820336085,MMW 12R,A01,892724,Herbst; Matthew,0,10,16,16
1745820336085,MMW 12R,A02,892725,Herbst; Matthew,0,9,16,16
1745820337110,MMW 13R,A01,892727,Staff,0,3,16,16
1745820337110,MMW 13R,A02,892728,Staff,0,4,16,16
1745820337110,MMW 13R,A03,958032,Staff,0,3,16,16
1745820337110,MMW 13R,A04,958033,Staff,0,2,16,16
1745820337110,MMW 13R,A05,958034,Staff,0,3,16,16
1745820338135,SIO 295LS,A00,894015,Staff,7,0,25,18
1745820339161,SIO 295S,A00,894020,Staff,7,0,25,18
1745820340193,SIOC 290S,B01,958918,Staff,0,0,0,0
1745820341221,SIOC 291S,B01,958922,Staff,0,0,0,0
1745820342252,SOCI 117,A01,895339,Staff,4,0,5,1
1745820343281,WES 237B,A00,894149,Staff,11,0,20,9
1745820345385,AESE 279B,A00,891859,Staff,13,0,35,22
1745820346411,AIP 197,001,891854,Staff,70,0,70,0
1745820347481,ANTH 289S,A00,891856,Gagneux; Pascal,12,0,12,0
1745820348509,BENG 196,001,957946,Engler; Adam J.,9996,0,9999,3
1745820349535,CAT 124RS,A01,956906,Staff,8,0,25,17
1745820350561,CAT 125RS,A01,922013,Staff,8,0,25,17
1745820351587,CLRE 250,A00,891860,Morris; Sheldon,9995,0,9999,4
1745820353643,CLRE 251R,A00,907817,Mehta; Ravindra L.,9994,0,9999,5
1745820354669,CLRE 252,A00,891864,Cuomo; Raphael Eduardo,9993,0,9999,6
1745820355700,CLRE 253,A00,891867,Vaida; Florin,9994,0,9999,5
1745820355700,CLRE 253,B00,907819,Staff,9999,0,9999,0
1745820356727,CLRE 259,A00,891868,Patel; Hemal,9998,0,9999,1
1745820357752,CLRE 260,A00,891872,Cuomo; Raphael Eduardo,9999,0,9999,0
1745820358778,CLRE 297,001,891888,Cuomo; Raphael Eduardo,9999,0,9999,0
1745820359803,CSE 191,A00,958773,Minnes Kemp; Mor Mia,9999,0,9999,0
1745820360829,CSS 201S,A01,892054,Mignozzetti; Umberto,30,0,30,0
1745820361859,CSS 202S,A01,892056,Mignozzetti; Umberto,30,0,30,0
1745820362893,DSC 197,001,956898,Eldridge; Justin Matthew,9998,0,9999,1
1745820363918,DSC 297,001,958000,Mazumdar; Arya,9998,0,9999,1
1745820364944,EAP 100,A00,905686,Staff,9776,0,9999,223
1745820365971,ECE 45,A01,892618,Staff,0,12,50,50
1745820367000,ECE 109,A01,892620,Staff,0,43,0,0
1745820368029,ECE 111,A01,892719,Staff,0,9,50,50
1745820369058,ECE 197,001,957920,Mercier; Patrick Philip,9992,0,9999,7
1745820370088,ECON 178,A01,907814,Zhu; Ying,28,0,35,7
1745820371118,EDS 115,A00,895312,Staff,41,0,45,4
1745820372146,EDS 117,A01,895337,Staff,30,0,30,0
1745820373170,EDS 125,A00,895341,Jones; Gabrielle Anastasia,43,0,45,2
1745820374197,EDS 128A,A01,895459,Fargason; Sharon Gayle,44,0,45,1
1745820375223,EDS 128B,A01,895543,Pappas; Elizabeth,44,0,45,1
1745820376249,EDS 139,A00,897203,Pappas; Elizabeth,44,0,45,1
1745820376249,EDS 139,B00,897209,Fargason; Sharon Gayle,44,0,45,1
1745820377275,EDS 201,A00,895545,Staff,43,0,45,2
1745820378305,EDS 203,A01,895581,Halter; Christopher P.,43,0,45,2
1745820379331,EDS 204R,A01,895625,Heinzman; Erica M.,43,0,45,2
1745820379331,EDS 204R,B01,895693,Halter; Christopher P.,18,0,45,27
1745820380362,EDS 206R,A00,895694,Fargason; Sharon Gayle,9,0,30,21
1745820380362,EDS 206R,B00,895695,Choi; Bailey Miyeon,20,0,30,10
1745820381391,EDS 250,A00,895697,Hemans; Patricia Ann Benitez,43,0,45,2
1745820382420,EDS 281,A00,895701,Meyerott; Theresa Ann,15,0,15,0
1745820383449,EDS 284,A00,895736,Meyerott; Theresa Ann,15,0,15,0
1745820384474,EDS 286,A00,897210,Fine; Sarah,15,0,15,0
1745820385503,EDS 289C,A01,895770,Daly; Alan J.,15,0,15,0
1745820386530,EDS 290,A00,897211,Hofstetter; Carolyn,15,0,15,0
1745820387557,LIGM 5A,A00,896162,Fischer-Grunski; Eva K,15,0,20,5
1745820388581,LIGM 5B,A00,896260,Fischer-Grunski; Eva K,17,0,20,3
1745820389607,LIGM 5C,A00,896308,Fischer-Grunski; Eva K,18,0,20,2
1745820390634,LIIT 5AS,A00,896313,Carnelos; Chiara,17,0,20,3
1745820391662,LIIT 5BS,A00,896416,Carnelos; Chiara,20,0,20,0
1745820392688,LIIT 5CS,A00,896564,Carnelos; Chiara,20,0,20,0
1745820393717,LISP 5A,A00,896588,Munoz Sanchez; Alicia,4,0,20,16
1745820394747,LISP 5B,A00,896653,Munoz Sanchez; Alicia,10,0,20,10
1745820395774,LISP 5C,A00,896655,Munoz Sanchez; Alicia,4,0,20,16
1745820396804,MAE 197,001,957918,Kleissl; Jan,9998,0,9999,1
1745820397834,MATH 2,A01,957937,Staff,34,0,35,1
1745820398858,MATH 197,001,957876,Kedlaya; Kiran S.,9993,0,9999,6
1745820399883,MCWP 40,A00,892729,Duru; Nur,13,0,20,7
1745820399883,MCWP 40,B00,893304,Montejo; Carolina,20,0,20,0
1745820400916,MCWP 40R,A00,893757,Redela; Pamela Morgan,0,7,20,20
1745820401946,MCWP 50,A00,893758,Morshed; Michael James,2,0,20,18
1745820401946,MCWP 50,B00,893761,Bartulis; Jason Michael,18,0,20,2
1745820402971,MCWP 50R,A00,893766,Compas; Sean Matthew,0,1,20,20
1745820402971,MCWP 50R,B00,893769,Carter; Jennifer A,0,0,20,20
1745820402971,MCWP 50R,C00,893771,Krone; Jarret,0,3,20,20
1745820402971,MCWP 50R,D00,893772,Miller; Elizabeth Deen,3,0,20,17
1745820402971,MCWP 50R,E00,893775,Carter; Andrea L,0,0,20,20
1745820404001,MMW 11R,A01,892721,Herbst; Matthew,11,0,27,16
1745820404001,MMW 11R,A02,892722,Herbst; Matthew,0,0,0,3
1745820405028,MMW 12R,A01,892724,Herbst; Matthew,0,10,16,16
1745820405028,MMW 12R,A02,892725,Herbst; Matthew,0,9,16,16
1745820406054,MMW 13R,A01,892727,Staff,0,3,16,16
1745820406054,MMW 13R,A02,892728,Staff,0,4,16,16
1745820406054,MMW 13R,A03,958032,Staff,0,3,16,16
1745820406054,MMW 13R,A04,958033,Staff,0,2,16,16
1745820406054,MMW 13R,A05,958034,Staff,0,3,16,16
1745820407081,SIO 295LS,A00,894015,Staff,7,0,25,18
1745820408107,SIO 295S,A00,894020,Staff,7,0,25,18
1745820409142,SIOC 290S,B01,958918,Staff,0,0,0,0
1745820410176,SIOC 291S,B01,958922,Staff,0,0,0,0
1745820411203,SOCI 117,A01,895339,Staff,4,0,5,1
1745820412230,WES 237B,A00,894149,Staff,11,0,20,9
1745820414307,AESE 279B,A00,891859,Staff,13,0,35,22
1745820415333,AIP 197,001,891854,Staff,70,0,70,0
1745820416362,ANTH 289S,A00,891856,Gagneux; Pascal,12,0,12,0
1745820417391,BENG 196,001,957946,Engler; Adam J.,9996,0,9999,3
1745820418418,CAT 124RS,A01,956906,Staff,8,0,25,17
1745820419443,CAT 125RS,A01,922013,Staff,8,0,25,17
1745820420471,CLRE 250,A00,891860,Morris; Sheldon,9995,0,9999,4
1745820422529,CLRE 251R,A00,907817,Mehta; Ravindra L.,9994,0,9999,5
1745820423558,CLRE 252,A00,891864,Cuomo; Raphael Eduardo,9993,0,9999,6
1745820424584,CLRE 253,A00,891867,Vaida; Florin,9994,0,9999,5
1745820424584,CLRE 253,B00,907819,Staff,9999,0,9999,0
1745820425612,CLRE 259,A00,891868,Patel; Hemal,9998,0,9999,1
1745820426638,CLRE 260,A00,891872,Cuomo; Raphael Eduardo,9999,0,9999,0
1745820427685,CLRE 297,001,891888,Cuomo; Raphael Eduardo,9999,0,9999,0
1745820428713,CSE 191,A00,958773,Minnes Kemp; Mor Mia,9999,0,9999,0
1745820429747,CSS 201S,A01,892054,Mignozzetti; Umberto,30,0,30,0
1745820430773,CSS 202S,A01,892056,Mignozzetti; Umberto,30,0,30,0
1745820431799,DSC 197,001,956898,Eldridge; Justin Matthew,9998,0,9999,1
1745820432824,DSC 297,001,958000,Mazumdar; Arya,9998,0,9999,1
1745820433852,EAP 100,A00,905686,Staff,9776,0,9999,223
1745820434879,ECE 45,A01,892618,Staff,0,12,50,50
1745820435906,ECE 109,A01,892620,Staff,0,43,0,0
1745820436939,ECE 111,A01,892719,Staff,0,9,50,50
1745820437964,ECE 197,001,957920,Mercier; Patrick Philip,9992,0,9999,7
1745820438991,ECON 178,A01,907814,Zhu; Ying,28,0,35,7
1745820440022,EDS 115,A00,895312,Staff,41,0,45,4
1745820441049,EDS 117,A01,895337,Staff,30,0,30,0
1745820442077,EDS 125,A00,895341,Jones; Gabrielle Anastasia,43,0,45,2
1745820443105,EDS 128A,A01,895459,Fargason; Sharon Gayle,44,0,45,1
1745820444132,EDS 128B,A01,895543,Pappas; Elizabeth,44,0,45,1
1745820445160,EDS 139,A00,897203,Pappas; Elizabeth,44,0,45,1
1745820445160,EDS 139,B00,897209,Fargason; Sharon Gayle,44,0,45,1
1745820446185,EDS 201,A00,895545,Staff,43,0,45,2
1745820447214,EDS 203,A01,895581,Halter; Christopher P.,43,0,45,2
1745820448240,EDS 204R,A01,895625,Heinzman; Erica M.,43,0,45,2
1745820448240,EDS 204R,B01,895693,Halter; Christopher P.,18,0,45,27
1745820449269,EDS 206R,A00,895694,Fargason; Sharon Gayle,9,0,30,21
1745820449269,EDS 206R,B00,895695,Choi; Bailey Miyeon,20,0,30,10
1745820450298,EDS 250,A00,895697,Hemans; Patricia Ann Benitez,43,0,45,2
1745820451380,EDS 281,A00,895701,Meyerott; Theresa Ann,15,0,15,0
1745820452409,EDS 284,A00,895736,Meyerott; Theresa Ann,15,0,15,0
1745820453434,EDS 286,A00,897210,Fine; Sarah,15,0,15,0
1745820454465,EDS 289C,A01,895770,Daly; Alan J.,15,0,15,0
1745820455491,EDS 290,A00,897211,Hofstetter; Carolyn,15,0,15,0
1745820456519,LIGM 5A,A00,896162,Fischer-Grunski; Eva K,15,0,20,5
1745820457548,LIGM 5B,A00,896260,Fischer-Grunski; Eva K,17,0,20,3
1745820458572,LIGM 5C,A00,896308,Fischer-Grunski; Eva K,18,0,20,2
1745820459599,LIIT 5AS,A00,896313,Carnelos; Chiara,17,0,20,3
1745820460627,LIIT 5BS,A00,896416,Carnelos; Chiara,20,0,20,0
1745820461656,LIIT 5CS,A00,896564,Carnelos; Chiara,20,0,20,0
1745820462681,LISP 5A,A00,896588,Munoz Sanchez; Alicia,4,0,20,16
1745820463709,LISP 5B,A00,896653,Munoz Sanchez; Alicia,10,0,20,10
1745820464738,LISP 5C,A00,896655,Munoz Sanchez; Alicia,4,0,20,16
1745820465766,MAE 197,001,957918,Kleissl; Jan,9998,0,9999,1
1745820466793,MATH 2,A01,957937,Staff,34,0,35,1
1745820467823,MATH 197,001,957876,Kedlaya; Kiran S.,9993,0,9999,6
1745820468851,MCWP 40,A00,892729,Duru; Nur,13,0,20,7
1745820468851,MCWP 40,B00,893304,Montejo; Carolina,20,0,20,0
1745820469879,MCWP 40R,A00,893757,Redela; Pamela Morgan,0,7,20,20
1745820470905,MCWP 50,A00,893758,Morshed; Michael James,2,0,20,18
1745820470905,MCWP 50,B00,893761,Bartulis; Jason Michael,18,0,20,2
1745820471930,MCWP 50R,A00,893766,Compas; Sean Matthew,0,1,20,20
1745820471930,MCWP 50R,B00,893769,Carter; Jennifer A,0,0,20,20
1745820471930,MCWP 50R,C00,893771,Krone; Jarret,0,3,20,20
1745820471930,MCWP 50R,D00,893772,Miller; Elizabeth Deen,3,0,20,17
1745820471930,MCWP 50R,E00,893775,Carter; Andrea L,0,0,20,20
1745820472958,MMW 11R,A01,892721,Herbst; Matthew,11,0,27,16
1745820472958,MMW 11R,A02,892722,Herbst; Matthew,0,0,0,3
1745820473990,MMW 12R,A01,892724,Herbst; Matthew,0,10,16,16
1745820473990,MMW 12R,A02,892725,Herbst; Matthew,0,9,16,16
1745820475019,MMW 13R,A01,892727,Staff,0,3,16,16
1745820475019,MMW 13R,A02,892728,Staff,0,4,16,16
1745820475019,MMW 13R,A03,958032,Staff,0,3,16,16
1745820475019,MMW 13R,A04,958033,Staff,0,2,16,16
1745820475019,MMW 13R,A05,958034,Staff,0,3,16,16
1745820476048,SIO 295LS,A00,894015,Staff,7,0,25,18
1745820477076,SIO 295S,A00,894020,Staff,7,0,25,18
1745820478103,SIOC 290S,B01,958918,Staff,0,0,0,0
1745820479135,SIOC 291S,B01,958922,Staff,0,0,0,0
1745820480165,SOCI 117,A01,895339,Staff,4,0,5,1
1745820481193,WES 237B,A00,894149,Staff,11,0,20,9
1745820483293,AESE 279B,A00,891859,Staff,13,0,35,22
1745820484318,AIP 197,001,891854,Staff,70,0,70,0
1745820485348,ANTH 289S,A00,891856,Gagneux; Pascal,12,0,12,0
1745820486374,BENG 196,001,957946,Engler; Adam J.,9996,0,9999,3
1745820487399,CAT 124RS,A01,956906,Staff,8,0,25,17
1745820488425,CAT 125RS,A01,922013,Staff,8,0,25,17
1745820489453,CLRE 250,A00,891860,Morris; Sheldon,9995,0,9999,4
1745820491505,CLRE 251R,A00,907817,Mehta; Ravindra L.,9994,0,9999,5
1745820492534,CLRE 252,A00,891864,Cuomo; Raphael Eduardo,9993,0,9999,6
1745820493562,CLRE 253,A00,891867,Vaida; Florin,9994,0,9999,5
1745820493562,CLRE 253,B00,907819,Staff,9999,0,9999,0
1745820494588,CLRE 259,A00,891868,Patel; Hemal,9998,0,9999,1
1745820495613,CLRE 260,A00,891872,Cuomo; Raphael Eduardo,9999,0,9999,0
1745820496639,CLRE 297,001,891888,Cuomo; Raphael Eduardo,9999,0,9999,0
1745820497664,CSE 191,A00,958773,Minnes Kemp; Mor Mia,9999,0,9999,0
1745820498690,CSS 201S,A01,892054,Mignozzetti; Umberto,30,0,30,0
1745820499720,CSS 202S,A01,892056,Mignozzetti; Umberto,30,0,30,0
1745820500744,DSC 197,001,956898,Eldridge; Justin Matthew,9998,0,9999,1
1745820501769,DSC 297,001,958000,Mazumdar; Arya,9998,0,9999,1
1745820502795,EAP 100,A00,905686,Staff,9776,0,9999,223
1745820503829,ECE 45,A01,892618,Staff,0,12,50,50
1745820504861,ECE 109,A01,892620,Staff,0,43,0,0
1745820505890,ECE 111,A01,892719,Staff,0,9,50,50
1745820506915,ECE 197,001,957920,Mercier; Patrick Philip,9992,0,9999,7
1745820507942,ECON 178,A01,907814,Zhu; Ying,28,0,35,7
1745820508967,EDS 115,A00,895312,Staff,41,0,45,4
1745820509993,EDS 117,A01,895337,Staff,30,0,30,0
1745820511020,EDS 125,A00,895341,Jones; Gabrielle Anastasia,43,0,45,2
1745820512046,EDS 128A,A01,895459,Fargason; Sharon Gayle,44,0,45,1
1745820513072,EDS 128B,A01,895543,Pappas; Elizabeth,44,0,45,1
1745820514101,EDS 139,A00,897203,Pappas; Elizabeth,44,0,45,1
1745820514101,EDS 139,B00,897209,Fargason; Sharon Gayle,44,0,45,1
1745820515132,EDS 201,A00,895545,Staff,43,0,45,2
1745820516157,EDS 203,A01,895581,Halter; Christopher P.,43,0,45,2
1745820517183,EDS 204R,A01,895625,Heinzman; Erica M.,43,0,45,2
1745820517183,EDS 204R,B01,895693,Halter; Christopher P.,18,0,45,27
1745820518209,EDS 206R,A00,895694,Fargason; Sharon Gayle,9,0,30,21
1745820518209,EDS 206R,B00,895695,Choi; Bailey Miyeon,20,0,30,10
1745820519237,EDS 250,A00,895697,Hemans; Patricia Ann Benitez,43,0,45,2
1745820520265,EDS 281,A00,895701,Meyerott; Theresa Ann,15,0,15,0
1745820521294,EDS 284,A00,895736,Meyerott; Theresa Ann,15,0,15,0
1745820522322,EDS 286,A00,897210,Fine; Sarah,15,0,15,0
1745820523348,EDS 289C,A01,895770,Daly; Alan J.,15,0,15,0
1745820524377,EDS 290,A00,897211,Hofstetter; Carolyn,15,0,15,0
1745820525407,LIGM 5A,A00,896162,Fischer-Grunski; Eva K,15,0,20,5
1745820526433,LIGM 5B,A00,896260,Fischer-Grunski; Eva K,17,0,20,3
1745820527462,LIGM 5C,A00,896308,Fischer-Grunski; Eva K,18,0,20,2
1745820528488,LIIT 5AS,A00,896313,Carnelos; Chiara,17,0,20,3
1745820529515,LIIT 5BS,A00,896416,Carnelos; Chiara,20,0,20,0
1745820530542,LIIT 5CS,A00,896564,Carnelos; Chiara,20,0,20,0
1745820531570,LISP 5A,A00,896588,Munoz Sanchez; Alicia,4,0,20,16
1745820532594,LISP 5B,A00,896653,Munoz Sanchez; Alicia,10,0,20,10
1745820533620,LISP 5C,A00,896655,Munoz Sanchez; Alicia,4,0,20,16
1745820534648,MAE 197,001,957918,Kleissl; Jan,9998,0,9999,1
1745820535675,MATH 2,A01,957937,Staff,34,0,35,1
1745820536701,MATH 197,001,957876,Kedlaya; Kiran S.,9993,0,9999,6
1745820537729,MCWP 40,A00,892729,Duru; Nur,13,0,20,7
1745820537729,MCWP 40,B00,893304,Montejo; Carolina,20,0,20,0
1745820538758,MCWP 40R,A00,893757,Redela; Pamela Morgan,0,7,20,20
1745820539787,MCWP 50,A00,893758,Morshed; Michael James,2,0,20,18
1745820539787,MCWP 50,B00,893761,Bartulis; Jason Michael,18,0,20,2
1745820540814,MCWP 50R,A00,893766,Compas; Sean Matthew,0,1,20,20
1745820540814,MCWP 50R,B00,893769,Carter; Jennifer A,0,0,20,20
1745820540814,MCWP 50R,C00,893771,Krone; Jarret,0,3,20,20
1745820540814,MCWP 50R,D00,893772,Miller; Elizabeth Deen,3,0,20,17
1745820540814,MCWP 50R,E00,893775,Carter; Andrea L,0,0,20,20
1745820541848,MMW 11R,A01,892721,Herbst; Matthew,11,0,27,16
1745820541848,MMW 11R,A02,892722,Herbst; Matthew,0,0,0,3
1745820542875,MMW 12R,A01,892724,Herbst; Matthew,0,10,16,16
1745820542875,MMW 12R,A02,892725,Herbst; Matthew,0,9,16,16
1745820543905,MMW 13R,A01,892727,Staff,0,3,16,16
1745820543905,MMW 13R,A02,892728,Staff,0,4,16,16
1745820543905,MMW 13R,A03,958032,Staff,0,3,16,16
1745820543905,MMW 13R,A04,958033,Staff,0,2,16,16
1745820543905,MMW 13R,A05,958034,Staff,0,3,16,16
1745820544931,SIO 295LS,A00,894015,Staff,7,0,25,18
1745820545957,SIO 295S,A00,894020,Staff,7,0,25,18
1745820546985,SIOC 290S,B01,958918,Staff,0,0,0,0
1745820548217,SIOC 291S,B01,958922,Staff,0,0,0,0
1745820549253,SOCI 117,A01,895339,Staff,4,0,5,1
1745820550280,WES 237B,A00,894149,Staff,11,0,20,9
1745820552352,AESE 279B,A00,891859,Staff,13,0,35,22
1745820553378,AIP 197,001,891854,Staff,70,0,70,0
1745820554403,ANTH 289S,A00,891856,Gagneux; Pascal,12,0,12,0
1745820555434,BENG 196,001,957946,Engler; Adam J.,9996,0,9999,3
1745820556467,CAT 124RS,A01,956906,Staff,8,0,25,17
1745820557499,CAT 125RS,A01,922013,Staff,8,0,25,17
1745820558524,CLRE 250,A00,891860,Morris; Sheldon,9995,0,9999,4
1745820560626,CLRE 251R,A00,907817,Mehta; Ravindra L.,9994,0,9999,5
1745820561655,CLRE 252,A00,891864,Cuomo; Raphael Eduardo,9993,0,9999,6
1745820562680,CLRE 253,A00,891867,Vaida; Florin,9994,0,9999,5
1745820562680,CLRE 253,B00,907819,Staff,9999,0,9999,0
1745820563708,CLRE 259,A00,891868,Patel; Hemal,9998,0,9999,1
1745820564735,CLRE 260,A00,891872,Cuomo; Raphael Eduardo,9999,0,9999,0
1745820565764,CLRE 297,001,891888,Cuomo; Raphael Eduardo,9999,0,9999,0
1745820566792,CSE 191,A00,958773,Minnes Kemp; Mor Mia,9999,0,9999,0
1745820567823,CSS 201S,A01,892054,Mignozzetti; Umberto,30,0,30,0
1745820568849,CSS 202S,A01,892056,Mignozzetti; Umberto,30,0,30,0
1745820569874,DSC 197,001,956898,Eldridge; Justin Matthew,9998,0,9999,1
1745820570902,DSC 297,001,958000,Mazumdar; Arya,9998,0,9999,1
1745820571928,EAP 100,A00,905686,Staff,9776,0,9999,223
1745820572957,ECE 45,A01,892618,Staff,0,12,50,50
1745820573986,ECE 109,A01,892620,Staff,0,43,0,0
1745820575019,ECE 111,A01,892719,Staff,0,9,50,50
1745820576053,ECE 197,001,957920,Mercier; Patrick Philip,9992,0,9999,7
1745820577082,ECON 178,A01,907814,Zhu; Ying,28,0,35,7
1745820578114,EDS 115,A00,895312,Staff,41,0,45,4
1745820579142,EDS 117,A01,895337,Staff,30,0,30,0
1745820580169,EDS 125,A00,895341,Jones; Gabrielle Anastasia,43,0,45,2
1745820581201,EDS 128A,A01,895459,Fargason; Sharon Gayle,44,0,45,1
1745820582226,EDS 128B,A01,895543,Pappas; Elizabeth,44,0,45,1
1745820583255,EDS 139,A00,897203,Pappas; Elizabeth,44,0,45,1
1745820583255,EDS 139,B00,897209,Fargason; Sharon Gayle,44,0,45,1
1745820584281,EDS 201,A00,895545,Staff,43,0,45,2
1745820585317,EDS 203,A01,895581,Halter; Christopher P.,43,0,45,2
1745820586343,EDS 204R,A01,895625,Heinzman; Erica M.,43,0,45,2
1745820586343,EDS 204R,B01,895693,Halter; Christopher P.,18,0,45,27
1745820587370,EDS 206R,A00,895694,Fargason; Sharon Gayle,9,0,30,21
1745820587370,EDS 206R,B00,895695,Choi; Bailey Miyeon,20,0,30,10
1745820588397,EDS 250,A00,895697,Hemans; Patricia Ann Benitez,43,0,45,2
1745820589423,EDS 281,A00,895701,Meyerott; Theresa Ann,15,0,15,0
1745820590450,EDS 284,A00,895736,Meyerott; Theresa Ann,15,0,15,0
1745820591481,EDS 286,A00,897210,Fine; Sarah,15,0,15,0
1745820592506,EDS 289C,A01,895770,Daly; Alan J.,15,0,15,0
1745820593534,EDS 290,A00,897211,Hofstetter; Carolyn,15,0,15,0
1745820594568,LIGM 5A,A00,896162,Fischer-Grunski; Eva K,15,0,20,5
1745820595598,LIGM 5B,A00,896260,Fischer-Grunski; Eva K,17,0,20,3
1745820596623,LIGM 5C,A00,896308,Fischer-Grunski; Eva K,18,0,20,2
1745820597648,LIIT 5AS,A00,896313,Carnelos; Chiara,17,0,20,3
1745820598672,LIIT 5BS,A00,896416,Carnelos; Chiara,20,0,20,0
1745820599743,LIIT 5CS,A00,896564,Carnelos; Chiara,20,0,20,0
1745820600771,LISP 5A,A00,896588,Munoz Sanchez; Alicia,4,0,20,16
1745820601801,LISP 5B,A00,896653,Munoz Sanchez; Alicia,10,0,20,10
1745820602831,LISP 5C,A00,896655,Munoz Sanchez; Alicia,4,0,20,16
1745820603860,MAE 197,001,957918,Kleissl; Jan,9998,0,9999,1
1745820604886,MATH 2,A01,957937,Staff,34,0,35,1
1745820605914,MATH 197,001,957876,Kedlaya; Kiran S.,9993,0,9999,6
1745820606944,MCWP 40,A00,892729,Duru; Nur,13,0,20,7
1745820606944,MCWP 40,B00,893304,Montejo; Carolina,20,0,20,0
1745820607970,MCWP 40R,A00,893757,Redela; Pamela Morgan,0,7,20,20
1745820608998,MCWP 50,A00,893758,Morshed; Michael James,2,0,20,18
1745820608998,MCWP 50,B00,893761,Bartulis; Jason Michael,18,0,20,2
1745820610032,MCWP 50R,A00,893766,Compas; Sean Matthew,0,1,20,20
1745820610032,MCWP 50R,B00,893769,Carter; Jennifer A,0,0,20,20
1745820610032,MCWP 50R,C00,893771,Krone; Jarret,0,3,20,20
1745820610032,MCWP 50R,D00,893772,Miller; Elizabeth Deen,3,0,20,17
1745820610032,MCWP 50R,E00,893775,Carter; Andrea L,0,0,20,20
1745820611060,MMW 11R,A01,892721,Herbst; Matthew,11,0,27,16
1745820611060,MMW 11R,A02,892722,Herbst; Matthew,0,0,0,3
1745820612085,MMW 12R,A01,892724,Herbst; Matthew,0,10,16,16
1745820612085,MMW 12R,A02,892725,Herbst; Matthew,0,9,16,16
1745820613110,MMW 13R,A01,892727,Staff,0,3,16,16
1745820613110,MMW 13R,A02,892728,Staff,0,4,16,16
1745820613110,MMW 13R,A03,958032,Staff,0,3,16,16
1745820613110,MMW 13R,A04,958033,Staff,0,2,16,16
1745820613110,MMW 13R,A05,958034,Staff,0,3,16,16
1745820614136,SIO 295LS,A00,894015,Staff,7,0,25,18
1745820615165,SIO 295S,A00,894020,Staff,7,0,25,18
1745820616195,SIOC 290S,B01,958918,Staff,0,0,0,0
1745820617222,SIOC 291S,B01,958922,Staff,0,0,0,0
1745820618249,SOCI 117,A01,895339,Staff,4,0,5,1
1745820619278,WES 237B,A00,894149,Staff,11,0,20,9
1745820621334,AESE 279B,A00,891859,Staff,13,0,35,22
1745820622360,AIP 197,001,891854,Staff,70,0,70,0
1745820623385,ANTH 289S,A00,891856,Gagneux; Pascal,12,0,12,0
1745820624414,BENG 196,001,957946,Engler; Adam J.,9996,0,9999,3
1745820625443,CAT 124RS,A01,956906,Staff,8,0,25,17
1745820626471,CAT 125RS,A01,922013,Staff,8,0,25,17
1745820627503,CLRE 250,A00,891860,Morris; Sheldon,9995,0,9999,4
1745820629556,CLRE 251R,A00,907817,Mehta; Ravindra L.,9994,0,9999,5
1745820630585,CLRE 252,A00,891864,Cuomo; Raphael Eduardo,9993,0,9999,6
1745820631611,CLRE 253,A00,891867,Vaida; Florin,9994,0,9999,5
1745820631611,CLRE 253,B00,907819,Staff,9999,0,9999,0
1745820632637,CLRE 259,A00,891868,Patel; Hemal,9998,0,9999,1
1745820633662,CLRE 260,A00,891872,Cuomo; Raphael Eduardo,9999,0,9999,0
1745820634688,CLRE 297,001,891888,Cuomo; Raphael Eduardo,9999,0,9999,0
1745820635718,CSE 191,A00,958773,Minnes Kemp; Mor Mia,9999,0,9999,0
1745820636744,CSS 201S,A01,892054,Mignozzetti; Umberto,30,0,30,0
1745820637773,CSS 202S,A01,892056,Mignozzetti; Umberto,30,0,30,0
1745820638799,DSC 197,001,956898,Eldridge; Justin Matthew,9998,0,9999,1
1745820639823,DSC 297,001,958000,Mazumdar; Arya,9998,0,9999,1
1745820640850,EAP 100,A00,905686,Staff,9776,0,9999,223
1745820641875,ECE 45,A01,892618,Staff,0,12,50,50
1745820642900,ECE 109,A01,892620,Staff,0,43,0,0
1745820643926,ECE 111,A01,892719,Staff,0,9,50,50
1745820644952,ECE 197,001,957920,Mercier; Patrick Philip,9992,0,9999,7
1745820645980,ECON 178,A01,907814,Zhu; Ying,28,0,35,7
1745820647004,EDS 115,A00,895312,Staff,41,0,45,4
1745820648029,EDS 117,A01,895337,Staff,30,0,30,0
1745820649054,EDS 125,A00,895341,Jones; Gabrielle Anastasia,43,0,45,2
1745820650082,EDS 128A,A01,895459,Fargason; Sharon Gayle,44,0,45,1
1745820651109,EDS 128B,A01,895543,Pappas; Elizabeth,44,0,45,1
1745820652134,EDS 139,A00,897203,Pappas; Elizabeth,44,0,45,1
1745820652134,EDS 139,B00,897209,Fargason; Sharon Gayle,44,0,45,1
1745820653160,EDS 201,A00,895545,Staff,43,0,45,2
1745820654187,EDS 203,A01,895581,Halter; Christopher P.,43,0,45,2
1745820655212,EDS 204R,A01,895625,Heinzman; Erica M.,43,0,45,2
1745820655212,EDS 204R,B01,895693,Halter; Christopher P.,18,0,45,27
1745820656238,EDS 206R,A00,895694,Fargason; Sharon Gayle,9,0,30,21
1745820656238,EDS 206R,B00,895695,Choi; Bailey Miyeon,20,0,30,10
1745820657263,EDS 250,A00,895697,Hemans; Patricia Ann Benitez,43,0,45,2
1745820658289,EDS 281,A00,895701,Meyerott; Theresa Ann,15,0,15,0
1745820659315,EDS 284,A00,895736,Meyerott; Theresa Ann,15,0,15,0
1745820660343,EDS 286,A00,897210,Fine; Sarah,15,0,15,0
1745820661372,EDS 289C,A01,895770,Daly; Alan J.,15,0,15,0
1745820662399,EDS 290,A00,897211,Hofstetter; Carolyn,15,0,15,0
1745820663424,LIGM 5A,A00,896162,Fischer-Grunski; Eva K,15,0,20,5
1745820664449,LIGM 5B,A00,896260,Fischer-Grunski; Eva K,17,0,20,3
1745820665479,LIGM 5C,A00,896308,Fischer-Grunski; Eva K,18,0,20,2
1745820666508,LIIT 5AS,A00,896313,Carnelos; Chiara,17,0,20,3
1745820667535,LIIT 5BS,A00,896416,Carnelos; Chiara,20,0,20,0
1745820668563,LIIT 5CS,A00,896564,Carnelos; Chiara,20,0,20,0
1745820669587,LISP 5A,A00,896588,Munoz Sanchez; Alicia,4,0,20,16
1745820670616,LISP 5B,A00,896653,Munoz Sanchez; Alicia,10,0,20,10
1745820671642,LISP 5C,A00,896655,Munoz Sanchez; Alicia,4,0,20,16
1745820672669,MAE 197,001,957918,Kleissl; Jan,9998,0,9999,1
1745820673695,MATH 2,A01,957937,Staff,34,0,35,1
1745820674722,MATH 197,001,957876,Kedlaya; Kiran S.,9993,0,9999,6
1745820675749,MCWP 40,A00,892729,Duru; Nur,13,0,20,7
1745820675749,MCWP 40,B00,893304,Montejo; Carolina,20,0,20,0
1745820676775,MCWP 40R,A00,893757,Redela; Pamela Morgan,0,7,20,20
1745820677801,MCWP 50,A00,893758,Morshed; Michael James,2,0,20,18
1745820677801,MCWP 50,B00,893761,Bartulis; Jason Michael,18,0,20,2
1745820678830,MCWP 50R,A00,893766,Compas; Sean Matthew,0,1,20,20
1745820678830,MCWP 50R,B00,893769,Carter; Jennifer A,0,0,20,20
1745820678830,MCWP 50R,C00,893771,Krone; Jarret,0,3,20,20
1745820678830,MCWP 50R,D00,893772,Miller; Elizabeth Deen,3,0,20,17
1745820678830,MCWP 50R,E00,893775,Carter; Andrea L,0,0,20,20
1745820679855,MMW 11R,A01,892721,Herbst; Matthew,11,0,27,16
1745820679855,MMW 11R,A02,892722,Herbst; Matthew,0,0,0,3
1745820680880,MMW 12R,A01,892724,Herbst; Matthew,0,10,16,16
1745820680880,MMW 12R,A02,892725,Herbst; Matthew,0,9,16,16
1745820681908,MMW 13R,A01,892727,Staff,0,3,16,16
1745820681908,MMW 13R,A02,892728,Staff,0,4,16,16
1745820681908,MMW 13R,A03,958032,Staff,0,3,16,16
1745820681908,MMW 13R,A04,958033,Staff,0,2,16,16
1745820681908,MMW 13R,A05,958034,Staff,0,3,16,16
1745820682934,SIO 295LS,A00,894015,Staff,7,0,25,18
1745820683959,SIO 295S,A00,894020,Staff,7,0,25,18
1745820684985,SIOC 290S,B01,958918,Staff,0,0,0,0
1745820686016,SIOC 291S,B01,958922,Staff,0,0,0,0
1745820687042,SOCI 117,A01,895339,Staff,4,0,5,1
1745820688068,WES 237B,A00,894149,Staff,11,0,20,9
1745820690128,AESE 279B,A00,891859,Staff,13,0,35,22
1745820691154,AIP 197,001,891854,Staff,70,0,70,0
1745820692182,ANTH 289S,A00,891856,Gagneux; Pascal,12,0,12,0
1745820693209,BENG 196,001,957946,Engler; Adam J.,9996,0,9999,3
1745820694236,CAT 124RS,A01,956906,Staff,8,0,25,17
1745820695262,CAT 125RS,A01,922013,Staff,8,0,25,17
1745820696286,CLRE 250,A00,891860,Morris; Sheldon,9995,0,9999,4
1745820698341,CLRE 251R,A00,907817,Mehta; Ravindra L.,9994,0,9999,5
1745820699368,CLRE 252,A00,891864,Cuomo; Raphael Eduardo,9993,0,9999,6
1745820700393,CLRE 253,A00,891867,Vaida; Florin,9994,0,9999,5
1745820700393,CLRE 253,B00,907819,Staff,9999,0,9999,0
1745820701421,CLRE 259,A00,891868,Patel; Hemal,9998,0,9999,1
1745820702449,CLRE 260,A00,891872,Cuomo; Raphael Eduardo,9999,0,9999,0
1745820703475,CLRE 297,001,891888,Cuomo; Raphael Eduardo,9999,0,9999,0
1745820704505,CSE 191,A00,958773,Minnes Kemp; Mor Mia,9999,0,9999,0
1745820705534,CSS 201S,A01,892054,Mignozzetti; Umberto,30,0,30,0
1745820706562,CSS 202S,A01,892056,Mignozzetti; Umberto,30,0,30,0
1745820707588,DSC 197,001,956898,Eldridge; Justin Matthew,9998,0,9999,1
1745820708615,DSC 297,001,958000,Mazumdar; Arya,9998,0,9999,1
1745820709641,EAP 100,A00,905686,Staff,9776,0,9999,223
1745820710667,ECE 45,A01,892618,Staff,0,12,50,50
1745820711696,ECE 109,A01,892620,Staff,0,43,0,0
1745820712726,ECE 111,A01,892719,Staff,0,9,50,50
1745820713754,ECE 197,001,957920,Mercier; Patrick Philip,9992,0,9999,7
1745820714785,ECON 178,A01,907814,Zhu; Ying,28,0,35,7
1745820715812,EDS 115,A00,895312,Staff,41,0,45,4
1745820716841,EDS 117,A01,895337,Staff,30,0,30,0
1745820717877,EDS 125,A00,895341,Jones; Gabrielle Anastasia,43,0,45,2
1745820718903,EDS 128A,A01,895459,Fargason; Sharon Gayle,44,0,45,1
1745820719929,EDS 128B,A01,895543,Pappas; Elizabeth,44,0,45,1
1745820720954,EDS 139,A00,897203,Pappas; Elizabeth,44,0,45,1
1745820720954,EDS 139,B00,897209,Fargason; Sharon Gayle,44,0,45,1
1745820721984,EDS 201,A00,895545,Staff,43,0,45,2
1745820723010,EDS 203,A01,895581,Halter; Christopher P.,43,0,45,2
1745820724038,EDS 204R,A01,895625,Heinzman; Erica M.,43,0,45,2
1745820724038,EDS 204R,B01,895693,Halter; Christopher P.,18,0,45,27
1745820725074,EDS 206R,A00,895694,Fargason; Sharon Gayle,9,0,30,21
1745820725074,EDS 206R,B00,895695,Choi; Bailey Miyeon,20,0,30,10
1745820726099,EDS 250,A00,895697,Hemans; Patricia Ann Benitez,43,0,45,2
1745820727126,EDS 281,A00,895701,Meyerott; Theresa Ann,15,0,15,0
1745820728153,EDS 284,A00,895736,Meyerott; Theresa Ann,15,0,15,0
1745820729176,EDS 286,A00,897210,Fine; Sarah,15,0,15,0
1745820730202,EDS 289C,A01,895770,Daly; Alan J.,15,0,15,0
1745820731232,EDS 290,A00,897211,Hofstetter; Carolyn,15,0,15,0
1745820732260,LIGM 5A,A00,896162,Fischer-Grunski; Eva K,15,0,20,5
1745820733287,LIGM 5B,A00,896260,Fischer-Grunski; Eva K,17,0,20,3
1745820734316,LIGM 5C,A00,896308,Fischer-Grunski; Eva K,18,0,20,2
1745820735346,LIIT 5AS,A00,896313,Carnelos; Chiara,17,0,20,3
1745820736372,LIIT 5BS,A00,896416,Carnelos; Chiara,20,0,20,0
1745820737402,LIIT 5CS,A00,896564,Carnelos; Chiara,20,0,20,0
1745820738431,LISP 5A,A00,896588,Munoz Sanchez; Alicia,4,0,20,16
1745820739455,LISP 5B,A00,896653,Munoz Sanchez; Alicia,10,0,20,10
1745820740484,LISP 5C,A00,896655,Munoz Sanchez; Alicia,4,0,20,16
1745820741511,MAE 197,001,957918,Kleissl; Jan,9998,0,9999,1
1745820742538,MATH 2,A01,957937,Staff,34,0,35,1
1745820743563,MATH 197,001,957876,Kedlaya; Kiran S.,9993,0,9999,6
1745820744591,MCWP 40,A00,892729,Duru; Nur,13,0,20,7
1745820744591,MCWP 40,B00,893304,Montejo; Carolina,20,0,20,0
1745820745619,MCWP 40R,A00,893757,Redela; Pamela Morgan,0,7,20,20
1745820746647,MCWP 50,A00,893758,Morshed; Michael James,2,0,20,18
1745820746647,MCWP 50,B00,893761,Bartulis; Jason Michael,18,0,20,2
1745820747673,MCWP 50R,A00,893766,Compas; Sean Matthew,0,1,20,20
1745820747673,MCWP 50R,B00,893769,Carter; Jennifer A,0,0,20,20
1745820747673,MCWP 50R,C00,893771,Krone; Jarret,0,3,20,20
1745820747673,MCWP 50R,D00,893772,Miller; Elizabeth Deen,3,0,20,17
1745820747673,MCWP 50R,E00,893775,Carter; Andrea L,0,0,20,20
1745820748696,MMW 11R,A01,892721,Herbst; Matthew,11,0,27,16
1745820748696,MMW 11R,A02,892722,Herbst; Matthew,0,0,0,3
1745820749724,MMW 12R,A01,892724,Herbst; Matthew,0,10,16,16
1745820749724,MMW 12R,A02,892725,Herbst; Matthew,0,9,16,16
1745820750749,MMW 13R,A01,892727,Staff,0,3,16,16
1745820750749,MMW 13R,A02,892728,Staff,0,4,16,16
1745820750749,MMW 13R,A03,958032,Staff,0,3,16,16
1745820750749,MMW 13R,A04,958033,Staff,0,2,16,16
1745820750749,MMW 13R,A05,958034,Staff,0,3,16,16
1745820751775,SIO 295LS,A00,894015,Staff,7,0,25,18
1745820752801,SIO 295S,A00,894020,Staff,7,0,25,18
1745820753831,SIOC 290S,B01,958918,Staff,0,0,0,0
1745820754858,SIOC 291S,B01,958922,Staff,0,0,0,0
1745820755884,SOCI 117,A01,895339,Staff,4,0,5,1
1745820756908,WES 237B,A00,894149,Staff,11,0,20,9
1745820758967,AESE 279B,A00,891859,Staff,13,0,35,22
1745820759995,AIP 197,001,891854,Staff,70,0,70,0
1745820761023,ANTH 289S,A00,891856,Gagneux; Pascal,12,0,12,0
1745820762048,BENG 196,001,957946,Engler; Adam J.,9996,0,9999,3
1745820763116,CAT 124RS,A01,956906,Staff,8,0,25,17
1745820764145,CAT 125RS,A01,922013,Staff,8,0,25,17
1745820765170,CLRE 250,A00,891860,Morris; Sheldon,9995,0,9999,4
1745820767228,CLRE 251R,A00,907817,Mehta; Ravindra L.,9994,0,9999,5
1745820768256,CLRE 252,A00,891864,Cuomo; Raphael Eduardo,9993,0,9999,6
1745820769283,CLRE 253,A00,891867,Vaida; Florin,9994,0,9999,5
1745820769283,CLRE 253,B00,907819,Staff,9999,0,9999,0
1745820770309,CLRE 259,A00,891868,Patel; Hemal,9998,0,9999,1
1745820771335,CLRE 260,A00,891872,Cuomo; Raphael Eduardo,9999,0,9999,0
1745820772363,CLRE 297,001,891888,Cuomo; Raphael Eduardo,9999,0,9999,0
1745820773388,CSE 191,A00,958773,Minnes Kemp; Mor Mia,9999,0,9999,0
1745820774415,CSS 201S,A01,892054,Mignozzetti; Umberto,30,0,30,0
1745820775444,CSS 202S,A01,892056,Mignozzetti; Umberto,30,0,30,0
1745820776472,DSC 197,001,956898,Eldridge; Justin Matthew,9998,0,9999,1
1745820777502,DSC 297,001,958000,Mazumdar; Arya,9998,0,9999,1
1745820778525,EAP 100,A00,905686,Staff,9776,0,9999,223
1745820779550,ECE 45,A01,892618,Staff,0,12,50,50
1745820780578,ECE 109,A01,892620,Staff,0,43,0,0
1745820781606,ECE 111,A01,892719,Staff,0,9,50,50
1745820782635,ECE 197,001,957920,Mercier; Patrick Philip,9992,0,9999,7
1745820783660,ECON 178,A01,907814,Zhu; Ying,28,0,35,7
1745820784688,EDS 115,A00,895312,Staff,41,0,45,4
1745820785714,EDS 117,A01,895337,Staff,30,0,30,0
1745820786741,EDS 125,A00,895341,Jones; Gabrielle Anastasia,43,0,45,2
1745820787766,EDS 128A,A01,895459,Fargason; Sharon Gayle,44,0,45,1
1745820788795,EDS 128B,A01,895543,Pappas; Elizabeth,44,0,45,1
1745820789822,EDS 139,A00,897203,Pappas; Elizabeth,44,0,45,1
1745820789822,EDS 139,B00,897209,Fargason; Sharon Gayle,44,0,45,1
1745820790848,EDS 201,A00,895545,Staff,43,0,45,2
1745820791876,EDS 203,A01,895581,Halter; Christopher P.,43,0,45,2
1745820792902,EDS 204R,A01,895625,Heinzman; Erica M.,43,0,45,2
1745820792902,EDS 204R,B01,895693,Halter; Christopher P.,18,0,45,27
1745820793930,EDS 206R,A00,895694,Fargason; Sharon Gayle,9,0,30,21
1745820793930,EDS 206R,B00,895695,Choi; Bailey Miyeon,20,0,30,10
1745820794965,EDS 250,A00,895697,Hemans; Patricia Ann Benitez,43,0,45,2
1745820795993,EDS 281,A00,895701,Meyerott; Theresa Ann,15,0,15,0
1745820797018,EDS 284,A00,895736,Meyerott; Theresa Ann,15,0,15,0
1745820798047,EDS 286,A00,897210,Fine; Sarah,15,0,15,0
1745820799071,EDS 289C,A01,895770,Daly; Alan J.,15,0,15,0
1745820800098,EDS 290,A00,897211,Hofstetter; Carolyn,15,0,15,0
1745820801124,LIGM 5A,A00,896162,Fischer-Grunski; Eva K,15,0,20,5
1745820802150,LIGM 5B,A00,896260,Fischer-Grunski; Eva K,17,0,20,3
1745820803179,LIGM 5C,A00,896308,Fischer-Grunski; Eva K,18,0,20,2
1745820804206,LIIT 5AS,A00,896313,Carnelos; Chiara,17,0,20,3
1745820805234,LIIT 5BS,A00,896416,Carnelos; Chiara,20,0,20,0
1745820806260,LIIT 5CS,A00,896564,Carnelos; Chiara,20,0,20,0
1745820807293,LISP 5A,A00,896588,Munoz Sanchez; Alicia,4,0,20,16
1745820808322,LISP 5B,A00,896653,Munoz Sanchez; Alicia,10,0,20,10
1745820809350,LISP 5C,A00,896655,Munoz Sanchez; Alicia,4,0,20,16
1745820810375,MAE 197,001,957918,Kleissl; Jan,9998,0,9999,1
1745820811430,MATH 2,A01,957937,Staff,34,0,35,1
1745820812459,MATH 197,001,957876,Kedlaya; Kiran S.,9993,0,9999,6
1745820813486,MCWP 40,A00,892729,Duru; Nur,13,0,20,7
1745820813486,MCWP 40,B00,893304,Montejo; Carolina,20,0,20,0
1745820814513,MCWP 40R,A00,893757,Redela; Pamela Morgan,0,7,20,20
1745820815539,MCWP 50,A00,893758,Morshed; Michael James,2,0,20,18
1745820815539,MCWP 50,B00,893761,Bartulis; Jason Michael,18,0,20,2
1745820816569,MCWP 50R,A00,893766,Compas; Sean Matthew,0,1,20,20
1745820816569,MCWP 50R,B00,893769,Carter; Jennifer A,0,0,20,20
1745820816569,MCWP 50R,C00,893771,Krone; Jarret,0,3,20,20
1745820816569,MCWP 50R,D00,893772,Miller; Elizabeth Deen,3,0,20,17
1745820816569,MCWP 50R,E00,893775,Carter; Andrea L,0,0,20,20
1745820817595,MMW 11R,A01,892721,Herbst; Matthew,11,0,27,16
1745820817595,MMW 11R,A02,892722,Herbst; Matthew,0,0,0,3
1745820818622,MMW 12R,A01,892724,Herbst; Matthew,0,10,16,16
1745820818622,MMW 12R,A02,892725,Herbst; Matthew,0,9,16,16
1745820819646,MMW 13R,A01,892727,Staff,0,3,16,16
1745820819646,MMW 13R,A02,892728,Staff,0,4,16,16
1745820819646,MMW 13R,A03,958032,Staff,0,3,16,16
1745820819646,MMW 13R,A04,958033,Staff,0,2,16,16
1745820819646,MMW 13R,A05,958034,Staff,0,3,16,16
1745820820670,SIO 295LS,A00,894015,Staff,7,0,25,18
1745820821696,SIO 295S,A00,894020,Staff,7,0,25,18
1745820822727,SIOC 290S,B01,958918,Staff,0,0,0,0
1745820823753,SIOC 291S,B01,958922,Staff,0,0,0,0
1745820824777,SOCI 117,A01,895339,Staff,4,0,5,1
1745820825805,WES 237B,A00,894149,Staff,11,0,20,9
1745820827870,AESE 279B,A00,891859,Staff,13,0,35,22
1745820828896,AIP 197,001,891854,Staff,70,0,70,0
1745820829924,ANTH 289S,A00,891856,Gagneux; Pascal,12,0,12,0
1745820830950,BENG 196,001,957946,Engler; Adam J.,9996,0,9999,3
1745820831975,CAT 124RS,A01,956906,Staff,8,0,25,17
1745820833003,CAT 125RS,A01,922013,Staff,8,0,25,17
1745820834033,CLRE 250,A00,891860,Morris; Sheldon,9995,0,9999,4
1745820836086,CLRE 251R,A00,907817,Mehta; Ravindra L.,9994,0,9999,5
1745820837113,CLRE 252,A00,891864,Cuomo; Raphael Eduardo,9993,0,9999,6
1745820838140,CLRE 253,A00,891867,Vaida; Florin,9994,0,9999,5
1745820838140,CLRE 253,B00,907819,Staff,9999,0,9999,0
1745820839167,CLRE 259,A00,891868,Patel; Hemal,9998,0,9999,1
1745820840197,CLRE 260,A00,891872,Cuomo; Raphael Eduardo,9999,0,9999,0
1745820841225,CLRE 297,001,891888,Cuomo; Raphael Eduardo,9999,0,9999,0
1745820842251,CSE 191,A00,958773,Minnes Kemp; Mor Mia,9999,0,9999,0
1745820843278,CSS 201S,A01,892054,Mignozzetti; Umberto,30,0,30,0
1745820844308,CSS 202S,A01,892056,Mignozzetti; Umberto,30,0,30,0
1745820845336,DSC 197,001,956898,Eldridge; Justin Matthew,9998,0,9999,1
1745820846362,DSC 297,001,958000,Mazumdar; Arya,9998,0,9999,1
1745820847388,EAP 100,A00,905686,Staff,9776,0,9999,223
1745820848417,ECE 45,A01,892618,Staff,0,12,50,50
1745820849442,ECE 109,A01,892620,Staff,0,43,0,0
1745820850467,ECE 111,A01,892719,Staff,0,9,50,50
1745820851492,ECE 197,001,957920,Mercier; Patrick Philip,9992,0,9999,7
1745820852521,ECON 178,A01,907814,Zhu; Ying,28,0,35,7
1745820853545,EDS 115,A00,895312,Staff,41,0,45,4
1745820854572,EDS 117,A01,895337,Staff,30,0,30,0
1745820855600,EDS 125,A00,895341,Jones; Gabrielle Anastasia,43,0,45,2
1745820856627,EDS 128A,A01,895459,Fargason; Sharon Gayle,44,0,45,1
1745820857654,EDS 128B,A01,895543,Pappas; Elizabeth,44,0,45,1
1745820858684,EDS 139,A00,897203,Pappas; Elizabeth,44,0,45,1
1745820858684,EDS 139,B00,897209,Fargason; Sharon Gayle,44,0,45,1
1745820859711,EDS 201,A00,895545,Staff,43,0,45,2
1745820860738,EDS 203,A01,895581,Halter; Christopher P.,43,0,45,2
1745820861768,EDS 204R,A01,895625,Heinzman; Erica M.,43,0,45,2
1745820861768,EDS 204R,B01,895693,Halter; Christopher P.,18,0,45,27
1745820862793,EDS 206R,A00,895694,Fargason; Sharon Gayle,9,0,30,21
1745820862793,EDS 206R,B00,895695,Choi; Bailey Miyeon,20,0,30,10
1745820863822,EDS 250,A00,895697,Hemans; Patricia Ann Benitez,43,0,45,2
1745820864849,EDS 281,A00,895701,Meyerott; Theresa Ann,15,0,15,0
1745820865875,EDS 284,A00,895736,Meyerott; Theresa Ann,15,0,15,0
1745820866903,EDS 286,A00,897210,Fine; Sarah,15,0,15,0
1745820867984,EDS 289C,A01,895770,Daly; Alan J.,15,0,15,0
1745820869012,EDS 290,A00,897211,Hofstetter; Carolyn,15,0,15,0
1745820870047,LIGM 5A,A00,896162,Fischer-Grunski; Eva K,15,0,20,5
1745820871077,LIGM 5B,A00,896260,Fischer-Grunski; Eva K,17,0,20,3
1745820872107,LIGM 5C,A00,896308,Fischer-Grunski; Eva K,18,0,20,2
1745820873138,LIIT 5AS,A00,896313,Carnelos; Chiara,17,0,20,3
1745820874167,LIIT 5BS,A00,896416,Carnelos; Chiara,20,0,20,0
1745820875193,LIIT 5CS,A00,896564,Carnelos; Chiara,20,0,20,0
1745820876219,LISP 5A,A00,896588,Munoz Sanchez; Alicia,4,0,20,16
1745820877245,LISP 5B,A00,896653,Munoz Sanchez; Alicia,10,0,20,10
1745820878270,LISP 5C,A00,896655,Munoz Sanchez; Alicia,4,0,20,16
1745820879302,MAE 197,001,957918,Kleissl; Jan,9998,0,9999,1
1745820880327,MATH 2,A01,957937,Staff,34,0,35,1
1745820881352,MATH 197,001,957876,Kedlaya; Kiran S.,9993,0,9999,6
1745820882402,MCWP 40,A00,892729,Duru; Nur,13,0,20,7
1745820882402,MCWP 40,B00,893304,Montejo; Carolina,20,0,20,0
1745820883428,MCWP 40R,A00,893757,Redela; Pamela Morgan,0,7,20,20
1745820884461,MCWP 50,A00,893758,Morshed; Michael James,2,0,20,18
1745820884461,MCWP 50,B00,893761,Bartulis; Jason Michael,18,0,20,2
1745820885489,MCWP 50R,A00,893766,Compas; Sean Matthew,0,1,20,20
1745820885489,MCWP 50R,B00,893769,Carter; Jennifer A,0,0,20,20
1745820885489,MCWP 50R,C00,893771,Krone; Jarret,0,3,20,20
1745820885489,MCWP 50R,D00,893772,Miller; Elizabeth Deen,3,0,20,17
1745820885489,MCWP 50R,E00,893775,Carter; Andrea L,0,0,20,20
1745820886516,MMW 11R,A01,892721,Herbst; Matthew,11,0,27,16
1745820886516,MMW 11R,A02,892722,Herbst; Matthew,0,0,0,3
1745820887544,MMW 12R,A01,892724,Herbst; Matthew,0,10,16,16
1745820887544,MMW 12R,A02,892725,Herbst; Matthew,0,9,16,16
1745820888570,MMW 13R,A01,892727,Staff,0,3,16,16
1745820888570,MMW 13R,A02,892728,Staff,0,4,16,16
1745820888570,MMW 13R,A03,958032,Staff,0,3,16,16
1745820888570,MMW 13R,A04,958033,Staff,0,2,16,16
1745820888570,MMW 13R,A05,958034,Staff,0,3,16,16
1745820889596,SIO 295LS,A00,894015,Staff,7,0,25,18
1745820890620,SIO 295S,A00,894020,Staff,7,0,25,18
1745820891657,SIOC 290S,B01,958918,Staff,0,0,0,0
1745820892685,SIOC 291S,B01,958922,Staff,0,0,0,0
1745820893714,SOCI 117,A01,895339,Staff,4,0,5,1
1745820894746,WES 237B,A00,894149,Staff,11,0,20,9
1745820896823,AESE 279B,A00,891859,Staff,13,0,35,22
1745820897851,AIP 197,001,891854,Staff,70,0,70,0
1745820898886,ANTH 289S,A00,891856,Gagneux; Pascal,12,0,12,0
1745820899914,BENG 196,001,957946,Engler; Adam J.,9996,0,9999,3
1745820900947,CAT 124RS,A01,956906,Staff,8,0,25,17
1745820901970,CAT 125RS,A01,922013,Staff,8,0,25,17
1745820902997,CLRE 250,A00,891860,Morris; Sheldon,9995,0,9999,4
1745820905058,CLRE 251R,A00,907817,Mehta; Ravindra L.,9994,0,9999,5
1745820906121,CLRE 252,A00,891864,Cuomo; Raphael Eduardo,9993,0,9999,6
1745820907152,CLRE 253,A00,891867,Vaida; Florin,9994,0,9999,5
1745820907152,CLRE 253,B00,907819,Staff,9999,0,9999,0
1745820908180,CLRE 259,A00,891868,Patel; Hemal,9998,0,9999,1
1745820909205,CLRE 260,A00,891872,Cuomo; Raphael Eduardo,9999,0,9999,0
1745820910230,CLRE 297,001,891888,Cuomo; Raphael Eduardo,9999,0,9999,0
1745820911260,CSE 191,A00,958773,Minnes Kemp; Mor Mia,9999,0,9999,0
1745820912288,CSS 201S,A01,892054,Mignozzetti; Umberto,30,0,30,0
1745820913313,CSS 202S,A01,892056,Mignozzetti; Umberto,30,0,30,0
1745820914340,DSC 197,001,956898,Eldridge; Justin Matthew,9998,0,9999,1
1745820915367,DSC 297,001,958000,Mazumdar; Arya,9998,0,9999,1
1745820916396,EAP 100,A00,905686,Staff,9776,0,9999,223
1745820917427,ECE 45,A01,892618,Staff,0,12,50,50
1745820918456,ECE 109,A01,892620,Staff,0,43,0,0
1745820919488,ECE 111,A01,892719,Staff,0,9,50,50
1745820920516,ECE 197,001,957920,Mercier; Patrick Philip,9992,0,9999,7
1745820921552,ECON 178,A01,907814,Zhu; Ying,28,0,35,7
1745820922576,EDS 115,A00,895312,Staff,41,0,45,4
1745820923610,EDS 117,A01,895337,Staff,30,0,30,0
1745820924637,EDS 125,A00,895341,Jones; Gabrielle Anastasia,43,0,45,2
1745820925664,EDS 128A,A01,895459,Fargason; Sharon Gayle,44,0,45,1
1745820926690,EDS 128B,A01,895543,Pappas; Elizabeth,44,0,45,1
1745820927716,EDS 139,A00,897203,Pappas; Elizabeth,44,0,45,1
1745820927716,EDS 139,B00,897209,Fargason; Sharon Gayle,44,0,45,1
1745820928743,EDS 201,A00,895545,Staff,43,0,45,2
1745820929866,EDS 203,A01,895581,Halter; Christopher P.,43,0,45,2
1745820930891,EDS 204R,A01,895625,Heinzman; Erica M.,43,0,45,2
1745820930891,EDS 204R,B01,895693,Halter; Christopher P.,18,0,45,27
1745820931921,EDS 206R,A00,895694,Fargason; Sharon Gayle,9,0,30,21
1745820931921,EDS 206R,B00,895695,Choi; Bailey Miyeon,20,0,30,10
1745820932949,EDS 250,A00,895697,Hemans; Patricia Ann Benitez,43,0,45,2
1745820933974,EDS 281,A00,895701,Meyerott; Theresa Ann,15,0,15,0
1745820935003,EDS 284,A00,895736,Meyerott; Theresa Ann,15,0,15,0
1745820936028,EDS 286,A00,897210,Fine; Sarah,15,0,15,0
1745820937055,EDS 289C,A01,895770,Daly; Alan J.,15,0,15,0
1745820938087,EDS 290,A00,897211,Hofstetter; Carolyn,15,0,15,0
1745820939113,LIGM 5A,A00,896162,Fischer-Grunski; Eva K,15,0,20,5
1745820940140,LIGM 5B,A00,896260,Fischer-Grunski; Eva K,17,0,20,3
1745820941168,LIGM 5C,A00,896308,Fischer-Grunski; Eva K,18,0,20,2
1745820942195,LIIT 5AS,A00,896313,Carnelos; Chiara,17,0,20,3
1745820943221,LIIT 5BS,A00,896416,Carnelos; Chiara,20,0,20,0
1745820944261,LIIT 5CS,A00,896564,Carnelos; Chiara,20,0,20,0
1745820945288,LISP 5A,A00,896588,Munoz Sanchez; Alicia,4,0,20,16
1745820946313,LISP 5B,A00,896653,Munoz Sanchez; Alicia,10,0,20,10
1745820947339,LISP 5C,A00,896655,Munoz Sanchez; Alicia,4,0,20,16
1745820948365,MAE 197,001,957918,Kleissl; Jan,9998,0,9999,1
1745820949393,MATH 2,A01,957937,Staff,34,0,35,1
1745820950418,MATH 197,001,957876,Kedlaya; Kiran S.,9993,0,9999,6
1745820951443,MCWP 40,A00,892729,Duru; Nur,13,0,20,7
1745820951443,MCWP 40,B00,893304,Montejo; Carolina,20,0,20,0
1745820952471,MCWP 40R,A00,893757,Redela; Pamela Morgan,0,7,20,20
1745820953497,MCWP 50,A00,893758,Morshed; Michael James,2,0,20,18
1745820953497,MCWP 50,B00,893761,Bartulis; Jason Michael,18,0,20,2
1745820954529,MCWP 50R,A00,893766,Compas; Sean Matthew,0,1,20,20
1745820954529,MCWP 50R,B00,893769,Carter; Jennifer A,0,0,20,20
1745820954529,MCWP 50R,C00,893771,Krone; Jarret,0,3,20,20
1745820954529,MCWP 50R,D00,893772,Miller; Elizabeth Deen,3,0,20,17
1745820954529,MCWP 50R,E00,893775,Carter; Andrea L,0,0,20,20
1745820955554,MMW 11R,A01,892721,Herbst; Matthew,11,0,27,16
1745820955554,MMW 11R,A02,892722,Herbst; Matthew,0,0,0,3
1745820956586,MMW 12R,A01,892724,Herbst; Matthew,0,10,16,16
1745820956586,MMW 12R,A02,892725,Herbst; Matthew,0,9,16,16
1745820957612,MMW 13R,A01,892727,Staff,0,3,16,16
1745820957612,MMW 13R,A02,892728,Staff,0,4,16,16
1745820957612,MMW 13R,A03,958032,Staff,0,3,16,16
1745820957612,MMW 13R,A04,958033,Staff,0,2,16,16
1745820957612,MMW 13R,A05,958034,Staff,0,3,16,16
1745820958635,SIO 295LS,A00,894015,Staff,7,0,25,18
1745820959675,SIO 295S,A00,894020,Staff,7,0,25,18
1745820960706,SIOC 290S,B01,958918,Staff,0,0,0,0
1745820961734,SIOC 291S,B01,958922,Staff,0,0,0,0
1745820962783,SOCI 117,A01,895339,Staff,4,0,5,1
1745820963810,WES 237B,A00,894149,Staff,11,0,20,9
1745820965868,AESE 279B,A00,891859,Staff,13,0,35,22
1745820966895,AIP 197,001,891854,Staff,70,0,70,0
1745820967924,ANTH 289S,A00,891856,Gagneux; Pascal,12,0,12,0
1745820968948,BENG 196,001,957946,Engler; Adam J.,9996,0,9999,3
1745820969974,CAT 124RS,A01,956906,Staff,8,0,25,17
1745820971000,CAT 125RS,A01,922013,Staff,8,0,25,17
1745820972026,CLRE 250,A00,891860,Morris; Sheldon,9995,0,9999,4
1745820974080,CLRE 251R,A00,907817,Mehta; Ravindra L.,9994,0,9999,5
1745820975112,CLRE 252,A00,891864,Cuomo; Raphael Eduardo,9993,0,9999,6
1745820976143,CLRE 253,A00,891867,Vaida; Florin,9994,0,9999,5
1745820976143,CLRE 253,B00,907819,Staff,9999,0,9999,0
1745820977175,CLRE 259,A00,891868,Patel; Hemal,9998,0,9999,1
1745820978207,CLRE 260,A00,891872,Cuomo; Raphael Eduardo,9999,0,9999,0
1745820979236,CLRE 297,001,891888,Cuomo; Raphael Eduardo,9999,0,9999,0
1745820980265,CSE 191,A00,958773,Minnes Kemp; Mor Mia,9999,0,9999,0
1745820981296,CSS 201S,A01,892054,Mignozzetti; Umberto,30,0,30,0
1745820982322,CSS 202S,A01,892056,Mignozzetti; Umberto,30,0,30,0
1745820983346,DSC 197,001,956898,Eldridge; Justin Matthew,9998,0,9999,1
1745820984376,DSC 297,001,958000,Mazumdar; Arya,9998,0,9999,1
1745820985403,EAP 100,A00,905686,Staff,9776,0,9999,223
1745820986429,ECE 45,A01,892618,Staff,0,12,50,50
1745820987458,ECE 109,A01,892620,Staff,0,43,0,0
1745820988487,ECE 111,A01,892719,Staff,0,9,50,50
1745820989512,ECE 197,001,957920,Mercier; Patrick Philip,9992,0,9999,7
1745820990537,ECON 178,A01,907814,Zhu; Ying,28,0,35,7
1745820991565,EDS 115,A00,895312,Staff,41,0,45,4
1745820992590,EDS 117,A01,895337,Staff,30,0,30,0
1745820993682,EDS 125,A00,895341,Jones; Gabrielle Anastasia,43,0,45,2
1745820994707,EDS 128A,A01,895459,Fargason; Sharon Gayle,44,0,45,1
1745820995734,EDS 128B,A01,895543,Pappas; Elizabeth,44,0,45,1
1745820996758,EDS 139,A00,897203,Pappas; Elizabeth,44,0,45,1
1745820996758,EDS 139,B00,897209,Fargason; Sharon Gayle,44,0,45,1
1745820997788,EDS 201,A00,895545,Staff,43,0,45,2
1745820998813,EDS 203,A01,895581,Halter; Christopher P.,43,0,45,2
1745820999839,EDS 204R,A01,895625,Heinzman; Erica M.,43,0,45,2
1745820999839,EDS 204R,B01,895693,Halter; Christopher P.,18,0,45,27
1745821000869,EDS 206R,A00,895694,Fargason; Sharon Gayle,9,0,30,21
1745821000869,EDS 206R,B00,895695,Choi; Bailey Miyeon,20,0,30,10
1745821001896,EDS 250,A00,895697,Hemans; Patricia Ann Benitez,43,0,45,2
1745821002921,EDS 281,A00,895701,Meyerott; Theresa Ann,15,0,15,0
1745821003949,EDS 284,A00,895736,Meyerott; Theresa Ann,15,0,15,0
1745821005104,EDS 286,A00,897210,Fine; Sarah,15,0,15,0
1745821006130,EDS 289C,A01,895770,Daly; Alan J.,15,0,15,0
1745821007157,EDS 290,A00,897211,Hofstetter; Carolyn,15,0,15,0
1745821008300,LIGM 5A,A00,896162,Fischer-Grunski; Eva K,15,0,20,5
1745821009330,LIGM 5B,A00,896260,Fischer-Grunski; Eva K,17,0,20,3
1745821010357,LIGM 5C,A00,896308,Fischer-Grunski; Eva K,18,0,20,2
1745821011402,LIIT 5AS,A00,896313,Carnelos; Chiara,17,0,20,3
1745821012429,LIIT 5BS,A00,896416,Carnelos; Chiara,20,0,20,0
1745821013459,LIIT 5CS,A00,896564,Carnelos; Chiara,20,0,20,0
1745821014485,LISP 5A,A00,896588,Munoz Sanchez; Alicia,4,0,20,16
1745821015511,LISP 5B,A00,896653,Munoz Sanchez; Alicia,10,0,20,10
1745821016539,LISP 5C,A00,896655,Munoz Sanchez; Alicia,4,0,20,16
1745821017567,MAE 197,001,957918,Kleissl; Jan,9998,0,9999,1
1745821018595,MATH 2,A01,957937,Staff,34,0,35,1
1745821019620,MATH 197,001,957876,Kedlaya; Kiran S.,9993,0,9999,6
1745821020650,MCWP 40,A00,892729,Duru; Nur,13,0,20,7
1745821020650,MCWP 40,B00,893304,Montejo; Carolina,20,0,20,0
1745821021676,MCWP 40R,A00,893757,Redela; Pamela Morgan,0,7,20,20
1745821022701,MCWP 50,A00,893758,Morshed; Michael James,2,0,20,18
1745821022701,MCWP 50,B00,893761,Bartulis; Jason Michael,18,0,20,2
1745821023735,MCWP 50R,A00,893766,Compas; Sean Matthew,0,1,20,20
1745821023735,MCWP 50R,B00,893769,Carter; Jennifer A,0,0,20,20
1745821023735,MCWP 50R,C00,893771,Krone; Jarret,0,3,20,20
1745821023735,MCWP 50R,D00,893772,Miller; Elizabeth Deen,3,0,20,17
1745821023735,MCWP 50R,E00,893775,Carter; Andrea L,0,0,20,20
1745821024779,MMW 11R,A01,892721,Herbst; Matthew,11,0,27,16
1745821024779,MMW 11R,A02,892722,Herbst; Matthew,0,0,0,3
1745821025809,MMW 12R,A01,892724,Herbst; Matthew,0,10,16,16
1745821025809,MMW 12R,A02,892725,Herbst; Matthew,0,9,16,16
1745821026838,MMW 13R,A01,892727,Staff,0,3,16,16
1745821026838,MMW 13R,A02,892728,Staff,0,4,16,16
1745821026838,MMW 13R,A03,958032,Staff,0,3,16,16
1745821026838,MMW 13R,A04,958033,Staff,0,2,16,16
1745821026838,MMW 13R,A05,958034,Staff,0,3,16,16
1745821027869,SIO 295LS,A00,894015,Staff,7,0,25,18
1745821028894,SIO 295S,A00,894020,Staff,7,0,25,18
1745821029928,SIOC 290S,B01,958918,Staff,0,0,0,0
1745821030956,SIOC 291S,B01,958922,Staff,0,0,0,0
1745821031982,SOCI 117,A01,895339,Staff,4,0,5,1
1745821033009,WES 237B,A00,894149,Staff,11,0,20,9
1745821035077,AESE 279B,A00,891859,Staff,13,0,35,22
1745821036111,AIP 197,001,891854,Staff,70,0,70,0
1745821037143,ANTH 289S,A00,891856,Gagneux; Pascal,12,0,12,0
1745821038178,BENG 196,001,957946,Engler; Adam J.,9996,0,9999,3
1745821039206,CAT 124RS,A01,956906,Staff,8,0,25,17
1745821040235,CAT 125RS,A01,922013,Staff,8,0,25,17
1745821041263,CLRE 250,A00,891860,Morris; Sheldon,9995,0,9999,4
1745821043316,CLRE 251R,A00,907817,Mehta; Ravindra L.,9994,0,9999,5
1745821044342,CLRE 252,A00,891864,Cuomo; Raphael Eduardo,9993,0,9999,6
1745821045371,CLRE 253,A00,891867,Vaida; Florin,9994,0,9999,5
1745821045371,CLRE 253,B00,907819,Staff,9999,0,9999,0
1745821046399,CLRE 259,A00,891868,Patel; Hemal,9998,0,9999,1
1745821047426,CLRE 260,A00,891872,Cuomo; Raphael Eduardo,9999,0,9999,0
1745821048449,CLRE 297,001,891888,Cuomo; Raphael Eduardo,9999,0,9999,0
1745821049478,CSE 191,A00,958773,Minnes Kemp; Mor Mia,9999,0,9999,0
1745821050504,CSS 201S,A01,892054,Mignozzetti; Umberto,30,0,30,0
1745821051539,CSS 202S,A01,892056,Mignozzetti; Umberto,30,0,30,0
1745821052563,DSC 197,001,956898,Eldridge; Justin Matthew,9998,0,9999,1
1745821053592,DSC 297,001,958000,Mazumdar; Arya,9998,0,9999,1
1745821054625,EAP 100,A00,905686,Staff,9776,0,9999,223
1745821055657,ECE 45,A01,892618,Staff,0,12,50,50
1745821056702,ECE 109,A01,892620,Staff,0,43,0,0
1745821057727,ECE 111,A01,892719,Staff,0,9,50,50
1745821058751,ECE 197,001,957920,Mercier; Patrick Philip,9992,0,9999,7
1745821059776,ECON 178,A01,907814,Zhu; Ying,28,0,35,7
1745821060805,EDS 115,A00,895312,Staff,41,0,45,4
1745821061832,EDS 117,A01,895337,Staff,30,0,30,0
1745821062861,EDS 125,A00,895341,Jones; Gabrielle Anastasia,43,0,45,2
1745821063890,EDS 128A,A01,895459,Fargason; Sharon Gayle,44,0,45,1
1745821064916,EDS 128B,A01,895543,Pappas; Elizabeth,44,0,45,1
1745821065943,EDS 139,A00,897203,Pappas; Elizabeth,44,0,45,1
1745821065943,EDS 139,B00,897209,Fargason; Sharon Gayle,44,0,45,1
1745821066967,EDS 201,A00,895545,Staff,43,0,45,2
1745821067993,EDS 203,A01,895581,Halter; Christopher P.,43,0,45,2
1745821069019,EDS 204R,A01,895625,Heinzman; Erica M.,43,0,45,2
1745821069019,EDS 204R,B01,895693,Halter; Christopher P.,18,0,45,27
1745821070051,EDS 206R,A00,895694,Fargason; Sharon Gayle,9,0,30,21
1745821070051,EDS 206R,B00,895695,Choi; Bailey Miyeon,20,0,30,10
1745821071079,EDS 250,A00,895697,Hemans; Patricia Ann Benitez,43,0,45,2
1745821072108,EDS 281,A00,895701,Meyerott; Theresa Ann,15,0,15,0
1745821073150,EDS 284,A00,895736,Meyerott; Theresa Ann,15,0,15,0
1745821074180,EDS 286,A00,897210,Fine; Sarah,15,0,15,0
1745821075210,EDS 289C,A01,895770,Daly; Alan J.,15,0,15,0
1745821076239,EDS 290,A00,897211,Hofstetter; Carolyn,15,0,15,0
1745821077279,LIGM 5A,A00,896162,Fischer-Grunski; Eva K,15,0,20,5
1745821078308,LIGM 5B,A00,896260,Fischer-Grunski; Eva K,17,0,20,3
1745821079369,LIGM 5C,A00,896308,Fischer-Grunski; Eva K,18,0,20,2
1745821080397,LIIT 5AS,A00,896313,Carnelos; Chiara,17,0,20,3
1745821081428,LIIT 5BS,A00,896416,Carnelos; Chiara,20,0,20,0
1745821082472,LIIT 5CS,A00,896564,Carnelos; Chiara,20,0,20,0
1745821083506,LISP 5A,A00,896588,Munoz Sanchez; Alicia,4,0,20,16
1745821084533,LISP 5B,A00,896653,Munoz Sanchez; Alicia,10,0,20,10
1745821085562,LISP 5C,A00,896655,Munoz Sanchez; Alicia,4,0,20,16
1745821086597,MAE 197,001,957918,Kleissl; Jan,9998,0,9999,1
1745821087626,MATH 2,A01,957937,Staff,34,0,35,1
1745821088653,MATH 197,001,957876,Kedlaya; Kiran S.,9993,0,9999,6
1745821089679,MCWP 40,A00,892729,Duru; Nur,13,0,20,7
1745821089679,MCWP 40,B00,893304,Montejo; Carolina,20,0,20,0
1745821090710,MCWP 40R,A00,893757,Redela; Pamela Morgan,0,7,20,20
1745821091735,MCWP 50,A00,893758,Morshed; Michael James,2,0,20,18
1745821091735,MCWP 50,B00,893761,Bartulis; Jason Michael,18,0,20,2
1745821092760,MCWP 50R,A00,893766,Compas; Sean Matthew,0,1,20,20
1745821092760,MCWP 50R,B00,893769,Carter; Jennifer A,0,0,20,20
1745821092760,MCWP 50R,C00,893771,Krone; Jarret,0,3,20,20
1745821092760,MCWP 50R,D00,893772,Miller; Elizabeth Deen,3,0,20,17
1745821092760,MCWP 50R,E00,893775,Carter; Andrea L,0,0,20,20
1745821093795,MMW 11R,A01,892721,Herbst; Matthew,11,0,27,16
1745821093795,MMW 11R,A02,892722,Herbst; Matthew,0,0,0,3
1745821094820,MMW 12R,A01,892724,Herbst; Matthew,0,10,16,16
1745821094820,MMW 12R,A02,892725,Herbst; Matthew,0,9,16,16
1745821095851,MMW 13R,A01,892727,Staff,0,3,16,16
1745821095851,MMW 13R,A02,892728,Staff,0,4,16,16
1745821095851,MMW 13R,A03,958032,Staff,0,3,16,16
1745821095851,MMW 13R,A04,958033,Staff,0,2,16,16
1745821095851,MMW 13R,A05,958034,Staff,0,3,16,16
1745821096876,SIO 295LS,A00,894015,Staff,7,0,25,18
1745821097902,SIO 295S,A00,894020,Staff,7,0,25,18
1745821098931,SIOC 290S,B01,958918,Staff,0,0,0,0
1745821099991,SIOC 291S,B01,958922,Staff,0,0,0,0
1745821101019,SOCI 117,A01,895339,Staff,4,0,5,1
1745821102044,WES 237B,A00,894149,Staff,11,0,20,9
1745821104103,AESE 279B,A00,891859,Staff,13,0,35,22
1745821105128,AIP 197,001,891854,Staff,70,0,70,0
1745821106152,ANTH 289S,A00,891856,Gagneux; Pascal,12,0,12,0
1745821107180,BENG 196,001,957946,Engler; Adam J.,9996,0,9999,3
1745821108214,CAT 124RS,A01,956906,Staff,8,0,25,17
1745821109239,CAT 125RS,A01,922013,Staff,8,0,25,17
1745821110263,CLRE 250,A00,891860,Morris; Sheldon,9995,0,9999,4
1745821112316,CLRE 251R,A00,907817,Mehta; Ravindra L.,9994,0,9999,5
1745821113346,CLRE 252,A00,891864,Cuomo; Raphael Eduardo,9993,0,9999,6
1745821114371,CLRE 253,A00,891867,Vaida; Florin,9994,0,9999,5
1745821114371,CLRE 253,B00,907819,Staff,9999,0,9999,0
1745821115409,CLRE 259,A00,891868,Patel; Hemal,9998,0,9999,1
1745821116437,CLRE 260,A00,891872,Cuomo; Raphael Eduardo,9999,0,9999,0
1745821117466,CLRE 297,001,891888,Cuomo; Raphael Eduardo,9999,0,9999,0
1745821118494,CSE 191,A00,958773,Minnes Kemp; Mor Mia,9999,0,9999,0
1745821119519,CSS 201S,A01,892054,Mignozzetti; Umberto,30,0,30,0
1745821120547,CSS 202S,A01,892056,Mignozzetti; Umberto,30,0,30,0
1745821121575,DSC 197,001,956898,Eldridge; Justin Matthew,9998,0,9999,1
1745821122646,DSC 297,001,958000,Mazumdar; Arya,9998,0,9999,1
1745821123673,EAP 100,A00,905686,Staff,9776,0,9999,223
1745821124698,ECE 45,A01,892618,Staff,0,12,50,50
1745821125724,ECE 109,A01,892620,Staff,0,43,0,0
1745821126754,ECE 111,A01,892719,Staff,0,9,50,50
1745821127801,ECE 197,001,957920,Mercier; Patrick Philip,9992,0,9999,7
1745821128829,ECON 178,A01,907814,Zhu; Ying,28,0,35,7
1745821129861,EDS 115,A00,895312,Staff,41,0,45,4
1745821130886,EDS 117,A01,895337,Staff,30,0,30,0
1745821131914,EDS 125,A00,895341,Jones; Gabrielle Anastasia,43,0,45,2
1745821132944,EDS 128A,A01,895459,Fargason; Sharon Gayle,44,0,45,1
1745821133970,EDS 128B,A01,895543,Pappas; Elizabeth,44,0,45,1
1745821134999,EDS 139,A00,897203,Pappas; Elizabeth,44,0,45,1
1745821134999,EDS 139,B00,897209,Fargason; Sharon Gayle,44,0,45,1
1745821136024,EDS 201,A00,895545,Staff,43,0,45,2
1745821137054,EDS 203,A01,895581,Halter; Christopher P.,43,0,45,2
1745821138081,EDS 204R,A01,895625,Heinzman; Erica M.,43,0,45,2
1745821138081,EDS 204R,B01,895693,Halter; Christopher P.,18,0,45,27
1745821139109,EDS 206R,A00,895694,Fargason; Sharon Gayle,9,0,30,21
1745821139109,EDS 206R,B00,895695,Choi; Bailey Miyeon,20,0,30,10
1745821140136,EDS 250,A00,895697,Hemans; Patricia Ann Benitez,43,0,45,2
1745821141164,EDS 281,A00,895701,Meyerott; Theresa Ann,15,0,15,0
1745821142192,EDS 284,A00,895736,Meyerott; Theresa Ann,15,0,15,0
1745821143248,EDS 286,A00,897210,Fine; Sarah,15,0,15,0
1745821144277,EDS 289C,A01,895770,Daly; Alan J.,15,0,15,0
1745821145304,EDS 290,A00,897211,Hofstetter; Carolyn,15,0,15,0
1745821146330,LIGM 5A,A00,896162,Fischer-Grunski; Eva K,15,0,20,5
1745821147356,LIGM 5B,A00,896260,Fischer-Grunski; Eva K,17,0,20,3
1745821148382,LIGM 5C,A00,896308,Fischer-Grunski; Eva K,18,0,20,2
1745821149409,LIIT 5AS,A00,896313,Carnelos; Chiara,17,0,20,3
1745821150445,LIIT 5BS,A00,896416,Carnelos; Chiara,20,0,20,0
1745821151475,LIIT 5CS,A00,896564,Carnelos; Chiara,20,0,20,0
1745821152505,LISP 5A,A00,896588,Munoz Sanchez; Alicia,4,0,20,16
1745821153530,LISP 5B,A00,896653,Munoz Sanchez; Alicia,10,0,20,10
1745821154557,LISP 5C,A00,896655,Munoz Sanchez; Alicia,4,0,20,16
1745821155585,MAE 197,001,957918,Kleissl; Jan,9998,0,9999,1
1745821156613,MATH 2,A01,957937,Staff,34,0,35,1
1745821157639,MATH 197,001,957876,Kedlaya; Kiran S.,9993,0,9999,6
1745821158666,MCWP 40,A00,892729,Duru; Nur,13,0,20,7
1745821158666,MCWP 40,B00,893304,Montejo; Carolina,20,0,20,0
1745821159694,MCWP 40R,A00,893757,Redela; Pamela Morgan,0,7,20,20
1745821160721,MCWP 50,A00,893758,Morshed; Michael James,2,0,20,18
1745821160721,MCWP 50,B00,893761,Bartulis; Jason Michael,18,0,20,2
1745821161747,MCWP 50R,A00,893766,Compas; Sean Matthew,0,1,20,20
1745821161747,MCWP 50R,B00,893769,Carter; Jennifer A,0,0,20,20
1745821161747,MCWP 50R,C00,893771,Krone; Jarret,0,3,20,20
1745821161747,MCWP 50R,D00,893772,Miller; Elizabeth Deen,3,0,20,17
1745821161747,MCWP 50R,E00,893775,Carter; Andrea L,0,0,20,20
1745821162776,MMW 11R,A01,892721,Herbst; Matthew,11,0,27,16
1745821162776,MMW 11R,A02,892722,Herbst; Matthew,0,0,0,3
1745821163805,MMW 12R,A01,892724,Herbst; Matthew,0,10,16,16
1745821163805,MMW 12R,A02,892725,Herbst; Matthew,0,9,16,16
1745821164850,MMW 13R,A01,892727,Staff,0,3,16,16
1745821164850,MMW 13R,A02,892728,Staff,0,4,16,16
1745821164850,MMW 13R,A03,958032,Staff,0,3,16,16
1745821164850,MMW 13R,A04,958033,Staff,0,2,16,16
1745821164850,MMW 13R,A05,958034,Staff,0,3,16,16
1745821165882,SIO 295LS,A00,894015,Staff,7,0,25,18
1745821166915,SIO 295S,A00,894020,Staff,7,0,25,18
1745821167944,SIOC 290S,B01,958918,Staff,0,0,0,0
1745821168974,SIOC 291S,B01,958922,Staff,0,0,0,0
1745821170003,SOCI 117,A01,895339,Staff,4,0,5,1
1745821171034,WES 237B,A00,894149,Staff,11,0,20,9
1745821173093,AESE 279B,A00,891859,Staff,13,0,35,22
1745821174119,AIP 197,001,891854,Staff,70,0,70,0
1745821175147,ANTH 289S,A00,891856,Gagneux; Pascal,12,0,12,0
1745821176172,BENG 196,001,957946,Engler; Adam J.,9996,0,9999,3
1745821177199,CAT 124RS,A01,956906,Staff,8,0,25,17
1745821178226,CAT 125RS,A01,922013,Staff,8,0,25,17
1745821179260,CLRE 250,A00,891860,Morris; Sheldon,9995,0,9999,4
1745821181308,CLRE 251R,A00,907817,Mehta; Ravindra L.,9994,0,9999,5
1745821182345,CLRE 252,A00,891864,Cuomo; Raphael Eduardo,9993,0,9999,6
1745821183379,CLRE 253,A00,891867,Vaida; Florin,9994,0,9999,5
1745821183379,CLRE 253,B00,907819,Staff,9999,0,9999,0
1745821184406,CLRE 259,A00,891868,Patel; Hemal,9998,0,9999,1
1745821185434,CLRE 260,A00,891872,Cuomo; Raphael Eduardo,9999,0,9999,0
1745821186463,CLRE 297,001,891888,Cuomo; Raphael Eduardo,9999,0,9999,0
1745821187491,CSE 191,A00,958773,Minnes Kemp; Mor Mia,9999,0,9999,0
1745821188518,CSS 201S,A01,892054,Mignozzetti; Umberto,30,0,30,0
1745821189547,CSS 202S,A01,892056,Mignozzetti; Umberto,30,0,30,0
1745821190580,DSC 197,001,956898,Eldridge; Justin Matthew,9998,0,9999,1
1745821191608,DSC 297,001,958000,Mazumdar; Arya,9998,0,9999,1
1745821192635,EAP 100,A00,905686,Staff,9776,0,9999,223
1745821193663,ECE 45,A01,892618,Staff,0,12,50,50
1745821194687,ECE 109,A01,892620,Staff,0,43,0,0
1745821195715,ECE 111,A01,892719,Staff,0,9,50,50
1745821196753,ECE 197,001,957920,Mercier; Patrick Philip,9992,0,9999,7
1745821197781,ECON 178,A01,907814,Zhu; Ying,28,0,35,7
1745821198806,EDS 115,A00,895312,Staff,41,0,45,4
1745821199858,EDS 117,A01,895337,Staff,30,0,30,0
1745821200885,EDS 125,A00,895341,Jones; Gabrielle Anastasia,43,0,45,2
1745821201912,EDS 128A,A01,895459,Fargason; Sharon Gayle,44,0,45,1
1745821202941,EDS 128B,A01,895543,Pappas; Elizabeth,44,0,45,1
1745821203967,EDS 139,A00,897203,Pappas; Elizabeth,44,0,45,1
1745821203967,EDS 139,B00,897209,Fargason; Sharon Gayle,44,0,45,1
1745821204996,EDS 201,A00,895545,Staff,43,0,45,2
1745821206028,EDS 203,A01,895581,Halter; Christopher P.,43,0,45,2
1745821207059,EDS 204R,A01,895625,Heinzman; Erica M.,43,0,45,2
1745821207059,EDS 204R,B01,895693,Halter; Christopher P.,18,0,45,27
1745821208085,EDS 206R,A00,895694,Fargason; Sharon Gayle,9,0,30,21
1745821208085,EDS 206R,B00,895695,Choi; Bailey Miyeon,20,0,30,10
1745821209110,EDS 250,A00,895697,Hemans; Patricia Ann Benitez,43,0,45,2
1745821210140,EDS 281,A00,895701,Meyerott; Theresa Ann,15,0,15,0
1745821211166,EDS 284,A00,895736,Meyerott; Theresa Ann,15,0,15,0
1745821212192,EDS 286,A00,897210,Fine; Sarah,15,0,15,0
1745821213234,EDS 289C,A01,895770,Daly; Alan J.,15,0,15,0
1745821214260,EDS 290,A00,897211,Hofstetter; Carolyn,15,0,15,0
1745821215291,LIGM 5A,A00,896162,Fischer-Grunski; Eva K,15,0,20,5
1745821216317,LIGM 5B,A00,896260,Fischer-Grunski; Eva K,17,0,20,3
1745821217361,LIGM 5C,A00,896308,Fischer-Grunski; Eva K,18,0,20,2
1745821218401,LIIT 5AS,A00,896313,Carnelos; Chiara,17,0,20,3
1745821219432,LIIT 5BS,A00,896416,Carnelos; Chiara,20,0,20,0
1745821220460,LIIT 5CS,A00,896564,Carnelos; Chiara,20,0,20,0
1745821221490,LISP 5A,A00,896588,Munoz Sanchez; Alicia,4,0,20,16
1745821222514,LISP 5B,A00,896653,Munoz Sanchez; Alicia,10,0,20,10
1745821223540,LISP 5C,A00,896655,Munoz Sanchez; Alicia,4,0,20,16
1745821224568,MAE 197,001,957918,Kleissl; Jan,9998,0,9999,1
1745821225597,MATH 2,A01,957937,Staff,34,0,35,1
1745821226623,MATH 197,001,957876,Kedlaya; Kiran S.,9993,0,9999,6
1745821227654,MCWP 40,A00,892729,Duru; Nur,13,0,20,7
1745821227654,MCWP 40,B00,893304,Montejo; Carolina,20,0,20,0
1745821228677,MCWP 40R,A00,893757,Redela; Pamela Morgan,0,7,20,20
1745821229704,MCWP 50,A00,893758,Morshed; Michael James,2,0,20,18
1745821229704,MCWP 50,B00,893761,Bartulis; Jason Michael,18,0,20,2
1745821230782,MCWP 50R,A00,893766,Compas; Sean Matthew,0,1,20,20
1745821230782,MCWP 50R,B00,893769,Carter; Jennifer A,0,0,20,20
1745821230782,MCWP 50R,C00,893771,Krone; Jarret,0,3,20,20
1745821230782,MCWP 50R,D00,893772,Miller; Elizabeth Deen,3,0,20,17
1745821230782,MCWP 50R,E00,893775,Carter; Andrea L,0,0,20,20
1745821231808,MMW 11R,A01,892721,Herbst; Matthew,11,0,27,16
1745821231808,MMW 11R,A02,892722,Herbst; Matthew,0,0,0,3
1745821232834,MMW 12R,A01,892724,Herbst; Matthew,0,10,16,16
1745821232834,MMW 12R,A02,892725,Herbst; Matthew,0,9,16,16
1745821233884,MMW 13R,A01,892727,Staff,0,3,16,16
1745821233884,MMW 13R,A02,892728,Staff,0,4,16,16
1745821233884,MMW 13R,A03,958032,Staff,0,3,16,16
1745821233884,MMW 13R,A04,958033,Staff,0,2,16,16
1745821233884,MMW 13R,A05,958034,Staff,0,3,16,16
1745821234907,SIO 295LS,A00,894015,Staff,7,0,25,18
1745821235932,SIO 295S,A00,894020,Staff,7,0,25,18
1745821236959,SIOC 290S,B01,958918,Staff,0,0,0,0
1745821237999,SIOC 291S,B01,958922,Staff,0,0,0,0
1745821239024,SOCI 117,A01,895339,Staff,4,0,5,1
1745821240055,WES 237B,A00,894149,Staff,11,0,20,9
1745821242111,AESE 279B,A00,891859,Staff,13,0,35,22
1745821243137,AIP 197,001,891854,Staff,70,0,70,0
1745821244164,ANTH 289S,A00,891856,Gagneux; Pascal,12,0,12,0
1745821245191,BENG 196,001,957946,Engler; Adam J.,9996,0,9999,3
1745821246221,CAT 124RS,A01,956906,Staff,8,0,25,17
1745821247247,CAT 125RS,A01,922013,Staff,8,0,25,17
1745821248275,CLRE 250,A00,891860,Morris; Sheldon,9995,0,9999,4
1745821250329,CLRE 251R,A00,907817,Mehta; Ravindra L.,9994,0,9999,5
1745821251356,CLRE 252,A00,891864,Cuomo; Raphael Eduardo,9993,0,9999,6
1745821252389,CLRE 253,A00,891867,Vaida; Florin,9994,0,9999,5
1745821252389,CLRE 253,B00,907819,Staff,9999,0,9999,0
1745821253419,CLRE 259,A00,891868,Patel; Hemal,9998,0,9999,1
1745821254445,CLRE 260,A00,891872,Cuomo; Raphael Eduardo,9999,0,9999,0
1745821255471,CLRE 297,001,891888,Cuomo; Raphael Eduardo,9999,0,9999,0
1745821256500,CSE 191,A00,958773,Minnes Kemp; Mor Mia,9999,0,9999,0
1745821257529,CSS 201S,A01,892054,Mignozzetti; Umberto,30,0,30,0
1745821258554,CSS 202S,A01,892056,Mignozzetti; Umberto,30,0,30,0
1745821259587,DSC 197,001,956898,Eldridge; Justin Matthew,9998,0,9999,1
1745821260617,DSC 297,001,958000,Mazumdar; Arya,9998,0,9999,1
1745821261647,EAP 100,A00,905686,Staff,9776,0,9999,223
1745821262676,ECE 45,A01,892618,Staff,0,12,50,50
1745821263706,ECE 109,A01,892620,Staff,0,43,0,0
1745821264734,ECE 111,A01,892719,Staff,0,9,50,50
1745821265758,ECE 197,001,957920,Mercier; Patrick Philip,9992,0,9999,7
1745821266785,ECON 178,A01,907814,Zhu; Ying,28,0,35,7
1745821267814,EDS 115,A00,895312,Staff,41,0,45,4
1745821268842,EDS 117,A01,895337,Staff,30,0,30,0
1745821269887,EDS 125,A00,895341,Jones; Gabrielle Anastasia,43,0,45,2
1745821270912,EDS 128A,A01,895459,Fargason; Sharon Gayle,44,0,45,1
1745821271942,EDS 128B,A01,895543,Pappas; Elizabeth,44,0,45,1
1745821272968,EDS 139,A00,897203,Pappas; Elizabeth,44,0,45,1
1745821272968,EDS 139,B00,897209,Fargason; Sharon Gayle,44,0,45,1
1745821273995,EDS 201,A00,895545,Staff,43,0,45,2
1745821275020,EDS 203,A01,895581,Halter; Christopher P.,43,0,45,2
1745821276049,EDS 204R,A01,895625,Heinzman; Erica M.,43,0,45,2
1745821276049,EDS 204R,B01,895693,Halter; Christopher P.,18,0,45,27
1745821277079,EDS 206R,A00,895694,Fargason; Sharon Gayle,9,0,30,21
1745821277079,EDS 206R,B00,895695,Choi; Bailey Miyeon,20,0,30,10
1745821278107,EDS 250,A00,895697,Hemans; Patricia Ann Benitez,43,0,45,2
1745821279137,EDS 281,A00,895701,Meyerott; Theresa Ann,15,0,15,0
1745821280167,EDS 284,A00,895736,Meyerott; Theresa Ann,15,0,15,0
1745821281194,EDS 286,A00,897210,Fine; Sarah,15,0,15,0
1745821282221,EDS 289C,A01,895770,Daly; Alan J.,15,0,15,0
1745821283250,EDS 290,A00,897211,Hofstetter; Carolyn,15,0,15,0
1745821284277,LIGM 5A,A00,896162,Fischer-Grunski; Eva K,15,0,20,5
1745821285309,LIGM 5B,A00,896260,Fischer-Grunski; Eva K,17,0,20,3
1745821286338,LIGM 5C,A00,896308,Fischer-Grunski; Eva K,18,0,20,2
1745821287363,LIIT 5AS,A00,896313,Carnelos; Chiara,17,0,20,3
1745821288390,LIIT 5BS,A00,896416,Carnelos; Chiara,20,0,20,0
1745821289421,LIIT 5CS,A00,896564,Carnelos; Chiara,20,0,20,0
1745821290472,LISP 5A,A00,896588,Munoz Sanchez; Alicia,4,0,20,16
1745821291501,LISP 5B,A00,896653,Munoz Sanchez; Alicia,10,0,20,10
1745821292528,LISP 5C,A00,896655,Munoz Sanchez; Alicia,4,0,20,16
1745821293556,MAE 197,001,957918,Kleissl; Jan,9998,0,9999,1
1745821294614,MATH 2,A01,957937,Staff,34,0,35,1
1745821295641,MATH 197,001,957876,Kedlaya; Kiran S.,9993,0,9999,6
1745821296670,MCWP 40,A00,892729,Duru; Nur,13,0,20,7
1745821296670,MCWP 40,B00,893304,Montejo; Carolina,20,0,20,0
1745821297697,MCWP 40R,A00,893757,Redela; Pamela Morgan,0,7,20,20
1745821298722,MCWP 50,A00,893758,Morshed; Michael James,2,0,20,18
1745821298722,MCWP 50,B00,893761,Bartulis; Jason Michael,18,0,20,2
1745821299751,MCWP 50R,A00,893766,Compas; Sean Matthew,0,1,20,20
1745821299751,MCWP 50R,B00,893769,Carter; Jennifer A,0,0,20,20
1745821299751,MCWP 50R,C00,893771,Krone; Jarret,0,3,20,20
1745821299751,MCWP 50R,D00,893772,Miller; Elizabeth Deen,3,0,20,17
1745821299751,MCWP 50R,E00,893775,Carter; Andrea L,0,0,20,20
1745821300779,MMW 11R,A01,892721,Herbst; Matthew,11,0,27,16
1745821300779,MMW 11R,A02,892722,Herbst; Matthew,0,0,0,3
1745821301804,MMW 12R,A01,892724,Herbst; Matthew,0,10,16,16
1745821301804,MMW 12R,A02,892725,Herbst; Matthew,0,9,16,16
1745821302834,MMW 13R,A01,892727,Staff,0,3,16,16
1745821302834,MMW 13R,A02,892728,Staff,0,4,16,16
1745821302834,MMW 13R,A03,958032,Staff,0,3,16,16
1745821302834,MMW 13R,A04,958033,Staff,0,2,16,16
1745821302834,MMW 13R,A05,958034,Staff,0,3,16,16
1745821303861,SIO 295LS,A00,894015,Staff,7,0,25,18
1745821304894,SIO 295S,A00,894020,Staff,7,0,25,18
1745821305920,SIOC 290S,B01,958918,Staff,0,0,0,0
1745821306946,SIOC 291S,B01,958922,Staff,0,0,0,0
1745821307975,SOCI 117,A01,895339,Staff,4,0,5,1
1745821309003,WES 237B,A00,894149,Staff,11,0,20,9
1745821311062,AESE 279B,A00,891859,Staff,13,0,35,22
1745821312087,AIP 197,001,891854,Staff,70,0,70,0
1745821313113,ANTH 289S,A00,891856,Gagneux; Pascal,12,0,12,0
1745821314137,BENG 196,001,957946,Engler; Adam J.,9996,0,9999,3
1745821315163,CAT 124RS,A01,956906,Staff,8,0,25,17
1745821316190,CAT 125RS,A01,922013,Staff,8,0,25,17
1745821317215,CLRE 250,A00,891860,Morris; Sheldon,9995,0,9999,4
1745821319273,CLRE 251R,A00,907817,Mehta; Ravindra L.,9994,0,9999,5
1745821320297,CLRE 252,A00,891864,Cuomo; Raphael Eduardo,9993,0,9999,6
1745821321325,CLRE 253,A00,891867,Vaida; Florin,9994,0,9999,5
1745821321325,CLRE 253,B00,907819,Staff,9999,0,9999,0
1745821322352,CLRE 259,A00,891868,Patel; Hemal,9998,0,9999,1
1745821323377,CLRE 260,A00,891872,Cuomo; Raphael Eduardo,9999,0,9999,0
1745821324405,CLRE 297,001,891888,Cuomo; Raphael Eduardo,9999,0,9999,0
1745821325430,CSE 191,A00,958773,Minnes Kemp; Mor Mia,9999,0,9999,0
1745821326461,CSS 201S,A01,892054,Mignozzetti; Umberto,30,0,30,0
1745821327487,CSS 202S,A01,892056,Mignozzetti; Umberto,30,0,30,0
1745821328511,DSC 197,001,956898,Eldridge; Justin Matthew,9998,0,9999,1
1745821329538,DSC 297,001,958000,Mazumdar; Arya,9998,0,9999,1
1745821330565,EAP 100,A00,905686,Staff,9776,0,9999,223
1745821331590,ECE 45,A01,892618,Staff,0,12,50,50
1745821332618,ECE 109,A01,892620,Staff,0,43,0,0
1745821333645,ECE 111,A01,892719,Staff,0,9,50,50
1745821334673,ECE 197,001,957920,Mercier; Patrick Philip,9992,0,9999,7
1745821335702,ECON 178,A01,907814,Zhu; Ying,28,0,35,7
1745821336727,EDS 115,A00,895312,Staff,41,0,45,4
1745821337755,EDS 117,A01,895337,Staff,30,0,30,0
1745821338780,EDS 125,A00,895341,Jones; Gabrielle Anastasia,43,0,45,2
1745821339807,EDS 128A,A01,895459,Fargason; Sharon Gayle,44,0,45,1
1745821340836,EDS 128B,A01,895543,Pappas; Elizabeth,44,0,45,1
1745821341862,EDS 139,A00,897203,Pappas; Elizabeth,44,0,45,1
1745821341862,EDS 139,B00,897209,Fargason; Sharon Gayle,44,0,45,1
1745821342891,EDS 201,A00,895545,Staff,43,0,45,2
1745821343916,EDS 203,A01,895581,Halter; Christopher P.,43,0,45,2
1745821344943,EDS 204R,A01,895625,Heinzman; Erica M.,43,0,45,2
1745821344943,EDS 204R,B01,895693,Halter; Christopher P.,18,0,45,27
1745821345968,EDS 206R,A00,895694,Fargason; Sharon Gayle,9,0,30,21
1745821345968,EDS 206R,B00,895695,Choi; Bailey Miyeon,20,0,30,10
1745821346996,EDS 250,A00,895697,Hemans; Patricia Ann Benitez,43,0,45,2
1745821348024,EDS 281,A00,895701,Meyerott; Theresa Ann,15,0,15,0
1745821349049,EDS 284,A00,895736,Meyerott; Theresa Ann,15,0,15,0
1745821350078,EDS 286,A00,897210,Fine; Sarah,15,0,15,0
1745821351112,EDS 289C,A01,895770,Daly; Alan J.,15,0,15,0
1745821352137,EDS 290,A00,897211,Hofstetter; Carolyn,15,0,15,0
1745821353165,LIGM 5A,A00,896162,Fischer-Grunski; Eva K,15,0,20,5
1745821354194,LIGM 5B,A00,896260,Fischer-Grunski; Eva K,17,0,20,3
1745821355220,LIGM 5C,A00,896308,Fischer-Grunski; Eva K,18,0,20,2
1745821356248,LIIT 5AS,A00,896313,Carnelos; Chiara,17,0,20,3
1745821357273,LIIT 5BS,A00,896416,Carnelos; Chiara,20,0,20,0
1745821358301,LIIT 5CS,A00,896564,Carnelos; Chiara,20,0,20,0
1745821359329,LISP 5A,A00,896588,Munoz Sanchez; Alicia,4,0,20,16
1745821360354,LISP 5B,A00,896653,Munoz Sanchez; Alicia,10,0,20,10
1745821361379,LISP 5C,A00,896655,Munoz Sanchez; Alicia,4,0,20,16
1745821362404,MAE 197,001,957918,Kleissl; Jan,9998,0,9999,1
1745821363430,MATH 2,A01,957937,Staff,34,0,35,1
1745821364460,MATH 197,001,957876,Kedlaya; Kiran S.,9993,0,9999,6
1745821365487,MCWP 40,A00,892729,Duru; Nur,13,0,20,7
1745821365487,MCWP 40,B00,893304,Montejo; Carolina,20,0,20,0
1745821366511,MCWP 40R,A00,893757,Redela; Pamela Morgan,0,7,20,20
1745821367536,MCWP 50,A00,893758,Morshed; Michael James,2,0,20,18
1745821367536,MCWP 50,B00,893761,Bartulis; Jason Michael,18,0,20,2
1745821368562,MCWP 50R,A00,893766,Compas; Sean Matthew,0,1,20,20
1745821368562,MCWP 50R,B00,893769,Carter; Jennifer A,0,0,20,20
1745821368562,MCWP 50R,C00,893771,Krone; Jarret,0,3,20,20
1745821368562,MCWP 50R,D00,893772,Miller; Elizabeth Deen,3,0,20,17
1745821368562,MCWP 50R,E00,893775,Carter; Andrea L,0,0,20,20
1745821369589,MMW 11R,A01,892721,Herbst; Matthew,11,0,27,16
1745821369589,MMW 11R,A02,892722,Herbst; Matthew,0,0,0,3
1745821370615,MMW 12R,A01,892724,Herbst; Matthew,0,10,16,16
1745821370615,MMW 12R,A02,892725,Herbst; Matthew,0,9,16,16
1745821371646,MMW 13R,A01,892727,Staff,0,3,16,16
1745821371646,MMW 13R,A02,892728,Staff,0,4,16,16
1745821371646,MMW 13R,A03,958032,Staff,0,3,16,16
1745821371646,MMW 13R,A04,958033,Staff,0,2,16,16
1745821371646,MMW 13R,A05,958034,Staff,0,3,16,16
1745821372669,SIO 295LS,A00,894015,Staff,7,0,25,18
1745821373695,SIO 295S,A00,894020,Staff,7,0,25,18
1745821374721,SIOC 290S,B01,958918,Staff,0,0,0,0
1745821375747,SIOC 291S,B01,958922,Staff,0,0,0,0
1745821376788,SOCI 117,A01,895339,Staff,4,0,5,1
1745821377811,WES 237B,A00,894149,Staff,11,0,20,9
1745821379868,AESE 279B,A00,891859,Staff,13,0,35,22
1745821380891,AIP 197,001,891854,Staff,70,0,70,0
1745821381916,ANTH 289S,A00,891856,Gagneux; Pascal,12,0,12,0
1745821382941,BENG 196,001,957946,Engler; Adam J.,9996,0,9999,3
1745821383968,CAT 124RS,A01,956906,Staff,8,0,25,17
1745821384994,CAT 125RS,A01,922013,Staff,8,0,25,17
1745821386021,CLRE 250,A00,891860,Morris; Sheldon,9995,0,9999,4
1745821388069,CLRE 251R,A00,907817,Mehta; Ravindra L.,9994,0,9999,5
1745821389098,CLRE 252,A00,891864,Cuomo; Raphael Eduardo,9993,0,9999,6
1745821390125,CLRE 253,A00,891867,Vaida; Florin,9994,0,9999,5
1745821390125,CLRE 253,B00,907819,Staff,9999,0,9999,0
1745821391151,CLRE 259,A00,891868,Patel; Hemal,9998,0,9999,1
1745821392175,CLRE 260,A00,891872,Cuomo; Raphael Eduardo,9999,0,9999,0
1745821393220,CLRE 297,001,891888,Cuomo; Raphael Eduardo,9999,0,9999,0
1745821394248,CSE 191,A00,958773,Minnes Kemp; Mor Mia,9999,0,9999,0
1745821395273,CSS 201S,A01,892054,Mignozzetti; Umberto,30,0,30,0
1745821396299,CSS 202S,A01,892056,Mignozzetti; Umberto,30,0,30,0
1745821397324,DSC 197,001,956898,Eldridge; Justin Matthew,9998,0,9999,1
1745821398348,DSC 297,001,958000,Mazumdar; Arya,9998,0,9999,1
1745821399374,EAP 100,A00,905686,Staff,9776,0,9999,223
1745821400399,ECE 45,A01,892618,Staff,0,13,50,50
1745821401423,ECE 109,A01,892620,Staff,0,43,0,0
1745821402446,ECE 111,A01,892719,Staff,0,9,50,50
1745821403471,ECE 197,001,957920,Mercier; Patrick Philip,9992,0,9999,7
1745821404497,ECON 178,A01,907814,Zhu; Ying,28,0,35,7
1745821405521,EDS 115,A00,895312,Staff,41,0,45,4
1745821406549,EDS 117,A01,895337,Staff,30,0,30,0
1745821407575,EDS 125,A00,895341,Jones; Gabrielle Anastasia,43,0,45,2
1745821408597,EDS 128A,A01,895459,Fargason; Sharon Gayle,44,0,45,1
1745821409627,EDS 128B,A01,895543,Pappas; Elizabeth,44,0,45,1
1745821410655,EDS 139,A00,897203,Pappas; Elizabeth,44,0,45,1
1745821410655,EDS 139,B00,897209,Fargason; Sharon Gayle,44,0,45,1
1745821411680,EDS 201,A00,895545,Staff,43,0,45,2
1745821412710,EDS 203,A01,895581,Halter; Christopher P.,43,0,45,2
1745821413743,EDS 204R,A01,895625,Heinzman; Erica M.,43,0,45,2
1745821413743,EDS 204R,B01,895693,Halter; Christopher P.,18,0,45,27
1745821414770,EDS 206R,A00,895694,Fargason; Sharon Gayle,9,0,30,21
1745821414770,EDS 206R,B00,895695,Choi; Bailey Miyeon,20,0,30,10
1745821415795,EDS 250,A00,895697,Hemans; Patricia Ann Benitez,43,0,45,2
1745821416822,EDS 281,A00,895701,Meyerott; Theresa Ann,15,0,15,0
1745821417850,EDS 284,A00,895736,Meyerott; Theresa Ann,15,0,15,0
1745821418878,EDS 286,A00,897210,Fine; Sarah,15,0,15,0
1745821419909,EDS 289C,A01,895770,Daly; Alan J.,15,0,15,0
1745821420936,EDS 290,A00,897211,Hofstetter; Carolyn,15,0,15,0
1745821421962,LIGM 5A,A00,896162,Fischer-Grunski; Eva K,15,0,20,5
1745821422988,LIGM 5B,A00,896260,Fischer-Grunski; Eva K,17,0,20,3
1745821424018,LIGM 5C,A00,896308,Fischer-Grunski; Eva K,18,0,20,2
1745821425043,LIIT 5AS,A00,896313,Carnelos; Chiara,17,0,20,3
1745821426073,LIIT 5BS,A00,896416,Carnelos; Chiara,20,0,20,0
1745821427100,LIIT 5CS,A00,896564,Carnelos; Chiara,20,0,20,0
1745821428130,LISP 5A,A00,896588,Munoz Sanchez; Alicia,4,0,20,16
1745821429157,LISP 5B,A00,896653,Munoz Sanchez; Alicia,10,0,20,10
1745821430183,LISP 5C,A00,896655,Munoz Sanchez; Alicia,4,0,20,16
1745821431209,MAE 197,001,957918,Kleissl; Jan,9998,0,9999,1
1745821432235,MATH 2,A01,957937,Staff,34,0,35,1
1745821433264,MATH 197,001,957876,Kedlaya; Kiran S.,9993,0,9999,6
1745821434293,MCWP 40,A00,892729,Duru; Nur,13,0,20,7
1745821434293,MCWP 40,B00,893304,Montejo; Carolina,20,0,20,0
1745821435322,MCWP 40R,A00,893757,Redela; Pamela Morgan,0,7,20,20
1745821436350,MCWP 50,A00,893758,Morshed; Michael James,2,0,20,18
1745821436350,MCWP 50,B00,893761,Bartulis; Jason Michael,18,0,20,2
1745821437380,MCWP 50R,A00,893766,Compas; Sean Matthew,0,1,20,20
1745821437380,MCWP 50R,B00,893769,Carter; Jennifer A,0,0,20,20
1745821437380,MCWP 50R,C00,893771,Krone; Jarret,0,3,20,20
1745821437380,MCWP 50R,D00,893772,Miller; Elizabeth Deen,3,0,20,17
1745821437380,MCWP 50R,E00,893775,Carter; Andrea L,0,0,20,20
1745821438407,MMW 11R,A01,892721,Herbst; Matthew,11,0,27,16
1745821438407,MMW 11R,A02,892722,Herbst; Matthew,0,0,0,3
1745821439434,MMW 12R,A01,892724,Herbst; Matthew,0,10,16,16
1745821439434,MMW 12R,A02,892725,Herbst; Matthew,0,9,16,16
1745821440460,MMW 13R,A01,892727,Staff,0,3,16,16
1745821440460,MMW 13R,A02,892728,Staff,0,4,16,16
1745821440460,MMW 13R,A03,958032,Staff,0,3,16,16
1745821440460,MMW 13R,A04,958033,Staff,0,2,16,16
1745821440460,MMW 13R,A05,958034,Staff,0,3,16,16
1745821441485,SIO 295LS,A00,894015,Staff,7,0,25,18
1745821442514,SIO 295S,A00,894020,Staff,7,0,25,18
1745821443540,SIOC 290S,B01,958918,Staff,0,0,0,0
1745821444566,SIOC 291S,B01,958922,Staff,0,0,0,0
1745821445594,SOCI 117,A01,895339,Staff,4,0,5,1
1745821446624,WES 237B,A00,894149,Staff,11,0,20,9
1745821448681,AESE 279B,A00,891859,Staff,13,0,35,22
1745821449707,AIP 197,001,891854,Staff,70,0,70,0
1745821450737,ANTH 289S,A00,891856,Gagneux; Pascal,12,0,12,0
1745821451763,BENG 196,001,957946,Engler; Adam J.,9996,0,9999,3
1745821452788,CAT 124RS,A01,956906,Staff,8,0,25,17
1745821453812,CAT 125RS,A01,922013,Staff,8,0,25,17
1745821454841,CLRE 250,A00,891860,Morris; Sheldon,9995,0,9999,4
1745821456889,CLRE 251R,A00,907817,Mehta; Ravindra L.,9994,0,9999,5
1745821457916,CLRE 252,A00,891864,Cuomo; Raphael Eduardo,9993,0,9999,6
1745821458942,CLRE 253,A00,891867,Vaida; Florin,9994,0,9999,5
1745821458942,CLRE 253,B00,907819,Staff,9999,0,9999,0
1745821459967,CLRE 259,A00,891868,Patel; Hemal,9998,0,9999,1
1745821460992,CLRE 260,A00,891872,Cuomo; Raphael Eduardo,9999,0,9999,0
1745821462017,CLRE 297,001,891888,Cuomo; Raphael Eduardo,9999,0,9999,0
1745821463046,CSE 191,A00,958773,Minnes Kemp; Mor Mia,9999,0,9999,0
1745821464070,CSS 201S,A01,892054,Mignozzetti; Umberto,30,0,30,0
1745821465095,CSS 202S,A01,892056,Mignozzetti; Umberto,30,0,30,0
1745821466119,DSC 197,001,956898,Eldridge; Justin Matthew,9998,0,9999,1
1745821467144,DSC 297,001,958000,Mazumdar; Arya,9998,0,9999,1
1745821468168,EAP 100,A00,905686,Staff,9776,0,9999,223
1745821469193,ECE 45,A01,892618,Staff,0,13,50,50
1745821470216,ECE 109,A01,892620,Staff,0,43,0,0
1745821471243,ECE 111,A01,892719,Staff,0,9,50,50
1745821472270,ECE 197,001,957920,Mercier; Patrick Philip,9992,0,9999,7
1745821473297,ECON 178,A01,907814,Zhu; Ying,28,0,35,7
1745821474320,EDS 115,A00,895312,Staff,41,0,45,4
1745821475345,EDS 117,A01,895337,Staff,30,0,30,0
1745821476375,EDS 125,A00,895341,Jones; Gabrielle Anastasia,43,0,45,2
1745821477403,EDS 128A,A01,895459,Fargason; Sharon Gayle,44,0,45,1
1745821478433,EDS 128B,A01,895543,Pappas; Elizabeth,44,0,45,1
1745821479459,EDS 139,A00,897203,Pappas; Elizabeth,44,0,45,1
1745821479459,EDS 139,B00,897209,Fargason; Sharon Gayle,44,0,45,1
1745821480487,EDS 201,A00,895545,Staff,43,0,45,2
1745821481512,EDS 203,A01,895581,Halter; Christopher P.,43,0,45,2
1745821482537,EDS 204R,A01,895625,Heinzman; Erica M.,43,0,45,2
1745821482537,EDS 204R,B01,895693,Halter; Christopher P.,18,0,45,27
1745821483561,EDS 206R,A00,895694,Fargason; Sharon Gayle,9,0,30,21
1745821483561,EDS 206R,B00,895695,Choi; Bailey Miyeon,20,0,30,10
1745821484587,EDS 250,A00,895697,Hemans; Patricia Ann Benitez,43,0,45,2
1745821485611,EDS 281,A00,895701,Meyerott; Theresa Ann,15,0,15,0
1745821486638,EDS 284,A00,895736,Meyerott; Theresa Ann,15,0,15,0
1745821487667,EDS 286,A00,897210,Fine; Sarah,15,0,15,0
1745821488691,EDS 289C,A01,895770,Daly; Alan J.,15,0,15,0
1745821489715,EDS 290,A00,897211,Hofstetter; Carolyn,15,0,15,0
1745821490744,LIGM 5A,A00,896162,Fischer-Grunski; Eva K,15,0,20,5
1745821491769,LIGM 5B,A00,896260,Fischer-Grunski; Eva K,17,0,20,3
1745821492798,LIGM 5C,A00,896308,Fischer-Grunski; Eva K,18,0,20,2
1745821493823,LIIT 5AS,A00,896313,Carnelos; Chiara,17,0,20,3
1745821494848,LIIT 5BS,A00,896416,Carnelos; Chiara,20,0,20,0
1745821495872,LIIT 5CS,A00,896564,Carnelos; Chiara,20,0,20,0
1745821496905,LISP 5A,A00,896588,Munoz Sanchez; Alicia,4,0,20,16
1745821497929,LISP 5B,A00,896653,Munoz Sanchez; Alicia,10,0,20,10
1745821498954,LISP 5C,A00,896655,Munoz Sanchez; Alicia,4,0,20,16
1745821499979,MAE 197,001,957918,Kleissl; Jan,9998,0,9999,1
1745821501011,MATH 2,A01,957937,Staff,34,0,35,1
1745821502038,MATH 197,001,957876,Kedlaya; Kiran S.,9993,0,9999,6
1745821503062,MCWP 40,A00,892729,Duru; Nur,13,0,20,7
1745821503062,MCWP 40,B00,893304,Montejo; Carolina,20,0,20,0
1745821504088,MCWP 40R,A00,893757,Redela; Pamela Morgan,0,7,20,20
1745821505113,MCWP 50,A00,893758,Morshed; Michael James,2,0,20,18
1745821505113,MCWP 50,B00,893761,Bartulis; Jason Michael,18,0,20,2
1745821506143,MCWP 50R,A00,893766,Compas; Sean Matthew,0,1,20,20
1745821506143,MCWP 50R,B00,893769,Carter; Jennifer A,0,0,20,20
1745821506143,MCWP 50R,C00,893771,Krone; Jarret,0,3,20,20
1745821506143,MCWP 50R,D00,893772,Miller; Elizabeth Deen,3,0,20,17
1745821506143,MCWP 50R,E00,893775,Carter; Andrea L,0,0,20,20
1745821507167,MMW 11R,A01,892721,Herbst; Matthew,11,0,27,16
1745821507167,MMW 11R,A02,892722,Herbst; Matthew,0,0,0,3
1745821508194,MMW 12R,A01,892724,Herbst; Matthew,0,10,16,16
1745821508194,MMW 12R,A02,892725,Herbst; Matthew,0,9,16,16
1745821509220,MMW 13R,A01,892727,Staff,0,3,16,16
1745821509220,MMW 13R,A02,892728,Staff,0,4,16,16
1745821509220,MMW 13R,A03,958032,Staff,0,3,16,16
1745821509220,MMW 13R,A04,958033,Staff,0,2,16,16
1745821509220,MMW 13R,A05,958034,Staff,0,3,16,16
1745821510249,SIO 295LS,A00,894015,Staff,7,0,25,18
1745821511277,SIO 295S,A00,894020,Staff,7,0,25,18
1745821512304,SIOC 290S,B01,958918,Staff,0,0,0,0
1745821513334,SIOC 291S,B01,958922,Staff,0,0,0,0
1745821514358,SOCI 117,A01,895339,Staff,4,0,5,1
1745821515386,WES 237B,A00,894149,Staff,11,0,20,9
1745821517449,AESE 279B,A00,891859,Staff,13,0,35,22
1745821518475,AIP 197,001,891854,Staff,70,0,70,0
1745821519499,ANTH 289S,A00,891856,Gagneux; Pascal,12,0,12,0
1745821520524,BENG 196,001,957946,Engler; Adam J.,9996,0,9999,3
1745821521549,CAT 124RS,A01,956906,Staff,8,0,25,17
1745821522574,CAT 125RS,A01,922013,Staff,8,0,25,17
1745821523599,CLRE 250,A00,891860,Morris; Sheldon,9995,0,9999,4
1745821525658,CLRE 251R,A00,907817,Mehta; Ravindra L.,9994,0,9999,5
1745821526683,CLRE 252,A00,891864,Cuomo; Raphael Eduardo,9993,0,9999,6
1745821527712,CLRE 253,A00,891867,Vaida; Florin,9994,0,9999,5
1745821527712,CLRE 253,B00,907819,Staff,9999,0,9999,0
1745821528738,CLRE 259,A00,891868,Patel; Hemal,9998,0,9999,1
1745821529764,CLRE 260,A00,891872,Cuomo; Raphael Eduardo,9999,0,9999,0
1745821530792,CLRE 297,001,891888,Cuomo; Raphael Eduardo,9999,0,9999,0
1745821531816,CSE 191,A00,958773,Minnes Kemp; Mor Mia,9999,0,9999,0
1745821532846,CSS 201S,A01,892054,Mignozzetti; Umberto,30,0,30,0
1745821533874,CSS 202S,A01,892056,Mignozzetti; Umberto,30,0,30,0
1745821534901,DSC 197,001,956898,Eldridge; Justin Matthew,9998,0,9999,1
1745821535926,DSC 297,001,958000,Mazumdar; Arya,9998,0,9999,1
1745821536953,EAP 100,A00,905686,Staff,9776,0,9999,223
1745821537983,ECE 45,A01,892618,Staff,0,13,50,50
1745821539012,ECE 109,A01,892620,Staff,0,43,0,0
1745821540037,ECE 111,A01,892719,Staff,0,9,50,50
1745821541063,ECE 197,001,957920,Mercier; Patrick Philip,9992,0,9999,7
1745821542092,ECON 178,A01,907814,Zhu; Ying,28,0,35,7
1745821543117,EDS 115,A00,895312,Staff,41,0,45,4
1745821544141,EDS 117,A01,895337,Staff,30,0,30,0
1745821545166,EDS 125,A00,895341,Jones; Gabrielle Anastasia,43,0,45,2
1745821546194,EDS 128A,A01,895459,Fargason; Sharon Gayle,44,0,45,1
1745821547218,EDS 128B,A01,895543,Pappas; Elizabeth,44,0,45,1
1745821548245,EDS 139,A00,897203,Pappas; Elizabeth,44,0,45,1
1745821548245,EDS 139,B00,897209,Fargason; Sharon Gayle,44,0,45,1
1745821549274,EDS 201,A00,895545,Staff,43,0,45,2
1745821550303,EDS 203,A01,895581,Halter; Christopher P.,43,0,45,2
1745821551330,EDS 204R,A01,895625,Heinzman; Erica M.,43,0,45,2
1745821551330,EDS 204R,B01,895693,Halter; Christopher P.,18,0,45,27
1745821552355,EDS 206R,A00,895694,Fargason; Sharon Gayle,9,0,30,21
1745821552355,EDS 206R,B00,895695,Choi; Bailey Miyeon,20,0,30,10
1745821553380,EDS 250,A00,895697,Hemans; Patricia Ann Benitez,43,0,45,2
1745821554407,EDS 281,A00,895701,Meyerott; Theresa Ann,15,0,15,0
1745821555434,EDS 284,A00,895736,Meyerott; Theresa Ann,15,0,15,0
1745821556458,EDS 286,A00,897210,Fine; Sarah,15,0,15,0
1745821557482,EDS 289C,A01,895770,Daly; Alan J.,15,0,15,0
1745821558553,EDS 290,A00,897211,Hofstetter; Carolyn,15,0,15,0
1745821559706,LIGM 5A,A00,896162,Fischer-Grunski; Eva K,15,0,20,5
1745821560733,LIGM 5B,A00,896260,Fischer-Grunski; Eva K,17,0,20,3
1745821561761,LIGM 5C,A00,896308,Fischer-Grunski; Eva K,18,0,20,2
1745821562787,LIIT 5AS,A00,896313,Carnelos; Chiara,17,0,20,3
1745821563817,LIIT 5BS,A00,896416,Carnelos; Chiara,20,0,20,0
1745821564848,LIIT 5CS,A00,896564,Carnelos; Chiara,20,0,20,0
1745821565878,LISP 5A,A00,896588,Munoz Sanchez; Alicia,4,0,20,16
1745821566904,LISP 5B,A00,896653,Munoz Sanchez; Alicia,10,0,20,10
1745821567934,LISP 5C,A00,896655,Munoz Sanchez; Alicia,4,0,20,16
1745821568959,MAE 197,001,957918,Kleissl; Jan,9998,0,9999,1
1745821569984,MATH 2,A01,957937,Staff,34,0,35,1
1745821571010,MATH 197,001,957876,Kedlaya; Kiran S.,9993,0,9999,6
1745821572036,MCWP 40,A00,892729,Duru; Nur,13,0,20,7
1745821572036,MCWP 40,B00,893304,Montejo; Carolina,20,0,20,0
1745821573064,MCWP 40R,A00,893757,Redela; Pamela Morgan,0,7,20,20
1745821574092,MCWP 50,A00,893758,Morshed; Michael James,2,0,20,18
1745821574092,MCWP 50,B00,893761,Bartulis; Jason Michael,18,0,20,2
1745821575119,MCWP 50R,A00,893766,Compas; Sean Matthew,0,1,20,20
1745821575119,MCWP 50R,B00,893769,Carter; Jennifer A,0,0,20,20
1745821575119,MCWP 50R,C00,893771,Krone; Jarret,0,3,20,20
1745821575119,MCWP 50R,D00,893772,Miller; Elizabeth Deen,3,0,20,17
1745821575119,MCWP 50R,E00,893775,Carter; Andrea L,0,0,20,20
1745821576147,MMW 11R,A01,892721,Herbst; Matthew,11,0,27,16
1745821576147,MMW 11R,A02,892722,Herbst; Matthew,0,0,0,3
1745821577172,MMW 12R,A01,892724,Herbst; Matthew,0,10,16,16
1745821577172,MMW 12R,A02,892725,Herbst; Matthew,0,9,16,16
1745821578196,MMW 13R,A01,892727,Staff,0,3,16,16
1745821578196,MMW 13R,A02,892728,Staff,0,4,16,16
1745821578196,MMW 13R,A03,958032,Staff,0,3,16,16
1745821578196,MMW 13R,A04,958033,Staff,0,2,16,16
1745821578196,MMW 13R,A05,958034,Staff,0,3,16,16
1745821579223,SIO 295LS,A00,894015,Staff,7,0,25,18
1745821580251,SIO 295S,A00,894020,Staff,7,0,25,18
1745821581280,SIOC 290S,B01,958918,Staff,0,0,0,0
1745821582307,SIOC 291S,B01,958922,Staff,0,0,0,0
1745821583335,SOCI 117,A01,895339,Staff,4,0,5,1
1745821584358,WES 237B,A00,894149,Staff,11,0,20,9
1745821586417,AESE 279B,A00,891859,Staff,13,0,35,22
1745821587442,AIP 197,001,891854,Staff,70,0,70,0
1745821588467,ANTH 289S,A00,891856,Gagneux; Pascal,12,0,12,0
1745821589493,BENG 196,001,957946,Engler; Adam J.,9996,0,9999,3
1745821590518,CAT 124RS,A01,956906,Staff,8,0,25,17
1745821591541,CAT 125RS,A01,922013,Staff,8,0,25,17
1745821592567,CLRE 250,A00,891860,Morris; Sheldon,9995,0,9999,4
1745821594617,CLRE 251R,A00,907817,Mehta; Ravindra L.,9994,0,9999,5
1745821595646,CLRE 252,A00,891864,Cuomo; Raphael Eduardo,9993,0,9999,6
1745821596673,CLRE 253,A00,891867,Vaida; Florin,9994,0,9999,5
1745821596673,CLRE 253,B00,907819,Staff,9999,0,9999,0
1745821597702,CLRE 259,A00,891868,Patel; Hemal,9998,0,9999,1
1745821598727,CLRE 260,A00,891872,Cuomo; Raphael Eduardo,9999,0,9999,0
1745821599751,CLRE 297,001,891888,Cuomo; Raphael Eduardo,9999,0,9999,0
1745821600776,CSE 191,A00,958773,Minnes Kemp; Mor Mia,9999,0,9999,0
1745821601804,CSS 201S,A01,892054,Mignozzetti; Umberto,30,0,30,0
1745821602831,CSS 202S,A01,892056,Mignozzetti; Umberto,30,0,30,0
1745821603859,DSC 197,001,956898,Eldridge; Justin Matthew,9998,0,9999,1
1745821604886,DSC 297,001,958000,Mazumdar; Arya,9998,0,9999,1
1745821605912,EAP 100,A00,905686,Staff,9776,0,9999,223
1745821606941,ECE 45,A01,892618,Staff,0,13,50,50
1745821607966,ECE 109,A01,892620,Staff,0,43,0,0
1745821608992,ECE 111,A01,892719,Staff,0,9,50,50
1745821610018,ECE 197,001,957920,Mercier; Patrick Philip,9992,0,9999,7
1745821611046,ECON 178,A01,907814,Zhu; Ying,28,0,35,7
1745821612074,EDS 115,A00,895312,Staff,41,0,45,4
1745821613100,EDS 117,A01,895337,Staff,30,0,30,0
1745821614125,EDS 125,A00,895341,Jones; Gabrielle Anastasia,43,0,45,2
1745821615150,EDS 128A,A01,895459,Fargason; Sharon Gayle,44,0,45,1
1745821616175,EDS 128B,A01,895543,Pappas; Elizabeth,44,0,45,1
1745821617200,EDS 139,A00,897203,Pappas; Elizabeth,44,0,45,1
1745821617200,EDS 139,B00,897209,Fargason; Sharon Gayle,44,0,45,1
1745821618227,EDS 201,A00,895545,Staff,43,0,45,2
1745821619253,EDS 203,A01,895581,Halter; Christopher P.,43,0,45,2
1745821620283,EDS 204R,A01,895625,Heinzman; Erica M.,43,0,45,2
1745821620283,EDS 204R,B01,895693,Halter; Christopher P.,18,0,45,27
1745821621308,EDS 206R,A00,895694,Fargason; Sharon Gayle,9,0,30,21
1745821621308,EDS 206R,B00,895695,Choi; Bailey Miyeon,20,0,30,10
1745821622333,EDS 250,A00,895697,Hemans; Patricia Ann Benitez,43,0,45,2
1745821623358,EDS 281,A00,895701,Meyerott; Theresa Ann,15,0,15,0
1745821624384,EDS 284,A00,895736,Meyerott; Theresa Ann,15,0,15,0
1745821625410,EDS 286,A00,897210,Fine; Sarah,15,0,15,0
1745821626436,EDS 289C,A01,895770,Daly; Alan J.,15,0,15,0
1745821627462,EDS 290,A00,897211,Hofstetter; Carolyn,15,0,15,0
1745821628487,LIGM 5A,A00,896162,Fischer-Grunski; Eva K,15,0,20,5
1745821629513,LIGM 5B,A00,896260,Fischer-Grunski; Eva K,17,0,20,3
1745821630541,LIGM 5C,A00,896308,Fischer-Grunski; Eva K,18,0,20,2
1745821631566,LIIT 5AS,A00,896313,Carnelos; Chiara,17,0,20,3
1745821632596,LIIT 5BS,A00,896416,Carnelos; Chiara,20,0,20,0
1745821633623,LIIT 5CS,A00,896564,Carnelos; Chiara,20,0,20,0
1745821634651,LISP 5A,A00,896588,Munoz Sanchez; Alicia,4,0,20,16
1745821635680,LISP 5B,A00,896653,Munoz Sanchez; Alicia,10,0,20,10
1745821636707,LISP 5C,A00,896655,Munoz Sanchez; Alicia,4,0,20,16
1745821637732,MAE 197,001,957918,Kleissl; Jan,9998,0,9999,1
1745821638757,MATH 2,A01,957937,Staff,34,0,35,1
1745821639784,MATH 197,001,957876,Kedlaya; Kiran S.,9993,0,9999,6
1745821640813,MCWP 40,A00,892729,Duru; Nur,13,0,20,7
1745821640813,MCWP 40,B00,893304,Montejo; Carolina,20,0,20,0
1745821641839,MCWP 40R,A00,893757,Redela; Pamela Morgan,0,7,20,20
1745821642866,MCWP 50,A00,893758,Morshed; Michael James,2,0,20,18
1745821642866,MCWP 50,B00,893761,Bartulis; Jason Michael,18,0,20,2
1745821643894,MCWP 50R,A00,893766,Compas; Sean Matthew,0,1,20,20
1745821643894,MCWP 50R,B00,893769,Carter; Jennifer A,0,0,20,20
1745821643894,MCWP 50R,C00,893771,Krone; Jarret,0,3,20,20
1745821643894,MCWP 50R,D00,893772,Miller; Elizabeth Deen,3,0,20,17
1745821643894,MCWP 50R,E00,893775,Carter; Andrea L,0,0,20,20
1745821644921,MMW 11R,A01,892721,Herbst; Matthew,11,0,27,16
1745821644921,MMW 11R,A02,892722,Herbst; Matthew,0,0,0,3
1745821645962,MMW 12R,A01,892724,Herbst; Matthew,0,10,16,16
1745821645962,MMW 12R,A02,892725,Herbst; Matthew,0,9,16,16
1745821646992,MMW 13R,A01,892727,Staff,0,3,16,16
1745821646992,MMW 13R,A02,892728,Staff,0,4,16,16
1745821646992,MMW 13R,A03,958032,Staff,0,3,16,16
1745821646992,MMW 13R,A04,958033,Staff,0,2,16,16
1745821646992,MMW 13R,A05,958034,Staff,0,3,16,16
1745821648020,SIO 295LS,A00,894015,Staff,7,0,25,18
1745821649048,SIO 295S,A00,894020,Staff,7,0,25,18
1745821650079,SIOC 290S,B01,958918,Staff,0,0,0,0
1745821651105,SIOC 291S,B01,958922,Staff,0,0,0,0
1745821652130,SOCI 117,A01,895339,Staff,4,0,5,1
1745821653155,WES 237B,A00,894149,Staff,11,0,20,9
1745821655210,AESE 279B,A00,891859,Staff,13,0,35,22
1745821656238,AIP 197,001,891854,Staff,70,0,70,0
1745821657264,ANTH 289S,A00,891856,Gagneux; Pascal,12,0,12,0
1745821658289,BENG 196,001,957946,Engler; Adam J.,9996,0,9999,3
1745821659316,CAT 124RS,A01,956906,Staff,8,0,25,17
1745821660343,CAT 125RS,A01,922013,Staff,8,0,25,17
1745821661368,CLRE 250,A00,891860,Morris; Sheldon,9995,0,9999,4
1745821663423,CLRE 251R,A00,907817,Mehta; Ravindra L.,9994,0,9999,5
1745821664451,CLRE 252,A00,891864,Cuomo; Raphael Eduardo,9993,0,9999,6
1745821665476,CLRE 253,A00,891867,Vaida; Florin,9994,0,9999,5
1745821665476,CLRE 253,B00,907819,Staff,9999,0,9999,0
1745821666502,CLRE 259,A00,891868,Patel; Hemal,9998,0,9999,1
1745821667529,CLRE 260,A00,891872,Cuomo; Raphael Eduardo,9999,0,9999,0
1745821668554,CLRE 297,001,891888,Cuomo; Raphael Eduardo,9999,0,9999,0
1745821669579,CSE 191,A00,958773,Minnes Kemp; Mor Mia,9999,0,9999,0
1745821670605,CSS 201S,A01,892054,Mignozzetti; Umberto,30,0,30,0
1745821671636,CSS 202S,A01,892056,Mignozzetti; Umberto,30,0,30,0
1745821672661,DSC 197,001,956898,Eldridge; Justin Matthew,9998,0,9999,1
1745821673689,DSC 297,001,958000,Mazumdar; Arya,9998,0,9999,1
1745821674719,EAP 100,A00,905686,Staff,9776,0,9999,223
1745821675745,ECE 45,A01,892618,Staff,0,13,50,50
1745821676771,ECE 109,A01,892620,Staff,0,43,0,0
1745821677797,ECE 111,A01,892719,Staff,0,9,50,50
1745821678822,ECE 197,001,957920,Mercier; Patrick Philip,9992,0,9999,7
1745821679847,ECON 178,A01,907814,Zhu; Ying,28,0,35,7
1745821680871,EDS 115,A00,895312,Staff,41,0,45,4
1745821681901,EDS 117,A01,895337,Staff,30,0,30,0
1745821682929,EDS 125,A00,895341,Jones; Gabrielle Anastasia,43,0,45,2
1745821683961,EDS 128A,A01,895459,Fargason; Sharon Gayle,44,0,45,1
1745821684987,EDS 128B,A01,895543,Pappas; Elizabeth,44,0,45,1
1745821686013,EDS 139,A00,897203,Pappas; Elizabeth,44,0,45,1
1745821686013,EDS 139,B00,897209,Fargason; Sharon Gayle,44,0,45,1
1745821687039,EDS 201,A00,895545,Staff,43,0,45,2
1745821688064,EDS 203,A01,895581,Halter; Christopher P.,43,0,45,2
1745821689089,EDS 204R,A01,895625,Heinzman; Erica M.,43,0,45,2
1745821689089,EDS 204R,B01,895693,Halter; Christopher P.,18,0,45,27
1745821690115,EDS 206R,A00,895694,Fargason; Sharon Gayle,9,0,30,21
1745821690115,EDS 206R,B00,895695,Choi; Bailey Miyeon,20,0,30,10
1745821691142,EDS 250,A00,895697,Hemans; Patricia Ann Benitez,43,0,45,2
1745821692168,EDS 281,A00,895701,Meyerott; Theresa Ann,15,0,15,0
1745821693194,EDS 284,A00,895736,Meyerott; Theresa Ann,15,0,15,0
1745821694222,EDS 286,A00,897210,Fine; Sarah,15,0,15,0
1745821695250,EDS 289C,A01,895770,Daly; Alan J.,15,0,15,0
1745821696277,EDS 290,A00,897211,Hofstetter; Carolyn,15,0,15,0
1745821697303,LIGM 5A,A00,896162,Fischer-Grunski; Eva K,15,0,20,5
1745821698331,LIGM 5B,A00,896260,Fischer-Grunski; Eva K,17,0,20,3
1745821699360,LIGM 5C,A00,896308,Fischer-Grunski; Eva K,18,0,20,2
1745821700386,LIIT 5AS,A00,896313,Carnelos; Chiara,17,0,20,3
1745821701412,LIIT 5BS,A00,896416,Carnelos; Chiara,20,0,20,0
1745821702439,LIIT 5CS,A00,896564,Carnelos; Chiara,20,0,20,0
1745821703465,LISP 5A,A00,896588,Munoz Sanchez; Alicia,4,0,20,16
1745821704492,LISP 5B,A00,896653,Munoz Sanchez; Alicia,10,0,20,10
1745821705518,LISP 5C,A00,896655,Munoz Sanchez; Alicia,4,0,20,16
1745821706544,MAE 197,001,957918,Kleissl; Jan,9998,0,9999,1
1745821707570,MATH 2,A01,957937,Staff,34,0,35,1
1745821708595,MATH 197,001,957876,Kedlaya; Kiran S.,9993,0,9999,6
1745821709621,MCWP 40,A00,892729,Duru; Nur,13,0,20,7
1745821709621,MCWP 40,B00,893304,Montejo; Carolina,20,0,20,0
1745821710649,MCWP 40R,A00,893757,Redela; Pamela Morgan,0,7,20,20
1745821711675,MCWP 50,A00,893758,Morshed; Michael James,2,0,20,18
1745821711675,MCWP 50,B00,893761,Bartulis; Jason Michael,18,0,20,2
1745821712702,MCWP 50R,A00,893766,Compas; Sean Matthew,0,1,20,20
1745821712702,MCWP 50R,B00,893769,Carter; Jennifer A,0,0,20,20
1745821712702,MCWP 50R,C00,893771,Krone; Jarret,0,3,20,20
1745821712702,MCWP 50R,D00,893772,Miller; Elizabeth Deen,3,0,20,17
1745821712702,MCWP 50R,E00,893775,Carter; Andrea L,0,0,20,20
1745821713732,MMW 11R,A01,892721,Herbst; Matthew,11,0,27,16
1745821713732,MMW 11R,A02,892722,Herbst; Matthew,0,0,0,3
1745821714758,MMW 12R,A01,892724,Herbst; Matthew,0,10,16,16
1745821714758,MMW 12R,A02,892725,Herbst; Matthew,0,9,16,16
1745821715785,MMW 13R,A01,892727,Staff,0,3,16,16
1745821715785,MMW 13R,A02,892728,Staff,0,4,16,16
1745821715785,MMW 13R,A03,958032,Staff,0,3,16,16
1745821715785,MMW 13R,A04,958033,Staff,0,2,16,16
1745821715785,MMW 13R,A05,958034,Staff,0,3,16,16
1745821716812,SIO 295LS,A00,894015,Staff,7,0,25,18
1745821717842,SIO 295S,A00,894020,Staff,7,0,25,18
1745821718873,SIOC 290S,B01,958918,Staff,0,0,0,0
1745821719897,SIOC 291S,B01,958922,Staff,0,0,0,0
1745821720924,SOCI 117,A01,895339,Staff,4,0,5,1
1745821721952,WES 237B,A00,894149,Staff,11,0,20,9
1745821724017,AESE 279B,A00,891859,Staff,13,0,35,22
1745821725042,AIP 197,001,891854,Staff,70,0,70,0
1745821726068,ANTH 289S,A00,891856,Gagneux; Pascal,12,0,12,0
1745821727096,BENG 196,001,957946,Engler; Adam J.,9996,0,9999,3
1745821728125,CAT 124RS,A01,956906,Staff,8,0,25,17
1745821729149,CAT 125RS,A01,922013,Staff,8,0,25,17
1745821730174,CLRE 250,A00,891860,Morris; Sheldon,9995,0,9999,4
1745821732229,CLRE 251R,A00,907817,Mehta; Ravindra L.,9994,0,9999,5
1745821733255,CLRE 252,A00,891864,Cuomo; Raphael Eduardo,9993,0,9999,6
1745821734280,CLRE 253,A00,891867,Vaida; Florin,9994,0,9999,5
1745821734280,CLRE 253,B00,907819,Staff,9999,0,9999,0
1745821735311,CLRE 259,A00,891868,Patel; Hemal,9998,0,9999,1
1745821736339,CLRE 260,A00,891872,Cuomo; Raphael Eduardo,9999,0,9999,0
1745821737363,CLRE 297,001,891888,Cuomo; Raphael Eduardo,9999,0,9999,0
1745821738387,CSE 191,A00,958773,Minnes Kemp; Mor Mia,9999,0,9999,0
1745821739421,CSS 201S,A01,892054,Mignozzetti; Umberto,30,0,30,0
1745821740445,CSS 202S,A01,892056,Mignozzetti; Umberto,30,0,30,0
1745821741471,DSC 197,001,956898,Eldridge; Justin Matthew,9998,0,9999,1
1745821742500,DSC 297,001,958000,Mazumdar; Arya,9998,0,9999,1
1745821743531,EAP 100,A00,905686,Staff,9776,0,9999,223
1745821744560,ECE 45,A01,892618,Staff,0,13,50,50
1745821745584,ECE 109,A01,892620,Staff,0,43,0,0
1745821746610,ECE 111,A01,892719,Staff,0,9,50,50
1745821747637,ECE 197,001,957920,Mercier; Patrick Philip,9992,0,9999,7
1745821748664,ECON 178,A01,907814,Zhu; Ying,28,0,35,7
1745821749689,EDS 115,A00,895312,Staff,41,0,45,4
1745821750715,EDS 117,A01,895337,Staff,30,0,30,0
1745821751740,EDS 125,A00,895341,Jones; Gabrielle Anastasia,43,0,45,2
1745821752770,EDS 128A,A01,895459,Fargason; Sharon Gayle,44,0,45,1
1745821753798,EDS 128B,A01,895543,Pappas; Elizabeth,44,0,45,1
1745821754822,EDS 139,A00,897203,Pappas; Elizabeth,44,0,45,1
1745821754822,EDS 139,B00,897209,Fargason; Sharon Gayle,44,0,45,1
1745821755849,EDS 201,A00,895545,Staff,43,0,45,2
1745821756880,EDS 203,A01,895581,Halter; Christopher P.,43,0,45,2
1745821757906,EDS 204R,A01,895625,Heinzman; Erica M.,43,0,45,2
1745821757906,EDS 204R,B01,895693,Halter; Christopher P.,18,0,45,27
1745821758935,EDS 206R,A00,895694,Fargason; Sharon Gayle,9,0,30,21
1745821758935,EDS 206R,B00,895695,Choi; Bailey Miyeon,20,0,30,10
1745821759965,EDS 250,A00,895697,Hemans; Patricia Ann Benitez,43,0,45,2
1745821760992,EDS 281,A00,895701,Meyerott; Theresa Ann,15,0,15,0
1745821762021,EDS 284,A00,895736,Meyerott; Theresa Ann,15,0,15,0
1745821763047,EDS 286,A00,897210,Fine; Sarah,15,0,15,0
1745821764076,EDS 289C,A01,895770,Daly; Alan J.,15,0,15,0
1745821765103,EDS 290,A00,897211,Hofstetter; Carolyn,15,0,15,0
1745821766130,LIGM 5A,A00,896162,Fischer-Grunski; Eva K,15,0,20,5
1745821767156,LIGM 5B,A00,896260,Fischer-Grunski; Eva K,17,0,20,3
1745821768183,LIGM 5C,A00,896308,Fischer-Grunski; Eva K,18,0,20,2
1745821769214,LIIT 5AS,A00,896313,Carnelos; Chiara,17,0,20,3
1745821770243,LIIT 5BS,A00,896416,Carnelos; Chiara,20,0,20,0
1745821771275,LIIT 5CS,A00,896564,Carnelos; Chiara,20,0,20,0
1745821772305,LISP 5A,A00,896588,Munoz Sanchez; Alicia,4,0,20,16
1745821773331,LISP 5B,A00,896653,Munoz Sanchez; Alicia,10,0,20,10
1745821774359,LISP 5C,A00,896655,Munoz Sanchez; Alicia,4,0,20,16
1745821775385,MAE 197,001,957918,Kleissl; Jan,9998,0,9999,1
1745821776414,MATH 2,A01,957937,Staff,34,0,35,1
1745821777439,MATH 197,001,957876,Kedlaya; Kiran S.,9993,0,9999,6
1745821778465,MCWP 40,A00,892729,Duru; Nur,13,0,20,7
1745821778465,MCWP 40,B00,893304,Montejo; Carolina,20,0,20,0
1745821779494,MCWP 40R,A00,893757,Redela; Pamela Morgan,0,7,20,20
1745821780522,MCWP 50,A00,893758,Morshed; Michael James,2,0,20,18
1745821780522,MCWP 50,B00,893761,Bartulis; Jason Michael,18,0,20,2
1745821781550,MCWP 50R,A00,893766,Compas; Sean Matthew,0,1,20,20
1745821781550,MCWP 50R,B00,893769,Carter; Jennifer A,0,0,20,20
1745821781550,MCWP 50R,C00,893771,Krone; Jarret,0,3,20,20
1745821781550,MCWP 50R,D00,893772,Miller; Elizabeth Deen,3,0,20,17
1745821781550,MCWP 50R,E00,893775,Carter; Andrea L,0,0,20,20
1745821782576,MMW 11R,A01,892721,Herbst; Matthew,11,0,27,16
1745821782576,MMW 11R,A02,892722,Herbst; Matthew,0,0,0,3
1745821783603,MMW 12R,A01,892724,Herbst; Matthew,0,10,16,16
1745821783603,MMW 12R,A02,892725,Herbst; Matthew,0,9,16,16
1745821784630,MMW 13R,A01,892727,Staff,0,3,16,16
1745821784630,MMW 13R,A02,892728,Staff,0,4,16,16
1745821784630,MMW 13R,A03,958032,Staff,0,3,16,16
1745821784630,MMW 13R,A04,958033,Staff,0,2,16,16
1745821784630,MMW 13R,A05,958034,Staff,0,3,16,16
1745821785658,SIO 295LS,A00,894015,Staff,7,0,25,18
1745821786684,SIO 295S,A00,894020,Staff,7,0,25,18
1745821787711,SIOC 290S,B01,958918,Staff,0,0,0,0
1745821788741,SIOC 291S,B01,958922,Staff,0,0,0,0
1745821789767,SOCI 117,A01,895339,Staff,4,0,5,1
1745821790793,WES 237B,A00,894149,Staff,11,0,20,9
1745821792854,AESE 279B,A00,891859,Staff,13,0,35,22
1745821793881,AIP 197,001,891854,Staff,70,0,70,0
1745821794908,ANTH 289S,A00,891856,Gagneux; Pascal,12,0,12,0
1745821795935,BENG 196,001,957946,Engler; Adam J.,9996,0,9999,3
1745821796960,CAT 124RS,A01,956906,Staff,8,0,25,17
1745821797987,CAT 125RS,A01,922013,Staff,8,0,25,17
1745821799016,CLRE 250,A00,891860,Morris; Sheldon,9995,0,9999,4
1745821801070,CLRE 251R,A00,907817,Mehta; Ravindra L.,9994,0,9999,5
1745821802096,CLRE 252,A00,891864,Cuomo; Raphael Eduardo,9993,0,9999,6
1745821803123,CLRE 253,A00,891867,Vaida; Florin,9994,0,9999,5
1745821803123,CLRE 253,B00,907819,Staff,9999,0,9999,0
1745821804151,CLRE 259,A00,891868,Patel; Hemal,9998,0,9999,1
1745821805181,CLRE 260,A00,891872,Cuomo; Raphael Eduardo,9999,0,9999,0
1745821806207,CLRE 297,001,891888,Cuomo; Raphael Eduardo,9999,0,9999,0
1745821807232,CSE 191,A00,958773,Minnes Kemp; Mor Mia,9999,0,9999,0
1745821808257,CSS 201S,A01,892054,Mignozzetti; Umberto,30,0,30,0
1745821809286,CSS 202S,A01,892056,Mignozzetti; Umberto,30,0,30,0
1745821810311,DSC 197,001,956898,Eldridge; Justin Matthew,9998,0,9999,1
1745821811337,DSC 297,001,958000,Mazumdar; Arya,9998,0,9999,1
1745821812394,EAP 100,A00,905686,Staff,9776,0,9999,223
1745821813421,ECE 45,A01,892618,Staff,0,13,50,50
1745821814449,ECE 109,A01,892620,Staff,0,43,0,0
1745821815478,ECE 111,A01,892719,Staff,0,9,50,50
1745821816503,ECE 197,001,957920,Mercier; Patrick Philip,9992,0,9999,7
1745821817528,ECON 178,A01,907814,Zhu; Ying,28,0,35,7
1745821818554,EDS 115,A00,895312,Staff,41,0,45,4
1745821819579,EDS 117,A01,895337,Staff,30,0,30,0
1745821820606,EDS 125,A00,895341,Jones; Gabrielle Anastasia,43,0,45,2
1745821821634,EDS 128A,A01,895459,Fargason; Sharon Gayle,44,0,45,1
1745821822658,EDS 128B,A01,895543,Pappas; Elizabeth,44,0,45,1
1745821823684,EDS 139,A00,897203,Pappas; Elizabeth,44,0,45,1
1745821823684,EDS 139,B00,897209,Fargason; Sharon Gayle,44,0,45,1
1745821824712,EDS 201,A00,895545,Staff,43,0,45,2
1745821825739,EDS 203,A01,895581,Halter; Christopher P.,43,0,45,2
1745821826767,EDS 204R,A01,895625,Heinzman; Erica M.,43,0,45,2
1745821826767,EDS 204R,B01,895693,Halter; Christopher P.,18,0,45,27
1745821827792,EDS 206R,A00,895694,Fargason; Sharon Gayle,9,0,30,21
1745821827792,EDS 206R,B00,895695,Choi; Bailey Miyeon,20,0,30,10
1745821828816,EDS 250,A00,895697,Hemans; Patricia Ann Benitez,43,0,45,2
1745821829842,EDS 281,A00,895701,Meyerott; Theresa Ann,15,0,15,0
1745821830870,EDS 284,A00,895736,Meyerott; Theresa Ann,15,0,15,0
1745821831897,EDS 286,A00,897210,Fine; Sarah,15,0,15,0
1745821832924,EDS 289C,A01,895770,Daly; Alan J.,15,0,15,0
1745821833949,EDS 290,A00,897211,Hofstetter; Carolyn,15,0,15,0
1745821834973,LIGM 5A,A00,896162,Fischer-Grunski; Eva K,15,0,20,5
1745821836002,LIGM 5B,A00,896260,Fischer-Grunski; Eva K,17,0,20,3
1745821837028,LIGM 5C,A00,896308,Fischer-Grunski; Eva K,18,0,20,2
1745821838054,LIIT 5AS,A00,896313,Carnelos; Chiara,17,0,20,3
1745821839082,LIIT 5BS,A00,896416,Carnelos; Chiara,20,0,20,0
1745821840108,LIIT 5CS,A00,896564,Carnelos; Chiara,20,0,20,0
1745821841132,LISP 5A,A00,896588,Munoz Sanchez; Alicia,4,0,20,16
1745821842162,LISP 5B,A00,896653,Munoz Sanchez; Alicia,10,0,20,10
1745821843187,LISP 5C,A00,896655,Munoz Sanchez; Alicia,4,0,20,16
1745821844211,MAE 197,001,957918,Kleissl; Jan,9998,0,9999,1
1745821845235,MATH 2,A01,957937,Staff,34,0,35,1
1745821846261,MATH 197,001,957876,Kedlaya; Kiran S.,9993,0,9999,6
1745821847286,MCWP 40,A00,892729,Duru; Nur,13,0,20,7
1745821847286,MCWP 40,B00,893304,Montejo; Carolina,20,0,20,0
1745821848312,MCWP 40R,A00,893757,Redela; Pamela Morgan,0,7,20,20
1745821849337,MCWP 50,A00,893758,Morshed; Michael James,2,0,20,18
1745821849337,MCWP 50,B00,893761,Bartulis; Jason Michael,18,0,20,2
1745821850366,MCWP 50R,A00,893766,Compas; Sean Matthew,0,1,20,20
1745821850366,MCWP 50R,B00,893769,Carter; Jennifer A,0,0,20,20
1745821850366,MCWP 50R,C00,893771,Krone; Jarret,0,3,20,20
1745821850366,MCWP 50R,D00,893772,Miller; Elizabeth Deen,3,0,20,17
1745821850366,MCWP 50R,E00,893775,Carter; Andrea L,0,0,20,20
1745821851390,MMW 11R,A01,892721,Herbst; Matthew,11,0,27,16
1745821851390,MMW 11R,A02,892722,Herbst; Matthew,0,0,0,3
1745821852415,MMW 12R,A01,892724,Herbst; Matthew,0,10,16,16
1745821852415,MMW 12R,A02,892725,Herbst; Matthew,0,9,16,16
1745821853444,MMW 13R,A01,892727,Staff,0,3,16,16
1745821853444,MMW 13R,A02,892728,Staff,0,4,16,16
1745821853444,MMW 13R,A03,958032,Staff,0,3,16,16
1745821853444,MMW 13R,A04,958033,Staff,0,2,16,16
1745821853444,MMW 13R,A05,958034,Staff,0,3,16,16
1745821854470,SIO 295LS,A00,894015,Staff,7,0,25,18
1745821855506,SIO 295S,A00,894020,Staff,7,0,25,18
1745821856530,SIOC 290S,B01,958918,Staff,0,0,0,0
1745821857559,SIOC 291S,B01,958922,Staff,0,0,0,0
1745821858584,SOCI 117,A01,895339,Staff,4,0,5,1
1745821859610,WES 237B,A00,894149,Staff,11,0,20,9
1745821861672,AESE 279B,A00,891859,Staff,13,0,35,22
1745821862701,AIP 197,001,891854,Staff,70,0,70,0
1745821863728,ANTH 289S,A00,891856,Gagneux; Pascal,12,0,12,0
1745821864752,BENG 196,001,957946,Engler; Adam J.,9996,0,9999,3
1745821865777,CAT 124RS,A01,956906,Staff,8,0,25,17
1745821866805,CAT 125RS,A01,922013,Staff,8,0,25,17
1745821867829,CLRE 250,A00,891860,Morris; Sheldon,9995,0,9999,4
1745821869876,CLRE 251R,A00,907817,Mehta; Ravindra L.,9994,0,9999,5
1745821870902,CLRE 252,A00,891864,Cuomo; Raphael Eduardo,9993,0,9999,6
1745821871928,CLRE 253,A00,891867,Vaida; Florin,9994,0,9999,5
1745821871928,CLRE 253,B00,907819,Staff,9999,0,9999,0
1745821872951,CLRE 259,A00,891868,Patel; Hemal,9998,0,9999,1
1745821873976,CLRE 260,A00,891872,Cuomo; Raphael Eduardo,9999,0,9999,0
1745821875003,CLRE 297,001,891888,Cuomo; Raphael Eduardo,9999,0,9999,0
1745821876031,CSE 191,A00,958773,Minnes Kemp; Mor Mia,9999,0,9999,0
1745821877058,CSS 201S,A01,892054,Mignozzetti; Umberto,30,0,30,0
1745821878083,CSS 202S,A01,892056,Mignozzetti; Umberto,30,0,30,0
1745821879110,DSC 197,001,956898,Eldridge; Justin Matthew,9998,0,9999,1
1745821880137,DSC 297,001,958000,Mazumdar; Arya,9998,0,9999,1
1745821881161,EAP 100,A00,905686,Staff,9776,0,9999,223
1745821882189,ECE 45,A01,892618,Staff,0,13,50,50
1745821883218,ECE 109,A01,892620,Staff,0,43,0,0
1745821884243,ECE 111,A01,892719,Staff,0,9,50,50
1745821885271,ECE 197,001,957920,Mercier; Patrick Philip,9992,0,9999,7
1745821886302,ECON 178,A01,907814,Zhu; Ying,28,0,35,7
1745821887327,EDS 115,A00,895312,Staff,41,0,45,4
1745821888353,EDS 117,A01,895337,Staff,30,0,30,0
1745821889379,EDS 125,A00,895341,Jones; Gabrielle Anastasia,43,0,45,2
1745821890404,EDS 128A,A01,895459,Fargason; Sharon Gayle,44,0,45,1
1745821891432,EDS 128B,A01,895543,Pappas; Elizabeth,44,0,45,1
1745821892457,EDS 139,A00,897203,Pappas; Elizabeth,44,0,45,1
1745821892457,EDS 139,B00,897209,Fargason; Sharon Gayle,44,0,45,1
1745821893482,EDS 201,A00,895545,Staff,43,0,45,2
1745821894507,EDS 203,A01,895581,Halter; Christopher P.,43,0,45,2
1745821895536,EDS 204R,A01,895625,Heinzman; Erica M.,43,0,45,2
1745821895536,EDS 204R,B01,895693,Halter; Christopher P.,18,0,45,27
1745821896562,EDS 206R,A00,895694,Fargason; Sharon Gayle,9,0,30,21
1745821896562,EDS 206R,B00,895695,Choi; Bailey Miyeon,20,0,30,10
1745821897585,EDS 250,A00,895697,Hemans; Patricia Ann Benitez,43,0,45,2
1745821898613,EDS 281,A00,895701,Meyerott; Theresa Ann,15,0,15,0
1745821899640,EDS 284,A00,895736,Meyerott; Theresa Ann,15,0,15,0
1745821900667,EDS 286,A00,897210,Fine; Sarah,15,0,15,0
1745821901694,EDS 289C,A01,895770,Daly; Alan J.,15,0,15,0
1745821902723,EDS 290,A00,897211,Hofstetter; Carolyn,15,0,15,0
1745821903749,LIGM 5A,A00,896162,Fischer-Grunski; Eva K,15,0,20,5
1745821904775,LIGM 5B,A00,896260,Fischer-Grunski; Eva K,17,0,20,3
1745821905805,LIGM 5C,A00,896308,Fischer-Grunski; Eva K,18,0,20,2
1745821906831,LIIT 5AS,A00,896313,Carnelos; Chiara,17,0,20,3
1745821907859,LIIT 5BS,A00,896416,Carnelos; Chiara,20,0,20,0
1745821908886,LIIT 5CS,A00,896564,Carnelos; Chiara,20,0,20,0
1745821909917,LISP 5A,A00,896588,Munoz Sanchez; Alicia,4,0,20,16
1745821910942,LISP 5B,A00,896653,Munoz Sanchez; Alicia,10,0,20,10
1745821911972,LISP 5C,A00,896655,Munoz Sanchez; Alicia,4,0,20,16
1745821913016,MAE 197,001,957918,Kleissl; Jan,9998,0,9999,1
1745821914044,MATH 2,A01,957937,Staff,34,0,35,1
1745821915069,MATH 197,001,957876,Kedlaya; Kiran S.,9993,0,9999,6
1745821916095,MCWP 40,A00,892729,Duru; Nur,13,0,20,7
1745821916095,MCWP 40,B00,893304,Montejo; Carolina,20,0,20,0
1745821917123,MCWP 40R,A00,893757,Redela; Pamela Morgan,0,7,20,20
1745821918149,MCWP 50,A00,893758,Morshed; Michael James,2,0,20,18
1745821918149,MCWP 50,B00,893761,Bartulis; Jason Michael,18,0,20,2
1745821919175,MCWP 50R,A00,893766,Compas; Sean Matthew,0,1,20,20
1745821919175,MCWP 50R,B00,893769,Carter; Jennifer A,0,0,20,20
1745821919175,MCWP 50R,C00,893771,Krone; Jarret,0,3,20,20
1745821919175,MCWP 50R,D00,893772,Miller; Elizabeth Deen,3,0,20,17
1745821919175,MCWP 50R,E00,893775,Carter; Andrea L,0,0,20,20
1745821920202,MMW 11R,A01,892721,Herbst; Matthew,11,0,27,16
1745821920202,MMW 11R,A02,892722,Herbst; Matthew,0,0,0,3
1745821921228,MMW 12R,A01,892724,Herbst; Matthew,0,10,16,16
1745821921228,MMW 12R,A02,892725,Herbst; Matthew,0,9,16,16
1745821922253,MMW 13R,A01,892727,Staff,0,3,16,16
1745821922253,MMW 13R,A02,892728,Staff,0,4,16,16
1745821922253,MMW 13R,A03,958032,Staff,0,3,16,16
1745821922253,MMW 13R,A04,958033,Staff,0,2,16,16
1745821922253,MMW 13R,A05,958034,Staff,0,3,16,16
1745821923280,SIO 295LS,A00,894015,Staff,7,0,25,18
1745821924308,SIO 295S,A00,894020,Staff,7,0,25,18
1745821925334,SIOC 290S,B01,958918,Staff,0,0,0,0
1745821926359,SIOC 291S,B01,958922,Staff,0,0,0,0
1745821927383,SOCI 117,A01,895339,Staff,4,0,5,1
1745821928408,WES 237B,A00,894149,Staff,11,0,20,9
1745821930461,AESE 279B,A00,891859,Staff,13,0,35,22
1745821931488,AIP 197,001,891854,Staff,70,0,70,0
1745821932515,ANTH 289S,A00,891856,Gagneux; Pascal,12,0,12,0
1745821933538,BENG 196,001,957946,Engler; Adam J.,9996,0,9999,3
1745821934563,CAT 124RS,A01,956906,Staff,8,0,25,17
1745821935593,CAT 125RS,A01,922013,Staff,8,0,25,17
1745821936619,CLRE 250,A00,891860,Morris; Sheldon,9995,0,9999,4
1745821938675,CLRE 251R,A00,907817,Mehta; Ravindra L.,9994,0,9999,5
1745821939700,CLRE 252,A00,891864,Cuomo; Raphael Eduardo,9993,0,9999,6
1745821940728,CLRE 253,A00,891867,Vaida; Florin,9994,0,9999,5
1745821940728,CLRE 253,B00,907819,Staff,9999,0,9999,0
1745821941759,CLRE 259,A00,891868,Patel; Hemal,9998,0,9999,1
1745821942786,CLRE 260,A00,891872,Cuomo; Raphael Eduardo,9999,0,9999,0
1745821943815,CLRE 297,001,891888,Cuomo; Raphael Eduardo,9999,0,9999,0
1745821944842,CSE 191,A00,958773,Minnes Kemp; Mor Mia,9999,0,9999,0
1745821945868,CSS 201S,A01,892054,Mignozzetti; Umberto,30,0,30,0
1745821946897,CSS 202S,A01,892056,Mignozzetti; Umberto,30,0,30,0
1745821947926,DSC 197,001,956898,Eldridge; Justin Matthew,9998,0,9999,1
1745821948951,DSC 297,001,958000,Mazumdar; Arya,9998,0,9999,1
1745821949997,EAP 100,A00,905686,Staff,9776,0,9999,223
1745821951023,ECE 45,A01,892618,Staff,0,13,50,50
1745821952047,ECE 109,A01,892620,Staff,0,43,0,0
1745821953072,ECE 111,A01,892719,Staff,0,9,50,50
1745821954099,ECE 197,001,957920,Mercier; Patrick Philip,9992,0,9999,7
1745821955128,ECON 178,A01,907814,Zhu; Ying,28,0,35,7
1745821956152,EDS 115,A00,895312,Staff,41,0,45,4
1745821957177,EDS 117,A01,895337,Staff,30,0,30,0
1745821958202,EDS 125,A00,895341,Jones; Gabrielle Anastasia,43,0,45,2
1745821959227,EDS 128A,A01,895459,Fargason; Sharon Gayle,44,0,45,1
1745821960255,EDS 128B,A01,895543,Pappas; Elizabeth,44,0,45,1
1745821961280,EDS 139,A00,897203,Pappas; Elizabeth,44,0,45,1
1745821961280,EDS 139,B00,897209,Fargason; Sharon Gayle,44,0,45,1
1745821962306,EDS 201,A00,895545,Staff,43,0,45,2
1745821963332,EDS 203,A01,895581,Halter; Christopher P.,43,0,45,2
1745821964361,EDS 204R,A01,895625,Heinzman; Erica M.,43,0,45,2
1745821964361,EDS 204R,B01,895693,Halter; Christopher P.,18,0,45,27
1745821965389,EDS 206R,A00,895694,Fargason; Sharon Gayle,9,0,30,21
1745821965389,EDS 206R,B00,895695,Choi; Bailey Miyeon,20,0,30,10
1745821966414,EDS 250,A00,895697,Hemans; Patricia Ann Benitez,43,0,45,2
1745821967439,EDS 281,A00,895701,Meyerott; Theresa Ann,15,0,15,0
1745821968467,EDS 284,A00,895736,Meyerott; Theresa Ann,15,0,15,0
1745821969494,EDS 286,A00,897210,Fine; Sarah,15,0,15,0
1745821970521,EDS 289C,A01,895770,Daly; Alan J.,15,0,15,0
1745821971545,EDS 290,A00,897211,Hofstetter; Carolyn,15,0,15,0
1745821972568,LIGM 5A,A00,896162,Fischer-Grunski; Eva K,15,0,20,5
1745821973594,LIGM 5B,A00,896260,Fischer-Grunski; Eva K,17,0,20,3
1745821974619,LIGM 5C,A00,896308,Fischer-Grunski; Eva K,18,0,20,2
1745821975644,LIIT 5AS,A00,896313,Carnelos; Chiara,17,0,20,3
1745821976669,LIIT 5BS,A00,896416,Carnelos; Chiara,20,0,20,0
1745821977697,LIIT 5CS,A00,896564,Carnelos; Chiara,20,0,20,0
1745821978721,LISP 5A,A00,896588,Munoz Sanchez; Alicia,4,0,20,16
1745821979761,LISP 5B,A00,896653,Munoz Sanchez; Alicia,10,0,20,10
1745821980791,LISP 5C,A00,896655,Munoz Sanchez; Alicia,4,0,20,16
1745821981816,MAE 197,001,957918,Kleissl; Jan,9998,0,9999,1
1745821982841,MATH 2,A01,957937,Staff,34,0,35,1
1745821983868,MATH 197,001,957876,Kedlaya; Kiran S.,9993,0,9999,6
1745821984895,MCWP 40,A00,892729,Duru; Nur,13,0,20,7
1745821984895,MCWP 40,B00,893304,Montejo; Carolina,20,0,20,0
1745821985923,MCWP 40R,A00,893757,Redela; Pamela Morgan,0,7,20,20
1745821986951,MCWP 50,A00,893758,Morshed; Michael James,2,0,20,18
1745821986951,MCWP 50,B00,893761,Bartulis; Jason Michael,18,0,20,2
1745821987980,MCWP 50R,A00,893766,Compas; Sean Matthew,0,1,20,20
1745821987980,MCWP 50R,B00,893769,Carter; Jennifer A,0,0,20,20
1745821987980,MCWP 50R,C00,893771,Krone; Jarret,0,3,20,20
1745821987980,MCWP 50R,D00,893772,Miller; Elizabeth Deen,3,0,20,17
1745821987980,MCWP 50R,E00,893775,Carter; Andrea L,0,0,20,20
1745821989003,MMW 11R,A01,892721,Herbst; Matthew,11,0,27,16
1745821989003,MMW 11R,A02,892722,Herbst; Matthew,0,0,0,3
1745821990031,MMW 12R,A01,892724,Herbst; Matthew,0,10,16,16
1745821990031,MMW 12R,A02,892725,Herbst; Matthew,0,9,16,16
1745821991070,MMW 13R,A01,892727,Staff,0,3,16,16
1745821991070,MMW 13R,A02,892728,Staff,0,4,16,16
1745821991070,MMW 13R,A03,958032,Staff,0,3,16,16
1745821991070,MMW 13R,A04,958033,Staff,0,2,16,16
1745821991070,MMW 13R,A05,958034,Staff,0,3,16,16
1745821992096,SIO 295LS,A00,894015,Staff,7,0,25,18
1745821993121,SIO 295S,A00,894020,Staff,7,0,25,18
1745821994148,SIOC 290S,B01,958918,Staff,0,0,0,0
1745821995174,SIOC 291S,B01,958922,Staff,0,0,0,0
1745821996198,SOCI 117,A01,895339,Staff,4,0,5,1
1745821997222,WES 237B,A00,894149,Staff,11,0,20,9
1745821999288,AESE 279B,A00,891859,Staff,13,0,35,22
1745822000314,AIP 197,001,891854,Staff,70,0,70,0
1745822001343,ANTH 289S,A00,891856,Gagneux; Pascal,12,0,12,0
1745822002368,BENG 196,001,957946,Engler; Adam J.,9996,0,9999,3
1745822003396,CAT 124RS,A01,956906,Staff,8,0,25,17
1745822004422,CAT 125RS,A01,922013,Staff,8,0,25,17
1745822005447,CLRE 250,A00,891860,Morris; Sheldon,9995,0,9999,4
1745822007499,CLRE 251R,A00,907817,Mehta; Ravindra L.,9994,0,9999,5
1745822008521,CLRE 252,A00,891864,Cuomo; Raphael Eduardo,9993,0,9999,6
1745822009548,CLRE 253,A00,891867,Vaida; Florin,9994,0,9999,5
1745822009548,CLRE 253,B00,907819,Staff,9999,0,9999,0
1745822010577,CLRE 259,A00,891868,Patel; Hemal,9998,0,9999,1
1745822011600,CLRE 260,A00,891872,Cuomo; Raphael Eduardo,9999,0,9999,0
1745822012625,CLRE 297,001,891888,Cuomo; Raphael Eduardo,9999,0,9999,0
1745822013654,CSE 191,A00,958773,Minnes Kemp; Mor Mia,9999,0,9999,0
1745822014680,CSS 201S,A01,892054,Mignozzetti; Umberto,30,0,30,0
1745822015706,CSS 202S,A01,892056,Mignozzetti; Umberto,30,0,30,0
1745822016732,DSC 197,001,956898,Eldridge; Justin Matthew,9998,0,9999,1
1745822017761,DSC 297,001,958000,Mazumdar; Arya,9998,0,9999,1
1745822018787,EAP 100,A00,905686,Staff,9776,0,9999,223
1745822019812,ECE 45,A01,892618,Staff,0,13,50,50
1745822020841,ECE 109,A01,892620,Staff,0,43,0,0
1745822021867,ECE 111,A01,892719,Staff,0,9,50,50
1745822022893,ECE 197,001,957920,Mercier; Patrick Philip,9992,0,9999,7
1745822023919,ECON 178,A01,907814,Zhu; Ying,28,0,35,7
1745822024946,EDS 115,A00,895312,Staff,41,0,45,4
1745822025971,EDS 117,A01,895337,Staff,30,0,30,0
1745822027008,EDS 125,A00,895341,Jones; Gabrielle Anastasia,43,0,45,2
1745822028031,EDS 128A,A01,895459,Fargason; Sharon Gayle,44,0,45,1
1745822029055,EDS 128B,A01,895543,Pappas; Elizabeth,44,0,45,1
1745822030079,EDS 139,A00,897203,Pappas; Elizabeth,44,0,45,1
1745822030079,EDS 139,B00,897209,Fargason; Sharon Gayle,44,0,45,1
1745822031106,EDS 201,A00,895545,Staff,43,0,45,2
1745822032131,EDS 203,A01,895581,Halter; Christopher P.,43,0,45,2
1745822033155,EDS 204R,A01,895625,Heinzman; Erica M.,43,0,45,2
1745822033155,EDS 204R,B01,895693,Halter; Christopher P.,18,0,45,27
1745822034182,EDS 206R,A00,895694,Fargason; Sharon Gayle,9,0,30,21
1745822034182,EDS 206R,B00,895695,Choi; Bailey Miyeon,20,0,30,10
1745822035208,EDS 250,A00,895697,Hemans; Patricia Ann Benitez,43,0,45,2
1745822036232,EDS 281,A00,895701,Meyerott; Theresa Ann,15,0,15,0
1745822037259,EDS 284,A00,895736,Meyerott; Theresa Ann,15,0,15,0
1745822038286,EDS 286,A00,897210,Fine; Sarah,15,0,15,0
1745822039316,EDS 289C,A01,895770,Daly; Alan J.,15,0,15,0
1745822040342,EDS 290,A00,897211,Hofstetter; Carolyn,15,0,15,0
1745822041376,LIGM 5A,A00,896162,Fischer-Grunski; Eva K,15,0,20,5
1745822042405,LIGM 5B,A00,896260,Fischer-Grunski; Eva K,17,0,20,3
1745822043436,LIGM 5C,A00,896308,Fischer-Grunski; Eva K,18,0,20,2
1745822044461,LIIT 5AS,A00,896313,Carnelos; Chiara,17,0,20,3
1745822045487,LIIT 5BS,A00,896416,Carnelos; Chiara,20,0,20,0
1745822046513,LIIT 5CS,A00,896564,Carnelos; Chiara,20,0,20,0
1745822047541,LISP 5A,A00,896588,Munoz Sanchez; Alicia,4,0,20,16
1745822048570,LISP 5B,A00,896653,Munoz Sanchez; Alicia,10,0,20,10
1745822049596,LISP 5C,A00,896655,Munoz Sanchez; Alicia,4,0,20,16
1745822050625,MAE 197,001,957918,Kleissl; Jan,9998,0,9999,1
1745822051655,MATH 2,A01,957937,Staff,34,0,35,1
1745822052680,MATH 197,001,957876,Kedlaya; Kiran S.,9993,0,9999,6
1745822053709,MCWP 40,A00,892729,Duru; Nur,13,0,20,7
1745822053709,MCWP 40,B00,893304,Montejo; Carolina,20,0,20,0
1745822054737,MCWP 40R,A00,893757,Redela; Pamela Morgan,0,7,20,20
1745822055764,MCWP 50,A00,893758,Morshed; Michael James,2,0,20,18
1745822055764,MCWP 50,B00,893761,Bartulis; Jason Michael,18,0,20,2
1745822056794,MCWP 50R,A00,893766,Compas; Sean Matthew,0,1,20,20
1745822056794,MCWP 50R,B00,893769,Carter; Jennifer A,0,0,20,20
1745822056794,MCWP 50R,C00,893771,Krone; Jarret,0,3,20,20
1745822056794,MCWP 50R,D00,893772,Miller; Elizabeth Deen,3,0,20,17
1745822056794,MCWP 50R,E00,893775,Carter; Andrea L,0,0,20,20
1745822057820,MMW 11R,A01,892721,Herbst; Matthew,11,0,27,16
1745822057820,MMW 11R,A02,892722,Herbst; Matthew,0,0,0,3
1745822058847,MMW 12R,A01,892724,Herbst; Matthew,0,10,16,16
1745822058847,MMW 12R,A02,892725,Herbst; Matthew,0,9,16,16
1745822059872,MMW 13R,A01,892727,Staff,0,3,16,16
1745822059872,MMW 13R,A02,892728,Staff,0,4,16,16
1745822059872,MMW 13R,A03,958032,Staff,0,3,16,16
1745822059872,MMW 13R,A04,958033,Staff,0,2,16,16
1745822059872,MMW 13R,A05,958034,Staff,0,3,16,16
1745822060901,SIO 295LS,A00,894015,Staff,7,0,25,18
1745822061929,SIO 295S,A00,894020,Staff,7,0,25,18
1745822062956,SIOC 290S,B01,958918,Staff,0,0,0,0
1745822063986,SIOC 291S,B01,958922,Staff,0,0,0,0
1745822065012,SOCI 117,A01,895339,Staff,4,0,5,1
1745822066042,WES 237B,A00,894149,Staff,11,0,20,9
1745822068132,AESE 279B,A00,891859,Staff,13,0,35,22
1745822069159,AIP 197,001,891854,Staff,70,0,70,0
1745822070184,ANTH 289S,A00,891856,Gagneux; Pascal,12,0,12,0
1745822071211,BENG 196,001,957946,Engler; Adam J.,9996,0,9999,3
1745822072249,CAT 124RS,A01,956906,Staff,8,0,25,17
1745822073274,CAT 125RS,A01,922013,Staff,8,0,25,17
1745822074302,CLRE 250,A00,891860,Morris; Sheldon,9995,0,9999,4
1745822076355,CLRE 251R,A00,907817,Mehta; Ravindra L.,9994,0,9999,5
1745822077379,CLRE 252,A00,891864,Cuomo; Raphael Eduardo,9993,0,9999,6
1745822078406,CLRE 253,A00,891867,Vaida; Florin,9994,0,9999,5
1745822078406,CLRE 253,B00,907819,Staff,9999,0,9999,0
1745822079432,CLRE 259,A00,891868,Patel; Hemal,9998,0,9999,1
1745822080461,CLRE 260,A00,891872,Cuomo; Raphael Eduardo,9999,0,9999,0
1745822081486,CLRE 297,001,891888,Cuomo; Raphael Eduardo,9999,0,9999,0
1745822082512,CSE 191,A00,958773,Minnes Kemp; Mor Mia,9999,0,9999,0
1745822083536,CSS 201S,A01,892054,Mignozzetti; Umberto,30,0,30,0
1745822084561,CSS 202S,A01,892056,Mignozzetti; Umberto,30,0,30,0
1745822085588,DSC 197,001,956898,Eldridge; Justin Matthew,9998,0,9999,1
1745822086612,DSC 297,001,958000,Mazumdar; Arya,9998,0,9999,1
1745822087639,EAP 100,A00,905686,Staff,9776,0,9999,223
1745822088668,ECE 45,A01,892618,Staff,0,13,50,50
1745822089697,ECE 109,A01,892620,Staff,0,43,0,0
1745822090721,ECE 111,A01,892719,Staff,0,9,50,50
1745822091748,ECE 197,001,957920,Mercier; Patrick Philip,9992,0,9999,7
1745822092779,ECON 178,A01,907814,Zhu; Ying,28,0,35,7
1745822093805,EDS 115,A00,895312,Staff,41,0,45,4
1745822094832,EDS 117,A01,895337,Staff,30,0,30,0
1745822095858,EDS 125,A00,895341,Jones; Gabrielle Anastasia,43,0,45,2
1745822096889,EDS 128A,A01,895459,Fargason; Sharon Gayle,44,0,45,1
1745822097915,EDS 128B,A01,895543,Pappas; Elizabeth,44,0,45,1
1745822098941,EDS 139,A00,897203,Pappas; Elizabeth,44,0,45,1
1745822098941,EDS 139,B00,897209,Fargason; Sharon Gayle,44,0,45,1
1745822099968,EDS 201,A00,895545,Staff,43,0,45,2
1745822100993,EDS 203,A01,895581,Halter; Christopher P.,43,0,45,2
1745822102023,EDS 204R,A01,895625,Heinzman; Erica M.,43,0,45,2
1745822102023,EDS 204R,B01,895693,Halter; Christopher P.,18,0,45,27
1745822103054,EDS 206R,A00,895694,Fargason; Sharon Gayle,9,0,30,21
1745822103054,EDS 206R,B00,895695,Choi; Bailey Miyeon,20,0,30,10
1745822104082,EDS 250,A00,895697,Hemans; Patricia Ann Benitez,43,0,45,2
1745822105109,EDS 281,A00,895701,Meyerott; Theresa Ann,15,0,15,0
1745822106137,EDS 284,A00,895736,Meyerott; Theresa Ann,15,0,15,0
1745822107164,EDS 286,A00,897210,Fine; Sarah,15,0,15,0
1745822108192,EDS 289C,A01,895770,Daly; Alan J.,15,0,15,0
1745822109219,EDS 290,A00,897211,Hofstetter; Carolyn,15,0,15,0
1745822110250,LIGM 5A,A00,896162,Fischer-Grunski; Eva K,15,0,20,5
1745822111274,LIGM 5B,A00,896260,Fischer-Grunski; Eva K,17,0,20,3
1745822112301,LIGM 5C,A00,896308,Fischer-Grunski; Eva K,18,0,20,2
1745822113325,LIIT 5AS,A00,896313,Carnelos; Chiara,17,0,20,3
1745822114355,LIIT 5BS,A00,896416,Carnelos; Chiara,20,0,20,0
1745822115381,LIIT 5CS,A00,896564,Carnelos; Chiara,20,0,20,0
1745822116413,LISP 5A,A00,896588,Munoz Sanchez; Alicia,4,0,20,16
1745822117439,LISP 5B,A00,896653,Munoz Sanchez; Alicia,10,0,20,10
1745822118466,LISP 5C,A00,896655,Munoz Sanchez; Alicia,4,0,20,16
1745822119493,MAE 197,001,957918,Kleissl; Jan,9998,0,9999,1
1745822120520,MATH 2,A01,957937,Staff,34,0,35,1
1745822121548,MATH 197,001,957876,Kedlaya; Kiran S.,9993,0,9999,6
1745822122578,MCWP 40,A00,892729,Duru; Nur,13,0,20,7
1745822122578,MCWP 40,B00,893304,Montejo; Carolina,20,0,20,0
1745822123605,MCWP 40R,A00,893757,Redela; Pamela Morgan,0,7,20,20
1745822124634,MCWP 50,A00,893758,Morshed; Michael James,2,0,20,18
1745822124634,MCWP 50,B00,893761,Bartulis; Jason Michael,18,0,20,2
1745822125662,MCWP 50R,A00,893766,Compas; Sean Matthew,0,1,20,20
1745822125662,MCWP 50R,B00,893769,Carter; Jennifer A,0,0,20,20
1745822125662,MCWP 50R,C00,893771,Krone; Jarret,0,3,20,20
1745822125662,MCWP 50R,D00,893772,Miller; Elizabeth Deen,3,0,20,17
1745822125662,MCWP 50R,E00,893775,Carter; Andrea L,0,0,20,20
1745822126690,MMW 11R,A01,892721,Herbst; Matthew,11,0,27,16
1745822126690,MMW 11R,A02,892722,Herbst; Matthew,0,0,0,3
1745822127718,MMW 12R,A01,892724,Herbst; Matthew,0,10,16,16
1745822127718,MMW 12R,A02,892725,Herbst; Matthew,0,9,16,16
1745822128744,MMW 13R,A01,892727,Staff,0,3,16,16
1745822128744,MMW 13R,A02,892728,Staff,0,4,16,16
1745822128744,MMW 13R,A03,958032,Staff,0,3,16,16
1745822128744,MMW 13R,A04,958033,Staff,0,2,16,16
1745822128744,MMW 13R,A05,958034,Staff,0,3,16,16
1745822129771,SIO 295LS,A00,894015,Staff,7,0,25,18
1745822130801,SIO 295S,A00,894020,Staff,7,0,25,18
1745822131827,SIOC 290S,B01,958918,Staff,0,0,0,0
1745822132853,SIOC 291S,B01,958922,Staff,0,0,0,0
1745822133882,SOCI 117,A01,895339,Staff,4,0,5,1
1745822134910,WES 237B,A00,894149,Staff,11,0,20,9
1745822136976,AESE 279B,A00,891859,Staff,13,0,35,22
1745822138002,AIP 197,001,891854,Staff,70,0,70,0
1745822139027,ANTH 289S,A00,891856,Gagneux; Pascal,12,0,12,0
1745822140055,BENG 196,001,957946,Engler; Adam J.,9996,0,9999,3
1745822141081,CAT 124RS,A01,956906,Staff,8,0,25,17
1745822142109,CAT 125RS,A01,922013,Staff,8,0,25,17
1745822143137,CLRE 250,A00,891860,Morris; Sheldon,9995,0,9999,4
1745822145194,CLRE 251R,A00,907817,Mehta; Ravindra L.,9994,0,9999,5
1745822146219,CLRE 252,A00,891864,Cuomo; Raphael Eduardo,9993,0,9999,6
1745822147245,CLRE 253,A00,891867,Vaida; Florin,9994,0,9999,5
1745822147245,CLRE 253,B00,907819,Staff,9999,0,9999,0
1745822148272,CLRE 259,A00,891868,Patel; Hemal,9998,0,9999,1
1745822149296,CLRE 260,A00,891872,Cuomo; Raphael Eduardo,9999,0,9999,0
1745822150324,CLRE 297,001,891888,Cuomo; Raphael Eduardo,9999,0,9999,0
1745822151350,CSE 191,A00,958773,Minnes Kemp; Mor Mia,9999,0,9999,0
1745822152393,CSS 201S,A01,892054,Mignozzetti; Umberto,30,0,30,0
1745822153421,CSS 202S,A01,892056,Mignozzetti; Umberto,30,0,30,0
1745822154446,DSC 197,001,956898,Eldridge; Justin Matthew,9998,0,9999,1
1745822155469,DSC 297,001,958000,Mazumdar; Arya,9998,0,9999,1
1745822156495,EAP 100,A00,905686,Staff,9776,0,9999,223
1745822157523,ECE 45,A01,892618,Staff,0,13,50,50
1745822158547,ECE 109,A01,892620,Staff,0,43,0,0
1745822159576,ECE 111,A01,892719,Staff,0,9,50,50
1745822160605,ECE 197,001,957920,Mercier; Patrick Philip,9992,0,9999,7
1745822161628,ECON 178,A01,907814,Zhu; Ying,28,0,35,7
1745822162654,EDS 115,A00,895312,Staff,41,0,45,4
1745822163679,EDS 117,A01,895337,Staff,30,0,30,0
1745822164708,EDS 125,A00,895341,Jones; Gabrielle Anastasia,43,0,45,2
1745822165737,EDS 128A,A01,895459,Fargason; Sharon Gayle,44,0,45,1
1745822166761,EDS 128B,A01,895543,Pappas; Elizabeth,44,0,45,1
1745822167787,EDS 139,A00,897203,Pappas; Elizabeth,44,0,45,1
1745822167787,EDS 139,B00,897209,Fargason; Sharon Gayle,44,0,45,1
1745822168817,EDS 201,A00,895545,Staff,43,0,45,2
1745822169845,EDS 203,A01,895581,Halter; Christopher P.,43,0,45,2
1745822170870,EDS 204R,A01,895625,Heinzman; Erica M.,43,0,45,2
1745822170870,EDS 204R,B01,895693,Halter; Christopher P.,18,0,45,27
1745822171899,EDS 206R,A00,895694,Fargason; Sharon Gayle,9,0,30,21
1745822171899,EDS 206R,B00,895695,Choi; Bailey Miyeon,20,0,30,10
1745822172928,EDS 250,A00,895697,Hemans; Patricia Ann Benitez,43,0,45,2
1745822173953,EDS 281,A00,895701,Meyerott; Theresa Ann,15,0,15,0
1745822174982,EDS 284,A00,895736,Meyerott; Theresa Ann,15,0,15,0
1745822176009,EDS 286,A00,897210,Fine; Sarah,15,0,15,0
1745822177036,EDS 289C,A01,895770,Daly; Alan J.,15,0,15,0
1745822178067,EDS 290,A00,897211,Hofstetter; Carolyn,15,0,15,0
1745822179093,LIGM 5A,A00,896162,Fischer-Grunski; Eva K,15,0,20,5
1745822180123,LIGM 5B,A00,896260,Fischer-Grunski; Eva K,17,0,20,3
1745822181148,LIGM 5C,A00,896308,Fischer-Grunski; Eva K,18,0,20,2
1745822182176,LIIT 5AS,A00,896313,Carnelos; Chiara,17,0,20,3
1745822183201,LIIT 5BS,A00,896416,Carnelos; Chiara,20,0,20,0
1745822184229,LIIT 5CS,A00,896564,Carnelos; Chiara,20,0,20,0
1745822185259,LISP 5A,A00,896588,Munoz Sanchez; Alicia,4,0,20,16
1745822186287,LISP 5B,A00,896653,Munoz Sanchez; Alicia,10,0,20,10
1745822187314,LISP 5C,A00,896655,Munoz Sanchez; Alicia,4,0,20,16
1745822188339,MAE 197,001,957918,Kleissl; Jan,9998,0,9999,1
1745822189365,MATH 2,A01,957937,Staff,34,0,35,1
1745822190397,MATH 197,001,957876,Kedlaya; Kiran S.,9993,0,9999,6
1745822191422,MCWP 40,A00,892729,Duru; Nur,13,0,20,7
1745822191422,MCWP 40,B00,893304,Montejo; Carolina,20,0,20,0
1745822192449,MCWP 40R,A00,893757,Redela; Pamela Morgan,0,7,20,20
1745822193472,MCWP 50,A00,893758,Morshed; Michael James,2,0,20,18
1745822193472,MCWP 50,B00,893761,Bartulis; Jason Michael,18,0,20,2
1745822194500,MCWP 50R,A00,893766,Compas; Sean Matthew,0,1,20,20
1745822194500,MCWP 50R,B00,893769,Carter; Jennifer A,0,0,20,20
1745822194500,MCWP 50R,C00,893771,Krone; Jarret,0,3,20,20
1745822194500,MCWP 50R,D00,893772,Miller; Elizabeth Deen,3,0,20,17
1745822194500,MCWP 50R,E00,893775,Carter; Andrea L,0,0,20,20
1745822195527,MMW 11R,A01,892721,Herbst; Matthew,11,0,27,16
1745822195527,MMW 11R,A02,892722,Herbst; Matthew,0,0,0,3
1745822196552,MMW 12R,A01,892724,Herbst; Matthew,0,10,16,16
1745822196552,MMW 12R,A02,892725,Herbst; Matthew,0,9,16,16
1745822197579,MMW 13R,A01,892727,Staff,0,3,16,16
1745822197579,MMW 13R,A02,892728,Staff,0,4,16,16
1745822197579,MMW 13R,A03,958032,Staff,0,3,16,16
1745822197579,MMW 13R,A04,958033,Staff,0,2,16,16
1745822197579,MMW 13R,A05,958034,Staff,0,3,16,16
1745822198604,SIO 295LS,A00,894015,Staff,7,0,25,18
1745822199630,SIO 295S,A00,894020,Staff,7,0,25,18
1745822200659,SIOC 290S,B01,958918,Staff,0,0,0,0
1745822201687,SIOC 291S,B01,958922,Staff,0,0,0,0
1745822202711,SOCI 117,A01,895339,Staff,4,0,5,1
1745822203737,WES 237B,A00,894149,Staff,11,0,20,9
1745822205793,AESE 279B,A00,891859,Staff,13,0,35,22
1745822206819,AIP 197,001,891854,Staff,70,0,70,0
1745822207847,ANTH 289S,A00,891856,Gagneux; Pascal,12,0,12,0
1745822208874,BENG 196,001,957946,Engler; Adam J.,9996,0,9999,3
1745822209899,CAT 124RS,A01,956906,Staff,8,0,25,17
1745822210925,CAT 125RS,A01,922013,Staff,8,0,25,17
1745822211952,CLRE 250,A00,891860,Morris; Sheldon,9995,0,9999,4
1745822214007,CLRE 251R,A00,907817,Mehta; Ravindra L.,9994,0,9999,5
1745822215035,CLRE 252,A00,891864,Cuomo; Raphael Eduardo,9993,0,9999,6
1745822216063,CLRE 253,A00,891867,Vaida; Florin,9994,0,9999,5
1745822216063,CLRE 253,B00,907819,Staff,9999,0,9999,0
1745822217089,CLRE 259,A00,891868,Patel; Hemal,9998,0,9999,1
1745822218116,CLRE 260,A00,891872,Cuomo; Raphael Eduardo,9999,0,9999,0
1745822219146,CLRE 297,001,891888,Cuomo; Raphael Eduardo,9999,0,9999,0
1745822220170,CSE 191,A00,958773,Minnes Kemp; Mor Mia,9999,0,9999,0
1745822221221,CSS 201S,A01,892054,Mignozzetti; Umberto,30,0,30,0
1745822222249,CSS 202S,A01,892056,Mignozzetti; Umberto,30,0,30,0
1745822223276,DSC 197,001,956898,Eldridge; Justin Matthew,9998,0,9999,1
1745822224301,DSC 297,001,958000,Mazumdar; Arya,9998,0,9999,1
1745822225327,EAP 100,A00,905686,Staff,9776,0,9999,223
1745822226358,ECE 45,A01,892618,Staff,0,13,50,50
1745822227386,ECE 109,A01,892620,Staff,0,43,0,0
1745822228411,ECE 111,A01,892719,Staff,0,9,50,50
1745822229436,ECE 197,001,957920,Mercier; Patrick Philip,9992,0,9999,7
1745822230465,ECON 178,A01,907814,Zhu; Ying,28,0,35,7
1745822231490,EDS 115,A00,895312,Staff,41,0,45,4
1745822232540,EDS 117,A01,895337,Staff,30,0,30,0
1745822233565,EDS 125,A00,895341,Jones; Gabrielle Anastasia,43,0,45,2
1745822234590,EDS 128A,A01,895459,Fargason; Sharon Gayle,44,0,45,1
1745822235615,EDS 128B,A01,895543,Pappas; Elizabeth,44,0,45,1
1745822236638,EDS 139,A00,897203,Pappas; Elizabeth,44,0,45,1
1745822236638,EDS 139,B00,897209,Fargason; Sharon Gayle,44,0,45,1
1745822237661,EDS 201,A00,895545,Staff,43,0,45,2
1745822238688,EDS 203,A01,895581,Halter; Christopher P.,43,0,45,2
1745822239715,EDS 204R,A01,895625,Heinzman; Erica M.,43,0,45,2
1745822239715,EDS 204R,B01,895693,Halter; Christopher P.,18,0,45,27
1745822240740,EDS 206R,A00,895694,Fargason; Sharon Gayle,9,0,30,21
1745822240740,EDS 206R,B00,895695,Choi; Bailey Miyeon,20,0,30,10
1745822241765,EDS 250,A00,895697,Hemans; Patricia Ann Benitez,43,0,45,2
1745822242789,EDS 281,A00,895701,Meyerott; Theresa Ann,15,0,15,0
1745822243814,EDS 284,A00,895736,Meyerott; Theresa Ann,15,0,15,0
1745822244838,EDS 286,A00,897210,Fine; Sarah,15,0,15,0
1745822245862,EDS 289C,A01,895770,Daly; Alan J.,15,0,15,0
1745822246890,EDS 290,A00,897211,Hofstetter; Carolyn,15,0,15,0
1745822247916,LIGM 5A,A00,896162,Fischer-Grunski; Eva K,15,0,20,5
1745822248942,LIGM 5B,A00,896260,Fischer-Grunski; Eva K,17,0,20,3
1745822249970,LIGM 5C,A00,896308,Fischer-Grunski; Eva K,18,0,20,2
1745822250995,LIIT 5AS,A00,896313,Carnelos; Chiara,17,0,20,3
1745822252021,LIIT 5BS,A00,896416,Carnelos; Chiara,20,0,20,0
1745822253048,LIIT 5CS,A00,896564,Carnelos; Chiara,20,0,20,0
1745822254076,LISP 5A,A00,896588,Munoz Sanchez; Alicia,4,0,20,16
1745822255105,LISP 5B,A00,896653,Munoz Sanchez; Alicia,10,0,20,10
1745822256132,LISP 5C,A00,896655,Munoz Sanchez; Alicia,4,0,20,16
1745822257159,MAE 197,001,957918,Kleissl; Jan,9998,0,9999,1
1745822258186,MATH 2,A01,957937,Staff,34,0,35,1
1745822259214,MATH 197,001,957876,Kedlaya; Kiran S.,9993,0,9999,6
1745822260244,MCWP 40,A00,892729,Duru; Nur,13,0,20,7
1745822260244,MCWP 40,B00,893304,Montejo; Carolina,20,0,20,0
1745822261273,MCWP 40R,A00,893757,Redela; Pamela Morgan,0,7,20,20
1745822262299,MCWP 50,A00,893758,Morshed; Michael James,2,0,20,18
1745822262299,MCWP 50,B00,893761,Bartulis; Jason Michael,18,0,20,2
1745822263328,MCWP 50R,A00,893766,Compas; Sean Matthew,0,1,20,20
1745822263328,MCWP 50R,B00,893769,Carter; Jennifer A,0,0,20,20
1745822263328,MCWP 50R,C00,893771,Krone; Jarret,0,3,20,20
1745822263328,MCWP 50R,D00,893772,Miller; Elizabeth Deen,3,0,20,17
1745822263328,MCWP 50R,E00,893775,Carter; Andrea L,0,0,20,20
1745822264356,MMW 11R,A01,892721,Herbst; Matthew,11,0,27,16
1745822264356,MMW 11R,A02,892722,Herbst; Matthew,0,0,0,3
1745822265383,MMW 12R,A01,892724,Herbst; Matthew,0,10,16,16
1745822265383,MMW 12R,A02,892725,Herbst; Matthew,0,9,16,16
1745822266410,MMW 13R,A01,892727,Staff,0,3,16,16
1745822266410,MMW 13R,A02,892728,Staff,0,4,16,16
1745822266410,MMW 13R,A03,958032,Staff,0,3,16,16
1745822266410,MMW 13R,A04,958033,Staff,0,2,16,16
1745822266410,MMW 13R,A05,958034,Staff,0,3,16,16
1745822267435,SIO 295LS,A00,894015,Staff,7,0,25,18
1745822268461,SIO 295S,A00,894020,Staff,7,0,25,18
1745822269488,SIOC 290S,B01,958918,Staff,0,0,0,0
1745822270513,SIOC 291S,B01,958922,Staff,0,0,0,0
1745822271541,SOCI 117,A01,895339,Staff,4,0,5,1
1745822272569,WES 237B,A00,894149,Staff,11,0,20,9
1745822274632,AESE 279B,A00,891859,Staff,13,0,35,22
1745822275656,AIP 197,001,891854,Staff,70,0,70,0
1745822276681,ANTH 289S,A00,891856,Gagneux; Pascal,12,0,12,0
1745822277708,BENG 196,001,957946,Engler; Adam J.,9996,0,9999,3
1745822278731,CAT 124RS,A01,956906,Staff,8,0,25,17
1745822279757,CAT 125RS,A01,922013,Staff,8,0,25,17
1745822280782,CLRE 250,A00,891860,Morris; Sheldon,9995,0,9999,4
1745822282915,CLRE 251R,A00,907817,Mehta; Ravindra L.,9994,0,9999,5
1745822283947,CLRE 252,A00,891864,Cuomo; Raphael Eduardo,9993,0,9999,6
1745822284973,CLRE 253,A00,891867,Vaida; Florin,9994,0,9999,5
1745822284973,CLRE 253,B00,907819,Staff,9999,0,9999,0
1745822286001,CLRE 259,A00,891868,Patel; Hemal,9998,0,9999,1
1745822287029,CLRE 260,A00,891872,Cuomo; Raphael Eduardo,9999,0,9999,0
1745822288058,CLRE 297,001,891888,Cuomo; Raphael Eduardo,9999,0,9999,0
1745822289089,CSE 191,A00,958773,Minnes Kemp; Mor Mia,9999,0,9999,0
1745822290121,CSS 201S,A01,892054,Mignozzetti; Umberto,30,0,30,0
1745822291148,CSS 202S,A01,892056,Mignozzetti; Umberto,30,0,30,0
1745822292175,DSC 197,001,956898,Eldridge; Justin Matthew,9998,0,9999,1
1745822293201,DSC 297,001,958000,Mazumdar; Arya,9998,0,9999,1
1745822294227,EAP 100,A00,905686,Staff,9776,0,9999,223
1745822295252,ECE 45,A01,892618,Staff,0,13,50,50
1745822296280,ECE 109,A01,892620,Staff,0,43,0,0
1745822297306,ECE 111,A01,892719,Staff,0,9,50,50
1745822298334,ECE 197,001,957920,Mercier; Patrick Philip,9992,0,9999,7
1745822299362,ECON 178,A01,907814,Zhu; Ying,28,0,35,7
1745822300388,EDS 115,A00,895312,Staff,41,0,45,4
1745822301413,EDS 117,A01,895337,Staff,30,0,30,0
1745822302440,EDS 125,A00,895341,Jones; Gabrielle Anastasia,43,0,45,2
1745822303470,EDS 128A,A01,895459,Fargason; Sharon Gayle,44,0,45,1
1745822304497,EDS 128B,A01,895543,Pappas; Elizabeth,44,0,45,1
1745822305525,EDS 139,A00,897203,Pappas; Elizabeth,44,0,45,1
1745822305525,EDS 139,B00,897209,Fargason; Sharon Gayle,44,0,45,1
1745822306551,EDS 201,A00,895545,Staff,43,0,45,2
1745822307579,EDS 203,A01,895581,Halter; Christopher P.,43,0,45,2
1745822308606,EDS 204R,A01,895625,Heinzman; Erica M.,43,0,45,2
1745822308606,EDS 204R,B01,895693,Halter; Christopher P.,18,0,45,27
1745822309634,EDS 206R,A00,895694,Fargason; Sharon Gayle,9,0,30,21
1745822309634,EDS 206R,B00,895695,Choi; Bailey Miyeon,20,0,30,10
1745822310660,EDS 250,A00,895697,Hemans; Patricia Ann Benitez,43,0,45,2
1745822311689,EDS 281,A00,895701,Meyerott; Theresa Ann,15,0,15,0
1745822312716,EDS 284,A00,895736,Meyerott; Theresa Ann,15,0,15,0
1745822313745,EDS 286,A00,897210,Fine; Sarah,15,0,15,0
1745822314774,EDS 289C,A01,895770,Daly; Alan J.,15,0,15,0
1745822315801,EDS 290,A00,897211,Hofstetter; Carolyn,15,0,15,0
1745822316828,LIGM 5A,A00,896162,Fischer-Grunski; Eva K,15,0,20,5
1745822317857,LIGM 5B,A00,896260,Fischer-Grunski; Eva K,17,0,20,3
1745822318882,LIGM 5C,A00,896308,Fischer-Grunski; Eva K,18,0,20,2
1745822319909,LIIT 5AS,A00,896313,Carnelos; Chiara,17,0,20,3
1745822320937,LIIT 5BS,A00,896416,Carnelos; Chiara,20,0,20,0
1745822321965,LIIT 5CS,A00,896564,Carnelos; Chiara,20,0,20,0
1745822322993,LISP 5A,A00,896588,Munoz Sanchez; Alicia,4,0,20,16
1745822324023,LISP 5B,A00,896653,Munoz Sanchez; Alicia,10,0,20,10
1745822325048,LISP 5C,A00,896655,Munoz Sanchez; Alicia,4,0,20,16
1745822326079,MAE 197,001,957918,Kleissl; Jan,9998,0,9999,1
1745822327107,MATH 2,A01,957937,Staff,34,0,35,1
1745822328136,MATH 197,001,957876,Kedlaya; Kiran S.,9993,0,9999,6
1745822329167,MCWP 40,A00,892729,Duru; Nur,13,0,20,7
1745822329167,MCWP 40,B00,893304,Montejo; Carolina,20,0,20,0
1745822330194,MCWP 40R,A00,893757,Redela; Pamela Morgan,0,7,20,20
1745822331222,MCWP 50,A00,893758,Morshed; Michael James,2,0,20,18
1745822331222,MCWP 50,B00,893761,Bartulis; Jason Michael,18,0,20,2
1745822332249,MCWP 50R,A00,893766,Compas; Sean Matthew,0,1,20,20
1745822332249,MCWP 50R,B00,893769,Carter; Jennifer A,0,0,20,20
1745822332249,MCWP 50R,C00,893771,Krone; Jarret,0,3,20,20
1745822332249,MCWP 50R,D00,893772,Miller; Elizabeth Deen,3,0,20,17
1745822332249,MCWP 50R,E00,893775,Carter; Andrea L,0,0,20,20
1745822333276,MMW 11R,A01,892721,Herbst; Matthew,11,0,27,16
1745822333276,MMW 11R,A02,892722,Herbst; Matthew,0,0,0,3
1745822334308,MMW 12R,A01,892724,Herbst; Matthew,0,10,16,16
1745822334308,MMW 12R,A02,892725,Herbst; Matthew,0,9,16,16
1745822335333,MMW 13R,A01,892727,Staff,0,3,16,16
1745822335333,MMW 13R,A02,892728,Staff,0,4,16,16
1745822335333,MMW 13R,A03,958032,Staff,0,3,16,16
1745822335333,MMW 13R,A04,958033,Staff,0,2,16,16
1745822335333,MMW 13R,A05,958034,Staff,0,3,16,16
1745822336357,SIO 295LS,A00,894015,Staff,7,0,25,18
1745822337390,SIO 295S,A00,894020,Staff,7,0,25,18
1745822338426,SIOC 290S,B01,958918,Staff,0,0,0,0
1745822339497,SIOC 291S,B01,958922,Staff,0,0,0,0
1745822340532,SOCI 117,A01,895339,Staff,4,0,5,1
1745822341561,WES 237B,A00,894149,Staff,11,0,20,9
1745822343649,AESE 279B,A00,891859,Staff,13,0,35,22
1745822344679,AIP 197,001,891854,Staff,70,0,70,0
1745822345705,ANTH 289S,A00,891856,Gagneux; Pascal,12,0,12,0
1745822346730,BENG 196,001,957946,Engler; Adam J.,9996,0,9999,3
1745822347758,CAT 124RS,A01,956906,Staff,8,0,25,17
1745822348787,CAT 125RS,A01,922013,Staff,8,0,25,17
1745822349827,CLRE 250,A00,891860,Morris; Sheldon,9995,0,9999,4
1745822351881,CLRE 251R,A00,907817,Mehta; Ravindra L.,9994,0,9999,5
1745822352912,CLRE 252,A00,891864,Cuomo; Raphael Eduardo,9993,0,9999,6
1745822353939,CLRE 253,A00,891867,Vaida; Florin,9994,0,9999,5
1745822353939,CLRE 253,B00,907819,Staff,9999,0,9999,0
1745822354972,CLRE 259,A00,891868,Patel; Hemal,9998,0,9999,1
1745822356002,CLRE 260,A00,891872,Cuomo; Raphael Eduardo,9999,0,9999,0
1745822357030,CLRE 297,001,891888,Cuomo; Raphael Eduardo,9999,0,9999,0
1745822358087,CSE 191,A00,958773,Minnes Kemp; Mor Mia,9999,0,9999,0
1745822359132,CSS 201S,A01,892054,Mignozzetti; Umberto,30,0,30,0
1745822360161,CSS 202S,A01,892056,Mignozzetti; Umberto,30,0,30,0
1745822361190,DSC 197,001,956898,Eldridge; Justin Matthew,9998,0,9999,1
1745822362217,DSC 297,001,958000,Mazumdar; Arya,9998,0,9999,1
1745822363297,EAP 100,A00,905686,Staff,9776,0,9999,223
1745822364323,ECE 45,A01,892618,Staff,0,13,50,50
1745822365353,ECE 109,A01,892620,Staff,0,43,0,0
1745822366380,ECE 111,A01,892719,Staff,0,9,50,50
1745822367406,ECE 197,001,957920,Mercier; Patrick Philip,9992,0,9999,7
1745822368443,ECON 178,A01,907814,Zhu; Ying,28,0,35,7
1745822369474,EDS 115,A00,895312,Staff,41,0,45,4
1745822370499,EDS 117,A01,895337,Staff,30,0,30,0
1745822371536,EDS 125,A00,895341,Jones; Gabrielle Anastasia,43,0,45,2
1745822372577,EDS 128A,A01,895459,Fargason; Sharon Gayle,44,0,45,1
1745822373604,EDS 128B,A01,895543,Pappas; Elizabeth,44,0,45,1
1745822374651,EDS 139,A00,897203,Pappas; Elizabeth,44,0,45,1
1745822374651,EDS 139,B00,897209,Fargason; Sharon Gayle,44,0,45,1
1745822375684,EDS 201,A00,895545,Staff,43,0,45,2
1745822376710,EDS 203,A01,895581,Halter; Christopher P.,43,0,45,2
1745822377740,EDS 204R,A01,895625,Heinzman; Erica M.,43,0,45,2
1745822377740,EDS 204R,B01,895693,Halter; Christopher P.,18,0,45,27
1745822378767,EDS 206R,A00,895694,Fargason; Sharon Gayle,9,0,30,21
1745822378767,EDS 206R,B00,895695,Choi; Bailey Miyeon,20,0,30,10
1745822379797,EDS 250,A00,895697,Hemans; Patricia Ann Benitez,43,0,45,2
1745822380824,EDS 281,A00,895701,Meyerott; Theresa Ann,15,0,15,0
1745822381849,EDS 284,A00,895736,Meyerott; Theresa Ann,15,0,15,0
1745822382875,EDS 286,A00,897210,Fine; Sarah,15,0,15,0
1745822383904,EDS 289C,A01,895770,Daly; Alan J.,15,0,15,0
1745822384930,EDS 290,A00,897211,Hofstetter; Carolyn,15,0,15,0
1745822385959,LIGM 5A,A00,896162,Fischer-Grunski; Eva K,15,0,20,5
1745822386989,LIGM 5B,A00,896260,Fischer-Grunski; Eva K,17,0,20,3
1745822388015,LIGM 5C,A00,896308,Fischer-Grunski; Eva K,18,0,20,2
1745822389045,LIIT 5AS,A00,896313,Carnelos; Chiara,17,0,20,3
1745822390076,LIIT 5BS,A00,896416,Carnelos; Chiara,20,0,20,0
1745822391102,LIIT 5CS,A00,896564,Carnelos; Chiara,20,0,20,0
1745822392132,LISP 5A,A00,896588,Munoz Sanchez; Alicia,4,0,20,16
1745822393156,LISP 5B,A00,896653,Munoz Sanchez; Alicia,10,0,20,10
1745822394182,LISP 5C,A00,896655,Munoz Sanchez; Alicia,4,0,20,16
1745822395211,MAE 197,001,957918,Kleissl; Jan,9998,0,9999,1
1745822396240,MATH 2,A01,957937,Staff,34,0,35,1
1745822397267,MATH 197,001,957876,Kedlaya; Kiran S.,9993,0,9999,6
1745822398293,MCWP 40,A00,892729,Duru; Nur,13,0,20,7
1745822398293,MCWP 40,B00,893304,Montejo; Carolina,20,0,20,0
1745822399321,MCWP 40R,A00,893757,Redela; Pamela Morgan,0,7,20,20
1745822400349,MCWP 50,A00,893758,Morshed; Michael James,2,0,20,18
1745822400349,MCWP 50,B00,893761,Bartulis; Jason Michael,18,0,20,2
1745822401379,MCWP 50R,A00,893766,Compas; Sean Matthew,0,1,20,20
1745822401379,MCWP 50R,B00,893769,Carter; Jennifer A,0,0,20,20
1745822401379,MCWP 50R,C00,893771,Krone; Jarret,0,3,20,20
1745822401379,MCWP 50R,D00,893772,Miller; Elizabeth Deen,3,0,20,17
1745822401379,MCWP 50R,E00,893775,Carter; Andrea L,0,0,20,20
1745822402414,MMW 11R,A01,892721,Herbst; Matthew,11,0,27,16
1745822402414,MMW 11R,A02,892722,Herbst; Matthew,0,0,0,3
1745822403441,MMW 12R,A01,892724,Herbst; Matthew,0,10,16,16
1745822403441,MMW 12R,A02,892725,Herbst; Matthew,0,9,16,16
1745822404466,MMW 13R,A01,892727,Staff,0,3,16,16
1745822404466,MMW 13R,A02,892728,Staff,0,4,16,16
1745822404466,MMW 13R,A03,958032,Staff,0,3,16,16
1745822404466,MMW 13R,A04,958033,Staff,0,2,16,16
1745822404466,MMW 13R,A05,958034,Staff,0,3,16,16
1745822405494,SIO 295LS,A00,894015,Staff,7,0,25,18
1745822406520,SIO 295S,A00,894020,Staff,7,0,25,18
1745822407548,SIOC 290S,B01,958918,Staff,0,0,0,0
1745822408575,SIOC 291S,B01,958922,Staff,0,0,0,0
1745822409602,SOCI 117,A01,895339,Staff,4,0,5,1
1745822410624,WES 237B,A00,894149,Staff,11,0,20,9
1745822412685,AESE 279B,A00,891859,Staff,13,0,35,22
1745822413709,AIP 197,001,891854,Staff,70,0,70,0
1745822414739,ANTH 289S,A00,891856,Gagneux; Pascal,12,0,12,0
1745822415771,BENG 196,001,957946,Engler; Adam J.,9996,0,9999,3
1745822416797,CAT 124RS,A01,956906,Staff,8,0,25,17
1745822417822,CAT 125RS,A01,922013,Staff,8,0,25,17
1745822418850,CLRE 250,A00,891860,Morris; Sheldon,9995,0,9999,4
1745822420906,CLRE 251R,A00,907817,Mehta; Ravindra L.,9994,0,9999,5
1745822421929,CLRE 252,A00,891864,Cuomo; Raphael Eduardo,9993,0,9999,6
1745822422960,CLRE 253,A00,891867,Vaida; Florin,9994,0,9999,5
1745822422960,CLRE 253,B00,907819,Staff,9999,0,9999,0
1745822423996,CLRE 259,A00,891868,Patel; Hemal,9998,0,9999,1
1745822425024,CLRE 260,A00,891872,Cuomo; Raphael Eduardo,9999,0,9999,0
1745822426050,CLRE 297,001,891888,Cuomo; Raphael Eduardo,9999,0,9999,0
1745822427075,CSE 191,A00,958773,Minnes Kemp; Mor Mia,9999,0,9999,0
1745822428105,CSS 201S,A01,892054,Mignozzetti; Umberto,30,0,30,0
1745822429132,CSS 202S,A01,892056,Mignozzetti; Umberto,30,0,30,0
1745822430161,DSC 197,001,956898,Eldridge; Justin Matthew,9998,0,9999,1
1745822431186,DSC 297,001,958000,Mazumdar; Arya,9998,0,9999,1
1745822432211,EAP 100,A00,905686,Staff,9776,0,9999,223
1745822433236,ECE 45,A01,892618,Staff,0,13,50,50
1745822434263,ECE 109,A01,892620,Staff,0,43,0,0
1745822435292,ECE 111,A01,892719,Staff,0,9,50,50
1745822436317,ECE 197,001,957920,Mercier; Patrick Philip,9992,0,9999,7
1745822437343,ECON 178,A01,907814,Zhu; Ying,28,0,35,7
1745822438367,EDS 115,A00,895312,Staff,41,0,45,4
1745822439394,EDS 117,A01,895337,Staff,30,0,30,0
1745822440426,EDS 125,A00,895341,Jones; Gabrielle Anastasia,43,0,45,2
1745822441453,EDS 128A,A01,895459,Fargason; Sharon Gayle,44,0,45,1
1745822442482,EDS 128B,A01,895543,Pappas; Elizabeth,44,0,45,1
1745822443509,EDS 139,A00,897203,Pappas; Elizabeth,44,0,45,1
1745822443509,EDS 139,B00,897209,Fargason; Sharon Gayle,44,0,45,1
1745822444534,EDS 201,A00,895545,Staff,43,0,45,2
1745822445563,EDS 203,A01,895581,Halter; Christopher P.,43,0,45,2
1745822446590,EDS 204R,A01,895625,Heinzman; Erica M.,43,0,45,2
1745822446590,EDS 204R,B01,895693,Halter; Christopher P.,18,0,45,27
1745822447615,EDS 206R,A00,895694,Fargason; Sharon Gayle,9,0,30,21
1745822447615,EDS 206R,B00,895695,Choi; Bailey Miyeon,20,0,30,10
1745822448642,EDS 250,A00,895697,Hemans; Patricia Ann Benitez,43,0,45,2
1745822449668,EDS 281,A00,895701,Meyerott; Theresa Ann,15,0,15,0
1745822450696,EDS 284,A00,895736,Meyerott; Theresa Ann,15,0,15,0
1745822451720,EDS 286,A00,897210,Fine; Sarah,15,0,15,0
1745822452749,EDS 289C,A01,895770,Daly; Alan J.,15,0,15,0
1745822453774,EDS 290,A00,897211,Hofstetter; Carolyn,15,0,15,0
1745822454804,LIGM 5A,A00,896162,Fischer-Grunski; Eva K,15,0,20,5
1745822455831,LIGM 5B,A00,896260,Fischer-Grunski; Eva K,17,0,20,3
1745822456858,LIGM 5C,A00,896308,Fischer-Grunski; Eva K,18,0,20,2
1745822457883,LIIT 5AS,A00,896313,Carnelos; Chiara,17,0,20,3
1745822458913,LIIT 5BS,A00,896416,Carnelos; Chiara,20,0,20,0
1745822459941,LIIT 5CS,A00,896564,Carnelos; Chiara,20,0,20,0
1745822460968,LISP 5A,A00,896588,Munoz Sanchez; Alicia,4,0,20,16
1745822461993,LISP 5B,A00,896653,Munoz Sanchez; Alicia,10,0,20,10
1745822463018,LISP 5C,A00,896655,Munoz Sanchez; Alicia,4,0,20,16
1745822464044,MAE 197,001,957918,Kleissl; Jan,9998,0,9999,1
1745822465073,MATH 2,A01,957937,Staff,34,0,35,1
1745822466099,MATH 197,001,957876,Kedlaya; Kiran S.,9993,0,9999,6
1745822467129,MCWP 40,A00,892729,Duru; Nur,13,0,20,7
1745822467129,MCWP 40,B00,893304,Montejo; Carolina,20,0,20,0
1745822468157,MCWP 40R,A00,893757,Redela; Pamela Morgan,0,7,20,20
1745822469182,MCWP 50,A00,893758,Morshed; Michael James,2,0,20,18
1745822469182,MCWP 50,B00,893761,Bartulis; Jason Michael,18,0,20,2
1745822470210,MCWP 50R,A00,893766,Compas; Sean Matthew,0,1,20,20
1745822470210,MCWP 50R,B00,893769,Carter; Jennifer A,0,0,20,20
1745822470210,MCWP 50R,C00,893771,Krone; Jarret,0,3,20,20
1745822470210,MCWP 50R,D00,893772,Miller; Elizabeth Deen,3,0,20,17
1745822470210,MCWP 50R,E00,893775,Carter; Andrea L,0,0,20,20
1745822471236,MMW 11R,A01,892721,Herbst; Matthew,11,0,27,16
1745822471236,MMW 11R,A02,892722,Herbst; Matthew,0,0,0,3
1745822472265,MMW 12R,A01,892724,Herbst; Matthew,0,10,16,16
1745822472265,MMW 12R,A02,892725,Herbst; Matthew,0,9,16,16
1745822473296,MMW 13R,A01,892727,Staff,0,3,16,16
1745822473296,MMW 13R,A02,892728,Staff,0,4,16,16
1745822473296,MMW 13R,A03,958032,Staff,0,3,16,16
1745822473296,MMW 13R,A04,958033,Staff,0,2,16,16
1745822473296,MMW 13R,A05,958034,Staff,0,3,16,16
1745822474325,SIO 295LS,A00,894015,Staff,7,0,25,18
1745822475351,SIO 295S,A00,894020,Staff,7,0,25,18
1745822476379,SIOC 290S,B01,958918,Staff,0,0,0,0
1745822477406,SIOC 291S,B01,958922,Staff,0,0,0,0
1745822478435,SOCI 117,A01,895339,Staff,4,0,5,1
1745822479461,WES 237B,A00,894149,Staff,11,0,20,9
1745822481521,AESE 279B,A00,891859,Staff,13,0,35,22
1745822482546,AIP 197,001,891854,Staff,70,0,70,0
1745822483576,ANTH 289S,A00,891856,Gagneux; Pascal,12,0,12,0
1745822484604,BENG 196,001,957946,Engler; Adam J.,9996,0,9999,3
1745822485630,CAT 124RS,A01,956906,Staff,8,0,25,17
1745822486656,CAT 125RS,A01,922013,Staff,8,0,25,17
1745822487682,CLRE 250,A00,891860,Morris; Sheldon,9995,0,9999,4
1745822489734,CLRE 251R,A00,907817,Mehta; Ravindra L.,9994,0,9999,5
1745822490765,CLRE 252,A00,891864,Cuomo; Raphael Eduardo,9993,0,9999,6
1745822491794,CLRE 253,A00,891867,Vaida; Florin,9994,0,9999,5
1745822491794,CLRE 253,B00,907819,Staff,9999,0,9999,0
1745822492820,CLRE 259,A00,891868,Patel; Hemal,9998,0,9999,1
1745822493847,CLRE 260,A00,891872,Cuomo; Raphael Eduardo,9999,0,9999,0
1745822494872,CLRE 297,001,891888,Cuomo; Raphael Eduardo,9999,0,9999,0
1745822495899,CSE 191,A00,958773,Minnes Kemp; Mor Mia,9999,0,9999,0
1745822496927,CSS 201S,A01,892054,Mignozzetti; Umberto,30,0,30,0
1745822497957,CSS 202S,A01,892056,Mignozzetti; Umberto,30,0,30,0
1745822498984,DSC 197,001,956898,Eldridge; Justin Matthew,9998,0,9999,1
1745822500014,DSC 297,001,958000,Mazumdar; Arya,9998,0,9999,1
1745822501044,EAP 100,A00,905686,Staff,9776,0,9999,223
1745822502073,ECE 45,A01,892618,Staff,0,13,50,50
1745822503121,ECE 109,A01,892620,Staff,0,43,0,0
1745822504149,ECE 111,A01,892719,Staff,0,9,50,50
1745822505175,ECE 197,001,957920,Mercier; Patrick Philip,9992,0,9999,7
1745822506201,ECON 178,A01,907814,Zhu; Ying,28,0,35,7
1745822507226,EDS 115,A00,895312,Staff,41,0,45,4
1745822508250,EDS 117,A01,895337,Staff,30,0,30,0
1745822509339,EDS 125,A00,895341,Jones; Gabrielle Anastasia,43,0,45,2
1745822510362,EDS 128A,A01,895459,Fargason; Sharon Gayle,44,0,45,1
1745822511437,EDS 128B,A01,895543,Pappas; Elizabeth,44,0,45,1
1745822512467,EDS 139,A00,897203,Pappas; Elizabeth,44,0,45,1
1745822512467,EDS 139,B00,897209,Fargason; Sharon Gayle,44,0,45,1
1745822513492,EDS 201,A00,895545,Staff,43,0,45,2
1745822514523,EDS 203,A01,895581,Halter; Christopher P.,43,0,45,2
1745822515547,EDS 204R,A01,895625,Heinzman; Erica M.,43,0,45,2
1745822515547,EDS 204R,B01,895693,Halter; Christopher P.,18,0,45,27
1745822516579,EDS 206R,A00,895694,Fargason; Sharon Gayle,9,0,30,21
1745822516579,EDS 206R,B00,895695,Choi; Bailey Miyeon,20,0,30,10
1745822517603,EDS 250,A00,895697,Hemans; Patricia Ann Benitez,43,0,45,2
1745822518628,EDS 281,A00,895701,Meyerott; Theresa Ann,15,0,15,0
1745822519655,EDS 284,A00,895736,Meyerott; Theresa Ann,15,0,15,0
1745822520682,EDS 286,A00,897210,Fine; Sarah,15,0,15,0
1745822521712,EDS 289C,A01,895770,Daly; Alan J.,15,0,15,0
1745822522740,EDS 290,A00,897211,Hofstetter; Carolyn,15,0,15,0
1745822523768,LIGM 5A,A00,896162,Fischer-Grunski; Eva K,15,0,20,5
1745822524796,LIGM 5B,A00,896260,Fischer-Grunski; Eva K,17,0,20,3
1745822525822,LIGM 5C,A00,896308,Fischer-Grunski; Eva K,18,0,20,2
1745822526867,LIIT 5AS,A00,896313,Carnelos; Chiara,17,0,20,3
1745822527894,LIIT 5BS,A00,896416,Carnelos; Chiara,20,0,20,0
1745822528920,LIIT 5CS,A00,896564,Carnelos; Chiara,20,0,20,0
1745822529946,LISP 5A,A00,896588,Munoz Sanchez; Alicia,4,0,20,16
1745822530976,LISP 5B,A00,896653,Munoz Sanchez; Alicia,10,0,20,10
1745822532005,LISP 5C,A00,896655,Munoz Sanchez; Alicia,4,0,20,16
1745822533032,MAE 197,001,957918,Kleissl; Jan,9998,0,9999,1
1745822534057,MATH 2,A01,957937,Staff,34,0,35,1
1745822535081,MATH 197,001,957876,Kedlaya; Kiran S.,9993,0,9999,6
1745822536109,MCWP 40,A00,892729,Duru; Nur,13,0,20,7
1745822536109,MCWP 40,B00,893304,Montejo; Carolina,20,0,20,0
1745822537137,MCWP 40R,A00,893757,Redela; Pamela Morgan,0,7,20,20
1745822538161,MCWP 50,A00,893758,Morshed; Michael James,2,0,20,18
1745822538161,MCWP 50,B00,893761,Bartulis; Jason Michael,18,0,20,2
1745822539187,MCWP 50R,A00,893766,Compas; Sean Matthew,0,1,20,20
1745822539187,MCWP 50R,B00,893769,Carter; Jennifer A,0,0,20,20
1745822539187,MCWP 50R,C00,893771,Krone; Jarret,0,3,20,20
1745822539187,MCWP 50R,D00,893772,Miller; Elizabeth Deen,3,0,20,17
1745822539187,MCWP 50R,E00,893775,Carter; Andrea L,0,0,20,20
1745822540212,MMW 11R,A01,892721,Herbst; Matthew,11,0,27,16
1745822540212,MMW 11R,A02,892722,Herbst; Matthew,0,0,0,3
1745822541238,MMW 12R,A01,892724,Herbst; Matthew,0,10,16,16
1745822541238,MMW 12R,A02,892725,Herbst; Matthew,0,9,16,16
1745822542266,MMW 13R,A01,892727,Staff,0,3,16,16
1745822542266,MMW 13R,A02,892728,Staff,0,4,16,16
1745822542266,MMW 13R,A03,958032,Staff,0,3,16,16
1745822542266,MMW 13R,A04,958033,Staff,0,2,16,16
1745822542266,MMW 13R,A05,958034,Staff,0,3,16,16
1745822543291,SIO 295LS,A00,894015,Staff,7,0,25,18
1745822544317,SIO 295S,A00,894020,Staff,7,0,25,18
1745822545395,SIOC 290S,B01,958918,Staff,0,0,0,0
1745822546425,SIOC 291S,B01,958922,Staff,0,0,0,0
1745822547452,SOCI 117,A01,895339,Staff,4,0,5,1
1745822548480,WES 237B,A00,894149,Staff,11,0,20,9
1745822550540,AESE 279B,A00,891859,Staff,13,0,35,22
1745822551567,AIP 197,001,891854,Staff,70,0,70,0
1745822552595,ANTH 289S,A00,891856,Gagneux; Pascal,12,0,12,0
1745822553619,BENG 196,001,957946,Engler; Adam J.,9996,0,9999,3
1745822554646,CAT 124RS,A01,956906,Staff,8,0,25,17
1745822555674,CAT 125RS,A01,922013,Staff,8,0,25,17
1745822556700,CLRE 250,A00,891860,Morris; Sheldon,9995,0,9999,4
1745822558750,CLRE 251R,A00,907817,Mehta; Ravindra L.,9994,0,9999,5
1745822559777,CLRE 252,A00,891864,Cuomo; Raphael Eduardo,9993,0,9999,6
1745822560807,CLRE 253,A00,891867,Vaida; Florin,9994,0,9999,5
1745822560807,CLRE 253,B00,907819,Staff,9999,0,9999,0
1745822561831,CLRE 259,A00,891868,Patel; Hemal,9998,0,9999,1
1745822562880,CLRE 260,A00,891872,Cuomo; Raphael Eduardo,9999,0,9999,0
1745822563905,CLRE 297,001,891888,Cuomo; Raphael Eduardo,9999,0,9999,0
1745822564930,CSE 191,A00,958773,Minnes Kemp; Mor Mia,9999,0,9999,0
1745822565961,CSS 201S,A01,892054,Mignozzetti; Umberto,30,0,30,0
1745822566990,CSS 202S,A01,892056,Mignozzetti; Umberto,30,0,30,0
1745822568018,DSC 197,001,956898,Eldridge; Justin Matthew,9998,0,9999,1
1745822569046,DSC 297,001,958000,Mazumdar; Arya,9998,0,9999,1
1745822570075,EAP 100,A00,905686,Staff,9776,0,9999,223
1745822571103,ECE 45,A01,892618,Staff,0,13,50,50
1745822572128,ECE 109,A01,892620,Staff,0,43,0,0
1745822573154,ECE 111,A01,892719,Staff,0,9,50,50
1745822574180,ECE 197,001,957920,Mercier; Patrick Philip,9992,0,9999,7
1745822575206,ECON 178,A01,907814,Zhu; Ying,28,0,35,7
1745822576233,EDS 115,A00,895312,Staff,41,0,45,4
1745822577262,EDS 117,A01,895337,Staff,30,0,30,0
1745822578289,EDS 125,A00,895341,Jones; Gabrielle Anastasia,43,0,45,2
1745822579319,EDS 128A,A01,895459,Fargason; Sharon Gayle,44,0,45,1
1745822580347,EDS 128B,A01,895543,Pappas; Elizabeth,44,0,45,1
1745822581371,EDS 139,A00,897203,Pappas; Elizabeth,44,0,45,1
1745822581371,EDS 139,B00,897209,Fargason; Sharon Gayle,44,0,45,1
1745822582398,EDS 201,A00,895545,Staff,43,0,45,2
1745822583423,EDS 203,A01,895581,Halter; Christopher P.,43,0,45,2
1745822584448,EDS 204R,A01,895625,Heinzman; Erica M.,43,0,45,2
1745822584448,EDS 204R,B01,895693,Halter; Christopher P.,18,0,45,27
1745822585477,EDS 206R,A00,895694,Fargason; Sharon Gayle,9,0,30,21
1745822585477,EDS 206R,B00,895695,Choi; Bailey Miyeon,20,0,30,10
1745822586503,EDS 250,A00,895697,Hemans; Patricia Ann Benitez,43,0,45,2
1745822587528,EDS 281,A00,895701,Meyerott; Theresa Ann,15,0,15,0
1745822588552,EDS 284,A00,895736,Meyerott; Theresa Ann,15,0,15,0
1745822589576,EDS 286,A00,897210,Fine; Sarah,15,0,15,0
1745822590619,EDS 289C,A01,895770,Daly; Alan J.,15,0,15,0
1745822591649,EDS 290,A00,897211,Hofstetter; Carolyn,15,0,15,0
1745822592678,LIGM 5A,A00,896162,Fischer-Grunski; Eva K,15,0,20,5
1745822593705,LIGM 5B,A00,896260,Fischer-Grunski; Eva K,17,0,20,3
1745822594731,LIGM 5C,A00,896308,Fischer-Grunski; Eva K,18,0,20,2
1745822595757,LIIT 5AS,A00,896313,Carnelos; Chiara,17,0,20,3
1745822596781,LIIT 5BS,A00,896416,Carnelos; Chiara,20,0,20,0
1745822597807,LIIT 5CS,A00,896564,Carnelos; Chiara,20,0,20,0
1745822598834,LISP 5A,A00,896588,Munoz Sanchez; Alicia,4,0,20,16
1745822599862,LISP 5B,A00,896653,Munoz Sanchez; Alicia,10,0,20,10
1745822600887,LISP 5C,A00,896655,Munoz Sanchez; Alicia,4,0,20,16
1745822601915,MAE 197,001,957918,Kleissl; Jan,9998,0,9999,1
1745822602942,MATH 2,A01,957937,Staff,34,0,35,1
1745822603968,MATH 197,001,957876,Kedlaya; Kiran S.,9993,0,9999,6
1745822604994,MCWP 40,A00,892729,Duru; Nur,13,0,20,7
1745822604994,MCWP 40,B00,893304,Montejo; Carolina,20,0,20,0
1745822606021,MCWP 40R,A00,893757,Redela; Pamela Morgan,0,7,20,20
1745822607078,MCWP 50,A00,893758,Morshed; Michael James,2,0,20,18
1745822607078,MCWP 50,B00,893761,Bartulis; Jason Michael,18,0,20,2
1745822608106,MCWP 50R,A00,893766,Compas; Sean Matthew,0,1,20,20
1745822608106,MCWP 50R,B00,893769,Carter; Jennifer A,0,0,20,20
1745822608106,MCWP 50R,C00,893771,Krone; Jarret,0,3,20,20
1745822608106,MCWP 50R,D00,893772,Miller; Elizabeth Deen,3,0,20,17
1745822608106,MCWP 50R,E00,893775,Carter; Andrea L,0,0,20,20
1745822609134,MMW 11R,A01,892721,Herbst; Matthew,11,0,27,16
1745822609134,MMW 11R,A02,892722,Herbst; Matthew,0,0,0,3
1745822610162,MMW 12R,A01,892724,Herbst; Matthew,0,10,16,16
1745822610162,MMW 12R,A02,892725,Herbst; Matthew,0,9,16,16
1745822611187,MMW 13R,A01,892727,Staff,0,3,16,16
1745822611187,MMW 13R,A02,892728,Staff,0,4,16,16
1745822611187,MMW 13R,A03,958032,Staff,0,3,16,16
1745822611187,MMW 13R,A04,958033,Staff,0,2,16,16
1745822611187,MMW 13R,A05,958034,Staff,0,3,16,16
1745822612213,SIO 295LS,A00,894015,Staff,7,0,25,18
1745822613240,SIO 295S,A00,894020,Staff,7,0,25,18
1745822614270,SIOC 290S,B01,958918,Staff,0,0,0,0
1745822615297,SIOC 291S,B01,958922,Staff,0,0,0,0
1745822616325,SOCI 117,A01,895339,Staff,4,0,5,1
1745822617352,WES 237B,A00,894149,Staff,11,0,20,9
1745822619415,AESE 279B,A00,891859,Staff,13,0,35,22
1745822620443,AIP 197,001,891854,Staff,70,0,70,0
1745822621468,ANTH 289S,A00,891856,Gagneux; Pascal,12,0,12,0
1745822622495,BENG 196,001,957946,Engler; Adam J.,9996,0,9999,3
1745822623524,CAT 124RS,A01,956906,Staff,8,0,25,17
1745822624755,CAT 125RS,A01,922013,Staff,8,0,25,17
1745822625781,CLRE 250,A00,891860,Morris; Sheldon,9995,0,9999,4
1745822627832,CLRE 251R,A00,907817,Mehta; Ravindra L.,9994,0,9999,5
1745822628861,CLRE 252,A00,891864,Cuomo; Raphael Eduardo,9993,0,9999,6
1745822629886,CLRE 253,A00,891867,Vaida; Florin,9994,0,9999,5
1745822629886,CLRE 253,B00,907819,Staff,9999,0,9999,0
1745822630911,CLRE 259,A00,891868,Patel; Hemal,9998,0,9999,1
1745822631940,CLRE 260,A00,891872,Cuomo; Raphael Eduardo,9999,0,9999,0
1745822632967,CLRE 297,001,891888,Cuomo; Raphael Eduardo,9999,0,9999,0
1745822633991,CSE 191,A00,958773,Minnes Kemp; Mor Mia,9999,0,9999,0
1745822635023,CSS 201S,A01,892054,Mignozzetti; Umberto,30,0,30,0
1745822636054,CSS 202S,A01,892056,Mignozzetti; Umberto,30,0,30,0
1745822637080,DSC 197,001,956898,Eldridge; Justin Matthew,9998,0,9999,1
1745822638109,DSC 297,001,958000,Mazumdar; Arya,9998,0,9999,1
1745822639137,EAP 100,A00,905686,Staff,9776,0,9999,223
1745822640163,ECE 45,A01,892618,Staff,0,13,50,50
1745822641192,ECE 109,A01,892620,Staff,0,43,0,0
1745822642218,ECE 111,A01,892719,Staff,0,9,50,50
1745822643244,ECE 197,001,957920,Mercier; Patrick Philip,9992,0,9999,7
1745822644269,ECON 178,A01,907814,Zhu; Ying,28,0,35,7
1745822645294,EDS 115,A00,895312,Staff,41,0,45,4
1745822646320,EDS 117,A01,895337,Staff,30,0,30,0
1745822647347,EDS 125,A00,895341,Jones; Gabrielle Anastasia,43,0,45,2
1745822648374,EDS 128A,A01,895459,Fargason; Sharon Gayle,44,0,45,1
1745822649400,EDS 128B,A01,895543,Pappas; Elizabeth,44,0,45,1
1745822650427,EDS 139,A00,897203,Pappas; Elizabeth,44,0,45,1
1745822650427,EDS 139,B00,897209,Fargason; Sharon Gayle,44,0,45,1
1745822651453,EDS 201,A00,895545,Staff,43,0,45,2
1745822652478,EDS 203,A01,895581,Halter; Christopher P.,43,0,45,2
1745822653503,EDS 204R,A01,895625,Heinzman; Erica M.,43,0,45,2
1745822653503,EDS 204R,B01,895693,Halter; Christopher P.,18,0,45,27
1745822654530,EDS 206R,A00,895694,Fargason; Sharon Gayle,9,0,30,21
1745822654530,EDS 206R,B00,895695,Choi; Bailey Miyeon,20,0,30,10
1745822655555,EDS 250,A00,895697,Hemans; Patricia Ann Benitez,43,0,45,2
1745822656579,EDS 281,A00,895701,Meyerott; Theresa Ann,15,0,15,0
1745822657608,EDS 284,A00,895736,Meyerott; Theresa Ann,15,0,15,0
1745822658635,EDS 286,A00,897210,Fine; Sarah,15,0,15,0
1745822659660,EDS 289C,A01,895770,Daly; Alan J.,15,0,15,0
1745822660686,EDS 290,A00,897211,Hofstetter; Carolyn,15,0,15,0
1745822661715,LIGM 5A,A00,896162,Fischer-Grunski; Eva K,15,0,20,5
1745822662743,LIGM 5B,A00,896260,Fischer-Grunski; Eva K,17,0,20,3
1745822663772,LIGM 5C,A00,896308,Fischer-Grunski; Eva K,18,0,20,2
1745822664798,LIIT 5AS,A00,896313,Carnelos; Chiara,17,0,20,3
1745822665826,LIIT 5BS,A00,896416,Carnelos; Chiara,20,0,20,0
1745822666852,LIIT 5CS,A00,896564,Carnelos; Chiara,20,0,20,0
1745822667878,LISP 5A,A00,896588,Munoz Sanchez; Alicia,4,0,20,16
1745822668904,LISP 5B,A00,896653,Munoz Sanchez; Alicia,10,0,20,10
1745822669930,LISP 5C,A00,896655,Munoz Sanchez; Alicia,4,0,20,16
1745822670956,MAE 197,001,957918,Kleissl; Jan,9998,0,9999,1
1745822671983,MATH 2,A01,957937,Staff,34,0,35,1
1745822673007,MATH 197,001,957876,Kedlaya; Kiran S.,9993,0,9999,6
1745822674037,MCWP 40,A00,892729,Duru; Nur,13,0,20,7
1745822674037,MCWP 40,B00,893304,Montejo; Carolina,20,0,20,0
1745822675065,MCWP 40R,A00,893757,Redela; Pamela Morgan,0,7,20,20
1745822676091,MCWP 50,A00,893758,Morshed; Michael James,2,0,20,18
1745822676091,MCWP 50,B00,893761,Bartulis; Jason Michael,18,0,20,2
1745822677122,MCWP 50R,A00,893766,Compas; Sean Matthew,0,1,20,20
1745822677122,MCWP 50R,B00,893769,Carter; Jennifer A,0,0,20,20
1745822677122,MCWP 50R,C00,893771,Krone; Jarret,0,3,20,20
1745822677122,MCWP 50R,D00,893772,Miller; Elizabeth Deen,3,0,20,17
1745822677122,MCWP 50R,E00,893775,Carter; Andrea L,0,0,20,20
1745822678149,MMW 11R,A01,892721,Herbst; Matthew,11,0,27,16
1745822678149,MMW 11R,A02,892722,Herbst; Matthew,0,0,0,3
1745822679175,MMW 12R,A01,892724,Herbst; Matthew,0,10,16,16
1745822679175,MMW 12R,A02,892725,Herbst; Matthew,0,9,16,16
1745822680222,MMW 13R,A01,892727,Staff,0,3,16,16
1745822680222,MMW 13R,A02,892728,Staff,0,4,16,16
1745822680222,MMW 13R,A03,958032,Staff,0,3,16,16
1745822680222,MMW 13R,A04,958033,Staff,0,2,16,16
1745822680222,MMW 13R,A05,958034,Staff,0,3,16,16
1745822681251,SIO 295LS,A00,894015,Staff,7,0,25,18
1745822682277,SIO 295S,A00,894020,Staff,7,0,25,18
1745822683307,SIOC 290S,B01,958918,Staff,0,0,0,0
1745822684334,SIOC 291S,B01,958922,Staff,0,0,0,0
1745822685359,SOCI 117,A01,895339,Staff,4,0,5,1
1745822686387,WES 237B,A00,894149,Staff,11,0,20,9
1745822688443,AESE 279B,A00,891859,Staff,13,0,35,22
1745822689471,AIP 197,001,891854,Staff,70,0,70,0
1745822690500,ANTH 289S,A00,891856,Gagneux; Pascal,12,0,12,0
1745822691527,BENG 196,001,957946,Engler; Adam J.,9996,0,9999,3
1745822692553,CAT 124RS,A01,956906,Staff,8,0,25,17
1745822693583,CAT 125RS,A01,922013,Staff,8,0,25,17
1745822694611,CLRE 250,A00,891860,Morris; Sheldon,9995,0,9999,4
1745822696667,CLRE 251R,A00,907817,Mehta; Ravindra L.,9994,0,9999,5
1745822697692,CLRE 252,A00,891864,Cuomo; Raphael Eduardo,9993,0,9999,6
1745822698720,CLRE 253,A00,891867,Vaida; Florin,9994,0,9999,5
1745822698720,CLRE 253,B00,907819,Staff,9999,0,9999,0
1745822699747,CLRE 259,A00,891868,Patel; Hemal,9998,0,9999,1
1745822700773,CLRE 260,A00,891872,Cuomo; Raphael Eduardo,9999,0,9999,0
1745822701800,CLRE 297,001,891888,Cuomo; Raphael Eduardo,9999,0,9999,0
1745822702826,CSE 191,A00,958773,Minnes Kemp; Mor Mia,9999,0,9999,0
1745822703855,CSS 201S,A01,892054,Mignozzetti; Umberto,30,0,30,0
1745822704886,CSS 202S,A01,892056,Mignozzetti; Umberto,30,0,30,0
1745822705920,DSC 197,001,956898,Eldridge; Justin Matthew,9998,0,9999,1
1745822706949,DSC 297,001,958000,Mazumdar; Arya,9998,0,9999,1
1745822707975,EAP 100,A00,905686,Staff,9776,0,9999,223
1745822709005,ECE 45,A01,892618,Staff,0,13,50,50
1745822710032,ECE 109,A01,892620,Staff,0,43,0,0
1745822711058,ECE 111,A01,892719,Staff,0,9,50,50
1745822712087,ECE 197,001,957920,Mercier; Patrick Philip,9992,0,9999,7
1745822713116,ECON 178,A01,907814,Zhu; Ying,28,0,35,7
1745822714141,EDS 115,A00,895312,Staff,41,0,45,4
1745822715168,EDS 117,A01,895337,Staff,30,0,30,0
1745822716197,EDS 125,A00,895341,Jones; Gabrielle Anastasia,43,0,45,2
1745822717223,EDS 128A,A01,895459,Fargason; Sharon Gayle,44,0,45,1
1745822718252,EDS 128B,A01,895543,Pappas; Elizabeth,44,0,45,1
1745822719279,EDS 139,A00,897203,Pappas; Elizabeth,44,0,45,1
1745822719279,EDS 139,B00,897209,Fargason; Sharon Gayle,44,0,45,1
1745822720305,EDS 201,A00,895545,Staff,43,0,45,2
1745822721335,EDS 203,A01,895581,Halter; Christopher P.,43,0,45,2
1745822722361,EDS 204R,A01,895625,Heinzman; Erica M.,43,0,45,2
1745822722361,EDS 204R,B01,895693,Halter; Christopher P.,18,0,45,27
1745822723387,EDS 206R,A00,895694,Fargason; Sharon Gayle,9,0,30,21
1745822723387,EDS 206R,B00,895695,Choi; Bailey Miyeon,20,0,30,10
1745822724413,EDS 250,A00,895697,Hemans; Patricia Ann Benitez,43,0,45,2
1745822725440,EDS 281,A00,895701,Meyerott; Theresa Ann,15,0,15,0
1745822726468,EDS 284,A00,895736,Meyerott; Theresa Ann,15,0,15,0
1745822727494,EDS 286,A00,897210,Fine; Sarah,15,0,15,0
1745822728519,EDS 289C,A01,895770,Daly; Alan J.,15,0,15,0
1745822729546,EDS 290,A00,897211,Hofstetter; Carolyn,15,0,15,0
1745822730573,LIGM 5A,A00,896162,Fischer-Grunski; Eva K,15,0,20,5
1745822731598,LIGM 5B,A00,896260,Fischer-Grunski; Eva K,17,0,20,3
1745822732623,LIGM 5C,A00,896308,Fischer-Grunski; Eva K,18,0,20,2
1745822733648,LIIT 5AS,A00,896313,Carnelos; Chiara,17,0,20,3
1745822734675,LIIT 5BS,A00,896416,Carnelos; Chiara,20,0,20,0
1745822735700,LIIT 5CS,A00,896564,Carnelos; Chiara,20,0,20,0
1745822736726,LISP 5A,A00,896588,Munoz Sanchez; Alicia,4,0,20,16
1745822737751,LISP 5B,A00,896653,Munoz Sanchez; Alicia,10,0,20,10
1745822738780,LISP 5C,A00,896655,Munoz Sanchez; Alicia,4,0,20,16
1745822739810,MAE 197,001,957918,Kleissl; Jan,9998,0,9999,1
1745822740835,MATH 2,A01,957937,Staff,34,0,35,1
1745822741861,MATH 197,001,957876,Kedlaya; Kiran S.,9993,0,9999,6
1745822742887,MCWP 40,A00,892729,Duru; Nur,13,0,20,7
1745822742887,MCWP 40,B00,893304,Montejo; Carolina,20,0,20,0
1745822743913,MCWP 40R,A00,893757,Redela; Pamela Morgan,0,7,20,20
1745822744938,MCWP 50,A00,893758,Morshed; Michael James,2,0,20,18
1745822744938,MCWP 50,B00,893761,Bartulis; Jason Michael,18,0,20,2
1745822745967,MCWP 50R,A00,893766,Compas; Sean Matthew,0,1,20,20
1745822745967,MCWP 50R,B00,893769,Carter; Jennifer A,0,0,20,20
1745822745967,MCWP 50R,C00,893771,Krone; Jarret,0,3,20,20
1745822745967,MCWP 50R,D00,893772,Miller; Elizabeth Deen,3,0,20,17
1745822745967,MCWP 50R,E00,893775,Carter; Andrea L,0,0,20,20
1745822746996,MMW 11R,A01,892721,Herbst; Matthew,11,0,27,16
1745822746996,MMW 11R,A02,892722,Herbst; Matthew,0,0,0,3
1745822748020,MMW 12R,A01,892724,Herbst; Matthew,0,10,16,16
1745822748020,MMW 12R,A02,892725,Herbst; Matthew,0,9,16,16
1745822749050,MMW 13R,A01,892727,Staff,0,3,16,16
1745822749050,MMW 13R,A02,892728,Staff,0,4,16,16
1745822749050,MMW 13R,A03,958032,Staff,0,3,16,16
1745822749050,MMW 13R,A04,958033,Staff,0,2,16,16
1745822749050,MMW 13R,A05,958034,Staff,0,3,16,16
1745822750078,SIO 295LS,A00,894015,Staff,7,0,25,18
1745822751107,SIO 295S,A00,894020,Staff,7,0,25,18
1745822752135,SIOC 290S,B01,958918,Staff,0,0,0,0
1745822753162,SIOC 291S,B01,958922,Staff,0,0,0,0
1745822754190,SOCI 117,A01,895339,Staff,4,0,5,1
1745822755218,WES 237B,A00,894149,Staff,11,0,20,9
1745822757279,AESE 279B,A00,891859,Staff,13,0,35,22
1745822758302,AIP 197,001,891854,Staff,70,0,70,0
1745822759329,ANTH 289S,A00,891856,Gagneux; Pascal,12,0,12,0
1745822760354,BENG 196,001,957946,Engler; Adam J.,9996,0,9999,3
1745822761380,CAT 124RS,A01,956906,Staff,8,0,25,17
1745822762408,CAT 125RS,A01,922013,Staff,8,0,25,17
1745822763437,CLRE 250,A00,891860,Morris; Sheldon,9995,0,9999,4
1745822765492,CLRE 251R,A00,907817,Mehta; Ravindra L.,9994,0,9999,5
1745822766519,CLRE 252,A00,891864,Cuomo; Raphael Eduardo,9993,0,9999,6
1745822767545,CLRE 253,A00,891867,Vaida; Florin,9994,0,9999,5
1745822767545,CLRE 253,B00,907819,Staff,9999,0,9999,0
1745822768570,CLRE 259,A00,891868,Patel; Hemal,9998,0,9999,1
1745822769596,CLRE 260,A00,891872,Cuomo; Raphael Eduardo,9999,0,9999,0
1745822770620,CLRE 297,001,891888,Cuomo; Raphael Eduardo,9999,0,9999,0
1745822771647,CSE 191,A00,958773,Minnes Kemp; Mor Mia,9999,0,9999,0
1745822772675,CSS 201S,A01,892054,Mignozzetti; Umberto,30,0,30,0
1745822773704,CSS 202S,A01,892056,Mignozzetti; Umberto,30,0,30,0
1745822774729,DSC 197,001,956898,Eldridge; Justin Matthew,9998,0,9999,1
1745822775755,DSC 297,001,958000,Mazumdar; Arya,9998,0,9999,1
1745822776779,EAP 100,A00,905686,Staff,9776,0,9999,223
1745822777807,ECE 45,A01,892618,Staff,0,13,50,50
1745822778832,ECE 109,A01,892620,Staff,0,43,0,0
1745822779858,ECE 111,A01,892719,Staff,0,9,50,50
1745822780883,ECE 197,001,957920,Mercier; Patrick Philip,9992,0,9999,7
1745822781912,ECON 178,A01,907814,Zhu; Ying,28,0,35,7
1745822782937,EDS 115,A00,895312,Staff,41,0,45,4
1745822783966,EDS 117,A01,895337,Staff,30,0,30,0
1745822784992,EDS 125,A00,895341,Jones; Gabrielle Anastasia,43,0,45,2
1745822786018,EDS 128A,A01,895459,Fargason; Sharon Gayle,44,0,45,1
1745822787044,EDS 128B,A01,895543,Pappas; Elizabeth,44,0,45,1
1745822788070,EDS 139,A00,897203,Pappas; Elizabeth,44,0,45,1
1745822788070,EDS 139,B00,897209,Fargason; Sharon Gayle,44,0,45,1
1745822789094,EDS 201,A00,895545,Staff,43,0,45,2
1745822790124,EDS 203,A01,895581,Halter; Christopher P.,43,0,45,2
1745822791151,EDS 204R,A01,895625,Heinzman; Erica M.,43,0,45,2
1745822791151,EDS 204R,B01,895693,Halter; Christopher P.,18,0,45,27
1745822792180,EDS 206R,A00,895694,Fargason; Sharon Gayle,9,0,30,21
1745822792180,EDS 206R,B00,895695,Choi; Bailey Miyeon,20,0,30,10
1745822793206,EDS 250,A00,895697,Hemans; Patricia Ann Benitez,43,0,45,2
1745822794231,EDS 281,A00,895701,Meyerott; Theresa Ann,15,0,15,0
1745822795254,EDS 284,A00,895736,Meyerott; Theresa Ann,15,0,15,0
1745822796283,EDS 286,A00,897210,Fine; Sarah,15,0,15,0
1745822797308,EDS 289C,A01,895770,Daly; Alan J.,15,0,15,0
1745822798334,EDS 290,A00,897211,Hofstetter; Carolyn,15,0,15,0
1745822799358,LIGM 5A,A00,896162,Fischer-Grunski; Eva K,15,0,20,5
1745822800384,LIGM 5B,A00,896260,Fischer-Grunski; Eva K,17,0,20,3
1745822801409,LIGM 5C,A00,896308,Fischer-Grunski; Eva K,18,0,20,2
1745822802434,LIIT 5AS,A00,896313,Carnelos; Chiara,17,0,20,3
1745822803462,LIIT 5BS,A00,896416,Carnelos; Chiara,20,0,20,0
1745822804488,LIIT 5CS,A00,896564,Carnelos; Chiara,20,0,20,0
1745822805516,LISP 5A,A00,896588,Munoz Sanchez; Alicia,4,0,20,16
1745822806540,LISP 5B,A00,896653,Munoz Sanchez; Alicia,10,0,20,10
1745822807566,LISP 5C,A00,896655,Munoz Sanchez; Alicia,4,0,20,16
1745822808593,MAE 197,001,957918,Kleissl; Jan,9998,0,9999,1
1745822809619,MATH 2,A01,957937,Staff,34,0,35,1
1745822810643,MATH 197,001,957876,Kedlaya; Kiran S.,9993,0,9999,6
1745822811669,MCWP 40,A00,892729,Duru; Nur,13,0,20,7
1745822811669,MCWP 40,B00,893304,Montejo; Carolina,20,0,20,0
1745822812695,MCWP 40R,A00,893757,Redela; Pamela Morgan,0,7,20,20
1745822813723,MCWP 50,A00,893758,Morshed; Michael James,2,0,20,18
1745822813723,MCWP 50,B00,893761,Bartulis; Jason Michael,18,0,20,2
1745822814749,MCWP 50R,A00,893766,Compas; Sean Matthew,0,1,20,20
1745822814749,MCWP 50R,B00,893769,Carter; Jennifer A,0,0,20,20
1745822814749,MCWP 50R,C00,893771,Krone; Jarret,0,3,20,20
1745822814749,MCWP 50R,D00,893772,Miller; Elizabeth Deen,3,0,20,17
1745822814749,MCWP 50R,E00,893775,Carter; Andrea L,0,0,20,20
1745822815777,MMW 11R,A01,892721,Herbst; Matthew,11,0,27,16
1745822815777,MMW 11R,A02,892722,Herbst; Matthew,0,0,0,3
1745822816803,MMW 12R,A01,892724,Herbst; Matthew,0,10,16,16
1745822816803,MMW 12R,A02,892725,Herbst; Matthew,0,9,16,16
1745822817828,MMW 13R,A01,892727,Staff,0,3,16,16
1745822817828,MMW 13R,A02,892728,Staff,0,4,16,16
1745822817828,MMW 13R,A03,958032,Staff,0,3,16,16
1745822817828,MMW 13R,A04,958033,Staff,0,2,16,16
1745822817828,MMW 13R,A05,958034,Staff,0,3,16,16
1745822818855,SIO 295LS,A00,894015,Staff,7,0,25,18
1745822819882,SIO 295S,A00,894020,Staff,7,0,25,18
1745822820909,SIOC 290S,B01,958918,Staff,0,0,0,0
1745822821934,SIOC 291S,B01,958922,Staff,0,0,0,0
1745822822962,SOCI 117,A01,895339,Staff,4,0,5,1
1745822823987,WES 237B,A00,894149,Staff,11,0,20,9
1745822826052,AESE 279B,A00,891859,Staff,13,0,35,22
1745822827077,AIP 197,001,891854,Staff,70,0,70,0
1745822828104,ANTH 289S,A00,891856,Gagneux; Pascal,12,0,12,0
1745822829133,BENG 196,001,957946,Engler; Adam J.,9996,0,9999,3
1745822830158,CAT 124RS,A01,956906,Staff,8,0,25,17
1745822831186,CAT 125RS,A01,922013,Staff,8,0,25,17
1745822832216,CLRE 250,A00,891860,Morris; Sheldon,9995,0,9999,4
1745822834268,CLRE 251R,A00,907817,Mehta; Ravindra L.,9994,0,9999,5
1745822835296,CLRE 252,A00,891864,Cuomo; Raphael Eduardo,9993,0,9999,6
1745822836323,CLRE 253,A00,891867,Vaida; Florin,9994,0,9999,5
1745822836323,CLRE 253,B00,907819,Staff,9999,0,9999,0
1745822837349,CLRE 259,A00,891868,Patel; Hemal,9998,0,9999,1
1745822838379,CLRE 260,A00,891872,Cuomo; Raphael Eduardo,9999,0,9999,0
1745822839403,CLRE 297,001,891888,Cuomo; Raphael Eduardo,9999,0,9999,0
1745822840433,CSE 191,A00,958773,Minnes Kemp; Mor Mia,9999,0,9999,0
1745822841459,CSS 201S,A01,892054,Mignozzetti; Umberto,30,0,30,0
1745822842485,CSS 202S,A01,892056,Mignozzetti; Umberto,30,0,30,0
1745822843510,DSC 197,001,956898,Eldridge; Justin Matthew,9998,0,9999,1
1745822844535,DSC 297,001,958000,Mazumdar; Arya,9998,0,9999,1
1745822845559,EAP 100,A00,905686,Staff,9776,0,9999,223
1745822846584,ECE 45,A01,892618,Staff,0,13,50,50
1745822847611,ECE 109,A01,892620,Staff,0,43,0,0
1745822848637,ECE 111,A01,892719,Staff,0,9,50,50
1745822849665,ECE 197,001,957920,Mercier; Patrick Philip,9992,0,9999,7
1745822850696,ECON 178,A01,907814,Zhu; Ying,28,0,35,7
1745822851723,EDS 115,A00,895312,Staff,41,0,45,4
1745822852748,EDS 117,A01,895337,Staff,30,0,30,0
1745822853773,EDS 125,A00,895341,Jones; Gabrielle Anastasia,43,0,45,2
1745822854804,EDS 128A,A01,895459,Fargason; Sharon Gayle,44,0,45,1
1745822855830,EDS 128B,A01,895543,Pappas; Elizabeth,44,0,45,1
1745822856854,EDS 139,A00,897203,Pappas; Elizabeth,44,0,45,1
1745822856854,EDS 139,B00,897209,Fargason; Sharon Gayle,44,0,45,1
1745822857880,EDS 201,A00,895545,Staff,43,0,45,2
1745822858908,EDS 203,A01,895581,Halter; Christopher P.,43,0,45,2
1745822859936,EDS 204R,A01,895625,Heinzman; Erica M.,43,0,45,2
1745822859936,EDS 204R,B01,895693,Halter; Christopher P.,18,0,45,27
1745822860960,EDS 206R,A00,895694,Fargason; Sharon Gayle,9,0,30,21
1745822860960,EDS 206R,B00,895695,Choi; Bailey Miyeon,20,0,30,10
1745822861985,EDS 250,A00,895697,Hemans; Patricia Ann Benitez,43,0,45,2
1745822863010,EDS 281,A00,895701,Meyerott; Theresa Ann,15,0,15,0
1745822864038,EDS 284,A00,895736,Meyerott; Theresa Ann,15,0,15,0
1745822865065,EDS 286,A00,897210,Fine; Sarah,15,0,15,0
1745822866093,EDS 289C,A01,895770,Daly; Alan J.,15,0,15,0
1745822867121,EDS 290,A00,897211,Hofstetter; Carolyn,15,0,15,0
1745822868180,LIGM 5A,A00,896162,Fischer-Grunski; Eva K,15,0,20,5
1745822869205,LIGM 5B,A00,896260,Fischer-Grunski; Eva K,17,0,20,3
1745822870230,LIGM 5C,A00,896308,Fischer-Grunski; Eva K,18,0,20,2
1745822871255,LIIT 5AS,A00,896313,Carnelos; Chiara,17,0,20,3
1745822872281,LIIT 5BS,A00,896416,Carnelos; Chiara,20,0,20,0
1745822873305,LIIT 5CS,A00,896564,Carnelos; Chiara,20,0,20,0
1745822874330,LISP 5A,A00,896588,Munoz Sanchez; Alicia,4,0,20,16
1745822875355,LISP 5B,A00,896653,Munoz Sanchez; Alicia,10,0,20,10
1745822876385,LISP 5C,A00,896655,Munoz Sanchez; Alicia,4,0,20,16
1745822877411,MAE 197,001,957918,Kleissl; Jan,9998,0,9999,1
1745822878437,MATH 2,A01,957937,Staff,34,0,35,1
1745822879463,MATH 197,001,957876,Kedlaya; Kiran S.,9993,0,9999,6
1745822880488,MCWP 40,A00,892729,Duru; Nur,13,0,20,7
1745822880488,MCWP 40,B00,893304,Montejo; Carolina,20,0,20,0
1745822881513,MCWP 40R,A00,893757,Redela; Pamela Morgan,0,7,20,20
1745822882543,MCWP 50,A00,893758,Morshed; Michael James,2,0,20,18
1745822882543,MCWP 50,B00,893761,Bartulis; Jason Michael,18,0,20,2
1745822883576,MCWP 50R,A00,893766,Compas; Sean Matthew,0,1,20,20
1745822883576,MCWP 50R,B00,893769,Carter; Jennifer A,0,0,20,20
1745822883576,MCWP 50R,C00,893771,Krone; Jarret,0,3,20,20
1745822883576,MCWP 50R,D00,893772,Miller; Elizabeth Deen,3,0,20,17
1745822883576,MCWP 50R,E00,893775,Carter; Andrea L,0,0,20,20
1745822884601,MMW 11R,A01,892721,Herbst; Matthew,11,0,27,16
1745822884601,MMW 11R,A02,892722,Herbst; Matthew,0,0,0,3
1745822885629,MMW 12R,A01,892724,Herbst; Matthew,0,10,16,16
1745822885629,MMW 12R,A02,892725,Herbst; Matthew,0,9,16,16
1745822886659,MMW 13R,A01,892727,Staff,0,3,16,16
1745822886659,MMW 13R,A02,892728,Staff,0,4,16,16
1745822886659,MMW 13R,A03,958032,Staff,0,3,16,16
1745822886659,MMW 13R,A04,958033,Staff,0,2,16,16
1745822886659,MMW 13R,A05,958034,Staff,0,3,16,16
1745822887686,SIO 295LS,A00,894015,Staff,7,0,25,18
1745822888715,SIO 295S,A00,894020,Staff,7,0,25,18
1745822889746,SIOC 290S,B01,958918,Staff,0,0,0,0
1745822890771,SIOC 291S,B01,958922,Staff,0,0,0,0
1745822891801,SOCI 117,A01,895339,Staff,4,0,5,1
1745822892826,WES 237B,A00,894149,Staff,11,0,20,9
1745822894885,AESE 279B,A00,891859,Staff,13,0,35,22
1745822895909,AIP 197,001,891854,Staff,70,0,70,0
1745822896935,ANTH 289S,A00,891856,Gagneux; Pascal,12,0,12,0
1745822897965,BENG 196,001,957946,Engler; Adam J.,9996,0,9999,3
1745822898995,CAT 124RS,A01,956906,Staff,8,0,25,17
1745822900021,CAT 125RS,A01,922013,Staff,8,0,25,17
1745822901051,CLRE 250,A00,891860,Morris; Sheldon,9995,0,9999,4
1745822903105,CLRE 251R,A00,907817,Mehta; Ravindra L.,9994,0,9999,5
1745822904133,CLRE 252,A00,891864,Cuomo; Raphael Eduardo,9993,0,9999,6
1745822905161,CLRE 253,A00,891867,Vaida; Florin,9994,0,9999,5
1745822905161,CLRE 253,B00,907819,Staff,9999,0,9999,0
1745822906187,CLRE 259,A00,891868,Patel; Hemal,9998,0,9999,1
1745822907215,CLRE 260,A00,891872,Cuomo; Raphael Eduardo,9999,0,9999,0
1745822908242,CLRE 297,001,891888,Cuomo; Raphael Eduardo,9999,0,9999,0
1745822909269,CSE 191,A00,958773,Minnes Kemp; Mor Mia,9999,0,9999,0
1745822910297,CSS 201S,A01,892054,Mignozzetti; Umberto,30,0,30,0
1745822911326,CSS 202S,A01,892056,Mignozzetti; Umberto,30,0,30,0
1745822912353,DSC 197,001,956898,Eldridge; Justin Matthew,9998,0,9999,1
1745822913378,DSC 297,001,958000,Mazumdar; Arya,9998,0,9999,1
1745822914403,EAP 100,A00,905686,Staff,9776,0,9999,223
1745822915431,ECE 45,A01,892618,Staff,0,13,50,50
1745822916456,ECE 109,A01,892620,Staff,0,43,0,0
1745822917481,ECE 111,A01,892719,Staff,0,9,50,50
1745822918509,ECE 197,001,957920,Mercier; Patrick Philip,9992,0,9999,7
1745822919539,ECON 178,A01,907814,Zhu; Ying,28,0,35,7
1745822920563,EDS 115,A00,895312,Staff,41,0,45,4
1745822921592,EDS 117,A01,895337,Staff,30,0,30,0
1745822922620,EDS 125,A00,895341,Jones; Gabrielle Anastasia,43,0,45,2
1745822923650,EDS 128A,A01,895459,Fargason; Sharon Gayle,44,0,45,1
1745822924675,EDS 128B,A01,895543,Pappas; Elizabeth,44,0,45,1
1745822925706,EDS 139,A00,897203,Pappas; Elizabeth,44,0,45,1
1745822925706,EDS 139,B00,897209,Fargason; Sharon Gayle,44,0,45,1
1745822926734,EDS 201,A00,895545,Staff,43,0,45,2
1745822927774,EDS 203,A01,895581,Halter; Christopher P.,43,0,45,2
1745822928800,EDS 204R,A01,895625,Heinzman; Erica M.,43,0,45,2
1745822928800,EDS 204R,B01,895693,Halter; Christopher P.,18,0,45,27
1745822929825,EDS 206R,A00,895694,Fargason; Sharon Gayle,9,0,30,21
1745822929825,EDS 206R,B00,895695,Choi; Bailey Miyeon,20,0,30,10
1745822930850,EDS 250,A00,895697,Hemans; Patricia Ann Benitez,43,0,45,2
1745822931877,EDS 281,A00,895701,Meyerott; Theresa Ann,15,0,15,0
1745822932905,EDS 284,A00,895736,Meyerott; Theresa Ann,15,0,15,0
1745822933935,EDS 286,A00,897210,Fine; Sarah,15,0,15,0
1745822934962,EDS 289C,A01,895770,Daly; Alan J.,15,0,15,0
1745822935990,EDS 290,A00,897211,Hofstetter; Carolyn,15,0,15,0
1745822937015,LIGM 5A,A00,896162,Fischer-Grunski; Eva K,15,0,20,5
1745822938041,LIGM 5B,A00,896260,Fischer-Grunski; Eva K,17,0,20,3
1745822939071,LIGM 5C,A00,896308,Fischer-Grunski; Eva K,18,0,20,2
1745822940097,LIIT 5AS,A00,896313,Carnelos; Chiara,17,0,20,3
1745822941128,LIIT 5BS,A00,896416,Carnelos; Chiara,20,0,20,0
1745822942159,LIIT 5CS,A00,896564,Carnelos; Chiara,20,0,20,0
1745822943186,LISP 5A,A00,896588,Munoz Sanchez; Alicia,4,0,20,16
1745822944212,LISP 5B,A00,896653,Munoz Sanchez; Alicia,10,0,20,10
1745822945239,LISP 5C,A00,896655,Munoz Sanchez; Alicia,4,0,20,16
1745822946266,MAE 197,001,957918,Kleissl; Jan,9998,0,9999,1
1745822947299,MATH 2,A01,957937,Staff,34,0,35,1
1745822948327,MATH 197,001,957876,Kedlaya; Kiran S.,9993,0,9999,6
1745822949354,MCWP 40,A00,892729,Duru; Nur,13,0,20,7
1745822949354,MCWP 40,B00,893304,Montejo; Carolina,20,0,20,0
1745822950380,MCWP 40R,A00,893757,Redela; Pamela Morgan,0,7,20,20
1745822951410,MCWP 50,A00,893758,Morshed; Michael James,2,0,20,18
1745822951410,MCWP 50,B00,893761,Bartulis; Jason Michael,18,0,20,2
1745822952441,MCWP 50R,A00,893766,Compas; Sean Matthew,0,1,20,20
1745822952441,MCWP 50R,B00,893769,Carter; Jennifer A,0,0,20,20
1745822952441,MCWP 50R,C00,893771,Krone; Jarret,0,3,20,20
1745822952441,MCWP 50R,D00,893772,Miller; Elizabeth Deen,3,0,20,17
1745822952441,MCWP 50R,E00,893775,Carter; Andrea L,0,0,20,20
1745822953465,MMW 11R,A01,892721,Herbst; Matthew,11,0,27,16
1745822953465,MMW 11R,A02,892722,Herbst; Matthew,0,0,0,3
1745822954491,MMW 12R,A01,892724,Herbst; Matthew,0,10,16,16
1745822954491,MMW 12R,A02,892725,Herbst; Matthew,0,9,16,16
1745822955519,MMW 13R,A01,892727,Staff,0,3,16,16
1745822955519,MMW 13R,A02,892728,Staff,0,4,16,16
1745822955519,MMW 13R,A03,958032,Staff,0,3,16,16
1745822955519,MMW 13R,A04,958033,Staff,0,2,16,16
1745822955519,MMW 13R,A05,958034,Staff,0,3,16,16
1745822956544,SIO 295LS,A00,894015,Staff,7,0,25,18
1745822957571,SIO 295S,A00,894020,Staff,7,0,25,18
1745822958598,SIOC 290S,B01,958918,Staff,0,0,0,0
1745822959624,SIOC 291S,B01,958922,Staff,0,0,0,0
1745822960654,SOCI 117,A01,895339,Staff,4,0,5,1
1745822961682,WES 237B,A00,894149,Staff,11,0,20,9
1745822963747,AESE 279B,A00,891859,Staff,13,0,35,22
1745822964775,AIP 197,001,891854,Staff,70,0,70,0
1745822965802,ANTH 289S,A00,891856,Gagneux; Pascal,12,0,12,0
1745822966826,BENG 196,001,957946,Engler; Adam J.,9996,0,9999,3
1745822967861,CAT 124RS,A01,956906,Staff,8,0,25,17
1745822968888,CAT 125RS,A01,922013,Staff,8,0,25,17
1745822969915,CLRE 250,A00,891860,Morris; Sheldon,9995,0,9999,4
1745822971971,CLRE 251R,A00,907817,Mehta; Ravindra L.,9994,0,9999,5
1745822973000,CLRE 252,A00,891864,Cuomo; Raphael Eduardo,9993,0,9999,6
1745822974025,CLRE 253,A00,891867,Vaida; Florin,9994,0,9999,5
1745822974025,CLRE 253,B00,907819,Staff,9999,0,9999,0
1745822975052,CLRE 259,A00,891868,Patel; Hemal,9998,0,9999,1
1745822976076,CLRE 260,A00,891872,Cuomo; Raphael Eduardo,9999,0,9999,0
1745822977101,CLRE 297,001,891888,Cuomo; Raphael Eduardo,9999,0,9999,0
1745822978128,CSE 191,A00,958773,Minnes Kemp; Mor Mia,9999,0,9999,0
1745822979154,CSS 201S,A01,892054,Mignozzetti; Umberto,30,0,30,0
1745822980182,CSS 202S,A01,892056,Mignozzetti; Umberto,30,0,30,0
1745822981208,DSC 197,001,956898,Eldridge; Justin Matthew,9998,0,9999,1
1745822982234,DSC 297,001,958000,Mazumdar; Arya,9998,0,9999,1
1745822983260,EAP 100,A00,905686,Staff,9776,0,9999,223
1745822984284,ECE 45,A01,892618,Staff,0,13,50,50
1745822985308,ECE 109,A01,892620,Staff,0,43,0,0
1745822986333,ECE 111,A01,892719,Staff,0,9,50,50
1745822987359,ECE 197,001,957920,Mercier; Patrick Philip,9992,0,9999,7
1745822988385,ECON 178,A01,907814,Zhu; Ying,28,0,35,7
1745822989412,EDS 115,A00,895312,Staff,41,0,45,4
1745822990437,EDS 117,A01,895337,Staff,30,0,30,0
1745822991467,EDS 125,A00,895341,Jones; Gabrielle Anastasia,43,0,45,2
1745822992493,EDS 128A,A01,895459,Fargason; Sharon Gayle,44,0,45,1
1745822993519,EDS 128B,A01,895543,Pappas; Elizabeth,44,0,45,1
1745822994549,EDS 139,A00,897203,Pappas; Elizabeth,44,0,45,1
1745822994549,EDS 139,B00,897209,Fargason; Sharon Gayle,44,0,45,1
1745822995574,EDS 201,A00,895545,Staff,43,0,45,2
1745822996601,EDS 203,A01,895581,Halter; Christopher P.,43,0,45,2
1745822997631,EDS 204R,A01,895625,Heinzman; Erica M.,43,0,45,2
1745822997631,EDS 204R,B01,895693,Halter; Christopher P.,18,0,45,27
1745822998656,EDS 206R,A00,895694,Fargason; Sharon Gayle,9,0,30,21
1745822998656,EDS 206R,B00,895695,Choi; Bailey Miyeon,20,0,30,10
1745822999682,EDS 250,A00,895697,Hemans; Patricia Ann Benitez,43,0,45,2
1745823000712,EDS 281,A00,895701,Meyerott; Theresa Ann,15,0,15,0
1745823001745,EDS 284,A00,895736,Meyerott; Theresa Ann,15,0,15,0
1745823002771,EDS 286,A00,897210,Fine; Sarah,15,0,15,0
1745823003800,EDS 289C,A01,895770,Daly; Alan J.,15,0,15,0
1745823004829,EDS 290,A00,897211,Hofstetter; Carolyn,15,0,15,0
1745823005857,LIGM 5A,A00,896162,Fischer-Grunski; Eva K,15,0,20,5
1745823006932,LIGM 5B,A00,896260,Fischer-Grunski; Eva K,17,0,20,3
1745823007957,LIGM 5C,A00,896308,Fischer-Grunski; Eva K,18,0,20,2
1745823008984,LIIT 5AS,A00,896313,Carnelos; Chiara,17,0,20,3
1745823010013,LIIT 5BS,A00,896416,Carnelos; Chiara,20,0,20,0
1745823011043,LIIT 5CS,A00,896564,Carnelos; Chiara,20,0,20,0
1745823012070,LISP 5A,A00,896588,Munoz Sanchez; Alicia,4,0,20,16
1745823013096,LISP 5B,A00,896653,Munoz Sanchez; Alicia,10,0,20,10
1745823014123,LISP 5C,A00,896655,Munoz Sanchez; Alicia,4,0,20,16
1745823015151,MAE 197,001,957918,Kleissl; Jan,9998,0,9999,1
1745823016176,MATH 2,A01,957937,Staff,34,0,35,1
1745823017204,MATH 197,001,957876,Kedlaya; Kiran S.,9993,0,9999,6
1745823018232,MCWP 40,A00,892729,Duru; Nur,13,0,20,7
1745823018232,MCWP 40,B00,893304,Montejo; Carolina,20,0,20,0
1745823019259,MCWP 40R,A00,893757,Redela; Pamela Morgan,0,7,20,20
1745823020289,MCWP 50,A00,893758,Morshed; Michael James,2,0,20,18
1745823020289,MCWP 50,B00,893761,Bartulis; Jason Michael,18,0,20,2
1745823021314,MCWP 50R,A00,893766,Compas; Sean Matthew,0,1,20,20
1745823021314,MCWP 50R,B00,893769,Carter; Jennifer A,0,0,20,20
1745823021314,MCWP 50R,C00,893771,Krone; Jarret,0,3,20,20
1745823021314,MCWP 50R,D00,893772,Miller; Elizabeth Deen,3,0,20,17
1745823021314,MCWP 50R,E00,893775,Carter; Andrea L,0,0,20,20
1745823022340,MMW 11R,A01,892721,Herbst; Matthew,11,0,27,16
1745823022340,MMW 11R,A02,892722,Herbst; Matthew,0,0,0,3
1745823023367,MMW 12R,A01,892724,Herbst; Matthew,0,10,16,16
1745823023367,MMW 12R,A02,892725,Herbst; Matthew,0,9,16,16
1745823024392,MMW 13R,A01,892727,Staff,0,3,16,16
1745823024392,MMW 13R,A02,892728,Staff,0,4,16,16
1745823024392,MMW 13R,A03,958032,Staff,0,3,16,16
1745823024392,MMW 13R,A04,958033,Staff,0,2,16,16
1745823024392,MMW 13R,A05,958034,Staff,0,3,16,16
1745823025416,SIO 295LS,A00,894015,Staff,7,0,25,18
1745823026442,SIO 295S,A00,894020,Staff,7,0,25,18
1745823027471,SIOC 290S,B01,958918,Staff,0,0,0,0
1745823028498,SIOC 291S,B01,958922,Staff,0,0,0,0
1745823029733,SOCI 117,A01,895339,Staff,4,0,5,1
1745823030758,WES 237B,A00,894149,Staff,11,0,20,9
1745823032816,AESE 279B,A00,891859,Staff,13,0,35,22
1745823033840,AIP 197,001,891854,Staff,70,0,70,0
1745823034868,ANTH 289S,A00,891856,Gagneux; Pascal,12,0,12,0
1745823035894,BENG 196,001,957946,Engler; Adam J.,9996,0,9999,3
1745823036919,CAT 124RS,A01,956906,Staff,8,0,25,17
1745823037945,CAT 125RS,A01,922013,Staff,8,0,25,17
1745823038973,CLRE 250,A00,891860,Morris; Sheldon,9995,0,9999,4
1745823041025,CLRE 251R,A00,907817,Mehta; Ravindra L.,9994,0,9999,5
1745823042051,CLRE 252,A00,891864,Cuomo; Raphael Eduardo,9993,0,9999,6
1745823043076,CLRE 253,A00,891867,Vaida; Florin,9994,0,9999,5
1745823043076,CLRE 253,B00,907819,Staff,9999,0,9999,0
1745823044103,CLRE 259,A00,891868,Patel; Hemal,9998,0,9999,1
1745823045129,CLRE 260,A00,891872,Cuomo; Raphael Eduardo,9999,0,9999,0
1745823046153,CLRE 297,001,891888,Cuomo; Raphael Eduardo,9999,0,9999,0
1745823047179,CSE 191,A00,958773,Minnes Kemp; Mor Mia,9999,0,9999,0
1745823048205,CSS 201S,A01,892054,Mignozzetti; Umberto,30,0,30,0
1745823049233,CSS 202S,A01,892056,Mignozzetti; Umberto,30,0,30,0
1745823050259,DSC 197,001,956898,Eldridge; Justin Matthew,9998,0,9999,1
1745823051287,DSC 297,001,958000,Mazumdar; Arya,9998,0,9999,1
1745823052312,EAP 100,A00,905686,Staff,9776,0,9999,223
1745823053340,ECE 45,A01,892618,Staff,0,13,50,50
1745823054367,ECE 109,A01,892620,Staff,0,43,0,0
1745823055395,ECE 111,A01,892719,Staff,0,9,50,50
1745823056423,ECE 197,001,957920,Mercier; Patrick Philip,9992,0,9999,7
1745823057449,ECON 178,A01,907814,Zhu; Ying,28,0,35,7
1745823058478,EDS 115,A00,895312,Staff,41,0,45,4
1745823059508,EDS 117,A01,895337,Staff,30,0,30,0
1745823060537,EDS 125,A00,895341,Jones; Gabrielle Anastasia,43,0,45,2
1745823061564,EDS 128A,A01,895459,Fargason; Sharon Gayle,44,0,45,1
1745823062593,EDS 128B,A01,895543,Pappas; Elizabeth,44,0,45,1
1745823063620,EDS 139,A00,897203,Pappas; Elizabeth,44,0,45,1
1745823063620,EDS 139,B00,897209,Fargason; Sharon Gayle,44,0,45,1
1745823064647,EDS 201,A00,895545,Staff,43,0,45,2
1745823065676,EDS 203,A01,895581,Halter; Christopher P.,43,0,45,2
1745823066705,EDS 204R,A01,895625,Heinzman; Erica M.,43,0,45,2
1745823066705,EDS 204R,B01,895693,Halter; Christopher P.,18,0,45,27
1745823067734,EDS 206R,A00,895694,Fargason; Sharon Gayle,9,0,30,21
1745823067734,EDS 206R,B00,895695,Choi; Bailey Miyeon,20,0,30,10
1745823068763,EDS 250,A00,895697,Hemans; Patricia Ann Benitez,43,0,45,2
1745823069791,EDS 281,A00,895701,Meyerott; Theresa Ann,15,0,15,0
1745823070819,EDS 284,A00,895736,Meyerott; Theresa Ann,15,0,15,0
1745823071843,EDS 286,A00,897210,Fine; Sarah,15,0,15,0
1745823072869,EDS 289C,A01,895770,Daly; Alan J.,15,0,15,0
1745823073899,EDS 290,A00,897211,Hofstetter; Carolyn,15,0,15,0
1745823074926,LIGM 5A,A00,896162,Fischer-Grunski; Eva K,15,0,20,5
1745823075960,LIGM 5B,A00,896260,Fischer-Grunski; Eva K,17,0,20,3
1745823076986,LIGM 5C,A00,896308,Fischer-Grunski; Eva K,18,0,20,2
1745823078015,LIIT 5AS,A00,896313,Carnelos; Chiara,17,0,20,3
1745823079041,LIIT 5BS,A00,896416,Carnelos; Chiara,20,0,20,0
1745823080070,LIIT 5CS,A00,896564,Carnelos; Chiara,20,0,20,0
1745823081100,LISP 5A,A00,896588,Munoz Sanchez; Alicia,4,0,20,16
1745823082129,LISP 5B,A00,896653,Munoz Sanchez; Alicia,10,0,20,10
1745823083159,LISP 5C,A00,896655,Munoz Sanchez; Alicia,4,0,20,16
1745823084184,MAE 197,001,957918,Kleissl; Jan,9998,0,9999,1
1745823085209,MATH 2,A01,957937,Staff,34,0,35,1
1745823086234,MATH 197,001,957876,Kedlaya; Kiran S.,9993,0,9999,6
1745823087260,MCWP 40,A00,892729,Duru; Nur,13,0,20,7
1745823087260,MCWP 40,B00,893304,Montejo; Carolina,20,0,20,0
1745823088285,MCWP 40R,A00,893757,Redela; Pamela Morgan,0,7,20,20
1745823089315,MCWP 50,A00,893758,Morshed; Michael James,2,0,20,18
1745823089315,MCWP 50,B00,893761,Bartulis; Jason Michael,18,0,20,2
1745823090346,MCWP 50R,A00,893766,Compas; Sean Matthew,0,1,20,20
1745823090346,MCWP 50R,B00,893769,Carter; Jennifer A,0,0,20,20
1745823090346,MCWP 50R,C00,893771,Krone; Jarret,0,3,20,20
1745823090346,MCWP 50R,D00,893772,Miller; Elizabeth Deen,3,0,20,17
1745823090346,MCWP 50R,E00,893775,Carter; Andrea L,0,0,20,20
1745823091373,MMW 11R,A01,892721,Herbst; Matthew,11,0,27,16
1745823091373,MMW 11R,A02,892722,Herbst; Matthew,0,0,0,3
1745823092401,MMW 12R,A01,892724,Herbst; Matthew,0,10,16,16
1745823092401,MMW 12R,A02,892725,Herbst; Matthew,0,9,16,16
1745823093426,MMW 13R,A01,892727,Staff,0,3,16,16
1745823093426,MMW 13R,A02,892728,Staff,0,4,16,16
1745823093426,MMW 13R,A03,958032,Staff,0,3,16,16
1745823093426,MMW 13R,A04,958033,Staff,0,2,16,16
1745823093426,MMW 13R,A05,958034,Staff,0,3,16,16
1745823094452,SIO 295LS,A00,894015,Staff,7,0,25,18
1745823095480,SIO 295S,A00,894020,Staff,7,0,25,18
1745823096508,SIOC 290S,B01,958918,Staff,0,0,0,0
1745823097535,SIOC 291S,B01,958922,Staff,0,0,0,0
1745823098563,SOCI 117,A01,895339,Staff,4,0,5,1
1745823099589,WES 237B,A00,894149,Staff,11,0,20,9
1745823101651,AESE 279B,A00,891859,Staff,13,0,35,22
1745823102674,AIP 197,001,891854,Staff,70,0,70,0
1745823103701,ANTH 289S,A00,891856,Gagneux; Pascal,12,0,12,0
1745823104731,BENG 196,001,957946,Engler; Adam J.,9996,0,9999,3
1745823105758,CAT 124RS,A01,956906,Staff,8,0,25,17
1745823106787,CAT 125RS,A01,922013,Staff,8,0,25,17
1745823107816,CLRE 250,A00,891860,Morris; Sheldon,9995,0,9999,4
1745823109872,CLRE 251R,A00,907817,Mehta; Ravindra L.,9994,0,9999,5
1745823110897,CLRE 252,A00,891864,Cuomo; Raphael Eduardo,9993,0,9999,6
1745823111921,CLRE 253,A00,891867,Vaida; Florin,9994,0,9999,5
1745823111921,CLRE 253,B00,907819,Staff,9999,0,9999,0
1745823112950,CLRE 259,A00,891868,Patel; Hemal,9998,0,9999,1
1745823113976,CLRE 260,A00,891872,Cuomo; Raphael Eduardo,9999,0,9999,0
1745823115006,CLRE 297,001,891888,Cuomo; Raphael Eduardo,9999,0,9999,0
1745823116033,CSE 191,A00,958773,Minnes Kemp; Mor Mia,9999,0,9999,0
1745823117060,CSS 201S,A01,892054,Mignozzetti; Umberto,30,0,30,0
1745823118092,CSS 202S,A01,892056,Mignozzetti; Umberto,30,0,30,0
1745823119117,DSC 197,001,956898,Eldridge; Justin Matthew,9998,0,9999,1
1745823120146,DSC 297,001,958000,Mazumdar; Arya,9998,0,9999,1
1745823121173,EAP 100,A00,905686,Staff,9776,0,9999,223
1745823122203,ECE 45,A01,892618,Staff,0,13,50,50
1745823123228,ECE 109,A01,892620,Staff,0,43,0,0
1745823124255,ECE 111,A01,892719,Staff,0,9,50,50
1745823125280,ECE 197,001,957920,Mercier; Patrick Philip,9992,0,9999,7
1745823126306,ECON 178,A01,907814,Zhu; Ying,28,0,35,7
1745823127332,EDS 115,A00,895312,Staff,41,0,45,4
1745823128359,EDS 117,A01,895337,Staff,30,0,30,0
1745823129391,EDS 125,A00,895341,Jones; Gabrielle Anastasia,43,0,45,2
1745823130419,EDS 128A,A01,895459,Fargason; Sharon Gayle,44,0,45,1
1745823131447,EDS 128B,A01,895543,Pappas; Elizabeth,44,0,45,1
1745823132475,EDS 139,A00,897203,Pappas; Elizabeth,44,0,45,1
1745823132475,EDS 139,B00,897209,Fargason; Sharon Gayle,44,0,45,1
1745823133501,EDS 201,A00,895545,Staff,43,0,45,2
1745823134529,EDS 203,A01,895581,Halter; Christopher P.,43,0,45,2
1745823135555,EDS 204R,A01,895625,Heinzman; Erica M.,43,0,45,2
1745823135555,EDS 204R,B01,895693,Halter; Christopher P.,18,0,45,27
1745823136580,EDS 206R,A00,895694,Fargason; Sharon Gayle,9,0,30,21
1745823136580,EDS 206R,B00,895695,Choi; Bailey Miyeon,20,0,30,10
1745823137609,EDS 250,A00,895697,Hemans; Patricia Ann Benitez,43,0,45,2
1745823138635,EDS 281,A00,895701,Meyerott; Theresa Ann,15,0,15,0
1745823139660,EDS 284,A00,895736,Meyerott; Theresa Ann,15,0,15,0
1745823140685,EDS 286,A00,897210,Fine; Sarah,15,0,15,0
1745823141713,EDS 289C,A01,895770,Daly; Alan J.,15,0,15,0
1745823142739,EDS 290,A00,897211,Hofstetter; Carolyn,15,0,15,0
1745823143765,LIGM 5A,A00,896162,Fischer-Grunski; Eva K,15,0,20,5
1745823144795,LIGM 5B,A00,896260,Fischer-Grunski; Eva K,17,0,20,3
1745823145822,LIGM 5C,A00,896308,Fischer-Grunski; Eva K,18,0,20,2
1745823146849,LIIT 5AS,A00,896313,Carnelos; Chiara,17,0,20,3
1745823147877,LIIT 5BS,A00,896416,Carnelos; Chiara,20,0,20,0
1745823148905,LIIT 5CS,A00,896564,Carnelos; Chiara,20,0,20,0
1745823149931,LISP 5A,A00,896588,Munoz Sanchez; Alicia,4,0,20,16
1745823150964,LISP 5B,A00,896653,Munoz Sanchez; Alicia,10,0,20,10
1745823151992,LISP 5C,A00,896655,Munoz Sanchez; Alicia,4,0,20,16
1745823153019,MAE 197,001,957918,Kleissl; Jan,9998,0,9999,1
1745823154045,MATH 2,A01,957937,Staff,34,0,35,1
1745823155070,MATH 197,001,957876,Kedlaya; Kiran S.,9993,0,9999,6
1745823156100,MCWP 40,A00,892729,Duru; Nur,13,0,20,7
1745823156100,MCWP 40,B00,893304,Montejo; Carolina,20,0,20,0
1745823157123,MCWP 40R,A00,893757,Redela; Pamela Morgan,0,7,20,20
1745823158148,MCWP 50,A00,893758,Morshed; Michael James,2,0,20,18
1745823158148,MCWP 50,B00,893761,Bartulis; Jason Michael,18,0,20,2
1745823159175,MCWP 50R,A00,893766,Compas; Sean Matthew,0,1,20,20
1745823159175,MCWP 50R,B00,893769,Carter; Jennifer A,0,0,20,20
1745823159175,MCWP 50R,C00,893771,Krone; Jarret,0,3,20,20
1745823159175,MCWP 50R,D00,893772,Miller; Elizabeth Deen,3,0,20,17
1745823159175,MCWP 50R,E00,893775,Carter; Andrea L,0,0,20,20
1745823160201,MMW 11R,A01,892721,Herbst; Matthew,11,0,27,16
1745823160201,MMW 11R,A02,892722,Herbst; Matthew,0,0,0,3
1745823161226,MMW 12R,A01,892724,Herbst; Matthew,0,10,16,16
1745823161226,MMW 12R,A02,892725,Herbst; Matthew,0,9,16,16
1745823162256,MMW 13R,A01,892727,Staff,0,3,16,16
1745823162256,MMW 13R,A02,892728,Staff,0,4,16,16
1745823162256,MMW 13R,A03,958032,Staff,0,3,16,16
1745823162256,MMW 13R,A04,958033,Staff,0,2,16,16
1745823162256,MMW 13R,A05,958034,Staff,0,3,16,16
1745823163282,SIO 295LS,A00,894015,Staff,7,0,25,18
1745823164306,SIO 295S,A00,894020,Staff,7,0,25,18
1745823165331,SIOC 290S,B01,958918,Staff,0,0,0,0
1745823166358,SIOC 291S,B01,958922,Staff,0,0,0,0
1745823167400,SOCI 117,A01,895339,Staff,4,0,5,1
1745823168426,WES 237B,A00,894149,Staff,11,0,20,9
1745823170484,AESE 279B,A00,891859,Staff,13,0,35,22
1745823171509,AIP 197,001,891854,Staff,70,0,70,0
1745823172534,ANTH 289S,A00,891856,Gagneux; Pascal,12,0,12,0
1745823173560,BENG 196,001,957946,Engler; Adam J.,9996,0,9999,3
1745823174586,CAT 124RS,A01,956906,Staff,8,0,25,17
1745823175615,CAT 125RS,A01,922013,Staff,8,0,25,17
1745823176643,CLRE 250,A00,891860,Morris; Sheldon,9995,0,9999,4
1745823178693,CLRE 251R,A00,907817,Mehta; Ravindra L.,9994,0,9999,5
1745823179719,CLRE 252,A00,891864,Cuomo; Raphael Eduardo,9993,0,9999,6
1745823180745,CLRE 253,A00,891867,Vaida; Florin,9994,0,9999,5
1745823180745,CLRE 253,B00,907819,Staff,9999,0,9999,0
1745823181773,CLRE 259,A00,891868,Patel; Hemal,9998,0,9999,1
1745823182799,CLRE 260,A00,891872,Cuomo; Raphael Eduardo,9999,0,9999,0
1745823183825,CLRE 297,001,891888,Cuomo; Raphael Eduardo,9999,0,9999,0
1745823184850,CSE 191,A00,958773,Minnes Kemp; Mor Mia,9999,0,9999,0
1745823185879,CSS 201S,A01,892054,Mignozzetti; Umberto,30,0,30,0
1745823186906,CSS 202S,A01,892056,Mignozzetti; Umberto,30,0,30,0
1745823187933,DSC 197,001,956898,Eldridge; Justin Matthew,9998,0,9999,1
1745823188958,DSC 297,001,958000,Mazumdar; Arya,9998,0,9999,1
1745823189984,EAP 100,A00,905686,Staff,9776,0,9999,223
1745823191009,ECE 45,A01,892618,Staff,0,13,50,50
1745823192033,ECE 109,A01,892620,Staff,0,43,0,0
1745823193063,ECE 111,A01,892719,Staff,0,9,50,50
1745823194089,ECE 197,001,957920,Mercier; Patrick Philip,9992,0,9999,7
1745823195531,ECON 178,A01,907814,Zhu; Ying,28,0,35,7
1745823196557,EDS 115,A00,895312,Staff,41,0,45,4
1745823197584,EDS 117,A01,895337,Staff,30,0,30,0
1745823198609,EDS 125,A00,895341,Jones; Gabrielle Anastasia,43,0,45,2
1745823199636,EDS 128A,A01,895459,Fargason; Sharon Gayle,44,0,45,1
1745823200671,EDS 128B,A01,895543,Pappas; Elizabeth,44,0,45,1
1745823201700,EDS 139,A00,897203,Pappas; Elizabeth,44,0,45,1
1745823201700,EDS 139,B00,897209,Fargason; Sharon Gayle,44,0,45,1
1745823202730,EDS 201,A00,895545,Staff,43,0,45,2
1745823203757,EDS 203,A01,895581,Halter; Christopher P.,43,0,45,2
1745823204797,EDS 204R,A01,895625,Heinzman; Erica M.,43,0,45,2
1745823204797,EDS 204R,B01,895693,Halter; Christopher P.,18,0,45,27
1745823205822,EDS 206R,A00,895694,Fargason; Sharon Gayle,9,0,30,21
1745823205822,EDS 206R,B00,895695,Choi; Bailey Miyeon,20,0,30,10
1745823206850,EDS 250,A00,895697,Hemans; Patricia Ann Benitez,43,0,45,2
1745823207875,EDS 281,A00,895701,Meyerott; Theresa Ann,15,0,15,0
1745823208903,EDS 284,A00,895736,Meyerott; Theresa Ann,15,0,15,0
1745823209929,EDS 286,A00,897210,Fine; Sarah,15,0,15,0
1745823210954,EDS 289C,A01,895770,Daly; Alan J.,15,0,15,0
1745823211980,EDS 290,A00,897211,Hofstetter; Carolyn,15,0,15,0
1745823213007,LIGM 5A,A00,896162,Fischer-Grunski; Eva K,15,0,20,5
1745823214034,LIGM 5B,A00,896260,Fischer-Grunski; Eva K,17,0,20,3
1745823215066,LIGM 5C,A00,896308,Fischer-Grunski; Eva K,18,0,20,2
1745823216091,LIIT 5AS,A00,896313,Carnelos; Chiara,17,0,20,3
1745823217122,LIIT 5BS,A00,896416,Carnelos; Chiara,20,0,20,0
1745823218147,LIIT 5CS,A00,896564,Carnelos; Chiara,20,0,20,0
1745823219173,LISP 5A,A00,896588,Munoz Sanchez; Alicia,4,0,20,16
1745823220200,LISP 5B,A00,896653,Munoz Sanchez; Alicia,10,0,20,10
1745823221230,LISP 5C,A00,896655,Munoz Sanchez; Alicia,4,0,20,16
1745823222257,MAE 197,001,957918,Kleissl; Jan,9998,0,9999,1
1745823223284,MATH 2,A01,957937,Staff,34,0,35,1
1745823224311,MATH 197,001,957876,Kedlaya; Kiran S.,9993,0,9999,6
1745823225341,MCWP 40,A00,892729,Duru; Nur,13,0,20,7
1745823225341,MCWP 40,B00,893304,Montejo; Carolina,20,0,20,0
1745823226367,MCWP 40R,A00,893757,Redela; Pamela Morgan,0,7,20,20
1745823227397,MCWP 50,A00,893758,Morshed; Michael James,2,0,20,18
1745823227397,MCWP 50,B00,893761,Bartulis; Jason Michael,18,0,20,2
1745823228424,MCWP 50R,A00,893766,Compas; Sean Matthew,0,1,20,20
1745823228424,MCWP 50R,B00,893769,Carter; Jennifer A,0,0,20,20
1745823228424,MCWP 50R,C00,893771,Krone; Jarret,0,3,20,20
1745823228424,MCWP 50R,D00,893772,Miller; Elizabeth Deen,3,0,20,17
1745823228424,MCWP 50R,E00,893775,Carter; Andrea L,0,0,20,20
1745823229448,MMW 11R,A01,892721,Herbst; Matthew,11,0,27,16
1745823229448,MMW 11R,A02,892722,Herbst; Matthew,0,0,0,3
1745823230475,MMW 12R,A01,892724,Herbst; Matthew,0,10,16,16
1745823230475,MMW 12R,A02,892725,Herbst; Matthew,0,9,16,16
1745823231502,MMW 13R,A01,892727,Staff,0,3,16,16
1745823231502,MMW 13R,A02,892728,Staff,0,4,16,16
1745823231502,MMW 13R,A03,958032,Staff,0,3,16,16
1745823231502,MMW 13R,A04,958033,Staff,0,2,16,16
1745823231502,MMW 13R,A05,958034,Staff,0,3,16,16
1745823232557,SIO 295LS,A00,894015,Staff,7,0,25,18
1745823233581,SIO 295S,A00,894020,Staff,7,0,25,18
1745823234607,SIOC 290S,B01,958918,Staff,0,0,0,0
1745823235631,SIOC 291S,B01,958922,Staff,0,0,0,0
1745823236657,SOCI 117,A01,895339,Staff,4,0,5,1
1745823237682,WES 237B,A00,894149,Staff,11,0,20,9
1745823239845,AESE 279B,A00,891859,Staff,13,0,35,22
1745823240871,AIP 197,001,891854,Staff,70,0,70,0
1745823241895,ANTH 289S,A00,891856,Gagneux; Pascal,12,0,12,0
1745823242923,BENG 196,001,957946,Engler; Adam J.,9996,0,9999,3
1745823243948,CAT 124RS,A01,956906,Staff,8,0,25,17
1745823244977,CAT 125RS,A01,922013,Staff,8,0,25,17
1745823246002,CLRE 250,A00,891860,Morris; Sheldon,9995,0,9999,4
1745823248055,CLRE 251R,A00,907817,Mehta; Ravindra L.,9994,0,9999,5
1745823249083,CLRE 252,A00,891864,Cuomo; Raphael Eduardo,9993,0,9999,6
1745823250110,CLRE 253,A00,891867,Vaida; Florin,9994,0,9999,5
1745823250110,CLRE 253,B00,907819,Staff,9999,0,9999,0
1745823251137,CLRE 259,A00,891868,Patel; Hemal,9998,0,9999,1
1745823252165,CLRE 260,A00,891872,Cuomo; Raphael Eduardo,9999,0,9999,0
1745823253191,CLRE 297,001,891888,Cuomo; Raphael Eduardo,9999,0,9999,0
1745823254219,CSE 191,A00,958773,Minnes Kemp; Mor Mia,9999,0,9999,0
1745823255247,CSS 201S,A01,892054,Mignozzetti; Umberto,30,0,30,0
1745823256276,CSS 202S,A01,892056,Mignozzetti; Umberto,30,0,30,0
1745823257306,DSC 197,001,956898,Eldridge; Justin Matthew,9998,0,9999,1
1745823258335,DSC 297,001,958000,Mazumdar; Arya,9998,0,9999,1
1745823259366,EAP 100,A00,905686,Staff,9776,0,9999,223
1745823260391,ECE 45,A01,892618,Staff,0,13,50,50
1745823261418,ECE 109,A01,892620,Staff,0,43,0,0
1745823262446,ECE 111,A01,892719,Staff,0,9,50,50
1745823263475,ECE 197,001,957920,Mercier; Patrick Philip,9992,0,9999,7
1745823264504,ECON 178,A01,907814,Zhu; Ying,28,0,35,7
1745823265529,EDS 115,A00,895312,Staff,41,0,45,4
1745823266556,EDS 117,A01,895337,Staff,30,0,30,0
1745823267581,EDS 125,A00,895341,Jones; Gabrielle Anastasia,43,0,45,2
1745823268608,EDS 128A,A01,895459,Fargason; Sharon Gayle,44,0,45,1
1745823269634,EDS 128B,A01,895543,Pappas; Elizabeth,44,0,45,1
1745823270662,EDS 139,A00,897203,Pappas; Elizabeth,44,0,45,1
1745823270662,EDS 139,B00,897209,Fargason; Sharon Gayle,44,0,45,1
1745823271688,EDS 201,A00,895545,Staff,43,0,45,2
1745823272713,EDS 203,A01,895581,Halter; Christopher P.,43,0,45,2
1745823273743,EDS 204R,A01,895625,Heinzman; Erica M.,43,0,45,2
1745823273743,EDS 204R,B01,895693,Halter; Christopher P.,18,0,45,27
1745823274772,EDS 206R,A00,895694,Fargason; Sharon Gayle,9,0,30,21
1745823274772,EDS 206R,B00,895695,Choi; Bailey Miyeon,20,0,30,10
1745823275802,EDS 250,A00,895697,Hemans; Patricia Ann Benitez,43,0,45,2
1745823276832,EDS 281,A00,895701,Meyerott; Theresa Ann,15,0,15,0
1745823277860,EDS 284,A00,895736,Meyerott; Theresa Ann,15,0,15,0
1745823278889,EDS 286,A00,897210,Fine; Sarah,15,0,15,0
1745823279917,EDS 289C,A01,895770,Daly; Alan J.,15,0,15,0
1745823280943,EDS 290,A00,897211,Hofstetter; Carolyn,15,0,15,0
1745823281970,LIGM 5A,A00,896162,Fischer-Grunski; Eva K,15,0,20,5
1745823282995,LIGM 5B,A00,896260,Fischer-Grunski; Eva K,17,0,20,3
1745823284022,LIGM 5C,A00,896308,Fischer-Grunski; Eva K,18,0,20,2
1745823285048,LIIT 5AS,A00,896313,Carnelos; Chiara,17,0,20,3
1745823286076,LIIT 5BS,A00,896416,Carnelos; Chiara,20,0,20,0
1745823287104,LIIT 5CS,A00,896564,Carnelos; Chiara,20,0,20,0
1745823288135,LISP 5A,A00,896588,Munoz Sanchez; Alicia,4,0,20,16
1745823289160,LISP 5B,A00,896653,Munoz Sanchez; Alicia,10,0,20,10
1745823290185,LISP 5C,A00,896655,Munoz Sanchez; Alicia,4,0,20,16
1745823291213,MAE 197,001,957918,Kleissl; Jan,9998,0,9999,1
1745823292239,MATH 2,A01,957937,Staff,34,0,35,1
1745823293262,MATH 197,001,957876,Kedlaya; Kiran S.,9993,0,9999,6
1745823294289,MCWP 40,A00,892729,Duru; Nur,13,0,20,7
1745823294289,MCWP 40,B00,893304,Montejo; Carolina,20,0,20,0
1745823295318,MCWP 40R,A00,893757,Redela; Pamela Morgan,0,7,20,20
1745823296345,MCWP 50,A00,893758,Morshed; Michael James,2,0,20,18
1745823296345,MCWP 50,B00,893761,Bartulis; Jason Michael,18,0,20,2
1745823297373,MCWP 50R,A00,893766,Compas; Sean Matthew,0,1,20,20
1745823297373,MCWP 50R,B00,893769,Carter; Jennifer A,0,0,20,20
1745823297373,MCWP 50R,C00,893771,Krone; Jarret,0,3,20,20
1745823297373,MCWP 50R,D00,893772,Miller; Elizabeth Deen,3,0,20,17
1745823297373,MCWP 50R,E00,893775,Carter; Andrea L,0,0,20,20
1745823298403,MMW 11R,A01,892721,Herbst; Matthew,11,0,27,16
1745823298403,MMW 11R,A02,892722,Herbst; Matthew,0,0,0,3
1745823299430,MMW 12R,A01,892724,Herbst; Matthew,0,10,16,16
1745823299430,MMW 12R,A02,892725,Herbst; Matthew,0,9,16,16
1745823300457,MMW 13R,A01,892727,Staff,0,3,16,16
1745823300457,MMW 13R,A02,892728,Staff,0,4,16,16
1745823300457,MMW 13R,A03,958032,Staff,0,3,16,16
1745823300457,MMW 13R,A04,958033,Staff,0,2,16,16
1745823300457,MMW 13R,A05,958034,Staff,0,3,16,16
1745823301484,SIO 295LS,A00,894015,Staff,7,0,25,18
1745823302512,SIO 295S,A00,894020,Staff,7,0,25,18
1745823303544,SIOC 290S,B01,958918,Staff,0,0,0,0
1745823304572,SIOC 291S,B01,958922,Staff,0,0,0,0
1745823305602,SOCI 117,A01,895339,Staff,4,0,5,1
1745823306631,WES 237B,A00,894149,Staff,11,0,20,9
1745823308701,AESE 279B,A00,891859,Staff,13,0,35,22
1745823309728,AIP 197,001,891854,Staff,70,0,70,0
1745823310754,ANTH 289S,A00,891856,Gagneux; Pascal,12,0,12,0
1745823311781,BENG 196,001,957946,Engler; Adam J.,9996,0,9999,3
1745823312809,CAT 124RS,A01,956906,Staff,8,0,25,17
1745823313838,CAT 125RS,A01,922013,Staff,8,0,25,17
1745823314868,CLRE 250,A00,891860,Morris; Sheldon,9995,0,9999,4
1745823316920,CLRE 251R,A00,907817,Mehta; Ravindra L.,9994,0,9999,5
1745823317945,CLRE 252,A00,891864,Cuomo; Raphael Eduardo,9993,0,9999,6
1745823318974,CLRE 253,A00,891867,Vaida; Florin,9994,0,9999,5
1745823318974,CLRE 253,B00,907819,Staff,9999,0,9999,0
1745823320003,CLRE 259,A00,891868,Patel; Hemal,9998,0,9999,1
1745823321030,CLRE 260,A00,891872,Cuomo; Raphael Eduardo,9999,0,9999,0
1745823322055,CLRE 297,001,891888,Cuomo; Raphael Eduardo,9999,0,9999,0
1745823323082,CSE 191,A00,958773,Minnes Kemp; Mor Mia,9999,0,9999,0
1745823324107,CSS 201S,A01,892054,Mignozzetti; Umberto,30,0,30,0
1745823325136,CSS 202S,A01,892056,Mignozzetti; Umberto,30,0,30,0
1745823326164,DSC 197,001,956898,Eldridge; Justin Matthew,9998,0,9999,1
1745823327193,DSC 297,001,958000,Mazumdar; Arya,9998,0,9999,1
1745823328219,EAP 100,A00,905686,Staff,9776,0,9999,223
1745823329248,ECE 45,A01,892618,Staff,0,13,50,50
1745823330274,ECE 109,A01,892620,Staff,0,43,0,0
1745823331305,ECE 111,A01,892719,Staff,0,9,50,50
1745823332335,ECE 197,001,957920,Mercier; Patrick Philip,9992,0,9999,7
1745823333361,ECON 178,A01,907814,Zhu; Ying,28,0,35,7
1745823334392,EDS 115,A00,895312,Staff,41,0,45,4
1745823335421,EDS 117,A01,895337,Staff,30,0,30,0
1745823336449,EDS 125,A00,895341,Jones; Gabrielle Anastasia,43,0,45,2
1745823337487,EDS 128A,A01,895459,Fargason; Sharon Gayle,44,0,45,1
1745823338515,EDS 128B,A01,895543,Pappas; Elizabeth,44,0,45,1
1745823339541,EDS 139,A00,897203,Pappas; Elizabeth,44,0,45,1
1745823339541,EDS 139,B00,897209,Fargason; Sharon Gayle,44,0,45,1
1745823340773,EDS 201,A00,895545,Staff,43,0,45,2
1745823341801,EDS 203,A01,895581,Halter; Christopher P.,43,0,45,2
1745823342826,EDS 204R,A01,895625,Heinzman; Erica M.,43,0,45,2
1745823342826,EDS 204R,B01,895693,Halter; Christopher P.,18,0,45,27
1745823343853,EDS 206R,A00,895694,Fargason; Sharon Gayle,9,0,30,21
1745823343853,EDS 206R,B00,895695,Choi; Bailey Miyeon,20,0,30,10
1745823344879,EDS 250,A00,895697,Hemans; Patricia Ann Benitez,43,0,45,2
1745823345904,EDS 281,A00,895701,Meyerott; Theresa Ann,15,0,15,0
1745823346931,EDS 284,A00,895736,Meyerott; Theresa Ann,15,0,15,0
1745823347959,EDS 286,A00,897210,Fine; Sarah,15,0,15,0
1745823348987,EDS 289C,A01,895770,Daly; Alan J.,15,0,15,0
1745823350016,EDS 290,A00,897211,Hofstetter; Carolyn,15,0,15,0
1745823351042,LIGM 5A,A00,896162,Fischer-Grunski; Eva K,15,0,20,5
1745823352068,LIGM 5B,A00,896260,Fischer-Grunski; Eva K,17,0,20,3
1745823353093,LIGM 5C,A00,896308,Fischer-Grunski; Eva K,18,0,20,2
1745823354120,LIIT 5AS,A00,896313,Carnelos; Chiara,17,0,20,3
1745823355146,LIIT 5BS,A00,896416,Carnelos; Chiara,20,0,20,0
1745823356173,LIIT 5CS,A00,896564,Carnelos; Chiara,20,0,20,0
1745823357203,LISP 5A,A00,896588,Munoz Sanchez; Alicia,4,0,20,16
1745823358233,LISP 5B,A00,896653,Munoz Sanchez; Alicia,10,0,20,10
1745823359266,LISP 5C,A00,896655,Munoz Sanchez; Alicia,4,0,20,16
1745823360295,MAE 197,001,957918,Kleissl; Jan,9998,0,9999,1
1745823361324,MATH 2,A01,957937,Staff,34,0,35,1
1745823362352,MATH 197,001,957876,Kedlaya; Kiran S.,9993,0,9999,6
1745823363377,MCWP 40,A00,892729,Duru; Nur,13,0,20,7
1745823363377,MCWP 40,B00,893304,Montejo; Carolina,20,0,20,0
1745823364415,MCWP 40R,A00,893757,Redela; Pamela Morgan,0,7,20,20
1745823365440,MCWP 50,A00,893758,Morshed; Michael James,2,0,20,18
1745823365440,MCWP 50,B00,893761,Bartulis; Jason Michael,18,0,20,2
1745823366468,MCWP 50R,A00,893766,Compas; Sean Matthew,0,1,20,20
1745823366468,MCWP 50R,B00,893769,Carter; Jennifer A,0,0,20,20
1745823366468,MCWP 50R,C00,893771,Krone; Jarret,0,3,20,20
1745823366468,MCWP 50R,D00,893772,Miller; Elizabeth Deen,3,0,20,17
1745823366468,MCWP 50R,E00,893775,Carter; Andrea L,0,0,20,20
1745823367504,MMW 11R,A01,892721,Herbst; Matthew,11,0,27,16
1745823367504,MMW 11R,A02,892722,Herbst; Matthew,0,0,0,3
1745823368530,MMW 12R,A01,892724,Herbst; Matthew,0,10,16,16
1745823368530,MMW 12R,A02,892725,Herbst; Matthew,0,9,16,16
1745823369555,MMW 13R,A01,892727,Staff,0,3,16,16
1745823369555,MMW 13R,A02,892728,Staff,0,4,16,16
1745823369555,MMW 13R,A03,958032,Staff,0,3,16,16
1745823369555,MMW 13R,A04,958033,Staff,0,2,16,16
1745823369555,MMW 13R,A05,958034,Staff,0,3,16,16
1745823370581,SIO 295LS,A00,894015,Staff,7,0,25,18
1745823371609,SIO 295S,A00,894020,Staff,7,0,25,18
1745823372634,SIOC 290S,B01,958918,Staff,0,0,0,0
1745823373663,SIOC 291S,B01,958922,Staff,0,0,0,0
1745823374692,SOCI 117,A01,895339,Staff,4,0,5,1
1745823375718,WES 237B,A00,894149,Staff,11,0,20,9
1745823377780,AESE 279B,A00,891859,Staff,13,0,35,22
1745823378806,AIP 197,001,891854,Staff,70,0,70,0
1745823379833,ANTH 289S,A00,891856,Gagneux; Pascal,12,0,12,0
1745823380858,BENG 196,001,957946,Engler; Adam J.,9996,0,9999,3
1745823381884,CAT 124RS,A01,956906,Staff,8,0,25,17
1745823382912,CAT 125RS,A01,922013,Staff,8,0,25,17
1745823383937,CLRE 250,A00,891860,Morris; Sheldon,9995,0,9999,4
1745823385989,CLRE 251R,A00,907817,Mehta; Ravindra L.,9994,0,9999,5
1745823387016,CLRE 252,A00,891864,Cuomo; Raphael Eduardo,9993,0,9999,6
1745823388058,CLRE 253,A00,891867,Vaida; Florin,9994,0,9999,5
1745823388058,CLRE 253,B00,907819,Staff,9999,0,9999,0
1745823389083,CLRE 259,A00,891868,Patel; Hemal,9998,0,9999,1
1745823390108,CLRE 260,A00,891872,Cuomo; Raphael Eduardo,9999,0,9999,0
1745823391135,CLRE 297,001,891888,Cuomo; Raphael Eduardo,9999,0,9999,0
1745823392160,CSE 191,A00,958773,Minnes Kemp; Mor Mia,9999,0,9999,0
1745823393187,CSS 201S,A01,892054,Mignozzetti; Umberto,30,0,30,0
1745823394213,CSS 202S,A01,892056,Mignozzetti; Umberto,30,0,30,0
1745823395241,DSC 197,001,956898,Eldridge; Justin Matthew,9998,0,9999,1
1745823396267,DSC 297,001,958000,Mazumdar; Arya,9998,0,9999,1
1745823397292,EAP 100,A00,905686,Staff,9776,0,9999,223
1745823398320,ECE 45,A01,892618,Staff,0,13,50,50
1745823399346,ECE 109,A01,892620,Staff,0,43,0,0
1745823400376,ECE 111,A01,892719,Staff,0,9,50,50
1745823401404,ECE 197,001,957920,Mercier; Patrick Philip,9992,0,9999,7
1745823402434,ECON 178,A01,907814,Zhu; Ying,28,0,35,7
1745823403459,EDS 115,A00,895312,Staff,41,0,45,4
1745823404484,EDS 117,A01,895337,Staff,30,0,30,0
1745823405509,EDS 125,A00,895341,Jones; Gabrielle Anastasia,43,0,45,2
1745823406539,EDS 128A,A01,895459,Fargason; Sharon Gayle,44,0,45,1
1745823407568,EDS 128B,A01,895543,Pappas; Elizabeth,44,0,45,1
1745823408592,EDS 139,A00,897203,Pappas; Elizabeth,44,0,45,1
1745823408592,EDS 139,B00,897209,Fargason; Sharon Gayle,44,0,45,1
1745823409620,EDS 201,A00,895545,Staff,43,0,45,2
1745823410645,EDS 203,A01,895581,Halter; Christopher P.,43,0,45,2
1745823411671,EDS 204R,A01,895625,Heinzman; Erica M.,43,0,45,2
1745823411671,EDS 204R,B01,895693,Halter; Christopher P.,18,0,45,27
1745823412695,EDS 206R,A00,895694,Fargason; Sharon Gayle,9,0,30,21
1745823412695,EDS 206R,B00,895695,Choi; Bailey Miyeon,20,0,30,10
1745823413718,EDS 250,A00,895697,Hemans; Patricia Ann Benitez,43,0,45,2
1745823414747,EDS 281,A00,895701,Meyerott; Theresa Ann,15,0,15,0
1745823415772,EDS 284,A00,895736,Meyerott; Theresa Ann,15,0,15,0
1745823416799,EDS 286,A00,897210,Fine; Sarah,15,0,15,0
1745823417827,EDS 289C,A01,895770,Daly; Alan J.,15,0,15,0
1745823418853,EDS 290,A00,897211,Hofstetter; Carolyn,15,0,15,0
1745823419880,LIGM 5A,A00,896162,Fischer-Grunski; Eva K,15,0,20,5
1745823420908,LIGM 5B,A00,896260,Fischer-Grunski; Eva K,17,0,20,3
1745823421933,LIGM 5C,A00,896308,Fischer-Grunski; Eva K,18,0,20,2
1745823422957,LIIT 5AS,A00,896313,Carnelos; Chiara,17,0,20,3
1745823423988,LIIT 5BS,A00,896416,Carnelos; Chiara,20,0,20,0
1745823425012,LIIT 5CS,A00,896564,Carnelos; Chiara,20,0,20,0
1745823426038,LISP 5A,A00,896588,Munoz Sanchez; Alicia,4,0,20,16
1745823427067,LISP 5B,A00,896653,Munoz Sanchez; Alicia,10,0,20,10
1745823428096,LISP 5C,A00,896655,Munoz Sanchez; Alicia,4,0,20,16
1745823429120,MAE 197,001,957918,Kleissl; Jan,9998,0,9999,1
1745823430149,MATH 2,A01,957937,Staff,34,0,35,1
1745823431174,MATH 197,001,957876,Kedlaya; Kiran S.,9993,0,9999,6
1745823432200,MCWP 40,A00,892729,Duru; Nur,13,0,20,7
1745823432200,MCWP 40,B00,893304,Montejo; Carolina,20,0,20,0
1745823433225,MCWP 40R,A00,893757,Redela; Pamela Morgan,0,7,20,20
1745823434254,MCWP 50,A00,893758,Morshed; Michael James,2,0,20,18
1745823434254,MCWP 50,B00,893761,Bartulis; Jason Michael,18,0,20,2
1745823435284,MCWP 50R,A00,893766,Compas; Sean Matthew,0,1,20,20
1745823435284,MCWP 50R,B00,893769,Carter; Jennifer A,0,0,20,20
1745823435284,MCWP 50R,C00,893771,Krone; Jarret,0,3,20,20
1745823435284,MCWP 50R,D00,893772,Miller; Elizabeth Deen,3,0,20,17
1745823435284,MCWP 50R,E00,893775,Carter; Andrea L,0,0,20,20
1745823436311,MMW 11R,A01,892721,Herbst; Matthew,11,0,27,16
1745823436311,MMW 11R,A02,892722,Herbst; Matthew,0,0,0,3
1745823437337,MMW 12R,A01,892724,Herbst; Matthew,0,10,16,16
1745823437337,MMW 12R,A02,892725,Herbst; Matthew,0,9,16,16
1745823438366,MMW 13R,A01,892727,Staff,0,3,16,16
1745823438366,MMW 13R,A02,892728,Staff,0,4,16,16
1745823438366,MMW 13R,A03,958032,Staff,0,3,16,16
1745823438366,MMW 13R,A04,958033,Staff,0,2,16,16
1745823438366,MMW 13R,A05,958034,Staff,0,3,16,16
1745823439394,SIO 295LS,A00,894015,Staff,7,0,25,18
1745823440422,SIO 295S,A00,894020,Staff,7,0,25,18
1745823441452,SIOC 290S,B01,958918,Staff,0,0,0,0
1745823442482,SIOC 291S,B01,958922,Staff,0,0,0,0
1745823443511,SOCI 117,A01,895339,Staff,4,0,5,1
1745823444536,WES 237B,A00,894149,Staff,11,0,20,9
1745823446598,AESE 279B,A00,891859,Staff,13,0,35,22
1745823447624,AIP 197,001,891854,Staff,70,0,70,0
1745823448649,ANTH 289S,A00,891856,Gagneux; Pascal,12,0,12,0
1745823449678,BENG 196,001,957946,Engler; Adam J.,9996,0,9999,3
1745823450704,CAT 124RS,A01,956906,Staff,8,0,25,17
1745823451729,CAT 125RS,A01,922013,Staff,8,0,25,17
1745823452755,CLRE 250,A00,891860,Morris; Sheldon,9995,0,9999,4
1745823454809,CLRE 251R,A00,907817,Mehta; Ravindra L.,9994,0,9999,5
1745823455835,CLRE 252,A00,891864,Cuomo; Raphael Eduardo,9993,0,9999,6
1745823456859,CLRE 253,A00,891867,Vaida; Florin,9994,0,9999,5
1745823456859,CLRE 253,B00,907819,Staff,9999,0,9999,0
1745823457883,CLRE 259,A00,891868,Patel; Hemal,9998,0,9999,1
1745823458908,CLRE 260,A00,891872,Cuomo; Raphael Eduardo,9999,0,9999,0
1745823459934,CLRE 297,001,891888,Cuomo; Raphael Eduardo,9999,0,9999,0
1745823461013,CSE 191,A00,958773,Minnes Kemp; Mor Mia,9999,0,9999,0
1745823462042,CSS 201S,A01,892054,Mignozzetti; Umberto,30,0,30,0
1745823463072,CSS 202S,A01,892056,Mignozzetti; Umberto,30,0,30,0
1745823464097,DSC 197,001,956898,Eldridge; Justin Matthew,9998,0,9999,1
1745823465122,DSC 297,001,958000,Mazumdar; Arya,9998,0,9999,1
1745823466147,EAP 100,A00,905686,Staff,9776,0,9999,223
1745823467176,ECE 45,A01,892618,Staff,0,13,50,50
1745823468205,ECE 109,A01,892620,Staff,0,43,0,0
1745823469235,ECE 111,A01,892719,Staff,0,9,50,50
1745823470263,ECE 197,001,957920,Mercier; Patrick Philip,9992,0,9999,7
1745823471293,ECON 178,A01,907814,Zhu; Ying,28,0,35,7
1745823472319,EDS 115,A00,895312,Staff,41,0,45,4
1745823473347,EDS 117,A01,895337,Staff,30,0,30,0
1745823474373,EDS 125,A00,895341,Jones; Gabrielle Anastasia,43,0,45,2
1745823475400,EDS 128A,A01,895459,Fargason; Sharon Gayle,44,0,45,1
1745823476426,EDS 128B,A01,895543,Pappas; Elizabeth,44,0,45,1
1745823477454,EDS 139,A00,897203,Pappas; Elizabeth,44,0,45,1
1745823477454,EDS 139,B00,897209,Fargason; Sharon Gayle,44,0,45,1
1745823478479,EDS 201,A00,895545,Staff,43,0,45,2
1745823479503,EDS 203,A01,895581,Halter; Christopher P.,43,0,45,2
1745823480533,EDS 204R,A01,895625,Heinzman; Erica M.,43,0,45,2
1745823480533,EDS 204R,B01,895693,Halter; Christopher P.,18,0,45,27
1745823481559,EDS 206R,A00,895694,Fargason; Sharon Gayle,9,0,30,21
1745823481559,EDS 206R,B00,895695,Choi; Bailey Miyeon,20,0,30,10
1745823482588,EDS 250,A00,895697,Hemans; Patricia Ann Benitez,43,0,45,2
1745823483614,EDS 281,A00,895701,Meyerott; Theresa Ann,15,0,15,0
1745823484638,EDS 284,A00,895736,Meyerott; Theresa Ann,15,0,15,0
1745823485664,EDS 286,A00,897210,Fine; Sarah,15,0,15,0
1745823486690,EDS 289C,A01,895770,Daly; Alan J.,15,0,15,0
1745823487719,EDS 290,A00,897211,Hofstetter; Carolyn,15,0,15,0
1745823488748,LIGM 5A,A00,896162,Fischer-Grunski; Eva K,15,0,20,5
1745823489778,LIGM 5B,A00,896260,Fischer-Grunski; Eva K,17,0,20,3
1745823490804,LIGM 5C,A00,896308,Fischer-Grunski; Eva K,18,0,20,2
1745823491829,LIIT 5AS,A00,896313,Carnelos; Chiara,17,0,20,3
1745823492855,LIIT 5BS,A00,896416,Carnelos; Chiara,20,0,20,0
1745823493884,LIIT 5CS,A00,896564,Carnelos; Chiara,20,0,20,0
1745823494913,LISP 5A,A00,896588,Munoz Sanchez; Alicia,4,0,20,16
1745823495939,LISP 5B,A00,896653,Munoz Sanchez; Alicia,10,0,20,10
1745823496965,LISP 5C,A00,896655,Munoz Sanchez; Alicia,4,0,20,16
1745823497992,MAE 197,001,957918,Kleissl; Jan,9998,0,9999,1
1745823499017,MATH 2,A01,957937,Staff,34,0,35,1
1745823500045,MATH 197,001,957876,Kedlaya; Kiran S.,9993,0,9999,6
1745823501070,MCWP 40,A00,892729,Duru; Nur,13,0,20,7
1745823501070,MCWP 40,B00,893304,Montejo; Carolina,20,0,20,0
1745823502099,MCWP 40R,A00,893757,Redela; Pamela Morgan,0,7,20,20
1745823503123,MCWP 50,A00,893758,Morshed; Michael James,2,0,20,18
1745823503123,MCWP 50,B00,893761,Bartulis; Jason Michael,18,0,20,2
1745823504150,MCWP 50R,A00,893766,Compas; Sean Matthew,0,1,20,20
1745823504150,MCWP 50R,B00,893769,Carter; Jennifer A,0,0,20,20
1745823504150,MCWP 50R,C00,893771,Krone; Jarret,0,3,20,20
1745823504150,MCWP 50R,D00,893772,Miller; Elizabeth Deen,3,0,20,17
1745823504150,MCWP 50R,E00,893775,Carter; Andrea L,0,0,20,20
1745823505176,MMW 11R,A01,892721,Herbst; Matthew,11,0,27,16
1745823505176,MMW 11R,A02,892722,Herbst; Matthew,0,0,0,3
1745823506206,MMW 12R,A01,892724,Herbst; Matthew,0,10,16,16
1745823506206,MMW 12R,A02,892725,Herbst; Matthew,0,9,16,16
1745823507236,MMW 13R,A01,892727,Staff,0,3,16,16
1745823507236,MMW 13R,A02,892728,Staff,0,4,16,16
1745823507236,MMW 13R,A03,958032,Staff,0,3,16,16
1745823507236,MMW 13R,A04,958033,Staff,0,2,16,16
1745823507236,MMW 13R,A05,958034,Staff,0,3,16,16
1745823508261,SIO 295LS,A00,894015,Staff,7,0,25,18
1745823509292,SIO 295S,A00,894020,Staff,7,0,25,18
1745823510317,SIOC 290S,B01,958918,Staff,0,0,0,0
1745823511349,SIOC 291S,B01,958922,Staff,0,0,0,0
1745823512377,SOCI 117,A01,895339,Staff,4,0,5,1
1745823513401,WES 237B,A00,894149,Staff,11,0,20,9
1745823515471,AESE 279B,A00,891859,Staff,13,0,35,22
1745823516499,AIP 197,001,891854,Staff,70,0,70,0
1745823517525,ANTH 289S,A00,891856,Gagneux; Pascal,12,0,12,0
1745823518551,BENG 196,001,957946,Engler; Adam J.,9996,0,9999,3
1745823519577,CAT 124RS,A01,956906,Staff,8,0,25,17
1745823520601,CAT 125RS,A01,922013,Staff,8,0,25,17
1745823521628,CLRE 250,A00,891860,Morris; Sheldon,9995,0,9999,4
1745823523683,CLRE 251R,A00,907817,Mehta; Ravindra L.,9994,0,9999,5
1745823524708,CLRE 252,A00,891864,Cuomo; Raphael Eduardo,9993,0,9999,6
1745823525734,CLRE 253,A00,891867,Vaida; Florin,9994,0,9999,5
1745823525734,CLRE 253,B00,907819,Staff,9999,0,9999,0
1745823526758,CLRE 259,A00,891868,Patel; Hemal,9998,0,9999,1
1745823527784,CLRE 260,A00,891872,Cuomo; Raphael Eduardo,9999,0,9999,0
1745823528808,CLRE 297,001,891888,Cuomo; Raphael Eduardo,9999,0,9999,0
1745823529834,CSE 191,A00,958773,Minnes Kemp; Mor Mia,9999,0,9999,0
1745823530864,CSS 201S,A01,892054,Mignozzetti; Umberto,30,0,30,0
1745823531889,CSS 202S,A01,892056,Mignozzetti; Umberto,30,0,30,0
1745823532916,DSC 197,001,956898,Eldridge; Justin Matthew,9998,0,9999,1
1745823533941,DSC 297,001,958000,Mazumdar; Arya,9998,0,9999,1
1745823534969,EAP 100,A00,905686,Staff,9776,0,9999,223
1745823536052,ECE 45,A01,892618,Staff,0,13,50,50
1745823537079,ECE 109,A01,892620,Staff,0,43,0,0
1745823538105,ECE 111,A01,892719,Staff,0,9,50,50
1745823539132,ECE 197,001,957920,Mercier; Patrick Philip,9992,0,9999,7
1745823540157,ECON 178,A01,907814,Zhu; Ying,28,0,35,7
1745823541185,EDS 115,A00,895312,Staff,41,0,45,4
1745823542213,EDS 117,A01,895337,Staff,30,0,30,0
1745823543237,EDS 125,A00,895341,Jones; Gabrielle Anastasia,43,0,45,2
1745823544263,EDS 128A,A01,895459,Fargason; Sharon Gayle,44,0,45,1
1745823545288,EDS 128B,A01,895543,Pappas; Elizabeth,44,0,45,1
1745823546314,EDS 139,A00,897203,Pappas; Elizabeth,44,0,45,1
1745823546314,EDS 139,B00,897209,Fargason; Sharon Gayle,44,0,45,1
1745823547339,EDS 201,A00,895545,Staff,43,0,45,2
1745823548366,EDS 203,A01,895581,Halter; Christopher P.,43,0,45,2
1745823549395,EDS 204R,A01,895625,Heinzman; Erica M.,43,0,45,2
1745823549395,EDS 204R,B01,895693,Halter; Christopher P.,18,0,45,27
1745823550422,EDS 206R,A00,895694,Fargason; Sharon Gayle,9,0,30,21
1745823550422,EDS 206R,B00,895695,Choi; Bailey Miyeon,20,0,30,10
1745823551446,EDS 250,A00,895697,Hemans; Patricia Ann Benitez,43,0,45,2
1745823552475,EDS 281,A00,895701,Meyerott; Theresa Ann,15,0,15,0
1745823553503,EDS 284,A00,895736,Meyerott; Theresa Ann,15,0,15,0
1745823554529,EDS 286,A00,897210,Fine; Sarah,15,0,15,0
1745823555558,EDS 289C,A01,895770,Daly; Alan J.,15,0,15,0
1745823556582,EDS 290,A00,897211,Hofstetter; Carolyn,15,0,15,0
1745823557613,LIGM 5A,A00,896162,Fischer-Grunski; Eva K,15,0,20,5
1745823558643,LIGM 5B,A00,896260,Fischer-Grunski; Eva K,17,0,20,3
1745823559673,LIGM 5C,A00,896308,Fischer-Grunski; Eva K,18,0,20,2
1745823560701,LIIT 5AS,A00,896313,Carnelos; Chiara,17,0,20,3
1745823561732,LIIT 5BS,A00,896416,Carnelos; Chiara,20,0,20,0
1745823562759,LIIT 5CS,A00,896564,Carnelos; Chiara,20,0,20,0
1745823563789,LISP 5A,A00,896588,Munoz Sanchez; Alicia,4,0,20,16
1745823564818,LISP 5B,A00,896653,Munoz Sanchez; Alicia,10,0,20,10
1745823565847,LISP 5C,A00,896655,Munoz Sanchez; Alicia,4,0,20,16
1745823566872,MAE 197,001,957918,Kleissl; Jan,9998,0,9999,1
1745823567898,MATH 2,A01,957937,Staff,34,0,35,1
1745823568927,MATH 197,001,957876,Kedlaya; Kiran S.,9993,0,9999,6
1745823569956,MCWP 40,A00,892729,Duru; Nur,13,0,20,7
1745823569956,MCWP 40,B00,893304,Montejo; Carolina,20,0,20,0
1745823570983,MCWP 40R,A00,893757,Redela; Pamela Morgan,0,7,20,20
1745823572008,MCWP 50,A00,893758,Morshed; Michael James,2,0,20,18
1745823572008,MCWP 50,B00,893761,Bartulis; Jason Michael,18,0,20,2
1745823573038,MCWP 50R,A00,893766,Compas; Sean Matthew,0,1,20,20
1745823573038,MCWP 50R,B00,893769,Carter; Jennifer A,0,0,20,20
1745823573038,MCWP 50R,C00,893771,Krone; Jarret,0,3,20,20
1745823573038,MCWP 50R,D00,893772,Miller; Elizabeth Deen,3,0,20,17
1745823573038,MCWP 50R,E00,893775,Carter; Andrea L,0,0,20,20
1745823574065,MMW 11R,A01,892721,Herbst; Matthew,11,0,27,16
1745823574065,MMW 11R,A02,892722,Herbst; Matthew,0,0,0,3
1745823575094,MMW 12R,A01,892724,Herbst; Matthew,0,10,16,16
1745823575094,MMW 12R,A02,892725,Herbst; Matthew,0,9,16,16
1745823576124,MMW 13R,A01,892727,Staff,0,3,16,16
1745823576124,MMW 13R,A02,892728,Staff,0,4,16,16
1745823576124,MMW 13R,A03,958032,Staff,0,3,16,16
1745823576124,MMW 13R,A04,958033,Staff,0,2,16,16
1745823576124,MMW 13R,A05,958034,Staff,0,3,16,16
1745823577151,SIO 295LS,A00,894015,Staff,7,0,25,18
1745823578178,SIO 295S,A00,894020,Staff,7,0,25,18
1745823579203,SIOC 290S,B01,958918,Staff,0,0,0,0
1745823580232,SIOC 291S,B01,958922,Staff,0,0,0,0
1745823581258,SOCI 117,A01,895339,Staff,4,0,5,1
1745823582286,WES 237B,A00,894149,Staff,11,0,20,9
1745823584352,AESE 279B,A00,891859,Staff,13,0,35,22
1745823585381,AIP 197,001,891854,Staff,70,0,70,0
1745823586407,ANTH 289S,A00,891856,Gagneux; Pascal,12,0,12,0
1745823587435,BENG 196,001,957946,Engler; Adam J.,9996,0,9999,3
1745823588461,CAT 124RS,A01,956906,Staff,8,0,25,17
1745823589489,CAT 125RS,A01,922013,Staff,8,0,25,17
1745823590516,CLRE 250,A00,891860,Morris; Sheldon,9995,0,9999,4
1745823592567,CLRE 251R,A00,907817,Mehta; Ravindra L.,9994,0,9999,5
1745823593593,CLRE 252,A00,891864,Cuomo; Raphael Eduardo,9993,0,9999,6
1745823594620,CLRE 253,A00,891867,Vaida; Florin,9994,0,9999,5
1745823594620,CLRE 253,B00,907819,Staff,9999,0,9999,0
1745823595646,CLRE 259,A00,891868,Patel; Hemal,9998,0,9999,1
1745823596675,CLRE 260,A00,891872,Cuomo; Raphael Eduardo,9999,0,9999,0
1745823597700,CLRE 297,001,891888,Cuomo; Raphael Eduardo,9999,0,9999,0
1745823598724,CSE 191,A00,958773,Minnes Kemp; Mor Mia,9999,0,9999,0
1745823599749,CSS 201S,A01,892054,Mignozzetti; Umberto,30,0,30,0
1745823600775,CSS 202S,A01,892056,Mignozzetti; Umberto,30,0,30,0
1745823601801,DSC 197,001,956898,Eldridge; Justin Matthew,9998,0,9999,1
1745823602827,DSC 297,001,958000,Mazumdar; Arya,9998,0,9999,1
1745823603852,EAP 100,A00,905686,Staff,9776,0,9999,223
1745823604877,ECE 45,A01,892618,Staff,0,13,50,50
1745823605904,ECE 109,A01,892620,Staff,0,43,0,0
1745823606930,ECE 111,A01,892719,Staff,0,9,50,50
1745823607955,ECE 197,001,957920,Mercier; Patrick Philip,9992,0,9999,7
1745823608982,ECON 178,A01,907814,Zhu; Ying,28,0,35,7
1745823610009,EDS 115,A00,895312,Staff,41,0,45,4
1745823611040,EDS 117,A01,895337,Staff,30,0,30,0
1745823612066,EDS 125,A00,895341,Jones; Gabrielle Anastasia,43,0,45,2
1745823613095,EDS 128A,A01,895459,Fargason; Sharon Gayle,44,0,45,1
1745823614126,EDS 128B,A01,895543,Pappas; Elizabeth,44,0,45,1
1745823615152,EDS 139,A00,897203,Pappas; Elizabeth,44,0,45,1
1745823615152,EDS 139,B00,897209,Fargason; Sharon Gayle,44,0,45,1
1745823616178,EDS 201,A00,895545,Staff,43,0,45,2
1745823617208,EDS 203,A01,895581,Halter; Christopher P.,43,0,45,2
1745823618234,EDS 204R,A01,895625,Heinzman; Erica M.,43,0,45,2
1745823618234,EDS 204R,B01,895693,Halter; Christopher P.,18,0,45,27
1745823619260,EDS 206R,A00,895694,Fargason; Sharon Gayle,9,0,30,21
1745823619260,EDS 206R,B00,895695,Choi; Bailey Miyeon,20,0,30,10
1745823620288,EDS 250,A00,895697,Hemans; Patricia Ann Benitez,43,0,45,2
1745823621315,EDS 281,A00,895701,Meyerott; Theresa Ann,15,0,15,0
1745823622342,EDS 284,A00,895736,Meyerott; Theresa Ann,15,0,15,0
1745823623366,EDS 286,A00,897210,Fine; Sarah,15,0,15,0
1745823624397,EDS 289C,A01,895770,Daly; Alan J.,15,0,15,0
1745823625423,EDS 290,A00,897211,Hofstetter; Carolyn,15,0,15,0
1745823626450,LIGM 5A,A00,896162,Fischer-Grunski; Eva K,15,0,20,5
1745823627477,LIGM 5B,A00,896260,Fischer-Grunski; Eva K,17,0,20,3
1745823628502,LIGM 5C,A00,896308,Fischer-Grunski; Eva K,18,0,20,2
1745823629531,LIIT 5AS,A00,896313,Carnelos; Chiara,17,0,20,3
1745823630559,LIIT 5BS,A00,896416,Carnelos; Chiara,20,0,20,0
1745823631583,LIIT 5CS,A00,896564,Carnelos; Chiara,20,0,20,0
1745823632610,LISP 5A,A00,896588,Munoz Sanchez; Alicia,4,0,20,16
1745823633636,LISP 5B,A00,896653,Munoz Sanchez; Alicia,10,0,20,10
1745823634660,LISP 5C,A00,896655,Munoz Sanchez; Alicia,4,0,20,16
1745823635685,MAE 197,001,957918,Kleissl; Jan,9998,0,9999,1
1745823636710,MATH 2,A01,957937,Staff,34,0,35,1
1745823637734,MATH 197,001,957876,Kedlaya; Kiran S.,9993,0,9999,6
1745823638759,MCWP 40,A00,892729,Duru; Nur,13,0,20,7
1745823638759,MCWP 40,B00,893304,Montejo; Carolina,20,0,20,0
1745823639784,MCWP 40R,A00,893757,Redela; Pamela Morgan,0,7,20,20
1745823640811,MCWP 50,A00,893758,Morshed; Michael James,2,0,20,18
1745823640811,MCWP 50,B00,893761,Bartulis; Jason Michael,18,0,20,2
1745823641838,MCWP 50R,A00,893766,Compas; Sean Matthew,0,1,20,20
1745823641838,MCWP 50R,B00,893769,Carter; Jennifer A,0,0,20,20
1745823641838,MCWP 50R,C00,893771,Krone; Jarret,0,3,20,20
1745823641838,MCWP 50R,D00,893772,Miller; Elizabeth Deen,3,0,20,17
1745823641838,MCWP 50R,E00,893775,Carter; Andrea L,0,0,20,20
1745823642867,MMW 11R,A01,892721,Herbst; Matthew,11,0,27,16
1745823642867,MMW 11R,A02,892722,Herbst; Matthew,0,0,0,3
1745823643895,MMW 12R,A01,892724,Herbst; Matthew,0,10,16,16
1745823643895,MMW 12R,A02,892725,Herbst; Matthew,0,9,16,16
1745823644921,MMW 13R,A01,892727,Staff,0,3,16,16
1745823644921,MMW 13R,A02,892728,Staff,0,4,16,16
1745823644921,MMW 13R,A03,958032,Staff,0,3,16,16
1745823644921,MMW 13R,A04,958033,Staff,0,2,16,16
1745823644921,MMW 13R,A05,958034,Staff,0,3,16,16
1745823645949,SIO 295LS,A00,894015,Staff,7,0,25,18
1745823646979,SIO 295S,A00,894020,Staff,7,0,25,18
1745823648006,SIOC 290S,B01,958918,Staff,0,0,0,0
1745823649033,SIOC 291S,B01,958922,Staff,0,0,0,0
1745823650063,SOCI 117,A01,895339,Staff,4,0,5,1
1745823651091,WES 237B,A00,894149,Staff,11,0,20,9
1745823653160,AESE 279B,A00,891859,Staff,13,0,35,22
1745823654184,AIP 197,001,891854,Staff,70,0,70,0
1745823655212,ANTH 289S,A00,891856,Gagneux; Pascal,12,0,12,0
1745823656236,BENG 196,001,957946,Engler; Adam J.,9996,0,9999,3
1745823657265,CAT 124RS,A01,956906,Staff,8,0,25,17
1745823658296,CAT 125RS,A01,922013,Staff,8,0,25,17
1745823659576,CLRE 250,A00,891860,Morris; Sheldon,9995,0,9999,4
1745823661643,CLRE 251R,A00,907817,Mehta; Ravindra L.,9994,0,9999,5
1745823662673,CLRE 252,A00,891864,Cuomo; Raphael Eduardo,9993,0,9999,6
1745823663704,CLRE 253,A00,891867,Vaida; Florin,9994,0,9999,5
1745823663704,CLRE 253,B00,907819,Staff,9999,0,9999,0
1745823664734,CLRE 259,A00,891868,Patel; Hemal,9998,0,9999,1
1745823665760,CLRE 260,A00,891872,Cuomo; Raphael Eduardo,9999,0,9999,0
1745823666789,CLRE 297,001,891888,Cuomo; Raphael Eduardo,9999,0,9999,0
1745823667819,CSE 191,A00,958773,Minnes Kemp; Mor Mia,9999,0,9999,0
1745823668851,CSS 201S,A01,892054,Mignozzetti; Umberto,30,0,30,0
1745823669882,CSS 202S,A01,892056,Mignozzetti; Umberto,30,0,30,0
1745823670913,DSC 197,001,956898,Eldridge; Justin Matthew,9998,0,9999,1
1745823671938,DSC 297,001,958000,Mazumdar; Arya,9998,0,9999,1
1745823672966,EAP 100,A00,905686,Staff,9776,0,9999,223
1745823673992,ECE 45,A01,892618,Staff,0,13,50,50
1745823675025,ECE 109,A01,892620,Staff,0,43,0,0
1745823676052,ECE 111,A01,892719,Staff,0,9,50,50
1745823677079,ECE 197,001,957920,Mercier; Patrick Philip,9992,0,9999,7
1745823678108,ECON 178,A01,907814,Zhu; Ying,28,0,35,7
1745823679139,EDS 115,A00,895312,Staff,41,0,45,4
1745823680166,EDS 117,A01,895337,Staff,30,0,30,0
1745823681198,EDS 125,A00,895341,Jones; Gabrielle Anastasia,43,0,45,2
1745823682226,EDS 128A,A01,895459,Fargason; Sharon Gayle,44,0,45,1
1745823683258,EDS 128B,A01,895543,Pappas; Elizabeth,44,0,45,1
1745823684288,EDS 139,A00,897203,Pappas; Elizabeth,44,0,45,1
1745823684288,EDS 139,B00,897209,Fargason; Sharon Gayle,44,0,45,1
1745823685314,EDS 201,A00,895545,Staff,43,0,45,2
1745823686340,EDS 203,A01,895581,Halter; Christopher P.,43,0,45,2
1745823687371,EDS 204R,A01,895625,Heinzman; Erica M.,43,0,45,2
1745823687371,EDS 204R,B01,895693,Halter; Christopher P.,18,0,45,27
1745823694194,EDS 206R,A00,895694,Fargason; Sharon Gayle,9,0,30,21
1745823694194,EDS 206R,B00,895695,Choi; Bailey Miyeon,20,0,30,10
1745823697728,EDS 250,A00,895697,Hemans; Patricia Ann Benitez,43,0,45,2
1745823698754,EDS 281,A00,895701,Meyerott; Theresa Ann,15,0,15,0
1745823699782,EDS 284,A00,895736,Meyerott; Theresa Ann,15,0,15,0
1745823700818,EDS 286,A00,897210,Fine; Sarah,15,0,15,0
1745823701842,EDS 289C,A01,895770,Daly; Alan J.,15,0,15,0
1745823702871,EDS 290,A00,897211,Hofstetter; Carolyn,15,0,15,0
1745823703905,LIGM 5A,A00,896162,Fischer-Grunski; Eva K,15,0,20,5
1745823704943,LIGM 5B,A00,896260,Fischer-Grunski; Eva K,17,0,20,3
1745823705978,LIGM 5C,A00,896308,Fischer-Grunski; Eva K,18,0,20,2
1745823707006,LIIT 5AS,A00,896313,Carnelos; Chiara,17,0,20,3
1745823708043,LIIT 5BS,A00,896416,Carnelos; Chiara,20,0,20,0
1745823709072,LIIT 5CS,A00,896564,Carnelos; Chiara,20,0,20,0
1745823710115,LISP 5A,A00,896588,Munoz Sanchez; Alicia,4,0,20,16
1745823711151,LISP 5B,A00,896653,Munoz Sanchez; Alicia,10,0,20,10
1745823712192,LISP 5C,A00,896655,Munoz Sanchez; Alicia,4,0,20,16
1745823713219,MAE 197,001,957918,Kleissl; Jan,9998,0,9999,1
1745823714251,MATH 2,A01,957937,Staff,34,0,35,1
1745823715276,MATH 197,001,957876,Kedlaya; Kiran S.,9993,0,9999,6
1745823716304,MCWP 40,A00,892729,Duru; Nur,13,0,20,7
1745823716304,MCWP 40,B00,893304,Montejo; Carolina,20,0,20,0
1745823717329,MCWP 40R,A00,893757,Redela; Pamela Morgan,0,7,20,20
1745823718370,MCWP 50,A00,893758,Morshed; Michael James,2,0,20,18
1745823718370,MCWP 50,B00,893761,Bartulis; Jason Michael,18,0,20,2
1745823719397,MCWP 50R,A00,893766,Compas; Sean Matthew,0,1,20,20
1745823719397,MCWP 50R,B00,893769,Carter; Jennifer A,0,0,20,20
1745823719397,MCWP 50R,C00,893771,Krone; Jarret,0,3,20,20
1745823719397,MCWP 50R,D00,893772,Miller; Elizabeth Deen,3,0,20,17
1745823719397,MCWP 50R,E00,893775,Carter; Andrea L,0,0,20,20
1745823720481,MMW 11R,A01,892721,Herbst; Matthew,11,0,27,16
1745823720481,MMW 11R,A02,892722,Herbst; Matthew,0,0,0,3
1745823721507,MMW 12R,A01,892724,Herbst; Matthew,0,10,16,16
1745823721507,MMW 12R,A02,892725,Herbst; Matthew,0,9,16,16
1745823722534,MMW 13R,A01,892727,Staff,0,3,16,16
1745823722534,MMW 13R,A02,892728,Staff,0,4,16,16
1745823722534,MMW 13R,A03,958032,Staff,0,3,16,16
1745823722534,MMW 13R,A04,958033,Staff,0,2,16,16
1745823722534,MMW 13R,A05,958034,Staff,0,3,16,16
1745823723560,SIO 295LS,A00,894015,Staff,7,0,25,18
1745823724594,SIO 295S,A00,894020,Staff,7,0,25,18
1745823725621,SIOC 290S,B01,958918,Staff,0,0,0,0
1745823726650,SIOC 291S,B01,958922,Staff,0,0,0,0
1745823727674,SOCI 117,A01,895339,Staff,4,0,5,1
1745823728705,WES 237B,A00,894149,Staff,11,0,20,9
1745823730775,AESE 279B,A00,891859,Staff,13,0,35,22
1745823731805,AIP 197,001,891854,Staff,70,0,70,0
1745823732837,ANTH 289S,A00,891856,Gagneux; Pascal,12,0,12,0
1745823733866,BENG 196,001,957946,Engler; Adam J.,9996,0,9999,3
1745823734890,CAT 124RS,A01,956906,Staff,8,0,25,17
1745823735919,CAT 125RS,A01,922013,Staff,8,0,25,17
1745823736949,CLRE 250,A00,891860,Morris; Sheldon,9995,0,9999,4
1745823739006,CLRE 251R,A00,907817,Mehta; Ravindra L.,9994,0,9999,5
1745823740034,CLRE 252,A00,891864,Cuomo; Raphael Eduardo,9993,0,9999,6
1745823741060,CLRE 253,A00,891867,Vaida; Florin,9994,0,9999,5
1745823741060,CLRE 253,B00,907819,Staff,9999,0,9999,0
1745823742090,CLRE 259,A00,891868,Patel; Hemal,9998,0,9999,1
1745823743122,CLRE 260,A00,891872,Cuomo; Raphael Eduardo,9999,0,9999,0
1745823744147,CLRE 297,001,891888,Cuomo; Raphael Eduardo,9999,0,9999,0
1745823745175,CSE 191,A00,958773,Minnes Kemp; Mor Mia,9999,0,9999,0
1745823746201,CSS 201S,A01,892054,Mignozzetti; Umberto,30,0,30,0
1745823747229,CSS 202S,A01,892056,Mignozzetti; Umberto,30,0,30,0
1745823748255,DSC 197,001,956898,Eldridge; Justin Matthew,9998,0,9999,1
1745823749280,DSC 297,001,958000,Mazumdar; Arya,9998,0,9999,1
1745823750317,EAP 100,A00,905686,Staff,9776,0,9999,223
1745823751345,ECE 45,A01,892618,Staff,0,13,50,50
1745823752382,ECE 109,A01,892620,Staff,0,43,0,0
1745823753408,ECE 111,A01,892719,Staff,0,9,50,50
1745823754434,ECE 197,001,957920,Mercier; Patrick Philip,9992,0,9999,7
1745823755464,ECON 178,A01,907814,Zhu; Ying,28,0,35,7
1745823756491,EDS 115,A00,895312,Staff,41,0,45,4
1745823757525,EDS 117,A01,895337,Staff,30,0,30,0
1745823758560,EDS 125,A00,895341,Jones; Gabrielle Anastasia,43,0,45,2
1745823760149,EDS 128A,A01,895459,Fargason; Sharon Gayle,44,0,45,1
1745823761181,EDS 128B,A01,895543,Pappas; Elizabeth,44,0,45,1
1745823762207,EDS 139,A00,897203,Pappas; Elizabeth,44,0,45,1
1745823762207,EDS 139,B00,897209,Fargason; Sharon Gayle,44,0,45,1
1745823763239,EDS 201,A00,895545,Staff,43,0,45,2
1745823764278,EDS 203,A01,895581,Halter; Christopher P.,43,0,45,2
1745823765311,EDS 204R,A01,895625,Heinzman; Erica M.,43,0,45,2
1745823765311,EDS 204R,B01,895693,Halter; Christopher P.,18,0,45,27
1745823766349,EDS 206R,A00,895694,Fargason; Sharon Gayle,9,0,30,21
1745823766349,EDS 206R,B00,895695,Choi; Bailey Miyeon,20,0,30,10
1745823767375,EDS 250,A00,895697,Hemans; Patricia Ann Benitez,43,0,45,2
1745823768409,EDS 281,A00,895701,Meyerott; Theresa Ann,15,0,15,0
1745823769435,EDS 284,A00,895736,Meyerott; Theresa Ann,15,0,15,0
1745823770465,EDS 286,A00,897210,Fine; Sarah,15,0,15,0
1745823771497,EDS 289C,A01,895770,Daly; Alan J.,15,0,15,0
1745823772533,EDS 290,A00,897211,Hofstetter; Carolyn,15,0,15,0
1745823773568,LIGM 5A,A00,896162,Fischer-Grunski; Eva K,15,0,20,5
1745823774594,LIGM 5B,A00,896260,Fischer-Grunski; Eva K,17,0,20,3
1745823775639,LIGM 5C,A00,896308,Fischer-Grunski; Eva K,18,0,20,2
1745823776667,LIIT 5AS,A00,896313,Carnelos; Chiara,17,0,20,3
1745823777704,LIIT 5BS,A00,896416,Carnelos; Chiara,20,0,20,0
1745823778736,LIIT 5CS,A00,896564,Carnelos; Chiara,20,0,20,0
1745823779763,LISP 5A,A00,896588,Munoz Sanchez; Alicia,4,0,20,16
1745823780787,LISP 5B,A00,896653,Munoz Sanchez; Alicia,10,0,20,10
1745823781812,LISP 5C,A00,896655,Munoz Sanchez; Alicia,4,0,20,16
1745823782839,MAE 197,001,957918,Kleissl; Jan,9998,0,9999,1
1745823783875,MATH 2,A01,957937,Staff,34,0,35,1
1745823784901,MATH 197,001,957876,Kedlaya; Kiran S.,9993,0,9999,6
1745823785927,MCWP 40,A00,892729,Duru; Nur,13,0,20,7
1745823785927,MCWP 40,B00,893304,Montejo; Carolina,20,0,20,0
1745823786959,MCWP 40R,A00,893757,Redela; Pamela Morgan,0,7,20,20
1745823787986,MCWP 50,A00,893758,Morshed; Michael James,2,0,20,18
1745823787986,MCWP 50,B00,893761,Bartulis; Jason Michael,18,0,20,2
1745823789012,MCWP 50R,A00,893766,Compas; Sean Matthew,0,1,20,20
1745823789012,MCWP 50R,B00,893769,Carter; Jennifer A,0,0,20,20
1745823789012,MCWP 50R,C00,893771,Krone; Jarret,0,3,20,20
1745823789012,MCWP 50R,D00,893772,Miller; Elizabeth Deen,3,0,20,17
1745823789012,MCWP 50R,E00,893775,Carter; Andrea L,0,0,20,20
1745823790050,MMW 11R,A01,892721,Herbst; Matthew,11,0,27,16
1745823790050,MMW 11R,A02,892722,Herbst; Matthew,0,0,0,3
1745823791075,MMW 12R,A01,892724,Herbst; Matthew,0,10,16,16
1745823791075,MMW 12R,A02,892725,Herbst; Matthew,0,9,16,16
1745823792108,MMW 13R,A01,892727,Staff,0,3,16,16
1745823792108,MMW 13R,A02,892728,Staff,0,4,16,16
1745823792108,MMW 13R,A03,958032,Staff,0,3,16,16
1745823792108,MMW 13R,A04,958033,Staff,0,2,16,16
1745823792108,MMW 13R,A05,958034,Staff,0,3,16,16
1745823793132,SIO 295LS,A00,894015,Staff,7,0,25,18
1745823794166,SIO 295S,A00,894020,Staff,7,0,25,18
1745823795193,SIOC 290S,B01,958918,Staff,0,0,0,0
1745823796218,SIOC 291S,B01,958922,Staff,0,0,0,0
1745823797246,SOCI 117,A01,895339,Staff,4,0,5,1
1745823798271,WES 237B,A00,894149,Staff,11,0,20,9
1745823800391,AESE 279B,A00,891859,Staff,13,0,35,22
1745823801417,AIP 197,001,891854,Staff,70,0,70,0
1745823802451,ANTH 289S,A00,891856,Gagneux; Pascal,12,0,12,0
1745823803484,BENG 196,001,957946,Engler; Adam J.,9996,0,9999,3
1745823804513,CAT 124RS,A01,956906,Staff,8,0,25,17
1745823805546,CAT 125RS,A01,922013,Staff,8,0,25,17
1745823806583,CLRE 250,A00,891860,Morris; Sheldon,9995,0,9999,4
1745823808636,CLRE 251R,A00,907817,Mehta; Ravindra L.,9994,0,9999,5
1745823809664,CLRE 252,A00,891864,Cuomo; Raphael Eduardo,9993,0,9999,6
1745823810692,CLRE 253,A00,891867,Vaida; Florin,9994,0,9999,5
1745823810692,CLRE 253,B00,907819,Staff,9999,0,9999,0
1745823811719,CLRE 259,A00,891868,Patel; Hemal,9998,0,9999,1
1745823812745,CLRE 260,A00,891872,Cuomo; Raphael Eduardo,9999,0,9999,0
1745823813772,CLRE 297,001,891888,Cuomo; Raphael Eduardo,9999,0,9999,0
1745823814804,CSE 191,A00,958773,Minnes Kemp; Mor Mia,9999,0,9999,0
1745823815838,CSS 201S,A01,892054,Mignozzetti; Umberto,30,0,30,0
1745823816869,CSS 202S,A01,892056,Mignozzetti; Umberto,30,0,30,0
1745823817895,DSC 197,001,956898,Eldridge; Justin Matthew,9998,0,9999,1
1745823818920,DSC 297,001,958000,Mazumdar; Arya,9998,0,9999,1
1745823819953,EAP 100,A00,905686,Staff,9776,0,9999,223
1745823820985,ECE 45,A01,892618,Staff,0,13,50,50
1745823822019,ECE 109,A01,892620,Staff,0,43,0,0
1745823823045,ECE 111,A01,892719,Staff,0,9,50,50
1745823824072,ECE 197,001,957920,Mercier; Patrick Philip,9992,0,9999,7
1745823825150,ECON 178,A01,907814,Zhu; Ying,28,0,35,7
1745823826175,EDS 115,A00,895312,Staff,41,0,45,4
1745823827202,EDS 117,A01,895337,Staff,30,0,30,0
1745823828228,EDS 125,A00,895341,Jones; Gabrielle Anastasia,43,0,45,2
1745823829263,EDS 128A,A01,895459,Fargason; Sharon Gayle,44,0,45,1
1745823830290,EDS 128B,A01,895543,Pappas; Elizabeth,44,0,45,1
1745823831323,EDS 139,A00,897203,Pappas; Elizabeth,44,0,45,1
1745823831323,EDS 139,B00,897209,Fargason; Sharon Gayle,44,0,45,1
1745823832356,EDS 201,A00,895545,Staff,43,0,45,2
1745823833382,EDS 203,A01,895581,Halter; Christopher P.,43,0,45,2
1745823834408,EDS 204R,A01,895625,Heinzman; Erica M.,43,0,45,2
1745823834408,EDS 204R,B01,895693,Halter; Christopher P.,18,0,45,27
1745823835440,EDS 206R,A00,895694,Fargason; Sharon Gayle,9,0,30,21
1745823835440,EDS 206R,B00,895695,Choi; Bailey Miyeon,20,0,30,10
1745823836472,EDS 250,A00,895697,Hemans; Patricia Ann Benitez,43,0,45,2
1745823837498,EDS 281,A00,895701,Meyerott; Theresa Ann,15,0,15,0
1745823838523,EDS 284,A00,895736,Meyerott; Theresa Ann,15,0,15,0
1745823839549,EDS 286,A00,897210,Fine; Sarah,15,0,15,0
1745823840582,EDS 289C,A01,895770,Daly; Alan J.,15,0,15,0
1745823841607,EDS 290,A00,897211,Hofstetter; Carolyn,15,0,15,0
1745823842631,LIGM 5A,A00,896162,Fischer-Grunski; Eva K,15,0,20,5
1745823843659,LIGM 5B,A00,896260,Fischer-Grunski; Eva K,17,0,20,3
1745823844698,LIGM 5C,A00,896308,Fischer-Grunski; Eva K,18,0,20,2
1745823845732,LIIT 5AS,A00,896313,Carnelos; Chiara,17,0,20,3
1745823846764,LIIT 5BS,A00,896416,Carnelos; Chiara,20,0,20,0
1745823847801,LIIT 5CS,A00,896564,Carnelos; Chiara,20,0,20,0
1745823848832,LISP 5A,A00,896588,Munoz Sanchez; Alicia,4,0,20,16
1745823849865,LISP 5B,A00,896653,Munoz Sanchez; Alicia,10,0,20,10
1745823850900,LISP 5C,A00,896655,Munoz Sanchez; Alicia,4,0,20,16
1745823851933,MAE 197,001,957918,Kleissl; Jan,9998,0,9999,1
1745823852966,MATH 2,A01,957937,Staff,34,0,35,1
1745823853992,MATH 197,001,957876,Kedlaya; Kiran S.,9993,0,9999,6
1745823855039,MCWP 40,A00,892729,Duru; Nur,13,0,20,7
1745823855039,MCWP 40,B00,893304,Montejo; Carolina,20,0,20,0
1745823856065,MCWP 40R,A00,893757,Redela; Pamela Morgan,0,7,20,20
1745823857091,MCWP 50,A00,893758,Morshed; Michael James,2,0,20,18
1745823857091,MCWP 50,B00,893761,Bartulis; Jason Michael,18,0,20,2
1745823858126,MCWP 50R,A00,893766,Compas; Sean Matthew,0,1,20,20
1745823858126,MCWP 50R,B00,893769,Carter; Jennifer A,0,0,20,20
1745823858126,MCWP 50R,C00,893771,Krone; Jarret,0,3,20,20
1745823858126,MCWP 50R,D00,893772,Miller; Elizabeth Deen,3,0,20,17
1745823858126,MCWP 50R,E00,893775,Carter; Andrea L,0,0,20,20
1745823859152,MMW 11R,A01,892721,Herbst; Matthew,11,0,27,16
1745823859152,MMW 11R,A02,892722,Herbst; Matthew,0,0,0,3
1745823860187,MMW 12R,A01,892724,Herbst; Matthew,0,10,16,16
1745823860187,MMW 12R,A02,892725,Herbst; Matthew,0,9,16,16
1745823861215,MMW 13R,A01,892727,Staff,0,3,16,16
1745823861215,MMW 13R,A02,892728,Staff,0,4,16,16
1745823861215,MMW 13R,A03,958032,Staff,0,3,16,16
1745823861215,MMW 13R,A04,958033,Staff,0,2,16,16
1745823861215,MMW 13R,A05,958034,Staff,0,3,16,16
1745823862242,SIO 295LS,A00,894015,Staff,7,0,25,18
1745823863269,SIO 295S,A00,894020,Staff,7,0,25,18
1745823864300,SIOC 290S,B01,958918,Staff,0,0,0,0
1745823865334,SIOC 291S,B01,958922,Staff,0,0,0,0
1745823866365,SOCI 117,A01,895339,Staff,4,0,5,1
1745823867392,WES 237B,A00,894149,Staff,11,0,20,9
1745823869467,AESE 279B,A00,891859,Staff,13,0,35,22
1745823870498,AIP 197,001,891854,Staff,70,0,70,0
1745823871524,ANTH 289S,A00,891856,Gagneux; Pascal,12,0,12,0
1745823872551,BENG 196,001,957946,Engler; Adam J.,9996,0,9999,3
1745823873581,CAT 124RS,A01,956906,Staff,8,0,25,17
1745823874609,CAT 125RS,A01,922013,Staff,8,0,25,17
1745823875638,CLRE 250,A00,891860,Morris; Sheldon,9995,0,9999,4
1745823877691,CLRE 251R,A00,907817,Mehta; Ravindra L.,9994,0,9999,5
1745823878719,CLRE 252,A00,891864,Cuomo; Raphael Eduardo,9993,0,9999,6
1745823879753,CLRE 253,A00,891867,Vaida; Florin,9994,0,9999,5
1745823879753,CLRE 253,B00,907819,Staff,9999,0,9999,0
1745823880781,CLRE 259,A00,891868,Patel; Hemal,9998,0,9999,1
1745823881810,CLRE 260,A00,891872,Cuomo; Raphael Eduardo,9999,0,9999,0
1745823882840,CLRE 297,001,891888,Cuomo; Raphael Eduardo,9999,0,9999,0
1745823883866,CSE 191,A00,958773,Minnes Kemp; Mor Mia,9999,0,9999,0
1745823884897,CSS 201S,A01,892054,Mignozzetti; Umberto,30,0,30,0
1745823885924,CSS 202S,A01,892056,Mignozzetti; Umberto,30,0,30,0
1745823886952,DSC 197,001,956898,Eldridge; Justin Matthew,9998,0,9999,1
1745823887976,DSC 297,001,958000,Mazumdar; Arya,9998,0,9999,1
1745823889004,EAP 100,A00,905686,Staff,9776,0,9999,223
1745823890032,ECE 45,A01,892618,Staff,0,13,50,50
1745823891057,ECE 109,A01,892620,Staff,0,43,0,0
1745823892084,ECE 111,A01,892719,Staff,0,9,50,50
1745823893109,ECE 197,001,957920,Mercier; Patrick Philip,9992,0,9999,7
1745823894135,ECON 178,A01,907814,Zhu; Ying,28,0,35,7
1745823895163,EDS 115,A00,895312,Staff,41,0,45,4
1745823896190,EDS 117,A01,895337,Staff,30,0,30,0
1745823897218,EDS 125,A00,895341,Jones; Gabrielle Anastasia,43,0,45,2
1745823898245,EDS 128A,A01,895459,Fargason; Sharon Gayle,44,0,45,1
1745823899276,EDS 128B,A01,895543,Pappas; Elizabeth,44,0,45,1
1745823900303,EDS 139,A00,897203,Pappas; Elizabeth,44,0,45,1
1745823900303,EDS 139,B00,897209,Fargason; Sharon Gayle,44,0,45,1
1745823901333,EDS 201,A00,895545,Staff,43,0,45,2
1745823902369,EDS 203,A01,895581,Halter; Christopher P.,43,0,45,2
1745823903397,EDS 204R,A01,895625,Heinzman; Erica M.,43,0,45,2
1745823903397,EDS 204R,B01,895693,Halter; Christopher P.,18,0,45,27
1745823904423,EDS 206R,A00,895694,Fargason; Sharon Gayle,9,0,30,21
1745823904423,EDS 206R,B00,895695,Choi; Bailey Miyeon,20,0,30,10
1745823905453,EDS 250,A00,895697,Hemans; Patricia Ann Benitez,43,0,45,2
1745823906479,EDS 281,A00,895701,Meyerott; Theresa Ann,15,0,15,0
1745823907505,EDS 284,A00,895736,Meyerott; Theresa Ann,15,0,15,0
1745823908534,EDS 286,A00,897210,Fine; Sarah,15,0,15,0
1745823909560,EDS 289C,A01,895770,Daly; Alan J.,15,0,15,0
1745823910586,EDS 290,A00,897211,Hofstetter; Carolyn,15,0,15,0
1745823911614,LIGM 5A,A00,896162,Fischer-Grunski; Eva K,15,0,20,5
1745823912647,LIGM 5B,A00,896260,Fischer-Grunski; Eva K,17,0,20,3
1745823913672,LIGM 5C,A00,896308,Fischer-Grunski; Eva K,18,0,20,2
1745823914701,LIIT 5AS,A00,896313,Carnelos; Chiara,17,0,20,3
1745823915731,LIIT 5BS,A00,896416,Carnelos; Chiara,20,0,20,0
1745823916758,LIIT 5CS,A00,896564,Carnelos; Chiara,20,0,20,0
1745823917785,LISP 5A,A00,896588,Munoz Sanchez; Alicia,4,0,20,16
1745823918814,LISP 5B,A00,896653,Munoz Sanchez; Alicia,10,0,20,10
1745823919844,LISP 5C,A00,896655,Munoz Sanchez; Alicia,4,0,20,16
1745823920874,MAE 197,001,957918,Kleissl; Jan,9998,0,9999,1
1745823921902,MATH 2,A01,957937,Staff,34,0,35,1
1745823922931,MATH 197,001,957876,Kedlaya; Kiran S.,9993,0,9999,6
1745823923957,MCWP 40,A00,892729,Duru; Nur,13,0,20,7
1745823923957,MCWP 40,B00,893304,Montejo; Carolina,20,0,20,0
1745823924982,MCWP 40R,A00,893757,Redela; Pamela Morgan,0,7,20,20
1745823926012,MCWP 50,A00,893758,Morshed; Michael James,2,0,20,18
1745823926012,MCWP 50,B00,893761,Bartulis; Jason Michael,18,0,20,2
1745823927042,MCWP 50R,A00,893766,Compas; Sean Matthew,0,1,20,20
1745823927042,MCWP 50R,B00,893769,Carter; Jennifer A,0,0,20,20
1745823927042,MCWP 50R,C00,893771,Krone; Jarret,0,3,20,20
1745823927042,MCWP 50R,D00,893772,Miller; Elizabeth Deen,3,0,20,17
1745823927042,MCWP 50R,E00,893775,Carter; Andrea L,0,0,20,20
1745823928072,MMW 11R,A01,892721,Herbst; Matthew,11,0,27,16
1745823928072,MMW 11R,A02,892722,Herbst; Matthew,0,0,0,3
1745823929138,MMW 12R,A01,892724,Herbst; Matthew,0,10,16,16
1745823929138,MMW 12R,A02,892725,Herbst; Matthew,0,9,16,16
1745823930164,MMW 13R,A01,892727,Staff,0,3,16,16
1745823930164,MMW 13R,A02,892728,Staff,0,4,16,16
1745823930164,MMW 13R,A03,958032,Staff,0,3,16,16
1745823930164,MMW 13R,A04,958033,Staff,0,2,16,16
1745823930164,MMW 13R,A05,958034,Staff,0,3,16,16
1745823931190,SIO 295LS,A00,894015,Staff,7,0,25,18
1745823932220,SIO 295S,A00,894020,Staff,7,0,25,18
1745823933250,SIOC 290S,B01,958918,Staff,0,0,0,0
1745823934278,SIOC 291S,B01,958922,Staff,0,0,0,0
1745823935304,SOCI 117,A01,895339,Staff,4,0,5,1
1745823936333,WES 237B,A00,894149,Staff,11,0,20,9
1745823938407,AESE 279B,A00,891859,Staff,13,0,35,22
1745823939434,AIP 197,001,891854,Staff,70,0,70,0
1745823940462,ANTH 289S,A00,891856,Gagneux; Pascal,12,0,12,0
1745823941488,BENG 196,001,957946,Engler; Adam J.,9996,0,9999,3
1745823942517,CAT 124RS,A01,956906,Staff,8,0,25,17
1745823943541,CAT 125RS,A01,922013,Staff,8,0,25,17
1745823944575,CLRE 250,A00,891860,Morris; Sheldon,9995,0,9999,4
1745823946631,CLRE 251R,A00,907817,Mehta; Ravindra L.,9994,0,9999,5
1745823947656,CLRE 252,A00,891864,Cuomo; Raphael Eduardo,9993,0,9999,6
1745823948686,CLRE 253,A00,891867,Vaida; Florin,9994,0,9999,5
1745823948686,CLRE 253,B00,907819,Staff,9999,0,9999,0
1745823949725,CLRE 259,A00,891868,Patel; Hemal,9998,0,9999,1
1745823950750,CLRE 260,A00,891872,Cuomo; Raphael Eduardo,9999,0,9999,0
1745823951774,CLRE 297,001,891888,Cuomo; Raphael Eduardo,9999,0,9999,0
1745823952802,CSE 191,A00,958773,Minnes Kemp; Mor Mia,9999,0,9999,0
1745823953832,CSS 201S,A01,892054,Mignozzetti; Umberto,30,0,30,0
1745823954859,CSS 202S,A01,892056,Mignozzetti; Umberto,30,0,30,0
1745823955885,DSC 197,001,956898,Eldridge; Justin Matthew,9998,0,9999,1
1745823956912,DSC 297,001,958000,Mazumdar; Arya,9998,0,9999,1
1745823957944,EAP 100,A00,905686,Staff,9776,0,9999,223
1745823958970,ECE 45,A01,892618,Staff,0,13,50,50
1745823960024,ECE 109,A01,892620,Staff,0,43,0,0
1745823961054,ECE 111,A01,892719,Staff,0,9,50,50
1745823962085,ECE 197,001,957920,Mercier; Patrick Philip,9992,0,9999,7
1745823963112,ECON 178,A01,907814,Zhu; Ying,28,0,35,7
1745823964143,EDS 115,A00,895312,Staff,41,0,45,4
1745823965173,EDS 117,A01,895337,Staff,30,0,30,0
1745823966199,EDS 125,A00,895341,Jones; Gabrielle Anastasia,43,0,45,2
1745823967225,EDS 128A,A01,895459,Fargason; Sharon Gayle,44,0,45,1
1745823968252,EDS 128B,A01,895543,Pappas; Elizabeth,44,0,45,1
1745823969278,EDS 139,A00,897203,Pappas; Elizabeth,44,0,45,1
1745823969278,EDS 139,B00,897209,Fargason; Sharon Gayle,44,0,45,1
1745823970308,EDS 201,A00,895545,Staff,43,0,45,2
1745823971338,EDS 203,A01,895581,Halter; Christopher P.,43,0,45,2
1745823972368,EDS 204R,A01,895625,Heinzman; Erica M.,43,0,45,2
1745823972368,EDS 204R,B01,895693,Halter; Christopher P.,18,0,45,27
1745823973393,EDS 206R,A00,895694,Fargason; Sharon Gayle,9,0,30,21
1745823973393,EDS 206R,B00,895695,Choi; Bailey Miyeon,20,0,30,10
1745823974420,EDS 250,A00,895697,Hemans; Patricia Ann Benitez,43,0,45,2
1745823975450,EDS 281,A00,895701,Meyerott; Theresa Ann,15,0,15,0
1745823976475,EDS 284,A00,895736,Meyerott; Theresa Ann,15,0,15,0
1745823977501,EDS 286,A00,897210,Fine; Sarah,15,0,15,0
1745823978527,EDS 289C,A01,895770,Daly; Alan J.,15,0,15,0
1745823979553,EDS 290,A00,897211,Hofstetter; Carolyn,15,0,15,0
1745823980583,LIGM 5A,A00,896162,Fischer-Grunski; Eva K,15,0,20,5
1745823981609,LIGM 5B,A00,896260,Fischer-Grunski; Eva K,17,0,20,3
1745823982634,LIGM 5C,A00,896308,Fischer-Grunski; Eva K,18,0,20,2
1745823983661,LIIT 5AS,A00,896313,Carnelos; Chiara,17,0,20,3
1745823984691,LIIT 5BS,A00,896416,Carnelos; Chiara,20,0,20,0
1745823985721,LIIT 5CS,A00,896564,Carnelos; Chiara,20,0,20,0
1745823986747,LISP 5A,A00,896588,Munoz Sanchez; Alicia,4,0,20,16
1745823987774,LISP 5B,A00,896653,Munoz Sanchez; Alicia,10,0,20,10
1745823988800,LISP 5C,A00,896655,Munoz Sanchez; Alicia,4,0,20,16
1745823989825,MAE 197,001,957918,Kleissl; Jan,9998,0,9999,1
1745823990855,MATH 2,A01,957937,Staff,34,0,35,1
1745823991882,MATH 197,001,957876,Kedlaya; Kiran S.,9993,0,9999,6
1745823992915,MCWP 40,A00,892729,Duru; Nur,13,0,20,7
1745823992915,MCWP 40,B00,893304,Montejo; Carolina,20,0,20,0
1745823993944,MCWP 40R,A00,893757,Redela; Pamela Morgan,0,7,20,20
1745823994975,MCWP 50,A00,893758,Morshed; Michael James,2,0,20,18
1745823994975,MCWP 50,B00,893761,Bartulis; Jason Michael,18,0,20,2
1745823996003,MCWP 50R,A00,893766,Compas; Sean Matthew,0,1,20,20
1745823996003,MCWP 50R,B00,893769,Carter; Jennifer A,0,0,20,20
1745823996003,MCWP 50R,C00,893771,Krone; Jarret,0,3,20,20
1745823996003,MCWP 50R,D00,893772,Miller; Elizabeth Deen,3,0,20,17
1745823996003,MCWP 50R,E00,893775,Carter; Andrea L,0,0,20,20
1745823997035,MMW 11R,A01,892721,Herbst; Matthew,11,0,27,16
1745823997035,MMW 11R,A02,892722,Herbst; Matthew,0,0,0,3
1745823998062,MMW 12R,A01,892724,Herbst; Matthew,0,10,16,16
1745823998062,MMW 12R,A02,892725,Herbst; Matthew,0,9,16,16
1745823999088,MMW 13R,A01,892727,Staff,0,3,16,16
1745823999088,MMW 13R,A02,892728,Staff,0,4,16,16
1745823999088,MMW 13R,A03,958032,Staff,0,3,16,16
1745823999088,MMW 13R,A04,958033,Staff,0,2,16,16
1745823999088,MMW 13R,A05,958034,Staff,0,3,16,16
1745824000121,SIO 295LS,A00,894015,Staff,7,0,25,18
1745824001147,SIO 295S,A00,894020,Staff,7,0,25,18
1745824002176,SIOC 290S,B01,958918,Staff,0,0,0,0
1745824003209,SIOC 291S,B01,958922,Staff,0,0,0,0
1745824004238,SOCI 117,A01,895339,Staff,4,0,5,1
1745824005265,WES 237B,A00,894149,Staff,11,0,20,9
1745824007347,AESE 279B,A00,891859,Staff,13,0,35,22
1745824008378,AIP 197,001,891854,Staff,70,0,70,0
1745824009406,ANTH 289S,A00,891856,Gagneux; Pascal,12,0,12,0
1745824010431,BENG 196,001,957946,Engler; Adam J.,9996,0,9999,3
1745824011458,CAT 124RS,A01,956906,Staff,8,0,25,17
1745824012483,CAT 125RS,A01,922013,Staff,8,0,25,17
1745824013509,CLRE 250,A00,891860,Morris; Sheldon,9995,0,9999,4
1745824015563,CLRE 251R,A00,907817,Mehta; Ravindra L.,9994,0,9999,5
1745824016595,CLRE 252,A00,891864,Cuomo; Raphael Eduardo,9993,0,9999,6
1745824017621,CLRE 253,A00,891867,Vaida; Florin,9994,0,9999,5
1745824017621,CLRE 253,B00,907819,Staff,9999,0,9999,0
1745824018649,CLRE 259,A00,891868,Patel; Hemal,9998,0,9999,1
1745824019680,CLRE 260,A00,891872,Cuomo; Raphael Eduardo,9999,0,9999,0
1745824020706,CLRE 297,001,891888,Cuomo; Raphael Eduardo,9999,0,9999,0
1745824021738,CSE 191,A00,958773,Minnes Kemp; Mor Mia,9999,0,9999,0
1745824022769,CSS 201S,A01,892054,Mignozzetti; Umberto,30,0,30,0
1745824023801,CSS 202S,A01,892056,Mignozzetti; Umberto,30,0,30,0
1745824024829,DSC 197,001,956898,Eldridge; Justin Matthew,9998,0,9999,1
1745824025859,DSC 297,001,958000,Mazumdar; Arya,9998,0,9999,1
1745824026889,EAP 100,A00,905686,Staff,9776,0,9999,223
1745824027922,ECE 45,A01,892618,Staff,0,13,50,50
1745824028951,ECE 109,A01,892620,Staff,0,43,0,0
1745824029977,ECE 111,A01,892719,Staff,0,9,50,50
1745824031007,ECE 197,001,957920,Mercier; Patrick Philip,9992,0,9999,7
1745824032037,ECON 178,A01,907814,Zhu; Ying,28,0,35,7
1745824033103,EDS 115,A00,895312,Staff,41,0,45,4
1745824034131,EDS 117,A01,895337,Staff,30,0,30,0
1745824035186,EDS 125,A00,895341,Jones; Gabrielle Anastasia,43,0,45,2
1745824036217,EDS 128A,A01,895459,Fargason; Sharon Gayle,44,0,45,1
1745824037244,EDS 128B,A01,895543,Pappas; Elizabeth,44,0,45,1
1745824038273,EDS 139,A00,897203,Pappas; Elizabeth,44,0,45,1
1745824038273,EDS 139,B00,897209,Fargason; Sharon Gayle,44,0,45,1
1745824039299,EDS 201,A00,895545,Staff,43,0,45,2
1745824040328,EDS 203,A01,895581,Halter; Christopher P.,43,0,45,2
1745824041356,EDS 204R,A01,895625,Heinzman; Erica M.,43,0,45,2
1745824041356,EDS 204R,B01,895693,Halter; Christopher P.,18,0,45,27
1745824042394,EDS 206R,A00,895694,Fargason; Sharon Gayle,9,0,30,21
1745824042394,EDS 206R,B00,895695,Choi; Bailey Miyeon,20,0,30,10
1745824043420,EDS 250,A00,895697,Hemans; Patricia Ann Benitez,43,0,45,2
1745824044445,EDS 281,A00,895701,Meyerott; Theresa Ann,15,0,15,0
1745824045477,EDS 284,A00,895736,Meyerott; Theresa Ann,15,0,15,0
1745824046503,EDS 286,A00,897210,Fine; Sarah,15,0,15,0
1745824047531,EDS 289C,A01,895770,Daly; Alan J.,15,0,15,0
1745824048558,EDS 290,A00,897211,Hofstetter; Carolyn,15,0,15,0
1745824049584,LIGM 5A,A00,896162,Fischer-Grunski; Eva K,15,0,20,5
1745824050614,LIGM 5B,A00,896260,Fischer-Grunski; Eva K,17,0,20,3
1745824051639,LIGM 5C,A00,896308,Fischer-Grunski; Eva K,18,0,20,2
1745824052669,LIIT 5AS,A00,896313,Carnelos; Chiara,17,0,20,3
1745824053695,LIIT 5BS,A00,896416,Carnelos; Chiara,20,0,20,0
1745824054720,LIIT 5CS,A00,896564,Carnelos; Chiara,20,0,20,0
1745824055747,LISP 5A,A00,896588,Munoz Sanchez; Alicia,4,0,20,16
1745824056776,LISP 5B,A00,896653,Munoz Sanchez; Alicia,10,0,20,10
1745824057800,LISP 5C,A00,896655,Munoz Sanchez; Alicia,4,0,20,16
1745824058830,MAE 197,001,957918,Kleissl; Jan,9998,0,9999,1
1745824059860,MATH 2,A01,957937,Staff,34,0,35,1
1745824060889,MATH 197,001,957876,Kedlaya; Kiran S.,9993,0,9999,6
1745824061918,MCWP 40,A00,892729,Duru; Nur,13,0,20,7
1745824061918,MCWP 40,B00,893304,Montejo; Carolina,20,0,20,0
1745824062947,MCWP 40R,A00,893757,Redela; Pamela Morgan,0,7,20,20
1745824063976,MCWP 50,A00,893758,Morshed; Michael James,2,0,20,18
1745824063976,MCWP 50,B00,893761,Bartulis; Jason Michael,18,0,20,2
1745824065007,MCWP 50R,A00,893766,Compas; Sean Matthew,0,1,20,20
1745824065007,MCWP 50R,B00,893769,Carter; Jennifer A,0,0,20,20
1745824065007,MCWP 50R,C00,893771,Krone; Jarret,0,3,20,20
1745824065007,MCWP 50R,D00,893772,Miller; Elizabeth Deen,3,0,20,17
1745824065007,MCWP 50R,E00,893775,Carter; Andrea L,0,0,20,20
1745824066037,MMW 11R,A01,892721,Herbst; Matthew,11,0,27,16
1745824066037,MMW 11R,A02,892722,Herbst; Matthew,0,0,0,3
1745824067066,MMW 12R,A01,892724,Herbst; Matthew,0,10,16,16
1745824067066,MMW 12R,A02,892725,Herbst; Matthew,0,9,16,16
1745824068094,MMW 13R,A01,892727,Staff,0,3,16,16
1745824068094,MMW 13R,A02,892728,Staff,0,4,16,16
1745824068094,MMW 13R,A03,958032,Staff,0,3,16,16
1745824068094,MMW 13R,A04,958033,Staff,0,2,16,16
1745824068094,MMW 13R,A05,958034,Staff,0,3,16,16
1745824069119,SIO 295LS,A00,894015,Staff,7,0,25,18
1745824070145,SIO 295S,A00,894020,Staff,7,0,25,18
1745824071171,SIOC 290S,B01,958918,Staff,0,0,0,0
1745824072198,SIOC 291S,B01,958922,Staff,0,0,0,0
1745824073223,SOCI 117,A01,895339,Staff,4,0,5,1
1745824074250,WES 237B,A00,894149,Staff,11,0,20,9
1745824076317,AESE 279B,A00,891859,Staff,13,0,35,22
1745824077344,AIP 197,001,891854,Staff,70,0,70,0
1745824078370,ANTH 289S,A00,891856,Gagneux; Pascal,12,0,12,0
1745824079399,BENG 196,001,957946,Engler; Adam J.,9996,0,9999,3
1745824080427,CAT 124RS,A01,956906,Staff,8,0,25,17
1745824081453,CAT 125RS,A01,922013,Staff,8,0,25,17
1745824082480,CLRE 250,A00,891860,Morris; Sheldon,9995,0,9999,4
1745824084536,CLRE 251R,A00,907817,Mehta; Ravindra L.,9994,0,9999,5
1745824085563,CLRE 252,A00,891864,Cuomo; Raphael Eduardo,9993,0,9999,6
1745824086591,CLRE 253,A00,891867,Vaida; Florin,9994,0,9999,5
1745824086591,CLRE 253,B00,907819,Staff,9999,0,9999,0
1745824087621,CLRE 259,A00,891868,Patel; Hemal,9998,0,9999,1
1745824088651,CLRE 260,A00,891872,Cuomo; Raphael Eduardo,9999,0,9999,0
1745824089681,CLRE 297,001,891888,Cuomo; Raphael Eduardo,9999,0,9999,0
1745824090708,CSE 191,A00,958773,Minnes Kemp; Mor Mia,9999,0,9999,0
1745824091737,CSS 201S,A01,892054,Mignozzetti; Umberto,30,0,30,0
1745824092762,CSS 202S,A01,892056,Mignozzetti; Umberto,30,0,30,0
1745824093791,DSC 197,001,956898,Eldridge; Justin Matthew,9998,0,9999,1
1745824094816,DSC 297,001,958000,Mazumdar; Arya,9998,0,9999,1
1745824095842,EAP 100,A00,905686,Staff,9776,0,9999,223
1745824096870,ECE 45,A01,892618,Staff,0,13,50,50
1745824097895,ECE 109,A01,892620,Staff,0,43,0,0
1745824098921,ECE 111,A01,892719,Staff,0,9,50,50
1745824099947,ECE 197,001,957920,Mercier; Patrick Philip,9992,0,9999,7
1745824100973,ECON 178,A01,907814,Zhu; Ying,28,0,35,7
1745824101999,EDS 115,A00,895312,Staff,41,0,45,4
1745824103028,EDS 117,A01,895337,Staff,30,0,30,0
1745824104057,EDS 125,A00,895341,Jones; Gabrielle Anastasia,43,0,45,2
1745824105085,EDS 128A,A01,895459,Fargason; Sharon Gayle,44,0,45,1
1745824106113,EDS 128B,A01,895543,Pappas; Elizabeth,44,0,45,1
1745824107140,EDS 139,A00,897203,Pappas; Elizabeth,44,0,45,1
1745824107140,EDS 139,B00,897209,Fargason; Sharon Gayle,44,0,45,1
1745824108166,EDS 201,A00,895545,Staff,43,0,45,2
1745824109196,EDS 203,A01,895581,Halter; Christopher P.,43,0,45,2
1745824110252,EDS 204R,A01,895625,Heinzman; Erica M.,43,0,45,2
1745824110252,EDS 204R,B01,895693,Halter; Christopher P.,18,0,45,27
1745824111279,EDS 206R,A00,895694,Fargason; Sharon Gayle,9,0,30,21
1745824111279,EDS 206R,B00,895695,Choi; Bailey Miyeon,20,0,30,10
1745824112305,EDS 250,A00,895697,Hemans; Patricia Ann Benitez,43,0,45,2
1745824113334,EDS 281,A00,895701,Meyerott; Theresa Ann,15,0,15,0
1745824114359,EDS 284,A00,895736,Meyerott; Theresa Ann,15,0,15,0
1745824115385,EDS 286,A00,897210,Fine; Sarah,15,0,15,0
1745824116415,EDS 289C,A01,895770,Daly; Alan J.,15,0,15,0
1745824117443,EDS 290,A00,897211,Hofstetter; Carolyn,15,0,15,0
1745824118474,LIGM 5A,A00,896162,Fischer-Grunski; Eva K,15,0,20,5
1745824119503,LIGM 5B,A00,896260,Fischer-Grunski; Eva K,17,0,20,3
1745824120527,LIGM 5C,A00,896308,Fischer-Grunski; Eva K,18,0,20,2
1745824121553,LIIT 5AS,A00,896313,Carnelos; Chiara,17,0,20,3
1745824122583,LIIT 5BS,A00,896416,Carnelos; Chiara,20,0,20,0
1745824123608,LIIT 5CS,A00,896564,Carnelos; Chiara,20,0,20,0
1745824124639,LISP 5A,A00,896588,Munoz Sanchez; Alicia,4,0,20,16
1745824125665,LISP 5B,A00,896653,Munoz Sanchez; Alicia,10,0,20,10
1745824126689,LISP 5C,A00,896655,Munoz Sanchez; Alicia,4,0,20,16
1745824127715,MAE 197,001,957918,Kleissl; Jan,9998,0,9999,1
1745824128743,MATH 2,A01,957937,Staff,34,0,35,1
1745824129770,MATH 197,001,957876,Kedlaya; Kiran S.,9993,0,9999,6
1745824130797,MCWP 40,A00,892729,Duru; Nur,13,0,20,7
1745824130797,MCWP 40,B00,893304,Montejo; Carolina,20,0,20,0
1745824131824,MCWP 40R,A00,893757,Redela; Pamela Morgan,0,7,20,20
1745824132849,MCWP 50,A00,893758,Morshed; Michael James,2,0,20,18
1745824132849,MCWP 50,B00,893761,Bartulis; Jason Michael,18,0,20,2
1745824133881,MCWP 50R,A00,893766,Compas; Sean Matthew,0,1,20,20
1745824133881,MCWP 50R,B00,893769,Carter; Jennifer A,0,0,20,20
1745824133881,MCWP 50R,C00,893771,Krone; Jarret,0,3,20,20
1745824133881,MCWP 50R,D00,893772,Miller; Elizabeth Deen,3,0,20,17
1745824133881,MCWP 50R,E00,893775,Carter; Andrea L,0,0,20,20
1745824134907,MMW 11R,A01,892721,Herbst; Matthew,11,0,27,16
1745824134907,MMW 11R,A02,892722,Herbst; Matthew,0,0,0,3
1745824135937,MMW 12R,A01,892724,Herbst; Matthew,0,10,16,16
1745824135937,MMW 12R,A02,892725,Herbst; Matthew,0,9,16,16
1745824137022,MMW 13R,A01,892727,Staff,0,3,16,16
1745824137022,MMW 13R,A02,892728,Staff,0,4,16,16
1745824137022,MMW 13R,A03,958032,Staff,0,3,16,16
1745824137022,MMW 13R,A04,958033,Staff,0,2,16,16
1745824137022,MMW 13R,A05,958034,Staff,0,3,16,16
1745824138049,SIO 295LS,A00,894015,Staff,7,0,25,18
1745824139075,SIO 295S,A00,894020,Staff,7,0,25,18
1745824140106,SIOC 290S,B01,958918,Staff,0,0,0,0
1745824141140,SIOC 291S,B01,958922,Staff,0,0,0,0
1745824142167,SOCI 117,A01,895339,Staff,4,0,5,1
1745824143191,WES 237B,A00,894149,Staff,11,0,20,9
1745824145250,AESE 279B,A00,891859,Staff,13,0,35,22
1745824146278,AIP 197,001,891854,Staff,70,0,70,0
1745824147308,ANTH 289S,A00,891856,Gagneux; Pascal,12,0,12,0
1745824148337,BENG 196,001,957946,Engler; Adam J.,9996,0,9999,3
1745824149363,CAT 124RS,A01,956906,Staff,8,0,25,17
1745824150390,CAT 125RS,A01,922013,Staff,8,0,25,17
1745824151419,CLRE 250,A00,891860,Morris; Sheldon,9995,0,9999,4
1745824153474,CLRE 251R,A00,907817,Mehta; Ravindra L.,9994,0,9999,5
1745824154505,CLRE 252,A00,891864,Cuomo; Raphael Eduardo,9993,0,9999,6
1745824155531,CLRE 253,A00,891867,Vaida; Florin,9994,0,9999,5
1745824155531,CLRE 253,B00,907819,Staff,9999,0,9999,0
1745824156557,CLRE 259,A00,891868,Patel; Hemal,9998,0,9999,1
1745824157583,CLRE 260,A00,891872,Cuomo; Raphael Eduardo,9999,0,9999,0
1745824158609,CLRE 297,001,891888,Cuomo; Raphael Eduardo,9999,0,9999,0
1745824159635,CSE 191,A00,958773,Minnes Kemp; Mor Mia,9999,0,9999,0
1745824160665,CSS 201S,A01,892054,Mignozzetti; Umberto,30,0,30,0
1745824161691,CSS 202S,A01,892056,Mignozzetti; Umberto,30,0,30,0
1745824162717,DSC 197,001,956898,Eldridge; Justin Matthew,9998,0,9999,1
1745824163746,DSC 297,001,958000,Mazumdar; Arya,9998,0,9999,1
1745824164774,EAP 100,A00,905686,Staff,9776,0,9999,223
1745824165806,ECE 45,A01,892618,Staff,0,13,50,50
1745824166833,ECE 109,A01,892620,Staff,0,43,0,0
1745824167863,ECE 111,A01,892719,Staff,0,9,50,50
1745824168894,ECE 197,001,957920,Mercier; Patrick Philip,9992,0,9999,7
1745824169920,ECON 178,A01,907814,Zhu; Ying,28,0,35,7
1745824170951,EDS 115,A00,895312,Staff,41,0,45,4
1745824171978,EDS 117,A01,895337,Staff,30,0,30,0
1745824173003,EDS 125,A00,895341,Jones; Gabrielle Anastasia,43,0,45,2
1745824174031,EDS 128A,A01,895459,Fargason; Sharon Gayle,44,0,45,1
1745824175057,EDS 128B,A01,895543,Pappas; Elizabeth,44,0,45,1
1745824176083,EDS 139,A00,897203,Pappas; Elizabeth,44,0,45,1
1745824176083,EDS 139,B00,897209,Fargason; Sharon Gayle,44,0,45,1
1745824177109,EDS 201,A00,895545,Staff,43,0,45,2
1745824178138,EDS 203,A01,895581,Halter; Christopher P.,43,0,45,2
1745824179164,EDS 204R,A01,895625,Heinzman; Erica M.,43,0,45,2
1745824179164,EDS 204R,B01,895693,Halter; Christopher P.,18,0,45,27
1745824180196,EDS 206R,A00,895694,Fargason; Sharon Gayle,9,0,30,21
1745824180196,EDS 206R,B00,895695,Choi; Bailey Miyeon,20,0,30,10
1745824181221,EDS 250,A00,895697,Hemans; Patricia Ann Benitez,43,0,45,2
1745824182246,EDS 281,A00,895701,Meyerott; Theresa Ann,15,0,15,0
1745824183272,EDS 284,A00,895736,Meyerott; Theresa Ann,15,0,15,0
1745824184299,EDS 286,A00,897210,Fine; Sarah,15,0,15,0
1745824185328,EDS 289C,A01,895770,Daly; Alan J.,15,0,15,0
1745824186359,EDS 290,A00,897211,Hofstetter; Carolyn,15,0,15,0
1745824187385,LIGM 5A,A00,896162,Fischer-Grunski; Eva K,15,0,20,5
1745824188413,LIGM 5B,A00,896260,Fischer-Grunski; Eva K,17,0,20,3
1745824189447,LIGM 5C,A00,896308,Fischer-Grunski; Eva K,18,0,20,2
1745824190478,LIIT 5AS,A00,896313,Carnelos; Chiara,17,0,20,3
1745824191509,LIIT 5BS,A00,896416,Carnelos; Chiara,20,0,20,0
1745824192539,LIIT 5CS,A00,896564,Carnelos; Chiara,20,0,20,0
1745824193565,LISP 5A,A00,896588,Munoz Sanchez; Alicia,4,0,20,16
1745824194595,LISP 5B,A00,896653,Munoz Sanchez; Alicia,10,0,20,10
1745824195622,LISP 5C,A00,896655,Munoz Sanchez; Alicia,4,0,20,16
1745824196648,MAE 197,001,957918,Kleissl; Jan,9998,0,9999,1
1745824197675,MATH 2,A01,957937,Staff,34,0,35,1
1745824198703,MATH 197,001,957876,Kedlaya; Kiran S.,9993,0,9999,6
1745824199730,MCWP 40,A00,892729,Duru; Nur,13,0,20,7
1745824199730,MCWP 40,B00,893304,Montejo; Carolina,20,0,20,0
1745824200759,MCWP 40R,A00,893757,Redela; Pamela Morgan,0,7,20,20
1745824201787,MCWP 50,A00,893758,Morshed; Michael James,2,0,20,18
1745824201787,MCWP 50,B00,893761,Bartulis; Jason Michael,18,0,20,2
1745824202813,MCWP 50R,A00,893766,Compas; Sean Matthew,0,1,20,20
1745824202813,MCWP 50R,B00,893769,Carter; Jennifer A,0,0,20,20
1745824202813,MCWP 50R,C00,893771,Krone; Jarret,0,3,20,20
1745824202813,MCWP 50R,D00,893772,Miller; Elizabeth Deen,3,0,20,17
1745824202813,MCWP 50R,E00,893775,Carter; Andrea L,0,0,20,20
1745824203847,MMW 11R,A01,892721,Herbst; Matthew,11,0,27,16
1745824203847,MMW 11R,A02,892722,Herbst; Matthew,0,0,0,3
1745824204875,MMW 12R,A01,892724,Herbst; Matthew,0,10,16,16
1745824204875,MMW 12R,A02,892725,Herbst; Matthew,0,9,16,16
1745824205903,MMW 13R,A01,892727,Staff,0,3,16,16
1745824205903,MMW 13R,A02,892728,Staff,0,4,16,16
1745824205903,MMW 13R,A03,958032,Staff,0,3,16,16
1745824205903,MMW 13R,A04,958033,Staff,0,2,16,16
1745824205903,MMW 13R,A05,958034,Staff,0,3,16,16
1745824206930,SIO 295LS,A00,894015,Staff,7,0,25,18
1745824207955,SIO 295S,A00,894020,Staff,7,0,25,18
1745824208986,SIOC 290S,B01,958918,Staff,0,0,0,0
1745824210014,SIOC 291S,B01,958922,Staff,0,0,0,0
1745824211040,SOCI 117,A01,895339,Staff,4,0,5,1
1745824212066,WES 237B,A00,894149,Staff,11,0,20,9
1745824214139,AESE 279B,A00,891859,Staff,13,0,35,22
1745824215163,AIP 197,001,891854,Staff,70,0,70,0
1745824216190,ANTH 289S,A00,891856,Gagneux; Pascal,12,0,12,0
1745824217216,BENG 196,001,957946,Engler; Adam J.,9996,0,9999,3
1745824218245,CAT 124RS,A01,956906,Staff,8,0,25,17
1745824219272,CAT 125RS,A01,922013,Staff,8,0,25,17
1745824220299,CLRE 250,A00,891860,Morris; Sheldon,9995,0,9999,4
1745824222358,CLRE 251R,A00,907817,Mehta; Ravindra L.,9994,0,9999,5
1745824223387,CLRE 252,A00,891864,Cuomo; Raphael Eduardo,9993,0,9999,6
1745824224417,CLRE 253,A00,891867,Vaida; Florin,9994,0,9999,5
1745824224417,CLRE 253,B00,907819,Staff,9999,0,9999,0
1745824225451,CLRE 259,A00,891868,Patel; Hemal,9998,0,9999,1
1745824226501,CLRE 260,A00,891872,Cuomo; Raphael Eduardo,9999,0,9999,0
1745824227527,CLRE 297,001,891888,Cuomo; Raphael Eduardo,9999,0,9999,0
1745824228555,CSE 191,A00,958773,Minnes Kemp; Mor Mia,9999,0,9999,0
1745824229586,CSS 201S,A01,892054,Mignozzetti; Umberto,30,0,30,0
1745824230613,CSS 202S,A01,892056,Mignozzetti; Umberto,30,0,30,0
1745824231642,DSC 197,001,956898,Eldridge; Justin Matthew,9998,0,9999,1
1745824232672,DSC 297,001,958000,Mazumdar; Arya,9998,0,9999,1
1745824233701,EAP 100,A00,905686,Staff,9776,0,9999,223
1745824234725,ECE 45,A01,892618,Staff,0,13,50,50
1745824235752,ECE 109,A01,892620,Staff,0,43,0,0
1745824236777,ECE 111,A01,892719,Staff,0,9,50,50
1745824237803,ECE 197,001,957920,Mercier; Patrick Philip,9992,0,9999,7
1745824238833,ECON 178,A01,907814,Zhu; Ying,28,0,35,7
1745824239861,EDS 115,A00,895312,Staff,41,0,45,4
1745824240929,EDS 117,A01,895337,Staff,30,0,30,0
1745824241959,EDS 125,A00,895341,Jones; Gabrielle Anastasia,43,0,45,2
1745824242983,EDS 128A,A01,895459,Fargason; Sharon Gayle,44,0,45,1
1745824244014,EDS 128B,A01,895543,Pappas; Elizabeth,44,0,45,1
1745824245044,EDS 139,A00,897203,Pappas; Elizabeth,44,0,45,1
1745824245044,EDS 139,B00,897209,Fargason; Sharon Gayle,44,0,45,1
1745824246069,EDS 201,A00,895545,Staff,43,0,45,2
1745824247094,EDS 203,A01,895581,Halter; Christopher P.,43,0,45,2
1745824248120,EDS 204R,A01,895625,Heinzman; Erica M.,43,0,45,2
1745824248120,EDS 204R,B01,895693,Halter; Christopher P.,18,0,45,27
1745824249147,EDS 206R,A00,895694,Fargason; Sharon Gayle,9,0,30,21
1745824249147,EDS 206R,B00,895695,Choi; Bailey Miyeon,20,0,30,10
1745824250177,EDS 250,A00,895697,Hemans; Patricia Ann Benitez,43,0,45,2
1745824251206,EDS 281,A00,895701,Meyerott; Theresa Ann,15,0,15,0
1745824252232,EDS 284,A00,895736,Meyerott; Theresa Ann,15,0,15,0
1745824253261,EDS 286,A00,897210,Fine; Sarah,15,0,15,0
1745824254290,EDS 289C,A01,895770,Daly; Alan J.,15,0,15,0
1745824255319,EDS 290,A00,897211,Hofstetter; Carolyn,15,0,15,0
1745824256352,LIGM 5A,A00,896162,Fischer-Grunski; Eva K,15,0,20,5
1745824257383,LIGM 5B,A00,896260,Fischer-Grunski; Eva K,17,0,20,3
1745824258412,LIGM 5C,A00,896308,Fischer-Grunski; Eva K,18,0,20,2
1745824259444,LIIT 5AS,A00,896313,Carnelos; Chiara,17,0,20,3
1745824260471,LIIT 5BS,A00,896416,Carnelos; Chiara,20,0,20,0
1745824261509,LIIT 5CS,A00,896564,Carnelos; Chiara,20,0,20,0
1745824262535,LISP 5A,A00,896588,Munoz Sanchez; Alicia,4,0,20,16
1745824263567,LISP 5B,A00,896653,Munoz Sanchez; Alicia,10,0,20,10
1745824264598,LISP 5C,A00,896655,Munoz Sanchez; Alicia,4,0,20,16
1745824265624,MAE 197,001,957918,Kleissl; Jan,9998,0,9999,1
1745824266649,MATH 2,A01,957937,Staff,34,0,35,1
1745824267676,MATH 197,001,957876,Kedlaya; Kiran S.,9993,0,9999,6
1745824268703,MCWP 40,A00,892729,Duru; Nur,13,0,20,7
1745824268703,MCWP 40,B00,893304,Montejo; Carolina,20,0,20,0
1745824269733,MCWP 40R,A00,893757,Redela; Pamela Morgan,0,7,20,20
1745824270759,MCWP 50,A00,893758,Morshed; Michael James,2,0,20,18
1745824270759,MCWP 50,B00,893761,Bartulis; Jason Michael,18,0,20,2
1745824271786,MCWP 50R,A00,893766,Compas; Sean Matthew,0,1,20,20
1745824271786,MCWP 50R,B00,893769,Carter; Jennifer A,0,0,20,20
1745824271786,MCWP 50R,C00,893771,Krone; Jarret,0,3,20,20
1745824271786,MCWP 50R,D00,893772,Miller; Elizabeth Deen,3,0,20,17
1745824271786,MCWP 50R,E00,893775,Carter; Andrea L,0,0,20,20
1745824272813,MMW 11R,A01,892721,Herbst; Matthew,11,0,27,16
1745824272813,MMW 11R,A02,892722,Herbst; Matthew,0,0,0,3
1745824273841,MMW 12R,A01,892724,Herbst; Matthew,0,10,16,16
1745824273841,MMW 12R,A02,892725,Herbst; Matthew,0,9,16,16
1745824274869,MMW 13R,A01,892727,Staff,0,3,16,16
1745824274869,MMW 13R,A02,892728,Staff,0,4,16,16
1745824274869,MMW 13R,A03,958032,Staff,0,3,16,16
1745824274869,MMW 13R,A04,958033,Staff,0,2,16,16
1745824274869,MMW 13R,A05,958034,Staff,0,3,16,16
1745824275896,SIO 295LS,A00,894015,Staff,7,0,25,18
1745824276923,SIO 295S,A00,894020,Staff,7,0,25,18
1745824277955,SIOC 290S,B01,958918,Staff,0,0,0,0
1745824278981,SIOC 291S,B01,958922,Staff,0,0,0,0
1745824280020,SOCI 117,A01,895339,Staff,4,0,5,1
1745824281047,WES 237B,A00,894149,Staff,11,0,20,9
1745824283125,AESE 279B,A00,891859,Staff,13,0,35,22
1745824284156,AIP 197,001,891854,Staff,70,0,70,0
1745824285183,ANTH 289S,A00,891856,Gagneux; Pascal,12,0,12,0
1745824286209,BENG 196,001,957946,Engler; Adam J.,9996,0,9999,3
1745824287240,CAT 124RS,A01,956906,Staff,8,0,25,17
1745824288269,CAT 125RS,A01,922013,Staff,8,0,25,17
1745824289296,CLRE 250,A00,891860,Morris; Sheldon,9995,0,9999,4
1745824291352,CLRE 251R,A00,907817,Mehta; Ravindra L.,9994,0,9999,5
1745824292391,CLRE 252,A00,891864,Cuomo; Raphael Eduardo,9993,0,9999,6
1745824293422,CLRE 253,A00,891867,Vaida; Florin,9994,0,9999,5
1745824293422,CLRE 253,B00,907819,Staff,9999,0,9999,0
1745824294448,CLRE 259,A00,891868,Patel; Hemal,9998,0,9999,1
1745824295481,CLRE 260,A00,891872,Cuomo; Raphael Eduardo,9999,0,9999,0
1745824296516,CLRE 297,001,891888,Cuomo; Raphael Eduardo,9999,0,9999,0
1745824297543,CSE 191,A00,958773,Minnes Kemp; Mor Mia,9999,0,9999,0
1745824298573,CSS 201S,A01,892054,Mignozzetti; Umberto,30,0,30,0
1745824299606,CSS 202S,A01,892056,Mignozzetti; Umberto,30,0,30,0
1745824300636,DSC 197,001,956898,Eldridge; Justin Matthew,9998,0,9999,1
1745824301672,DSC 297,001,958000,Mazumdar; Arya,9998,0,9999,1
1745824302703,EAP 100,A00,905686,Staff,9776,0,9999,223
1745824303735,ECE 45,A01,892618,Staff,0,13,50,50
1745824304768,ECE 109,A01,892620,Staff,0,43,0,0
1745824305800,ECE 111,A01,892719,Staff,0,9,50,50
1745824306833,ECE 197,001,957920,Mercier; Patrick Philip,9992,0,9999,7
1745824307866,ECON 178,A01,907814,Zhu; Ying,28,0,35,7
1745824312995,EDS 115,A00,895312,Staff,41,0,45,4
1745824318185,EDS 117,A01,895337,Staff,30,0,30,0
1745824319222,EDS 125,A00,895341,Jones; Gabrielle Anastasia,43,0,45,2
1745824320258,EDS 128A,A01,895459,Fargason; Sharon Gayle,44,0,45,1
1745824321291,EDS 128B,A01,895543,Pappas; Elizabeth,44,0,45,1
1745824322317,EDS 139,A00,897203,Pappas; Elizabeth,44,0,45,1
1745824322317,EDS 139,B00,897209,Fargason; Sharon Gayle,44,0,45,1
1745824323352,EDS 201,A00,895545,Staff,43,0,45,2
1745824324378,EDS 203,A01,895581,Halter; Christopher P.,43,0,45,2
1745824325419,EDS 204R,A01,895625,Heinzman; Erica M.,43,0,45,2
1745824325419,EDS 204R,B01,895693,Halter; Christopher P.,18,0,45,27
1745824326445,EDS 206R,A00,895694,Fargason; Sharon Gayle,9,0,30,21
1745824326445,EDS 206R,B00,895695,Choi; Bailey Miyeon,20,0,30,10
1745824327470,EDS 250,A00,895697,Hemans; Patricia Ann Benitez,43,0,45,2
1745824328495,EDS 281,A00,895701,Meyerott; Theresa Ann,15,0,15,0
1745824329532,EDS 284,A00,895736,Meyerott; Theresa Ann,15,0,15,0
1745824330557,EDS 286,A00,897210,Fine; Sarah,15,0,15,0
1745824331583,EDS 289C,A01,895770,Daly; Alan J.,15,0,15,0
1745824332610,EDS 290,A00,897211,Hofstetter; Carolyn,15,0,15,0
1745824333641,LIGM 5A,A00,896162,Fischer-Grunski; Eva K,15,0,20,5
1745824334667,LIGM 5B,A00,896260,Fischer-Grunski; Eva K,17,0,20,3
1745824335691,LIGM 5C,A00,896308,Fischer-Grunski; Eva K,18,0,20,2
1745824336723,LIIT 5AS,A00,896313,Carnelos; Chiara,17,0,20,3
1745824337753,LIIT 5BS,A00,896416,Carnelos; Chiara,20,0,20,0
1745824338784,LIIT 5CS,A00,896564,Carnelos; Chiara,20,0,20,0
1745824339821,LISP 5A,A00,896588,Munoz Sanchez; Alicia,4,0,20,16
1745824340847,LISP 5B,A00,896653,Munoz Sanchez; Alicia,10,0,20,10
1745824341872,LISP 5C,A00,896655,Munoz Sanchez; Alicia,4,0,20,16
1745824342897,MAE 197,001,957918,Kleissl; Jan,9998,0,9999,1
1745824343937,MATH 2,A01,957937,Staff,34,0,35,1
1745824344965,MATH 197,001,957876,Kedlaya; Kiran S.,9993,0,9999,6
1745824345993,MCWP 40,A00,892729,Duru; Nur,13,0,20,7
1745824345993,MCWP 40,B00,893304,Montejo; Carolina,20,0,20,0
1745824347021,MCWP 40R,A00,893757,Redela; Pamela Morgan,0,7,20,20
1745824348047,MCWP 50,A00,893758,Morshed; Michael James,2,0,20,18
1745824348047,MCWP 50,B00,893761,Bartulis; Jason Michael,18,0,20,2
1745824349082,MCWP 50R,A00,893766,Compas; Sean Matthew,0,1,20,20
1745824349082,MCWP 50R,B00,893769,Carter; Jennifer A,0,0,20,20
1745824349082,MCWP 50R,C00,893771,Krone; Jarret,0,3,20,20
1745824349082,MCWP 50R,D00,893772,Miller; Elizabeth Deen,3,0,20,17
1745824349082,MCWP 50R,E00,893775,Carter; Andrea L,0,0,20,20
1745824350108,MMW 11R,A01,892721,Herbst; Matthew,11,0,27,16
1745824350108,MMW 11R,A02,892722,Herbst; Matthew,0,0,0,3
1745824351141,MMW 12R,A01,892724,Herbst; Matthew,0,10,16,16
1745824351141,MMW 12R,A02,892725,Herbst; Matthew,0,9,16,16
1745824352186,MMW 13R,A01,892727,Staff,0,3,16,16
1745824352186,MMW 13R,A02,892728,Staff,0,4,16,16
1745824352186,MMW 13R,A03,958032,Staff,0,3,16,16
1745824352186,MMW 13R,A04,958033,Staff,0,2,16,16
1745824352186,MMW 13R,A05,958034,Staff,0,3,16,16
1745824353216,SIO 295LS,A00,894015,Staff,7,0,25,18
1745824354297,SIO 295S,A00,894020,Staff,7,0,25,18
1745824355324,SIOC 290S,B01,958918,Staff,0,0,0,0
1745824356351,SIOC 291S,B01,958922,Staff,0,0,0,0
1745824357378,SOCI 117,A01,895339,Staff,4,0,5,1
1745824358407,WES 237B,A00,894149,Staff,11,0,20,9
1745824360482,AESE 279B,A00,891859,Staff,13,0,35,22
1745824361508,AIP 197,001,891854,Staff,70,0,70,0
1745824362535,ANTH 289S,A00,891856,Gagneux; Pascal,12,0,12,0
1745824363577,BENG 196,001,957946,Engler; Adam J.,9996,0,9999,3
1745824364607,CAT 124RS,A01,956906,Staff,8,0,25,17
1745824365631,CAT 125RS,A01,922013,Staff,8,0,25,17
1745824366658,CLRE 250,A00,891860,Morris; Sheldon,9995,0,9999,4
1745824368715,CLRE 251R,A00,907817,Mehta; Ravindra L.,9994,0,9999,5
1745824369743,CLRE 252,A00,891864,Cuomo; Raphael Eduardo,9993,0,9999,6
1745824370774,CLRE 253,A00,891867,Vaida; Florin,9994,0,9999,5
1745824370774,CLRE 253,B00,907819,Staff,9999,0,9999,0
1745824371803,CLRE 259,A00,891868,Patel; Hemal,9998,0,9999,1
1745824372834,CLRE 260,A00,891872,Cuomo; Raphael Eduardo,9999,0,9999,0
1745824373860,CLRE 297,001,891888,Cuomo; Raphael Eduardo,9999,0,9999,0
1745824374889,CSE 191,A00,958773,Minnes Kemp; Mor Mia,9999,0,9999,0
1745824375921,CSS 201S,A01,892054,Mignozzetti; Umberto,30,0,30,0
1745824376946,CSS 202S,A01,892056,Mignozzetti; Umberto,30,0,30,0
1745824377974,DSC 197,001,956898,Eldridge; Justin Matthew,9998,0,9999,1
1745824378999,DSC 297,001,958000,Mazumdar; Arya,9998,0,9999,1
1745824380026,EAP 100,A00,905686,Staff,9776,0,9999,223
1745824381054,ECE 45,A01,892618,Staff,0,13,50,50
1745824382104,ECE 109,A01,892620,Staff,0,43,0,0
1745824383135,ECE 111,A01,892719,Staff,0,9,50,50
1745824384161,ECE 197,001,957920,Mercier; Patrick Philip,9992,0,9999,7
1745824385188,ECON 178,A01,907814,Zhu; Ying,28,0,35,7
1745824386217,EDS 115,A00,895312,Staff,41,0,45,4
1745824387246,EDS 117,A01,895337,Staff,30,0,30,0
1745824388276,EDS 125,A00,895341,Jones; Gabrielle Anastasia,43,0,45,2
1745824389302,EDS 128A,A01,895459,Fargason; Sharon Gayle,44,0,45,1
1745824390330,EDS 128B,A01,895543,Pappas; Elizabeth,44,0,45,1
1745824391358,EDS 139,A00,897203,Pappas; Elizabeth,44,0,45,1
1745824391358,EDS 139,B00,897209,Fargason; Sharon Gayle,44,0,45,1
1745824392394,EDS 201,A00,895545,Staff,43,0,45,2
1745824393419,EDS 203,A01,895581,Halter; Christopher P.,43,0,45,2
1745824394453,EDS 204R,A01,895625,Heinzman; Erica M.,43,0,45,2
1745824394453,EDS 204R,B01,895693,Halter; Christopher P.,18,0,45,27
1745824395480,EDS 206R,A00,895694,Fargason; Sharon Gayle,9,0,30,21
1745824395480,EDS 206R,B00,895695,Choi; Bailey Miyeon,20,0,30,10
1745824396505,EDS 250,A00,895697,Hemans; Patricia Ann Benitez,43,0,45,2
1745824397532,EDS 281,A00,895701,Meyerott; Theresa Ann,15,0,15,0
1745824398558,EDS 284,A00,895736,Meyerott; Theresa Ann,15,0,15,0
1745824399582,EDS 286,A00,897210,Fine; Sarah,15,0,15,0
1745824400612,EDS 289C,A01,895770,Daly; Alan J.,15,0,15,0
1745824401637,EDS 290,A00,897211,Hofstetter; Carolyn,15,0,15,0
1745824402661,LIGM 5A,A00,896162,Fischer-Grunski; Eva K,15,0,20,5
1745824403687,LIGM 5B,A00,896260,Fischer-Grunski; Eva K,17,0,20,3
1745824404713,LIGM 5C,A00,896308,Fischer-Grunski; Eva K,18,0,20,2
1745824405741,LIIT 5AS,A00,896313,Carnelos; Chiara,17,0,20,3
1745824406772,LIIT 5BS,A00,896416,Carnelos; Chiara,20,0,20,0
1745824407800,LIIT 5CS,A00,896564,Carnelos; Chiara,20,0,20,0
1745824408827,LISP 5A,A00,896588,Munoz Sanchez; Alicia,4,0,20,16
1745824409857,LISP 5B,A00,896653,Munoz Sanchez; Alicia,10,0,20,10
1745824410883,LISP 5C,A00,896655,Munoz Sanchez; Alicia,4,0,20,16
1745824411912,MAE 197,001,957918,Kleissl; Jan,9998,0,9999,1
1745824412955,MATH 2,A01,957937,Staff,34,0,35,1
1745824413982,MATH 197,001,957876,Kedlaya; Kiran S.,9993,0,9999,6
1745824415009,MCWP 40,A00,892729,Duru; Nur,13,0,20,7
1745824415009,MCWP 40,B00,893304,Montejo; Carolina,20,0,20,0
1745824416037,MCWP 40R,A00,893757,Redela; Pamela Morgan,0,7,20,20
1745824417065,MCWP 50,A00,893758,Morshed; Michael James,2,0,20,18
1745824417065,MCWP 50,B00,893761,Bartulis; Jason Michael,18,0,20,2
1745824418092,MCWP 50R,A00,893766,Compas; Sean Matthew,0,1,20,20
1745824418092,MCWP 50R,B00,893769,Carter; Jennifer A,0,0,20,20
1745824418092,MCWP 50R,C00,893771,Krone; Jarret,0,3,20,20
1745824418092,MCWP 50R,D00,893772,Miller; Elizabeth Deen,3,0,20,17
1745824418092,MCWP 50R,E00,893775,Carter; Andrea L,0,0,20,20
1745824419120,MMW 11R,A01,892721,Herbst; Matthew,11,0,27,16
1745824419120,MMW 11R,A02,892722,Herbst; Matthew,0,0,0,3
1745824420149,MMW 12R,A01,892724,Herbst; Matthew,0,10,16,16
1745824420149,MMW 12R,A02,892725,Herbst; Matthew,0,9,16,16
1745824421181,MMW 13R,A01,892727,Staff,0,3,16,16
1745824421181,MMW 13R,A02,892728,Staff,0,4,16,16
1745824421181,MMW 13R,A03,958032,Staff,0,3,16,16
1745824421181,MMW 13R,A04,958033,Staff,0,2,16,16
1745824421181,MMW 13R,A05,958034,Staff,0,3,16,16
1745824422209,SIO 295LS,A00,894015,Staff,7,0,25,18
1745824423241,SIO 295S,A00,894020,Staff,7,0,25,18
1745824424270,SIOC 290S,B01,958918,Staff,0,0,0,0
1745824425299,SIOC 291S,B01,958922,Staff,0,0,0,0
1745824426326,SOCI 117,A01,895339,Staff,4,0,5,1
1745824427354,WES 237B,A00,894149,Staff,11,0,20,9
1745824429424,AESE 279B,A00,891859,Staff,13,0,35,22
1745824430449,AIP 197,001,891854,Staff,70,0,70,0
1745824431478,ANTH 289S,A00,891856,Gagneux; Pascal,12,0,12,0
1745824432506,BENG 196,001,957946,Engler; Adam J.,9996,0,9999,3
1745824433534,CAT 124RS,A01,956906,Staff,8,0,25,17
1745824434560,CAT 125RS,A01,922013,Staff,8,0,25,17
1745824435587,CLRE 250,A00,891860,Morris; Sheldon,9995,0,9999,4
1745824437644,CLRE 251R,A00,907817,Mehta; Ravindra L.,9994,0,9999,5
1745824438670,CLRE 252,A00,891864,Cuomo; Raphael Eduardo,9993,0,9999,6
1745824439704,CLRE 253,A00,891867,Vaida; Florin,9994,0,9999,5
1745824439704,CLRE 253,B00,907819,Staff,9999,0,9999,0
1745824440736,CLRE 259,A00,891868,Patel; Hemal,9998,0,9999,1
1745824441765,CLRE 260,A00,891872,Cuomo; Raphael Eduardo,9999,0,9999,0
1745824442797,CLRE 297,001,891888,Cuomo; Raphael Eduardo,9999,0,9999,0
1745824443829,CSE 191,A00,958773,Minnes Kemp; Mor Mia,9999,0,9999,0
1745824444855,CSS 201S,A01,892054,Mignozzetti; Umberto,30,0,30,0
1745824445884,CSS 202S,A01,892056,Mignozzetti; Umberto,30,0,30,0
1745824446915,DSC 197,001,956898,Eldridge; Justin Matthew,9998,0,9999,1
1745824447940,DSC 297,001,958000,Mazumdar; Arya,9998,0,9999,1
1745824448967,EAP 100,A00,905686,Staff,9776,0,9999,223
1745824449993,ECE 45,A01,892618,Staff,0,13,50,50
1745824451023,ECE 109,A01,892620,Staff,0,43,0,0
1745824452048,ECE 111,A01,892719,Staff,0,9,50,50
1745824453080,ECE 197,001,957920,Mercier; Patrick Philip,9992,0,9999,7
1745824454109,ECON 178,A01,907814,Zhu; Ying,28,0,35,7
1745824455137,EDS 115,A00,895312,Staff,41,0,45,4
1745824456164,EDS 117,A01,895337,Staff,30,0,30,0
1745824457192,EDS 125,A00,895341,Jones; Gabrielle Anastasia,43,0,45,2
1745824458231,EDS 128A,A01,895459,Fargason; Sharon Gayle,44,0,45,1
1745824459259,EDS 128B,A01,895543,Pappas; Elizabeth,44,0,45,1
1745824460288,EDS 139,A00,897203,Pappas; Elizabeth,44,0,45,1
1745824460288,EDS 139,B00,897209,Fargason; Sharon Gayle,44,0,45,1
1745824461319,EDS 201,A00,895545,Staff,43,0,45,2
1745824462347,EDS 203,A01,895581,Halter; Christopher P.,43,0,45,2
1745824463375,EDS 204R,A01,895625,Heinzman; Erica M.,43,0,45,2
1745824463375,EDS 204R,B01,895693,Halter; Christopher P.,18,0,45,27
1745824464402,EDS 206R,A00,895694,Fargason; Sharon Gayle,9,0,30,21
1745824464402,EDS 206R,B00,895695,Choi; Bailey Miyeon,20,0,30,10
1745824465437,EDS 250,A00,895697,Hemans; Patricia Ann Benitez,43,0,45,2
1745824466467,EDS 281,A00,895701,Meyerott; Theresa Ann,15,0,15,0
1745824467494,EDS 284,A00,895736,Meyerott; Theresa Ann,15,0,15,0
1745824468521,EDS 286,A00,897210,Fine; Sarah,15,0,15,0
1745824469551,EDS 289C,A01,895770,Daly; Alan J.,15,0,15,0
1745824470578,EDS 290,A00,897211,Hofstetter; Carolyn,15,0,15,0
1745824471605,LIGM 5A,A00,896162,Fischer-Grunski; Eva K,15,0,20,5
1745824472632,LIGM 5B,A00,896260,Fischer-Grunski; Eva K,17,0,20,3
1745824473664,LIGM 5C,A00,896308,Fischer-Grunski; Eva K,18,0,20,2
1745824474696,LIIT 5AS,A00,896313,Carnelos; Chiara,17,0,20,3
1745824475726,LIIT 5BS,A00,896416,Carnelos; Chiara,20,0,20,0
1745824476758,LIIT 5CS,A00,896564,Carnelos; Chiara,20,0,20,0
1745824477782,LISP 5A,A00,896588,Munoz Sanchez; Alicia,4,0,20,16
1745824478813,LISP 5B,A00,896653,Munoz Sanchez; Alicia,10,0,20,10
1745824479842,LISP 5C,A00,896655,Munoz Sanchez; Alicia,4,0,20,16
1745824480869,MAE 197,001,957918,Kleissl; Jan,9998,0,9999,1
1745824481894,MATH 2,A01,957937,Staff,34,0,35,1
1745824482919,MATH 197,001,957876,Kedlaya; Kiran S.,9993,0,9999,6
1745824483949,MCWP 40,A00,892729,Duru; Nur,13,0,20,7
1745824483949,MCWP 40,B00,893304,Montejo; Carolina,20,0,20,0
1745824484975,MCWP 40R,A00,893757,Redela; Pamela Morgan,0,7,20,20
1745824486005,MCWP 50,A00,893758,Morshed; Michael James,2,0,20,18
1745824486005,MCWP 50,B00,893761,Bartulis; Jason Michael,18,0,20,2
1745824487036,MCWP 50R,A00,893766,Compas; Sean Matthew,0,1,20,20
1745824487036,MCWP 50R,B00,893769,Carter; Jennifer A,0,0,20,20
1745824487036,MCWP 50R,C00,893771,Krone; Jarret,0,3,20,20
1745824487036,MCWP 50R,D00,893772,Miller; Elizabeth Deen,3,0,20,17
1745824487036,MCWP 50R,E00,893775,Carter; Andrea L,0,0,20,20
1745824488063,MMW 11R,A01,892721,Herbst; Matthew,11,0,27,16
1745824488063,MMW 11R,A02,892722,Herbst; Matthew,0,0,0,3
1745824489089,MMW 12R,A01,892724,Herbst; Matthew,0,10,16,16
1745824489089,MMW 12R,A02,892725,Herbst; Matthew,0,9,16,16
1745824490121,MMW 13R,A01,892727,Staff,0,3,16,16
1745824490121,MMW 13R,A02,892728,Staff,0,4,16,16
1745824490121,MMW 13R,A03,958032,Staff,0,3,16,16
1745824490121,MMW 13R,A04,958033,Staff,0,2,16,16
1745824490121,MMW 13R,A05,958034,Staff,0,3,16,16
1745824491151,SIO 295LS,A00,894015,Staff,7,0,25,18
1745824492177,SIO 295S,A00,894020,Staff,7,0,25,18
1745824493208,SIOC 290S,B01,958918,Staff,0,0,0,0
1745824494235,SIOC 291S,B01,958922,Staff,0,0,0,0
1745824495261,SOCI 117,A01,895339,Staff,4,0,5,1
1745824496289,WES 237B,A00,894149,Staff,11,0,20,9
1745824498352,AESE 279B,A00,891859,Staff,13,0,35,22
1745824499379,AIP 197,001,891854,Staff,70,0,70,0
1745824500404,ANTH 289S,A00,891856,Gagneux; Pascal,12,0,12,0
1745824501437,BENG 196,001,957946,Engler; Adam J.,9996,0,9999,3
1745824502512,CAT 124RS,A01,956906,Staff,8,0,25,17
1745824503538,CAT 125RS,A01,922013,Staff,8,0,25,17
1745824504564,CLRE 250,A00,891860,Morris; Sheldon,9995,0,9999,4
1745824506625,CLRE 251R,A00,907817,Mehta; Ravindra L.,9994,0,9999,5
1745824507653,CLRE 252,A00,891864,Cuomo; Raphael Eduardo,9993,0,9999,6
1745824508682,CLRE 253,A00,891867,Vaida; Florin,9994,0,9999,5
1745824508682,CLRE 253,B00,907819,Staff,9999,0,9999,0
1745824509718,CLRE 259,A00,891868,Patel; Hemal,9998,0,9999,1
1745824510744,CLRE 260,A00,891872,Cuomo; Raphael Eduardo,9999,0,9999,0
1745824511771,CLRE 297,001,891888,Cuomo; Raphael Eduardo,9999,0,9999,0
1745824512801,CSE 191,A00,958773,Minnes Kemp; Mor Mia,9999,0,9999,0
1745824513830,CSS 201S,A01,892054,Mignozzetti; Umberto,30,0,30,0
1745824514860,CSS 202S,A01,892056,Mignozzetti; Umberto,30,0,30,0
1745824515887,DSC 197,001,956898,Eldridge; Justin Matthew,9998,0,9999,1
1745824516914,DSC 297,001,958000,Mazumdar; Arya,9998,0,9999,1
1745824517941,EAP 100,A00,905686,Staff,9776,0,9999,223
1745824518970,ECE 45,A01,892618,Staff,0,13,50,50
1745824519997,ECE 109,A01,892620,Staff,0,43,0,0
1745824521025,ECE 111,A01,892719,Staff,0,9,50,50
1745824522051,ECE 197,001,957920,Mercier; Patrick Philip,9992,0,9999,7
1745824523086,ECON 178,A01,907814,Zhu; Ying,28,0,35,7
1745824524114,EDS 115,A00,895312,Staff,41,0,45,4
1745824525139,EDS 117,A01,895337,Staff,30,0,30,0
1745824526166,EDS 125,A00,895341,Jones; Gabrielle Anastasia,43,0,45,2
1745824527191,EDS 128A,A01,895459,Fargason; Sharon Gayle,44,0,45,1
1745824528217,EDS 128B,A01,895543,Pappas; Elizabeth,44,0,45,1
1745824529245,EDS 139,A00,897203,Pappas; Elizabeth,44,0,45,1
1745824529245,EDS 139,B00,897209,Fargason; Sharon Gayle,44,0,45,1
1745824530270,EDS 201,A00,895545,Staff,43,0,45,2
1745824531298,EDS 203,A01,895581,Halter; Christopher P.,43,0,45,2
1745824532325,EDS 204R,A01,895625,Heinzman; Erica M.,43,0,45,2
1745824532325,EDS 204R,B01,895693,Halter; Christopher P.,18,0,45,27
1745824533351,EDS 206R,A00,895694,Fargason; Sharon Gayle,9,0,30,21
1745824533351,EDS 206R,B00,895695,Choi; Bailey Miyeon,20,0,30,10
1745824534379,EDS 250,A00,895697,Hemans; Patricia Ann Benitez,43,0,45,2
1745824535404,EDS 281,A00,895701,Meyerott; Theresa Ann,15,0,15,0
1745824536432,EDS 284,A00,895736,Meyerott; Theresa Ann,15,0,15,0
1745824537456,EDS 286,A00,897210,Fine; Sarah,15,0,15,0
1745824538485,EDS 289C,A01,895770,Daly; Alan J.,15,0,15,0
1745824539511,EDS 290,A00,897211,Hofstetter; Carolyn,15,0,15,0
1745824540536,LIGM 5A,A00,896162,Fischer-Grunski; Eva K,15,0,20,5
1745824541562,LIGM 5B,A00,896260,Fischer-Grunski; Eva K,17,0,20,3
1745824542587,LIGM 5C,A00,896308,Fischer-Grunski; Eva K,18,0,20,2
1745824543613,LIIT 5AS,A00,896313,Carnelos; Chiara,17,0,20,3
1745824544638,LIIT 5BS,A00,896416,Carnelos; Chiara,20,0,20,0
1745824545664,LIIT 5CS,A00,896564,Carnelos; Chiara,20,0,20,0
1745824546691,LISP 5A,A00,896588,Munoz Sanchez; Alicia,4,0,20,16
1745824547717,LISP 5B,A00,896653,Munoz Sanchez; Alicia,10,0,20,10
1745824548744,LISP 5C,A00,896655,Munoz Sanchez; Alicia,4,0,20,16
1745824549773,MAE 197,001,957918,Kleissl; Jan,9998,0,9999,1
1745824550798,MATH 2,A01,957937,Staff,34,0,35,1
1745824551823,MATH 197,001,957876,Kedlaya; Kiran S.,9993,0,9999,6
1745824552849,MCWP 40,A00,892729,Duru; Nur,13,0,20,7
1745824552849,MCWP 40,B00,893304,Montejo; Carolina,20,0,20,0
1745824553876,MCWP 40R,A00,893757,Redela; Pamela Morgan,0,7,20,20
1745824554902,MCWP 50,A00,893758,Morshed; Michael James,2,0,20,18
1745824554902,MCWP 50,B00,893761,Bartulis; Jason Michael,18,0,20,2
1745824555929,MCWP 50R,A00,893766,Compas; Sean Matthew,0,1,20,20
1745824555929,MCWP 50R,B00,893769,Carter; Jennifer A,0,0,20,20
1745824555929,MCWP 50R,C00,893771,Krone; Jarret,0,3,20,20
1745824555929,MCWP 50R,D00,893772,Miller; Elizabeth Deen,3,0,20,17
1745824555929,MCWP 50R,E00,893775,Carter; Andrea L,0,0,20,20
1745824556976,MMW 11R,A01,892721,Herbst; Matthew,11,0,27,16
1745824556976,MMW 11R,A02,892722,Herbst; Matthew,0,0,0,3
1745824558007,MMW 12R,A01,892724,Herbst; Matthew,0,10,16,16
1745824558007,MMW 12R,A02,892725,Herbst; Matthew,0,9,16,16
1745824559035,MMW 13R,A01,892727,Staff,0,3,16,16
1745824559035,MMW 13R,A02,892728,Staff,0,4,16,16
1745824559035,MMW 13R,A03,958032,Staff,0,3,16,16
1745824559035,MMW 13R,A04,958033,Staff,0,2,16,16
1745824559035,MMW 13R,A05,958034,Staff,0,3,16,16
1745824560060,SIO 295LS,A00,894015,Staff,7,0,25,18
1745824561087,SIO 295S,A00,894020,Staff,7,0,25,18
1745824562122,SIOC 290S,B01,958918,Staff,0,0,0,0
1745824563149,SIOC 291S,B01,958922,Staff,0,0,0,0
1745824564176,SOCI 117,A01,895339,Staff,4,0,5,1
1745824565201,WES 237B,A00,894149,Staff,11,0,20,9
1745824567269,AESE 279B,A00,891859,Staff,13,0,35,22
1745824568295,AIP 197,001,891854,Staff,70,0,70,0
1745824569326,ANTH 289S,A00,891856,Gagneux; Pascal,12,0,12,0
1745824570355,BENG 196,001,957946,Engler; Adam J.,9996,0,9999,3
1745824571380,CAT 124RS,A01,956906,Staff,8,0,25,17
1745824572409,CAT 125RS,A01,922013,Staff,8,0,25,17
1745824573436,CLRE 250,A00,891860,Morris; Sheldon,9995,0,9999,4
1745824575490,CLRE 251R,A00,907817,Mehta; Ravindra L.,9994,0,9999,5
1745824576516,CLRE 252,A00,891864,Cuomo; Raphael Eduardo,9993,0,9999,6
1745824577546,CLRE 253,A00,891867,Vaida; Florin,9994,0,9999,5
1745824577546,CLRE 253,B00,907819,Staff,9999,0,9999,0
1745824578577,CLRE 259,A00,891868,Patel; Hemal,9998,0,9999,1
1745824579604,CLRE 260,A00,891872,Cuomo; Raphael Eduardo,9999,0,9999,0
1745824580630,CLRE 297,001,891888,Cuomo; Raphael Eduardo,9999,0,9999,0
1745824581655,CSE 191,A00,958773,Minnes Kemp; Mor Mia,9999,0,9999,0
1745824582681,CSS 201S,A01,892054,Mignozzetti; Umberto,30,0,30,0
1745824583707,CSS 202S,A01,892056,Mignozzetti; Umberto,30,0,30,0
1745824584741,DSC 197,001,956898,Eldridge; Justin Matthew,9998,0,9999,1
1745824585770,DSC 297,001,958000,Mazumdar; Arya,9998,0,9999,1
1745824586798,EAP 100,A00,905686,Staff,9776,0,9999,223
1745824587826,ECE 45,A01,892618,Staff,0,13,50,50
1745824588852,ECE 109,A01,892620,Staff,0,43,0,0
1745824589876,ECE 111,A01,892719,Staff,0,9,50,50
1745824590906,ECE 197,001,957920,Mercier; Patrick Philip,9992,0,9999,7
1745824591935,ECON 178,A01,907814,Zhu; Ying,28,0,35,7
1745824592962,EDS 115,A00,895312,Staff,41,0,45,4
1745824593988,EDS 117,A01,895337,Staff,30,0,30,0
1745824595022,EDS 125,A00,895341,Jones; Gabrielle Anastasia,43,0,45,2
1745824596046,EDS 128A,A01,895459,Fargason; Sharon Gayle,44,0,45,1
1745824597072,EDS 128B,A01,895543,Pappas; Elizabeth,44,0,45,1
1745824598101,EDS 139,A00,897203,Pappas; Elizabeth,44,0,45,1
1745824598101,EDS 139,B00,897209,Fargason; Sharon Gayle,44,0,45,1
1745824599129,EDS 201,A00,895545,Staff,43,0,45,2
1745824600155,EDS 203,A01,895581,Halter; Christopher P.,43,0,45,2
1745824601184,EDS 204R,A01,895625,Heinzman; Erica M.,43,0,45,2
1745824601184,EDS 204R,B01,895693,Halter; Christopher P.,18,0,45,27
1745824602213,EDS 206R,A00,895694,Fargason; Sharon Gayle,9,0,30,21
1745824602213,EDS 206R,B00,895695,Choi; Bailey Miyeon,20,0,30,10
1745824603243,EDS 250,A00,895697,Hemans; Patricia Ann Benitez,43,0,45,2
1745824604270,EDS 281,A00,895701,Meyerott; Theresa Ann,15,0,15,0
1745824605296,EDS 284,A00,895736,Meyerott; Theresa Ann,15,0,15,0
1745824606323,EDS 286,A00,897210,Fine; Sarah,15,0,15,0
1745824607349,EDS 289C,A01,895770,Daly; Alan J.,15,0,15,0
1745824608376,EDS 290,A00,897211,Hofstetter; Carolyn,15,0,15,0
1745824609406,LIGM 5A,A00,896162,Fischer-Grunski; Eva K,15,0,20,5
1745824610432,LIGM 5B,A00,896260,Fischer-Grunski; Eva K,17,0,20,3
1745824611460,LIGM 5C,A00,896308,Fischer-Grunski; Eva K,18,0,20,2
1745824612511,LIIT 5AS,A00,896313,Carnelos; Chiara,17,0,20,3
1745824613539,LIIT 5BS,A00,896416,Carnelos; Chiara,20,0,20,0
1745824614564,LIIT 5CS,A00,896564,Carnelos; Chiara,20,0,20,0
1745824615589,LISP 5A,A00,896588,Munoz Sanchez; Alicia,4,0,20,16
1745824616615,LISP 5B,A00,896653,Munoz Sanchez; Alicia,10,0,20,10
1745824617647,LISP 5C,A00,896655,Munoz Sanchez; Alicia,4,0,20,16
1745824618673,MAE 197,001,957918,Kleissl; Jan,9998,0,9999,1
1745824619714,MATH 2,A01,957937,Staff,34,0,35,1
1745824620739,MATH 197,001,957876,Kedlaya; Kiran S.,9993,0,9999,6
1745824621770,MCWP 40,A00,892729,Duru; Nur,13,0,20,7
1745824621770,MCWP 40,B00,893304,Montejo; Carolina,20,0,20,0
1745824622797,MCWP 40R,A00,893757,Redela; Pamela Morgan,0,7,20,20
1745824623826,MCWP 50,A00,893758,Morshed; Michael James,2,0,20,18
1745824623826,MCWP 50,B00,893761,Bartulis; Jason Michael,18,0,20,2
1745824624876,MCWP 50R,A00,893766,Compas; Sean Matthew,0,1,20,20
1745824624876,MCWP 50R,B00,893769,Carter; Jennifer A,0,0,20,20
1745824624876,MCWP 50R,C00,893771,Krone; Jarret,0,3,20,20
1745824624876,MCWP 50R,D00,893772,Miller; Elizabeth Deen,3,0,20,17
1745824624876,MCWP 50R,E00,893775,Carter; Andrea L,0,0,20,20
1745824625906,MMW 11R,A01,892721,Herbst; Matthew,11,0,27,16
1745824625906,MMW 11R,A02,892722,Herbst; Matthew,0,0,0,3
1745824626940,MMW 12R,A01,892724,Herbst; Matthew,0,10,16,16
1745824626940,MMW 12R,A02,892725,Herbst; Matthew,0,9,16,16
1745824627975,MMW 13R,A01,892727,Staff,0,3,16,16
1745824627975,MMW 13R,A02,892728,Staff,0,4,16,16
1745824627975,MMW 13R,A03,958032,Staff,0,3,16,16
1745824627975,MMW 13R,A04,958033,Staff,0,2,16,16
1745824627975,MMW 13R,A05,958034,Staff,0,3,16,16
1745824629004,SIO 295LS,A00,894015,Staff,7,0,25,18
1745824630066,SIO 295S,A00,894020,Staff,7,0,25,18
1745824631095,SIOC 290S,B01,958918,Staff,0,0,0,0
1745824632127,SIOC 291S,B01,958922,Staff,0,0,0,0
1745824633158,SOCI 117,A01,895339,Staff,4,0,5,1
1745824634188,WES 237B,A00,894149,Staff,11,0,20,9
1745824636272,AESE 279B,A00,891859,Staff,13,0,35,22
1745824637302,AIP 197,001,891854,Staff,70,0,70,0
1745824638336,ANTH 289S,A00,891856,Gagneux; Pascal,12,0,12,0
1745824639366,BENG 196,001,957946,Engler; Adam J.,9996,0,9999,3
1745824640394,CAT 124RS,A01,956906,Staff,8,0,25,17
1745824641425,CAT 125RS,A01,922013,Staff,8,0,25,17
1745824642456,CLRE 250,A00,891860,Morris; Sheldon,9995,0,9999,4
1745824644513,CLRE 251R,A00,907817,Mehta; Ravindra L.,9994,0,9999,5
1745824645547,CLRE 252,A00,891864,Cuomo; Raphael Eduardo,9993,0,9999,6
1745824646579,CLRE 253,A00,891867,Vaida; Florin,9994,0,9999,5
1745824646579,CLRE 253,B00,907819,Staff,9999,0,9999,0
1745824647609,CLRE 259,A00,891868,Patel; Hemal,9998,0,9999,1
1745824648641,CLRE 260,A00,891872,Cuomo; Raphael Eduardo,9999,0,9999,0
1745824649677,CLRE 297,001,891888,Cuomo; Raphael Eduardo,9999,0,9999,0
1745824650707,CSE 191,A00,958773,Minnes Kemp; Mor Mia,9999,0,9999,0
1745824651740,CSS 201S,A01,892054,Mignozzetti; Umberto,30,0,30,0
1745824652768,CSS 202S,A01,892056,Mignozzetti; Umberto,30,0,30,0
1745824653798,DSC 197,001,956898,Eldridge; Justin Matthew,9998,0,9999,1
1745824654827,DSC 297,001,958000,Mazumdar; Arya,9998,0,9999,1
1745824655854,EAP 100,A00,905686,Staff,9776,0,9999,223
1745824656882,ECE 45,A01,892618,Staff,0,13,50,50
1745824657908,ECE 109,A01,892620,Staff,0,43,0,0
1745824658933,ECE 111,A01,892719,Staff,0,9,50,50
1745824659964,ECE 197,001,957920,Mercier; Patrick Philip,9992,0,9999,7
1745824660990,ECON 178,A01,907814,Zhu; Ying,28,0,35,7
1745824662019,EDS 115,A00,895312,Staff,41,0,45,4
1745824663049,EDS 117,A01,895337,Staff,30,0,30,0
1745824664077,EDS 125,A00,895341,Jones; Gabrielle Anastasia,43,0,45,2
1745824665107,EDS 128A,A01,895459,Fargason; Sharon Gayle,44,0,45,1
1745824666137,EDS 128B,A01,895543,Pappas; Elizabeth,44,0,45,1
1745824667165,EDS 139,A00,897203,Pappas; Elizabeth,44,0,45,1
1745824667165,EDS 139,B00,897209,Fargason; Sharon Gayle,44,0,45,1
1745824668191,EDS 201,A00,895545,Staff,43,0,45,2
1745824669217,EDS 203,A01,895581,Halter; Christopher P.,43,0,45,2
1745824670246,EDS 204R,A01,895625,Heinzman; Erica M.,43,0,45,2
1745824670246,EDS 204R,B01,895693,Halter; Christopher P.,18,0,45,27
1745824671272,EDS 206R,A00,895694,Fargason; Sharon Gayle,9,0,30,21
1745824671272,EDS 206R,B00,895695,Choi; Bailey Miyeon,20,0,30,10
1745824672298,EDS 250,A00,895697,Hemans; Patricia Ann Benitez,43,0,45,2
1745824673328,EDS 281,A00,895701,Meyerott; Theresa Ann,15,0,15,0
1745824674356,EDS 284,A00,895736,Meyerott; Theresa Ann,15,0,15,0
1745824675383,EDS 286,A00,897210,Fine; Sarah,15,0,15,0
1745824676409,EDS 289C,A01,895770,Daly; Alan J.,15,0,15,0
1745824677438,EDS 290,A00,897211,Hofstetter; Carolyn,15,0,15,0
1745824678466,LIGM 5A,A00,896162,Fischer-Grunski; Eva K,15,0,20,5
1745824679498,LIGM 5B,A00,896260,Fischer-Grunski; Eva K,17,0,20,3
1745824680525,LIGM 5C,A00,896308,Fischer-Grunski; Eva K,18,0,20,2
1745824681551,LIIT 5AS,A00,896313,Carnelos; Chiara,17,0,20,3
1745824682579,LIIT 5BS,A00,896416,Carnelos; Chiara,20,0,20,0
1745824683617,LIIT 5CS,A00,896564,Carnelos; Chiara,20,0,20,0
1745824684644,LISP 5A,A00,896588,Munoz Sanchez; Alicia,4,0,20,16
1745824685671,LISP 5B,A00,896653,Munoz Sanchez; Alicia,10,0,20,10
1745824686698,LISP 5C,A00,896655,Munoz Sanchez; Alicia,4,0,20,16
1745824687726,MAE 197,001,957918,Kleissl; Jan,9998,0,9999,1
1745824688755,MATH 2,A01,957937,Staff,34,0,35,1
1745824689782,MATH 197,001,957876,Kedlaya; Kiran S.,9993,0,9999,6
1745824690812,MCWP 40,A00,892729,Duru; Nur,13,0,20,7
1745824690812,MCWP 40,B00,893304,Montejo; Carolina,20,0,20,0
1745824691839,MCWP 40R,A00,893757,Redela; Pamela Morgan,0,7,20,20
1745824692873,MCWP 50,A00,893758,Morshed; Michael James,2,0,20,18
1745824692873,MCWP 50,B00,893761,Bartulis; Jason Michael,18,0,20,2
1745824693903,MCWP 50R,A00,893766,Compas; Sean Matthew,0,1,20,20
1745824693903,MCWP 50R,B00,893769,Carter; Jennifer A,0,0,20,20
1745824693903,MCWP 50R,C00,893771,Krone; Jarret,0,3,20,20
1745824693903,MCWP 50R,D00,893772,Miller; Elizabeth Deen,3,0,20,17
1745824693903,MCWP 50R,E00,893775,Carter; Andrea L,0,0,20,20
1745824694928,MMW 11R,A01,892721,Herbst; Matthew,11,0,27,16
1745824694928,MMW 11R,A02,892722,Herbst; Matthew,0,0,0,3
1745824695958,MMW 12R,A01,892724,Herbst; Matthew,0,10,16,16
1745824695958,MMW 12R,A02,892725,Herbst; Matthew,0,9,16,16
1745824696984,MMW 13R,A01,892727,Staff,0,3,16,16
1745824696984,MMW 13R,A02,892728,Staff,0,4,16,16
1745824696984,MMW 13R,A03,958032,Staff,0,3,16,16
1745824696984,MMW 13R,A04,958033,Staff,0,2,16,16
1745824696984,MMW 13R,A05,958034,Staff,0,3,16,16
1745824698013,SIO 295LS,A00,894015,Staff,7,0,25,18
1745824699044,SIO 295S,A00,894020,Staff,7,0,25,18
1745824700071,SIOC 290S,B01,958918,Staff,0,0,0,0
1745824701104,SIOC 291S,B01,958922,Staff,0,0,0,0
1745824702131,SOCI 117,A01,895339,Staff,4,0,5,1
1745824703158,WES 237B,A00,894149,Staff,11,0,20,9
1745824705265,AESE 279B,A00,891859,Staff,13,0,35,22
1745824706290,AIP 197,001,891854,Staff,70,0,70,0
1745824707320,ANTH 289S,A00,891856,Gagneux; Pascal,12,0,12,0
1745824708348,BENG 196,001,957946,Engler; Adam J.,9996,0,9999,3
1745824709376,CAT 124RS,A01,956906,Staff,8,0,25,17
1745824710402,CAT 125RS,A01,922013,Staff,8,0,25,17
1745824711429,CLRE 250,A00,891860,Morris; Sheldon,9995,0,9999,4
1745824713487,CLRE 251R,A00,907817,Mehta; Ravindra L.,9994,0,9999,5
1745824714513,CLRE 252,A00,891864,Cuomo; Raphael Eduardo,9993,0,9999,6
1745824715539,CLRE 253,A00,891867,Vaida; Florin,9994,0,9999,5
1745824715539,CLRE 253,B00,907819,Staff,9999,0,9999,0
1745824716572,CLRE 259,A00,891868,Patel; Hemal,9998,0,9999,1
1745824717598,CLRE 260,A00,891872,Cuomo; Raphael Eduardo,9999,0,9999,0
1745824718626,CLRE 297,001,891888,Cuomo; Raphael Eduardo,9999,0,9999,0
1745824719653,CSE 191,A00,958773,Minnes Kemp; Mor Mia,9999,0,9999,0
1745824720678,CSS 201S,A01,892054,Mignozzetti; Umberto,30,0,30,0
1745824721705,CSS 202S,A01,892056,Mignozzetti; Umberto,30,0,30,0
1745824722736,DSC 197,001,956898,Eldridge; Justin Matthew,9998,0,9999,1
1745824723765,DSC 297,001,958000,Mazumdar; Arya,9998,0,9999,1
1745824724797,EAP 100,A00,905686,Staff,9776,0,9999,223
1745824725824,ECE 45,A01,892618,Staff,0,13,50,50
1745824726851,ECE 109,A01,892620,Staff,0,43,0,0
1745824727878,ECE 111,A01,892719,Staff,0,9,50,50
1745824728904,ECE 197,001,957920,Mercier; Patrick Philip,9992,0,9999,7
1745824729932,ECON 178,A01,907814,Zhu; Ying,28,0,35,7
1745824730959,EDS 115,A00,895312,Staff,41,0,45,4
1745824731989,EDS 117,A01,895337,Staff,30,0,30,0
1745824733015,EDS 125,A00,895341,Jones; Gabrielle Anastasia,43,0,45,2
1745824734047,EDS 128A,A01,895459,Fargason; Sharon Gayle,44,0,45,1
1745824735075,EDS 128B,A01,895543,Pappas; Elizabeth,44,0,45,1
1745824736101,EDS 139,A00,897203,Pappas; Elizabeth,44,0,45,1
1745824736101,EDS 139,B00,897209,Fargason; Sharon Gayle,44,0,45,1
1745824737129,EDS 201,A00,895545,Staff,43,0,45,2
1745824738162,EDS 203,A01,895581,Halter; Christopher P.,43,0,45,2
1745824739213,EDS 204R,A01,895625,Heinzman; Erica M.,43,0,45,2
1745824739213,EDS 204R,B01,895693,Halter; Christopher P.,18,0,45,27
1745824740239,EDS 206R,A00,895694,Fargason; Sharon Gayle,9,0,30,21
1745824740239,EDS 206R,B00,895695,Choi; Bailey Miyeon,20,0,30,10
1745824741271,EDS 250,A00,895697,Hemans; Patricia Ann Benitez,43,0,45,2
1745824742311,EDS 281,A00,895701,Meyerott; Theresa Ann,15,0,15,0
1745824743340,EDS 284,A00,895736,Meyerott; Theresa Ann,15,0,15,0
1745824744372,EDS 286,A00,897210,Fine; Sarah,15,0,15,0
1745824745401,EDS 289C,A01,895770,Daly; Alan J.,15,0,15,0
1745824746429,EDS 290,A00,897211,Hofstetter; Carolyn,15,0,15,0
1745824747455,LIGM 5A,A00,896162,Fischer-Grunski; Eva K,15,0,20,5
1745824748487,LIGM 5B,A00,896260,Fischer-Grunski; Eva K,17,0,20,3
1745824749514,LIGM 5C,A00,896308,Fischer-Grunski; Eva K,18,0,20,2
1745824750544,LIIT 5AS,A00,896313,Carnelos; Chiara,17,0,20,3
1745824751575,LIIT 5BS,A00,896416,Carnelos; Chiara,20,0,20,0
1745824752603,LIIT 5CS,A00,896564,Carnelos; Chiara,20,0,20,0
1745824753630,LISP 5A,A00,896588,Munoz Sanchez; Alicia,4,0,20,16
1745824754662,LISP 5B,A00,896653,Munoz Sanchez; Alicia,10,0,20,10
1745824755687,LISP 5C,A00,896655,Munoz Sanchez; Alicia,4,0,20,16
1745824756715,MAE 197,001,957918,Kleissl; Jan,9998,0,9999,1
1745824757759,MATH 2,A01,957937,Staff,34,0,35,1
1745824758784,MATH 197,001,957876,Kedlaya; Kiran S.,9993,0,9999,6
1745824759814,MCWP 40,A00,892729,Duru; Nur,13,0,20,7
1745824759814,MCWP 40,B00,893304,Montejo; Carolina,20,0,20,0
1745824760840,MCWP 40R,A00,893757,Redela; Pamela Morgan,0,7,20,20
1745824761868,MCWP 50,A00,893758,Morshed; Michael James,2,0,20,18
1745824761868,MCWP 50,B00,893761,Bartulis; Jason Michael,18,0,20,2
1745824762900,MCWP 50R,A00,893766,Compas; Sean Matthew,0,1,20,20
1745824762900,MCWP 50R,B00,893769,Carter; Jennifer A,0,0,20,20
1745824762900,MCWP 50R,C00,893771,Krone; Jarret,0,3,20,20
1745824762900,MCWP 50R,D00,893772,Miller; Elizabeth Deen,3,0,20,17
1745824762900,MCWP 50R,E00,893775,Carter; Andrea L,0,0,20,20
1745824763934,MMW 11R,A01,892721,Herbst; Matthew,11,0,27,16
1745824763934,MMW 11R,A02,892722,Herbst; Matthew,0,0,0,3
1745824764965,MMW 12R,A01,892724,Herbst; Matthew,0,10,16,16
1745824764965,MMW 12R,A02,892725,Herbst; Matthew,0,9,16,16
1745824765994,MMW 13R,A01,892727,Staff,0,3,16,16
1745824765994,MMW 13R,A02,892728,Staff,0,4,16,16
1745824765994,MMW 13R,A03,958032,Staff,0,3,16,16
1745824765994,MMW 13R,A04,958033,Staff,0,2,16,16
1745824765994,MMW 13R,A05,958034,Staff,0,3,16,16
1745824767023,SIO 295LS,A00,894015,Staff,7,0,25,18
1745824768052,SIO 295S,A00,894020,Staff,7,0,25,18
1745824769084,SIOC 290S,B01,958918,Staff,0,0,0,0
1745824770118,SIOC 291S,B01,958922,Staff,0,0,0,0
1745824771146,SOCI 117,A01,895339,Staff,4,0,5,1
1745824772172,WES 237B,A00,894149,Staff,11,0,20,9
1745824774237,AESE 279B,A00,891859,Staff,13,0,35,22
1745824775265,AIP 197,001,891854,Staff,70,0,70,0
1745824776294,ANTH 289S,A00,891856,Gagneux; Pascal,12,0,12,0
1745824777324,BENG 196,001,957946,Engler; Adam J.,9996,0,9999,3
1745824778350,CAT 124RS,A01,956906,Staff,8,0,25,17
1745824779381,CAT 125RS,A01,922013,Staff,8,0,25,17
1745824780410,CLRE 250,A00,891860,Morris; Sheldon,9995,0,9999,4
1745824782468,CLRE 251R,A00,907817,Mehta; Ravindra L.,9994,0,9999,5
1745824783494,CLRE 252,A00,891864,Cuomo; Raphael Eduardo,9993,0,9999,6
1745824784524,CLRE 253,A00,891867,Vaida; Florin,9994,0,9999,5
1745824784524,CLRE 253,B00,907819,Staff,9999,0,9999,0
1745824785555,CLRE 259,A00,891868,Patel; Hemal,9998,0,9999,1
1745824786581,CLRE 260,A00,891872,Cuomo; Raphael Eduardo,9999,0,9999,0
1745824787612,CLRE 297,001,891888,Cuomo; Raphael Eduardo,9999,0,9999,0
1745824788652,CSE 191,A00,958773,Minnes Kemp; Mor Mia,9999,0,9999,0
1745824789680,CSS 201S,A01,892054,Mignozzetti; Umberto,30,0,30,0
1745824790706,CSS 202S,A01,892056,Mignozzetti; Umberto,30,0,30,0
1745824791734,DSC 197,001,956898,Eldridge; Justin Matthew,9998,0,9999,1
1745824792761,DSC 297,001,958000,Mazumdar; Arya,9998,0,9999,1
1745824793787,EAP 100,A00,905686,Staff,9776,0,9999,223
1745824794814,ECE 45,A01,892618,Staff,0,13,50,50
1745824795839,ECE 109,A01,892620,Staff,0,43,0,0
1745824796867,ECE 111,A01,892719,Staff,0,9,50,50
1745824797896,ECE 197,001,957920,Mercier; Patrick Philip,9992,0,9999,7
1745824798927,ECON 178,A01,907814,Zhu; Ying,28,0,35,7
1745824799957,EDS 115,A00,895312,Staff,41,0,45,4
1745824800985,EDS 117,A01,895337,Staff,30,0,30,0
1745824802014,EDS 125,A00,895341,Jones; Gabrielle Anastasia,43,0,45,2
1745824803044,EDS 128A,A01,895459,Fargason; Sharon Gayle,44,0,45,1
1745824804075,EDS 128B,A01,895543,Pappas; Elizabeth,44,0,45,1
1745824805103,EDS 139,A00,897203,Pappas; Elizabeth,44,0,45,1
1745824805103,EDS 139,B00,897209,Fargason; Sharon Gayle,44,0,45,1
1745824806129,EDS 201,A00,895545,Staff,43,0,45,2
1745824807163,EDS 203,A01,895581,Halter; Christopher P.,43,0,45,2
1745824808190,EDS 204R,A01,895625,Heinzman; Erica M.,43,0,45,2
1745824808190,EDS 204R,B01,895693,Halter; Christopher P.,18,0,45,27
1745824809226,EDS 206R,A00,895694,Fargason; Sharon Gayle,9,0,30,21
1745824809226,EDS 206R,B00,895695,Choi; Bailey Miyeon,20,0,30,10
1745824810254,EDS 250,A00,895697,Hemans; Patricia Ann Benitez,43,0,45,2
1745824811283,EDS 281,A00,895701,Meyerott; Theresa Ann,15,0,15,0
1745824812310,EDS 284,A00,895736,Meyerott; Theresa Ann,15,0,15,0
1745824813335,EDS 286,A00,897210,Fine; Sarah,15,0,15,0
1745824814365,EDS 289C,A01,895770,Daly; Alan J.,15,0,15,0
1745824815394,EDS 290,A00,897211,Hofstetter; Carolyn,15,0,15,0
1745824816426,LIGM 5A,A00,896162,Fischer-Grunski; Eva K,15,0,20,5
1745824817452,LIGM 5B,A00,896260,Fischer-Grunski; Eva K,17,0,20,3
1745824818479,LIGM 5C,A00,896308,Fischer-Grunski; Eva K,18,0,20,2
1745824819508,LIIT 5AS,A00,896313,Carnelos; Chiara,17,0,20,3
1745824820538,LIIT 5BS,A00,896416,Carnelos; Chiara,20,0,20,0
1745824821568,LIIT 5CS,A00,896564,Carnelos; Chiara,20,0,20,0
1745824822594,LISP 5A,A00,896588,Munoz Sanchez; Alicia,4,0,20,16
1745824823622,LISP 5B,A00,896653,Munoz Sanchez; Alicia,10,0,20,10
1745824824653,LISP 5C,A00,896655,Munoz Sanchez; Alicia,4,0,20,16
1745824825678,MAE 197,001,957918,Kleissl; Jan,9998,0,9999,1
1745824826704,MATH 2,A01,957937,Staff,34,0,35,1
1745824827735,MATH 197,001,957876,Kedlaya; Kiran S.,9993,0,9999,6
1745824828761,MCWP 40,A00,892729,Duru; Nur,13,0,20,7
1745824828761,MCWP 40,B00,893304,Montejo; Carolina,20,0,20,0
1745824829791,MCWP 40R,A00,893757,Redela; Pamela Morgan,0,7,20,20
1745824830820,MCWP 50,A00,893758,Morshed; Michael James,2,0,20,18
1745824830820,MCWP 50,B00,893761,Bartulis; Jason Michael,18,0,20,2
1745824831850,MCWP 50R,A00,893766,Compas; Sean Matthew,0,1,20,20
1745824831850,MCWP 50R,B00,893769,Carter; Jennifer A,0,0,20,20
1745824831850,MCWP 50R,C00,893771,Krone; Jarret,0,3,20,20
1745824831850,MCWP 50R,D00,893772,Miller; Elizabeth Deen,3,0,20,17
1745824831850,MCWP 50R,E00,893775,Carter; Andrea L,0,0,20,20
1745824832875,MMW 11R,A01,892721,Herbst; Matthew,11,0,27,16
1745824832875,MMW 11R,A02,892722,Herbst; Matthew,0,0,0,3
1745824833904,MMW 12R,A01,892724,Herbst; Matthew,0,10,16,16
1745824833904,MMW 12R,A02,892725,Herbst; Matthew,0,9,16,16
1745824834935,MMW 13R,A01,892727,Staff,0,3,16,16
1745824834935,MMW 13R,A02,892728,Staff,0,4,16,16
1745824834935,MMW 13R,A03,958032,Staff,0,3,16,16
1745824834935,MMW 13R,A04,958033,Staff,0,2,16,16
1745824834935,MMW 13R,A05,958034,Staff,0,3,16,16
1745824835960,SIO 295LS,A00,894015,Staff,7,0,25,18
1745824836987,SIO 295S,A00,894020,Staff,7,0,25,18
1745824838014,SIOC 290S,B01,958918,Staff,0,0,0,0
1745824839044,SIOC 291S,B01,958922,Staff,0,0,0,0
1745824840069,SOCI 117,A01,895339,Staff,4,0,5,1
1745824841103,WES 237B,A00,894149,Staff,11,0,20,9
1745824843162,AESE 279B,A00,891859,Staff,13,0,35,22
1745824844190,AIP 197,001,891854,Staff,70,0,70,0
1745824845217,ANTH 289S,A00,891856,Gagneux; Pascal,12,0,12,0
1745824846245,BENG 196,001,957946,Engler; Adam J.,9996,0,9999,3
1745824847273,CAT 124RS,A01,956906,Staff,8,0,25,17
1745824848303,CAT 125RS,A01,922013,Staff,8,0,25,17
1745824849331,CLRE 250,A00,891860,Morris; Sheldon,9995,0,9999,4
1745824851389,CLRE 251R,A00,907817,Mehta; Ravindra L.,9994,0,9999,5
1745824852413,CLRE 252,A00,891864,Cuomo; Raphael Eduardo,9993,0,9999,6
1745824853439,CLRE 253,A00,891867,Vaida; Florin,9994,0,9999,5
1745824853439,CLRE 253,B00,907819,Staff,9999,0,9999,0
1745824854468,CLRE 259,A00,891868,Patel; Hemal,9998,0,9999,1
1745824855495,CLRE 260,A00,891872,Cuomo; Raphael Eduardo,9999,0,9999,0
1745824856523,CLRE 297,001,891888,Cuomo; Raphael Eduardo,9999,0,9999,0
1745824857549,CSE 191,A00,958773,Minnes Kemp; Mor Mia,9999,0,9999,0
1745824858579,CSS 201S,A01,892054,Mignozzetti; Umberto,30,0,30,0
1745824859607,CSS 202S,A01,892056,Mignozzetti; Umberto,30,0,30,0
1745824860632,DSC 197,001,956898,Eldridge; Justin Matthew,9998,0,9999,1
1745824861662,DSC 297,001,958000,Mazumdar; Arya,9998,0,9999,1
1745824862688,EAP 100,A00,905686,Staff,9776,0,9999,223
1745824863716,ECE 45,A01,892618,Staff,0,13,50,50
1745824864744,ECE 109,A01,892620,Staff,0,43,0,0
1745824865777,ECE 111,A01,892719,Staff,0,9,50,50
1745824866805,ECE 197,001,957920,Mercier; Patrick Philip,9992,0,9999,7
1745824867837,ECON 178,A01,907814,Zhu; Ying,28,0,35,7
1745824868871,EDS 115,A00,895312,Staff,41,0,45,4
1745824869898,EDS 117,A01,895337,Staff,30,0,30,0
1745824870927,EDS 125,A00,895341,Jones; Gabrielle Anastasia,43,0,45,2
1745824871957,EDS 128A,A01,895459,Fargason; Sharon Gayle,44,0,45,1
1745824872986,EDS 128B,A01,895543,Pappas; Elizabeth,44,0,45,1
1745824874017,EDS 139,A00,897203,Pappas; Elizabeth,44,0,45,1
1745824874017,EDS 139,B00,897209,Fargason; Sharon Gayle,44,0,45,1
1745824875046,EDS 201,A00,895545,Staff,43,0,45,2
1745824876071,EDS 203,A01,895581,Halter; Christopher P.,43,0,45,2
1745824877102,EDS 204R,A01,895625,Heinzman; Erica M.,43,0,45,2
1745824877102,EDS 204R,B01,895693,Halter; Christopher P.,18,0,45,27
1745824878135,EDS 206R,A00,895694,Fargason; Sharon Gayle,9,0,30,21
1745824878135,EDS 206R,B00,895695,Choi; Bailey Miyeon,20,0,30,10
1745824879164,EDS 250,A00,895697,Hemans; Patricia Ann Benitez,43,0,45,2
1745824880196,EDS 281,A00,895701,Meyerott; Theresa Ann,15,0,15,0
1745824881225,EDS 284,A00,895736,Meyerott; Theresa Ann,15,0,15,0
1745824882251,EDS 286,A00,897210,Fine; Sarah,15,0,15,0
1745824883286,EDS 289C,A01,895770,Daly; Alan J.,15,0,15,0
1745824884315,EDS 290,A00,897211,Hofstetter; Carolyn,15,0,15,0
1745824885346,LIGM 5A,A00,896162,Fischer-Grunski; Eva K,15,0,20,5
1745824886380,LIGM 5B,A00,896260,Fischer-Grunski; Eva K,17,0,20,3
1745824887410,LIGM 5C,A00,896308,Fischer-Grunski; Eva K,18,0,20,2
1745824888437,LIIT 5AS,A00,896313,Carnelos; Chiara,17,0,20,3
1745824889466,LIIT 5BS,A00,896416,Carnelos; Chiara,20,0,20,0
1745824890499,LIIT 5CS,A00,896564,Carnelos; Chiara,20,0,20,0
1745824891529,LISP 5A,A00,896588,Munoz Sanchez; Alicia,4,0,20,16
1745824892561,LISP 5B,A00,896653,Munoz Sanchez; Alicia,10,0,20,10
1745824893592,LISP 5C,A00,896655,Munoz Sanchez; Alicia,4,0,20,16
1745824894621,MAE 197,001,957918,Kleissl; Jan,9998,0,9999,1
1745824895647,MATH 2,A01,957937,Staff,34,0,35,1
1745824896677,MATH 197,001,957876,Kedlaya; Kiran S.,9993,0,9999,6
1745824897706,MCWP 40,A00,892729,Duru; Nur,13,0,20,7
1745824897706,MCWP 40,B00,893304,Montejo; Carolina,20,0,20,0
1745824898734,MCWP 40R,A00,893757,Redela; Pamela Morgan,0,7,20,20
1745824899767,MCWP 50,A00,893758,Morshed; Michael James,2,0,20,18
1745824899767,MCWP 50,B00,893761,Bartulis; Jason Michael,18,0,20,2
1745824900797,MCWP 50R,A00,893766,Compas; Sean Matthew,0,1,20,20
1745824900797,MCWP 50R,B00,893769,Carter; Jennifer A,0,0,20,20
1745824900797,MCWP 50R,C00,893771,Krone; Jarret,0,3,20,20
1745824900797,MCWP 50R,D00,893772,Miller; Elizabeth Deen,3,0,20,17
1745824900797,MCWP 50R,E00,893775,Carter; Andrea L,0,0,20,20
1745824901832,MMW 11R,A01,892721,Herbst; Matthew,11,0,27,16
1745824901832,MMW 11R,A02,892722,Herbst; Matthew,0,0,0,3
1745824902862,MMW 12R,A01,892724,Herbst; Matthew,0,10,16,16
1745824902862,MMW 12R,A02,892725,Herbst; Matthew,0,9,16,16
1745824903899,MMW 13R,A01,892727,Staff,0,3,16,16
1745824903899,MMW 13R,A02,892728,Staff,0,4,16,16
1745824903899,MMW 13R,A03,958032,Staff,0,3,16,16
1745824903899,MMW 13R,A04,958033,Staff,0,2,16,16
1745824903899,MMW 13R,A05,958034,Staff,0,3,16,16
1745824904929,SIO 295LS,A00,894015,Staff,7,0,25,18
1745824905958,SIO 295S,A00,894020,Staff,7,0,25,18
1745824906988,SIOC 290S,B01,958918,Staff,0,0,0,0
1745824908019,SIOC 291S,B01,958922,Staff,0,0,0,0
1745824909049,SOCI 117,A01,895339,Staff,4,0,5,1
1745824910076,WES 237B,A00,894149,Staff,11,0,20,9
1745824912160,AESE 279B,A00,891859,Staff,13,0,35,22
1745824913189,AIP 197,001,891854,Staff,70,0,70,0
1745824914217,ANTH 289S,A00,891856,Gagneux; Pascal,12,0,12,0
1745824915246,BENG 196,001,957946,Engler; Adam J.,9996,0,9999,3
1745824916273,CAT 124RS,A01,956906,Staff,8,0,25,17
1745824917300,CAT 125RS,A01,922013,Staff,8,0,25,17
1745824918326,CLRE 250,A00,891860,Morris; Sheldon,9995,0,9999,4
1745824920379,CLRE 251R,A00,907817,Mehta; Ravindra L.,9994,0,9999,5
1745824921406,CLRE 252,A00,891864,Cuomo; Raphael Eduardo,9993,0,9999,6
1745824922437,CLRE 253,A00,891867,Vaida; Florin,9994,0,9999,5
1745824922437,CLRE 253,B00,907819,Staff,9999,0,9999,0
1745824923465,CLRE 259,A00,891868,Patel; Hemal,9998,0,9999,1
1745824924494,CLRE 260,A00,891872,Cuomo; Raphael Eduardo,9999,0,9999,0
1745824925523,CLRE 297,001,891888,Cuomo; Raphael Eduardo,9999,0,9999,0
1745824926551,CSE 191,A00,958773,Minnes Kemp; Mor Mia,9999,0,9999,0
1745824927580,CSS 201S,A01,892054,Mignozzetti; Umberto,30,0,30,0
1745824928608,CSS 202S,A01,892056,Mignozzetti; Umberto,30,0,30,0
1745824929639,DSC 197,001,956898,Eldridge; Justin Matthew,9998,0,9999,1
1745824930668,DSC 297,001,958000,Mazumdar; Arya,9998,0,9999,1
1745824931695,EAP 100,A00,905686,Staff,9776,0,9999,223
1745824932722,ECE 45,A01,892618,Staff,0,13,50,50
1745824933748,ECE 109,A01,892620,Staff,0,43,0,0
1745824934776,ECE 111,A01,892719,Staff,0,9,50,50
1745824935805,ECE 197,001,957920,Mercier; Patrick Philip,9992,0,9999,7
1745824936834,ECON 178,A01,907814,Zhu; Ying,28,0,35,7
1745824937860,EDS 115,A00,895312,Staff,41,0,45,4
1745824938886,EDS 117,A01,895337,Staff,30,0,30,0
1745824939917,EDS 125,A00,895341,Jones; Gabrielle Anastasia,43,0,45,2
1745824940947,EDS 128A,A01,895459,Fargason; Sharon Gayle,44,0,45,1
1745824941976,EDS 128B,A01,895543,Pappas; Elizabeth,44,0,45,1
1745824943000,EDS 139,A00,897203,Pappas; Elizabeth,44,0,45,1
1745824943000,EDS 139,B00,897209,Fargason; Sharon Gayle,44,0,45,1
1745824944027,EDS 201,A00,895545,Staff,43,0,45,2
1745824945052,EDS 203,A01,895581,Halter; Christopher P.,43,0,45,2
1745824946082,EDS 204R,A01,895625,Heinzman; Erica M.,43,0,45,2
1745824946082,EDS 204R,B01,895693,Halter; Christopher P.,18,0,45,27
1745824947110,EDS 206R,A00,895694,Fargason; Sharon Gayle,9,0,30,21
1745824947110,EDS 206R,B00,895695,Choi; Bailey Miyeon,20,0,30,10
1745824948138,EDS 250,A00,895697,Hemans; Patricia Ann Benitez,43,0,45,2
1745824949162,EDS 281,A00,895701,Meyerott; Theresa Ann,15,0,15,0
1745824950189,EDS 284,A00,895736,Meyerott; Theresa Ann,15,0,15,0
1745824951218,EDS 286,A00,897210,Fine; Sarah,15,0,15,0
1745824952250,EDS 289C,A01,895770,Daly; Alan J.,15,0,15,0
1745824953277,EDS 290,A00,897211,Hofstetter; Carolyn,15,0,15,0
1745824954304,LIGM 5A,A00,896162,Fischer-Grunski; Eva K,15,0,20,5
1745824955335,LIGM 5B,A00,896260,Fischer-Grunski; Eva K,17,0,20,3
1745824956360,LIGM 5C,A00,896308,Fischer-Grunski; Eva K,18,0,20,2
1745824957384,LIIT 5AS,A00,896313,Carnelos; Chiara,17,0,20,3
1745824958410,LIIT 5BS,A00,896416,Carnelos; Chiara,20,0,20,0
1745824959439,LIIT 5CS,A00,896564,Carnelos; Chiara,20,0,20,0
1745824960470,LISP 5A,A00,896588,Munoz Sanchez; Alicia,4,0,20,16
1745824961500,LISP 5B,A00,896653,Munoz Sanchez; Alicia,10,0,20,10
1745824962528,LISP 5C,A00,896655,Munoz Sanchez; Alicia,4,0,20,16
1745824963561,MAE 197,001,957918,Kleissl; Jan,9998,0,9999,1
1745824964590,MATH 2,A01,957937,Staff,34,0,35,1
1745824965619,MATH 197,001,957876,Kedlaya; Kiran S.,9993,0,9999,6
1745824966645,MCWP 40,A00,892729,Duru; Nur,13,0,20,7
1745824966645,MCWP 40,B00,893304,Montejo; Carolina,20,0,20,0
1745824967675,MCWP 40R,A00,893757,Redela; Pamela Morgan,0,7,20,20
1745824968703,MCWP 50,A00,893758,Morshed; Michael James,2,0,20,18
1745824968703,MCWP 50,B00,893761,Bartulis; Jason Michael,18,0,20,2
1745824969731,MCWP 50R,A00,893766,Compas; Sean Matthew,0,1,20,20
1745824969731,MCWP 50R,B00,893769,Carter; Jennifer A,0,0,20,20
1745824969731,MCWP 50R,C00,893771,Krone; Jarret,0,3,20,20
1745824969731,MCWP 50R,D00,893772,Miller; Elizabeth Deen,3,0,20,17
1745824969731,MCWP 50R,E00,893775,Carter; Andrea L,0,0,20,20
1745824970758,MMW 11R,A01,892721,Herbst; Matthew,11,0,27,16
1745824970758,MMW 11R,A02,892722,Herbst; Matthew,0,0,0,3
1745824971784,MMW 12R,A01,892724,Herbst; Matthew,0,10,16,16
1745824971784,MMW 12R,A02,892725,Herbst; Matthew,0,9,16,16
1745824972811,MMW 13R,A01,892727,Staff,0,3,16,16
1745824972811,MMW 13R,A02,892728,Staff,0,4,16,16
1745824972811,MMW 13R,A03,958032,Staff,0,3,16,16
1745824972811,MMW 13R,A04,958033,Staff,0,2,16,16
1745824972811,MMW 13R,A05,958034,Staff,0,3,16,16
1745824973839,SIO 295LS,A00,894015,Staff,7,0,25,18
1745824974865,SIO 295S,A00,894020,Staff,7,0,25,18
1745824975895,SIOC 290S,B01,958918,Staff,0,0,0,0
1745824976924,SIOC 291S,B01,958922,Staff,0,0,0,0
1745824977952,SOCI 117,A01,895339,Staff,4,0,5,1
1745824978978,WES 237B,A00,894149,Staff,11,0,20,9
1745824981052,AESE 279B,A00,891859,Staff,13,0,35,22
1745824982079,AIP 197,001,891854,Staff,70,0,70,0
1745824983106,ANTH 289S,A00,891856,Gagneux; Pascal,12,0,12,0
1745824984132,BENG 196,001,957946,Engler; Adam J.,9996,0,9999,3
1745824985161,CAT 124RS,A01,956906,Staff,8,0,25,17
1745824986190,CAT 125RS,A01,922013,Staff,8,0,25,17
1745824987217,CLRE 250,A00,891860,Morris; Sheldon,9995,0,9999,4
1745824989270,CLRE 251R,A00,907817,Mehta; Ravindra L.,9994,0,9999,5
1745824990296,CLRE 252,A00,891864,Cuomo; Raphael Eduardo,9993,0,9999,6
1745824991321,CLRE 253,A00,891867,Vaida; Florin,9994,0,9999,5
1745824991321,CLRE 253,B00,907819,Staff,9999,0,9999,0
1745824992350,CLRE 259,A00,891868,Patel; Hemal,9998,0,9999,1
1745824993376,CLRE 260,A00,891872,Cuomo; Raphael Eduardo,9999,0,9999,0
1745824994402,CLRE 297,001,891888,Cuomo; Raphael Eduardo,9999,0,9999,0
1745824995428,CSE 191,A00,958773,Minnes Kemp; Mor Mia,9999,0,9999,0
1745824996458,CSS 201S,A01,892054,Mignozzetti; Umberto,30,0,30,0
1745824997489,CSS 202S,A01,892056,Mignozzetti; Umberto,30,0,30,0
1745824998517,DSC 197,001,956898,Eldridge; Justin Matthew,9998,0,9999,1
1745824999541,DSC 297,001,958000,Mazumdar; Arya,9998,0,9999,1
1745825000568,EAP 100,A00,905686,Staff,9776,0,9999,223
1745825001597,ECE 45,A01,892618,Staff,0,13,50,50
1745825002625,ECE 109,A01,892620,Staff,0,43,0,0
1745825003656,ECE 111,A01,892719,Staff,0,9,50,50
1745825004683,ECE 197,001,957920,Mercier; Patrick Philip,9992,0,9999,7
1745825005709,ECON 178,A01,907814,Zhu; Ying,28,0,35,7
1745825006734,EDS 115,A00,895312,Staff,41,0,45,4
1745825007760,EDS 117,A01,895337,Staff,30,0,30,0
1745825008789,EDS 125,A00,895341,Jones; Gabrielle Anastasia,43,0,45,2
1745825009814,EDS 128A,A01,895459,Fargason; Sharon Gayle,44,0,45,1
1745825010845,EDS 128B,A01,895543,Pappas; Elizabeth,44,0,45,1
1745825011871,EDS 139,A00,897203,Pappas; Elizabeth,44,0,45,1
1745825011871,EDS 139,B00,897209,Fargason; Sharon Gayle,44,0,45,1
1745825012899,EDS 201,A00,895545,Staff,43,0,45,2
1745825013924,EDS 203,A01,895581,Halter; Christopher P.,43,0,45,2
1745825014950,EDS 204R,A01,895625,Heinzman; Erica M.,43,0,45,2
1745825014950,EDS 204R,B01,895693,Halter; Christopher P.,18,0,45,27
1745825015978,EDS 206R,A00,895694,Fargason; Sharon Gayle,9,0,30,21
1745825015978,EDS 206R,B00,895695,Choi; Bailey Miyeon,20,0,30,10
1745825017003,EDS 250,A00,895697,Hemans; Patricia Ann Benitez,43,0,45,2
1745825018029,EDS 281,A00,895701,Meyerott; Theresa Ann,15,0,15,0
1745825019055,EDS 284,A00,895736,Meyerott; Theresa Ann,15,0,15,0
1745825020084,EDS 286,A00,897210,Fine; Sarah,15,0,15,0
1745825021115,EDS 289C,A01,895770,Daly; Alan J.,15,0,15,0
1745825022147,EDS 290,A00,897211,Hofstetter; Carolyn,15,0,15,0
1745825023178,LIGM 5A,A00,896162,Fischer-Grunski; Eva K,15,0,20,5
1745825024208,LIGM 5B,A00,896260,Fischer-Grunski; Eva K,17,0,20,3
1745825025236,LIGM 5C,A00,896308,Fischer-Grunski; Eva K,18,0,20,2
1745825026261,LIIT 5AS,A00,896313,Carnelos; Chiara,17,0,20,3
1745825027289,LIIT 5BS,A00,896416,Carnelos; Chiara,20,0,20,0
1745825028317,LIIT 5CS,A00,896564,Carnelos; Chiara,20,0,20,0
1745825029347,LISP 5A,A00,896588,Munoz Sanchez; Alicia,4,0,20,16
1745825030376,LISP 5B,A00,896653,Munoz Sanchez; Alicia,10,0,20,10
1745825031407,LISP 5C,A00,896655,Munoz Sanchez; Alicia,4,0,20,16
1745825032435,MAE 197,001,957918,Kleissl; Jan,9998,0,9999,1
1745825033464,MATH 2,A01,957937,Staff,34,0,35,1
1745825034493,MATH 197,001,957876,Kedlaya; Kiran S.,9993,0,9999,6
1745825035519,MCWP 40,A00,892729,Duru; Nur,13,0,20,7
1745825035519,MCWP 40,B00,893304,Montejo; Carolina,20,0,20,0
1745825036548,MCWP 40R,A00,893757,Redela; Pamela Morgan,0,7,20,20
1745825037574,MCWP 50,A00,893758,Morshed; Michael James,2,0,20,18
1745825037574,MCWP 50,B00,893761,Bartulis; Jason Michael,18,0,20,2
1745825038602,MCWP 50R,A00,893766,Compas; Sean Matthew,0,1,20,20
1745825038602,MCWP 50R,B00,893769,Carter; Jennifer A,0,0,20,20
1745825038602,MCWP 50R,C00,893771,Krone; Jarret,0,3,20,20
1745825038602,MCWP 50R,D00,893772,Miller; Elizabeth Deen,3,0,20,17
1745825038602,MCWP 50R,E00,893775,Carter; Andrea L,0,0,20,20
1745825039627,MMW 11R,A01,892721,Herbst; Matthew,11,0,27,16
1745825039627,MMW 11R,A02,892722,Herbst; Matthew,0,0,0,3
1745825040656,MMW 12R,A01,892724,Herbst; Matthew,0,10,16,16
1745825040656,MMW 12R,A02,892725,Herbst; Matthew,0,9,16,16
1745825041683,MMW 13R,A01,892727,Staff,0,3,16,16
1745825041683,MMW 13R,A02,892728,Staff,0,4,16,16
1745825041683,MMW 13R,A03,958032,Staff,0,3,16,16
1745825041683,MMW 13R,A04,958033,Staff,0,2,16,16
1745825041683,MMW 13R,A05,958034,Staff,0,3,16,16
1745825042709,SIO 295LS,A00,894015,Staff,7,0,25,18
1745825043736,SIO 295S,A00,894020,Staff,7,0,25,18
1745825044762,SIOC 290S,B01,958918,Staff,0,0,0,0
1745825045793,SIOC 291S,B01,958922,Staff,0,0,0,0
1745825046818,SOCI 117,A01,895339,Staff,4,0,5,1
1745825047845,WES 237B,A00,894149,Staff,11,0,20,9
1745825049911,AESE 279B,A00,891859,Staff,13,0,35,22
1745825050936,AIP 197,001,891854,Staff,70,0,70,0
1745825051962,ANTH 289S,A00,891856,Gagneux; Pascal,12,0,12,0
1745825052990,BENG 196,001,957946,Engler; Adam J.,9996,0,9999,3
1745825054020,CAT 124RS,A01,956906,Staff,8,0,25,17
1745825055046,CAT 125RS,A01,922013,Staff,8,0,25,17
1745825056071,CLRE 250,A00,891860,Morris; Sheldon,9995,0,9999,4
1745825058124,CLRE 251R,A00,907817,Mehta; Ravindra L.,9994,0,9999,5
1745825059150,CLRE 252,A00,891864,Cuomo; Raphael Eduardo,9993,0,9999,6
1745825060180,CLRE 253,A00,891867,Vaida; Florin,9994,0,9999,5
1745825060180,CLRE 253,B00,907819,Staff,9999,0,9999,0
1745825061209,CLRE 259,A00,891868,Patel; Hemal,9998,0,9999,1
1745825062235,CLRE 260,A00,891872,Cuomo; Raphael Eduardo,9999,0,9999,0
1745825063261,CLRE 297,001,891888,Cuomo; Raphael Eduardo,9999,0,9999,0
1745825064290,CSE 191,A00,958773,Minnes Kemp; Mor Mia,9999,0,9999,0
1745825065319,CSS 201S,A01,892054,Mignozzetti; Umberto,30,0,30,0
1745825066350,CSS 202S,A01,892056,Mignozzetti; Umberto,30,0,30,0
1745825067378,DSC 197,001,956898,Eldridge; Justin Matthew,9998,0,9999,1
1745825068404,DSC 297,001,958000,Mazumdar; Arya,9998,0,9999,1
1745825069432,EAP 100,A00,905686,Staff,9776,0,9999,223
1745825070462,ECE 45,A01,892618,Staff,0,13,50,50
1745825071488,ECE 109,A01,892620,Staff,0,43,0,0
1745825072519,ECE 111,A01,892719,Staff,0,9,50,50
1745825073550,ECE 197,001,957920,Mercier; Patrick Philip,9992,0,9999,7
1745825074580,ECON 178,A01,907814,Zhu; Ying,28,0,35,7
1745825075608,EDS 115,A00,895312,Staff,41,0,45,4
1745825076637,EDS 117,A01,895337,Staff,30,0,30,0
1745825077666,EDS 125,A00,895341,Jones; Gabrielle Anastasia,43,0,45,2
1745825078698,EDS 128A,A01,895459,Fargason; Sharon Gayle,44,0,45,1
1745825079728,EDS 128B,A01,895543,Pappas; Elizabeth,44,0,45,1
1745825080758,EDS 139,A00,897203,Pappas; Elizabeth,44,0,45,1
1745825080758,EDS 139,B00,897209,Fargason; Sharon Gayle,44,0,45,1
1745825081791,EDS 201,A00,895545,Staff,43,0,45,2
1745825082818,EDS 203,A01,895581,Halter; Christopher P.,43,0,45,2
1745825083846,EDS 204R,A01,895625,Heinzman; Erica M.,43,0,45,2
1745825083846,EDS 204R,B01,895693,Halter; Christopher P.,18,0,45,27
1745825084875,EDS 206R,A00,895694,Fargason; Sharon Gayle,9,0,30,21
1745825084875,EDS 206R,B00,895695,Choi; Bailey Miyeon,20,0,30,10
1745825085903,EDS 250,A00,895697,Hemans; Patricia Ann Benitez,43,0,45,2
1745825086935,EDS 281,A00,895701,Meyerott; Theresa Ann,15,0,15,0
1745825087966,EDS 284,A00,895736,Meyerott; Theresa Ann,15,0,15,0
1745825088994,EDS 286,A00,897210,Fine; Sarah,15,0,15,0
1745825090026,EDS 289C,A01,895770,Daly; Alan J.,15,0,15,0
1745825091052,EDS 290,A00,897211,Hofstetter; Carolyn,15,0,15,0
1745825092083,LIGM 5A,A00,896162,Fischer-Grunski; Eva K,15,0,20,5
1745825093113,LIGM 5B,A00,896260,Fischer-Grunski; Eva K,17,0,20,3
1745825094145,LIGM 5C,A00,896308,Fischer-Grunski; Eva K,18,0,20,2
1745825095175,LIIT 5AS,A00,896313,Carnelos; Chiara,17,0,20,3
1745825096205,LIIT 5BS,A00,896416,Carnelos; Chiara,20,0,20,0
1745825097234,LIIT 5CS,A00,896564,Carnelos; Chiara,20,0,20,0
1745825098262,LISP 5A,A00,896588,Munoz Sanchez; Alicia,4,0,20,16
1745825099291,LISP 5B,A00,896653,Munoz Sanchez; Alicia,10,0,20,10
1745825100317,LISP 5C,A00,896655,Munoz Sanchez; Alicia,4,0,20,16
1745825101344,MAE 197,001,957918,Kleissl; Jan,9998,0,9999,1
1745825102381,MATH 2,A01,957937,Staff,34,0,35,1
1745825103411,MATH 197,001,957876,Kedlaya; Kiran S.,9993,0,9999,6
1745825104441,MCWP 40,A00,892729,Duru; Nur,13,0,20,7
1745825104441,MCWP 40,B00,893304,Montejo; Carolina,20,0,20,0
1745825105469,MCWP 40R,A00,893757,Redela; Pamela Morgan,0,7,20,20
1745825106496,MCWP 50,A00,893758,Morshed; Michael James,2,0,20,18
1745825106496,MCWP 50,B00,893761,Bartulis; Jason Michael,18,0,20,2
1745825107526,MCWP 50R,A00,893766,Compas; Sean Matthew,0,1,20,20
1745825107526,MCWP 50R,B00,893769,Carter; Jennifer A,0,0,20,20
1745825107526,MCWP 50R,C00,893771,Krone; Jarret,0,3,20,20
1745825107526,MCWP 50R,D00,893772,Miller; Elizabeth Deen,3,0,20,17
1745825107526,MCWP 50R,E00,893775,Carter; Andrea L,0,0,20,20
1745825108551,MMW 11R,A01,892721,Herbst; Matthew,11,0,27,16
1745825108551,MMW 11R,A02,892722,Herbst; Matthew,0,0,0,3
1745825109578,MMW 12R,A01,892724,Herbst; Matthew,0,10,16,16
1745825109578,MMW 12R,A02,892725,Herbst; Matthew,0,9,16,16
1745825110604,MMW 13R,A01,892727,Staff,0,3,16,16
1745825110604,MMW 13R,A02,892728,Staff,0,4,16,16
1745825110604,MMW 13R,A03,958032,Staff,0,3,16,16
1745825110604,MMW 13R,A04,958033,Staff,0,2,16,16
1745825110604,MMW 13R,A05,958034,Staff,0,3,16,16
1745825111632,SIO 295LS,A00,894015,Staff,7,0,25,18
1745825112661,SIO 295S,A00,894020,Staff,7,0,25,18
1745825113687,SIOC 290S,B01,958918,Staff,0,0,0,0
1745825114713,SIOC 291S,B01,958922,Staff,0,0,0,0
1745825115741,SOCI 117,A01,895339,Staff,4,0,5,1
1745825116769,WES 237B,A00,894149,Staff,11,0,20,9
1745825118828,AESE 279B,A00,891859,Staff,13,0,35,22
1745825119857,AIP 197,001,891854,Staff,70,0,70,0
1745825120882,ANTH 289S,A00,891856,Gagneux; Pascal,12,0,12,0
1745825121910,BENG 196,001,957946,Engler; Adam J.,9996,0,9999,3
1745825122936,CAT 124RS,A01,956906,Staff,8,0,25,17
1745825123963,CAT 125RS,A01,922013,Staff,8,0,25,17
1745825124996,CLRE 250,A00,891860,Morris; Sheldon,9995,0,9999,4
1745825127050,CLRE 251R,A00,907817,Mehta; Ravindra L.,9994,0,9999,5
1745825128086,CLRE 252,A00,891864,Cuomo; Raphael Eduardo,9993,0,9999,6
1745825129112,CLRE 253,A00,891867,Vaida; Florin,9994,0,9999,5
1745825129112,CLRE 253,B00,907819,Staff,9999,0,9999,0
1745825130141,CLRE 259,A00,891868,Patel; Hemal,9998,0,9999,1
1745825131164,CLRE 260,A00,891872,Cuomo; Raphael Eduardo,9999,0,9999,0
1745825132191,CLRE 297,001,891888,Cuomo; Raphael Eduardo,9999,0,9999,0
1745825133218,CSE 191,A00,958773,Minnes Kemp; Mor Mia,9999,0,9999,0
1745825134250,CSS 201S,A01,892054,Mignozzetti; Umberto,30,0,30,0
1745825135277,CSS 202S,A01,892056,Mignozzetti; Umberto,30,0,30,0
1745825136306,DSC 197,001,956898,Eldridge; Justin Matthew,9998,0,9999,1
1745825137334,DSC 297,001,958000,Mazumdar; Arya,9998,0,9999,1
1745825138361,EAP 100,A00,905686,Staff,9776,0,9999,223
1745825139387,ECE 45,A01,892618,Staff,0,13,50,50
1745825140416,ECE 109,A01,892620,Staff,0,43,0,0
1745825141442,ECE 111,A01,892719,Staff,0,9,50,50
1745825142471,ECE 197,001,957920,Mercier; Patrick Philip,9992,0,9999,7
1745825143499,ECON 178,A01,907814,Zhu; Ying,28,0,35,7
1745825144526,EDS 115,A00,895312,Staff,41,0,45,4
1745825145553,EDS 117,A01,895337,Staff,30,0,30,0
1745825146579,EDS 125,A00,895341,Jones; Gabrielle Anastasia,43,0,45,2
1745825147605,EDS 128A,A01,895459,Fargason; Sharon Gayle,44,0,45,1
1745825148631,EDS 128B,A01,895543,Pappas; Elizabeth,44,0,45,1
1745825149658,EDS 139,A00,897203,Pappas; Elizabeth,44,0,45,1
1745825149658,EDS 139,B00,897209,Fargason; Sharon Gayle,44,0,45,1
1745825150685,EDS 201,A00,895545,Staff,43,0,45,2
1745825151713,EDS 203,A01,895581,Halter; Christopher P.,43,0,45,2
1745825152737,EDS 204R,A01,895625,Heinzman; Erica M.,43,0,45,2
1745825152737,EDS 204R,B01,895693,Halter; Christopher P.,18,0,45,27
1745825153763,EDS 206R,A00,895694,Fargason; Sharon Gayle,9,0,30,21
1745825153763,EDS 206R,B00,895695,Choi; Bailey Miyeon,20,0,30,10
1745825154792,EDS 250,A00,895697,Hemans; Patricia Ann Benitez,43,0,45,2
1745825155821,EDS 281,A00,895701,Meyerott; Theresa Ann,15,0,15,0
1745825156850,EDS 284,A00,895736,Meyerott; Theresa Ann,15,0,15,0
1745825157875,EDS 286,A00,897210,Fine; Sarah,15,0,15,0
1745825158904,EDS 289C,A01,895770,Daly; Alan J.,15,0,15,0
1745825159932,EDS 290,A00,897211,Hofstetter; Carolyn,15,0,15,0
1745825160962,LIGM 5A,A00,896162,Fischer-Grunski; Eva K,15,0,20,5
1745825161995,LIGM 5B,A00,896260,Fischer-Grunski; Eva K,17,0,20,3
1745825163020,LIGM 5C,A00,896308,Fischer-Grunski; Eva K,18,0,20,2
1745825164051,LIIT 5AS,A00,896313,Carnelos; Chiara,17,0,20,3
1745825165080,LIIT 5BS,A00,896416,Carnelos; Chiara,20,0,20,0
1745825166105,LIIT 5CS,A00,896564,Carnelos; Chiara,20,0,20,0
1745825167131,LISP 5A,A00,896588,Munoz Sanchez; Alicia,4,0,20,16
1745825168161,LISP 5B,A00,896653,Munoz Sanchez; Alicia,10,0,20,10
1745825169193,LISP 5C,A00,896655,Munoz Sanchez; Alicia,4,0,20,16
1745825170221,MAE 197,001,957918,Kleissl; Jan,9998,0,9999,1
1745825171250,MATH 2,A01,957937,Staff,34,0,35,1
1745825172278,MATH 197,001,957876,Kedlaya; Kiran S.,9993,0,9999,6
1745825173312,MCWP 40,A00,892729,Duru; Nur,13,0,20,7
1745825173312,MCWP 40,B00,893304,Montejo; Carolina,20,0,20,0
1745825174344,MCWP 40R,A00,893757,Redela; Pamela Morgan,0,7,20,20
1745825175438,MCWP 50,A00,893758,Morshed; Michael James,2,0,20,18
1745825175438,MCWP 50,B00,893761,Bartulis; Jason Michael,18,0,20,2
1745825176472,MCWP 50R,A00,893766,Compas; Sean Matthew,0,1,20,20
1745825176472,MCWP 50R,B00,893769,Carter; Jennifer A,0,0,20,20
1745825176472,MCWP 50R,C00,893771,Krone; Jarret,0,3,20,20
1745825176472,MCWP 50R,D00,893772,Miller; Elizabeth Deen,3,0,20,17
1745825176472,MCWP 50R,E00,893775,Carter; Andrea L,0,0,20,20
1745825177499,MMW 11R,A01,892721,Herbst; Matthew,11,0,27,16
1745825177499,MMW 11R,A02,892722,Herbst; Matthew,0,0,0,3
1745825178528,MMW 12R,A01,892724,Herbst; Matthew,0,10,16,16
1745825178528,MMW 12R,A02,892725,Herbst; Matthew,0,9,16,16
1745825179560,MMW 13R,A01,892727,Staff,0,3,16,16
1745825179560,MMW 13R,A02,892728,Staff,0,4,16,16
1745825179560,MMW 13R,A03,958032,Staff,0,3,16,16
1745825179560,MMW 13R,A04,958033,Staff,0,2,16,16
1745825179560,MMW 13R,A05,958034,Staff,0,3,16,16
1745825180588,SIO 295LS,A00,894015,Staff,7,0,25,18
1745825181624,SIO 295S,A00,894020,Staff,7,0,25,18
1745825182654,SIOC 290S,B01,958918,Staff,0,0,0,0
1745825183689,SIOC 291S,B01,958922,Staff,0,0,0,0
1745825184725,SOCI 117,A01,895339,Staff,4,0,5,1
1745825185754,WES 237B,A00,894149,Staff,11,0,20,9
1745825187852,AESE 279B,A00,891859,Staff,13,0,35,22
1745825188882,AIP 197,001,891854,Staff,70,0,70,0
1745825189913,ANTH 289S,A00,891856,Gagneux; Pascal,12,0,12,0
1745825190946,BENG 196,001,957946,Engler; Adam J.,9996,0,9999,3
1745825191978,CAT 124RS,A01,956906,Staff,8,0,25,17
1745825193008,CAT 125RS,A01,922013,Staff,8,0,25,17
1745825194037,CLRE 250,A00,891860,Morris; Sheldon,9995,0,9999,4
1745825196102,CLRE 251R,A00,907817,Mehta; Ravindra L.,9994,0,9999,5
1745825197131,CLRE 252,A00,891864,Cuomo; Raphael Eduardo,9993,0,9999,6
1745825198173,CLRE 253,A00,891867,Vaida; Florin,9994,0,9999,5
1745825198173,CLRE 253,B00,907819,Staff,9999,0,9999,0
1745825199206,CLRE 259,A00,891868,Patel; Hemal,9998,0,9999,1
1745825200238,CLRE 260,A00,891872,Cuomo; Raphael Eduardo,9999,0,9999,0
1745825201265,CLRE 297,001,891888,Cuomo; Raphael Eduardo,9999,0,9999,0
1745825202294,CSE 191,A00,958773,Minnes Kemp; Mor Mia,9999,0,9999,0
1745825203324,CSS 201S,A01,892054,Mignozzetti; Umberto,30,0,30,0
1745825204356,CSS 202S,A01,892056,Mignozzetti; Umberto,30,0,30,0
1745825205386,DSC 197,001,956898,Eldridge; Justin Matthew,9998,0,9999,1
1745825206423,DSC 297,001,958000,Mazumdar; Arya,9998,0,9999,1
1745825207452,EAP 100,A00,905686,Staff,9776,0,9999,223
1745825208488,ECE 45,A01,892618,Staff,0,13,50,50
1745825209514,ECE 109,A01,892620,Staff,0,43,0,0
1745825210546,ECE 111,A01,892719,Staff,0,9,50,50
1745825211576,ECE 197,001,957920,Mercier; Patrick Philip,9992,0,9999,7
1745825212606,ECON 178,A01,907814,Zhu; Ying,28,0,35,7
1745825213634,EDS 115,A00,895312,Staff,41,0,45,4
1745825214668,EDS 117,A01,895337,Staff,30,0,30,0
1745825215694,EDS 125,A00,895341,Jones; Gabrielle Anastasia,43,0,45,2
1745825216724,EDS 128A,A01,895459,Fargason; Sharon Gayle,44,0,45,1
1745825217754,EDS 128B,A01,895543,Pappas; Elizabeth,44,0,45,1
1745825218783,EDS 139,A00,897203,Pappas; Elizabeth,44,0,45,1
1745825218783,EDS 139,B00,897209,Fargason; Sharon Gayle,44,0,45,1
1745825219810,EDS 201,A00,895545,Staff,43,0,45,2
1745825220839,EDS 203,A01,895581,Halter; Christopher P.,43,0,45,2
1745825221866,EDS 204R,A01,895625,Heinzman; Erica M.,43,0,45,2
1745825221866,EDS 204R,B01,895693,Halter; Christopher P.,18,0,45,27
1745825222897,EDS 206R,A00,895694,Fargason; Sharon Gayle,9,0,30,21
1745825222897,EDS 206R,B00,895695,Choi; Bailey Miyeon,20,0,30,10
1745825223926,EDS 250,A00,895697,Hemans; Patricia Ann Benitez,43,0,45,2
1745825224953,EDS 281,A00,895701,Meyerott; Theresa Ann,15,0,15,0
1745825225979,EDS 284,A00,895736,Meyerott; Theresa Ann,15,0,15,0
1745825227008,EDS 286,A00,897210,Fine; Sarah,15,0,15,0
1745825228034,EDS 289C,A01,895770,Daly; Alan J.,15,0,15,0
1745825229064,EDS 290,A00,897211,Hofstetter; Carolyn,15,0,15,0
1745825230094,LIGM 5A,A00,896162,Fischer-Grunski; Eva K,15,0,20,5
1745825231123,LIGM 5B,A00,896260,Fischer-Grunski; Eva K,17,0,20,3
1745825232150,LIGM 5C,A00,896308,Fischer-Grunski; Eva K,18,0,20,2
1745825233179,LIIT 5AS,A00,896313,Carnelos; Chiara,17,0,20,3
1745825234218,LIIT 5BS,A00,896416,Carnelos; Chiara,20,0,20,0
1745825235244,LIIT 5CS,A00,896564,Carnelos; Chiara,20,0,20,0
1745825236270,LISP 5A,A00,896588,Munoz Sanchez; Alicia,4,0,20,16
1745825237302,LISP 5B,A00,896653,Munoz Sanchez; Alicia,10,0,20,10
1745825238328,LISP 5C,A00,896655,Munoz Sanchez; Alicia,4,0,20,16
1745825239360,MAE 197,001,957918,Kleissl; Jan,9998,0,9999,1
1745825240389,MATH 2,A01,957937,Staff,34,0,35,1
1745825241415,MATH 197,001,957876,Kedlaya; Kiran S.,9993,0,9999,6
1745825242444,MCWP 40,A00,892729,Duru; Nur,13,0,20,7
1745825242444,MCWP 40,B00,893304,Montejo; Carolina,20,0,20,0
1745825243472,MCWP 40R,A00,893757,Redela; Pamela Morgan,0,7,20,20
1745825244498,MCWP 50,A00,893758,Morshed; Michael James,2,0,20,18
1745825244498,MCWP 50,B00,893761,Bartulis; Jason Michael,18,0,20,2
1745825245528,MCWP 50R,A00,893766,Compas; Sean Matthew,0,1,20,20
1745825245528,MCWP 50R,B00,893769,Carter; Jennifer A,0,0,20,20
1745825245528,MCWP 50R,C00,893771,Krone; Jarret,0,3,20,20
1745825245528,MCWP 50R,D00,893772,Miller; Elizabeth Deen,3,0,20,17
1745825245528,MCWP 50R,E00,893775,Carter; Andrea L,0,0,20,20
1745825246557,MMW 11R,A01,892721,Herbst; Matthew,11,0,27,16
1745825246557,MMW 11R,A02,892722,Herbst; Matthew,0,0,0,3
1745825247582,MMW 12R,A01,892724,Herbst; Matthew,0,10,16,16
1745825247582,MMW 12R,A02,892725,Herbst; Matthew,0,9,16,16
1745825248607,MMW 13R,A01,892727,Staff,0,3,16,16
1745825248607,MMW 13R,A02,892728,Staff,0,4,16,16
1745825248607,MMW 13R,A03,958032,Staff,0,3,16,16
1745825248607,MMW 13R,A04,958033,Staff,0,2,16,16
1745825248607,MMW 13R,A05,958034,Staff,0,3,16,16
1745825249632,SIO 295LS,A00,894015,Staff,7,0,25,18
1745825250657,SIO 295S,A00,894020,Staff,7,0,25,18
1745825251685,SIOC 290S,B01,958918,Staff,0,0,0,0
1745825252710,SIOC 291S,B01,958922,Staff,0,0,0,0
1745825253735,SOCI 117,A01,895339,Staff,4,0,5,1
1745825254765,WES 237B,A00,894149,Staff,11,0,20,9
1745825256837,AESE 279B,A00,891859,Staff,13,0,35,22
1745825257869,AIP 197,001,891854,Staff,70,0,70,0
1745825258899,ANTH 289S,A00,891856,Gagneux; Pascal,12,0,12,0
1745825259924,BENG 196,001,957946,Engler; Adam J.,9996,0,9999,3
1745825260955,CAT 124RS,A01,956906,Staff,8,0,25,17
1745825261981,CAT 125RS,A01,922013,Staff,8,0,25,17
1745825263011,CLRE 250,A00,891860,Morris; Sheldon,9995,0,9999,4
1745825265084,CLRE 251R,A00,907817,Mehta; Ravindra L.,9994,0,9999,5
1745825266112,CLRE 252,A00,891864,Cuomo; Raphael Eduardo,9993,0,9999,6
1745825267147,CLRE 253,A00,891867,Vaida; Florin,9994,0,9999,5
1745825267147,CLRE 253,B00,907819,Staff,9999,0,9999,0
1745825268174,CLRE 259,A00,891868,Patel; Hemal,9998,0,9999,1
1745825269200,CLRE 260,A00,891872,Cuomo; Raphael Eduardo,9999,0,9999,0
1745825270230,CLRE 297,001,891888,Cuomo; Raphael Eduardo,9999,0,9999,0
1745825271256,CSE 191,A00,958773,Minnes Kemp; Mor Mia,9999,0,9999,0
1745825272283,CSS 201S,A01,892054,Mignozzetti; Umberto,30,0,30,0
1745825273310,CSS 202S,A01,892056,Mignozzetti; Umberto,30,0,30,0
1745825274338,DSC 197,001,956898,Eldridge; Justin Matthew,9998,0,9999,1
1745825275365,DSC 297,001,958000,Mazumdar; Arya,9998,0,9999,1
1745825276394,EAP 100,A00,905686,Staff,9776,0,9999,223
1745825277422,ECE 45,A01,892618,Staff,0,13,50,50
1745825278450,ECE 109,A01,892620,Staff,0,43,0,0
1745825279515,ECE 111,A01,892719,Staff,0,9,50,50
1745825280545,ECE 197,001,957920,Mercier; Patrick Philip,9992,0,9999,7
1745825281573,ECON 178,A01,907814,Zhu; Ying,28,0,35,7
1745825282600,EDS 115,A00,895312,Staff,41,0,45,4
1745825283626,EDS 117,A01,895337,Staff,30,0,30,0
1745825284652,EDS 125,A00,895341,Jones; Gabrielle Anastasia,43,0,45,2
1745825285681,EDS 128A,A01,895459,Fargason; Sharon Gayle,44,0,45,1
1745825286711,EDS 128B,A01,895543,Pappas; Elizabeth,44,0,45,1
1745825287742,EDS 139,A00,897203,Pappas; Elizabeth,44,0,45,1
1745825287742,EDS 139,B00,897209,Fargason; Sharon Gayle,44,0,45,1
1745825288767,EDS 201,A00,895545,Staff,43,0,45,2
1745825289808,EDS 203,A01,895581,Halter; Christopher P.,43,0,45,2
1745825290840,EDS 204R,A01,895625,Heinzman; Erica M.,43,0,45,2
1745825290840,EDS 204R,B01,895693,Halter; Christopher P.,18,0,45,27
1745825291874,EDS 206R,A00,895694,Fargason; Sharon Gayle,9,0,30,21
1745825291874,EDS 206R,B00,895695,Choi; Bailey Miyeon,20,0,30,10
1745825292907,EDS 250,A00,895697,Hemans; Patricia Ann Benitez,43,0,45,2
1745825293939,EDS 281,A00,895701,Meyerott; Theresa Ann,15,0,15,0
1745825294969,EDS 284,A00,895736,Meyerott; Theresa Ann,15,0,15,0
1745825295996,EDS 286,A00,897210,Fine; Sarah,15,0,15,0
1745825297022,EDS 289C,A01,895770,Daly; Alan J.,15,0,15,0
1745825298048,EDS 290,A00,897211,Hofstetter; Carolyn,15,0,15,0
1745825299074,LIGM 5A,A00,896162,Fischer-Grunski; Eva K,15,0,20,5
1745825300120,LIGM 5B,A00,896260,Fischer-Grunski; Eva K,17,0,20,3
1745825301149,LIGM 5C,A00,896308,Fischer-Grunski; Eva K,18,0,20,2
1745825302180,LIIT 5AS,A00,896313,Carnelos; Chiara,17,0,20,3
1745825303207,LIIT 5BS,A00,896416,Carnelos; Chiara,20,0,20,0
1745825304237,LIIT 5CS,A00,896564,Carnelos; Chiara,20,0,20,0
1745825305272,LISP 5A,A00,896588,Munoz Sanchez; Alicia,4,0,20,16
1745825306300,LISP 5B,A00,896653,Munoz Sanchez; Alicia,10,0,20,10
1745825307326,LISP 5C,A00,896655,Munoz Sanchez; Alicia,4,0,20,16
1745825308356,MAE 197,001,957918,Kleissl; Jan,9998,0,9999,1
1745825309383,MATH 2,A01,957937,Staff,34,0,35,1
1745825310411,MATH 197,001,957876,Kedlaya; Kiran S.,9993,0,9999,6
1745825311438,MCWP 40,A00,892729,Duru; Nur,13,0,20,7
1745825311438,MCWP 40,B00,893304,Montejo; Carolina,20,0,20,0
1745825312465,MCWP 40R,A00,893757,Redela; Pamela Morgan,0,7,20,20
1745825313491,MCWP 50,A00,893758,Morshed; Michael James,2,0,20,18
1745825313491,MCWP 50,B00,893761,Bartulis; Jason Michael,18,0,20,2
1745825314523,MCWP 50R,A00,893766,Compas; Sean Matthew,0,1,20,20
1745825314523,MCWP 50R,B00,893769,Carter; Jennifer A,0,0,20,20
1745825314523,MCWP 50R,C00,893771,Krone; Jarret,0,3,20,20
1745825314523,MCWP 50R,D00,893772,Miller; Elizabeth Deen,3,0,20,17
1745825314523,MCWP 50R,E00,893775,Carter; Andrea L,0,0,20,20
1745825315551,MMW 11R,A01,892721,Herbst; Matthew,11,0,27,16
1745825315551,MMW 11R,A02,892722,Herbst; Matthew,0,0,0,3
1745825316581,MMW 12R,A01,892724,Herbst; Matthew,0,10,16,16
1745825316581,MMW 12R,A02,892725,Herbst; Matthew,0,9,16,16
1745825317610,MMW 13R,A01,892727,Staff,0,3,16,16
1745825317610,MMW 13R,A02,892728,Staff,0,4,16,16
1745825317610,MMW 13R,A03,958032,Staff,0,3,16,16
1745825317610,MMW 13R,A04,958033,Staff,0,2,16,16
1745825317610,MMW 13R,A05,958034,Staff,0,3,16,16
1745825318641,SIO 295LS,A00,894015,Staff,7,0,25,18
1745825319677,SIO 295S,A00,894020,Staff,7,0,25,18
1745825320708,SIOC 290S,B01,958918,Staff,0,0,0,0
1745825321741,SIOC 291S,B01,958922,Staff,0,0,0,0
1745825322777,SOCI 117,A01,895339,Staff,4,0,5,1
1745825323805,WES 237B,A00,894149,Staff,11,0,20,9
1745825325912,AESE 279B,A00,891859,Staff,13,0,35,22
1745825326942,AIP 197,001,891854,Staff,70,0,70,0
1745825327973,ANTH 289S,A00,891856,Gagneux; Pascal,12,0,12,0
1745825329004,BENG 196,001,957946,Engler; Adam J.,9996,0,9999,3
1745825330063,CAT 124RS,A01,956906,Staff,8,0,25,17
1745825331092,CAT 125RS,A01,922013,Staff,8,0,25,17
1745825332122,CLRE 250,A00,891860,Morris; Sheldon,9995,0,9999,4
1745825334182,CLRE 251R,A00,907817,Mehta; Ravindra L.,9994,0,9999,5
1745825335212,CLRE 252,A00,891864,Cuomo; Raphael Eduardo,9993,0,9999,6
1745825336243,CLRE 253,A00,891867,Vaida; Florin,9994,0,9999,5
1745825336243,CLRE 253,B00,907819,Staff,9999,0,9999,0
1745825337271,CLRE 259,A00,891868,Patel; Hemal,9998,0,9999,1
1745825338306,CLRE 260,A00,891872,Cuomo; Raphael Eduardo,9999,0,9999,0
1745825339352,CLRE 297,001,891888,Cuomo; Raphael Eduardo,9999,0,9999,0
1745825340380,CSE 191,A00,958773,Minnes Kemp; Mor Mia,9999,0,9999,0
1745825341415,CSS 201S,A01,892054,Mignozzetti; Umberto,30,0,30,0
1745825342453,CSS 202S,A01,892056,Mignozzetti; Umberto,30,0,30,0
1745825343483,DSC 197,001,956898,Eldridge; Justin Matthew,9998,0,9999,1
1745825344515,DSC 297,001,958000,Mazumdar; Arya,9998,0,9999,1
1745825345543,EAP 100,A00,905686,Staff,9776,0,9999,223
1745825346570,ECE 45,A01,892618,Staff,0,13,50,50
1745825347601,ECE 109,A01,892620,Staff,0,43,0,0
1745825348631,ECE 111,A01,892719,Staff,0,9,50,50
1745825349670,ECE 197,001,957920,Mercier; Patrick Philip,9992,0,9999,7
1745825350696,ECON 178,A01,907814,Zhu; Ying,28,0,35,7
1745825351725,EDS 115,A00,895312,Staff,41,0,45,4
1745825352760,EDS 117,A01,895337,Staff,30,0,30,0
1745825353790,EDS 125,A00,895341,Jones; Gabrielle Anastasia,43,0,45,2
1745825354826,EDS 128A,A01,895459,Fargason; Sharon Gayle,44,0,45,1
1745825355855,EDS 128B,A01,895543,Pappas; Elizabeth,44,0,45,1
1745825356888,EDS 139,A00,897203,Pappas; Elizabeth,44,0,45,1
1745825356888,EDS 139,B00,897209,Fargason; Sharon Gayle,44,0,45,1
1745825357917,EDS 201,A00,895545,Staff,43,0,45,2
1745825358946,EDS 203,A01,895581,Halter; Christopher P.,43,0,45,2
1745825360049,EDS 204R,A01,895625,Heinzman; Erica M.,43,0,45,2
1745825360049,EDS 204R,B01,895693,Halter; Christopher P.,18,0,45,27
1745825361082,EDS 206R,A00,895694,Fargason; Sharon Gayle,9,0,30,21
1745825361082,EDS 206R,B00,895695,Choi; Bailey Miyeon,20,0,30,10
1745825362167,EDS 250,A00,895697,Hemans; Patricia Ann Benitez,43,0,45,2
1745825363197,EDS 281,A00,895701,Meyerott; Theresa Ann,15,0,15,0
1745825364231,EDS 284,A00,895736,Meyerott; Theresa Ann,15,0,15,0
1745825365258,EDS 286,A00,897210,Fine; Sarah,15,0,15,0
1745825366288,EDS 289C,A01,895770,Daly; Alan J.,15,0,15,0
1745825367319,EDS 290,A00,897211,Hofstetter; Carolyn,15,0,15,0
1745825368350,LIGM 5A,A00,896162,Fischer-Grunski; Eva K,15,0,20,5
1745825369385,LIGM 5B,A00,896260,Fischer-Grunski; Eva K,17,0,20,3
1745825370421,LIGM 5C,A00,896308,Fischer-Grunski; Eva K,18,0,20,2
1745825371452,LIIT 5AS,A00,896313,Carnelos; Chiara,17,0,20,3
1745825372481,LIIT 5BS,A00,896416,Carnelos; Chiara,20,0,20,0
1745825373511,LIIT 5CS,A00,896564,Carnelos; Chiara,20,0,20,0
1745825374542,LISP 5A,A00,896588,Munoz Sanchez; Alicia,4,0,20,16
1745825375571,LISP 5B,A00,896653,Munoz Sanchez; Alicia,10,0,20,10
1745825376604,LISP 5C,A00,896655,Munoz Sanchez; Alicia,4,0,20,16
1745825377629,MAE 197,001,957918,Kleissl; Jan,9998,0,9999,1
1745825378662,MATH 2,A01,957937,Staff,34,0,35,1
1745825379693,MATH 197,001,957876,Kedlaya; Kiran S.,9993,0,9999,6
1745825380725,MCWP 40,A00,892729,Duru; Nur,13,0,20,7
1745825380725,MCWP 40,B00,893304,Montejo; Carolina,20,0,20,0
1745825381756,MCWP 40R,A00,893757,Redela; Pamela Morgan,0,7,20,20
1745825382786,MCWP 50,A00,893758,Morshed; Michael James,2,0,20,18
1745825382786,MCWP 50,B00,893761,Bartulis; Jason Michael,18,0,20,2
1745825383873,MCWP 50R,A00,893766,Compas; Sean Matthew,0,1,20,20
1745825383873,MCWP 50R,B00,893769,Carter; Jennifer A,0,0,20,20
1745825383873,MCWP 50R,C00,893771,Krone; Jarret,0,3,20,20
1745825383873,MCWP 50R,D00,893772,Miller; Elizabeth Deen,3,0,20,17
1745825383873,MCWP 50R,E00,893775,Carter; Andrea L,0,0,20,20
1745825384907,MMW 11R,A01,892721,Herbst; Matthew,11,0,27,16
1745825384907,MMW 11R,A02,892722,Herbst; Matthew,0,0,0,3
1745825385937,MMW 12R,A01,892724,Herbst; Matthew,0,10,16,16
1745825385937,MMW 12R,A02,892725,Herbst; Matthew,0,9,16,16
1745825386966,MMW 13R,A01,892727,Staff,0,3,16,16
1745825386966,MMW 13R,A02,892728,Staff,0,4,16,16
1745825386966,MMW 13R,A03,958032,Staff,0,3,16,16
1745825386966,MMW 13R,A04,958033,Staff,0,2,16,16
1745825386966,MMW 13R,A05,958034,Staff,0,3,16,16
1745825387997,SIO 295LS,A00,894015,Staff,7,0,25,18
1745825389027,SIO 295S,A00,894020,Staff,7,0,25,18
1745825390064,SIOC 290S,B01,958918,Staff,0,0,0,0
1745825391096,SIOC 291S,B01,958922,Staff,0,0,0,0
1745825392126,SOCI 117,A01,895339,Staff,4,0,5,1
1745825393154,WES 237B,A00,894149,Staff,11,0,20,9
1745825395245,AESE 279B,A00,891859,Staff,13,0,35,22
1745825396272,AIP 197,001,891854,Staff,70,0,70,0
1745825397300,ANTH 289S,A00,891856,Gagneux; Pascal,12,0,12,0
1745825398328,BENG 196,001,957946,Engler; Adam J.,9996,0,9999,3
1745825399362,CAT 124RS,A01,956906,Staff,8,0,25,17
1745825400391,CAT 125RS,A01,922013,Staff,8,0,25,17
1745825401429,CLRE 250,A00,891860,Morris; Sheldon,9995,0,9999,4
1745825403488,CLRE 251R,A00,907817,Mehta; Ravindra L.,9994,0,9999,5
1745825404521,CLRE 252,A00,891864,Cuomo; Raphael Eduardo,9993,0,9999,6
1745825405552,CLRE 253,A00,891867,Vaida; Florin,9994,0,9999,5
1745825405552,CLRE 253,B00,907819,Staff,9999,0,9999,0
1745825406582,CLRE 259,A00,891868,Patel; Hemal,9998,0,9999,1
1745825407608,CLRE 260,A00,891872,Cuomo; Raphael Eduardo,9999,0,9999,0
1745825408641,CLRE 297,001,891888,Cuomo; Raphael Eduardo,9999,0,9999,0
1745825409675,CSE 191,A00,958773,Minnes Kemp; Mor Mia,9999,0,9999,0
1745825410708,CSS 201S,A01,892054,Mignozzetti; Umberto,30,0,30,0
1745825411772,CSS 202S,A01,892056,Mignozzetti; Umberto,30,0,30,0
1745825412799,DSC 197,001,956898,Eldridge; Justin Matthew,9998,0,9999,1
1745825413828,DSC 297,001,958000,Mazumdar; Arya,9998,0,9999,1
1745825414860,EAP 100,A00,905686,Staff,9776,0,9999,223
1745825415885,ECE 45,A01,892618,Staff,0,13,50,50
1745825416913,ECE 109,A01,892620,Staff,0,43,0,0
1745825417939,ECE 111,A01,892719,Staff,0,9,50,50
1745825418970,ECE 197,001,957920,Mercier; Patrick Philip,9992,0,9999,7
1745825420004,ECON 178,A01,907814,Zhu; Ying,28,0,35,7
1745825421037,EDS 115,A00,895312,Staff,41,0,45,4
1745825422069,EDS 117,A01,895337,Staff,30,0,30,0
1745825423095,EDS 125,A00,895341,Jones; Gabrielle Anastasia,43,0,45,2
1745825424125,EDS 128A,A01,895459,Fargason; Sharon Gayle,44,0,45,1
1745825425157,EDS 128B,A01,895543,Pappas; Elizabeth,44,0,45,1
1745825426184,EDS 139,A00,897203,Pappas; Elizabeth,44,0,45,1
1745825426184,EDS 139,B00,897209,Fargason; Sharon Gayle,44,0,45,1
1745825427216,EDS 201,A00,895545,Staff,43,0,45,2
1745825428245,EDS 203,A01,895581,Halter; Christopher P.,43,0,45,2
1745825429275,EDS 204R,A01,895625,Heinzman; Erica M.,43,0,45,2
1745825429275,EDS 204R,B01,895693,Halter; Christopher P.,18,0,45,27
1745825430304,EDS 206R,A00,895694,Fargason; Sharon Gayle,9,0,30,21
1745825430304,EDS 206R,B00,895695,Choi; Bailey Miyeon,20,0,30,10
1745825431338,EDS 250,A00,895697,Hemans; Patricia Ann Benitez,43,0,45,2
1745825432369,EDS 281,A00,895701,Meyerott; Theresa Ann,15,0,15,0
1745825433396,EDS 284,A00,895736,Meyerott; Theresa Ann,15,0,15,0
1745825434426,EDS 286,A00,897210,Fine; Sarah,15,0,15,0
1745825435457,EDS 289C,A01,895770,Daly; Alan J.,15,0,15,0
1745825436485,EDS 290,A00,897211,Hofstetter; Carolyn,15,0,15,0
1745825437514,LIGM 5A,A00,896162,Fischer-Grunski; Eva K,15,0,20,5
1745825438544,LIGM 5B,A00,896260,Fischer-Grunski; Eva K,17,0,20,3
1745825439571,LIGM 5C,A00,896308,Fischer-Grunski; Eva K,18,0,20,2
1745825440604,LIIT 5AS,A00,896313,Carnelos; Chiara,17,0,20,3
1745825441629,LIIT 5BS,A00,896416,Carnelos; Chiara,20,0,20,0
1745825442658,LIIT 5CS,A00,896564,Carnelos; Chiara,20,0,20,0
1745825443689,LISP 5A,A00,896588,Munoz Sanchez; Alicia,4,0,20,16
1745825444720,LISP 5B,A00,896653,Munoz Sanchez; Alicia,10,0,20,10
1745825445747,LISP 5C,A00,896655,Munoz Sanchez; Alicia,4,0,20,16
1745825446774,MAE 197,001,957918,Kleissl; Jan,9998,0,9999,1
1745825447802,MATH 2,A01,957937,Staff,34,0,35,1
1745825448829,MATH 197,001,957876,Kedlaya; Kiran S.,9993,0,9999,6
1745825449861,MCWP 40,A00,892729,Duru; Nur,13,0,20,7
1745825449861,MCWP 40,B00,893304,Montejo; Carolina,20,0,20,0
1745825450888,MCWP 40R,A00,893757,Redela; Pamela Morgan,0,7,20,20
1745825451917,MCWP 50,A00,893758,Morshed; Michael James,2,0,20,18
1745825451917,MCWP 50,B00,893761,Bartulis; Jason Michael,18,0,20,2
1745825452946,MCWP 50R,A00,893766,Compas; Sean Matthew,0,1,20,20
1745825452946,MCWP 50R,B00,893769,Carter; Jennifer A,0,0,20,20
1745825452946,MCWP 50R,C00,893771,Krone; Jarret,0,3,20,20
1745825452946,MCWP 50R,D00,893772,Miller; Elizabeth Deen,3,0,20,17
1745825452946,MCWP 50R,E00,893775,Carter; Andrea L,0,0,20,20
1745825453974,MMW 11R,A01,892721,Herbst; Matthew,11,0,27,16
1745825453974,MMW 11R,A02,892722,Herbst; Matthew,0,0,0,3
1745825455018,MMW 12R,A01,892724,Herbst; Matthew,0,10,16,16
1745825455018,MMW 12R,A02,892725,Herbst; Matthew,0,9,16,16
1745825456045,MMW 13R,A01,892727,Staff,0,3,16,16
1745825456045,MMW 13R,A02,892728,Staff,0,4,16,16
1745825456045,MMW 13R,A03,958032,Staff,0,3,16,16
1745825456045,MMW 13R,A04,958033,Staff,0,2,16,16
1745825456045,MMW 13R,A05,958034,Staff,0,3,16,16
1745825457073,SIO 295LS,A00,894015,Staff,7,0,25,18
1745825458098,SIO 295S,A00,894020,Staff,7,0,25,18
1745825459184,SIOC 290S,B01,958918,Staff,0,0,0,0
1745825460211,SIOC 291S,B01,958922,Staff,0,0,0,0
1745825461236,SOCI 117,A01,895339,Staff,4,0,5,1
1745825462267,WES 237B,A00,894149,Staff,11,0,20,9
1745825464340,AESE 279B,A00,891859,Staff,13,0,35,22
1745825465371,AIP 197,001,891854,Staff,70,0,70,0
1745825466395,ANTH 289S,A00,891856,Gagneux; Pascal,12,0,12,0
1745825467423,BENG 196,001,957946,Engler; Adam J.,9996,0,9999,3
1745825468450,CAT 124RS,A01,956906,Staff,8,0,25,17
1745825469475,CAT 125RS,A01,922013,Staff,8,0,25,17
1745825470505,CLRE 250,A00,891860,Morris; Sheldon,9995,0,9999,4
1745825472553,CLRE 251R,A00,907817,Mehta; Ravindra L.,9994,0,9999,5
1745825473581,CLRE 252,A00,891864,Cuomo; Raphael Eduardo,9993,0,9999,6
1745825474606,CLRE 253,A00,891867,Vaida; Florin,9994,0,9999,5
1745825474606,CLRE 253,B00,907819,Staff,9999,0,9999,0
1745825475634,CLRE 259,A00,891868,Patel; Hemal,9998,0,9999,1
1745825476660,CLRE 260,A00,891872,Cuomo; Raphael Eduardo,9999,0,9999,0
1745825477688,CLRE 297,001,891888,Cuomo; Raphael Eduardo,9999,0,9999,0
1745825478712,CSE 191,A00,958773,Minnes Kemp; Mor Mia,9999,0,9999,0
1745825479743,CSS 201S,A01,892054,Mignozzetti; Umberto,30,0,30,0
1745825480769,CSS 202S,A01,892056,Mignozzetti; Umberto,30,0,30,0
1745825481797,DSC 197,001,956898,Eldridge; Justin Matthew,9998,0,9999,1
1745825482826,DSC 297,001,958000,Mazumdar; Arya,9998,0,9999,1
1745825483851,EAP 100,A00,905686,Staff,9776,0,9999,223
1745825484877,ECE 45,A01,892618,Staff,0,13,50,50
1745825485908,ECE 109,A01,892620,Staff,0,43,0,0
1745825486937,ECE 111,A01,892719,Staff,0,9,50,50
1745825487965,ECE 197,001,957920,Mercier; Patrick Philip,9992,0,9999,7
1745825488990,ECON 178,A01,907814,Zhu; Ying,28,0,35,7
1745825490026,EDS 115,A00,895312,Staff,41,0,45,4
1745825491054,EDS 117,A01,895337,Staff,30,0,30,0
1745825492081,EDS 125,A00,895341,Jones; Gabrielle Anastasia,43,0,45,2
1745825493109,EDS 128A,A01,895459,Fargason; Sharon Gayle,44,0,45,1
1745825494133,EDS 128B,A01,895543,Pappas; Elizabeth,44,0,45,1
1745825495160,EDS 139,A00,897203,Pappas; Elizabeth,44,0,45,1
1745825495160,EDS 139,B00,897209,Fargason; Sharon Gayle,44,0,45,1
1745825496186,EDS 201,A00,895545,Staff,43,0,45,2
1745825497213,EDS 203,A01,895581,Halter; Christopher P.,43,0,45,2
1745825498241,EDS 204R,A01,895625,Heinzman; Erica M.,43,0,45,2
1745825498241,EDS 204R,B01,895693,Halter; Christopher P.,18,0,45,27
1745825499268,EDS 206R,A00,895694,Fargason; Sharon Gayle,9,0,30,21
1745825499268,EDS 206R,B00,895695,Choi; Bailey Miyeon,20,0,30,10
1745825500297,EDS 250,A00,895697,Hemans; Patricia Ann Benitez,43,0,45,2
1745825501324,EDS 281,A00,895701,Meyerott; Theresa Ann,15,0,15,0
1745825502354,EDS 284,A00,895736,Meyerott; Theresa Ann,15,0,15,0
1745825503384,EDS 286,A00,897210,Fine; Sarah,15,0,15,0
1745825504413,EDS 289C,A01,895770,Daly; Alan J.,15,0,15,0
1745825505440,EDS 290,A00,897211,Hofstetter; Carolyn,15,0,15,0
1745825506469,LIGM 5A,A00,896162,Fischer-Grunski; Eva K,15,0,20,5
1745825507499,LIGM 5B,A00,896260,Fischer-Grunski; Eva K,17,0,20,3
1745825508526,LIGM 5C,A00,896308,Fischer-Grunski; Eva K,18,0,20,2
1745825509552,LIIT 5AS,A00,896313,Carnelos; Chiara,17,0,20,3
1745825510578,LIIT 5BS,A00,896416,Carnelos; Chiara,20,0,20,0
1745825511607,LIIT 5CS,A00,896564,Carnelos; Chiara,20,0,20,0
1745825512634,LISP 5A,A00,896588,Munoz Sanchez; Alicia,4,0,20,16
1745825513661,LISP 5B,A00,896653,Munoz Sanchez; Alicia,10,0,20,10
1745825514692,LISP 5C,A00,896655,Munoz Sanchez; Alicia,4,0,20,16
1745825515719,MAE 197,001,957918,Kleissl; Jan,9998,0,9999,1
1745825516745,MATH 2,A01,957937,Staff,34,0,35,1
1745825517773,MATH 197,001,957876,Kedlaya; Kiran S.,9993,0,9999,6
1745825518803,MCWP 40,A00,892729,Duru; Nur,13,0,20,7
1745825518803,MCWP 40,B00,893304,Montejo; Carolina,20,0,20,0
1745825519834,MCWP 40R,A00,893757,Redela; Pamela Morgan,0,7,20,20
1745825520865,MCWP 50,A00,893758,Morshed; Michael James,2,0,20,18
1745825520865,MCWP 50,B00,893761,Bartulis; Jason Michael,18,0,20,2
1745825521893,MCWP 50R,A00,893766,Compas; Sean Matthew,0,1,20,20
1745825521893,MCWP 50R,B00,893769,Carter; Jennifer A,0,0,20,20
1745825521893,MCWP 50R,C00,893771,Krone; Jarret,0,3,20,20
1745825521893,MCWP 50R,D00,893772,Miller; Elizabeth Deen,3,0,20,17
1745825521893,MCWP 50R,E00,893775,Carter; Andrea L,0,0,20,20
1745825522919,MMW 11R,A01,892721,Herbst; Matthew,11,0,27,16
1745825522919,MMW 11R,A02,892722,Herbst; Matthew,0,0,0,3
1745825523949,MMW 12R,A01,892724,Herbst; Matthew,0,10,16,16
1745825523949,MMW 12R,A02,892725,Herbst; Matthew,0,9,16,16
1745825524974,MMW 13R,A01,892727,Staff,0,3,16,16
1745825524974,MMW 13R,A02,892728,Staff,0,4,16,16
1745825524974,MMW 13R,A03,958032,Staff,0,3,16,16
1745825524974,MMW 13R,A04,958033,Staff,0,2,16,16
1745825524974,MMW 13R,A05,958034,Staff,0,3,16,16
1745825526001,SIO 295LS,A00,894015,Staff,7,0,25,18
1745825527028,SIO 295S,A00,894020,Staff,7,0,25,18
1745825528054,SIOC 290S,B01,958918,Staff,0,0,0,0
1745825529131,SIOC 291S,B01,958922,Staff,0,0,0,0
1745825530161,SOCI 117,A01,895339,Staff,4,0,5,1
1745825531188,WES 237B,A00,894149,Staff,11,0,20,9
1745825533256,AESE 279B,A00,891859,Staff,13,0,35,22
1745825534282,AIP 197,001,891854,Staff,70,0,70,0
1745825535312,ANTH 289S,A00,891856,Gagneux; Pascal,12,0,12,0
1745825536340,BENG 196,001,957946,Engler; Adam J.,9996,0,9999,3
1745825537367,CAT 124RS,A01,956906,Staff,8,0,25,17
1745825538394,CAT 125RS,A01,922013,Staff,8,0,25,17
1745825539423,CLRE 250,A00,891860,Morris; Sheldon,9995,0,9999,4
1745825541476,CLRE 251R,A00,907817,Mehta; Ravindra L.,9994,0,9999,5
1745825542501,CLRE 252,A00,891864,Cuomo; Raphael Eduardo,9993,0,9999,6
1745825543534,CLRE 253,A00,891867,Vaida; Florin,9994,0,9999,5
1745825543534,CLRE 253,B00,907819,Staff,9999,0,9999,0
1745825544562,CLRE 259,A00,891868,Patel; Hemal,9998,0,9999,1
1745825545587,CLRE 260,A00,891872,Cuomo; Raphael Eduardo,9999,0,9999,0
1745825546617,CLRE 297,001,891888,Cuomo; Raphael Eduardo,9999,0,9999,0
1745825547642,CSE 191,A00,958773,Minnes Kemp; Mor Mia,9999,0,9999,0
1745825548675,CSS 201S,A01,892054,Mignozzetti; Umberto,30,0,30,0
1745825549705,CSS 202S,A01,892056,Mignozzetti; Umberto,30,0,30,0
1745825550732,DSC 197,001,956898,Eldridge; Justin Matthew,9998,0,9999,1
1745825551760,DSC 297,001,958000,Mazumdar; Arya,9998,0,9999,1
1745825552787,EAP 100,A00,905686,Staff,9776,0,9999,223
1745825553814,ECE 45,A01,892618,Staff,0,13,50,50
1745825554841,ECE 109,A01,892620,Staff,0,43,0,0
1745825555867,ECE 111,A01,892719,Staff,0,9,50,50
1745825556893,ECE 197,001,957920,Mercier; Patrick Philip,9992,0,9999,7
1745825557920,ECON 178,A01,907814,Zhu; Ying,28,0,35,7
1745825558945,EDS 115,A00,895312,Staff,41,0,45,4
1745825559975,EDS 117,A01,895337,Staff,30,0,30,0
1745825561003,EDS 125,A00,895341,Jones; Gabrielle Anastasia,43,0,45,2
1745825562034,EDS 128A,A01,895459,Fargason; Sharon Gayle,44,0,45,1
1745825563063,EDS 128B,A01,895543,Pappas; Elizabeth,44,0,45,1
1745825564092,EDS 139,A00,897203,Pappas; Elizabeth,44,0,45,1
1745825564092,EDS 139,B00,897209,Fargason; Sharon Gayle,44,0,45,1
1745825565121,EDS 201,A00,895545,Staff,43,0,45,2
1745825566146,EDS 203,A01,895581,Halter; Christopher P.,43,0,45,2
1745825567172,EDS 204R,A01,895625,Heinzman; Erica M.,43,0,45,2
1745825567172,EDS 204R,B01,895693,Halter; Christopher P.,18,0,45,27
1745825568198,EDS 206R,A00,895694,Fargason; Sharon Gayle,9,0,30,21
1745825568198,EDS 206R,B00,895695,Choi; Bailey Miyeon,20,0,30,10
1745825569223,EDS 250,A00,895697,Hemans; Patricia Ann Benitez,43,0,45,2
1745825570250,EDS 281,A00,895701,Meyerott; Theresa Ann,15,0,15,0
1745825571278,EDS 284,A00,895736,Meyerott; Theresa Ann,15,0,15,0
1745825572308,EDS 286,A00,897210,Fine; Sarah,15,0,15,0
1745825573334,EDS 289C,A01,895770,Daly; Alan J.,15,0,15,0
1745825574362,EDS 290,A00,897211,Hofstetter; Carolyn,15,0,15,0
1745825575391,LIGM 5A,A00,896162,Fischer-Grunski; Eva K,15,0,20,5
1745825576419,LIGM 5B,A00,896260,Fischer-Grunski; Eva K,17,0,20,3
1745825577445,LIGM 5C,A00,896308,Fischer-Grunski; Eva K,18,0,20,2
1745825578473,LIIT 5AS,A00,896313,Carnelos; Chiara,17,0,20,3
1745825579504,LIIT 5BS,A00,896416,Carnelos; Chiara,20,0,20,0
1745825580531,LIIT 5CS,A00,896564,Carnelos; Chiara,20,0,20,0
1745825581563,LISP 5A,A00,896588,Munoz Sanchez; Alicia,4,0,20,16
1745825582589,LISP 5B,A00,896653,Munoz Sanchez; Alicia,10,0,20,10
1745825583617,LISP 5C,A00,896655,Munoz Sanchez; Alicia,4,0,20,16
1745825584646,MAE 197,001,957918,Kleissl; Jan,9998,0,9999,1
1745825585672,MATH 2,A01,957937,Staff,34,0,35,1
1745825586699,MATH 197,001,957876,Kedlaya; Kiran S.,9993,0,9999,6
1745825587724,MCWP 40,A00,892729,Duru; Nur,13,0,20,7
1745825587724,MCWP 40,B00,893304,Montejo; Carolina,20,0,20,0
1745825588748,MCWP 40R,A00,893757,Redela; Pamela Morgan,0,7,20,20
1745825589773,MCWP 50,A00,893758,Morshed; Michael James,2,0,20,18
1745825589773,MCWP 50,B00,893761,Bartulis; Jason Michael,18,0,20,2
1745825590802,MCWP 50R,A00,893766,Compas; Sean Matthew,0,1,20,20
1745825590802,MCWP 50R,B00,893769,Carter; Jennifer A,0,0,20,20
1745825590802,MCWP 50R,C00,893771,Krone; Jarret,0,3,20,20
1745825590802,MCWP 50R,D00,893772,Miller; Elizabeth Deen,3,0,20,17
1745825590802,MCWP 50R,E00,893775,Carter; Andrea L,0,0,20,20
1745825591829,MMW 11R,A01,892721,Herbst; Matthew,11,0,27,16
1745825591829,MMW 11R,A02,892722,Herbst; Matthew,0,0,0,3
1745825592854,MMW 12R,A01,892724,Herbst; Matthew,0,10,16,16
1745825592854,MMW 12R,A02,892725,Herbst; Matthew,0,9,16,16
1745825593881,MMW 13R,A01,892727,Staff,0,3,16,16
1745825593881,MMW 13R,A02,892728,Staff,0,4,16,16
1745825593881,MMW 13R,A03,958032,Staff,0,3,16,16
1745825593881,MMW 13R,A04,958033,Staff,0,2,16,16
1745825593881,MMW 13R,A05,958034,Staff,0,3,16,16
1745825594905,SIO 295LS,A00,894015,Staff,7,0,25,18
1745825595936,SIO 295S,A00,894020,Staff,7,0,25,18
1745825596962,SIOC 290S,B01,958918,Staff,0,0,0,0
1745825597993,SIOC 291S,B01,958922,Staff,0,0,0,0
1745825599017,SOCI 117,A01,895339,Staff,4,0,5,1
1745825600043,WES 237B,A00,894149,Staff,11,0,20,9
1745825602115,AESE 279B,A00,891859,Staff,13,0,35,22
1745825603140,AIP 197,001,891854,Staff,70,0,70,0
1745825604168,ANTH 289S,A00,891856,Gagneux; Pascal,12,0,12,0
1745825605193,BENG 196,001,957946,Engler; Adam J.,9996,0,9999,3
1745825606218,CAT 124RS,A01,956906,Staff,8,0,25,17
1745825607245,CAT 125RS,A01,922013,Staff,8,0,25,17
1745825608271,CLRE 250,A00,891860,Morris; Sheldon,9995,0,9999,4
1745825610326,CLRE 251R,A00,907817,Mehta; Ravindra L.,9994,0,9999,5
1745825611350,CLRE 252,A00,891864,Cuomo; Raphael Eduardo,9993,0,9999,6
1745825612391,CLRE 253,A00,891867,Vaida; Florin,9994,0,9999,5
1745825612391,CLRE 253,B00,907819,Staff,9999,0,9999,0
1745825613419,CLRE 259,A00,891868,Patel; Hemal,9998,0,9999,1
1745825614445,CLRE 260,A00,891872,Cuomo; Raphael Eduardo,9999,0,9999,0
1745825615472,CLRE 297,001,891888,Cuomo; Raphael Eduardo,9999,0,9999,0
1745825616497,CSE 191,A00,958773,Minnes Kemp; Mor Mia,9999,0,9999,0
1745825617525,CSS 201S,A01,892054,Mignozzetti; Umberto,30,0,30,0
1745825618552,CSS 202S,A01,892056,Mignozzetti; Umberto,30,0,30,0
1745825619578,DSC 197,001,956898,Eldridge; Justin Matthew,9998,0,9999,1
1745825620610,DSC 297,001,958000,Mazumdar; Arya,9998,0,9999,1
1745825621636,EAP 100,A00,905686,Staff,9776,0,9999,223
1745825622662,ECE 45,A01,892618,Staff,0,13,50,50
1745825623688,ECE 109,A01,892620,Staff,0,43,0,0
1745825624716,ECE 111,A01,892719,Staff,0,9,50,50
1745825625748,ECE 197,001,957920,Mercier; Patrick Philip,9992,0,9999,7
1745825626779,ECON 178,A01,907814,Zhu; Ying,28,0,35,7
1745825627810,EDS 115,A00,895312,Staff,41,0,45,4
1745825628844,EDS 117,A01,895337,Staff,30,0,30,0
1745825629871,EDS 125,A00,895341,Jones; Gabrielle Anastasia,43,0,45,2
1745825630900,EDS 128A,A01,895459,Fargason; Sharon Gayle,44,0,45,1
1745825631929,EDS 128B,A01,895543,Pappas; Elizabeth,44,0,45,1
1745825632955,EDS 139,A00,897203,Pappas; Elizabeth,44,0,45,1
1745825632955,EDS 139,B00,897209,Fargason; Sharon Gayle,44,0,45,1
1745825633981,EDS 201,A00,895545,Staff,43,0,45,2
1745825635008,EDS 203,A01,895581,Halter; Christopher P.,43,0,45,2
1745825636034,EDS 204R,A01,895625,Heinzman; Erica M.,43,0,45,2
1745825636034,EDS 204R,B01,895693,Halter; Christopher P.,18,0,45,27
1745825637062,EDS 206R,A00,895694,Fargason; Sharon Gayle,9,0,30,21
1745825637062,EDS 206R,B00,895695,Choi; Bailey Miyeon,20,0,30,10
1745825638092,EDS 250,A00,895697,Hemans; Patricia Ann Benitez,43,0,45,2
1745825639118,EDS 281,A00,895701,Meyerott; Theresa Ann,15,0,15,0
1745825648403,EDS 284,A00,895736,Meyerott; Theresa Ann,15,0,15,0
1745825649431,EDS 286,A00,897210,Fine; Sarah,15,0,15,0
1745825650459,EDS 289C,A01,895770,Daly; Alan J.,15,0,15,0
1745825651487,EDS 290,A00,897211,Hofstetter; Carolyn,15,0,15,0
1745825652517,LIGM 5A,A00,896162,Fischer-Grunski; Eva K,15,0,20,5
1745825653544,LIGM 5B,A00,896260,Fischer-Grunski; Eva K,17,0,20,3
1745825654567,LIGM 5C,A00,896308,Fischer-Grunski; Eva K,18,0,20,2
1745825655591,LIIT 5AS,A00,896313,Carnelos; Chiara,17,0,20,3
1745825656616,LIIT 5BS,A00,896416,Carnelos; Chiara,20,0,20,0
1745825657647,LIIT 5CS,A00,896564,Carnelos; Chiara,20,0,20,0
1745825658673,LISP 5A,A00,896588,Munoz Sanchez; Alicia,4,0,20,16
1745825659703,LISP 5B,A00,896653,Munoz Sanchez; Alicia,10,0,20,10
1745825660731,LISP 5C,A00,896655,Munoz Sanchez; Alicia,4,0,20,16
1745825661762,MAE 197,001,957918,Kleissl; Jan,9998,0,9999,1
1745825662790,MATH 2,A01,957937,Staff,34,0,35,1
1745825663815,MATH 197,001,957876,Kedlaya; Kiran S.,9993,0,9999,6
1745825664842,MCWP 40,A00,892729,Duru; Nur,13,0,20,7
1745825664842,MCWP 40,B00,893304,Montejo; Carolina,20,0,20,0
1745825665868,MCWP 40R,A00,893757,Redela; Pamela Morgan,0,7,20,20
1745825666897,MCWP 50,A00,893758,Morshed; Michael James,2,0,20,18
1745825666897,MCWP 50,B00,893761,Bartulis; Jason Michael,18,0,20,2
1745825667927,MCWP 50R,A00,893766,Compas; Sean Matthew,0,1,20,20
1745825667927,MCWP 50R,B00,893769,Carter; Jennifer A,0,0,20,20
1745825667927,MCWP 50R,C00,893771,Krone; Jarret,0,3,20,20
1745825667927,MCWP 50R,D00,893772,Miller; Elizabeth Deen,3,0,20,17
1745825667927,MCWP 50R,E00,893775,Carter; Andrea L,0,0,20,20
1745825668952,MMW 11R,A01,892721,Herbst; Matthew,11,0,27,16
1745825668952,MMW 11R,A02,892722,Herbst; Matthew,0,0,0,3
1745825669978,MMW 12R,A01,892724,Herbst; Matthew,0,10,16,16
1745825669978,MMW 12R,A02,892725,Herbst; Matthew,0,9,16,16
1745825671003,MMW 13R,A01,892727,Staff,0,3,16,16
1745825671003,MMW 13R,A02,892728,Staff,0,4,16,16
1745825671003,MMW 13R,A03,958032,Staff,0,3,16,16
1745825671003,MMW 13R,A04,958033,Staff,0,2,16,16
1745825671003,MMW 13R,A05,958034,Staff,0,3,16,16
1745825672031,SIO 295LS,A00,894015,Staff,7,0,25,18
1745825673062,SIO 295S,A00,894020,Staff,7,0,25,18
1745825674088,SIOC 290S,B01,958918,Staff,0,0,0,0
1745825675123,SIOC 291S,B01,958922,Staff,0,0,0,0
1745825676151,SOCI 117,A01,895339,Staff,4,0,5,1
1745825677179,WES 237B,A00,894149,Staff,11,0,20,9
1745825679250,AESE 279B,A00,891859,Staff,13,0,35,22
1745825680277,AIP 197,001,891854,Staff,70,0,70,0
1745825681301,ANTH 289S,A00,891856,Gagneux; Pascal,12,0,12,0
1745825682326,BENG 196,001,957946,Engler; Adam J.,9996,0,9999,3
1745825683353,CAT 124RS,A01,956906,Staff,8,0,25,17
1745825684381,CAT 125RS,A01,922013,Staff,8,0,25,17
1745825685411,CLRE 250,A00,891860,Morris; Sheldon,9995,0,9999,4
1745825687465,CLRE 251R,A00,907817,Mehta; Ravindra L.,9994,0,9999,5
1745825688490,CLRE 252,A00,891864,Cuomo; Raphael Eduardo,9993,0,9999,6
1745825689520,CLRE 253,A00,891867,Vaida; Florin,9994,0,9999,5
1745825689520,CLRE 253,B00,907819,Staff,9999,0,9999,0
1745825690546,CLRE 259,A00,891868,Patel; Hemal,9998,0,9999,1
1745825691574,CLRE 260,A00,891872,Cuomo; Raphael Eduardo,9999,0,9999,0
1745825692601,CLRE 297,001,891888,Cuomo; Raphael Eduardo,9999,0,9999,0
1745825693631,CSE 191,A00,958773,Minnes Kemp; Mor Mia,9999,0,9999,0
1745825694660,CSS 201S,A01,892054,Mignozzetti; Umberto,30,0,30,0
1745825695683,CSS 202S,A01,892056,Mignozzetti; Umberto,30,0,30,0
1745825696710,DSC 197,001,956898,Eldridge; Justin Matthew,9998,0,9999,1
1745825697738,DSC 297,001,958000,Mazumdar; Arya,9998,0,9999,1
1745825698765,EAP 100,A00,905686,Staff,9776,0,9999,223
1745825699799,ECE 45,A01,892618,Staff,0,13,50,50
1745825700827,ECE 109,A01,892620,Staff,0,43,0,0
1745825701861,ECE 111,A01,892719,Staff,0,9,50,50
1745825702891,ECE 197,001,957920,Mercier; Patrick Philip,9992,0,9999,7
1745825703919,ECON 178,A01,907814,Zhu; Ying,28,0,35,7
1745825704948,EDS 115,A00,895312,Staff,41,0,45,4
1745825705974,EDS 117,A01,895337,Staff,30,0,30,0
1745825707006,EDS 125,A00,895341,Jones; Gabrielle Anastasia,43,0,45,2
1745825708036,EDS 128A,A01,895459,Fargason; Sharon Gayle,44,0,45,1
1745825709062,EDS 128B,A01,895543,Pappas; Elizabeth,44,0,45,1
1745825710089,EDS 139,A00,897203,Pappas; Elizabeth,44,0,45,1
1745825710089,EDS 139,B00,897209,Fargason; Sharon Gayle,44,0,45,1
1745825711114,EDS 201,A00,895545,Staff,43,0,45,2
1745825712138,EDS 203,A01,895581,Halter; Christopher P.,43,0,45,2
1745825713162,EDS 204R,A01,895625,Heinzman; Erica M.,43,0,45,2
1745825713162,EDS 204R,B01,895693,Halter; Christopher P.,18,0,45,27
1745825714190,EDS 206R,A00,895694,Fargason; Sharon Gayle,9,0,30,21
1745825714190,EDS 206R,B00,895695,Choi; Bailey Miyeon,20,0,30,10
1745825715221,EDS 250,A00,895697,Hemans; Patricia Ann Benitez,43,0,45,2
1745825716248,EDS 281,A00,895701,Meyerott; Theresa Ann,15,0,15,0
1745825717274,EDS 284,A00,895736,Meyerott; Theresa Ann,15,0,15,0
1745825718306,EDS 286,A00,897210,Fine; Sarah,15,0,15,0
1745825719334,EDS 289C,A01,895770,Daly; Alan J.,15,0,15,0
1745825720363,EDS 290,A00,897211,Hofstetter; Carolyn,15,0,15,0
1745825721389,LIGM 5A,A00,896162,Fischer-Grunski; Eva K,15,0,20,5
1745825722419,LIGM 5B,A00,896260,Fischer-Grunski; Eva K,17,0,20,3
1745825723446,LIGM 5C,A00,896308,Fischer-Grunski; Eva K,18,0,20,2
1745825724475,LIIT 5AS,A00,896313,Carnelos; Chiara,17,0,20,3
1745825725505,LIIT 5BS,A00,896416,Carnelos; Chiara,20,0,20,0
1745825726532,LIIT 5CS,A00,896564,Carnelos; Chiara,20,0,20,0
1745825727561,LISP 5A,A00,896588,Munoz Sanchez; Alicia,4,0,20,16
1745825728590,LISP 5B,A00,896653,Munoz Sanchez; Alicia,10,0,20,10
1745825729623,LISP 5C,A00,896655,Munoz Sanchez; Alicia,4,0,20,16
1745825730650,MAE 197,001,957918,Kleissl; Jan,9998,0,9999,1
1745825731677,MATH 2,A01,957937,Staff,34,0,35,1
1745825732706,MATH 197,001,957876,Kedlaya; Kiran S.,9993,0,9999,6
1745825733738,MCWP 40,A00,892729,Duru; Nur,13,0,20,7
1745825733738,MCWP 40,B00,893304,Montejo; Carolina,20,0,20,0
1745825734765,MCWP 40R,A00,893757,Redela; Pamela Morgan,0,7,20,20
1745825735791,MCWP 50,A00,893758,Morshed; Michael James,2,0,20,18
1745825735791,MCWP 50,B00,893761,Bartulis; Jason Michael,18,0,20,2
1745825736823,MCWP 50R,A00,893766,Compas; Sean Matthew,0,1,20,20
1745825736823,MCWP 50R,B00,893769,Carter; Jennifer A,0,0,20,20
1745825736823,MCWP 50R,C00,893771,Krone; Jarret,0,3,20,20
1745825736823,MCWP 50R,D00,893772,Miller; Elizabeth Deen,3,0,20,17
1745825736823,MCWP 50R,E00,893775,Carter; Andrea L,0,0,20,20
1745825737852,MMW 11R,A01,892721,Herbst; Matthew,11,0,27,16
1745825737852,MMW 11R,A02,892722,Herbst; Matthew,0,0,0,3
1745825738878,MMW 12R,A01,892724,Herbst; Matthew,0,10,16,16
1745825738878,MMW 12R,A02,892725,Herbst; Matthew,0,9,16,16
1745825739910,MMW 13R,A01,892727,Staff,0,3,16,16
1745825739910,MMW 13R,A02,892728,Staff,0,4,16,16
1745825739910,MMW 13R,A03,958032,Staff,0,3,16,16
1745825739910,MMW 13R,A04,958033,Staff,0,2,16,16
1745825739910,MMW 13R,A05,958034,Staff,0,3,16,16
1745825740943,SIO 295LS,A00,894015,Staff,7,0,25,18
1745825741971,SIO 295S,A00,894020,Staff,7,0,25,18
1745825743002,SIOC 290S,B01,958918,Staff,0,0,0,0
1745825744033,SIOC 291S,B01,958922,Staff,0,0,0,0
1745825745061,SOCI 117,A01,895339,Staff,4,0,5,1
1745825746089,WES 237B,A00,894149,Staff,11,0,20,9
1745825748170,AESE 279B,A00,891859,Staff,13,0,35,22
1745825749196,AIP 197,001,891854,Staff,70,0,70,0
1745825750223,ANTH 289S,A00,891856,Gagneux; Pascal,12,0,12,0
1745825751249,BENG 196,001,957946,Engler; Adam J.,9996,0,9999,3
1745825752303,CAT 124RS,A01,956906,Staff,8,0,25,17
1745825753330,CAT 125RS,A01,922013,Staff,8,0,25,17
1745825754357,CLRE 250,A00,891860,Morris; Sheldon,9995,0,9999,4
1745825756410,CLRE 251R,A00,907817,Mehta; Ravindra L.,9994,0,9999,5
1745825757437,CLRE 252,A00,891864,Cuomo; Raphael Eduardo,9993,0,9999,6
1745825758461,CLRE 253,A00,891867,Vaida; Florin,9994,0,9999,5
1745825758461,CLRE 253,B00,907819,Staff,9999,0,9999,0
1745825759491,CLRE 259,A00,891868,Patel; Hemal,9998,0,9999,1
1745825760518,CLRE 260,A00,891872,Cuomo; Raphael Eduardo,9999,0,9999,0
1745825761547,CLRE 297,001,891888,Cuomo; Raphael Eduardo,9999,0,9999,0
1745825762574,CSE 191,A00,958773,Minnes Kemp; Mor Mia,9999,0,9999,0
1745825763603,CSS 201S,A01,892054,Mignozzetti; Umberto,30,0,30,0
1745825764632,CSS 202S,A01,892056,Mignozzetti; Umberto,30,0,30,0
1745825765666,DSC 197,001,956898,Eldridge; Justin Matthew,9998,0,9999,1
1745825766693,DSC 297,001,958000,Mazumdar; Arya,9998,0,9999,1
1745825767721,EAP 100,A00,905686,Staff,9776,0,9999,223
1745825768753,ECE 45,A01,892618,Staff,0,13,50,50
1745825769787,ECE 109,A01,892620,Staff,0,43,0,0
1745825770819,ECE 111,A01,892719,Staff,0,9,50,50
1745825771848,ECE 197,001,957920,Mercier; Patrick Philip,9992,0,9999,7
1745825772883,ECON 178,A01,907814,Zhu; Ying,28,0,35,7
1745825773912,EDS 115,A00,895312,Staff,41,0,45,4
1745825774941,EDS 117,A01,895337,Staff,30,0,30,0
1745825775973,EDS 125,A00,895341,Jones; Gabrielle Anastasia,43,0,45,2
1745825777005,EDS 128A,A01,895459,Fargason; Sharon Gayle,44,0,45,1
1745825778034,EDS 128B,A01,895543,Pappas; Elizabeth,44,0,45,1
1745825779066,EDS 139,A00,897203,Pappas; Elizabeth,44,0,45,1
1745825779066,EDS 139,B00,897209,Fargason; Sharon Gayle,44,0,45,1
1745825780099,EDS 201,A00,895545,Staff,43,0,45,2
1745825781132,EDS 203,A01,895581,Halter; Christopher P.,43,0,45,2
1745825782159,EDS 204R,A01,895625,Heinzman; Erica M.,43,0,45,2
1745825782159,EDS 204R,B01,895693,Halter; Christopher P.,18,0,45,27
1745825783194,EDS 206R,A00,895694,Fargason; Sharon Gayle,9,0,30,21
1745825783194,EDS 206R,B00,895695,Choi; Bailey Miyeon,20,0,30,10
1745825784224,EDS 250,A00,895697,Hemans; Patricia Ann Benitez,43,0,45,2
1745825785251,EDS 281,A00,895701,Meyerott; Theresa Ann,15,0,15,0
1745825786278,EDS 284,A00,895736,Meyerott; Theresa Ann,15,0,15,0
1745825787304,EDS 286,A00,897210,Fine; Sarah,15,0,15,0
1745825788334,EDS 289C,A01,895770,Daly; Alan J.,15,0,15,0
1745825789364,EDS 290,A00,897211,Hofstetter; Carolyn,15,0,15,0
1745825790394,LIGM 5A,A00,896162,Fischer-Grunski; Eva K,15,0,20,5
1745825791423,LIGM 5B,A00,896260,Fischer-Grunski; Eva K,17,0,20,3
1745825792463,LIGM 5C,A00,896308,Fischer-Grunski; Eva K,18,0,20,2
1745825793496,LIIT 5AS,A00,896313,Carnelos; Chiara,17,0,20,3
1745825794534,LIIT 5BS,A00,896416,Carnelos; Chiara,20,0,20,0
1745825795567,LIIT 5CS,A00,896564,Carnelos; Chiara,20,0,20,0
1745825796593,LISP 5A,A00,896588,Munoz Sanchez; Alicia,4,0,20,16
1745825797621,LISP 5B,A00,896653,Munoz Sanchez; Alicia,10,0,20,10
1745825798651,LISP 5C,A00,896655,Munoz Sanchez; Alicia,4,0,20,16
1745825799682,MAE 197,001,957918,Kleissl; Jan,9998,0,9999,1
1745825800712,MATH 2,A01,957937,Staff,34,0,35,1
1745825801742,MATH 197,001,957876,Kedlaya; Kiran S.,9993,0,9999,6
1745825802769,MCWP 40,A00,892729,Duru; Nur,13,0,20,7
1745825802769,MCWP 40,B00,893304,Montejo; Carolina,20,0,20,0
1745825803793,MCWP 40R,A00,893757,Redela; Pamela Morgan,0,7,20,20
1745825804820,MCWP 50,A00,893758,Morshed; Michael James,2,0,20,18
1745825804820,MCWP 50,B00,893761,Bartulis; Jason Michael,18,0,20,2
1745825805849,MCWP 50R,A00,893766,Compas; Sean Matthew,0,1,20,20
1745825805849,MCWP 50R,B00,893769,Carter; Jennifer A,0,0,20,20
1745825805849,MCWP 50R,C00,893771,Krone; Jarret,0,3,20,20
1745825805849,MCWP 50R,D00,893772,Miller; Elizabeth Deen,3,0,20,17
1745825805849,MCWP 50R,E00,893775,Carter; Andrea L,0,0,20,20
1745825806879,MMW 11R,A01,892721,Herbst; Matthew,11,0,27,16
1745825806879,MMW 11R,A02,892722,Herbst; Matthew,0,0,0,3
1745825807908,MMW 12R,A01,892724,Herbst; Matthew,0,10,16,16
1745825807908,MMW 12R,A02,892725,Herbst; Matthew,0,9,16,16
1745825808934,MMW 13R,A01,892727,Staff,0,3,16,16
1745825808934,MMW 13R,A02,892728,Staff,0,4,16,16
1745825808934,MMW 13R,A03,958032,Staff,0,3,16,16
1745825808934,MMW 13R,A04,958033,Staff,0,2,16,16
1745825808934,MMW 13R,A05,958034,Staff,0,3,16,16
1745825809965,SIO 295LS,A00,894015,Staff,7,0,25,18
1745825810992,SIO 295S,A00,894020,Staff,7,0,25,18
1745825812018,SIOC 290S,B01,958918,Staff,0,0,0,0
1745825813049,SIOC 291S,B01,958922,Staff,0,0,0,0
1745825814079,SOCI 117,A01,895339,Staff,4,0,5,1
1745825815109,WES 237B,A00,894149,Staff,11,0,20,9
1745825817190,AESE 279B,A00,891859,Staff,13,0,35,22
1745825818217,AIP 197,001,891854,Staff,70,0,70,0
1745825819254,ANTH 289S,A00,891856,Gagneux; Pascal,12,0,12,0
1745825820284,BENG 196,001,957946,Engler; Adam J.,9996,0,9999,3
1745825821313,CAT 124RS,A01,956906,Staff,8,0,25,17
1745825822345,CAT 125RS,A01,922013,Staff,8,0,25,17
1745825823375,CLRE 250,A00,891860,Morris; Sheldon,9995,0,9999,4
1745825825434,CLRE 251R,A00,907817,Mehta; Ravindra L.,9994,0,9999,5
1745825826467,CLRE 252,A00,891864,Cuomo; Raphael Eduardo,9993,0,9999,6
1745825827498,CLRE 253,A00,891867,Vaida; Florin,9994,0,9999,5
1745825827498,CLRE 253,B00,907819,Staff,9999,0,9999,0
1745825828529,CLRE 259,A00,891868,Patel; Hemal,9998,0,9999,1
1745825829561,CLRE 260,A00,891872,Cuomo; Raphael Eduardo,9999,0,9999,0
1745825830594,CLRE 297,001,891888,Cuomo; Raphael Eduardo,9999,0,9999,0
1745825831626,CSE 191,A00,958773,Minnes Kemp; Mor Mia,9999,0,9999,0
1745825832658,CSS 201S,A01,892054,Mignozzetti; Umberto,30,0,30,0
1745825833693,CSS 202S,A01,892056,Mignozzetti; Umberto,30,0,30,0
1745825834721,DSC 197,001,956898,Eldridge; Justin Matthew,9998,0,9999,1
1745825835750,DSC 297,001,958000,Mazumdar; Arya,9998,0,9999,1
1745825836780,EAP 100,A00,905686,Staff,9776,0,9999,223
1745825837807,ECE 45,A01,892618,Staff,0,13,50,50
1745825838836,ECE 109,A01,892620,Staff,0,43,0,0
1745825839865,ECE 111,A01,892719,Staff,0,9,50,50
1745825840894,ECE 197,001,957920,Mercier; Patrick Philip,9992,0,9999,7
1745825841925,ECON 178,A01,907814,Zhu; Ying,28,0,35,7
1745825842959,EDS 115,A00,895312,Staff,41,0,45,4
1745825843988,EDS 117,A01,895337,Staff,30,0,30,0
1745825845049,EDS 125,A00,895341,Jones; Gabrielle Anastasia,43,0,45,2
1745825846077,EDS 128A,A01,895459,Fargason; Sharon Gayle,44,0,45,1
1745825847108,EDS 128B,A01,895543,Pappas; Elizabeth,44,0,45,1
1745825848137,EDS 139,A00,897203,Pappas; Elizabeth,44,0,45,1
1745825848137,EDS 139,B00,897209,Fargason; Sharon Gayle,44,0,45,1
1745825849164,EDS 201,A00,895545,Staff,43,0,45,2
1745825850196,EDS 203,A01,895581,Halter; Christopher P.,43,0,45,2
1745825851222,EDS 204R,A01,895625,Heinzman; Erica M.,43,0,45,2
1745825851222,EDS 204R,B01,895693,Halter; Christopher P.,18,0,45,27
1745825852248,EDS 206R,A00,895694,Fargason; Sharon Gayle,9,0,30,21
1745825852248,EDS 206R,B00,895695,Choi; Bailey Miyeon,20,0,30,10
1745825853278,EDS 250,A00,895697,Hemans; Patricia Ann Benitez,43,0,45,2
1745825854307,EDS 281,A00,895701,Meyerott; Theresa Ann,15,0,15,0
1745825855332,EDS 284,A00,895736,Meyerott; Theresa Ann,15,0,15,0
1745825856362,EDS 286,A00,897210,Fine; Sarah,15,0,15,0
1745825857388,EDS 289C,A01,895770,Daly; Alan J.,15,0,15,0
1745825858413,EDS 290,A00,897211,Hofstetter; Carolyn,15,0,15,0
1745825859440,LIGM 5A,A00,896162,Fischer-Grunski; Eva K,15,0,20,5
1745825860470,LIGM 5B,A00,896260,Fischer-Grunski; Eva K,17,0,20,3
1745825861496,LIGM 5C,A00,896308,Fischer-Grunski; Eva K,18,0,20,2
1745825862528,LIIT 5AS,A00,896313,Carnelos; Chiara,17,0,20,3
1745825863557,LIIT 5BS,A00,896416,Carnelos; Chiara,20,0,20,0
1745825864584,LIIT 5CS,A00,896564,Carnelos; Chiara,20,0,20,0
1745825865616,LISP 5A,A00,896588,Munoz Sanchez; Alicia,4,0,20,16
1745825866676,LISP 5B,A00,896653,Munoz Sanchez; Alicia,10,0,20,10
1745825867701,LISP 5C,A00,896655,Munoz Sanchez; Alicia,4,0,20,16
1745825868730,MAE 197,001,957918,Kleissl; Jan,9998,0,9999,1
1745825869754,MATH 2,A01,957937,Staff,34,0,35,1
1745825870781,MATH 197,001,957876,Kedlaya; Kiran S.,9993,0,9999,6
1745825871806,MCWP 40,A00,892729,Duru; Nur,13,0,20,7
1745825871806,MCWP 40,B00,893304,Montejo; Carolina,20,0,20,0
1745825872831,MCWP 40R,A00,893757,Redela; Pamela Morgan,0,7,20,20
1745825873858,MCWP 50,A00,893758,Morshed; Michael James,2,0,20,18
1745825873858,MCWP 50,B00,893761,Bartulis; Jason Michael,18,0,20,2
1745825874882,MCWP 50R,A00,893766,Compas; Sean Matthew,0,1,20,20
1745825874882,MCWP 50R,B00,893769,Carter; Jennifer A,0,0,20,20
1745825874882,MCWP 50R,C00,893771,Krone; Jarret,0,3,20,20
1745825874882,MCWP 50R,D00,893772,Miller; Elizabeth Deen,3,0,20,17
1745825874882,MCWP 50R,E00,893775,Carter; Andrea L,0,0,20,20
1745825875917,MMW 11R,A01,892721,Herbst; Matthew,11,0,27,16
1745825875917,MMW 11R,A02,892722,Herbst; Matthew,0,0,0,3
1745825876943,MMW 12R,A01,892724,Herbst; Matthew,0,10,16,16
1745825876943,MMW 12R,A02,892725,Herbst; Matthew,0,9,16,16
1745825877969,MMW 13R,A01,892727,Staff,0,3,16,16
1745825877969,MMW 13R,A02,892728,Staff,0,4,16,16
1745825877969,MMW 13R,A03,958032,Staff,0,3,16,16
1745825877969,MMW 13R,A04,958033,Staff,0,2,16,16
1745825877969,MMW 13R,A05,958034,Staff,0,3,16,16
1745825879000,SIO 295LS,A00,894015,Staff,7,0,25,18
1745825880027,SIO 295S,A00,894020,Staff,7,0,25,18
1745825881057,SIOC 290S,B01,958918,Staff,0,0,0,0
1745825882090,SIOC 291S,B01,958922,Staff,0,0,0,0
1745825883117,SOCI 117,A01,895339,Staff,4,0,5,1
1745825884142,WES 237B,A00,894149,Staff,11,0,20,9
1745825886221,AESE 279B,A00,891859,Staff,13,0,35,22
1745825887244,AIP 197,001,891854,Staff,70,0,70,0
1745825888273,ANTH 289S,A00,891856,Gagneux; Pascal,12,0,12,0
1745825889298,BENG 196,001,957946,Engler; Adam J.,9996,0,9999,3
1745825890322,CAT 124RS,A01,956906,Staff,8,0,25,17
1745825891348,CAT 125RS,A01,922013,Staff,8,0,25,17
1745825892381,CLRE 250,A00,891860,Morris; Sheldon,9995,0,9999,4
1745825894433,CLRE 251R,A00,907817,Mehta; Ravindra L.,9994,0,9999,5
1745825895458,CLRE 252,A00,891864,Cuomo; Raphael Eduardo,9993,0,9999,6
1745825896485,CLRE 253,A00,891867,Vaida; Florin,9994,0,9999,5
1745825896485,CLRE 253,B00,907819,Staff,9999,0,9999,0
1745825897508,CLRE 259,A00,891868,Patel; Hemal,9998,0,9999,1
1745825898533,CLRE 260,A00,891872,Cuomo; Raphael Eduardo,9999,0,9999,0
1745825899559,CLRE 297,001,891888,Cuomo; Raphael Eduardo,9999,0,9999,0
1745825900586,CSE 191,A00,958773,Minnes Kemp; Mor Mia,9999,0,9999,0
1745825901612,CSS 201S,A01,892054,Mignozzetti; Umberto,30,0,30,0
1745825902640,CSS 202S,A01,892056,Mignozzetti; Umberto,30,0,30,0
1745825903673,DSC 197,001,956898,Eldridge; Justin Matthew,9998,0,9999,1
1745825904700,DSC 297,001,958000,Mazumdar; Arya,9998,0,9999,1
1745825905730,EAP 100,A00,905686,Staff,9776,0,9999,223
1745825906759,ECE 45,A01,892618,Staff,0,13,50,50
1745825907786,ECE 109,A01,892620,Staff,0,43,0,0
1745825908818,ECE 111,A01,892719,Staff,0,9,50,50
1745825909849,ECE 197,001,957920,Mercier; Patrick Philip,9992,0,9999,7
1745825910879,ECON 178,A01,907814,Zhu; Ying,28,0,35,7
1745825911905,EDS 115,A00,895312,Staff,41,0,45,4
1745825912932,EDS 117,A01,895337,Staff,30,0,30,0
1745825913961,EDS 125,A00,895341,Jones; Gabrielle Anastasia,43,0,45,2
1745825914997,EDS 128A,A01,895459,Fargason; Sharon Gayle,44,0,45,1
1745825916029,EDS 128B,A01,895543,Pappas; Elizabeth,44,0,45,1
1745825917053,EDS 139,A00,897203,Pappas; Elizabeth,44,0,45,1
1745825917053,EDS 139,B00,897209,Fargason; Sharon Gayle,44,0,45,1
1745825918079,EDS 201,A00,895545,Staff,43,0,45,2
1745825919103,EDS 203,A01,895581,Halter; Christopher P.,43,0,45,2
1745825920130,EDS 204R,A01,895625,Heinzman; Erica M.,43,0,45,2
1745825920130,EDS 204R,B01,895693,Halter; Christopher P.,18,0,45,27
1745825921157,EDS 206R,A00,895694,Fargason; Sharon Gayle,9,0,30,21
1745825921157,EDS 206R,B00,895695,Choi; Bailey Miyeon,20,0,30,10
1745825922190,EDS 250,A00,895697,Hemans; Patricia Ann Benitez,43,0,45,2
1745825923217,EDS 281,A00,895701,Meyerott; Theresa Ann,15,0,15,0
1745825924245,EDS 284,A00,895736,Meyerott; Theresa Ann,15,0,15,0
1745825925270,EDS 286,A00,897210,Fine; Sarah,15,0,15,0
1745825926297,EDS 289C,A01,895770,Daly; Alan J.,15,0,15,0
1745825927325,EDS 290,A00,897211,Hofstetter; Carolyn,15,0,15,0
1745825928351,LIGM 5A,A00,896162,Fischer-Grunski; Eva K,15,0,20,5
1745825929379,LIGM 5B,A00,896260,Fischer-Grunski; Eva K,17,0,20,3
1745825930415,LIGM 5C,A00,896308,Fischer-Grunski; Eva K,18,0,20,2
1745825931445,LIIT 5AS,A00,896313,Carnelos; Chiara,17,0,20,3
1745825932477,LIIT 5BS,A00,896416,Carnelos; Chiara,20,0,20,0
1745825933501,LIIT 5CS,A00,896564,Carnelos; Chiara,20,0,20,0
1745825934527,LISP 5A,A00,896588,Munoz Sanchez; Alicia,4,0,20,16
1745825935553,LISP 5B,A00,896653,Munoz Sanchez; Alicia,10,0,20,10
1745825936583,LISP 5C,A00,896655,Munoz Sanchez; Alicia,4,0,20,16
1745825937609,MAE 197,001,957918,Kleissl; Jan,9998,0,9999,1
1745825938635,MATH 2,A01,957937,Staff,34,0,35,1
1745825939661,MATH 197,001,957876,Kedlaya; Kiran S.,9993,0,9999,6
1745825940686,MCWP 40,A00,892729,Duru; Nur,13,0,20,7
1745825940686,MCWP 40,B00,893304,Montejo; Carolina,20,0,20,0
1745825941719,MCWP 40R,A00,893757,Redela; Pamela Morgan,0,7,20,20
1745825942745,MCWP 50,A00,893758,Morshed; Michael James,2,0,20,18
1745825942745,MCWP 50,B00,893761,Bartulis; Jason Michael,18,0,20,2
1745825943785,MCWP 50R,A00,893766,Compas; Sean Matthew,0,1,20,20
1745825943785,MCWP 50R,B00,893769,Carter; Jennifer A,0,0,20,20
1745825943785,MCWP 50R,C00,893771,Krone; Jarret,0,3,20,20
1745825943785,MCWP 50R,D00,893772,Miller; Elizabeth Deen,3,0,20,17
1745825943785,MCWP 50R,E00,893775,Carter; Andrea L,0,0,20,20
1745825944816,MMW 11R,A01,892721,Herbst; Matthew,11,0,27,16
1745825944816,MMW 11R,A02,892722,Herbst; Matthew,0,0,0,3
1745825945845,MMW 12R,A01,892724,Herbst; Matthew,0,10,16,16
1745825945845,MMW 12R,A02,892725,Herbst; Matthew,0,9,16,16
1745825946872,MMW 13R,A01,892727,Staff,0,3,16,16
1745825946872,MMW 13R,A02,892728,Staff,0,4,16,16
1745825946872,MMW 13R,A03,958032,Staff,0,3,16,16
1745825946872,MMW 13R,A04,958033,Staff,0,2,16,16
1745825946872,MMW 13R,A05,958034,Staff,0,3,16,16
1745825947902,SIO 295LS,A00,894015,Staff,7,0,25,18
1745825948932,SIO 295S,A00,894020,Staff,7,0,25,18
1745825949958,SIOC 290S,B01,958918,Staff,0,0,0,0
1745825950989,SIOC 291S,B01,958922,Staff,0,0,0,0
1745825952021,SOCI 117,A01,895339,Staff,4,0,5,1
1745825953047,WES 237B,A00,894149,Staff,11,0,20,9
1745825955124,AESE 279B,A00,891859,Staff,13,0,35,22
1745825956156,AIP 197,001,891854,Staff,70,0,70,0
1745825957184,ANTH 289S,A00,891856,Gagneux; Pascal,12,0,12,0
1745825958209,BENG 196,001,957946,Engler; Adam J.,9996,0,9999,3
1745825959236,CAT 124RS,A01,956906,Staff,8,0,25,17
1745825960268,CAT 125RS,A01,922013,Staff,8,0,25,17
1745825961297,CLRE 250,A00,891860,Morris; Sheldon,9995,0,9999,4
1745825963352,CLRE 251R,A00,907817,Mehta; Ravindra L.,9994,0,9999,5
1745825964381,CLRE 252,A00,891864,Cuomo; Raphael Eduardo,9993,0,9999,6
1745825965410,CLRE 253,A00,891867,Vaida; Florin,9994,0,9999,5
1745825965410,CLRE 253,B00,907819,Staff,9999,0,9999,0
1745825966437,CLRE 259,A00,891868,Patel; Hemal,9998,0,9999,1
1745825967464,CLRE 260,A00,891872,Cuomo; Raphael Eduardo,9999,0,9999,0
1745825968490,CLRE 297,001,891888,Cuomo; Raphael Eduardo,9999,0,9999,0
1745825969517,CSE 191,A00,958773,Minnes Kemp; Mor Mia,9999,0,9999,0
1745825970546,CSS 201S,A01,892054,Mignozzetti; Umberto,30,0,30,0
1745825971578,CSS 202S,A01,892056,Mignozzetti; Umberto,30,0,30,0
1745825972606,DSC 197,001,956898,Eldridge; Justin Matthew,9998,0,9999,1
1745825973632,DSC 297,001,958000,Mazumdar; Arya,9998,0,9999,1
1745825974667,EAP 100,A00,905686,Staff,9776,0,9999,223
1745825975698,ECE 45,A01,892618,Staff,0,13,50,50
1745825976724,ECE 109,A01,892620,Staff,0,43,0,0
1745825977749,ECE 111,A01,892719,Staff,0,9,50,50
1745825978777,ECE 197,001,957920,Mercier; Patrick Philip,9992,0,9999,7
1745825979816,ECON 178,A01,907814,Zhu; Ying,28,0,35,7
1745825980854,EDS 115,A00,895312,Staff,41,0,45,4
1745825981885,EDS 117,A01,895337,Staff,30,0,30,0
1745825982913,EDS 125,A00,895341,Jones; Gabrielle Anastasia,43,0,45,2
1745825983946,EDS 128A,A01,895459,Fargason; Sharon Gayle,44,0,45,1
1745825984976,EDS 128B,A01,895543,Pappas; Elizabeth,44,0,45,1
1745825986004,EDS 139,A00,897203,Pappas; Elizabeth,44,0,45,1
1745825986004,EDS 139,B00,897209,Fargason; Sharon Gayle,44,0,45,1
1745825987035,EDS 201,A00,895545,Staff,43,0,45,2
1745825988064,EDS 203,A01,895581,Halter; Christopher P.,43,0,45,2
1745825989100,EDS 204R,A01,895625,Heinzman; Erica M.,43,0,45,2
1745825989100,EDS 204R,B01,895693,Halter; Christopher P.,18,0,45,27
1745825990127,EDS 206R,A00,895694,Fargason; Sharon Gayle,9,0,30,21
1745825990127,EDS 206R,B00,895695,Choi; Bailey Miyeon,20,0,30,10
1745825991153,EDS 250,A00,895697,Hemans; Patricia Ann Benitez,43,0,45,2
1745825992181,EDS 281,A00,895701,Meyerott; Theresa Ann,15,0,15,0
1745825993212,EDS 284,A00,895736,Meyerott; Theresa Ann,15,0,15,0
1745825994239,EDS 286,A00,897210,Fine; Sarah,15,0,15,0
1745825995268,EDS 289C,A01,895770,Daly; Alan J.,15,0,15,0
1745825996298,EDS 290,A00,897211,Hofstetter; Carolyn,15,0,15,0
1745825997325,LIGM 5A,A00,896162,Fischer-Grunski; Eva K,15,0,20,5
1745825998351,LIGM 5B,A00,896260,Fischer-Grunski; Eva K,17,0,20,3
1745825999377,LIGM 5C,A00,896308,Fischer-Grunski; Eva K,18,0,20,2
1745826000432,LIIT 5AS,A00,896313,Carnelos; Chiara,17,0,20,3
1745826001458,LIIT 5BS,A00,896416,Carnelos; Chiara,20,0,20,0
1745826002490,LIIT 5CS,A00,896564,Carnelos; Chiara,20,0,20,0
1745826003519,LISP 5A,A00,896588,Munoz Sanchez; Alicia,4,0,20,16
1745826004547,LISP 5B,A00,896653,Munoz Sanchez; Alicia,10,0,20,10
1745826005573,LISP 5C,A00,896655,Munoz Sanchez; Alicia,4,0,20,16
1745826006602,MAE 197,001,957918,Kleissl; Jan,9998,0,9999,1
1745826007630,MATH 2,A01,957937,Staff,34,0,35,1
1745826008661,MATH 197,001,957876,Kedlaya; Kiran S.,9993,0,9999,6
1745826009687,MCWP 40,A00,892729,Duru; Nur,13,0,20,7
1745826009687,MCWP 40,B00,893304,Montejo; Carolina,20,0,20,0
1745826010713,MCWP 40R,A00,893757,Redela; Pamela Morgan,0,7,20,20
1745826011739,MCWP 50,A00,893758,Morshed; Michael James,2,0,20,18
1745826011739,MCWP 50,B00,893761,Bartulis; Jason Michael,18,0,20,2
1745826012769,MCWP 50R,A00,893766,Compas; Sean Matthew,0,1,20,20
1745826012769,MCWP 50R,B00,893769,Carter; Jennifer A,0,0,20,20
1745826012769,MCWP 50R,C00,893771,Krone; Jarret,0,3,20,20
1745826012769,MCWP 50R,D00,893772,Miller; Elizabeth Deen,3,0,20,17
1745826012769,MCWP 50R,E00,893775,Carter; Andrea L,0,0,20,20
1745826013796,MMW 11R,A01,892721,Herbst; Matthew,11,0,27,16
1745826013796,MMW 11R,A02,892722,Herbst; Matthew,0,0,0,3
1745826014821,MMW 12R,A01,892724,Herbst; Matthew,0,10,16,16
1745826014821,MMW 12R,A02,892725,Herbst; Matthew,0,9,16,16
1745826015849,MMW 13R,A01,892727,Staff,0,3,16,16
1745826015849,MMW 13R,A02,892728,Staff,0,4,16,16
1745826015849,MMW 13R,A03,958032,Staff,0,3,16,16
1745826015849,MMW 13R,A04,958033,Staff,0,2,16,16
1745826015849,MMW 13R,A05,958034,Staff,0,3,16,16
1745826016877,SIO 295LS,A00,894015,Staff,7,0,25,18
1745826017905,SIO 295S,A00,894020,Staff,7,0,25,18
1745826018959,SIOC 290S,B01,958918,Staff,0,0,0,0
1745826019990,SIOC 291S,B01,958922,Staff,0,0,0,0
1745826021019,SOCI 117,A01,895339,Staff,4,0,5,1
1745826022045,WES 237B,A00,894149,Staff,11,0,20,9
1745826024126,AESE 279B,A00,891859,Staff,13,0,35,22
1745826025153,AIP 197,001,891854,Staff,70,0,70,0
1745826026179,ANTH 289S,A00,891856,Gagneux; Pascal,12,0,12,0
1745826027204,BENG 196,001,957946,Engler; Adam J.,9996,0,9999,3
1745826028229,CAT 124RS,A01,956906,Staff,8,0,25,17
1745826029254,CAT 125RS,A01,922013,Staff,8,0,25,17
1745826030280,CLRE 250,A00,891860,Morris; Sheldon,9995,0,9999,4
1745826032337,CLRE 251R,A00,907817,Mehta; Ravindra L.,9994,0,9999,5
1745826033366,CLRE 252,A00,891864,Cuomo; Raphael Eduardo,9993,0,9999,6
1745826034395,CLRE 253,A00,891867,Vaida; Florin,9994,0,9999,5
1745826034395,CLRE 253,B00,907819,Staff,9999,0,9999,0
1745826035421,CLRE 259,A00,891868,Patel; Hemal,9998,0,9999,1
1745826036446,CLRE 260,A00,891872,Cuomo; Raphael Eduardo,9999,0,9999,0
1745826037472,CLRE 297,001,891888,Cuomo; Raphael Eduardo,9999,0,9999,0
1745826038497,CSE 191,A00,958773,Minnes Kemp; Mor Mia,9999,0,9999,0
1745826039523,CSS 201S,A01,892054,Mignozzetti; Umberto,30,0,30,0
1745826040549,CSS 202S,A01,892056,Mignozzetti; Umberto,30,0,30,0
1745826041580,DSC 197,001,956898,Eldridge; Justin Matthew,9998,0,9999,1
1745826042608,DSC 297,001,958000,Mazumdar; Arya,9998,0,9999,1
1745826043633,EAP 100,A00,905686,Staff,9776,0,9999,223
1745826044658,ECE 45,A01,892618,Staff,0,13,50,50
1745826045687,ECE 109,A01,892620,Staff,0,43,0,0
1745826046711,ECE 111,A01,892719,Staff,0,9,50,50
1745826047736,ECE 197,001,957920,Mercier; Patrick Philip,9992,0,9999,7
1745826048762,ECON 178,A01,907814,Zhu; Ying,28,0,35,7
1745826049789,EDS 115,A00,895312,Staff,41,0,45,4
1745826050814,EDS 117,A01,895337,Staff,30,0,30,0
1745826051846,EDS 125,A00,895341,Jones; Gabrielle Anastasia,43,0,45,2
1745826052873,EDS 128A,A01,895459,Fargason; Sharon Gayle,44,0,45,1
1745826053905,EDS 128B,A01,895543,Pappas; Elizabeth,44,0,45,1
1745826054934,EDS 139,A00,897203,Pappas; Elizabeth,44,0,45,1
1745826054934,EDS 139,B00,897209,Fargason; Sharon Gayle,44,0,45,1
1745826055963,EDS 201,A00,895545,Staff,43,0,45,2
1745826056993,EDS 203,A01,895581,Halter; Christopher P.,43,0,45,2
1745826058025,EDS 204R,A01,895625,Heinzman; Erica M.,43,0,45,2
1745826058025,EDS 204R,B01,895693,Halter; Christopher P.,18,0,45,27
1745826059050,EDS 206R,A00,895694,Fargason; Sharon Gayle,9,0,30,21
1745826059050,EDS 206R,B00,895695,Choi; Bailey Miyeon,20,0,30,10
1745826060087,EDS 250,A00,895697,Hemans; Patricia Ann Benitez,43,0,45,2
1745826061117,EDS 281,A00,895701,Meyerott; Theresa Ann,15,0,15,0
1745826062148,EDS 284,A00,895736,Meyerott; Theresa Ann,15,0,15,0
1745826063173,EDS 286,A00,897210,Fine; Sarah,15,0,15,0
1745826064200,EDS 289C,A01,895770,Daly; Alan J.,15,0,15,0
1745826065238,EDS 290,A00,897211,Hofstetter; Carolyn,15,0,15,0
1745826066263,LIGM 5A,A00,896162,Fischer-Grunski; Eva K,15,0,20,5
1745826067293,LIGM 5B,A00,896260,Fischer-Grunski; Eva K,17,0,20,3
1745826068322,LIGM 5C,A00,896308,Fischer-Grunski; Eva K,18,0,20,2
1745826069373,LIIT 5AS,A00,896313,Carnelos; Chiara,17,0,20,3
1745826070405,LIIT 5BS,A00,896416,Carnelos; Chiara,20,0,20,0
1745826071431,LIIT 5CS,A00,896564,Carnelos; Chiara,20,0,20,0
1745826072461,LISP 5A,A00,896588,Munoz Sanchez; Alicia,4,0,20,16
1745826073486,LISP 5B,A00,896653,Munoz Sanchez; Alicia,10,0,20,10
1745826074512,LISP 5C,A00,896655,Munoz Sanchez; Alicia,4,0,20,16
1745826075539,MAE 197,001,957918,Kleissl; Jan,9998,0,9999,1
1745826076564,MATH 2,A01,957937,Staff,34,0,35,1
1745826077588,MATH 197,001,957876,Kedlaya; Kiran S.,9993,0,9999,6
1745826078621,MCWP 40,A00,892729,Duru; Nur,13,0,20,7
1745826078621,MCWP 40,B00,893304,Montejo; Carolina,20,0,20,0
1745826079646,MCWP 40R,A00,893757,Redela; Pamela Morgan,0,7,20,20
1745826080673,MCWP 50,A00,893758,Morshed; Michael James,2,0,20,18
1745826080673,MCWP 50,B00,893761,Bartulis; Jason Michael,18,0,20,2
1745826081705,MCWP 50R,A00,893766,Compas; Sean Matthew,0,1,20,20
1745826081705,MCWP 50R,B00,893769,Carter; Jennifer A,0,0,20,20
1745826081705,MCWP 50R,C00,893771,Krone; Jarret,0,3,20,20
1745826081705,MCWP 50R,D00,893772,Miller; Elizabeth Deen,3,0,20,17
1745826081705,MCWP 50R,E00,893775,Carter; Andrea L,0,0,20,20
1745826082735,MMW 11R,A01,892721,Herbst; Matthew,11,0,27,16
1745826082735,MMW 11R,A02,892722,Herbst; Matthew,0,0,0,3
1745826083761,MMW 12R,A01,892724,Herbst; Matthew,0,10,16,16
1745826083761,MMW 12R,A02,892725,Herbst; Matthew,0,9,16,16
1745826084789,MMW 13R,A01,892727,Staff,0,3,16,16
1745826084789,MMW 13R,A02,892728,Staff,0,4,16,16
1745826084789,MMW 13R,A03,958032,Staff,0,3,16,16
1745826084789,MMW 13R,A04,958033,Staff,0,2,16,16
1745826084789,MMW 13R,A05,958034,Staff,0,3,16,16
1745826085819,SIO 295LS,A00,894015,Staff,7,0,25,18
1745826086846,SIO 295S,A00,894020,Staff,7,0,25,18
1745826087877,SIOC 290S,B01,958918,Staff,0,0,0,0
1745826088905,SIOC 291S,B01,958922,Staff,0,0,0,0
1745826089932,SOCI 117,A01,895339,Staff,4,0,5,1
1745826090961,WES 237B,A00,894149,Staff,11,0,20,9
1745826093023,AESE 279B,A00,891859,Staff,13,0,35,22
1745826094050,AIP 197,001,891854,Staff,70,0,70,0
1745826095077,ANTH 289S,A00,891856,Gagneux; Pascal,12,0,12,0
1745826096104,BENG 196,001,957946,Engler; Adam J.,9996,0,9999,3
1745826097136,CAT 124RS,A01,956906,Staff,8,0,25,17
1745826098167,CAT 125RS,A01,922013,Staff,8,0,25,17
1745826099193,CLRE 250,A00,891860,Morris; Sheldon,9995,0,9999,4
1745826101245,CLRE 251R,A00,907817,Mehta; Ravindra L.,9994,0,9999,5
1745826102270,CLRE 252,A00,891864,Cuomo; Raphael Eduardo,9993,0,9999,6
1745826103297,CLRE 253,A00,891867,Vaida; Florin,9994,0,9999,5
1745826103297,CLRE 253,B00,907819,Staff,9999,0,9999,0
1745826104326,CLRE 259,A00,891868,Patel; Hemal,9998,0,9999,1
1745826105352,CLRE 260,A00,891872,Cuomo; Raphael Eduardo,9999,0,9999,0
1745826106379,CLRE 297,001,891888,Cuomo; Raphael Eduardo,9999,0,9999,0
1745826107410,CSE 191,A00,958773,Minnes Kemp; Mor Mia,9999,0,9999,0
1745826108442,CSS 201S,A01,892054,Mignozzetti; Umberto,30,0,30,0
1745826109473,CSS 202S,A01,892056,Mignozzetti; Umberto,30,0,30,0
1745826110501,DSC 197,001,956898,Eldridge; Justin Matthew,9998,0,9999,1
1745826111531,DSC 297,001,958000,Mazumdar; Arya,9998,0,9999,1
1745826112560,EAP 100,A00,905686,Staff,9776,0,9999,223
1745826113585,ECE 45,A01,892618,Staff,0,13,50,50
1745826114611,ECE 109,A01,892620,Staff,0,43,0,0
1745826115641,ECE 111,A01,892719,Staff,0,9,50,50
1745826116664,ECE 197,001,957920,Mercier; Patrick Philip,9992,0,9999,7
1745826117697,ECON 178,A01,907814,Zhu; Ying,28,0,35,7
1745826118725,EDS 115,A00,895312,Staff,41,0,45,4
1745826119757,EDS 117,A01,895337,Staff,30,0,30,0
1745826120783,EDS 125,A00,895341,Jones; Gabrielle Anastasia,43,0,45,2
1745826121812,EDS 128A,A01,895459,Fargason; Sharon Gayle,44,0,45,1
1745826122839,EDS 128B,A01,895543,Pappas; Elizabeth,44,0,45,1
1745826123873,EDS 139,A00,897203,Pappas; Elizabeth,44,0,45,1
1745826123873,EDS 139,B00,897209,Fargason; Sharon Gayle,44,0,45,1
1745826124900,EDS 201,A00,895545,Staff,43,0,45,2
1745826125924,EDS 203,A01,895581,Halter; Christopher P.,43,0,45,2
1745826126952,EDS 204R,A01,895625,Heinzman; Erica M.,43,0,45,2
1745826126952,EDS 204R,B01,895693,Halter; Christopher P.,18,0,45,27
1745826127979,EDS 206R,A00,895694,Fargason; Sharon Gayle,9,0,30,21
1745826127979,EDS 206R,B00,895695,Choi; Bailey Miyeon,20,0,30,10
1745826129007,EDS 250,A00,895697,Hemans; Patricia Ann Benitez,43,0,45,2
1745826130037,EDS 281,A00,895701,Meyerott; Theresa Ann,15,0,15,0
1745826131064,EDS 284,A00,895736,Meyerott; Theresa Ann,15,0,15,0
1745826132096,EDS 286,A00,897210,Fine; Sarah,15,0,15,0
1745826133125,EDS 289C,A01,895770,Daly; Alan J.,15,0,15,0
1745826134150,EDS 290,A00,897211,Hofstetter; Carolyn,15,0,15,0
1745826135178,LIGM 5A,A00,896162,Fischer-Grunski; Eva K,15,0,20,5
1745826136211,LIGM 5B,A00,896260,Fischer-Grunski; Eva K,17,0,20,3
1745826137242,LIGM 5C,A00,896308,Fischer-Grunski; Eva K,18,0,20,2
1745826138268,LIIT 5AS,A00,896313,Carnelos; Chiara,17,0,20,3
1745826139295,LIIT 5BS,A00,896416,Carnelos; Chiara,20,0,20,0
1745826140322,LIIT 5CS,A00,896564,Carnelos; Chiara,20,0,20,0
1745826141351,LISP 5A,A00,896588,Munoz Sanchez; Alicia,4,0,20,16
1745826142393,LISP 5B,A00,896653,Munoz Sanchez; Alicia,10,0,20,10
1745826143421,LISP 5C,A00,896655,Munoz Sanchez; Alicia,4,0,20,16
1745826144448,MAE 197,001,957918,Kleissl; Jan,9998,0,9999,1
1745826145475,MATH 2,A01,957937,Staff,34,0,35,1
1745826146501,MATH 197,001,957876,Kedlaya; Kiran S.,9993,0,9999,6
1745826147526,MCWP 40,A00,892729,Duru; Nur,13,0,20,7
1745826147526,MCWP 40,B00,893304,Montejo; Carolina,20,0,20,0
1745826148553,MCWP 40R,A00,893757,Redela; Pamela Morgan,0,7,20,20
1745826149580,MCWP 50,A00,893758,Morshed; Michael James,2,0,20,18
1745826149580,MCWP 50,B00,893761,Bartulis; Jason Michael,18,0,20,2
1745826150621,MCWP 50R,A00,893766,Compas; Sean Matthew,0,1,20,20
1745826150621,MCWP 50R,B00,893769,Carter; Jennifer A,0,0,20,20
1745826150621,MCWP 50R,C00,893771,Krone; Jarret,0,3,20,20
1745826150621,MCWP 50R,D00,893772,Miller; Elizabeth Deen,3,0,20,17
1745826150621,MCWP 50R,E00,893775,Carter; Andrea L,0,0,20,20
1745826151650,MMW 11R,A01,892721,Herbst; Matthew,11,0,27,16
1745826151650,MMW 11R,A02,892722,Herbst; Matthew,0,0,0,3
1745826152675,MMW 12R,A01,892724,Herbst; Matthew,0,10,16,16
1745826152675,MMW 12R,A02,892725,Herbst; Matthew,0,9,16,16
1745826153703,MMW 13R,A01,892727,Staff,0,3,16,16
1745826153703,MMW 13R,A02,892728,Staff,0,4,16,16
1745826153703,MMW 13R,A03,958032,Staff,0,3,16,16
1745826153703,MMW 13R,A04,958033,Staff,0,2,16,16
1745826153703,MMW 13R,A05,958034,Staff,0,3,16,16
1745826154728,SIO 295LS,A00,894015,Staff,7,0,25,18
1745826155753,SIO 295S,A00,894020,Staff,7,0,25,18
1745826156782,SIOC 290S,B01,958918,Staff,0,0,0,0
1745826157810,SIOC 291S,B01,958922,Staff,0,0,0,0
1745826158836,SOCI 117,A01,895339,Staff,4,0,5,1
1745826159861,WES 237B,A00,894149,Staff,11,0,20,9
1745826161960,AESE 279B,A00,891859,Staff,13,0,35,22
1745826162985,AIP 197,001,891854,Staff,70,0,70,0
1745826164010,ANTH 289S,A00,891856,Gagneux; Pascal,12,0,12,0
1745826165055,BENG 196,001,957946,Engler; Adam J.,9996,0,9999,3
1745826166085,CAT 124RS,A01,956906,Staff,8,0,25,17
1745826167116,CAT 125RS,A01,922013,Staff,8,0,25,17
1745826168142,CLRE 250,A00,891860,Morris; Sheldon,9995,0,9999,4
1745826170201,CLRE 251R,A00,907817,Mehta; Ravindra L.,9994,0,9999,5
1745826171226,CLRE 252,A00,891864,Cuomo; Raphael Eduardo,9993,0,9999,6
1745826172255,CLRE 253,A00,891867,Vaida; Florin,9994,0,9999,5
1745826172255,CLRE 253,B00,907819,Staff,9999,0,9999,0
1745826173286,CLRE 259,A00,891868,Patel; Hemal,9998,0,9999,1
1745826174312,CLRE 260,A00,891872,Cuomo; Raphael Eduardo,9999,0,9999,0
1745826175338,CLRE 297,001,891888,Cuomo; Raphael Eduardo,9999,0,9999,0
1745826176369,CSE 191,A00,958773,Minnes Kemp; Mor Mia,9999,0,9999,0
1745826177399,CSS 201S,A01,892054,Mignozzetti; Umberto,30,0,30,0
1745826178425,CSS 202S,A01,892056,Mignozzetti; Umberto,30,0,30,0
1745826179453,DSC 197,001,956898,Eldridge; Justin Matthew,9998,0,9999,1
1745826180478,DSC 297,001,958000,Mazumdar; Arya,9998,0,9999,1
1745826181508,EAP 100,A00,905686,Staff,9776,0,9999,223
1745826182538,ECE 45,A01,892618,Staff,0,13,50,50
1745826183567,ECE 109,A01,892620,Staff,0,43,0,0
1745826184598,ECE 111,A01,892719,Staff,0,9,50,50
1745826185629,ECE 197,001,957920,Mercier; Patrick Philip,9992,0,9999,7
1745826186660,ECON 178,A01,907814,Zhu; Ying,28,0,35,7
1745826187688,EDS 115,A00,895312,Staff,41,0,45,4
1745826188714,EDS 117,A01,895337,Staff,30,0,30,0
1745826189739,EDS 125,A00,895341,Jones; Gabrielle Anastasia,43,0,45,2
1745826190764,EDS 128A,A01,895459,Fargason; Sharon Gayle,44,0,45,1
1745826191788,EDS 128B,A01,895543,Pappas; Elizabeth,44,0,45,1
1745826192815,EDS 139,A00,897203,Pappas; Elizabeth,44,0,45,1
1745826192815,EDS 139,B00,897209,Fargason; Sharon Gayle,44,0,45,1
1745826193841,EDS 201,A00,895545,Staff,43,0,45,2
1745826194870,EDS 203,A01,895581,Halter; Christopher P.,43,0,45,2
1745826195906,EDS 204R,A01,895625,Heinzman; Erica M.,43,0,45,2
1745826195906,EDS 204R,B01,895693,Halter; Christopher P.,18,0,45,27
1745826196934,EDS 206R,A00,895694,Fargason; Sharon Gayle,9,0,30,21
1745826196934,EDS 206R,B00,895695,Choi; Bailey Miyeon,20,0,30,10
1745826197962,EDS 250,A00,895697,Hemans; Patricia Ann Benitez,43,0,45,2
1745826198994,EDS 281,A00,895701,Meyerott; Theresa Ann,15,0,15,0
1745826200049,EDS 284,A00,895736,Meyerott; Theresa Ann,15,0,15,0
1745826201079,EDS 286,A00,897210,Fine; Sarah,15,0,15,0
1745826202105,EDS 289C,A01,895770,Daly; Alan J.,15,0,15,0
1745826203135,EDS 290,A00,897211,Hofstetter; Carolyn,15,0,15,0
1745826204162,LIGM 5A,A00,896162,Fischer-Grunski; Eva K,15,0,20,5
1745826205189,LIGM 5B,A00,896260,Fischer-Grunski; Eva K,17,0,20,3
1745826206219,LIGM 5C,A00,896308,Fischer-Grunski; Eva K,18,0,20,2
1745826207249,LIIT 5AS,A00,896313,Carnelos; Chiara,17,0,20,3
1745826208277,LIIT 5BS,A00,896416,Carnelos; Chiara,20,0,20,0
1745826209307,LIIT 5CS,A00,896564,Carnelos; Chiara,20,0,20,0
1745826210335,LISP 5A,A00,896588,Munoz Sanchez; Alicia,4,0,20,16
1745826211361,LISP 5B,A00,896653,Munoz Sanchez; Alicia,10,0,20,10
1745826212392,LISP 5C,A00,896655,Munoz Sanchez; Alicia,4,0,20,16
1745826213418,MAE 197,001,957918,Kleissl; Jan,9998,0,9999,1
1745826214447,MATH 2,A01,957937,Staff,34,0,35,1
1745826215473,MATH 197,001,957876,Kedlaya; Kiran S.,9993,0,9999,6
1745826216503,MCWP 40,A00,892729,Duru; Nur,13,0,20,7
1745826216503,MCWP 40,B00,893304,Montejo; Carolina,20,0,20,0
1745826217578,MCWP 40R,A00,893757,Redela; Pamela Morgan,0,7,20,20
1745826218609,MCWP 50,A00,893758,Morshed; Michael James,2,0,20,18
1745826218609,MCWP 50,B00,893761,Bartulis; Jason Michael,18,0,20,2
1745826219637,MCWP 50R,A00,893766,Compas; Sean Matthew,0,1,20,20
1745826219637,MCWP 50R,B00,893769,Carter; Jennifer A,0,0,20,20
1745826219637,MCWP 50R,C00,893771,Krone; Jarret,0,3,20,20
1745826219637,MCWP 50R,D00,893772,Miller; Elizabeth Deen,3,0,20,17
1745826219637,MCWP 50R,E00,893775,Carter; Andrea L,0,0,20,20
1745826220663,MMW 11R,A01,892721,Herbst; Matthew,11,0,27,16
1745826220663,MMW 11R,A02,892722,Herbst; Matthew,0,0,0,3
1745826221689,MMW 12R,A01,892724,Herbst; Matthew,0,10,16,16
1745826221689,MMW 12R,A02,892725,Herbst; Matthew,0,9,16,16
1745826222716,MMW 13R,A01,892727,Staff,0,3,16,16
1745826222716,MMW 13R,A02,892728,Staff,0,4,16,16
1745826222716,MMW 13R,A03,958032,Staff,0,3,16,16
1745826222716,MMW 13R,A04,958033,Staff,0,2,16,16
1745826222716,MMW 13R,A05,958034,Staff,0,3,16,16
1745826223745,SIO 295LS,A00,894015,Staff,7,0,25,18
1745826224775,SIO 295S,A00,894020,Staff,7,0,25,18
1745826225803,SIOC 290S,B01,958918,Staff,0,0,0,0
1745826226831,SIOC 291S,B01,958922,Staff,0,0,0,0
1745826227858,SOCI 117,A01,895339,Staff,4,0,5,1
1745826228891,WES 237B,A00,894149,Staff,11,0,20,9
1745826230959,AESE 279B,A00,891859,Staff,13,0,35,22
1745826231988,AIP 197,001,891854,Staff,70,0,70,0
1745826233018,ANTH 289S,A00,891856,Gagneux; Pascal,12,0,12,0
1745826234044,BENG 196,001,957946,Engler; Adam J.,9996,0,9999,3
1745826235071,CAT 124RS,A01,956906,Staff,8,0,25,17
1745826236099,CAT 125RS,A01,922013,Staff,8,0,25,17
1745826237128,CLRE 250,A00,891860,Morris; Sheldon,9995,0,9999,4
1745826239180,CLRE 251R,A00,907817,Mehta; Ravindra L.,9994,0,9999,5
1745826240210,CLRE 252,A00,891864,Cuomo; Raphael Eduardo,9993,0,9999,6
1745826241243,CLRE 253,A00,891867,Vaida; Florin,9994,0,9999,5
1745826241243,CLRE 253,B00,907819,Staff,9999,0,9999,0
1745826242282,CLRE 259,A00,891868,Patel; Hemal,9998,0,9999,1
1745826243311,CLRE 260,A00,891872,Cuomo; Raphael Eduardo,9999,0,9999,0
1745826244338,CLRE 297,001,891888,Cuomo; Raphael Eduardo,9999,0,9999,0
1745826245366,CSE 191,A00,958773,Minnes Kemp; Mor Mia,9999,0,9999,0
1745826246401,CSS 201S,A01,892054,Mignozzetti; Umberto,30,0,30,0
1745826247427,CSS 202S,A01,892056,Mignozzetti; Umberto,30,0,30,0
1745826248459,DSC 197,001,956898,Eldridge; Justin Matthew,9998,0,9999,1
1745826249487,DSC 297,001,958000,Mazumdar; Arya,9998,0,9999,1
1745826250512,EAP 100,A00,905686,Staff,9776,0,9999,223
1745826251538,ECE 45,A01,892618,Staff,0,13,50,50
1745826252568,ECE 109,A01,892620,Staff,0,43,0,0
1745826253596,ECE 111,A01,892719,Staff,0,9,50,50
1745826254623,ECE 197,001,957920,Mercier; Patrick Philip,9992,0,9999,7
1745826255650,ECON 178,A01,907814,Zhu; Ying,28,0,35,7
1745826256677,EDS 115,A00,895312,Staff,41,0,45,4
1745826257706,EDS 117,A01,895337,Staff,30,0,30,0
1745826258737,EDS 125,A00,895341,Jones; Gabrielle Anastasia,43,0,45,2
1745826259773,EDS 128A,A01,895459,Fargason; Sharon Gayle,44,0,45,1
1745826260804,EDS 128B,A01,895543,Pappas; Elizabeth,44,0,45,1
1745826261830,EDS 139,A00,897203,Pappas; Elizabeth,44,0,45,1
1745826261830,EDS 139,B00,897209,Fargason; Sharon Gayle,44,0,45,1
1745826262858,EDS 201,A00,895545,Staff,43,0,45,2
1745826263883,EDS 203,A01,895581,Halter; Christopher P.,43,0,45,2
1745826264910,EDS 204R,A01,895625,Heinzman; Erica M.,43,0,45,2
1745826264910,EDS 204R,B01,895693,Halter; Christopher P.,18,0,45,27
1745826265941,EDS 206R,A00,895694,Fargason; Sharon Gayle,9,0,30,21
1745826265941,EDS 206R,B00,895695,Choi; Bailey Miyeon,20,0,30,10
1745826266967,EDS 250,A00,895697,Hemans; Patricia Ann Benitez,43,0,45,2
1745826267993,EDS 281,A00,895701,Meyerott; Theresa Ann,15,0,15,0
1745826269020,EDS 284,A00,895736,Meyerott; Theresa Ann,15,0,15,0
1745826270073,EDS 286,A00,897210,Fine; Sarah,15,0,15,0
1745826271104,EDS 289C,A01,895770,Daly; Alan J.,15,0,15,0
1745826272136,EDS 290,A00,897211,Hofstetter; Carolyn,15,0,15,0
1745826273162,LIGM 5A,A00,896162,Fischer-Grunski; Eva K,15,0,20,5
1745826274187,LIGM 5B,A00,896260,Fischer-Grunski; Eva K,17,0,20,3
1745826275215,LIGM 5C,A00,896308,Fischer-Grunski; Eva K,18,0,20,2
1745826276246,LIIT 5AS,A00,896313,Carnelos; Chiara,17,0,20,3
1745826277273,LIIT 5BS,A00,896416,Carnelos; Chiara,20,0,20,0
1745826278305,LIIT 5CS,A00,896564,Carnelos; Chiara,20,0,20,0
1745826279333,LISP 5A,A00,896588,Munoz Sanchez; Alicia,4,0,20,16
1745826280363,LISP 5B,A00,896653,Munoz Sanchez; Alicia,10,0,20,10
1745826281389,LISP 5C,A00,896655,Munoz Sanchez; Alicia,4,0,20,16
1745826282416,MAE 197,001,957918,Kleissl; Jan,9998,0,9999,1
1745826283445,MATH 2,A01,957937,Staff,34,0,35,1
1745826284473,MATH 197,001,957876,Kedlaya; Kiran S.,9993,0,9999,6
1745826285501,MCWP 40,A00,892729,Duru; Nur,13,0,20,7
1745826285501,MCWP 40,B00,893304,Montejo; Carolina,20,0,20,0
1745826286529,MCWP 40R,A00,893757,Redela; Pamela Morgan,0,7,20,20
1745826287555,MCWP 50,A00,893758,Morshed; Michael James,2,0,20,18
1745826287555,MCWP 50,B00,893761,Bartulis; Jason Michael,18,0,20,2
1745826288583,MCWP 50R,A00,893766,Compas; Sean Matthew,0,1,20,20
1745826288583,MCWP 50R,B00,893769,Carter; Jennifer A,0,0,20,20
1745826288583,MCWP 50R,C00,893771,Krone; Jarret,0,3,20,20
1745826288583,MCWP 50R,D00,893772,Miller; Elizabeth Deen,3,0,20,17
1745826288583,MCWP 50R,E00,893775,Carter; Andrea L,0,0,20,20
1745826289607,MMW 11R,A01,892721,Herbst; Matthew,11,0,27,16
1745826289607,MMW 11R,A02,892722,Herbst; Matthew,0,0,0,3
1745826290634,MMW 12R,A01,892724,Herbst; Matthew,0,10,16,16
1745826290634,MMW 12R,A02,892725,Herbst; Matthew,0,9,16,16
1745826291670,MMW 13R,A01,892727,Staff,0,3,16,16
1745826291670,MMW 13R,A02,892728,Staff,0,4,16,16
1745826291670,MMW 13R,A03,958032,Staff,0,3,16,16
1745826291670,MMW 13R,A04,958033,Staff,0,2,16,16
1745826291670,MMW 13R,A05,958034,Staff,0,3,16,16
1745826292700,SIO 295LS,A00,894015,Staff,7,0,25,18
1745826293726,SIO 295S,A00,894020,Staff,7,0,25,18
1745826294763,SIOC 290S,B01,958918,Staff,0,0,0,0
1745826295794,SIOC 291S,B01,958922,Staff,0,0,0,0
1745826296821,SOCI 117,A01,895339,Staff,4,0,5,1
1745826297851,WES 237B,A00,894149,Staff,11,0,20,9
1745826299941,AESE 279B,A00,891859,Staff,13,0,35,22
1745826300967,AIP 197,001,891854,Staff,70,0,70,0
1745826301995,ANTH 289S,A00,891856,Gagneux; Pascal,12,0,12,0
1745826303023,BENG 196,001,957946,Engler; Adam J.,9996,0,9999,3
1745826304063,CAT 124RS,A01,956906,Staff,8,0,25,17
1745826305091,CAT 125RS,A01,922013,Staff,8,0,25,17
1745826306119,CLRE 250,A00,891860,Morris; Sheldon,9995,0,9999,4
1745826308170,CLRE 251R,A00,907817,Mehta; Ravindra L.,9994,0,9999,5
1745826309197,CLRE 252,A00,891864,Cuomo; Raphael Eduardo,9993,0,9999,6
1745826310230,CLRE 253,A00,891867,Vaida; Florin,9994,0,9999,5
1745826310230,CLRE 253,B00,907819,Staff,9999,0,9999,0
1745826311256,CLRE 259,A00,891868,Patel; Hemal,9998,0,9999,1
1745826312286,CLRE 260,A00,891872,Cuomo; Raphael Eduardo,9999,0,9999,0
1745826313325,CLRE 297,001,891888,Cuomo; Raphael Eduardo,9999,0,9999,0
1745826314352,CSE 191,A00,958773,Minnes Kemp; Mor Mia,9999,0,9999,0
1745826315378,CSS 201S,A01,892054,Mignozzetti; Umberto,30,0,30,0
1745826316412,CSS 202S,A01,892056,Mignozzetti; Umberto,30,0,30,0
1745826317442,DSC 197,001,956898,Eldridge; Justin Matthew,9998,0,9999,1
1745826318473,DSC 297,001,958000,Mazumdar; Arya,9998,0,9999,1
1745826319501,EAP 100,A00,905686,Staff,9776,0,9999,223
1745826320529,ECE 45,A01,892618,Staff,0,13,50,50
1745826321559,ECE 109,A01,892620,Staff,0,43,0,0
1745826322601,ECE 111,A01,892719,Staff,0,9,50,50
1745826323628,ECE 197,001,957920,Mercier; Patrick Philip,9992,0,9999,7
1745826324674,ECON 178,A01,907814,Zhu; Ying,28,0,35,7
1745826325699,EDS 115,A00,895312,Staff,41,0,45,4
1745826326726,EDS 117,A01,895337,Staff,30,0,30,0
1745826327758,EDS 125,A00,895341,Jones; Gabrielle Anastasia,43,0,45,2
1745826328794,EDS 128A,A01,895459,Fargason; Sharon Gayle,44,0,45,1
1745826329822,EDS 128B,A01,895543,Pappas; Elizabeth,44,0,45,1
1745826330857,EDS 139,A00,897203,Pappas; Elizabeth,44,0,45,1
1745826330857,EDS 139,B00,897209,Fargason; Sharon Gayle,44,0,45,1
1745826331888,EDS 201,A00,895545,Staff,43,0,45,2
1745826332916,EDS 203,A01,895581,Halter; Christopher P.,43,0,45,2
1745826333945,EDS 204R,A01,895625,Heinzman; Erica M.,43,0,45,2
1745826333945,EDS 204R,B01,895693,Halter; Christopher P.,18,0,45,27
1745826334989,EDS 206R,A00,895694,Fargason; Sharon Gayle,9,0,30,21
1745826334989,EDS 206R,B00,895695,Choi; Bailey Miyeon,20,0,30,10
1745826336029,EDS 250,A00,895697,Hemans; Patricia Ann Benitez,43,0,45,2
1745826337063,EDS 281,A00,895701,Meyerott; Theresa Ann,15,0,15,0
1745826338092,EDS 284,A00,895736,Meyerott; Theresa Ann,15,0,15,0
1745826339144,EDS 286,A00,897210,Fine; Sarah,15,0,15,0
1745826340181,EDS 289C,A01,895770,Daly; Alan J.,15,0,15,0
1745826341208,EDS 290,A00,897211,Hofstetter; Carolyn,15,0,15,0
1745826342242,LIGM 5A,A00,896162,Fischer-Grunski; Eva K,15,0,20,5
1745826343271,LIGM 5B,A00,896260,Fischer-Grunski; Eva K,17,0,20,3
1745826344299,LIGM 5C,A00,896308,Fischer-Grunski; Eva K,18,0,20,2
1745826345326,LIIT 5AS,A00,896313,Carnelos; Chiara,17,0,20,3
1745826346353,LIIT 5BS,A00,896416,Carnelos; Chiara,20,0,20,0
1745826347380,LIIT 5CS,A00,896564,Carnelos; Chiara,20,0,20,0
1745826348414,LISP 5A,A00,896588,Munoz Sanchez; Alicia,4,0,20,16
1745826349440,LISP 5B,A00,896653,Munoz Sanchez; Alicia,10,0,20,10
1745826350467,LISP 5C,A00,896655,Munoz Sanchez; Alicia,4,0,20,16
1745826351829,MAE 197,001,957918,Kleissl; Jan,9998,0,9999,1
1745826352866,MATH 2,A01,957937,Staff,34,0,35,1
1745826353915,MATH 197,001,957876,Kedlaya; Kiran S.,9993,0,9999,6
1745826354963,MCWP 40,A00,892729,Duru; Nur,13,0,20,7
1745826354963,MCWP 40,B00,893304,Montejo; Carolina,20,0,20,0
1745826356000,MCWP 40R,A00,893757,Redela; Pamela Morgan,0,7,20,20
1745826357040,MCWP 50,A00,893758,Morshed; Michael James,2,0,20,18
1745826357040,MCWP 50,B00,893761,Bartulis; Jason Michael,18,0,20,2
1745826358100,MCWP 50R,A00,893766,Compas; Sean Matthew,0,1,20,20
1745826358100,MCWP 50R,B00,893769,Carter; Jennifer A,0,0,20,20
1745826358100,MCWP 50R,C00,893771,Krone; Jarret,0,3,20,20
1745826358100,MCWP 50R,D00,893772,Miller; Elizabeth Deen,3,0,20,17
1745826358100,MCWP 50R,E00,893775,Carter; Andrea L,0,0,20,20
1745826359299,MMW 11R,A01,892721,Herbst; Matthew,11,0,27,16
1745826359299,MMW 11R,A02,892722,Herbst; Matthew,0,0,0,3
1745826360325,MMW 12R,A01,892724,Herbst; Matthew,0,10,16,16
1745826360325,MMW 12R,A02,892725,Herbst; Matthew,0,9,16,16
1745826361351,MMW 13R,A01,892727,Staff,0,3,16,16
1745826361351,MMW 13R,A02,892728,Staff,0,4,16,16
1745826361351,MMW 13R,A03,958032,Staff,0,3,16,16
1745826361351,MMW 13R,A04,958033,Staff,0,2,16,16
1745826361351,MMW 13R,A05,958034,Staff,0,3,16,16
1745826362394,SIO 295LS,A00,894015,Staff,7,0,25,18
1745826363427,SIO 295S,A00,894020,Staff,7,0,25,18
1745826364469,SIOC 290S,B01,958918,Staff,0,0,0,0
1745826365497,SIOC 291S,B01,958922,Staff,0,0,0,0
1745826366522,SOCI 117,A01,895339,Staff,4,0,5,1
1745826367549,WES 237B,A00,894149,Staff,11,0,20,9
1745826369649,AESE 279B,A00,891859,Staff,13,0,35,22
1745826370673,AIP 197,001,891854,Staff,70,0,70,0
1745826371703,ANTH 289S,A00,891856,Gagneux; Pascal,12,0,12,0
1745826372732,BENG 196,001,957946,Engler; Adam J.,9996,0,9999,3
1745826373761,CAT 124RS,A01,956906,Staff,8,0,25,17
1745826374793,CAT 125RS,A01,922013,Staff,8,0,25,17
1745826375820,CLRE 250,A00,891860,Morris; Sheldon,9995,0,9999,4
1745826377876,CLRE 251R,A00,907817,Mehta; Ravindra L.,9994,0,9999,5
1745826378903,CLRE 252,A00,891864,Cuomo; Raphael Eduardo,9993,0,9999,6
1745826379933,CLRE 253,A00,891867,Vaida; Florin,9994,0,9999,5
1745826379933,CLRE 253,B00,907819,Staff,9999,0,9999,0
1745826380960,CLRE 259,A00,891868,Patel; Hemal,9998,0,9999,1
1745826382016,CLRE 260,A00,891872,Cuomo; Raphael Eduardo,9999,0,9999,0
1745826383042,CLRE 297,001,891888,Cuomo; Raphael Eduardo,9999,0,9999,0
1745826384071,CSE 191,A00,958773,Minnes Kemp; Mor Mia,9999,0,9999,0
1745826385098,CSS 201S,A01,892054,Mignozzetti; Umberto,30,0,30,0
1745826386125,CSS 202S,A01,892056,Mignozzetti; Umberto,30,0,30,0
1745826387152,DSC 197,001,956898,Eldridge; Justin Matthew,9998,0,9999,1
1745826388179,DSC 297,001,958000,Mazumdar; Arya,9998,0,9999,1
1745826389204,EAP 100,A00,905686,Staff,9776,0,9999,223
1745826390232,ECE 45,A01,892618,Staff,0,13,50,50
1745826391259,ECE 109,A01,892620,Staff,0,43,0,0
1745826392286,ECE 111,A01,892719,Staff,0,9,50,50
1745826393313,ECE 197,001,957920,Mercier; Patrick Philip,9992,0,9999,7
1745826394341,ECON 178,A01,907814,Zhu; Ying,28,0,35,7
1745826395372,EDS 115,A00,895312,Staff,41,0,45,4
1745826396398,EDS 117,A01,895337,Staff,30,0,30,0
1745826397426,EDS 125,A00,895341,Jones; Gabrielle Anastasia,43,0,45,2
1745826398464,EDS 128A,A01,895459,Fargason; Sharon Gayle,44,0,45,1
1745826399491,EDS 128B,A01,895543,Pappas; Elizabeth,44,0,45,1
1745826400517,EDS 139,A00,897203,Pappas; Elizabeth,44,0,45,1
1745826400517,EDS 139,B00,897209,Fargason; Sharon Gayle,44,0,45,1
1745826401544,EDS 201,A00,895545,Staff,43,0,45,2
1745826402571,EDS 203,A01,895581,Halter; Christopher P.,43,0,45,2
1745826403602,EDS 204R,A01,895625,Heinzman; Erica M.,43,0,45,2
1745826403602,EDS 204R,B01,895693,Halter; Christopher P.,18,0,45,27
1745826404633,EDS 206R,A00,895694,Fargason; Sharon Gayle,9,0,30,21
1745826404633,EDS 206R,B00,895695,Choi; Bailey Miyeon,20,0,30,10
1745826405665,EDS 250,A00,895697,Hemans; Patricia Ann Benitez,43,0,45,2
1745826406696,EDS 281,A00,895701,Meyerott; Theresa Ann,15,0,15,0
1745826407725,EDS 284,A00,895736,Meyerott; Theresa Ann,15,0,15,0
1745826408765,EDS 286,A00,897210,Fine; Sarah,15,0,15,0
1745826409809,EDS 289C,A01,895770,Daly; Alan J.,15,0,15,0
1745826410835,EDS 290,A00,897211,Hofstetter; Carolyn,15,0,15,0
1745826411861,LIGM 5A,A00,896162,Fischer-Grunski; Eva K,15,0,20,5
1745826412893,LIGM 5B,A00,896260,Fischer-Grunski; Eva K,17,0,20,3
1745826413925,LIGM 5C,A00,896308,Fischer-Grunski; Eva K,18,0,20,2
1745826414956,LIIT 5AS,A00,896313,Carnelos; Chiara,17,0,20,3
1745826415982,LIIT 5BS,A00,896416,Carnelos; Chiara,20,0,20,0
1745826417012,LIIT 5CS,A00,896564,Carnelos; Chiara,20,0,20,0
1745826418040,LISP 5A,A00,896588,Munoz Sanchez; Alicia,4,0,20,16
1745826419066,LISP 5B,A00,896653,Munoz Sanchez; Alicia,10,0,20,10
1745826420097,LISP 5C,A00,896655,Munoz Sanchez; Alicia,4,0,20,16
1745826421125,MAE 197,001,957918,Kleissl; Jan,9998,0,9999,1
1745826422153,MATH 2,A01,957937,Staff,34,0,35,1
1745826423184,MATH 197,001,957876,Kedlaya; Kiran S.,9993,0,9999,6
1745826424211,MCWP 40,A00,892729,Duru; Nur,13,0,20,7
1745826424211,MCWP 40,B00,893304,Montejo; Carolina,20,0,20,0
1745826425245,MCWP 40R,A00,893757,Redela; Pamela Morgan,0,7,20,20
1745826426276,MCWP 50,A00,893758,Morshed; Michael James,2,0,20,18
1745826426276,MCWP 50,B00,893761,Bartulis; Jason Michael,18,0,20,2
1745826427320,MCWP 50R,A00,893766,Compas; Sean Matthew,0,1,20,20
1745826427320,MCWP 50R,B00,893769,Carter; Jennifer A,0,0,20,20
1745826427320,MCWP 50R,C00,893771,Krone; Jarret,0,3,20,20
1745826427320,MCWP 50R,D00,893772,Miller; Elizabeth Deen,3,0,20,17
1745826427320,MCWP 50R,E00,893775,Carter; Andrea L,0,0,20,20
1745826428350,MMW 11R,A01,892721,Herbst; Matthew,11,0,27,16
1745826428350,MMW 11R,A02,892722,Herbst; Matthew,0,0,0,3
1745826429377,MMW 12R,A01,892724,Herbst; Matthew,0,10,16,16
1745826429377,MMW 12R,A02,892725,Herbst; Matthew,0,9,16,16
1745826430404,MMW 13R,A01,892727,Staff,0,3,16,16
1745826430404,MMW 13R,A02,892728,Staff,0,4,16,16
1745826430404,MMW 13R,A03,958032,Staff,0,3,16,16
1745826430404,MMW 13R,A04,958033,Staff,0,2,16,16
1745826430404,MMW 13R,A05,958034,Staff,0,3,16,16
1745826431431,SIO 295LS,A00,894015,Staff,7,0,25,18
1745826432460,SIO 295S,A00,894020,Staff,7,0,25,18
1745826433492,SIOC 290S,B01,958918,Staff,0,0,0,0
1745826434520,SIOC 291S,B01,958922,Staff,0,0,0,0
1745826435549,SOCI 117,A01,895339,Staff,4,0,5,1
1745826436574,WES 237B,A00,894149,Staff,11,0,20,9
1745826438677,AESE 279B,A00,891859,Staff,13,0,35,22
1745826439704,AIP 197,001,891854,Staff,70,0,70,0
1745826440731,ANTH 289S,A00,891856,Gagneux; Pascal,12,0,12,0
1745826441758,BENG 196,001,957946,Engler; Adam J.,9996,0,9999,3
1745826442785,CAT 124RS,A01,956906,Staff,8,0,25,17
1745826443811,CAT 125RS,A01,922013,Staff,8,0,25,17
1745826444840,CLRE 250,A00,891860,Morris; Sheldon,9995,0,9999,4
1745826446936,CLRE 251R,A00,907817,Mehta; Ravindra L.,9994,0,9999,5
1745826447963,CLRE 252,A00,891864,Cuomo; Raphael Eduardo,9993,0,9999,6
1745826448990,CLRE 253,A00,891867,Vaida; Florin,9994,0,9999,5
1745826448990,CLRE 253,B00,907819,Staff,9999,0,9999,0
1745826450018,CLRE 259,A00,891868,Patel; Hemal,9998,0,9999,1
1745826451045,CLRE 260,A00,891872,Cuomo; Raphael Eduardo,9999,0,9999,0
1745826452072,CLRE 297,001,891888,Cuomo; Raphael Eduardo,9999,0,9999,0
1745826453099,CSE 191,A00,958773,Minnes Kemp; Mor Mia,9999,0,9999,0
1745826454130,CSS 201S,A01,892054,Mignozzetti; Umberto,30,0,30,0
1745826455164,CSS 202S,A01,892056,Mignozzetti; Umberto,30,0,30,0
1745826456190,DSC 197,001,956898,Eldridge; Justin Matthew,9998,0,9999,1
1745826457216,DSC 297,001,958000,Mazumdar; Arya,9998,0,9999,1
1745826458244,EAP 100,A00,905686,Staff,9776,0,9999,223
1745826459271,ECE 45,A01,892618,Staff,0,13,50,50
1745826460302,ECE 109,A01,892620,Staff,0,43,0,0
1745826461331,ECE 111,A01,892719,Staff,0,9,50,50
1745826462360,ECE 197,001,957920,Mercier; Patrick Philip,9992,0,9999,7
1745826463391,ECON 178,A01,907814,Zhu; Ying,28,0,35,7
1745826464418,EDS 115,A00,895312,Staff,41,0,45,4
1745826465448,EDS 117,A01,895337,Staff,30,0,30,0
1745826466478,EDS 125,A00,895341,Jones; Gabrielle Anastasia,43,0,45,2
1745826467508,EDS 128A,A01,895459,Fargason; Sharon Gayle,44,0,45,1
1745826468535,EDS 128B,A01,895543,Pappas; Elizabeth,44,0,45,1
1745826469564,EDS 139,A00,897203,Pappas; Elizabeth,44,0,45,1
1745826469564,EDS 139,B00,897209,Fargason; Sharon Gayle,44,0,45,1
1745826470594,EDS 201,A00,895545,Staff,43,0,45,2
1745826471623,EDS 203,A01,895581,Halter; Christopher P.,43,0,45,2
1745826472650,EDS 204R,A01,895625,Heinzman; Erica M.,43,0,45,2
1745826472650,EDS 204R,B01,895693,Halter; Christopher P.,18,0,45,27
1745826473676,EDS 206R,A00,895694,Fargason; Sharon Gayle,9,0,30,21
1745826473676,EDS 206R,B00,895695,Choi; Bailey Miyeon,20,0,30,10
1745826474704,EDS 250,A00,895697,Hemans; Patricia Ann Benitez,43,0,45,2
1745826475731,EDS 281,A00,895701,Meyerott; Theresa Ann,15,0,15,0
1745826476757,EDS 284,A00,895736,Meyerott; Theresa Ann,15,0,15,0
1745826477785,EDS 286,A00,897210,Fine; Sarah,15,0,15,0
1745826478809,EDS 289C,A01,895770,Daly; Alan J.,15,0,15,0
1745826479835,EDS 290,A00,897211,Hofstetter; Carolyn,15,0,15,0
1745826480863,LIGM 5A,A00,896162,Fischer-Grunski; Eva K,15,0,20,5
1745826481889,LIGM 5B,A00,896260,Fischer-Grunski; Eva K,17,0,20,3
1745826482917,LIGM 5C,A00,896308,Fischer-Grunski; Eva K,18,0,20,2
1745826483952,LIIT 5AS,A00,896313,Carnelos; Chiara,17,0,20,3
1745826484979,LIIT 5BS,A00,896416,Carnelos; Chiara,20,0,20,0
1745826486006,LIIT 5CS,A00,896564,Carnelos; Chiara,20,0,20,0
1745826487032,LISP 5A,A00,896588,Munoz Sanchez; Alicia,4,0,20,16
1745826488062,LISP 5B,A00,896653,Munoz Sanchez; Alicia,10,0,20,10
1745826489088,LISP 5C,A00,896655,Munoz Sanchez; Alicia,4,0,20,16
1745826490117,MAE 197,001,957918,Kleissl; Jan,9998,0,9999,1
1745826491142,MATH 2,A01,957937,Staff,34,0,35,1
1745826492171,MATH 197,001,957876,Kedlaya; Kiran S.,9993,0,9999,6
1745826493203,MCWP 40,A00,892729,Duru; Nur,13,0,20,7
1745826493203,MCWP 40,B00,893304,Montejo; Carolina,20,0,20,0
1745826494229,MCWP 40R,A00,893757,Redela; Pamela Morgan,0,7,20,20
1745826495259,MCWP 50,A00,893758,Morshed; Michael James,2,0,20,18
1745826495259,MCWP 50,B00,893761,Bartulis; Jason Michael,18,0,20,2
1745826496290,MCWP 50R,A00,893766,Compas; Sean Matthew,0,1,20,20
1745826496290,MCWP 50R,B00,893769,Carter; Jennifer A,0,0,20,20
1745826496290,MCWP 50R,C00,893771,Krone; Jarret,0,3,20,20
1745826496290,MCWP 50R,D00,893772,Miller; Elizabeth Deen,3,0,20,17
1745826496290,MCWP 50R,E00,893775,Carter; Andrea L,0,0,20,20
1745826497317,MMW 11R,A01,892721,Herbst; Matthew,11,0,27,16
1745826497317,MMW 11R,A02,892722,Herbst; Matthew,0,0,0,3
1745826498341,MMW 12R,A01,892724,Herbst; Matthew,0,10,16,16
1745826498341,MMW 12R,A02,892725,Herbst; Matthew,0,9,16,16
1745826499371,MMW 13R,A01,892727,Staff,0,3,16,16
1745826499371,MMW 13R,A02,892728,Staff,0,4,16,16
1745826499371,MMW 13R,A03,958032,Staff,0,3,16,16
1745826499371,MMW 13R,A04,958033,Staff,0,2,16,16
1745826499371,MMW 13R,A05,958034,Staff,0,3,16,16
1745826500398,SIO 295LS,A00,894015,Staff,7,0,25,18
1745826501428,SIO 295S,A00,894020,Staff,7,0,25,18
1745826502456,SIOC 290S,B01,958918,Staff,0,0,0,0
1745826503483,SIOC 291S,B01,958922,Staff,0,0,0,0
1745826504514,SOCI 117,A01,895339,Staff,4,0,5,1
1745826505542,WES 237B,A00,894149,Staff,11,0,20,9
1745826507632,AESE 279B,A00,891859,Staff,13,0,35,22
1745826508657,AIP 197,001,891854,Staff,70,0,70,0
1745826509682,ANTH 289S,A00,891856,Gagneux; Pascal,12,0,12,0
1745826510708,BENG 196,001,957946,Engler; Adam J.,9996,0,9999,3
1745826511737,CAT 124RS,A01,956906,Staff,8,0,25,17
1745826512764,CAT 125RS,A01,922013,Staff,8,0,25,17
1745826513791,CLRE 250,A00,891860,Morris; Sheldon,9995,0,9999,4
1745826515843,CLRE 251R,A00,907817,Mehta; Ravindra L.,9994,0,9999,5
1745826516868,CLRE 252,A00,891864,Cuomo; Raphael Eduardo,9993,0,9999,6
1745826517894,CLRE 253,A00,891867,Vaida; Florin,9994,0,9999,5
1745826517894,CLRE 253,B00,907819,Staff,9999,0,9999,0
1745826518919,CLRE 259,A00,891868,Patel; Hemal,9998,0,9999,1
1745826519946,CLRE 260,A00,891872,Cuomo; Raphael Eduardo,9999,0,9999,0
1745826520974,CLRE 297,001,891888,Cuomo; Raphael Eduardo,9999,0,9999,0
1745826522001,CSE 191,A00,958773,Minnes Kemp; Mor Mia,9999,0,9999,0
1745826523071,CSS 201S,A01,892054,Mignozzetti; Umberto,30,0,30,0
1745826524098,CSS 202S,A01,892056,Mignozzetti; Umberto,30,0,30,0
1745826525321,DSC 197,001,956898,Eldridge; Justin Matthew,9998,0,9999,1
1745826526350,DSC 297,001,958000,Mazumdar; Arya,9998,0,9999,1
1745826527377,EAP 100,A00,905686,Staff,9776,0,9999,223
1745826528403,ECE 45,A01,892618,Staff,0,13,50,50
1745826529431,ECE 109,A01,892620,Staff,0,43,0,0
1745826530460,ECE 111,A01,892719,Staff,0,9,50,50
1745826531488,ECE 197,001,957920,Mercier; Patrick Philip,9992,0,9999,7
1745826532513,ECON 178,A01,907814,Zhu; Ying,28,0,35,7
1745826533543,EDS 115,A00,895312,Staff,41,0,45,4
1745826534569,EDS 117,A01,895337,Staff,30,0,30,0
1745826535599,EDS 125,A00,895341,Jones; Gabrielle Anastasia,43,0,45,2
1745826536628,EDS 128A,A01,895459,Fargason; Sharon Gayle,44,0,45,1
1745826537656,EDS 128B,A01,895543,Pappas; Elizabeth,44,0,45,1
1745826538682,EDS 139,A00,897203,Pappas; Elizabeth,44,0,45,1
1745826538682,EDS 139,B00,897209,Fargason; Sharon Gayle,44,0,45,1
1745826539709,EDS 201,A00,895545,Staff,43,0,45,2
1745826540735,EDS 203,A01,895581,Halter; Christopher P.,43,0,45,2
1745826541763,EDS 204R,A01,895625,Heinzman; Erica M.,43,0,45,2
1745826541763,EDS 204R,B01,895693,Halter; Christopher P.,18,0,45,27
1745826542792,EDS 206R,A00,895694,Fargason; Sharon Gayle,9,0,30,21
1745826542792,EDS 206R,B00,895695,Choi; Bailey Miyeon,20,0,30,10
1745826543818,EDS 250,A00,895697,Hemans; Patricia Ann Benitez,43,0,45,2
1745826544849,EDS 281,A00,895701,Meyerott; Theresa Ann,15,0,15,0
1745826545877,EDS 284,A00,895736,Meyerott; Theresa Ann,15,0,15,0
1745826546907,EDS 286,A00,897210,Fine; Sarah,15,0,15,0
1745826547935,EDS 289C,A01,895770,Daly; Alan J.,15,0,15,0
1745826548961,EDS 290,A00,897211,Hofstetter; Carolyn,15,0,15,0
1745826549993,LIGM 5A,A00,896162,Fischer-Grunski; Eva K,15,0,20,5
1745826551020,LIGM 5B,A00,896260,Fischer-Grunski; Eva K,17,0,20,3
1745826552047,LIGM 5C,A00,896308,Fischer-Grunski; Eva K,18,0,20,2
1745826553076,LIIT 5AS,A00,896313,Carnelos; Chiara,17,0,20,3
1745826554105,LIIT 5BS,A00,896416,Carnelos; Chiara,20,0,20,0
1745826555130,LIIT 5CS,A00,896564,Carnelos; Chiara,20,0,20,0
1745826556160,LISP 5A,A00,896588,Munoz Sanchez; Alicia,4,0,20,16
1745826557187,LISP 5B,A00,896653,Munoz Sanchez; Alicia,10,0,20,10
1745826558217,LISP 5C,A00,896655,Munoz Sanchez; Alicia,4,0,20,16
1745826559247,MAE 197,001,957918,Kleissl; Jan,9998,0,9999,1
1745826560274,MATH 2,A01,957937,Staff,34,0,35,1
1745826561303,MATH 197,001,957876,Kedlaya; Kiran S.,9993,0,9999,6
1745826562329,MCWP 40,A00,892729,Duru; Nur,13,0,20,7
1745826562329,MCWP 40,B00,893304,Montejo; Carolina,20,0,20,0
1745826563356,MCWP 40R,A00,893757,Redela; Pamela Morgan,0,7,20,20
1745826564386,MCWP 50,A00,893758,Morshed; Michael James,2,0,20,18
1745826564386,MCWP 50,B00,893761,Bartulis; Jason Michael,18,0,20,2
1745826565415,MCWP 50R,A00,893766,Compas; Sean Matthew,0,1,20,20
1745826565415,MCWP 50R,B00,893769,Carter; Jennifer A,0,0,20,20
1745826565415,MCWP 50R,C00,893771,Krone; Jarret,0,3,20,20
1745826565415,MCWP 50R,D00,893772,Miller; Elizabeth Deen,3,0,20,17
1745826565415,MCWP 50R,E00,893775,Carter; Andrea L,0,0,20,20
1745826566445,MMW 11R,A01,892721,Herbst; Matthew,11,0,27,16
1745826566445,MMW 11R,A02,892722,Herbst; Matthew,0,0,0,3
1745826567472,MMW 12R,A01,892724,Herbst; Matthew,0,10,16,16
1745826567472,MMW 12R,A02,892725,Herbst; Matthew,0,9,16,16
1745826568497,MMW 13R,A01,892727,Staff,0,3,16,16
1745826568497,MMW 13R,A02,892728,Staff,0,4,16,16
1745826568497,MMW 13R,A03,958032,Staff,0,3,16,16
1745826568497,MMW 13R,A04,958033,Staff,0,2,16,16
1745826568497,MMW 13R,A05,958034,Staff,0,3,16,16
1745826569525,SIO 295LS,A00,894015,Staff,7,0,25,18
1745826570550,SIO 295S,A00,894020,Staff,7,0,25,18
1745826571575,SIOC 290S,B01,958918,Staff,0,0,0,0
1745826572602,SIOC 291S,B01,958922,Staff,0,0,0,0
1745826573627,SOCI 117,A01,895339,Staff,4,0,5,1
1745826574654,WES 237B,A00,894149,Staff,11,0,20,9
1745826576717,AESE 279B,A00,891859,Staff,13,0,35,22
1745826577744,AIP 197,001,891854,Staff,70,0,70,0
1745826578770,ANTH 289S,A00,891856,Gagneux; Pascal,12,0,12,0
1745826579795,BENG 196,001,957946,Engler; Adam J.,9996,0,9999,3
1745826580820,CAT 124RS,A01,956906,Staff,8,0,25,17
1745826581849,CAT 125RS,A01,922013,Staff,8,0,25,17
1745826582875,CLRE 250,A00,891860,Morris; Sheldon,9995,0,9999,4
1745826584928,CLRE 251R,A00,907817,Mehta; Ravindra L.,9994,0,9999,5
1745826585956,CLRE 252,A00,891864,Cuomo; Raphael Eduardo,9993,0,9999,6
1745826586981,CLRE 253,A00,891867,Vaida; Florin,9994,0,9999,5
1745826586981,CLRE 253,B00,907819,Staff,9999,0,9999,0
1745826588008,CLRE 259,A00,891868,Patel; Hemal,9998,0,9999,1
1745826589035,CLRE 260,A00,891872,Cuomo; Raphael Eduardo,9999,0,9999,0
1745826590070,CLRE 297,001,891888,Cuomo; Raphael Eduardo,9999,0,9999,0
1745826591100,CSE 191,A00,958773,Minnes Kemp; Mor Mia,9999,0,9999,0
1745826592132,CSS 201S,A01,892054,Mignozzetti; Umberto,30,0,30,0
1745826593158,CSS 202S,A01,892056,Mignozzetti; Umberto,30,0,30,0
1745826594189,DSC 197,001,956898,Eldridge; Justin Matthew,9998,0,9999,1
1745826595215,DSC 297,001,958000,Mazumdar; Arya,9998,0,9999,1
1745826596244,EAP 100,A00,905686,Staff,9776,0,9999,223
1745826597273,ECE 45,A01,892618,Staff,0,13,50,50
1745826598300,ECE 109,A01,892620,Staff,0,43,0,0
1745826599330,ECE 111,A01,892719,Staff,0,9,50,50
1745826600358,ECE 197,001,957920,Mercier; Patrick Philip,9992,0,9999,7
1745826601385,ECON 178,A01,907814,Zhu; Ying,28,0,35,7
1745826602417,EDS 115,A00,895312,Staff,41,0,45,4
1745826603444,EDS 117,A01,895337,Staff,30,0,30,0
1745826604475,EDS 125,A00,895341,Jones; Gabrielle Anastasia,43,0,45,2
1745826605502,EDS 128A,A01,895459,Fargason; Sharon Gayle,44,0,45,1
1745826606530,EDS 128B,A01,895543,Pappas; Elizabeth,44,0,45,1
1745826607559,EDS 139,A00,897203,Pappas; Elizabeth,44,0,45,1
1745826607559,EDS 139,B00,897209,Fargason; Sharon Gayle,44,0,45,1
1745826608590,EDS 201,A00,895545,Staff,43,0,45,2
1745826609617,EDS 203,A01,895581,Halter; Christopher P.,43,0,45,2
1745826610647,EDS 204R,A01,895625,Heinzman; Erica M.,43,0,45,2
1745826610647,EDS 204R,B01,895693,Halter; Christopher P.,18,0,45,27
1745826611681,EDS 206R,A00,895694,Fargason; Sharon Gayle,9,0,30,21
1745826611681,EDS 206R,B00,895695,Choi; Bailey Miyeon,20,0,30,10
1745826612709,EDS 250,A00,895697,Hemans; Patricia Ann Benitez,43,0,45,2
1745826613734,EDS 281,A00,895701,Meyerott; Theresa Ann,15,0,15,0
1745826614761,EDS 284,A00,895736,Meyerott; Theresa Ann,15,0,15,0
1745826615788,EDS 286,A00,897210,Fine; Sarah,15,0,15,0
1745826616815,EDS 289C,A01,895770,Daly; Alan J.,15,0,15,0
1745826617843,EDS 290,A00,897211,Hofstetter; Carolyn,15,0,15,0
1745826618871,LIGM 5A,A00,896162,Fischer-Grunski; Eva K,15,0,20,5
1745826619901,LIGM 5B,A00,896260,Fischer-Grunski; Eva K,17,0,20,3
1745826620930,LIGM 5C,A00,896308,Fischer-Grunski; Eva K,18,0,20,2
1745826621961,LIIT 5AS,A00,896313,Carnelos; Chiara,17,0,20,3
1745826622991,LIIT 5BS,A00,896416,Carnelos; Chiara,20,0,20,0
1745826624016,LIIT 5CS,A00,896564,Carnelos; Chiara,20,0,20,0
1745826625044,LISP 5A,A00,896588,Munoz Sanchez; Alicia,4,0,20,16
1745826626072,LISP 5B,A00,896653,Munoz Sanchez; Alicia,10,0,20,10
1745826627096,LISP 5C,A00,896655,Munoz Sanchez; Alicia,4,0,20,16
1745826628121,MAE 197,001,957918,Kleissl; Jan,9998,0,9999,1
1745826629149,MATH 2,A01,957937,Staff,34,0,35,1
1745826630178,MATH 197,001,957876,Kedlaya; Kiran S.,9993,0,9999,6
1745826631204,MCWP 40,A00,892729,Duru; Nur,13,0,20,7
1745826631204,MCWP 40,B00,893304,Montejo; Carolina,20,0,20,0
1745826632233,MCWP 40R,A00,893757,Redela; Pamela Morgan,0,7,20,20
1745826633263,MCWP 50,A00,893758,Morshed; Michael James,2,0,20,18
1745826633263,MCWP 50,B00,893761,Bartulis; Jason Michael,18,0,20,2
1745826634294,MCWP 50R,A00,893766,Compas; Sean Matthew,0,1,20,20
1745826634294,MCWP 50R,B00,893769,Carter; Jennifer A,0,0,20,20
1745826634294,MCWP 50R,C00,893771,Krone; Jarret,0,3,20,20
1745826634294,MCWP 50R,D00,893772,Miller; Elizabeth Deen,3,0,20,17
1745826634294,MCWP 50R,E00,893775,Carter; Andrea L,0,0,20,20
1745826635320,MMW 11R,A01,892721,Herbst; Matthew,11,0,27,16
1745826635320,MMW 11R,A02,892722,Herbst; Matthew,0,0,0,3
1745826636346,MMW 12R,A01,892724,Herbst; Matthew,0,10,16,16
1745826636346,MMW 12R,A02,892725,Herbst; Matthew,0,9,16,16
1745826637373,MMW 13R,A01,892727,Staff,0,3,16,16
1745826637373,MMW 13R,A02,892728,Staff,0,4,16,16
1745826637373,MMW 13R,A03,958032,Staff,0,3,16,16
1745826637373,MMW 13R,A04,958033,Staff,0,2,16,16
1745826637373,MMW 13R,A05,958034,Staff,0,3,16,16
1745826638399,SIO 295LS,A00,894015,Staff,7,0,25,18
1745826639424,SIO 295S,A00,894020,Staff,7,0,25,18
1745826640451,SIOC 290S,B01,958918,Staff,0,0,0,0
1745826641478,SIOC 291S,B01,958922,Staff,0,0,0,0
1745826642508,SOCI 117,A01,895339,Staff,4,0,5,1
1745826643536,WES 237B,A00,894149,Staff,11,0,20,9
1745826645608,AESE 279B,A00,891859,Staff,13,0,35,22
1745826646633,AIP 197,001,891854,Staff,70,0,70,0
1745826647659,ANTH 289S,A00,891856,Gagneux; Pascal,12,0,12,0
1745826648683,BENG 196,001,957946,Engler; Adam J.,9996,0,9999,3
1745826649709,CAT 124RS,A01,956906,Staff,8,0,25,17
1745826650735,CAT 125RS,A01,922013,Staff,8,0,25,17
1745826651762,CLRE 250,A00,891860,Morris; Sheldon,9995,0,9999,4
1745826653815,CLRE 251R,A00,907817,Mehta; Ravindra L.,9994,0,9999,5
1745826654841,CLRE 252,A00,891864,Cuomo; Raphael Eduardo,9993,0,9999,6
1745826655870,CLRE 253,A00,891867,Vaida; Florin,9994,0,9999,5
1745826655870,CLRE 253,B00,907819,Staff,9999,0,9999,0
1745826656902,CLRE 259,A00,891868,Patel; Hemal,9998,0,9999,1
1745826657929,CLRE 260,A00,891872,Cuomo; Raphael Eduardo,9999,0,9999,0
1745826658957,CLRE 297,001,891888,Cuomo; Raphael Eduardo,9999,0,9999,0
1745826659983,CSE 191,A00,958773,Minnes Kemp; Mor Mia,9999,0,9999,0
1745826661009,CSS 201S,A01,892054,Mignozzetti; Umberto,30,0,30,0
1745826662036,CSS 202S,A01,892056,Mignozzetti; Umberto,30,0,30,0
1745826663063,DSC 197,001,956898,Eldridge; Justin Matthew,9998,0,9999,1
1745826664088,DSC 297,001,958000,Mazumdar; Arya,9998,0,9999,1
1745826665115,EAP 100,A00,905686,Staff,9776,0,9999,223
1745826666147,ECE 45,A01,892618,Staff,0,13,50,50
1745826667175,ECE 109,A01,892620,Staff,0,43,0,0
1745826668201,ECE 111,A01,892719,Staff,0,9,50,50
1745826669267,ECE 197,001,957920,Mercier; Patrick Philip,9992,0,9999,7
1745826670295,ECON 178,A01,907814,Zhu; Ying,28,0,35,7
1745826671321,EDS 115,A00,895312,Staff,41,0,45,4
1745826672346,EDS 117,A01,895337,Staff,30,0,30,0
1745826673377,EDS 125,A00,895341,Jones; Gabrielle Anastasia,43,0,45,2
1745826674405,EDS 128A,A01,895459,Fargason; Sharon Gayle,44,0,45,1
1745826675433,EDS 128B,A01,895543,Pappas; Elizabeth,44,0,45,1
1745826676462,EDS 139,A00,897203,Pappas; Elizabeth,44,0,45,1
1745826676462,EDS 139,B00,897209,Fargason; Sharon Gayle,44,0,45,1
1745826677488,EDS 201,A00,895545,Staff,43,0,45,2
1745826678515,EDS 203,A01,895581,Halter; Christopher P.,43,0,45,2
1745826679542,EDS 204R,A01,895625,Heinzman; Erica M.,43,0,45,2
1745826679542,EDS 204R,B01,895693,Halter; Christopher P.,18,0,45,27
1745826680569,EDS 206R,A00,895694,Fargason; Sharon Gayle,9,0,30,21
1745826680569,EDS 206R,B00,895695,Choi; Bailey Miyeon,20,0,30,10
1745826681604,EDS 250,A00,895697,Hemans; Patricia Ann Benitez,43,0,45,2
1745826682628,EDS 281,A00,895701,Meyerott; Theresa Ann,15,0,15,0
1745826683656,EDS 284,A00,895736,Meyerott; Theresa Ann,15,0,15,0
1745826684686,EDS 286,A00,897210,Fine; Sarah,15,0,15,0
1745826685713,EDS 289C,A01,895770,Daly; Alan J.,15,0,15,0
1745826686739,EDS 290,A00,897211,Hofstetter; Carolyn,15,0,15,0
1745826687766,LIGM 5A,A00,896162,Fischer-Grunski; Eva K,15,0,20,5
1745826688792,LIGM 5B,A00,896260,Fischer-Grunski; Eva K,17,0,20,3
1745826689818,LIGM 5C,A00,896308,Fischer-Grunski; Eva K,18,0,20,2
1745826690845,LIIT 5AS,A00,896313,Carnelos; Chiara,17,0,20,3
1745826691874,LIIT 5BS,A00,896416,Carnelos; Chiara,20,0,20,0
1745826692904,LIIT 5CS,A00,896564,Carnelos; Chiara,20,0,20,0
1745826693933,LISP 5A,A00,896588,Munoz Sanchez; Alicia,4,0,20,16
1745826694961,LISP 5B,A00,896653,Munoz Sanchez; Alicia,10,0,20,10
1745826695987,LISP 5C,A00,896655,Munoz Sanchez; Alicia,4,0,20,16
1745826697019,MAE 197,001,957918,Kleissl; Jan,9998,0,9999,1
1745826698046,MATH 2,A01,957937,Staff,34,0,35,1
1745826699072,MATH 197,001,957876,Kedlaya; Kiran S.,9993,0,9999,6
1745826700103,MCWP 40,A00,892729,Duru; Nur,13,0,20,7
1745826700103,MCWP 40,B00,893304,Montejo; Carolina,20,0,20,0
1745826701129,MCWP 40R,A00,893757,Redela; Pamela Morgan,0,7,20,20
1745826702156,MCWP 50,A00,893758,Morshed; Michael James,2,0,20,18
1745826702156,MCWP 50,B00,893761,Bartulis; Jason Michael,18,0,20,2
1745826703183,MCWP 50R,A00,893766,Compas; Sean Matthew,0,1,20,20
1745826703183,MCWP 50R,B00,893769,Carter; Jennifer A,0,0,20,20
1745826703183,MCWP 50R,C00,893771,Krone; Jarret,0,3,20,20
1745826703183,MCWP 50R,D00,893772,Miller; Elizabeth Deen,3,0,20,17
1745826703183,MCWP 50R,E00,893775,Carter; Andrea L,0,0,20,20
1745826704210,MMW 11R,A01,892721,Herbst; Matthew,11,0,27,16
1745826704210,MMW 11R,A02,892722,Herbst; Matthew,0,0,0,3
1745826705239,MMW 12R,A01,892724,Herbst; Matthew,0,10,16,16
1745826705239,MMW 12R,A02,892725,Herbst; Matthew,0,9,16,16
1745826706267,MMW 13R,A01,892727,Staff,0,3,16,16
1745826706267,MMW 13R,A02,892728,Staff,0,4,16,16
1745826706267,MMW 13R,A03,958032,Staff,0,3,16,16
1745826706267,MMW 13R,A04,958033,Staff,0,2,16,16
1745826706267,MMW 13R,A05,958034,Staff,0,3,16,16
1745826707293,SIO 295LS,A00,894015,Staff,7,0,25,18
1745826708321,SIO 295S,A00,894020,Staff,7,0,25,18
1745826709353,SIOC 290S,B01,958918,Staff,0,0,0,0
1745826710379,SIOC 291S,B01,958922,Staff,0,0,0,0
1745826711406,SOCI 117,A01,895339,Staff,4,0,5,1
1745826712431,WES 237B,A00,894149,Staff,11,0,20,9
1745826714503,AESE 279B,A00,891859,Staff,13,0,35,22
1745826715529,AIP 197,001,891854,Staff,70,0,70,0
1745826716556,ANTH 289S,A00,891856,Gagneux; Pascal,12,0,12,0
1745826717587,BENG 196,001,957946,Engler; Adam J.,9996,0,9999,3
1745826718627,CAT 124RS,A01,956906,Staff,8,0,25,17
1745826719660,CAT 125RS,A01,922013,Staff,8,0,25,17
1745826720685,CLRE 250,A00,891860,Morris; Sheldon,9995,0,9999,4
1745826722746,CLRE 251R,A00,907817,Mehta; Ravindra L.,9994,0,9999,5
1745826723773,CLRE 252,A00,891864,Cuomo; Raphael Eduardo,9993,0,9999,6
1745826724807,CLRE 253,A00,891867,Vaida; Florin,9994,0,9999,5
1745826724807,CLRE 253,B00,907819,Staff,9999,0,9999,0
1745826725837,CLRE 259,A00,891868,Patel; Hemal,9998,0,9999,1
1745826726873,CLRE 260,A00,891872,Cuomo; Raphael Eduardo,9999,0,9999,0
1745826727902,CLRE 297,001,891888,Cuomo; Raphael Eduardo,9999,0,9999,0
1745826728931,CSE 191,A00,958773,Minnes Kemp; Mor Mia,9999,0,9999,0
1745826729957,CSS 201S,A01,892054,Mignozzetti; Umberto,30,0,30,0
1745826730984,CSS 202S,A01,892056,Mignozzetti; Umberto,30,0,30,0
1745826732009,DSC 197,001,956898,Eldridge; Justin Matthew,9998,0,9999,1
1745826733035,DSC 297,001,958000,Mazumdar; Arya,9998,0,9999,1
1745826734061,EAP 100,A00,905686,Staff,9776,0,9999,223
1745826735094,ECE 45,A01,892618,Staff,0,13,50,50
1745826736120,ECE 109,A01,892620,Staff,0,43,0,0
1745826737155,ECE 111,A01,892719,Staff,0,9,50,50
1745826738180,ECE 197,001,957920,Mercier; Patrick Philip,9992,0,9999,7
1745826739207,ECON 178,A01,907814,Zhu; Ying,28,0,35,7
1745826740232,EDS 115,A00,895312,Staff,41,0,45,4
1745826741258,EDS 117,A01,895337,Staff,30,0,30,0
1745826742297,EDS 125,A00,895341,Jones; Gabrielle Anastasia,43,0,45,2
1745826743324,EDS 128A,A01,895459,Fargason; Sharon Gayle,44,0,45,1
1745826744353,EDS 128B,A01,895543,Pappas; Elizabeth,44,0,45,1
1745826745386,EDS 139,A00,897203,Pappas; Elizabeth,44,0,45,1
1745826745386,EDS 139,B00,897209,Fargason; Sharon Gayle,44,0,45,1
1745826746414,EDS 201,A00,895545,Staff,43,0,45,2
1745826747441,EDS 203,A01,895581,Halter; Christopher P.,43,0,45,2
1745826748469,EDS 204R,A01,895625,Heinzman; Erica M.,43,0,45,2
1745826748469,EDS 204R,B01,895693,Halter; Christopher P.,18,0,45,27
1745826749496,EDS 206R,A00,895694,Fargason; Sharon Gayle,9,0,30,21
1745826749496,EDS 206R,B00,895695,Choi; Bailey Miyeon,20,0,30,10
1745826750528,EDS 250,A00,895697,Hemans; Patricia Ann Benitez,43,0,45,2
1745826751555,EDS 281,A00,895701,Meyerott; Theresa Ann,15,0,15,0
1745826752582,EDS 284,A00,895736,Meyerott; Theresa Ann,15,0,15,0
1745826753611,EDS 286,A00,897210,Fine; Sarah,15,0,15,0
1745826754636,EDS 289C,A01,895770,Daly; Alan J.,15,0,15,0
1745826755669,EDS 290,A00,897211,Hofstetter; Carolyn,15,0,15,0
1745826756695,LIGM 5A,A00,896162,Fischer-Grunski; Eva K,15,0,20,5
1745826757721,LIGM 5B,A00,896260,Fischer-Grunski; Eva K,17,0,20,3
1745826758749,LIGM 5C,A00,896308,Fischer-Grunski; Eva K,18,0,20,2
1745826759774,LIIT 5AS,A00,896313,Carnelos; Chiara,17,0,20,3
1745826760804,LIIT 5BS,A00,896416,Carnelos; Chiara,20,0,20,0
1745826761830,LIIT 5CS,A00,896564,Carnelos; Chiara,20,0,20,0
1745826762859,LISP 5A,A00,896588,Munoz Sanchez; Alicia,4,0,20,16
1745826763887,LISP 5B,A00,896653,Munoz Sanchez; Alicia,10,0,20,10
1745826764914,LISP 5C,A00,896655,Munoz Sanchez; Alicia,4,0,20,16
1745826765939,MAE 197,001,957918,Kleissl; Jan,9998,0,9999,1
1745826766969,MATH 2,A01,957937,Staff,34,0,35,1
1745826767993,MATH 197,001,957876,Kedlaya; Kiran S.,9993,0,9999,6
1745826769019,MCWP 40,A00,892729,Duru; Nur,13,0,20,7
1745826769019,MCWP 40,B00,893304,Montejo; Carolina,20,0,20,0
1745826770062,MCWP 40R,A00,893757,Redela; Pamela Morgan,0,7,20,20
1745826771091,MCWP 50,A00,893758,Morshed; Michael James,2,0,20,18
1745826771091,MCWP 50,B00,893761,Bartulis; Jason Michael,18,0,20,2
1745826772118,MCWP 50R,A00,893766,Compas; Sean Matthew,0,1,20,20
1745826772118,MCWP 50R,B00,893769,Carter; Jennifer A,0,0,20,20
1745826772118,MCWP 50R,C00,893771,Krone; Jarret,0,3,20,20
1745826772118,MCWP 50R,D00,893772,Miller; Elizabeth Deen,3,0,20,17
1745826772118,MCWP 50R,E00,893775,Carter; Andrea L,0,0,20,20
1745826773143,MMW 11R,A01,892721,Herbst; Matthew,11,0,27,16
1745826773143,MMW 11R,A02,892722,Herbst; Matthew,0,0,0,3
1745826774170,MMW 12R,A01,892724,Herbst; Matthew,0,10,16,16
1745826774170,MMW 12R,A02,892725,Herbst; Matthew,0,9,16,16
1745826775196,MMW 13R,A01,892727,Staff,0,3,16,16
1745826775196,MMW 13R,A02,892728,Staff,0,4,16,16
1745826775196,MMW 13R,A03,958032,Staff,0,3,16,16
1745826775196,MMW 13R,A04,958033,Staff,0,2,16,16
1745826775196,MMW 13R,A05,958034,Staff,0,3,16,16
1745826776223,SIO 295LS,A00,894015,Staff,7,0,25,18
1745826777250,SIO 295S,A00,894020,Staff,7,0,25,18
1745826778276,SIOC 290S,B01,958918,Staff,0,0,0,0
1745826779304,SIOC 291S,B01,958922,Staff,0,0,0,0
1745826780336,SOCI 117,A01,895339,Staff,4,0,5,1
1745826781360,WES 237B,A00,894149,Staff,11,0,20,9
1745826783468,AESE 279B,A00,891859,Staff,13,0,35,22
1745826784499,AIP 197,001,891854,Staff,70,0,70,0
1745826785532,ANTH 289S,A00,891856,Gagneux; Pascal,12,0,12,0
1745826786558,BENG 196,001,957946,Engler; Adam J.,9996,0,9999,3
1745826787584,CAT 124RS,A01,956906,Staff,8,0,25,17
1745826788614,CAT 125RS,A01,922013,Staff,8,0,25,17
1745826789642,CLRE 250,A00,891860,Morris; Sheldon,9995,0,9999,4
1745826791692,CLRE 251R,A00,907817,Mehta; Ravindra L.,9994,0,9999,5
1745826792724,CLRE 252,A00,891864,Cuomo; Raphael Eduardo,9993,0,9999,6
1745826793751,CLRE 253,A00,891867,Vaida; Florin,9994,0,9999,5
1745826793751,CLRE 253,B00,907819,Staff,9999,0,9999,0
1745826794778,CLRE 259,A00,891868,Patel; Hemal,9998,0,9999,1
1745826795805,CLRE 260,A00,891872,Cuomo; Raphael Eduardo,9999,0,9999,0
1745826796832,CLRE 297,001,891888,Cuomo; Raphael Eduardo,9999,0,9999,0
1745826797857,CSE 191,A00,958773,Minnes Kemp; Mor Mia,9999,0,9999,0
1745826798889,CSS 201S,A01,892054,Mignozzetti; Umberto,30,0,30,0
1745826799916,CSS 202S,A01,892056,Mignozzetti; Umberto,30,0,30,0
1745826800950,DSC 197,001,956898,Eldridge; Justin Matthew,9998,0,9999,1
1745826801979,DSC 297,001,958000,Mazumdar; Arya,9998,0,9999,1
1745826803006,EAP 100,A00,905686,Staff,9776,0,9999,223
1745826804034,ECE 45,A01,892618,Staff,0,13,50,50
1745826805061,ECE 109,A01,892620,Staff,0,43,0,0
1745826806093,ECE 111,A01,892719,Staff,0,9,50,50
1745826807120,ECE 197,001,957920,Mercier; Patrick Philip,9992,0,9999,7
1745826808146,ECON 178,A01,907814,Zhu; Ying,28,0,35,7
1745826809175,EDS 115,A00,895312,Staff,41,0,45,4
1745826810207,EDS 117,A01,895337,Staff,30,0,30,0
1745826811234,EDS 125,A00,895341,Jones; Gabrielle Anastasia,43,0,45,2
1745826812265,EDS 128A,A01,895459,Fargason; Sharon Gayle,44,0,45,1
1745826813291,EDS 128B,A01,895543,Pappas; Elizabeth,44,0,45,1
1745826814317,EDS 139,A00,897203,Pappas; Elizabeth,44,0,45,1
1745826814317,EDS 139,B00,897209,Fargason; Sharon Gayle,44,0,45,1
1745826815347,EDS 201,A00,895545,Staff,43,0,45,2
1745826816380,EDS 203,A01,895581,Halter; Christopher P.,43,0,45,2
1745826817416,EDS 204R,A01,895625,Heinzman; Erica M.,43,0,45,2
1745826817416,EDS 204R,B01,895693,Halter; Christopher P.,18,0,45,27
1745826818442,EDS 206R,A00,895694,Fargason; Sharon Gayle,9,0,30,21
1745826818442,EDS 206R,B00,895695,Choi; Bailey Miyeon,20,0,30,10
1745826819467,EDS 250,A00,895697,Hemans; Patricia Ann Benitez,43,0,45,2
1745826820493,EDS 281,A00,895701,Meyerott; Theresa Ann,15,0,15,0
1745826821521,EDS 284,A00,895736,Meyerott; Theresa Ann,15,0,15,0
1745826822547,EDS 286,A00,897210,Fine; Sarah,15,0,15,0
1745826823573,EDS 289C,A01,895770,Daly; Alan J.,15,0,15,0
1745826824604,EDS 290,A00,897211,Hofstetter; Carolyn,15,0,15,0
1745826825631,LIGM 5A,A00,896162,Fischer-Grunski; Eva K,15,0,20,5
1745826826656,LIGM 5B,A00,896260,Fischer-Grunski; Eva K,17,0,20,3
1745826827683,LIGM 5C,A00,896308,Fischer-Grunski; Eva K,18,0,20,2
1745826828710,LIIT 5AS,A00,896313,Carnelos; Chiara,17,0,20,3
1745826829739,LIIT 5BS,A00,896416,Carnelos; Chiara,20,0,20,0
1745826830769,LIIT 5CS,A00,896564,Carnelos; Chiara,20,0,20,0
1745826831798,LISP 5A,A00,896588,Munoz Sanchez; Alicia,4,0,20,16
1745826832828,LISP 5B,A00,896653,Munoz Sanchez; Alicia,10,0,20,10
1745826833859,LISP 5C,A00,896655,Munoz Sanchez; Alicia,4,0,20,16
1745826834884,MAE 197,001,957918,Kleissl; Jan,9998,0,9999,1
1745826835909,MATH 2,A01,957937,Staff,34,0,35,1
1745826836940,MATH 197,001,957876,Kedlaya; Kiran S.,9993,0,9999,6
1745826837971,MCWP 40,A00,892729,Duru; Nur,13,0,20,7
1745826837971,MCWP 40,B00,893304,Montejo; Carolina,20,0,20,0
1745826839003,MCWP 40R,A00,893757,Redela; Pamela Morgan,0,7,20,20
1745826840035,MCWP 50,A00,893758,Morshed; Michael James,2,0,20,18
1745826840035,MCWP 50,B00,893761,Bartulis; Jason Michael,18,0,20,2
1745826841067,MCWP 50R,A00,893766,Compas; Sean Matthew,0,1,20,20
1745826841067,MCWP 50R,B00,893769,Carter; Jennifer A,0,0,20,20
1745826841067,MCWP 50R,C00,893771,Krone; Jarret,0,3,20,20
1745826841067,MCWP 50R,D00,893772,Miller; Elizabeth Deen,3,0,20,17
1745826841067,MCWP 50R,E00,893775,Carter; Andrea L,0,0,20,20
1745826842097,MMW 11R,A01,892721,Herbst; Matthew,11,0,27,16
1745826842097,MMW 11R,A02,892722,Herbst; Matthew,0,0,0,3
1745826843124,MMW 12R,A01,892724,Herbst; Matthew,0,10,16,16
1745826843124,MMW 12R,A02,892725,Herbst; Matthew,0,9,16,16
1745826844154,MMW 13R,A01,892727,Staff,0,3,16,16
1745826844154,MMW 13R,A02,892728,Staff,0,4,16,16
1745826844154,MMW 13R,A03,958032,Staff,0,3,16,16
1745826844154,MMW 13R,A04,958033,Staff,0,2,16,16
1745826844154,MMW 13R,A05,958034,Staff,0,3,16,16
1745826845181,SIO 295LS,A00,894015,Staff,7,0,25,18
1745826846214,SIO 295S,A00,894020,Staff,7,0,25,18
1745826847241,SIOC 290S,B01,958918,Staff,0,0,0,0
1745826848271,SIOC 291S,B01,958922,Staff,0,0,0,0
1745826849297,SOCI 117,A01,895339,Staff,4,0,5,1
1745826850324,WES 237B,A00,894149,Staff,11,0,20,9
1745826852393,AESE 279B,A00,891859,Staff,13,0,35,22
1745826853421,AIP 197,001,891854,Staff,70,0,70,0
1745826854452,ANTH 289S,A00,891856,Gagneux; Pascal,12,0,12,0
1745826855479,BENG 196,001,957946,Engler; Adam J.,9996,0,9999,3
1745826856506,CAT 124RS,A01,956906,Staff,8,0,25,17
1745826857537,CAT 125RS,A01,922013,Staff,8,0,25,17
1745826858567,CLRE 250,A00,891860,Morris; Sheldon,9995,0,9999,4
1745826860624,CLRE 251R,A00,907817,Mehta; Ravindra L.,9994,0,9999,5
1745826861652,CLRE 252,A00,891864,Cuomo; Raphael Eduardo,9993,0,9999,6
1745826862676,CLRE 253,A00,891867,Vaida; Florin,9994,0,9999,5
1745826862676,CLRE 253,B00,907819,Staff,9999,0,9999,0
1745826863706,CLRE 259,A00,891868,Patel; Hemal,9998,0,9999,1
1745826864731,CLRE 260,A00,891872,Cuomo; Raphael Eduardo,9999,0,9999,0
1745826865758,CLRE 297,001,891888,Cuomo; Raphael Eduardo,9999,0,9999,0
1745826866785,CSE 191,A00,958773,Minnes Kemp; Mor Mia,9999,0,9999,0
1745826867811,CSS 201S,A01,892054,Mignozzetti; Umberto,30,0,30,0
1745826868841,CSS 202S,A01,892056,Mignozzetti; Umberto,30,0,30,0
1745826869868,DSC 197,001,956898,Eldridge; Justin Matthew,9998,0,9999,1
1745826870892,DSC 297,001,958000,Mazumdar; Arya,9998,0,9999,1
1745826871918,EAP 100,A00,905686,Staff,9776,0,9999,223
1745826872954,ECE 45,A01,892618,Staff,0,13,50,50
1745826873981,ECE 109,A01,892620,Staff,0,43,0,0
1745826875008,ECE 111,A01,892719,Staff,0,9,50,50
1745826876034,ECE 197,001,957920,Mercier; Patrick Philip,9992,0,9999,7
1745826877060,ECON 178,A01,907814,Zhu; Ying,28,0,35,7
1745826878085,EDS 115,A00,895312,Staff,41,0,45,4
1745826879112,EDS 117,A01,895337,Staff,30,0,30,0
1745826880139,EDS 125,A00,895341,Jones; Gabrielle Anastasia,43,0,45,2
1745826881170,EDS 128A,A01,895459,Fargason; Sharon Gayle,44,0,45,1
1745826882201,EDS 128B,A01,895543,Pappas; Elizabeth,44,0,45,1
1745826883228,EDS 139,A00,897203,Pappas; Elizabeth,44,0,45,1
1745826883228,EDS 139,B00,897209,Fargason; Sharon Gayle,44,0,45,1
1745826884256,EDS 201,A00,895545,Staff,43,0,45,2
1745826885284,EDS 203,A01,895581,Halter; Christopher P.,43,0,45,2
1745826886313,EDS 204R,A01,895625,Heinzman; Erica M.,43,0,45,2
1745826886313,EDS 204R,B01,895693,Halter; Christopher P.,18,0,45,27
1745826887339,EDS 206R,A00,895694,Fargason; Sharon Gayle,9,0,30,21
1745826887339,EDS 206R,B00,895695,Choi; Bailey Miyeon,20,0,30,10
1745826888371,EDS 250,A00,895697,Hemans; Patricia Ann Benitez,43,0,45,2
1745826889397,EDS 281,A00,895701,Meyerott; Theresa Ann,15,0,15,0
1745826890425,EDS 284,A00,895736,Meyerott; Theresa Ann,15,0,15,0
1745826891494,EDS 286,A00,897210,Fine; Sarah,15,0,15,0
1745826892520,EDS 289C,A01,895770,Daly; Alan J.,15,0,15,0
1745826893546,EDS 290,A00,897211,Hofstetter; Carolyn,15,0,15,0
1745826894582,LIGM 5A,A00,896162,Fischer-Grunski; Eva K,15,0,20,5
1745826895609,LIGM 5B,A00,896260,Fischer-Grunski; Eva K,17,0,20,3
1745826896635,LIGM 5C,A00,896308,Fischer-Grunski; Eva K,18,0,20,2
1745826897669,LIIT 5AS,A00,896313,Carnelos; Chiara,17,0,20,3
1745826898694,LIIT 5BS,A00,896416,Carnelos; Chiara,20,0,20,0
1745826899727,LIIT 5CS,A00,896564,Carnelos; Chiara,20,0,20,0
1745826900756,LISP 5A,A00,896588,Munoz Sanchez; Alicia,4,0,20,16
1745826901795,LISP 5B,A00,896653,Munoz Sanchez; Alicia,10,0,20,10
1745826902821,LISP 5C,A00,896655,Munoz Sanchez; Alicia,4,0,20,16
1745826903848,MAE 197,001,957918,Kleissl; Jan,9998,0,9999,1
1745826904878,MATH 2,A01,957937,Staff,34,0,35,1
1745826905906,MATH 197,001,957876,Kedlaya; Kiran S.,9993,0,9999,6
1745826906933,MCWP 40,A00,892729,Duru; Nur,13,0,20,7
1745826906933,MCWP 40,B00,893304,Montejo; Carolina,20,0,20,0
1745826907960,MCWP 40R,A00,893757,Redela; Pamela Morgan,0,7,20,20
1745826908985,MCWP 50,A00,893758,Morshed; Michael James,2,0,20,18
1745826908985,MCWP 50,B00,893761,Bartulis; Jason Michael,18,0,20,2
1745826910036,MCWP 50R,A00,893766,Compas; Sean Matthew,0,1,20,20
1745826910036,MCWP 50R,B00,893769,Carter; Jennifer A,0,0,20,20
1745826910036,MCWP 50R,C00,893771,Krone; Jarret,0,3,20,20
1745826910036,MCWP 50R,D00,893772,Miller; Elizabeth Deen,3,0,20,17
1745826910036,MCWP 50R,E00,893775,Carter; Andrea L,0,0,20,20
1745826911065,MMW 11R,A01,892721,Herbst; Matthew,11,0,27,16
1745826911065,MMW 11R,A02,892722,Herbst; Matthew,0,0,0,3
1745826912094,MMW 12R,A01,892724,Herbst; Matthew,0,10,16,16
1745826912094,MMW 12R,A02,892725,Herbst; Matthew,0,9,16,16
1745826913119,MMW 13R,A01,892727,Staff,0,3,16,16
1745826913119,MMW 13R,A02,892728,Staff,0,4,16,16
1745826913119,MMW 13R,A03,958032,Staff,0,3,16,16
1745826913119,MMW 13R,A04,958033,Staff,0,2,16,16
1745826913119,MMW 13R,A05,958034,Staff,0,3,16,16
1745826914146,SIO 295LS,A00,894015,Staff,7,0,25,18
1745826915176,SIO 295S,A00,894020,Staff,7,0,25,18
1745826916202,SIOC 290S,B01,958918,Staff,0,0,0,0
1745826917231,SIOC 291S,B01,958922,Staff,0,0,0,0
1745826918261,SOCI 117,A01,895339,Staff,4,0,5,1
1745826919287,WES 237B,A00,894149,Staff,11,0,20,9
1745826921361,AESE 279B,A00,891859,Staff,13,0,35,22
1745826922395,AIP 197,001,891854,Staff,70,0,70,0
1745826923423,ANTH 289S,A00,891856,Gagneux; Pascal,12,0,12,0
1745826924452,BENG 196,001,957946,Engler; Adam J.,9996,0,9999,3
1745826925479,CAT 124RS,A01,956906,Staff,8,0,25,17
1745826926505,CAT 125RS,A01,922013,Staff,8,0,25,17
1745826927538,CLRE 250,A00,891860,Morris; Sheldon,9995,0,9999,4
1745826929599,CLRE 251R,A00,907817,Mehta; Ravindra L.,9994,0,9999,5
1745826930635,CLRE 252,A00,891864,Cuomo; Raphael Eduardo,9993,0,9999,6
1745826931661,CLRE 253,A00,891867,Vaida; Florin,9994,0,9999,5
1745826931661,CLRE 253,B00,907819,Staff,9999,0,9999,0
1745826932690,CLRE 259,A00,891868,Patel; Hemal,9998,0,9999,1
1745826933717,CLRE 260,A00,891872,Cuomo; Raphael Eduardo,9999,0,9999,0
1745826934750,CLRE 297,001,891888,Cuomo; Raphael Eduardo,9999,0,9999,0
1745826935777,CSE 191,A00,958773,Minnes Kemp; Mor Mia,9999,0,9999,0
1745826936808,CSS 201S,A01,892054,Mignozzetti; Umberto,30,0,30,0
1745826937834,CSS 202S,A01,892056,Mignozzetti; Umberto,30,0,30,0
1745826938861,DSC 197,001,956898,Eldridge; Justin Matthew,9998,0,9999,1
1745826939887,DSC 297,001,958000,Mazumdar; Arya,9998,0,9999,1
1745826940913,EAP 100,A00,905686,Staff,9776,0,9999,223
1745826941944,ECE 45,A01,892618,Staff,0,13,50,50
1745826942970,ECE 109,A01,892620,Staff,0,43,0,0
1745826943998,ECE 111,A01,892719,Staff,0,9,50,50
1745826945033,ECE 197,001,957920,Mercier; Patrick Philip,9992,0,9999,7
1745826946067,ECON 178,A01,907814,Zhu; Ying,28,0,35,7
1745826947093,EDS 115,A00,895312,Staff,41,0,45,4
1745826948119,EDS 117,A01,895337,Staff,30,0,30,0
1745826949146,EDS 125,A00,895341,Jones; Gabrielle Anastasia,43,0,45,2
1745826950183,EDS 128A,A01,895459,Fargason; Sharon Gayle,44,0,45,1
1745826951208,EDS 128B,A01,895543,Pappas; Elizabeth,44,0,45,1
1745826952235,EDS 139,A00,897203,Pappas; Elizabeth,44,0,45,1
1745826952235,EDS 139,B00,897209,Fargason; Sharon Gayle,44,0,45,1
1745826953260,EDS 201,A00,895545,Staff,43,0,45,2
1745826954289,EDS 203,A01,895581,Halter; Christopher P.,43,0,45,2
1745826955318,EDS 204R,A01,895625,Heinzman; Erica M.,43,0,45,2
1745826955318,EDS 204R,B01,895693,Halter; Christopher P.,18,0,45,27
1745826956345,EDS 206R,A00,895694,Fargason; Sharon Gayle,9,0,30,21
1745826956345,EDS 206R,B00,895695,Choi; Bailey Miyeon,20,0,30,10
1745826957373,EDS 250,A00,895697,Hemans; Patricia Ann Benitez,43,0,45,2
1745826958399,EDS 281,A00,895701,Meyerott; Theresa Ann,15,0,15,0
1745826959423,EDS 284,A00,895736,Meyerott; Theresa Ann,15,0,15,0
1745826960451,EDS 286,A00,897210,Fine; Sarah,15,0,15,0
1745826961478,EDS 289C,A01,895770,Daly; Alan J.,15,0,15,0
1745826962504,EDS 290,A00,897211,Hofstetter; Carolyn,15,0,15,0
1745826963538,LIGM 5A,A00,896162,Fischer-Grunski; Eva K,15,0,20,5
1745826964563,LIGM 5B,A00,896260,Fischer-Grunski; Eva K,17,0,20,3
1745826965589,LIGM 5C,A00,896308,Fischer-Grunski; Eva K,18,0,20,2
1745826966618,LIIT 5AS,A00,896313,Carnelos; Chiara,17,0,20,3
1745826967647,LIIT 5BS,A00,896416,Carnelos; Chiara,20,0,20,0
1745826968673,LIIT 5CS,A00,896564,Carnelos; Chiara,20,0,20,0
1745826969699,LISP 5A,A00,896588,Munoz Sanchez; Alicia,4,0,20,16
1745826970729,LISP 5B,A00,896653,Munoz Sanchez; Alicia,10,0,20,10
1745826971758,LISP 5C,A00,896655,Munoz Sanchez; Alicia,4,0,20,16
1745826972789,MAE 197,001,957918,Kleissl; Jan,9998,0,9999,1
1745826973825,MATH 2,A01,957937,Staff,34,0,35,1
1745826974855,MATH 197,001,957876,Kedlaya; Kiran S.,9993,0,9999,6
1745826975903,MCWP 40,A00,892729,Duru; Nur,13,0,20,7
1745826975903,MCWP 40,B00,893304,Montejo; Carolina,20,0,20,0
1745826976932,MCWP 40R,A00,893757,Redela; Pamela Morgan,0,7,20,20
1745826977962,MCWP 50,A00,893758,Morshed; Michael James,2,0,20,18
1745826977962,MCWP 50,B00,893761,Bartulis; Jason Michael,18,0,20,2
1745826978988,MCWP 50R,A00,893766,Compas; Sean Matthew,0,1,20,20
1745826978988,MCWP 50R,B00,893769,Carter; Jennifer A,0,0,20,20
1745826978988,MCWP 50R,C00,893771,Krone; Jarret,0,3,20,20
1745826978988,MCWP 50R,D00,893772,Miller; Elizabeth Deen,3,0,20,17
1745826978988,MCWP 50R,E00,893775,Carter; Andrea L,0,0,20,20
1745826980017,MMW 11R,A01,892721,Herbst; Matthew,11,0,27,16
1745826980017,MMW 11R,A02,892722,Herbst; Matthew,0,0,0,3
1745826981047,MMW 12R,A01,892724,Herbst; Matthew,0,10,16,16
1745826981047,MMW 12R,A02,892725,Herbst; Matthew,0,9,16,16
1745826982073,MMW 13R,A01,892727,Staff,0,3,16,16
1745826982073,MMW 13R,A02,892728,Staff,0,4,16,16
1745826982073,MMW 13R,A03,958032,Staff,0,3,16,16
1745826982073,MMW 13R,A04,958033,Staff,0,2,16,16
1745826982073,MMW 13R,A05,958034,Staff,0,3,16,16
1745826983104,SIO 295LS,A00,894015,Staff,7,0,25,18
1745826984130,SIO 295S,A00,894020,Staff,7,0,25,18
1745826985158,SIOC 290S,B01,958918,Staff,0,0,0,0
1745826986184,SIOC 291S,B01,958922,Staff,0,0,0,0
1745826987211,SOCI 117,A01,895339,Staff,4,0,5,1
1745826988239,WES 237B,A00,894149,Staff,11,0,20,9
1745826990357,AESE 279B,A00,891859,Staff,13,0,35,22
1745826991384,AIP 197,001,891854,Staff,70,0,70,0
1745826992411,ANTH 289S,A00,891856,Gagneux; Pascal,12,0,12,0
1745826993441,BENG 196,001,957946,Engler; Adam J.,9996,0,9999,3
1745826994468,CAT 124RS,A01,956906,Staff,8,0,25,17
1745826995498,CAT 125RS,A01,922013,Staff,8,0,25,17
1745826996529,CLRE 250,A00,891860,Morris; Sheldon,9995,0,9999,4
1745826998585,CLRE 251R,A00,907817,Mehta; Ravindra L.,9994,0,9999,5
1745826999615,CLRE 252,A00,891864,Cuomo; Raphael Eduardo,9993,0,9999,6
1745827000641,CLRE 253,A00,891867,Vaida; Florin,9994,0,9999,5
1745827000641,CLRE 253,B00,907819,Staff,9999,0,9999,0
1745827001666,CLRE 259,A00,891868,Patel; Hemal,9998,0,9999,1
1745827002695,CLRE 260,A00,891872,Cuomo; Raphael Eduardo,9999,0,9999,0
1745827003720,CLRE 297,001,891888,Cuomo; Raphael Eduardo,9999,0,9999,0
1745827004746,CSE 191,A00,958773,Minnes Kemp; Mor Mia,9999,0,9999,0
1745827005779,CSS 201S,A01,892054,Mignozzetti; Umberto,30,0,30,0
1745827006809,CSS 202S,A01,892056,Mignozzetti; Umberto,30,0,30,0
1745827007836,DSC 197,001,956898,Eldridge; Justin Matthew,9998,0,9999,1
1745827008866,DSC 297,001,958000,Mazumdar; Arya,9998,0,9999,1
1745827009894,EAP 100,A00,905686,Staff,9776,0,9999,223
1745827010923,ECE 45,A01,892618,Staff,0,13,50,50
1745827011955,ECE 109,A01,892620,Staff,0,43,0,0
1745827012985,ECE 111,A01,892719,Staff,0,9,50,50
1745827014017,ECE 197,001,957920,Mercier; Patrick Philip,9992,0,9999,7
1745827015052,ECON 178,A01,907814,Zhu; Ying,28,0,35,7
1745827016082,EDS 115,A00,895312,Staff,41,0,45,4
1745827017108,EDS 117,A01,895337,Staff,30,0,30,0
1745827018135,EDS 125,A00,895341,Jones; Gabrielle Anastasia,43,0,45,2
1745827019168,EDS 128A,A01,895459,Fargason; Sharon Gayle,44,0,45,1
1745827020198,EDS 128B,A01,895543,Pappas; Elizabeth,44,0,45,1
1745827021227,EDS 139,A00,897203,Pappas; Elizabeth,44,0,45,1
1745827021227,EDS 139,B00,897209,Fargason; Sharon Gayle,44,0,45,1
1745827022255,EDS 201,A00,895545,Staff,43,0,45,2
1745827023282,EDS 203,A01,895581,Halter; Christopher P.,43,0,45,2
1745827024311,EDS 204R,A01,895625,Heinzman; Erica M.,43,0,45,2
1745827024311,EDS 204R,B01,895693,Halter; Christopher P.,18,0,45,27
1745827025339,EDS 206R,A00,895694,Fargason; Sharon Gayle,9,0,30,21
1745827025339,EDS 206R,B00,895695,Choi; Bailey Miyeon,20,0,30,10
1745827026370,EDS 250,A00,895697,Hemans; Patricia Ann Benitez,43,0,45,2
1745827027397,EDS 281,A00,895701,Meyerott; Theresa Ann,15,0,15,0
1745827028428,EDS 284,A00,895736,Meyerott; Theresa Ann,15,0,15,0
1745827029458,EDS 286,A00,897210,Fine; Sarah,15,0,15,0
1745827030485,EDS 289C,A01,895770,Daly; Alan J.,15,0,15,0
1745827031510,EDS 290,A00,897211,Hofstetter; Carolyn,15,0,15,0
1745827032545,LIGM 5A,A00,896162,Fischer-Grunski; Eva K,15,0,20,5
1745827033576,LIGM 5B,A00,896260,Fischer-Grunski; Eva K,17,0,20,3
1745827034605,LIGM 5C,A00,896308,Fischer-Grunski; Eva K,18,0,20,2
1745827035633,LIIT 5AS,A00,896313,Carnelos; Chiara,17,0,20,3
1745827036661,LIIT 5BS,A00,896416,Carnelos; Chiara,20,0,20,0
1745827037687,LIIT 5CS,A00,896564,Carnelos; Chiara,20,0,20,0
1745827038718,LISP 5A,A00,896588,Munoz Sanchez; Alicia,4,0,20,16
1745827039743,LISP 5B,A00,896653,Munoz Sanchez; Alicia,10,0,20,10
1745827040773,LISP 5C,A00,896655,Munoz Sanchez; Alicia,4,0,20,16
1745827041800,MAE 197,001,957918,Kleissl; Jan,9998,0,9999,1
1745827042831,MATH 2,A01,957937,Staff,34,0,35,1
1745827043859,MATH 197,001,957876,Kedlaya; Kiran S.,9993,0,9999,6
1745827044886,MCWP 40,A00,892729,Duru; Nur,13,0,20,7
1745827044886,MCWP 40,B00,893304,Montejo; Carolina,20,0,20,0
1745827045915,MCWP 40R,A00,893757,Redela; Pamela Morgan,0,7,20,20
1745827046941,MCWP 50,A00,893758,Morshed; Michael James,2,0,20,18
1745827046941,MCWP 50,B00,893761,Bartulis; Jason Michael,18,0,20,2
1745827047968,MCWP 50R,A00,893766,Compas; Sean Matthew,0,1,20,20
1745827047968,MCWP 50R,B00,893769,Carter; Jennifer A,0,0,20,20
1745827047968,MCWP 50R,C00,893771,Krone; Jarret,0,3,20,20
1745827047968,MCWP 50R,D00,893772,Miller; Elizabeth Deen,3,0,20,17
1745827047968,MCWP 50R,E00,893775,Carter; Andrea L,0,0,20,20
1745827048994,MMW 11R,A01,892721,Herbst; Matthew,11,0,27,16
1745827048994,MMW 11R,A02,892722,Herbst; Matthew,0,0,0,3
1745827050028,MMW 12R,A01,892724,Herbst; Matthew,0,10,16,16
1745827050028,MMW 12R,A02,892725,Herbst; Matthew,0,9,16,16
1745827051054,MMW 13R,A01,892727,Staff,0,3,16,16
1745827051054,MMW 13R,A02,892728,Staff,0,4,16,16
1745827051054,MMW 13R,A03,958032,Staff,0,3,16,16
1745827051054,MMW 13R,A04,958033,Staff,0,2,16,16
1745827051054,MMW 13R,A05,958034,Staff,0,3,16,16
1745827052081,SIO 295LS,A00,894015,Staff,7,0,25,18
1745827053107,SIO 295S,A00,894020,Staff,7,0,25,18
1745827054134,SIOC 290S,B01,958918,Staff,0,0,0,0
1745827055161,SIOC 291S,B01,958922,Staff,0,0,0,0
1745827056185,SOCI 117,A01,895339,Staff,4,0,5,1
1745827057211,WES 237B,A00,894149,Staff,11,0,20,9
1745827059297,AESE 279B,A00,891859,Staff,13,0,35,22
1745827060323,AIP 197,001,891854,Staff,70,0,70,0
1745827061354,ANTH 289S,A00,891856,Gagneux; Pascal,12,0,12,0
1745827062380,BENG 196,001,957946,Engler; Adam J.,9996,0,9999,3
1745827063410,CAT 124RS,A01,956906,Staff,8,0,25,17
1745827064438,CAT 125RS,A01,922013,Staff,8,0,25,17
1745827065468,CLRE 250,A00,891860,Morris; Sheldon,9995,0,9999,4
1745827067521,CLRE 251R,A00,907817,Mehta; Ravindra L.,9994,0,9999,5
1745827068603,CLRE 252,A00,891864,Cuomo; Raphael Eduardo,9993,0,9999,6
1745827069633,CLRE 253,A00,891867,Vaida; Florin,9994,0,9999,5
1745827069633,CLRE 253,B00,907819,Staff,9999,0,9999,0
1745827070658,CLRE 259,A00,891868,Patel; Hemal,9998,0,9999,1
1745827071682,CLRE 260,A00,891872,Cuomo; Raphael Eduardo,9999,0,9999,0
1745827072709,CLRE 297,001,891888,Cuomo; Raphael Eduardo,9999,0,9999,0
1745827073739,CSE 191,A00,958773,Minnes Kemp; Mor Mia,9999,0,9999,0
1745827074766,CSS 201S,A01,892054,Mignozzetti; Umberto,30,0,30,0
1745827075802,CSS 202S,A01,892056,Mignozzetti; Umberto,30,0,30,0
1745827076832,DSC 197,001,956898,Eldridge; Justin Matthew,9998,0,9999,1
1745827077859,DSC 297,001,958000,Mazumdar; Arya,9998,0,9999,1
1745827078889,EAP 100,A00,905686,Staff,9776,0,9999,223
1745827079920,ECE 45,A01,892618,Staff,0,13,50,50
1745827080945,ECE 109,A01,892620,Staff,0,43,0,0
1745827081973,ECE 111,A01,892719,Staff,0,9,50,50
1745827083005,ECE 197,001,957920,Mercier; Patrick Philip,9992,0,9999,7
1745827084033,ECON 178,A01,907814,Zhu; Ying,28,0,35,7
1745827085065,EDS 115,A00,895312,Staff,41,0,45,4
1745827086093,EDS 117,A01,895337,Staff,30,0,30,0
1745827087124,EDS 125,A00,895341,Jones; Gabrielle Anastasia,43,0,45,2
1745827088156,EDS 128A,A01,895459,Fargason; Sharon Gayle,44,0,45,1
1745827089184,EDS 128B,A01,895543,Pappas; Elizabeth,44,0,45,1
1745827090213,EDS 139,A00,897203,Pappas; Elizabeth,44,0,45,1
1745827090213,EDS 139,B00,897209,Fargason; Sharon Gayle,44,0,45,1
1745827091238,EDS 201,A00,895545,Staff,43,0,45,2
1745827092264,EDS 203,A01,895581,Halter; Christopher P.,43,0,45,2
1745827093301,EDS 204R,A01,895625,Heinzman; Erica M.,43,0,45,2
1745827093301,EDS 204R,B01,895693,Halter; Christopher P.,18,0,45,27
1745827094333,EDS 206R,A00,895694,Fargason; Sharon Gayle,9,0,30,21
1745827094333,EDS 206R,B00,895695,Choi; Bailey Miyeon,20,0,30,10
1745827095360,EDS 250,A00,895697,Hemans; Patricia Ann Benitez,43,0,45,2
1745827096386,EDS 281,A00,895701,Meyerott; Theresa Ann,15,0,15,0
1745827097415,EDS 284,A00,895736,Meyerott; Theresa Ann,15,0,15,0
1745827098440,EDS 286,A00,897210,Fine; Sarah,15,0,15,0
1745827099467,EDS 289C,A01,895770,Daly; Alan J.,15,0,15,0
1745827100498,EDS 290,A00,897211,Hofstetter; Carolyn,15,0,15,0
1745827101526,LIGM 5A,A00,896162,Fischer-Grunski; Eva K,15,0,20,5
1745827102559,LIGM 5B,A00,896260,Fischer-Grunski; Eva K,17,0,20,3
1745827103587,LIGM 5C,A00,896308,Fischer-Grunski; Eva K,18,0,20,2
1745827104613,LIIT 5AS,A00,896313,Carnelos; Chiara,17,0,20,3
1745827105639,LIIT 5BS,A00,896416,Carnelos; Chiara,20,0,20,0
1745827106666,LIIT 5CS,A00,896564,Carnelos; Chiara,20,0,20,0
1745827107690,LISP 5A,A00,896588,Munoz Sanchez; Alicia,4,0,20,16
1745827108715,LISP 5B,A00,896653,Munoz Sanchez; Alicia,10,0,20,10
1745827109740,LISP 5C,A00,896655,Munoz Sanchez; Alicia,4,0,20,16
1745827110765,MAE 197,001,957918,Kleissl; Jan,9998,0,9999,1
1745827111795,MATH 2,A01,957937,Staff,34,0,35,1
1745827112822,MATH 197,001,957876,Kedlaya; Kiran S.,9993,0,9999,6
1745827113851,MCWP 40,A00,892729,Duru; Nur,13,0,20,7
1745827113851,MCWP 40,B00,893304,Montejo; Carolina,20,0,20,0
1745827114880,MCWP 40R,A00,893757,Redela; Pamela Morgan,0,7,20,20
1745827115909,MCWP 50,A00,893758,Morshed; Michael James,2,0,20,18
1745827115909,MCWP 50,B00,893761,Bartulis; Jason Michael,18,0,20,2
1745827116941,MCWP 50R,A00,893766,Compas; Sean Matthew,0,1,20,20
1745827116941,MCWP 50R,B00,893769,Carter; Jennifer A,0,0,20,20
1745827116941,MCWP 50R,C00,893771,Krone; Jarret,0,3,20,20
1745827116941,MCWP 50R,D00,893772,Miller; Elizabeth Deen,3,0,20,17
1745827116941,MCWP 50R,E00,893775,Carter; Andrea L,0,0,20,20
1745827117969,MMW 11R,A01,892721,Herbst; Matthew,11,0,27,16
1745827117969,MMW 11R,A02,892722,Herbst; Matthew,0,0,0,3
1745827119000,MMW 12R,A01,892724,Herbst; Matthew,0,10,16,16
1745827119000,MMW 12R,A02,892725,Herbst; Matthew,0,9,16,16
1745827120030,MMW 13R,A01,892727,Staff,0,3,16,16
1745827120030,MMW 13R,A02,892728,Staff,0,4,16,16
1745827120030,MMW 13R,A03,958032,Staff,0,3,16,16
1745827120030,MMW 13R,A04,958033,Staff,0,2,16,16
1745827120030,MMW 13R,A05,958034,Staff,0,3,16,16
1745827121060,SIO 295LS,A00,894015,Staff,7,0,25,18
1745827122087,SIO 295S,A00,894020,Staff,7,0,25,18
1745827123113,SIOC 290S,B01,958918,Staff,0,0,0,0
1745827124141,SIOC 291S,B01,958922,Staff,0,0,0,0
1745827125168,SOCI 117,A01,895339,Staff,4,0,5,1
1745827126198,WES 237B,A00,894149,Staff,11,0,20,9
1745827128304,AESE 279B,A00,891859,Staff,13,0,35,22
1745827129331,AIP 197,001,891854,Staff,70,0,70,0
1745827130358,ANTH 289S,A00,891856,Gagneux; Pascal,12,0,12,0
1745827131384,BENG 196,001,957946,Engler; Adam J.,9996,0,9999,3
1745827132408,CAT 124RS,A01,956906,Staff,8,0,25,17
1745827133433,CAT 125RS,A01,922013,Staff,8,0,25,17
1745827134461,CLRE 250,A00,891860,Morris; Sheldon,9995,0,9999,4
1745827136515,CLRE 251R,A00,907817,Mehta; Ravindra L.,9994,0,9999,5
1745827137543,CLRE 252,A00,891864,Cuomo; Raphael Eduardo,9993,0,9999,6
1745827138571,CLRE 253,A00,891867,Vaida; Florin,9994,0,9999,5
1745827138571,CLRE 253,B00,907819,Staff,9999,0,9999,0
1745827139601,CLRE 259,A00,891868,Patel; Hemal,9998,0,9999,1
1745827140630,CLRE 260,A00,891872,Cuomo; Raphael Eduardo,9999,0,9999,0
1745827141658,CLRE 297,001,891888,Cuomo; Raphael Eduardo,9999,0,9999,0
1745827142690,CSE 191,A00,958773,Minnes Kemp; Mor Mia,9999,0,9999,0
1745827143718,CSS 201S,A01,892054,Mignozzetti; Umberto,30,0,30,0
1745827144744,CSS 202S,A01,892056,Mignozzetti; Umberto,30,0,30,0
1745827145771,DSC 197,001,956898,Eldridge; Justin Matthew,9998,0,9999,1
1745827146797,DSC 297,001,958000,Mazumdar; Arya,9998,0,9999,1
1745827147826,EAP 100,A00,905686,Staff,9776,0,9999,223
1745827148857,ECE 45,A01,892618,Staff,0,13,50,50
1745827149889,ECE 109,A01,892620,Staff,0,43,0,0
1745827150916,ECE 111,A01,892719,Staff,0,9,50,50
1745827151942,ECE 197,001,957920,Mercier; Patrick Philip,9992,0,9999,7
1745827152969,ECON 178,A01,907814,Zhu; Ying,28,0,35,7
1745827154000,EDS 115,A00,895312,Staff,41,0,45,4
1745827155029,EDS 117,A01,895337,Staff,30,0,30,0
1745827156062,EDS 125,A00,895341,Jones; Gabrielle Anastasia,43,0,45,2
1745827157091,EDS 128A,A01,895459,Fargason; Sharon Gayle,44,0,45,1
1745827158123,EDS 128B,A01,895543,Pappas; Elizabeth,44,0,45,1
1745827159150,EDS 139,A00,897203,Pappas; Elizabeth,44,0,45,1
1745827159150,EDS 139,B00,897209,Fargason; Sharon Gayle,44,0,45,1
1745827160174,EDS 201,A00,895545,Staff,43,0,45,2
1745827161203,EDS 203,A01,895581,Halter; Christopher P.,43,0,45,2
1745827162230,EDS 204R,A01,895625,Heinzman; Erica M.,43,0,45,2
1745827162230,EDS 204R,B01,895693,Halter; Christopher P.,18,0,45,27
1745827163256,EDS 206R,A00,895694,Fargason; Sharon Gayle,9,0,30,21
1745827163256,EDS 206R,B00,895695,Choi; Bailey Miyeon,20,0,30,10
1745827164285,EDS 250,A00,895697,Hemans; Patricia Ann Benitez,43,0,45,2
1745827165316,EDS 281,A00,895701,Meyerott; Theresa Ann,15,0,15,0
1745827166347,EDS 284,A00,895736,Meyerott; Theresa Ann,15,0,15,0
1745827167393,EDS 286,A00,897210,Fine; Sarah,15,0,15,0
1745827168425,EDS 289C,A01,895770,Daly; Alan J.,15,0,15,0
1745827169454,EDS 290,A00,897211,Hofstetter; Carolyn,15,0,15,0
1745827170480,LIGM 5A,A00,896162,Fischer-Grunski; Eva K,15,0,20,5
1745827171510,LIGM 5B,A00,896260,Fischer-Grunski; Eva K,17,0,20,3
1745827172541,LIGM 5C,A00,896308,Fischer-Grunski; Eva K,18,0,20,2
1745827173569,LIIT 5AS,A00,896313,Carnelos; Chiara,17,0,20,3
1745827174600,LIIT 5BS,A00,896416,Carnelos; Chiara,20,0,20,0
1745827175626,LIIT 5CS,A00,896564,Carnelos; Chiara,20,0,20,0
1745827176653,LISP 5A,A00,896588,Munoz Sanchez; Alicia,4,0,20,16
1745827177684,LISP 5B,A00,896653,Munoz Sanchez; Alicia,10,0,20,10
1745827178715,LISP 5C,A00,896655,Munoz Sanchez; Alicia,4,0,20,16
1745827179744,MAE 197,001,957918,Kleissl; Jan,9998,0,9999,1
1745827180773,MATH 2,A01,957937,Staff,34,0,35,1
1745827181805,MATH 197,001,957876,Kedlaya; Kiran S.,9993,0,9999,6
1745827182833,MCWP 40,A00,892729,Duru; Nur,13,0,20,7
1745827182833,MCWP 40,B00,893304,Montejo; Carolina,20,0,20,0
1745827183861,MCWP 40R,A00,893757,Redela; Pamela Morgan,0,7,20,20
1745827184891,MCWP 50,A00,893758,Morshed; Michael James,2,0,20,18
1745827184891,MCWP 50,B00,893761,Bartulis; Jason Michael,18,0,20,2
1745827185919,MCWP 50R,A00,893766,Compas; Sean Matthew,0,1,20,20
1745827185919,MCWP 50R,B00,893769,Carter; Jennifer A,0,0,20,20
1745827185919,MCWP 50R,C00,893771,Krone; Jarret,0,3,20,20
1745827185919,MCWP 50R,D00,893772,Miller; Elizabeth Deen,3,0,20,17
1745827185919,MCWP 50R,E00,893775,Carter; Andrea L,0,0,20,20
1745827186947,MMW 11R,A01,892721,Herbst; Matthew,11,0,27,16
1745827186947,MMW 11R,A02,892722,Herbst; Matthew,0,0,0,3
1745827187976,MMW 12R,A01,892724,Herbst; Matthew,0,10,16,16
1745827187976,MMW 12R,A02,892725,Herbst; Matthew,0,9,16,16
1745827189007,MMW 13R,A01,892727,Staff,0,3,16,16
1745827189007,MMW 13R,A02,892728,Staff,0,4,16,16
1745827189007,MMW 13R,A03,958032,Staff,0,3,16,16
1745827189007,MMW 13R,A04,958033,Staff,0,2,16,16
1745827189007,MMW 13R,A05,958034,Staff,0,3,16,16
1745827190048,SIO 295LS,A00,894015,Staff,7,0,25,18
1745827191088,SIO 295S,A00,894020,Staff,7,0,25,18
1745827192120,SIOC 290S,B01,958918,Staff,0,0,0,0
1745827193151,SIOC 291S,B01,958922,Staff,0,0,0,0
1745827194176,SOCI 117,A01,895339,Staff,4,0,5,1
1745827195202,WES 237B,A00,894149,Staff,11,0,20,9
1745827197272,AESE 279B,A00,891859,Staff,13,0,35,22
1745827198297,AIP 197,001,891854,Staff,70,0,70,0
1745827199323,ANTH 289S,A00,891856,Gagneux; Pascal,12,0,12,0
1745827200348,BENG 196,001,957946,Engler; Adam J.,9996,0,9999,3
1745827201375,CAT 124RS,A01,956906,Staff,8,0,25,17
1745827202403,CAT 125RS,A01,922013,Staff,8,0,25,17
1745827203433,CLRE 250,A00,891860,Morris; Sheldon,9995,0,9999,4
1745827205488,CLRE 251R,A00,907817,Mehta; Ravindra L.,9994,0,9999,5
1745827206515,CLRE 252,A00,891864,Cuomo; Raphael Eduardo,9993,0,9999,6
1745827207542,CLRE 253,A00,891867,Vaida; Florin,9994,0,9999,5
1745827207542,CLRE 253,B00,907819,Staff,9999,0,9999,0
1745827208571,CLRE 259,A00,891868,Patel; Hemal,9998,0,9999,1
1745827209599,CLRE 260,A00,891872,Cuomo; Raphael Eduardo,9999,0,9999,0
1745827210631,CLRE 297,001,891888,Cuomo; Raphael Eduardo,9999,0,9999,0
1745827211659,CSE 191,A00,958773,Minnes Kemp; Mor Mia,9999,0,9999,0
1745827212687,CSS 201S,A01,892054,Mignozzetti; Umberto,30,0,30,0
1745827213714,CSS 202S,A01,892056,Mignozzetti; Umberto,30,0,30,0
1745827214742,DSC 197,001,956898,Eldridge; Justin Matthew,9998,0,9999,1
1745827215771,DSC 297,001,958000,Mazumdar; Arya,9998,0,9999,1
1745827216800,EAP 100,A00,905686,Staff,9776,0,9999,223
1745827217831,ECE 45,A01,892618,Staff,0,13,50,50
1745827218859,ECE 109,A01,892620,Staff,0,43,0,0
1745827219884,ECE 111,A01,892719,Staff,0,9,50,50
1745827220911,ECE 197,001,957920,Mercier; Patrick Philip,9992,0,9999,7
1745827221939,ECON 178,A01,907814,Zhu; Ying,28,0,35,7
1745827222965,EDS 115,A00,895312,Staff,41,0,45,4
1745827223992,EDS 117,A01,895337,Staff,30,0,30,0
1745827225020,EDS 125,A00,895341,Jones; Gabrielle Anastasia,43,0,45,2
1745827226052,EDS 128A,A01,895459,Fargason; Sharon Gayle,44,0,45,1
1745827227083,EDS 128B,A01,895543,Pappas; Elizabeth,44,0,45,1
1745827228113,EDS 139,A00,897203,Pappas; Elizabeth,44,0,45,1
1745827228113,EDS 139,B00,897209,Fargason; Sharon Gayle,44,0,45,1
1745827229140,EDS 201,A00,895545,Staff,43,0,45,2
1745827230171,EDS 203,A01,895581,Halter; Christopher P.,43,0,45,2
1745827231201,EDS 204R,A01,895625,Heinzman; Erica M.,43,0,45,2
1745827231201,EDS 204R,B01,895693,Halter; Christopher P.,18,0,45,27
1745827232229,EDS 206R,A00,895694,Fargason; Sharon Gayle,9,0,30,21
1745827232229,EDS 206R,B00,895695,Choi; Bailey Miyeon,20,0,30,10
1745827233257,EDS 250,A00,895697,Hemans; Patricia Ann Benitez,43,0,45,2
1745827234284,EDS 281,A00,895701,Meyerott; Theresa Ann,15,0,15,0
1745827235310,EDS 284,A00,895736,Meyerott; Theresa Ann,15,0,15,0
1745827236336,EDS 286,A00,897210,Fine; Sarah,15,0,15,0
1745827237362,EDS 289C,A01,895770,Daly; Alan J.,15,0,15,0
1745827238389,EDS 290,A00,897211,Hofstetter; Carolyn,15,0,15,0
1745827239418,LIGM 5A,A00,896162,Fischer-Grunski; Eva K,15,0,20,5
1745827240445,LIGM 5B,A00,896260,Fischer-Grunski; Eva K,17,0,20,3
1745827241475,LIGM 5C,A00,896308,Fischer-Grunski; Eva K,18,0,20,2
1745827242501,LIIT 5AS,A00,896313,Carnelos; Chiara,17,0,20,3
1745827243529,LIIT 5BS,A00,896416,Carnelos; Chiara,20,0,20,0
1745827244555,LIIT 5CS,A00,896564,Carnelos; Chiara,20,0,20,0
1745827245582,LISP 5A,A00,896588,Munoz Sanchez; Alicia,4,0,20,16
1745827246609,LISP 5B,A00,896653,Munoz Sanchez; Alicia,10,0,20,10
1745827247637,LISP 5C,A00,896655,Munoz Sanchez; Alicia,4,0,20,16
1745827248664,MAE 197,001,957918,Kleissl; Jan,9998,0,9999,1
1745827249691,MATH 2,A01,957937,Staff,34,0,35,1
1745827250722,MATH 197,001,957876,Kedlaya; Kiran S.,9993,0,9999,6
1745827251749,MCWP 40,A00,892729,Duru; Nur,13,0,20,7
1745827251749,MCWP 40,B00,893304,Montejo; Carolina,20,0,20,0
1745827252776,MCWP 40R,A00,893757,Redela; Pamela Morgan,0,7,20,20
1745827253806,MCWP 50,A00,893758,Morshed; Michael James,2,0,20,18
1745827253806,MCWP 50,B00,893761,Bartulis; Jason Michael,18,0,20,2
1745827254833,MCWP 50R,A00,893766,Compas; Sean Matthew,0,1,20,20
1745827254833,MCWP 50R,B00,893769,Carter; Jennifer A,0,0,20,20
1745827254833,MCWP 50R,C00,893771,Krone; Jarret,0,3,20,20
1745827254833,MCWP 50R,D00,893772,Miller; Elizabeth Deen,3,0,20,17
1745827254833,MCWP 50R,E00,893775,Carter; Andrea L,0,0,20,20
1745827255865,MMW 11R,A01,892721,Herbst; Matthew,11,0,27,16
1745827255865,MMW 11R,A02,892722,Herbst; Matthew,0,0,0,3
1745827256891,MMW 12R,A01,892724,Herbst; Matthew,0,10,16,16
1745827256891,MMW 12R,A02,892725,Herbst; Matthew,0,9,16,16
1745827257922,MMW 13R,A01,892727,Staff,0,3,16,16
1745827257922,MMW 13R,A02,892728,Staff,0,4,16,16
1745827257922,MMW 13R,A03,958032,Staff,0,3,16,16
1745827257922,MMW 13R,A04,958033,Staff,0,2,16,16
1745827257922,MMW 13R,A05,958034,Staff,0,3,16,16
1745827258949,SIO 295LS,A00,894015,Staff,7,0,25,18
1745827259982,SIO 295S,A00,894020,Staff,7,0,25,18
1745827261010,SIOC 290S,B01,958918,Staff,0,0,0,0
1745827262042,SIOC 291S,B01,958922,Staff,0,0,0,0
1745827263074,SOCI 117,A01,895339,Staff,4,0,5,1
1745827264102,WES 237B,A00,894149,Staff,11,0,20,9
1745827266184,AESE 279B,A00,891859,Staff,13,0,35,22
1745827267211,AIP 197,001,891854,Staff,70,0,70,0
1745827268241,ANTH 289S,A00,891856,Gagneux; Pascal,12,0,12,0
1745827269268,BENG 196,001,957946,Engler; Adam J.,9996,0,9999,3
1745827270296,CAT 124RS,A01,956906,Staff,8,0,25,17
1745827271323,CAT 125RS,A01,922013,Staff,8,0,25,17
1745827272361,CLRE 250,A00,891860,Morris; Sheldon,9995,0,9999,4
1745827274414,CLRE 251R,A00,907817,Mehta; Ravindra L.,9994,0,9999,5
1745827275444,CLRE 252,A00,891864,Cuomo; Raphael Eduardo,9993,0,9999,6
1745827276470,CLRE 253,A00,891867,Vaida; Florin,9994,0,9999,5
1745827276470,CLRE 253,B00,907819,Staff,9999,0,9999,0
1745827277497,CLRE 259,A00,891868,Patel; Hemal,9998,0,9999,1
1745827278521,CLRE 260,A00,891872,Cuomo; Raphael Eduardo,9999,0,9999,0
1745827279545,CLRE 297,001,891888,Cuomo; Raphael Eduardo,9999,0,9999,0
1745827280593,CSE 191,A00,958773,Minnes Kemp; Mor Mia,9999,0,9999,0
1745827281623,CSS 201S,A01,892054,Mignozzetti; Umberto,30,0,30,0
1745827282648,CSS 202S,A01,892056,Mignozzetti; Umberto,30,0,30,0
1745827283676,DSC 197,001,956898,Eldridge; Justin Matthew,9998,0,9999,1
1745827284705,DSC 297,001,958000,Mazumdar; Arya,9998,0,9999,1
1745827285731,EAP 100,A00,905686,Staff,9776,0,9999,223
1745827286759,ECE 45,A01,892618,Staff,0,13,50,50
1745827287790,ECE 109,A01,892620,Staff,0,43,0,0
1745827288818,ECE 111,A01,892719,Staff,0,9,50,50
1745827289842,ECE 197,001,957920,Mercier; Patrick Philip,9992,0,9999,7
1745827290871,ECON 178,A01,907814,Zhu; Ying,28,0,35,7
1745827291895,EDS 115,A00,895312,Staff,41,0,45,4
1745827292923,EDS 117,A01,895337,Staff,30,0,30,0
1745827293955,EDS 125,A00,895341,Jones; Gabrielle Anastasia,43,0,45,2
1745827294982,EDS 128A,A01,895459,Fargason; Sharon Gayle,44,0,45,1
1745827296010,EDS 128B,A01,895543,Pappas; Elizabeth,44,0,45,1
1745827297036,EDS 139,A00,897203,Pappas; Elizabeth,44,0,45,1
1745827297036,EDS 139,B00,897209,Fargason; Sharon Gayle,44,0,45,1
1745827298064,EDS 201,A00,895545,Staff,43,0,45,2
1745827299091,EDS 203,A01,895581,Halter; Christopher P.,43,0,45,2
1745827300120,EDS 204R,A01,895625,Heinzman; Erica M.,43,0,45,2
1745827300120,EDS 204R,B01,895693,Halter; Christopher P.,18,0,45,27
1745827301148,EDS 206R,A00,895694,Fargason; Sharon Gayle,9,0,30,21
1745827301148,EDS 206R,B00,895695,Choi; Bailey Miyeon,20,0,30,10
1745827302176,EDS 250,A00,895697,Hemans; Patricia Ann Benitez,43,0,45,2
1745827303207,EDS 281,A00,895701,Meyerott; Theresa Ann,15,0,15,0
1745827304234,EDS 284,A00,895736,Meyerott; Theresa Ann,15,0,15,0
1745827305262,EDS 286,A00,897210,Fine; Sarah,15,0,15,0
1745827306291,EDS 289C,A01,895770,Daly; Alan J.,15,0,15,0
1745827307343,EDS 290,A00,897211,Hofstetter; Carolyn,15,0,15,0
1745827308378,LIGM 5A,A00,896162,Fischer-Grunski; Eva K,15,0,20,5
1745827309410,LIGM 5B,A00,896260,Fischer-Grunski; Eva K,17,0,20,3
1745827310438,LIGM 5C,A00,896308,Fischer-Grunski; Eva K,18,0,20,2
1745827311469,LIIT 5AS,A00,896313,Carnelos; Chiara,17,0,20,3
1745827312494,LIIT 5BS,A00,896416,Carnelos; Chiara,20,0,20,0
1745827313524,LIIT 5CS,A00,896564,Carnelos; Chiara,20,0,20,0
1745827314551,LISP 5A,A00,896588,Munoz Sanchez; Alicia,4,0,20,16
1745827315581,LISP 5B,A00,896653,Munoz Sanchez; Alicia,10,0,20,10
1745827316607,LISP 5C,A00,896655,Munoz Sanchez; Alicia,4,0,20,16
1745827317633,MAE 197,001,957918,Kleissl; Jan,9998,0,9999,1
1745827318661,MATH 2,A01,957937,Staff,34,0,35,1
1745827319690,MATH 197,001,957876,Kedlaya; Kiran S.,9993,0,9999,6
1745827320720,MCWP 40,A00,892729,Duru; Nur,13,0,20,7
1745827320720,MCWP 40,B00,893304,Montejo; Carolina,20,0,20,0
1745827321751,MCWP 40R,A00,893757,Redela; Pamela Morgan,0,7,20,20
1745827322782,MCWP 50,A00,893758,Morshed; Michael James,2,0,20,18
1745827322782,MCWP 50,B00,893761,Bartulis; Jason Michael,18,0,20,2
1745827323816,MCWP 50R,A00,893766,Compas; Sean Matthew,0,1,20,20
1745827323816,MCWP 50R,B00,893769,Carter; Jennifer A,0,0,20,20
1745827323816,MCWP 50R,C00,893771,Krone; Jarret,0,3,20,20
1745827323816,MCWP 50R,D00,893772,Miller; Elizabeth Deen,3,0,20,17
1745827323816,MCWP 50R,E00,893775,Carter; Andrea L,0,0,20,20
1745827324849,MMW 11R,A01,892721,Herbst; Matthew,11,0,27,16
1745827324849,MMW 11R,A02,892722,Herbst; Matthew,0,0,0,3
1745827325878,MMW 12R,A01,892724,Herbst; Matthew,0,10,16,16
1745827325878,MMW 12R,A02,892725,Herbst; Matthew,0,9,16,16
1745827326904,MMW 13R,A01,892727,Staff,0,3,16,16
1745827326904,MMW 13R,A02,892728,Staff,0,4,16,16
1745827326904,MMW 13R,A03,958032,Staff,0,3,16,16
1745827326904,MMW 13R,A04,958033,Staff,0,2,16,16
1745827326904,MMW 13R,A05,958034,Staff,0,3,16,16
1745827327932,SIO 295LS,A00,894015,Staff,7,0,25,18
1745827328962,SIO 295S,A00,894020,Staff,7,0,25,18
1745827329999,SIOC 290S,B01,958918,Staff,0,0,0,0
1745827331027,SIOC 291S,B01,958922,Staff,0,0,0,0
1745827332056,SOCI 117,A01,895339,Staff,4,0,5,1
1745827333083,WES 237B,A00,894149,Staff,11,0,20,9
1745827335168,AESE 279B,A00,891859,Staff,13,0,35,22
1745827336195,AIP 197,001,891854,Staff,70,0,70,0
1745827337225,ANTH 289S,A00,891856,Gagneux; Pascal,12,0,12,0
1745827338254,BENG 196,001,957946,Engler; Adam J.,9996,0,9999,3
1745827339282,CAT 124RS,A01,956906,Staff,8,0,25,17
1745827340313,CAT 125RS,A01,922013,Staff,8,0,25,17
1745827341342,CLRE 250,A00,891860,Morris; Sheldon,9995,0,9999,4
1745827343411,CLRE 251R,A00,907817,Mehta; Ravindra L.,9994,0,9999,5
1745827344438,CLRE 252,A00,891864,Cuomo; Raphael Eduardo,9993,0,9999,6
1745827345465,CLRE 253,A00,891867,Vaida; Florin,9994,0,9999,5
1745827345465,CLRE 253,B00,907819,Staff,9999,0,9999,0
1745827346493,CLRE 259,A00,891868,Patel; Hemal,9998,0,9999,1
1745827347524,CLRE 260,A00,891872,Cuomo; Raphael Eduardo,9999,0,9999,0
1745827348554,CLRE 297,001,891888,Cuomo; Raphael Eduardo,9999,0,9999,0
1745827349582,CSE 191,A00,958773,Minnes Kemp; Mor Mia,9999,0,9999,0
1745827350611,CSS 201S,A01,892054,Mignozzetti; Umberto,30,0,30,0
1745827351635,CSS 202S,A01,892056,Mignozzetti; Umberto,30,0,30,0
1745827352663,DSC 197,001,956898,Eldridge; Justin Matthew,9998,0,9999,1
1745827353692,DSC 297,001,958000,Mazumdar; Arya,9998,0,9999,1
1745827354721,EAP 100,A00,905686,Staff,9776,0,9999,223
1745827355752,ECE 45,A01,892618,Staff,0,13,50,50
1745827356777,ECE 109,A01,892620,Staff,0,43,0,0
1745827357805,ECE 111,A01,892719,Staff,0,9,50,50
1745827358832,ECE 197,001,957920,Mercier; Patrick Philip,9992,0,9999,7
1745827359862,ECON 178,A01,907814,Zhu; Ying,28,0,35,7
1745827360889,EDS 115,A00,895312,Staff,41,0,45,4
1745827361919,EDS 117,A01,895337,Staff,30,0,30,0
1745827362952,EDS 125,A00,895341,Jones; Gabrielle Anastasia,43,0,45,2
1745827363977,EDS 128A,A01,895459,Fargason; Sharon Gayle,44,0,45,1
1745827365005,EDS 128B,A01,895543,Pappas; Elizabeth,44,0,45,1
1745827366032,EDS 139,A00,897203,Pappas; Elizabeth,44,0,45,1
1745827366032,EDS 139,B00,897209,Fargason; Sharon Gayle,44,0,45,1
1745827367058,EDS 201,A00,895545,Staff,43,0,45,2
1745827368087,EDS 203,A01,895581,Halter; Christopher P.,43,0,45,2
1745827369115,EDS 204R,A01,895625,Heinzman; Erica M.,43,0,45,2
1745827369115,EDS 204R,B01,895693,Halter; Christopher P.,18,0,45,27
1745827370145,EDS 206R,A00,895694,Fargason; Sharon Gayle,9,0,30,21
1745827370145,EDS 206R,B00,895695,Choi; Bailey Miyeon,20,0,30,10
1745827371172,EDS 250,A00,895697,Hemans; Patricia Ann Benitez,43,0,45,2
1745827372198,EDS 281,A00,895701,Meyerott; Theresa Ann,15,0,15,0
1745827373227,EDS 284,A00,895736,Meyerott; Theresa Ann,15,0,15,0
1745827374254,EDS 286,A00,897210,Fine; Sarah,15,0,15,0
1745827375280,EDS 289C,A01,895770,Daly; Alan J.,15,0,15,0
1745827376311,EDS 290,A00,897211,Hofstetter; Carolyn,15,0,15,0
1745827377342,LIGM 5A,A00,896162,Fischer-Grunski; Eva K,15,0,20,5
1745827378370,LIGM 5B,A00,896260,Fischer-Grunski; Eva K,17,0,20,3
1745827379397,LIGM 5C,A00,896308,Fischer-Grunski; Eva K,18,0,20,2
1745827380427,LIIT 5AS,A00,896313,Carnelos; Chiara,17,0,20,3
1745827381456,LIIT 5BS,A00,896416,Carnelos; Chiara,20,0,20,0
1745827382486,LIIT 5CS,A00,896564,Carnelos; Chiara,20,0,20,0
1745827383514,LISP 5A,A00,896588,Munoz Sanchez; Alicia,4,0,20,16
1745827384540,LISP 5B,A00,896653,Munoz Sanchez; Alicia,10,0,20,10
1745827385568,LISP 5C,A00,896655,Munoz Sanchez; Alicia,4,0,20,16
1745827386597,MAE 197,001,957918,Kleissl; Jan,9998,0,9999,1
1745827387626,MATH 2,A01,957937,Staff,34,0,35,1
1745827388654,MATH 197,001,957876,Kedlaya; Kiran S.,9993,0,9999,6
1745827389686,MCWP 40,A00,892729,Duru; Nur,13,0,20,7
1745827389686,MCWP 40,B00,893304,Montejo; Carolina,20,0,20,0
1745827390712,MCWP 40R,A00,893757,Redela; Pamela Morgan,0,7,20,20
1745827391741,MCWP 50,A00,893758,Morshed; Michael James,2,0,20,18
1745827391741,MCWP 50,B00,893761,Bartulis; Jason Michael,18,0,20,2
1745827392776,MCWP 50R,A00,893766,Compas; Sean Matthew,0,1,20,20
1745827392776,MCWP 50R,B00,893769,Carter; Jennifer A,0,0,20,20
1745827392776,MCWP 50R,C00,893771,Krone; Jarret,0,3,20,20
1745827392776,MCWP 50R,D00,893772,Miller; Elizabeth Deen,3,0,20,17
1745827392776,MCWP 50R,E00,893775,Carter; Andrea L,0,0,20,20
1745827393804,MMW 11R,A01,892721,Herbst; Matthew,11,0,27,16
1745827393804,MMW 11R,A02,892722,Herbst; Matthew,0,0,0,3
1745827394830,MMW 12R,A01,892724,Herbst; Matthew,0,10,16,16
1745827394830,MMW 12R,A02,892725,Herbst; Matthew,0,9,16,16
1745827395857,MMW 13R,A01,892727,Staff,0,3,16,16
1745827395857,MMW 13R,A02,892728,Staff,0,4,16,16
1745827395857,MMW 13R,A03,958032,Staff,0,3,16,16
1745827395857,MMW 13R,A04,958033,Staff,0,2,16,16
1745827395857,MMW 13R,A05,958034,Staff,0,3,16,16
1745827396884,SIO 295LS,A00,894015,Staff,7,0,25,18
1745827397911,SIO 295S,A00,894020,Staff,7,0,25,18
1745827398939,SIOC 290S,B01,958918,Staff,0,0,0,0
1745827399965,SIOC 291S,B01,958922,Staff,0,0,0,0
1745827400992,SOCI 117,A01,895339,Staff,4,0,5,1
1745827402018,WES 237B,A00,894149,Staff,11,0,20,9
1745827404102,AESE 279B,A00,891859,Staff,13,0,35,22
1745827405127,AIP 197,001,891854,Staff,70,0,70,0
1745827406154,ANTH 289S,A00,891856,Gagneux; Pascal,12,0,12,0
1745827407182,BENG 196,001,957946,Engler; Adam J.,9996,0,9999,3
1745827408210,CAT 124RS,A01,956906,Staff,8,0,25,17
1745827409238,CAT 125RS,A01,922013,Staff,8,0,25,17
1745827410265,CLRE 250,A00,891860,Morris; Sheldon,9995,0,9999,4
1745827412318,CLRE 251R,A00,907817,Mehta; Ravindra L.,9994,0,9999,5
1745827413346,CLRE 252,A00,891864,Cuomo; Raphael Eduardo,9993,0,9999,6
1745827414377,CLRE 253,A00,891867,Vaida; Florin,9994,0,9999,5
1745827414377,CLRE 253,B00,907819,Staff,9999,0,9999,0
1745827415405,CLRE 259,A00,891868,Patel; Hemal,9998,0,9999,1
1745827416431,CLRE 260,A00,891872,Cuomo; Raphael Eduardo,9999,0,9999,0
1745827417457,CLRE 297,001,891888,Cuomo; Raphael Eduardo,9999,0,9999,0
1745827418486,CSE 191,A00,958773,Minnes Kemp; Mor Mia,9999,0,9999,0
1745827419514,CSS 201S,A01,892054,Mignozzetti; Umberto,30,0,30,0
1745827420542,CSS 202S,A01,892056,Mignozzetti; Umberto,30,0,30,0
1745827421571,DSC 197,001,956898,Eldridge; Justin Matthew,9998,0,9999,1
1745827422600,DSC 297,001,958000,Mazumdar; Arya,9998,0,9999,1
1745827423627,EAP 100,A00,905686,Staff,9776,0,9999,223
1745827424653,ECE 45,A01,892618,Staff,0,13,50,50
1745827425683,ECE 109,A01,892620,Staff,0,43,0,0
1745827426708,ECE 111,A01,892719,Staff,0,9,50,50
1745827427735,ECE 197,001,957920,Mercier; Patrick Philip,9992,0,9999,7
1745827428764,ECON 178,A01,907814,Zhu; Ying,28,0,35,7
1745827429792,EDS 115,A00,895312,Staff,41,0,45,4
1745827430819,EDS 117,A01,895337,Staff,30,0,30,0
1745827431848,EDS 125,A00,895341,Jones; Gabrielle Anastasia,43,0,45,2
1745827432875,EDS 128A,A01,895459,Fargason; Sharon Gayle,44,0,45,1
1745827433906,EDS 128B,A01,895543,Pappas; Elizabeth,44,0,45,1
1745827434933,EDS 139,A00,897203,Pappas; Elizabeth,44,0,45,1
1745827434933,EDS 139,B00,897209,Fargason; Sharon Gayle,44,0,45,1
1745827435961,EDS 201,A00,895545,Staff,43,0,45,2
1745827436992,EDS 203,A01,895581,Halter; Christopher P.,43,0,45,2
1745827438021,EDS 204R,A01,895625,Heinzman; Erica M.,43,0,45,2
1745827438021,EDS 204R,B01,895693,Halter; Christopher P.,18,0,45,27
1745827439053,EDS 206R,A00,895694,Fargason; Sharon Gayle,9,0,30,21
1745827439053,EDS 206R,B00,895695,Choi; Bailey Miyeon,20,0,30,10
1745827440083,EDS 250,A00,895697,Hemans; Patricia Ann Benitez,43,0,45,2
1745827441112,EDS 281,A00,895701,Meyerott; Theresa Ann,15,0,15,0
1745827442142,EDS 284,A00,895736,Meyerott; Theresa Ann,15,0,15,0
1745827443170,EDS 286,A00,897210,Fine; Sarah,15,0,15,0
1745827444198,EDS 289C,A01,895770,Daly; Alan J.,15,0,15,0
1745827445226,EDS 290,A00,897211,Hofstetter; Carolyn,15,0,15,0
1745827446260,LIGM 5A,A00,896162,Fischer-Grunski; Eva K,15,0,20,5
1745827447287,LIGM 5B,A00,896260,Fischer-Grunski; Eva K,17,0,20,3
1745827448313,LIGM 5C,A00,896308,Fischer-Grunski; Eva K,18,0,20,2
1745827449339,LIIT 5AS,A00,896313,Carnelos; Chiara,17,0,20,3
1745827450365,LIIT 5BS,A00,896416,Carnelos; Chiara,20,0,20,0
1745827451392,LIIT 5CS,A00,896564,Carnelos; Chiara,20,0,20,0
1745827452419,LISP 5A,A00,896588,Munoz Sanchez; Alicia,4,0,20,16
1745827453448,LISP 5B,A00,896653,Munoz Sanchez; Alicia,10,0,20,10
1745827454478,LISP 5C,A00,896655,Munoz Sanchez; Alicia,4,0,20,16
1745827455507,MAE 197,001,957918,Kleissl; Jan,9998,0,9999,1
1745827456534,MATH 2,A01,957937,Staff,34,0,35,1
1745827457561,MATH 197,001,957876,Kedlaya; Kiran S.,9993,0,9999,6
1745827458589,MCWP 40,A00,892729,Duru; Nur,13,0,20,7
1745827458589,MCWP 40,B00,893304,Montejo; Carolina,20,0,20,0
1745827459620,MCWP 40R,A00,893757,Redela; Pamela Morgan,0,7,20,20
1745827460646,MCWP 50,A00,893758,Morshed; Michael James,2,0,20,18
1745827460646,MCWP 50,B00,893761,Bartulis; Jason Michael,18,0,20,2
1745827461675,MCWP 50R,A00,893766,Compas; Sean Matthew,0,1,20,20
1745827461675,MCWP 50R,B00,893769,Carter; Jennifer A,0,0,20,20
1745827461675,MCWP 50R,C00,893771,Krone; Jarret,0,3,20,20
1745827461675,MCWP 50R,D00,893772,Miller; Elizabeth Deen,3,0,20,17
1745827461675,MCWP 50R,E00,893775,Carter; Andrea L,0,0,20,20
1745827462703,MMW 11R,A01,892721,Herbst; Matthew,11,0,27,16
1745827462703,MMW 11R,A02,892722,Herbst; Matthew,0,0,0,3
1745827463735,MMW 12R,A01,892724,Herbst; Matthew,0,10,16,16
1745827463735,MMW 12R,A02,892725,Herbst; Matthew,0,9,16,16
1745827464764,MMW 13R,A01,892727,Staff,0,3,16,16
1745827464764,MMW 13R,A02,892728,Staff,0,4,16,16
1745827464764,MMW 13R,A03,958032,Staff,0,3,16,16
1745827464764,MMW 13R,A04,958033,Staff,0,2,16,16
1745827464764,MMW 13R,A05,958034,Staff,0,3,16,16
1745827465791,SIO 295LS,A00,894015,Staff,7,0,25,18
1745827466820,SIO 295S,A00,894020,Staff,7,0,25,18
1745827467849,SIOC 290S,B01,958918,Staff,0,0,0,0
1745827468879,SIOC 291S,B01,958922,Staff,0,0,0,0
1745827469925,SOCI 117,A01,895339,Staff,4,0,5,1
1745827470949,WES 237B,A00,894149,Staff,11,0,20,9
1745827473046,AESE 279B,A00,891859,Staff,13,0,35,22
1745827474071,AIP 197,001,891854,Staff,70,0,70,0
1745827475097,ANTH 289S,A00,891856,Gagneux; Pascal,12,0,12,0
1745827476123,BENG 196,001,957946,Engler; Adam J.,9996,0,9999,3
1745827477149,CAT 124RS,A01,956906,Staff,8,0,25,17
1745827478175,CAT 125RS,A01,922013,Staff,8,0,25,17
1745827479203,CLRE 250,A00,891860,Morris; Sheldon,9995,0,9999,4
1745827481263,CLRE 251R,A00,907817,Mehta; Ravindra L.,9994,0,9999,5
1745827482292,CLRE 252,A00,891864,Cuomo; Raphael Eduardo,9993,0,9999,6
1745827483319,CLRE 253,A00,891867,Vaida; Florin,9994,0,9999,5
1745827483319,CLRE 253,B00,907819,Staff,9999,0,9999,0
1745827484349,CLRE 259,A00,891868,Patel; Hemal,9998,0,9999,1
1745827485374,CLRE 260,A00,891872,Cuomo; Raphael Eduardo,9999,0,9999,0
1745827486406,CLRE 297,001,891888,Cuomo; Raphael Eduardo,9999,0,9999,0
1745827487432,CSE 191,A00,958773,Minnes Kemp; Mor Mia,9999,0,9999,0
1745827488459,CSS 201S,A01,892054,Mignozzetti; Umberto,30,0,30,0
1745827489489,CSS 202S,A01,892056,Mignozzetti; Umberto,30,0,30,0
1745827490516,DSC 197,001,956898,Eldridge; Justin Matthew,9998,0,9999,1
1745827491541,DSC 297,001,958000,Mazumdar; Arya,9998,0,9999,1
1745827492568,EAP 100,A00,905686,Staff,9776,0,9999,223
1745827493596,ECE 45,A01,892618,Staff,0,13,50,50
1745827494627,ECE 109,A01,892620,Staff,0,43,0,0
1745827495652,ECE 111,A01,892719,Staff,0,9,50,50
1745827496681,ECE 197,001,957920,Mercier; Patrick Philip,9992,0,9999,7
1745827497708,ECON 178,A01,907814,Zhu; Ying,28,0,35,7
1745827498735,EDS 115,A00,895312,Staff,41,0,45,4
1745827499760,EDS 117,A01,895337,Staff,30,0,30,0
1745827500787,EDS 125,A00,895341,Jones; Gabrielle Anastasia,43,0,45,2
1745827501818,EDS 128A,A01,895459,Fargason; Sharon Gayle,44,0,45,1
1745827502848,EDS 128B,A01,895543,Pappas; Elizabeth,44,0,45,1
1745827503874,EDS 139,A00,897203,Pappas; Elizabeth,44,0,45,1
1745827503874,EDS 139,B00,897209,Fargason; Sharon Gayle,44,0,45,1
1745827504907,EDS 201,A00,895545,Staff,43,0,45,2
1745827505980,EDS 203,A01,895581,Halter; Christopher P.,43,0,45,2
1745827507010,EDS 204R,A01,895625,Heinzman; Erica M.,43,0,45,2
1745827507010,EDS 204R,B01,895693,Halter; Christopher P.,18,0,45,27
1745827508036,EDS 206R,A00,895694,Fargason; Sharon Gayle,9,0,30,21
1745827508036,EDS 206R,B00,895695,Choi; Bailey Miyeon,20,0,30,10
1745827509067,EDS 250,A00,895697,Hemans; Patricia Ann Benitez,43,0,45,2
1745827510095,EDS 281,A00,895701,Meyerott; Theresa Ann,15,0,15,0
1745827511124,EDS 284,A00,895736,Meyerott; Theresa Ann,15,0,15,0
1745827512151,EDS 286,A00,897210,Fine; Sarah,15,0,15,0
1745827513175,EDS 289C,A01,895770,Daly; Alan J.,15,0,15,0
1745827514200,EDS 290,A00,897211,Hofstetter; Carolyn,15,0,15,0
1745827515227,LIGM 5A,A00,896162,Fischer-Grunski; Eva K,15,0,20,5
1745827516254,LIGM 5B,A00,896260,Fischer-Grunski; Eva K,17,0,20,3
1745827517290,LIGM 5C,A00,896308,Fischer-Grunski; Eva K,18,0,20,2
1745827518321,LIIT 5AS,A00,896313,Carnelos; Chiara,17,0,20,3
1745827519352,LIIT 5BS,A00,896416,Carnelos; Chiara,20,0,20,0
1745827520382,LIIT 5CS,A00,896564,Carnelos; Chiara,20,0,20,0
1745827521407,LISP 5A,A00,896588,Munoz Sanchez; Alicia,4,0,20,16
1745827522437,LISP 5B,A00,896653,Munoz Sanchez; Alicia,10,0,20,10
1745827523467,LISP 5C,A00,896655,Munoz Sanchez; Alicia,4,0,20,16
1745827524498,MAE 197,001,957918,Kleissl; Jan,9998,0,9999,1
1745827525526,MATH 2,A01,957937,Staff,34,0,35,1
1745827526551,MATH 197,001,957876,Kedlaya; Kiran S.,9993,0,9999,6
1745827527580,MCWP 40,A00,892729,Duru; Nur,13,0,20,7
1745827527580,MCWP 40,B00,893304,Montejo; Carolina,20,0,20,0
1745827528604,MCWP 40R,A00,893757,Redela; Pamela Morgan,0,7,20,20
1745827529629,MCWP 50,A00,893758,Morshed; Michael James,2,0,20,18
1745827529629,MCWP 50,B00,893761,Bartulis; Jason Michael,18,0,20,2
1745827530661,MCWP 50R,A00,893766,Compas; Sean Matthew,0,1,20,20
1745827530661,MCWP 50R,B00,893769,Carter; Jennifer A,0,0,20,20
1745827530661,MCWP 50R,C00,893771,Krone; Jarret,0,3,20,20
1745827530661,MCWP 50R,D00,893772,Miller; Elizabeth Deen,3,0,20,17
1745827530661,MCWP 50R,E00,893775,Carter; Andrea L,0,0,20,20
1745827531685,MMW 11R,A01,892721,Herbst; Matthew,11,0,27,16
1745827531685,MMW 11R,A02,892722,Herbst; Matthew,0,0,0,3
1745827532711,MMW 12R,A01,892724,Herbst; Matthew,0,10,16,16
1745827532711,MMW 12R,A02,892725,Herbst; Matthew,0,9,16,16
1745827533740,MMW 13R,A01,892727,Staff,0,3,16,16
1745827533740,MMW 13R,A02,892728,Staff,0,4,16,16
1745827533740,MMW 13R,A03,958032,Staff,0,3,16,16
1745827533740,MMW 13R,A04,958033,Staff,0,2,16,16
1745827533740,MMW 13R,A05,958034,Staff,0,3,16,16
1745827534767,SIO 295LS,A00,894015,Staff,7,0,25,18
1745827535793,SIO 295S,A00,894020,Staff,7,0,25,18
1745827536817,SIOC 290S,B01,958918,Staff,0,0,0,0
1745827537846,SIOC 291S,B01,958922,Staff,0,0,0,0
1745827538873,SOCI 117,A01,895339,Staff,4,0,5,1
1745827539899,WES 237B,A00,894149,Staff,11,0,20,9
1745827541968,AESE 279B,A00,891859,Staff,13,0,35,22
1745827543002,AIP 197,001,891854,Staff,70,0,70,0
1745827544033,ANTH 289S,A00,891856,Gagneux; Pascal,12,0,12,0
1745827545060,BENG 196,001,957946,Engler; Adam J.,9996,0,9999,3
1745827546086,CAT 124RS,A01,956906,Staff,8,0,25,17
1745827547119,CAT 125RS,A01,922013,Staff,8,0,25,17
1745827548144,CLRE 250,A00,891860,Morris; Sheldon,9995,0,9999,4
1745827550199,CLRE 251R,A00,907817,Mehta; Ravindra L.,9994,0,9999,5
1745827551228,CLRE 252,A00,891864,Cuomo; Raphael Eduardo,9993,0,9999,6
1745827552255,CLRE 253,A00,891867,Vaida; Florin,9994,0,9999,5
1745827552255,CLRE 253,B00,907819,Staff,9999,0,9999,0
1745827553285,CLRE 259,A00,891868,Patel; Hemal,9998,0,9999,1
1745827554313,CLRE 260,A00,891872,Cuomo; Raphael Eduardo,9999,0,9999,0
1745827555344,CLRE 297,001,891888,Cuomo; Raphael Eduardo,9999,0,9999,0
1745827556371,CSE 191,A00,958773,Minnes Kemp; Mor Mia,9999,0,9999,0
1745827557400,CSS 201S,A01,892054,Mignozzetti; Umberto,30,0,30,0
1745827558427,CSS 202S,A01,892056,Mignozzetti; Umberto,30,0,30,0
1745827559453,DSC 197,001,956898,Eldridge; Justin Matthew,9998,0,9999,1
1745827560485,DSC 297,001,958000,Mazumdar; Arya,9998,0,9999,1
1745827561510,EAP 100,A00,905686,Staff,9776,0,9999,223
1745827562542,ECE 45,A01,892618,Staff,0,13,50,50
1745827563568,ECE 109,A01,892620,Staff,0,43,0,0
1745827564595,ECE 111,A01,892719,Staff,0,9,50,50
1745827565622,ECE 197,001,957920,Mercier; Patrick Philip,9992,0,9999,7
1745827566653,ECON 178,A01,907814,Zhu; Ying,28,0,35,7
1745827567678,EDS 115,A00,895312,Staff,41,0,45,4
1745827568708,EDS 117,A01,895337,Staff,30,0,30,0
1745827569735,EDS 125,A00,895341,Jones; Gabrielle Anastasia,43,0,45,2
1745827570760,EDS 128A,A01,895459,Fargason; Sharon Gayle,44,0,45,1
1745827571791,EDS 128B,A01,895543,Pappas; Elizabeth,44,0,45,1
1745827572821,EDS 139,A00,897203,Pappas; Elizabeth,44,0,45,1
1745827572821,EDS 139,B00,897209,Fargason; Sharon Gayle,44,0,45,1
1745827573846,EDS 201,A00,895545,Staff,43,0,45,2
1745827574874,EDS 203,A01,895581,Halter; Christopher P.,43,0,45,2
1745827575913,EDS 204R,A01,895625,Heinzman; Erica M.,43,0,45,2
1745827575913,EDS 204R,B01,895693,Halter; Christopher P.,18,0,45,27
1745827576948,EDS 206R,A00,895694,Fargason; Sharon Gayle,9,0,30,21
1745827576948,EDS 206R,B00,895695,Choi; Bailey Miyeon,20,0,30,10
1745827577974,EDS 250,A00,895697,Hemans; Patricia Ann Benitez,43,0,45,2
1745827578999,EDS 281,A00,895701,Meyerott; Theresa Ann,15,0,15,0
1745827580040,EDS 284,A00,895736,Meyerott; Theresa Ann,15,0,15,0
1745827581066,EDS 286,A00,897210,Fine; Sarah,15,0,15,0
1745827582093,EDS 289C,A01,895770,Daly; Alan J.,15,0,15,0
1745827583126,EDS 290,A00,897211,Hofstetter; Carolyn,15,0,15,0
1745827584154,LIGM 5A,A00,896162,Fischer-Grunski; Eva K,15,0,20,5
1745827585185,LIGM 5B,A00,896260,Fischer-Grunski; Eva K,17,0,20,3
1745827586217,LIGM 5C,A00,896308,Fischer-Grunski; Eva K,18,0,20,2
1745827587245,LIIT 5AS,A00,896313,Carnelos; Chiara,17,0,20,3
1745827588275,LIIT 5BS,A00,896416,Carnelos; Chiara,20,0,20,0
1745827589300,LIIT 5CS,A00,896564,Carnelos; Chiara,20,0,20,0
1745827590331,LISP 5A,A00,896588,Munoz Sanchez; Alicia,4,0,20,16
1745827591361,LISP 5B,A00,896653,Munoz Sanchez; Alicia,10,0,20,10
1745827592396,LISP 5C,A00,896655,Munoz Sanchez; Alicia,4,0,20,16
1745827593425,MAE 197,001,957918,Kleissl; Jan,9998,0,9999,1
1745827594451,MATH 2,A01,957937,Staff,34,0,35,1
1745827595478,MATH 197,001,957876,Kedlaya; Kiran S.,9993,0,9999,6
1745827596521,MCWP 40,A00,892729,Duru; Nur,13,0,20,7
1745827596521,MCWP 40,B00,893304,Montejo; Carolina,20,0,20,0
1745827597548,MCWP 40R,A00,893757,Redela; Pamela Morgan,0,7,20,20
1745827598576,MCWP 50,A00,893758,Morshed; Michael James,2,0,20,18
1745827598576,MCWP 50,B00,893761,Bartulis; Jason Michael,18,0,20,2
1745827599601,MCWP 50R,A00,893766,Compas; Sean Matthew,0,1,20,20
1745827599601,MCWP 50R,B00,893769,Carter; Jennifer A,0,0,20,20
1745827599601,MCWP 50R,C00,893771,Krone; Jarret,0,3,20,20
1745827599601,MCWP 50R,D00,893772,Miller; Elizabeth Deen,3,0,20,17
1745827599601,MCWP 50R,E00,893775,Carter; Andrea L,0,0,20,20
1745827600627,MMW 11R,A01,892721,Herbst; Matthew,11,0,27,16
1745827600627,MMW 11R,A02,892722,Herbst; Matthew,0,0,0,3
1745827601656,MMW 12R,A01,892724,Herbst; Matthew,0,10,16,16
1745827601656,MMW 12R,A02,892725,Herbst; Matthew,0,9,16,16
1745827602682,MMW 13R,A01,892727,Staff,0,3,16,16
1745827602682,MMW 13R,A02,892728,Staff,0,4,16,16
1745827602682,MMW 13R,A03,958032,Staff,0,3,16,16
1745827602682,MMW 13R,A04,958033,Staff,0,2,16,16
1745827602682,MMW 13R,A05,958034,Staff,0,3,16,16
1745827603710,SIO 295LS,A00,894015,Staff,7,0,25,18
1745827604735,SIO 295S,A00,894020,Staff,7,0,25,18
1745827605761,SIOC 290S,B01,958918,Staff,0,0,0,0
1745827606790,SIOC 291S,B01,958922,Staff,0,0,0,0
1745827607817,SOCI 117,A01,895339,Staff,4,0,5,1
1745827608843,WES 237B,A00,894149,Staff,11,0,20,9
1745827610959,AESE 279B,A00,891859,Staff,13,0,35,22
1745827611988,AIP 197,001,891854,Staff,70,0,70,0
1745827613017,ANTH 289S,A00,891856,Gagneux; Pascal,12,0,12,0
1745827614051,BENG 196,001,957946,Engler; Adam J.,9996,0,9999,3
1745827615084,CAT 124RS,A01,956906,Staff,8,0,25,17
1745827616121,CAT 125RS,A01,922013,Staff,8,0,25,17
1745827617146,CLRE 250,A00,891860,Morris; Sheldon,9995,0,9999,4
1745827619211,CLRE 251R,A00,907817,Mehta; Ravindra L.,9994,0,9999,5
1745827620242,CLRE 252,A00,891864,Cuomo; Raphael Eduardo,9993,0,9999,6
1745827621267,CLRE 253,A00,891867,Vaida; Florin,9994,0,9999,5
1745827621267,CLRE 253,B00,907819,Staff,9999,0,9999,0
1745827622297,CLRE 259,A00,891868,Patel; Hemal,9998,0,9999,1
1745827623323,CLRE 260,A00,891872,Cuomo; Raphael Eduardo,9999,0,9999,0
1745827624354,CLRE 297,001,891888,Cuomo; Raphael Eduardo,9999,0,9999,0
1745827625381,CSE 191,A00,958773,Minnes Kemp; Mor Mia,9999,0,9999,0
1745827626420,CSS 201S,A01,892054,Mignozzetti; Umberto,30,0,30,0
1745827627451,CSS 202S,A01,892056,Mignozzetti; Umberto,30,0,30,0
1745827628478,DSC 197,001,956898,Eldridge; Justin Matthew,9998,0,9999,1
1745827629513,DSC 297,001,958000,Mazumdar; Arya,9998,0,9999,1
1745827630542,EAP 100,A00,905686,Staff,9776,0,9999,223
1745827631568,ECE 45,A01,892618,Staff,0,13,50,50
1745827632593,ECE 109,A01,892620,Staff,0,43,0,0
1745827633619,ECE 111,A01,892719,Staff,0,9,50,50
1745827634649,ECE 197,001,957920,Mercier; Patrick Philip,9992,0,9999,7
1745827635677,ECON 178,A01,907814,Zhu; Ying,28,0,35,7
1745827636709,EDS 115,A00,895312,Staff,41,0,45,4
1745827637736,EDS 117,A01,895337,Staff,30,0,30,0
1745827638773,EDS 125,A00,895341,Jones; Gabrielle Anastasia,43,0,45,2
1745827639806,EDS 128A,A01,895459,Fargason; Sharon Gayle,44,0,45,1
1745827640852,EDS 128B,A01,895543,Pappas; Elizabeth,44,0,45,1
1745827641877,EDS 139,A00,897203,Pappas; Elizabeth,44,0,45,1
1745827641877,EDS 139,B00,897209,Fargason; Sharon Gayle,44,0,45,1
1745827642902,EDS 201,A00,895545,Staff,43,0,45,2
1745827643929,EDS 203,A01,895581,Halter; Christopher P.,43,0,45,2
1745827644960,EDS 204R,A01,895625,Heinzman; Erica M.,43,0,45,2
1745827644960,EDS 204R,B01,895693,Halter; Christopher P.,18,0,45,27
1745827645993,EDS 206R,A00,895694,Fargason; Sharon Gayle,9,0,30,21
1745827645993,EDS 206R,B00,895695,Choi; Bailey Miyeon,20,0,30,10
1745827647019,EDS 250,A00,895697,Hemans; Patricia Ann Benitez,43,0,45,2
1745827648045,EDS 281,A00,895701,Meyerott; Theresa Ann,15,0,15,0
1745827649071,EDS 284,A00,895736,Meyerott; Theresa Ann,15,0,15,0
1745827650101,EDS 286,A00,897210,Fine; Sarah,15,0,15,0
1745827651134,EDS 289C,A01,895770,Daly; Alan J.,15,0,15,0
1745827652160,EDS 290,A00,897211,Hofstetter; Carolyn,15,0,15,0
1745827653194,LIGM 5A,A00,896162,Fischer-Grunski; Eva K,15,0,20,5
1745827654219,LIGM 5B,A00,896260,Fischer-Grunski; Eva K,17,0,20,3
1745827655252,LIGM 5C,A00,896308,Fischer-Grunski; Eva K,18,0,20,2
1745827656285,LIIT 5AS,A00,896313,Carnelos; Chiara,17,0,20,3
1745827657311,LIIT 5BS,A00,896416,Carnelos; Chiara,20,0,20,0
1745827658341,LIIT 5CS,A00,896564,Carnelos; Chiara,20,0,20,0
1745827659372,LISP 5A,A00,896588,Munoz Sanchez; Alicia,4,0,20,16
1745827660402,LISP 5B,A00,896653,Munoz Sanchez; Alicia,10,0,20,10
1745827661437,LISP 5C,A00,896655,Munoz Sanchez; Alicia,4,0,20,16
1745827662463,MAE 197,001,957918,Kleissl; Jan,9998,0,9999,1
1745827663490,MATH 2,A01,957937,Staff,34,0,35,1
1745827664517,MATH 197,001,957876,Kedlaya; Kiran S.,9993,0,9999,6
1745827665546,MCWP 40,A00,892729,Duru; Nur,13,0,20,7
1745827665546,MCWP 40,B00,893304,Montejo; Carolina,20,0,20,0
1745827666572,MCWP 40R,A00,893757,Redela; Pamela Morgan,0,7,20,20
1745827667605,MCWP 50,A00,893758,Morshed; Michael James,2,0,20,18
1745827667605,MCWP 50,B00,893761,Bartulis; Jason Michael,18,0,20,2
1745827668641,MCWP 50R,A00,893766,Compas; Sean Matthew,0,1,20,20
1745827668641,MCWP 50R,B00,893769,Carter; Jennifer A,0,0,20,20
1745827668641,MCWP 50R,C00,893771,Krone; Jarret,0,3,20,20
1745827668641,MCWP 50R,D00,893772,Miller; Elizabeth Deen,3,0,20,17
1745827668641,MCWP 50R,E00,893775,Carter; Andrea L,0,0,20,20
1745827669669,MMW 11R,A01,892721,Herbst; Matthew,11,0,27,16
1745827669669,MMW 11R,A02,892722,Herbst; Matthew,0,0,0,3
1745827670700,MMW 12R,A01,892724,Herbst; Matthew,0,10,16,16
1745827670700,MMW 12R,A02,892725,Herbst; Matthew,0,9,16,16
1745827671726,MMW 13R,A01,892727,Staff,0,3,16,16
1745827671726,MMW 13R,A02,892728,Staff,0,4,16,16
1745827671726,MMW 13R,A03,958032,Staff,0,3,16,16
1745827671726,MMW 13R,A04,958033,Staff,0,2,16,16
1745827671726,MMW 13R,A05,958034,Staff,0,3,16,16
1745827672759,SIO 295LS,A00,894015,Staff,7,0,25,18
1745827673792,SIO 295S,A00,894020,Staff,7,0,25,18
1745827674820,SIOC 290S,B01,958918,Staff,0,0,0,0
1745827675850,SIOC 291S,B01,958922,Staff,0,0,0,0
1745827676879,SOCI 117,A01,895339,Staff,4,0,5,1
1745827677910,WES 237B,A00,894149,Staff,11,0,20,9
1745827680068,AESE 279B,A00,891859,Staff,13,0,35,22
1745827681095,AIP 197,001,891854,Staff,70,0,70,0
1745827682123,ANTH 289S,A00,891856,Gagneux; Pascal,12,0,12,0
1745827683150,BENG 196,001,957946,Engler; Adam J.,9996,0,9999,3
1745827684175,CAT 124RS,A01,956906,Staff,8,0,25,17
1745827685207,CAT 125RS,A01,922013,Staff,8,0,25,17
1745827686233,CLRE 250,A00,891860,Morris; Sheldon,9995,0,9999,4
1745827688293,CLRE 251R,A00,907817,Mehta; Ravindra L.,9994,0,9999,5
1745827689322,CLRE 252,A00,891864,Cuomo; Raphael Eduardo,9993,0,9999,6
1745827690356,CLRE 253,A00,891867,Vaida; Florin,9994,0,9999,5
1745827690356,CLRE 253,B00,907819,Staff,9999,0,9999,0
1745827691437,CLRE 259,A00,891868,Patel; Hemal,9998,0,9999,1
1745827692468,CLRE 260,A00,891872,Cuomo; Raphael Eduardo,9999,0,9999,0
1745827693494,CLRE 297,001,891888,Cuomo; Raphael Eduardo,9999,0,9999,0
1745827694522,CSE 191,A00,958773,Minnes Kemp; Mor Mia,9999,0,9999,0
1745827695549,CSS 201S,A01,892054,Mignozzetti; Umberto,30,0,30,0
1745827696576,CSS 202S,A01,892056,Mignozzetti; Umberto,30,0,30,0
1745827697601,DSC 197,001,956898,Eldridge; Justin Matthew,9998,0,9999,1
1745827698634,DSC 297,001,958000,Mazumdar; Arya,9998,0,9999,1
1745827699668,EAP 100,A00,905686,Staff,9776,0,9999,223
1745827700696,ECE 45,A01,892618,Staff,0,13,50,50
1745827701726,ECE 109,A01,892620,Staff,0,43,0,0
1745827702753,ECE 111,A01,892719,Staff,0,9,50,50
1745827703779,ECE 197,001,957920,Mercier; Patrick Philip,9992,0,9999,7
1745827704817,ECON 178,A01,907814,Zhu; Ying,28,0,35,7
1745827705845,EDS 115,A00,895312,Staff,41,0,45,4
1745827706873,EDS 117,A01,895337,Staff,30,0,30,0
1745827707907,EDS 125,A00,895341,Jones; Gabrielle Anastasia,43,0,45,2
1745827708935,EDS 128A,A01,895459,Fargason; Sharon Gayle,44,0,45,1
1745827709961,EDS 128B,A01,895543,Pappas; Elizabeth,44,0,45,1
1745827710989,EDS 139,A00,897203,Pappas; Elizabeth,44,0,45,1
1745827710989,EDS 139,B00,897209,Fargason; Sharon Gayle,44,0,45,1
1745827712030,EDS 201,A00,895545,Staff,43,0,45,2
1745827713056,EDS 203,A01,895581,Halter; Christopher P.,43,0,45,2
1745827714084,EDS 204R,A01,895625,Heinzman; Erica M.,43,0,45,2
1745827714084,EDS 204R,B01,895693,Halter; Christopher P.,18,0,45,27
1745827715110,EDS 206R,A00,895694,Fargason; Sharon Gayle,9,0,30,21
1745827715110,EDS 206R,B00,895695,Choi; Bailey Miyeon,20,0,30,10
1745827716143,EDS 250,A00,895697,Hemans; Patricia Ann Benitez,43,0,45,2
1745827717170,EDS 281,A00,895701,Meyerott; Theresa Ann,15,0,15,0
1745827718196,EDS 284,A00,895736,Meyerott; Theresa Ann,15,0,15,0
1745827719223,EDS 286,A00,897210,Fine; Sarah,15,0,15,0
1745827720256,EDS 289C,A01,895770,Daly; Alan J.,15,0,15,0
1745827721286,EDS 290,A00,897211,Hofstetter; Carolyn,15,0,15,0
1745827722321,LIGM 5A,A00,896162,Fischer-Grunski; Eva K,15,0,20,5
1745827723359,LIGM 5B,A00,896260,Fischer-Grunski; Eva K,17,0,20,3
1745827724392,LIGM 5C,A00,896308,Fischer-Grunski; Eva K,18,0,20,2
1745827725430,LIIT 5AS,A00,896313,Carnelos; Chiara,17,0,20,3
1745827726456,LIIT 5BS,A00,896416,Carnelos; Chiara,20,0,20,0
1745827727484,LIIT 5CS,A00,896564,Carnelos; Chiara,20,0,20,0
1745827728521,LISP 5A,A00,896588,Munoz Sanchez; Alicia,4,0,20,16
1745827729548,LISP 5B,A00,896653,Munoz Sanchez; Alicia,10,0,20,10
1745827730577,LISP 5C,A00,896655,Munoz Sanchez; Alicia,4,0,20,16
1745827731605,MAE 197,001,957918,Kleissl; Jan,9998,0,9999,1
1745827732633,MATH 2,A01,957937,Staff,34,0,35,1
1745827733664,MATH 197,001,957876,Kedlaya; Kiran S.,9993,0,9999,6
1745827734693,MCWP 40,A00,892729,Duru; Nur,13,0,20,7
1745827734693,MCWP 40,B00,893304,Montejo; Carolina,20,0,20,0
1745827735730,MCWP 40R,A00,893757,Redela; Pamela Morgan,0,7,20,20
1745827736765,MCWP 50,A00,893758,Morshed; Michael James,2,0,20,18
1745827736765,MCWP 50,B00,893761,Bartulis; Jason Michael,18,0,20,2
1745827737801,MCWP 50R,A00,893766,Compas; Sean Matthew,0,1,20,20
1745827737801,MCWP 50R,B00,893769,Carter; Jennifer A,0,0,20,20
1745827737801,MCWP 50R,C00,893771,Krone; Jarret,0,3,20,20
1745827737801,MCWP 50R,D00,893772,Miller; Elizabeth Deen,3,0,20,17
1745827737801,MCWP 50R,E00,893775,Carter; Andrea L,0,0,20,20
1745827738827,MMW 11R,A01,892721,Herbst; Matthew,11,0,27,16
1745827738827,MMW 11R,A02,892722,Herbst; Matthew,0,0,0,3
1745827739858,MMW 12R,A01,892724,Herbst; Matthew,0,10,16,16
1745827739858,MMW 12R,A02,892725,Herbst; Matthew,0,9,16,16
1745827740890,MMW 13R,A01,892727,Staff,0,3,16,16
1745827740890,MMW 13R,A02,892728,Staff,0,4,16,16
1745827740890,MMW 13R,A03,958032,Staff,0,3,16,16
1745827740890,MMW 13R,A04,958033,Staff,0,2,16,16
1745827740890,MMW 13R,A05,958034,Staff,0,3,16,16
1745827741921,SIO 295LS,A00,894015,Staff,7,0,25,18
1745827742950,SIO 295S,A00,894020,Staff,7,0,25,18
1745827743995,SIOC 290S,B01,958918,Staff,0,0,0,0
1745827745042,SIOC 291S,B01,958922,Staff,0,0,0,0
1745827746073,SOCI 117,A01,895339,Staff,4,0,5,1
1745827747099,WES 237B,A00,894149,Staff,11,0,20,9
1745827749195,AESE 279B,A00,891859,Staff,13,0,35,22
1745827750221,AIP 197,001,891854,Staff,70,0,70,0
1745827751253,ANTH 289S,A00,891856,Gagneux; Pascal,12,0,12,0
1745827752292,BENG 196,001,957946,Engler; Adam J.,9996,0,9999,3
1745827753322,CAT 124RS,A01,956906,Staff,8,0,25,17
1745827754351,CAT 125RS,A01,922013,Staff,8,0,25,17
1745827755379,CLRE 250,A00,891860,Morris; Sheldon,9995,0,9999,4
1745827757438,CLRE 251R,A00,907817,Mehta; Ravindra L.,9994,0,9999,5
1745827758467,CLRE 252,A00,891864,Cuomo; Raphael Eduardo,9993,0,9999,6
1745827759494,CLRE 253,A00,891867,Vaida; Florin,9994,0,9999,5
1745827759494,CLRE 253,B00,907819,Staff,9999,0,9999,0
1745827760523,CLRE 259,A00,891868,Patel; Hemal,9998,0,9999,1
1745827761549,CLRE 260,A00,891872,Cuomo; Raphael Eduardo,9999,0,9999,0
1745827762575,CLRE 297,001,891888,Cuomo; Raphael Eduardo,9999,0,9999,0
1745827763604,CSE 191,A00,958773,Minnes Kemp; Mor Mia,9999,0,9999,0
1745827764643,CSS 201S,A01,892054,Mignozzetti; Umberto,30,0,30,0
1745827765676,CSS 202S,A01,892056,Mignozzetti; Umberto,30,0,30,0
1745827766703,DSC 197,001,956898,Eldridge; Justin Matthew,9998,0,9999,1
1745827767730,DSC 297,001,958000,Mazumdar; Arya,9998,0,9999,1
1745827768756,EAP 100,A00,905686,Staff,9776,0,9999,223
1745827769798,ECE 45,A01,892618,Staff,0,13,50,50
1745827770824,ECE 109,A01,892620,Staff,0,43,0,0
1745827771857,ECE 111,A01,892719,Staff,0,9,50,50
1745827772889,ECE 197,001,957920,Mercier; Patrick Philip,9992,0,9999,7
1745827773917,ECON 178,A01,907814,Zhu; Ying,28,0,35,7
1745827774963,EDS 115,A00,895312,Staff,41,0,45,4
1745827775995,EDS 117,A01,895337,Staff,30,0,30,0
1745827777023,EDS 125,A00,895341,Jones; Gabrielle Anastasia,43,0,45,2
1745827778053,EDS 128A,A01,895459,Fargason; Sharon Gayle,44,0,45,1
1745827779081,EDS 128B,A01,895543,Pappas; Elizabeth,44,0,45,1
1745827780113,EDS 139,A00,897203,Pappas; Elizabeth,44,0,45,1
1745827780113,EDS 139,B00,897209,Fargason; Sharon Gayle,44,0,45,1
1745827781144,EDS 201,A00,895545,Staff,43,0,45,2
1745827782171,EDS 203,A01,895581,Halter; Christopher P.,43,0,45,2
1745827783200,EDS 204R,A01,895625,Heinzman; Erica M.,43,0,45,2
1745827783200,EDS 204R,B01,895693,Halter; Christopher P.,18,0,45,27
1745827784232,EDS 206R,A00,895694,Fargason; Sharon Gayle,9,0,30,21
1745827784232,EDS 206R,B00,895695,Choi; Bailey Miyeon,20,0,30,10
1745827785264,EDS 250,A00,895697,Hemans; Patricia Ann Benitez,43,0,45,2
1745827786293,EDS 281,A00,895701,Meyerott; Theresa Ann,15,0,15,0
1745827787318,EDS 284,A00,895736,Meyerott; Theresa Ann,15,0,15,0
1745827788351,EDS 286,A00,897210,Fine; Sarah,15,0,15,0
1745827789377,EDS 289C,A01,895770,Daly; Alan J.,15,0,15,0
1745827790405,EDS 290,A00,897211,Hofstetter; Carolyn,15,0,15,0
1745827791433,LIGM 5A,A00,896162,Fischer-Grunski; Eva K,15,0,20,5
1745827792462,LIGM 5B,A00,896260,Fischer-Grunski; Eva K,17,0,20,3
1745827793489,LIGM 5C,A00,896308,Fischer-Grunski; Eva K,18,0,20,2
1745827794516,LIIT 5AS,A00,896313,Carnelos; Chiara,17,0,20,3
1745827795546,LIIT 5BS,A00,896416,Carnelos; Chiara,20,0,20,0
1745827796572,LIIT 5CS,A00,896564,Carnelos; Chiara,20,0,20,0
1745827797601,LISP 5A,A00,896588,Munoz Sanchez; Alicia,4,0,20,16
1745827798631,LISP 5B,A00,896653,Munoz Sanchez; Alicia,10,0,20,10
1745827799670,LISP 5C,A00,896655,Munoz Sanchez; Alicia,4,0,20,16
1745827800701,MAE 197,001,957918,Kleissl; Jan,9998,0,9999,1
1745827801729,MATH 2,A01,957937,Staff,34,0,35,1
1745827802762,MATH 197,001,957876,Kedlaya; Kiran S.,9993,0,9999,6
1745827803802,MCWP 40,A00,892729,Duru; Nur,13,0,20,7
1745827803802,MCWP 40,B00,893304,Montejo; Carolina,20,0,20,0
1745827804827,MCWP 40R,A00,893757,Redela; Pamela Morgan,0,7,20,20
1745827805858,MCWP 50,A00,893758,Morshed; Michael James,2,0,20,18
1745827805858,MCWP 50,B00,893761,Bartulis; Jason Michael,18,0,20,2
1745827806903,MCWP 50R,A00,893766,Compas; Sean Matthew,0,1,20,20
1745827806903,MCWP 50R,B00,893769,Carter; Jennifer A,0,0,20,20
1745827806903,MCWP 50R,C00,893771,Krone; Jarret,0,3,20,20
1745827806903,MCWP 50R,D00,893772,Miller; Elizabeth Deen,3,0,20,17
1745827806903,MCWP 50R,E00,893775,Carter; Andrea L,0,0,20,20
1745827807933,MMW 11R,A01,892721,Herbst; Matthew,11,0,27,16
1745827807933,MMW 11R,A02,892722,Herbst; Matthew,0,0,0,3
1745827808960,MMW 12R,A01,892724,Herbst; Matthew,0,10,16,16
1745827808960,MMW 12R,A02,892725,Herbst; Matthew,0,9,16,16
1745827809988,MMW 13R,A01,892727,Staff,0,3,16,16
1745827809988,MMW 13R,A02,892728,Staff,0,4,16,16
1745827809988,MMW 13R,A03,958032,Staff,0,3,16,16
1745827809988,MMW 13R,A04,958033,Staff,0,2,16,16
1745827809988,MMW 13R,A05,958034,Staff,0,3,16,16
1745827811019,SIO 295LS,A00,894015,Staff,7,0,25,18
1745827812048,SIO 295S,A00,894020,Staff,7,0,25,18
1745827813078,SIOC 290S,B01,958918,Staff,0,0,0,0
1745827814107,SIOC 291S,B01,958922,Staff,0,0,0,0
1745827815136,SOCI 117,A01,895339,Staff,4,0,5,1
1745827816166,WES 237B,A00,894149,Staff,11,0,20,9
1745827818245,AESE 279B,A00,891859,Staff,13,0,35,22
1745827819273,AIP 197,001,891854,Staff,70,0,70,0
1745827820306,ANTH 289S,A00,891856,Gagneux; Pascal,12,0,12,0
1745827821337,BENG 196,001,957946,Engler; Adam J.,9996,0,9999,3
1745827822363,CAT 124RS,A01,956906,Staff,8,0,25,17
1745827823395,CAT 125RS,A01,922013,Staff,8,0,25,17
1745827824430,CLRE 250,A00,891860,Morris; Sheldon,9995,0,9999,4
1745827826485,CLRE 251R,A00,907817,Mehta; Ravindra L.,9994,0,9999,5
1745827827511,CLRE 252,A00,891864,Cuomo; Raphael Eduardo,9993,0,9999,6
1745827828536,CLRE 253,A00,891867,Vaida; Florin,9994,0,9999,5
1745827828536,CLRE 253,B00,907819,Staff,9999,0,9999,0
1745827829571,CLRE 259,A00,891868,Patel; Hemal,9998,0,9999,1
1745827830597,CLRE 260,A00,891872,Cuomo; Raphael Eduardo,9999,0,9999,0
1745827831623,CLRE 297,001,891888,Cuomo; Raphael Eduardo,9999,0,9999,0
1745827832670,CSE 191,A00,958773,Minnes Kemp; Mor Mia,9999,0,9999,0
1745827833705,CSS 201S,A01,892054,Mignozzetti; Umberto,30,0,30,0
1745827834732,CSS 202S,A01,892056,Mignozzetti; Umberto,30,0,30,0
1745827835766,DSC 197,001,956898,Eldridge; Justin Matthew,9998,0,9999,1
1745827836798,DSC 297,001,958000,Mazumdar; Arya,9998,0,9999,1
1745827837891,EAP 100,A00,905686,Staff,9776,0,9999,223
1745827838915,ECE 45,A01,892618,Staff,0,13,50,50
1745827839943,ECE 109,A01,892620,Staff,0,43,0,0
1745827840971,ECE 111,A01,892719,Staff,0,9,50,50
1745827841997,ECE 197,001,957920,Mercier; Patrick Philip,9992,0,9999,7
1745827843027,ECON 178,A01,907814,Zhu; Ying,28,0,35,7
1745827844054,EDS 115,A00,895312,Staff,41,0,45,4
1745827845082,EDS 117,A01,895337,Staff,30,0,30,0
1745827846121,EDS 125,A00,895341,Jones; Gabrielle Anastasia,43,0,45,2
1745827847162,EDS 128A,A01,895459,Fargason; Sharon Gayle,44,0,45,1
1745827848191,EDS 128B,A01,895543,Pappas; Elizabeth,44,0,45,1
1745827849218,EDS 139,A00,897203,Pappas; Elizabeth,44,0,45,1
1745827849218,EDS 139,B00,897209,Fargason; Sharon Gayle,44,0,45,1
1745827850243,EDS 201,A00,895545,Staff,43,0,45,2
1745827851270,EDS 203,A01,895581,Halter; Christopher P.,43,0,45,2
1745827852318,EDS 204R,A01,895625,Heinzman; Erica M.,43,0,45,2
1745827852318,EDS 204R,B01,895693,Halter; Christopher P.,18,0,45,27
1745827853357,EDS 206R,A00,895694,Fargason; Sharon Gayle,9,0,30,21
1745827853357,EDS 206R,B00,895695,Choi; Bailey Miyeon,20,0,30,10
1745827854390,EDS 250,A00,895697,Hemans; Patricia Ann Benitez,43,0,45,2
1745827855432,EDS 281,A00,895701,Meyerott; Theresa Ann,15,0,15,0
1745827856458,EDS 284,A00,895736,Meyerott; Theresa Ann,15,0,15,0
1745827857483,EDS 286,A00,897210,Fine; Sarah,15,0,15,0
1745827858522,EDS 289C,A01,895770,Daly; Alan J.,15,0,15,0
1745827859553,EDS 290,A00,897211,Hofstetter; Carolyn,15,0,15,0
1745827860588,LIGM 5A,A00,896162,Fischer-Grunski; Eva K,15,0,20,5
1745827861620,LIGM 5B,A00,896260,Fischer-Grunski; Eva K,17,0,20,3
1745827862651,LIGM 5C,A00,896308,Fischer-Grunski; Eva K,18,0,20,2
1745827863685,LIIT 5AS,A00,896313,Carnelos; Chiara,17,0,20,3
1745827864711,LIIT 5BS,A00,896416,Carnelos; Chiara,20,0,20,0
1745827865750,LIIT 5CS,A00,896564,Carnelos; Chiara,20,0,20,0
1745827866784,LISP 5A,A00,896588,Munoz Sanchez; Alicia,4,0,20,16
1745827867810,LISP 5B,A00,896653,Munoz Sanchez; Alicia,10,0,20,10
1745827868840,LISP 5C,A00,896655,Munoz Sanchez; Alicia,4,0,20,16
1745827869868,MAE 197,001,957918,Kleissl; Jan,9998,0,9999,1
1745827870900,MATH 2,A01,957937,Staff,34,0,35,1
1745827871932,MATH 197,001,957876,Kedlaya; Kiran S.,9993,0,9999,6
1745827872961,MCWP 40,A00,892729,Duru; Nur,13,0,20,7
1745827872961,MCWP 40,B00,893304,Montejo; Carolina,20,0,20,0
1745827873991,MCWP 40R,A00,893757,Redela; Pamela Morgan,0,7,20,20
1745827875020,MCWP 50,A00,893758,Morshed; Michael James,2,0,20,18
1745827875020,MCWP 50,B00,893761,Bartulis; Jason Michael,18,0,20,2
1745827876056,MCWP 50R,A00,893766,Compas; Sean Matthew,0,1,20,20
1745827876056,MCWP 50R,B00,893769,Carter; Jennifer A,0,0,20,20
1745827876056,MCWP 50R,C00,893771,Krone; Jarret,0,3,20,20
1745827876056,MCWP 50R,D00,893772,Miller; Elizabeth Deen,3,0,20,17
1745827876056,MCWP 50R,E00,893775,Carter; Andrea L,0,0,20,20
1745827877089,MMW 11R,A01,892721,Herbst; Matthew,11,0,27,16
1745827877089,MMW 11R,A02,892722,Herbst; Matthew,0,0,0,3
1745827878117,MMW 12R,A01,892724,Herbst; Matthew,0,10,16,16
1745827878117,MMW 12R,A02,892725,Herbst; Matthew,0,9,16,16
1745827879144,MMW 13R,A01,892727,Staff,0,3,16,16
1745827879144,MMW 13R,A02,892728,Staff,0,4,16,16
1745827879144,MMW 13R,A03,958032,Staff,0,3,16,16
1745827879144,MMW 13R,A04,958033,Staff,0,2,16,16
1745827879144,MMW 13R,A05,958034,Staff,0,3,16,16
1745827880174,SIO 295LS,A00,894015,Staff,7,0,25,18
1745827881201,SIO 295S,A00,894020,Staff,7,0,25,18
1745827882238,SIOC 290S,B01,958918,Staff,0,0,0,0
1745827883263,SIOC 291S,B01,958922,Staff,0,0,0,0
1745827884294,SOCI 117,A01,895339,Staff,4,0,5,1
1745827885320,WES 237B,A00,894149,Staff,11,0,20,9
1745827887422,AESE 279B,A00,891859,Staff,13,0,35,22
1745827888452,AIP 197,001,891854,Staff,70,0,70,0
1745827889479,ANTH 289S,A00,891856,Gagneux; Pascal,12,0,12,0
1745827890505,BENG 196,001,957946,Engler; Adam J.,9996,0,9999,3
1745827891531,CAT 124RS,A01,956906,Staff,8,0,25,17
1745827892560,CAT 125RS,A01,922013,Staff,8,0,25,17
1745827893585,CLRE 250,A00,891860,Morris; Sheldon,9995,0,9999,4
1745827895646,CLRE 251R,A00,907817,Mehta; Ravindra L.,9994,0,9999,5
1745827896674,CLRE 252,A00,891864,Cuomo; Raphael Eduardo,9993,0,9999,6
1745827897701,CLRE 253,A00,891867,Vaida; Florin,9994,0,9999,5
1745827897701,CLRE 253,B00,907819,Staff,9999,0,9999,0
1745827898729,CLRE 259,A00,891868,Patel; Hemal,9998,0,9999,1
1745827899759,CLRE 260,A00,891872,Cuomo; Raphael Eduardo,9999,0,9999,0
1745827900788,CLRE 297,001,891888,Cuomo; Raphael Eduardo,9999,0,9999,0
1745827901819,CSE 191,A00,958773,Minnes Kemp; Mor Mia,9999,0,9999,0
1745827902863,CSS 201S,A01,892054,Mignozzetti; Umberto,30,0,30,0
1745827903895,CSS 202S,A01,892056,Mignozzetti; Umberto,30,0,30,0
1745827904926,DSC 197,001,956898,Eldridge; Justin Matthew,9998,0,9999,1
1745827905953,DSC 297,001,958000,Mazumdar; Arya,9998,0,9999,1
1745827906980,EAP 100,A00,905686,Staff,9776,0,9999,223
1745827908006,ECE 45,A01,892618,Staff,0,13,50,50
1745827909036,ECE 109,A01,892620,Staff,0,43,0,0
1745827910088,ECE 111,A01,892719,Staff,0,9,50,50
1745827911117,ECE 197,001,957920,Mercier; Patrick Philip,9992,0,9999,7
1745827912151,ECON 178,A01,907814,Zhu; Ying,28,0,35,7
1745827913177,EDS 115,A00,895312,Staff,41,0,45,4
1745827914202,EDS 117,A01,895337,Staff,30,0,30,0
1745827915229,EDS 125,A00,895341,Jones; Gabrielle Anastasia,43,0,45,2
1745827916262,EDS 128A,A01,895459,Fargason; Sharon Gayle,44,0,45,1
1745827917289,EDS 128B,A01,895543,Pappas; Elizabeth,44,0,45,1
1745827918316,EDS 139,A00,897203,Pappas; Elizabeth,44,0,45,1
1745827918316,EDS 139,B00,897209,Fargason; Sharon Gayle,44,0,45,1
1745827919342,EDS 201,A00,895545,Staff,43,0,45,2
1745827920371,EDS 203,A01,895581,Halter; Christopher P.,43,0,45,2
1745827921409,EDS 204R,A01,895625,Heinzman; Erica M.,43,0,45,2
1745827921409,EDS 204R,B01,895693,Halter; Christopher P.,18,0,45,27
1745827922447,EDS 206R,A00,895694,Fargason; Sharon Gayle,9,0,30,21
1745827922447,EDS 206R,B00,895695,Choi; Bailey Miyeon,20,0,30,10
1745827923475,EDS 250,A00,895697,Hemans; Patricia Ann Benitez,43,0,45,2
1745827924504,EDS 281,A00,895701,Meyerott; Theresa Ann,15,0,15,0
1745827925529,EDS 284,A00,895736,Meyerott; Theresa Ann,15,0,15,0
1745827926557,EDS 286,A00,897210,Fine; Sarah,15,0,15,0
1745827927583,EDS 289C,A01,895770,Daly; Alan J.,15,0,15,0
1745827928613,EDS 290,A00,897211,Hofstetter; Carolyn,15,0,15,0
1745827929643,LIGM 5A,A00,896162,Fischer-Grunski; Eva K,15,0,20,5
1745827930670,LIGM 5B,A00,896260,Fischer-Grunski; Eva K,17,0,20,3
1745827931697,LIGM 5C,A00,896308,Fischer-Grunski; Eva K,18,0,20,2
1745827932725,LIIT 5AS,A00,896313,Carnelos; Chiara,17,0,20,3
1745827933757,LIIT 5BS,A00,896416,Carnelos; Chiara,20,0,20,0
1745827934783,LIIT 5CS,A00,896564,Carnelos; Chiara,20,0,20,0
1745827935812,LISP 5A,A00,896588,Munoz Sanchez; Alicia,4,0,20,16
1745827936837,LISP 5B,A00,896653,Munoz Sanchez; Alicia,10,0,20,10
1745827937865,LISP 5C,A00,896655,Munoz Sanchez; Alicia,4,0,20,16
1745827938894,MAE 197,001,957918,Kleissl; Jan,9998,0,9999,1
1745827939923,MATH 2,A01,957937,Staff,34,0,35,1
1745827940952,MATH 197,001,957876,Kedlaya; Kiran S.,9993,0,9999,6
1745827941986,MCWP 40,A00,892729,Duru; Nur,13,0,20,7
1745827941986,MCWP 40,B00,893304,Montejo; Carolina,20,0,20,0
1745827943013,MCWP 40R,A00,893757,Redela; Pamela Morgan,0,7,20,20
1745827944044,MCWP 50,A00,893758,Morshed; Michael James,2,0,20,18
1745827944044,MCWP 50,B00,893761,Bartulis; Jason Michael,18,0,20,2
1745827945076,MCWP 50R,A00,893766,Compas; Sean Matthew,0,1,20,20
1745827945076,MCWP 50R,B00,893769,Carter; Jennifer A,0,0,20,20
1745827945076,MCWP 50R,C00,893771,Krone; Jarret,0,3,20,20
1745827945076,MCWP 50R,D00,893772,Miller; Elizabeth Deen,3,0,20,17
1745827945076,MCWP 50R,E00,893775,Carter; Andrea L,0,0,20,20
1745827946121,MMW 11R,A01,892721,Herbst; Matthew,11,0,27,16
1745827946121,MMW 11R,A02,892722,Herbst; Matthew,0,0,0,3
1745827947149,MMW 12R,A01,892724,Herbst; Matthew,0,10,16,16
1745827947149,MMW 12R,A02,892725,Herbst; Matthew,0,9,16,16
1745827948176,MMW 13R,A01,892727,Staff,0,3,16,16
1745827948176,MMW 13R,A02,892728,Staff,0,4,16,16
1745827948176,MMW 13R,A03,958032,Staff,0,3,16,16
1745827948176,MMW 13R,A04,958033,Staff,0,2,16,16
1745827948176,MMW 13R,A05,958034,Staff,0,3,16,16
1745827949205,SIO 295LS,A00,894015,Staff,7,0,25,18
1745827950232,SIO 295S,A00,894020,Staff,7,0,25,18
1745827951266,SIOC 290S,B01,958918,Staff,0,0,0,0
1745827952292,SIOC 291S,B01,958922,Staff,0,0,0,0
1745827953344,SOCI 117,A01,895339,Staff,4,0,5,1
1745827954372,WES 237B,A00,894149,Staff,11,0,20,9
1745827956457,AESE 279B,A00,891859,Staff,13,0,35,22
1745827957484,AIP 197,001,891854,Staff,70,0,70,0
1745827958516,ANTH 289S,A00,891856,Gagneux; Pascal,12,0,12,0
1745827959545,BENG 196,001,957946,Engler; Adam J.,9996,0,9999,3
1745827960570,CAT 124RS,A01,956906,Staff,8,0,25,17
1745827961595,CAT 125RS,A01,922013,Staff,8,0,25,17
1745827962622,CLRE 250,A00,891860,Morris; Sheldon,9995,0,9999,4
1745827964676,CLRE 251R,A00,907817,Mehta; Ravindra L.,9994,0,9999,5
1745827965703,CLRE 252,A00,891864,Cuomo; Raphael Eduardo,9993,0,9999,6
1745827966728,CLRE 253,A00,891867,Vaida; Florin,9994,0,9999,5
1745827966728,CLRE 253,B00,907819,Staff,9999,0,9999,0
1745827967753,CLRE 259,A00,891868,Patel; Hemal,9998,0,9999,1
1745827968778,CLRE 260,A00,891872,Cuomo; Raphael Eduardo,9999,0,9999,0
1745827969805,CLRE 297,001,891888,Cuomo; Raphael Eduardo,9999,0,9999,0
1745827970835,CSE 191,A00,958773,Minnes Kemp; Mor Mia,9999,0,9999,0
1745827971864,CSS 201S,A01,892054,Mignozzetti; Umberto,30,0,30,0
1745827972894,CSS 202S,A01,892056,Mignozzetti; Umberto,30,0,30,0
1745827973921,DSC 197,001,956898,Eldridge; Justin Matthew,9998,0,9999,1
1745827974957,DSC 297,001,958000,Mazumdar; Arya,9998,0,9999,1
1745827975984,EAP 100,A00,905686,Staff,9776,0,9999,223
1745827977040,ECE 45,A01,892618,Staff,0,13,50,50
1745827978069,ECE 109,A01,892620,Staff,0,43,0,0
1745827979094,ECE 111,A01,892719,Staff,0,9,50,50
1745827980124,ECE 197,001,957920,Mercier; Patrick Philip,9992,0,9999,7
1745827981158,ECON 178,A01,907814,Zhu; Ying,28,0,35,7
1745827982184,EDS 115,A00,895312,Staff,41,0,45,4
1745827983211,EDS 117,A01,895337,Staff,30,0,30,0
1745827984238,EDS 125,A00,895341,Jones; Gabrielle Anastasia,43,0,45,2
1745827985264,EDS 128A,A01,895459,Fargason; Sharon Gayle,44,0,45,1
1745827986294,EDS 128B,A01,895543,Pappas; Elizabeth,44,0,45,1
1745827987322,EDS 139,A00,897203,Pappas; Elizabeth,44,0,45,1
1745827987322,EDS 139,B00,897209,Fargason; Sharon Gayle,44,0,45,1
1745827988352,EDS 201,A00,895545,Staff,43,0,45,2
1745827989389,EDS 203,A01,895581,Halter; Christopher P.,43,0,45,2
1745827990414,EDS 204R,A01,895625,Heinzman; Erica M.,43,0,45,2
1745827990414,EDS 204R,B01,895693,Halter; Christopher P.,18,0,45,27
1745827991441,EDS 206R,A00,895694,Fargason; Sharon Gayle,9,0,30,21
1745827991441,EDS 206R,B00,895695,Choi; Bailey Miyeon,20,0,30,10
1745827992468,EDS 250,A00,895697,Hemans; Patricia Ann Benitez,43,0,45,2
1745827993498,EDS 281,A00,895701,Meyerott; Theresa Ann,15,0,15,0
1745827994523,EDS 284,A00,895736,Meyerott; Theresa Ann,15,0,15,0
1745827995550,EDS 286,A00,897210,Fine; Sarah,15,0,15,0
1745827996574,EDS 289C,A01,895770,Daly; Alan J.,15,0,15,0
1745827997601,EDS 290,A00,897211,Hofstetter; Carolyn,15,0,15,0
1745827998635,LIGM 5A,A00,896162,Fischer-Grunski; Eva K,15,0,20,5
1745827999661,LIGM 5B,A00,896260,Fischer-Grunski; Eva K,17,0,20,3
1745828000689,LIGM 5C,A00,896308,Fischer-Grunski; Eva K,18,0,20,2
1745828001718,LIIT 5AS,A00,896313,Carnelos; Chiara,17,0,20,3
1745828002752,LIIT 5BS,A00,896416,Carnelos; Chiara,20,0,20,0
1745828003780,LIIT 5CS,A00,896564,Carnelos; Chiara,20,0,20,0
1745828004809,LISP 5A,A00,896588,Munoz Sanchez; Alicia,4,0,20,16
1745828005837,LISP 5B,A00,896653,Munoz Sanchez; Alicia,10,0,20,10
1745828006869,LISP 5C,A00,896655,Munoz Sanchez; Alicia,4,0,20,16
1745828007896,MAE 197,001,957918,Kleissl; Jan,9998,0,9999,1
1745828008929,MATH 2,A01,957937,Staff,34,0,35,1
1745828009960,MATH 197,001,957876,Kedlaya; Kiran S.,9993,0,9999,6
1745828011006,MCWP 40,A00,892729,Duru; Nur,13,0,20,7
1745828011006,MCWP 40,B00,893304,Montejo; Carolina,20,0,20,0
1745828012038,MCWP 40R,A00,893757,Redela; Pamela Morgan,0,7,20,20
1745828013072,MCWP 50,A00,893758,Morshed; Michael James,2,0,20,18
1745828013072,MCWP 50,B00,893761,Bartulis; Jason Michael,18,0,20,2
1745828014101,MCWP 50R,A00,893766,Compas; Sean Matthew,0,1,20,20
1745828014101,MCWP 50R,B00,893769,Carter; Jennifer A,0,0,20,20
1745828014101,MCWP 50R,C00,893771,Krone; Jarret,0,3,20,20
1745828014101,MCWP 50R,D00,893772,Miller; Elizabeth Deen,3,0,20,17
1745828014101,MCWP 50R,E00,893775,Carter; Andrea L,0,0,20,20
1745828015127,MMW 11R,A01,892721,Herbst; Matthew,11,0,27,16
1745828015127,MMW 11R,A02,892722,Herbst; Matthew,0,0,0,3
1745828016159,MMW 12R,A01,892724,Herbst; Matthew,0,10,16,16
1745828016159,MMW 12R,A02,892725,Herbst; Matthew,0,9,16,16
1745828017187,MMW 13R,A01,892727,Staff,0,3,16,16
1745828017187,MMW 13R,A02,892728,Staff,0,4,16,16
1745828017187,MMW 13R,A03,958032,Staff,0,3,16,16
1745828017187,MMW 13R,A04,958033,Staff,0,2,16,16
1745828017187,MMW 13R,A05,958034,Staff,0,3,16,16
1745828018215,SIO 295LS,A00,894015,Staff,7,0,25,18
1745828019242,SIO 295S,A00,894020,Staff,7,0,25,18
1745828020268,SIOC 290S,B01,958918,Staff,0,0,0,0
1745828021299,SIOC 291S,B01,958922,Staff,0,0,0,0
1745828022326,SOCI 117,A01,895339,Staff,4,0,5,1
1745828023352,WES 237B,A00,894149,Staff,11,0,20,9
1745828025431,AESE 279B,A00,891859,Staff,13,0,35,22
1745828026468,AIP 197,001,891854,Staff,70,0,70,0
1745828027499,ANTH 289S,A00,891856,Gagneux; Pascal,12,0,12,0
1745828028532,BENG 196,001,957946,Engler; Adam J.,9996,0,9999,3
1745828029562,CAT 124RS,A01,956906,Staff,8,0,25,17
1745828030593,CAT 125RS,A01,922013,Staff,8,0,25,17
1745828031625,CLRE 250,A00,891860,Morris; Sheldon,9995,0,9999,4
1745828033683,CLRE 251R,A00,907817,Mehta; Ravindra L.,9994,0,9999,5
1745828034719,CLRE 252,A00,891864,Cuomo; Raphael Eduardo,9993,0,9999,6
1745828035747,CLRE 253,A00,891867,Vaida; Florin,9994,0,9999,5
1745828035747,CLRE 253,B00,907819,Staff,9999,0,9999,0
1745828036774,CLRE 259,A00,891868,Patel; Hemal,9998,0,9999,1
1745828037802,CLRE 260,A00,891872,Cuomo; Raphael Eduardo,9999,0,9999,0
1745828038833,CLRE 297,001,891888,Cuomo; Raphael Eduardo,9999,0,9999,0
1745828039861,CSE 191,A00,958773,Minnes Kemp; Mor Mia,9999,0,9999,0
1745828040911,CSS 201S,A01,892054,Mignozzetti; Umberto,30,0,30,0
1745828041942,CSS 202S,A01,892056,Mignozzetti; Umberto,30,0,30,0
1745828042970,DSC 197,001,956898,Eldridge; Justin Matthew,9998,0,9999,1
1745828044002,DSC 297,001,958000,Mazumdar; Arya,9998,0,9999,1
1745828045034,EAP 100,A00,905686,Staff,9776,0,9999,223
1745828046061,ECE 45,A01,892618,Staff,0,13,50,50
1745828047088,ECE 109,A01,892620,Staff,0,43,0,0
1745828048114,ECE 111,A01,892719,Staff,0,9,50,50
1745828049144,ECE 197,001,957920,Mercier; Patrick Philip,9992,0,9999,7
1745828050171,ECON 178,A01,907814,Zhu; Ying,28,0,35,7
1745828051198,EDS 115,A00,895312,Staff,41,0,45,4
1745828052224,EDS 117,A01,895337,Staff,30,0,30,0
1745828053251,EDS 125,A00,895341,Jones; Gabrielle Anastasia,43,0,45,2
1745828054278,EDS 128A,A01,895459,Fargason; Sharon Gayle,44,0,45,1
1745828055308,EDS 128B,A01,895543,Pappas; Elizabeth,44,0,45,1
1745828056341,EDS 139,A00,897203,Pappas; Elizabeth,44,0,45,1
1745828056341,EDS 139,B00,897209,Fargason; Sharon Gayle,44,0,45,1
1745828057369,EDS 201,A00,895545,Staff,43,0,45,2
1745828058397,EDS 203,A01,895581,Halter; Christopher P.,43,0,45,2
1745828059425,EDS 204R,A01,895625,Heinzman; Erica M.,43,0,45,2
1745828059425,EDS 204R,B01,895693,Halter; Christopher P.,18,0,45,27
1745828060453,EDS 206R,A00,895694,Fargason; Sharon Gayle,9,0,30,21
1745828060453,EDS 206R,B00,895695,Choi; Bailey Miyeon,20,0,30,10
1745828061489,EDS 250,A00,895697,Hemans; Patricia Ann Benitez,43,0,45,2
1745828062517,EDS 281,A00,895701,Meyerott; Theresa Ann,15,0,15,0
1745828063544,EDS 284,A00,895736,Meyerott; Theresa Ann,15,0,15,0
1745828064571,EDS 286,A00,897210,Fine; Sarah,15,0,15,0
1745828065597,EDS 289C,A01,895770,Daly; Alan J.,15,0,15,0
1745828066625,EDS 290,A00,897211,Hofstetter; Carolyn,15,0,15,0
1745828067653,LIGM 5A,A00,896162,Fischer-Grunski; Eva K,15,0,20,5
1745828068679,LIGM 5B,A00,896260,Fischer-Grunski; Eva K,17,0,20,3
1745828069707,LIGM 5C,A00,896308,Fischer-Grunski; Eva K,18,0,20,2
1745828070736,LIIT 5AS,A00,896313,Carnelos; Chiara,17,0,20,3
1745828071767,LIIT 5BS,A00,896416,Carnelos; Chiara,20,0,20,0
1745828072795,LIIT 5CS,A00,896564,Carnelos; Chiara,20,0,20,0
1745828073827,LISP 5A,A00,896588,Munoz Sanchez; Alicia,4,0,20,16
1745828074855,LISP 5B,A00,896653,Munoz Sanchez; Alicia,10,0,20,10
1745828075888,LISP 5C,A00,896655,Munoz Sanchez; Alicia,4,0,20,16
1745828076920,MAE 197,001,957918,Kleissl; Jan,9998,0,9999,1
1745828077947,MATH 2,A01,957937,Staff,34,0,35,1
1745828078978,MATH 197,001,957876,Kedlaya; Kiran S.,9993,0,9999,6
1745828080007,MCWP 40,A00,892729,Duru; Nur,13,0,20,7
1745828080007,MCWP 40,B00,893304,Montejo; Carolina,20,0,20,0
1745828081035,MCWP 40R,A00,893757,Redela; Pamela Morgan,0,7,20,20
1745828082069,MCWP 50,A00,893758,Morshed; Michael James,2,0,20,18
1745828082069,MCWP 50,B00,893761,Bartulis; Jason Michael,18,0,20,2
1745828083140,MCWP 50R,A00,893766,Compas; Sean Matthew,0,1,20,20
1745828083140,MCWP 50R,B00,893769,Carter; Jennifer A,0,0,20,20
1745828083140,MCWP 50R,C00,893771,Krone; Jarret,0,3,20,20
1745828083140,MCWP 50R,D00,893772,Miller; Elizabeth Deen,3,0,20,17
1745828083140,MCWP 50R,E00,893775,Carter; Andrea L,0,0,20,20
1745828084167,MMW 11R,A01,892721,Herbst; Matthew,11,0,27,16
1745828084167,MMW 11R,A02,892722,Herbst; Matthew,0,0,0,3
1745828085197,MMW 12R,A01,892724,Herbst; Matthew,0,10,16,16
1745828085197,MMW 12R,A02,892725,Herbst; Matthew,0,9,16,16
1745828086224,MMW 13R,A01,892727,Staff,0,3,16,16
1745828086224,MMW 13R,A02,892728,Staff,0,4,16,16
1745828086224,MMW 13R,A03,958032,Staff,0,3,16,16
1745828086224,MMW 13R,A04,958033,Staff,0,2,16,16
1745828086224,MMW 13R,A05,958034,Staff,0,3,16,16
1745828087256,SIO 295LS,A00,894015,Staff,7,0,25,18
1745828088282,SIO 295S,A00,894020,Staff,7,0,25,18
1745828089320,SIOC 290S,B01,958918,Staff,0,0,0,0
1745828090348,SIOC 291S,B01,958922,Staff,0,0,0,0
1745828091379,SOCI 117,A01,895339,Staff,4,0,5,1
1745828092407,WES 237B,A00,894149,Staff,11,0,20,9
1745828094506,AESE 279B,A00,891859,Staff,13,0,35,22
1745828095533,AIP 197,001,891854,Staff,70,0,70,0
1745828096561,ANTH 289S,A00,891856,Gagneux; Pascal,12,0,12,0
1745828097591,BENG 196,001,957946,Engler; Adam J.,9996,0,9999,3
1745828098617,CAT 124RS,A01,956906,Staff,8,0,25,17
1745828099643,CAT 125RS,A01,922013,Staff,8,0,25,17
1745828100670,CLRE 250,A00,891860,Morris; Sheldon,9995,0,9999,4
1745828102732,CLRE 251R,A00,907817,Mehta; Ravindra L.,9994,0,9999,5
1745828103761,CLRE 252,A00,891864,Cuomo; Raphael Eduardo,9993,0,9999,6
1745828104796,CLRE 253,A00,891867,Vaida; Florin,9994,0,9999,5
1745828104796,CLRE 253,B00,907819,Staff,9999,0,9999,0
1745828105827,CLRE 259,A00,891868,Patel; Hemal,9998,0,9999,1
1745828106855,CLRE 260,A00,891872,Cuomo; Raphael Eduardo,9999,0,9999,0
1745828107881,CLRE 297,001,891888,Cuomo; Raphael Eduardo,9999,0,9999,0
1745828108917,CSE 191,A00,958773,Minnes Kemp; Mor Mia,9999,0,9999,0
1745828109945,CSS 201S,A01,892054,Mignozzetti; Umberto,30,0,30,0
1745828110975,CSS 202S,A01,892056,Mignozzetti; Umberto,30,0,30,0
1745828112002,DSC 197,001,956898,Eldridge; Justin Matthew,9998,0,9999,1
1745828113034,DSC 297,001,958000,Mazumdar; Arya,9998,0,9999,1
1745828114064,EAP 100,A00,905686,Staff,9776,0,9999,223
1745828115092,ECE 45,A01,892618,Staff,0,13,50,50
1745828116123,ECE 109,A01,892620,Staff,0,43,0,0
1745828117153,ECE 111,A01,892719,Staff,0,9,50,50
1745828118179,ECE 197,001,957920,Mercier; Patrick Philip,9992,0,9999,7
1745828119208,ECON 178,A01,907814,Zhu; Ying,28,0,35,7
1745828120236,EDS 115,A00,895312,Staff,41,0,45,4
1745828121263,EDS 117,A01,895337,Staff,30,0,30,0
1745828122290,EDS 125,A00,895341,Jones; Gabrielle Anastasia,43,0,45,2
1745828123323,EDS 128A,A01,895459,Fargason; Sharon Gayle,44,0,45,1
1745828124351,EDS 128B,A01,895543,Pappas; Elizabeth,44,0,45,1
1745828125378,EDS 139,A00,897203,Pappas; Elizabeth,44,0,45,1
1745828125378,EDS 139,B00,897209,Fargason; Sharon Gayle,44,0,45,1
1745828126407,EDS 201,A00,895545,Staff,43,0,45,2
1745828127438,EDS 203,A01,895581,Halter; Christopher P.,43,0,45,2
1745828128465,EDS 204R,A01,895625,Heinzman; Erica M.,43,0,45,2
1745828128465,EDS 204R,B01,895693,Halter; Christopher P.,18,0,45,27
1745828129493,EDS 206R,A00,895694,Fargason; Sharon Gayle,9,0,30,21
1745828129493,EDS 206R,B00,895695,Choi; Bailey Miyeon,20,0,30,10
1745828130520,EDS 250,A00,895697,Hemans; Patricia Ann Benitez,43,0,45,2
1745828131549,EDS 281,A00,895701,Meyerott; Theresa Ann,15,0,15,0
1745828132574,EDS 284,A00,895736,Meyerott; Theresa Ann,15,0,15,0
1745828133599,EDS 286,A00,897210,Fine; Sarah,15,0,15,0
1745828134627,EDS 289C,A01,895770,Daly; Alan J.,15,0,15,0
1745828135655,EDS 290,A00,897211,Hofstetter; Carolyn,15,0,15,0
1745828136690,LIGM 5A,A00,896162,Fischer-Grunski; Eva K,15,0,20,5
1745828137720,LIGM 5B,A00,896260,Fischer-Grunski; Eva K,17,0,20,3
1745828138762,LIGM 5C,A00,896308,Fischer-Grunski; Eva K,18,0,20,2
1745828139790,LIIT 5AS,A00,896313,Carnelos; Chiara,17,0,20,3
1745828140817,LIIT 5BS,A00,896416,Carnelos; Chiara,20,0,20,0
1745828141848,LIIT 5CS,A00,896564,Carnelos; Chiara,20,0,20,0
1745828142874,LISP 5A,A00,896588,Munoz Sanchez; Alicia,4,0,20,16
1745828143900,LISP 5B,A00,896653,Munoz Sanchez; Alicia,10,0,20,10
1745828144928,LISP 5C,A00,896655,Munoz Sanchez; Alicia,4,0,20,16
1745828145959,MAE 197,001,957918,Kleissl; Jan,9998,0,9999,1
1745828146987,MATH 2,A01,957937,Staff,34,0,35,1
1745828148013,MATH 197,001,957876,Kedlaya; Kiran S.,9993,0,9999,6
1745828149049,MCWP 40,A00,892729,Duru; Nur,13,0,20,7
1745828149049,MCWP 40,B00,893304,Montejo; Carolina,20,0,20,0
1745828150076,MCWP 40R,A00,893757,Redela; Pamela Morgan,0,7,20,20
1745828151104,MCWP 50,A00,893758,Morshed; Michael James,2,0,20,18
1745828151104,MCWP 50,B00,893761,Bartulis; Jason Michael,18,0,20,2
1745828152131,MCWP 50R,A00,893766,Compas; Sean Matthew,0,1,20,20
1745828152131,MCWP 50R,B00,893769,Carter; Jennifer A,0,0,20,20
1745828152131,MCWP 50R,C00,893771,Krone; Jarret,0,3,20,20
1745828152131,MCWP 50R,D00,893772,Miller; Elizabeth Deen,3,0,20,17
1745828152131,MCWP 50R,E00,893775,Carter; Andrea L,0,0,20,20
1745828153157,MMW 11R,A01,892721,Herbst; Matthew,11,0,27,16
1745828153157,MMW 11R,A02,892722,Herbst; Matthew,0,0,0,3
1745828154183,MMW 12R,A01,892724,Herbst; Matthew,0,10,16,16
1745828154183,MMW 12R,A02,892725,Herbst; Matthew,0,9,16,16
1745828155212,MMW 13R,A01,892727,Staff,0,3,16,16
1745828155212,MMW 13R,A02,892728,Staff,0,4,16,16
1745828155212,MMW 13R,A03,958032,Staff,0,3,16,16
1745828155212,MMW 13R,A04,958033,Staff,0,2,16,16
1745828155212,MMW 13R,A05,958034,Staff,0,3,16,16
1745828156242,SIO 295LS,A00,894015,Staff,7,0,25,18
1745828157271,SIO 295S,A00,894020,Staff,7,0,25,18
1745828158302,SIOC 290S,B01,958918,Staff,0,0,0,0
1745828159329,SIOC 291S,B01,958922,Staff,0,0,0,0
1745828160357,SOCI 117,A01,895339,Staff,4,0,5,1
1745828161385,WES 237B,A00,894149,Staff,11,0,20,9
1745828163458,AESE 279B,A00,891859,Staff,13,0,35,22
1745828164486,AIP 197,001,891854,Staff,70,0,70,0
1745828165514,ANTH 289S,A00,891856,Gagneux; Pascal,12,0,12,0
1745828166544,BENG 196,001,957946,Engler; Adam J.,9996,0,9999,3
1745828167575,CAT 124RS,A01,956906,Staff,8,0,25,17
1745828168605,CAT 125RS,A01,922013,Staff,8,0,25,17
1745828169632,CLRE 250,A00,891860,Morris; Sheldon,9995,0,9999,4
1745828171685,CLRE 251R,A00,907817,Mehta; Ravindra L.,9994,0,9999,5
1745828172719,CLRE 252,A00,891864,Cuomo; Raphael Eduardo,9993,0,9999,6
1745828173745,CLRE 253,A00,891867,Vaida; Florin,9994,0,9999,5
1745828173745,CLRE 253,B00,907819,Staff,9999,0,9999,0
1745828174777,CLRE 259,A00,891868,Patel; Hemal,9998,0,9999,1
1745828175807,CLRE 260,A00,891872,Cuomo; Raphael Eduardo,9999,0,9999,0
1745828176834,CLRE 297,001,891888,Cuomo; Raphael Eduardo,9999,0,9999,0
1745828177861,CSE 191,A00,958773,Minnes Kemp; Mor Mia,9999,0,9999,0
1745828178892,CSS 201S,A01,892054,Mignozzetti; Umberto,30,0,30,0
1745828179924,CSS 202S,A01,892056,Mignozzetti; Umberto,30,0,30,0
1745828180958,DSC 197,001,956898,Eldridge; Justin Matthew,9998,0,9999,1
1745828181989,DSC 297,001,958000,Mazumdar; Arya,9998,0,9999,1
1745828183015,EAP 100,A00,905686,Staff,9776,0,9999,223
1745828184045,ECE 45,A01,892618,Staff,0,13,50,50
1745828185076,ECE 109,A01,892620,Staff,0,43,0,0
1745828186102,ECE 111,A01,892719,Staff,0,9,50,50
1745828187186,ECE 197,001,957920,Mercier; Patrick Philip,9992,0,9999,7
1745828188213,ECON 178,A01,907814,Zhu; Ying,28,0,35,7
1745828189245,EDS 115,A00,895312,Staff,41,0,45,4
1745828190274,EDS 117,A01,895337,Staff,30,0,30,0
1745828191311,EDS 125,A00,895341,Jones; Gabrielle Anastasia,43,0,45,2
1745828192343,EDS 128A,A01,895459,Fargason; Sharon Gayle,44,0,45,1
1745828193369,EDS 128B,A01,895543,Pappas; Elizabeth,44,0,45,1
1745828194401,EDS 139,A00,897203,Pappas; Elizabeth,44,0,45,1
1745828194401,EDS 139,B00,897209,Fargason; Sharon Gayle,44,0,45,1
1745828195429,EDS 201,A00,895545,Staff,43,0,45,2
1745828196457,EDS 203,A01,895581,Halter; Christopher P.,43,0,45,2
1745828197484,EDS 204R,A01,895625,Heinzman; Erica M.,43,0,45,2
1745828197484,EDS 204R,B01,895693,Halter; Christopher P.,18,0,45,27
1745828198513,EDS 206R,A00,895694,Fargason; Sharon Gayle,9,0,30,21
1745828198513,EDS 206R,B00,895695,Choi; Bailey Miyeon,20,0,30,10
1745828199543,EDS 250,A00,895697,Hemans; Patricia Ann Benitez,43,0,45,2
1745828200573,EDS 281,A00,895701,Meyerott; Theresa Ann,15,0,15,0
1745828201601,EDS 284,A00,895736,Meyerott; Theresa Ann,15,0,15,0
1745828202628,EDS 286,A00,897210,Fine; Sarah,15,0,15,0
1745828203656,EDS 289C,A01,895770,Daly; Alan J.,15,0,15,0
1745828204683,EDS 290,A00,897211,Hofstetter; Carolyn,15,0,15,0
1745828205715,LIGM 5A,A00,896162,Fischer-Grunski; Eva K,15,0,20,5
1745828206743,LIGM 5B,A00,896260,Fischer-Grunski; Eva K,17,0,20,3
1745828207770,LIGM 5C,A00,896308,Fischer-Grunski; Eva K,18,0,20,2
1745828208798,LIIT 5AS,A00,896313,Carnelos; Chiara,17,0,20,3
1745828209830,LIIT 5BS,A00,896416,Carnelos; Chiara,20,0,20,0
1745828210856,LIIT 5CS,A00,896564,Carnelos; Chiara,20,0,20,0
1745828211886,LISP 5A,A00,896588,Munoz Sanchez; Alicia,4,0,20,16
1745828212917,LISP 5B,A00,896653,Munoz Sanchez; Alicia,10,0,20,10
1745828213948,LISP 5C,A00,896655,Munoz Sanchez; Alicia,4,0,20,16
1745828214974,MAE 197,001,957918,Kleissl; Jan,9998,0,9999,1
1745828215999,MATH 2,A01,957937,Staff,34,0,35,1
1745828217029,MATH 197,001,957876,Kedlaya; Kiran S.,9993,0,9999,6
1745828218059,MCWP 40,A00,892729,Duru; Nur,13,0,20,7
1745828218059,MCWP 40,B00,893304,Montejo; Carolina,20,0,20,0
1745828219093,MCWP 40R,A00,893757,Redela; Pamela Morgan,0,7,20,20
1745828220122,MCWP 50,A00,893758,Morshed; Michael James,2,0,20,18
1745828220122,MCWP 50,B00,893761,Bartulis; Jason Michael,18,0,20,2
1745828221151,MCWP 50R,A00,893766,Compas; Sean Matthew,0,1,20,20
1745828221151,MCWP 50R,B00,893769,Carter; Jennifer A,0,0,20,20
1745828221151,MCWP 50R,C00,893771,Krone; Jarret,0,3,20,20
1745828221151,MCWP 50R,D00,893772,Miller; Elizabeth Deen,3,0,20,17
1745828221151,MCWP 50R,E00,893775,Carter; Andrea L,0,0,20,20
1745828222192,MMW 11R,A01,892721,Herbst; Matthew,11,0,27,16
1745828222192,MMW 11R,A02,892722,Herbst; Matthew,0,0,0,3
1745828223220,MMW 12R,A01,892724,Herbst; Matthew,0,10,16,16
1745828223220,MMW 12R,A02,892725,Herbst; Matthew,0,9,16,16
1745828224248,MMW 13R,A01,892727,Staff,0,3,16,16
1745828224248,MMW 13R,A02,892728,Staff,0,4,16,16
1745828224248,MMW 13R,A03,958032,Staff,0,3,16,16
1745828224248,MMW 13R,A04,958033,Staff,0,2,16,16
1745828224248,MMW 13R,A05,958034,Staff,0,3,16,16
1745828225275,SIO 295LS,A00,894015,Staff,7,0,25,18
1745828226304,SIO 295S,A00,894020,Staff,7,0,25,18
1745828227337,SIOC 290S,B01,958918,Staff,0,0,0,0
1745828228368,SIOC 291S,B01,958922,Staff,0,0,0,0
1745828229394,SOCI 117,A01,895339,Staff,4,0,5,1
1745828230421,WES 237B,A00,894149,Staff,11,0,20,9
1745828232516,AESE 279B,A00,891859,Staff,13,0,35,22
1745828233542,AIP 197,001,891854,Staff,70,0,70,0
1745828234570,ANTH 289S,A00,891856,Gagneux; Pascal,12,0,12,0
1745828235601,BENG 196,001,957946,Engler; Adam J.,9996,0,9999,3
1745828236677,CAT 124RS,A01,956906,Staff,8,0,25,17
1745828237704,CAT 125RS,A01,922013,Staff,8,0,25,17
1745828238736,CLRE 250,A00,891860,Morris; Sheldon,9995,0,9999,4
1745828240789,CLRE 251R,A00,907817,Mehta; Ravindra L.,9994,0,9999,5
1745828241819,CLRE 252,A00,891864,Cuomo; Raphael Eduardo,9993,0,9999,6
1745828242851,CLRE 253,A00,891867,Vaida; Florin,9994,0,9999,5
1745828242851,CLRE 253,B00,907819,Staff,9999,0,9999,0
1745828243876,CLRE 259,A00,891868,Patel; Hemal,9998,0,9999,1
1745828244906,CLRE 260,A00,891872,Cuomo; Raphael Eduardo,9999,0,9999,0
1745828245933,CLRE 297,001,891888,Cuomo; Raphael Eduardo,9999,0,9999,0
1745828246963,CSE 191,A00,958773,Minnes Kemp; Mor Mia,9999,0,9999,0
1745828247991,CSS 201S,A01,892054,Mignozzetti; Umberto,30,0,30,0
1745828249018,CSS 202S,A01,892056,Mignozzetti; Umberto,30,0,30,0
1745828250046,DSC 197,001,956898,Eldridge; Justin Matthew,9998,0,9999,1
1745828251072,DSC 297,001,958000,Mazumdar; Arya,9998,0,9999,1
1745828252101,EAP 100,A00,905686,Staff,9776,0,9999,223
1745828253127,ECE 45,A01,892618,Staff,0,13,50,50
1745828254152,ECE 109,A01,892620,Staff,0,43,0,0
1745828255180,ECE 111,A01,892719,Staff,0,9,50,50
1745828256208,ECE 197,001,957920,Mercier; Patrick Philip,9992,0,9999,7
1745828257235,ECON 178,A01,907814,Zhu; Ying,28,0,35,7
1745828258262,EDS 115,A00,895312,Staff,41,0,45,4
1745828259288,EDS 117,A01,895337,Staff,30,0,30,0
1745828260319,EDS 125,A00,895341,Jones; Gabrielle Anastasia,43,0,45,2
1745828261347,EDS 128A,A01,895459,Fargason; Sharon Gayle,44,0,45,1
1745828262376,EDS 128B,A01,895543,Pappas; Elizabeth,44,0,45,1
1745828263403,EDS 139,A00,897203,Pappas; Elizabeth,44,0,45,1
1745828263403,EDS 139,B00,897209,Fargason; Sharon Gayle,44,0,45,1
1745828264434,EDS 201,A00,895545,Staff,43,0,45,2
1745828265465,EDS 203,A01,895581,Halter; Christopher P.,43,0,45,2
1745828266490,EDS 204R,A01,895625,Heinzman; Erica M.,43,0,45,2
1745828266490,EDS 204R,B01,895693,Halter; Christopher P.,18,0,45,27
1745828267522,EDS 206R,A00,895694,Fargason; Sharon Gayle,9,0,30,21
1745828267522,EDS 206R,B00,895695,Choi; Bailey Miyeon,20,0,30,10
1745828268551,EDS 250,A00,895697,Hemans; Patricia Ann Benitez,43,0,45,2
1745828269579,EDS 281,A00,895701,Meyerott; Theresa Ann,15,0,15,0
1745828270605,EDS 284,A00,895736,Meyerott; Theresa Ann,15,0,15,0
1745828271632,EDS 286,A00,897210,Fine; Sarah,15,0,15,0
1745828272662,EDS 289C,A01,895770,Daly; Alan J.,15,0,15,0
1745828273691,EDS 290,A00,897211,Hofstetter; Carolyn,15,0,15,0
1745828274718,LIGM 5A,A00,896162,Fischer-Grunski; Eva K,15,0,20,5
1745828275748,LIGM 5B,A00,896260,Fischer-Grunski; Eva K,17,0,20,3
1745828276778,LIGM 5C,A00,896308,Fischer-Grunski; Eva K,18,0,20,2
1745828277808,LIIT 5AS,A00,896313,Carnelos; Chiara,17,0,20,3
1745828278838,LIIT 5BS,A00,896416,Carnelos; Chiara,20,0,20,0
1745828279864,LIIT 5CS,A00,896564,Carnelos; Chiara,20,0,20,0
1745828280891,LISP 5A,A00,896588,Munoz Sanchez; Alicia,4,0,20,16
1745828281920,LISP 5B,A00,896653,Munoz Sanchez; Alicia,10,0,20,10
1745828282950,LISP 5C,A00,896655,Munoz Sanchez; Alicia,4,0,20,16
1745828283981,MAE 197,001,957918,Kleissl; Jan,9998,0,9999,1
1745828285018,MATH 2,A01,957937,Staff,34,0,35,1
1745828286045,MATH 197,001,957876,Kedlaya; Kiran S.,9993,0,9999,6
1745828287076,MCWP 40,A00,892729,Duru; Nur,13,0,20,7
1745828287076,MCWP 40,B00,893304,Montejo; Carolina,20,0,20,0
1745828288109,MCWP 40R,A00,893757,Redela; Pamela Morgan,0,7,20,20
1745828289138,MCWP 50,A00,893758,Morshed; Michael James,2,0,20,18
1745828289138,MCWP 50,B00,893761,Bartulis; Jason Michael,18,0,20,2
1745828290169,MCWP 50R,A00,893766,Compas; Sean Matthew,0,1,20,20
1745828290169,MCWP 50R,B00,893769,Carter; Jennifer A,0,0,20,20
1745828290169,MCWP 50R,C00,893771,Krone; Jarret,0,3,20,20
1745828290169,MCWP 50R,D00,893772,Miller; Elizabeth Deen,3,0,20,17
1745828290169,MCWP 50R,E00,893775,Carter; Andrea L,0,0,20,20
1745828291241,MMW 11R,A01,892721,Herbst; Matthew,11,0,27,16
1745828291241,MMW 11R,A02,892722,Herbst; Matthew,0,0,0,3
1745828292282,MMW 12R,A01,892724,Herbst; Matthew,0,10,16,16
1745828292282,MMW 12R,A02,892725,Herbst; Matthew,0,9,16,16
1745828293311,MMW 13R,A01,892727,Staff,0,3,16,16
1745828293311,MMW 13R,A02,892728,Staff,0,4,16,16
1745828293311,MMW 13R,A03,958032,Staff,0,3,16,16
1745828293311,MMW 13R,A04,958033,Staff,0,2,16,16
1745828293311,MMW 13R,A05,958034,Staff,0,3,16,16
1745828294338,SIO 295LS,A00,894015,Staff,7,0,25,18
1745828295363,SIO 295S,A00,894020,Staff,7,0,25,18
1745828296396,SIOC 290S,B01,958918,Staff,0,0,0,0
1745828297422,SIOC 291S,B01,958922,Staff,0,0,0,0
1745828298456,SOCI 117,A01,895339,Staff,4,0,5,1
1745828299482,WES 237B,A00,894149,Staff,11,0,20,9
1745828301562,AESE 279B,A00,891859,Staff,13,0,35,22
1745828302586,AIP 197,001,891854,Staff,70,0,70,0
1745828303613,ANTH 289S,A00,891856,Gagneux; Pascal,12,0,12,0
1745828304645,BENG 196,001,957946,Engler; Adam J.,9996,0,9999,3
1745828305674,CAT 124RS,A01,956906,Staff,8,0,25,17
1745828306703,CAT 125RS,A01,922013,Staff,8,0,25,17
1745828307730,CLRE 250,A00,891860,Morris; Sheldon,9995,0,9999,4
1745828309787,CLRE 251R,A00,907817,Mehta; Ravindra L.,9994,0,9999,5
1745828310814,CLRE 252,A00,891864,Cuomo; Raphael Eduardo,9993,0,9999,6
1745828311840,CLRE 253,A00,891867,Vaida; Florin,9994,0,9999,5
1745828311840,CLRE 253,B00,907819,Staff,9999,0,9999,0
1745828312868,CLRE 259,A00,891868,Patel; Hemal,9998,0,9999,1
1745828313895,CLRE 260,A00,891872,Cuomo; Raphael Eduardo,9999,0,9999,0
1745828314925,CLRE 297,001,891888,Cuomo; Raphael Eduardo,9999,0,9999,0
1745828315952,CSE 191,A00,958773,Minnes Kemp; Mor Mia,9999,0,9999,0
1745828316979,CSS 201S,A01,892054,Mignozzetti; Umberto,30,0,30,0
1745828318006,CSS 202S,A01,892056,Mignozzetti; Umberto,30,0,30,0
1745828319038,DSC 197,001,956898,Eldridge; Justin Matthew,9998,0,9999,1
1745828320065,DSC 297,001,958000,Mazumdar; Arya,9998,0,9999,1
1745828321090,EAP 100,A00,905686,Staff,9776,0,9999,223
1745828322120,ECE 45,A01,892618,Staff,0,13,50,50
1745828323147,ECE 109,A01,892620,Staff,0,43,0,0
1745828324173,ECE 111,A01,892719,Staff,0,9,50,50
1745828325200,ECE 197,001,957920,Mercier; Patrick Philip,9992,0,9999,7
1745828326230,ECON 178,A01,907814,Zhu; Ying,28,0,35,7
1745828327261,EDS 115,A00,895312,Staff,41,0,45,4
1745828328292,EDS 117,A01,895337,Staff,30,0,30,0
1745828329320,EDS 125,A00,895341,Jones; Gabrielle Anastasia,43,0,45,2
1745828330347,EDS 128A,A01,895459,Fargason; Sharon Gayle,44,0,45,1
1745828331380,EDS 128B,A01,895543,Pappas; Elizabeth,44,0,45,1
1745828332406,EDS 139,A00,897203,Pappas; Elizabeth,44,0,45,1
1745828332406,EDS 139,B00,897209,Fargason; Sharon Gayle,44,0,45,1
1745828333434,EDS 201,A00,895545,Staff,43,0,45,2
1745828334460,EDS 203,A01,895581,Halter; Christopher P.,43,0,45,2
1745828335493,EDS 204R,A01,895625,Heinzman; Erica M.,43,0,45,2
1745828335493,EDS 204R,B01,895693,Halter; Christopher P.,18,0,45,27
1745828336521,EDS 206R,A00,895694,Fargason; Sharon Gayle,9,0,30,21
1745828336521,EDS 206R,B00,895695,Choi; Bailey Miyeon,20,0,30,10
1745828337547,EDS 250,A00,895697,Hemans; Patricia Ann Benitez,43,0,45,2
1745828338571,EDS 281,A00,895701,Meyerott; Theresa Ann,15,0,15,0
1745828339598,EDS 284,A00,895736,Meyerott; Theresa Ann,15,0,15,0
1745828340625,EDS 286,A00,897210,Fine; Sarah,15,0,15,0
1745828341653,EDS 289C,A01,895770,Daly; Alan J.,15,0,15,0
1745828342683,EDS 290,A00,897211,Hofstetter; Carolyn,15,0,15,0
1745828343713,LIGM 5A,A00,896162,Fischer-Grunski; Eva K,15,0,20,5
1745828344748,LIGM 5B,A00,896260,Fischer-Grunski; Eva K,17,0,20,3
1745828345774,LIGM 5C,A00,896308,Fischer-Grunski; Eva K,18,0,20,2
1745828346801,LIIT 5AS,A00,896313,Carnelos; Chiara,17,0,20,3
1745828347829,LIIT 5BS,A00,896416,Carnelos; Chiara,20,0,20,0
1745828348858,LIIT 5CS,A00,896564,Carnelos; Chiara,20,0,20,0
1745828349890,LISP 5A,A00,896588,Munoz Sanchez; Alicia,4,0,20,16
1745828350918,LISP 5B,A00,896653,Munoz Sanchez; Alicia,10,0,20,10
1745828351951,LISP 5C,A00,896655,Munoz Sanchez; Alicia,4,0,20,16
1745828352976,MAE 197,001,957918,Kleissl; Jan,9998,0,9999,1
1745828354006,MATH 2,A01,957937,Staff,34,0,35,1
1745828355033,MATH 197,001,957876,Kedlaya; Kiran S.,9993,0,9999,6
1745828356067,MCWP 40,A00,892729,Duru; Nur,13,0,20,7
1745828356067,MCWP 40,B00,893304,Montejo; Carolina,20,0,20,0
1745828357094,MCWP 40R,A00,893757,Redela; Pamela Morgan,0,7,20,20
1745828358122,MCWP 50,A00,893758,Morshed; Michael James,2,0,20,18
1745828358122,MCWP 50,B00,893761,Bartulis; Jason Michael,18,0,20,2
1745828359155,MCWP 50R,A00,893766,Compas; Sean Matthew,0,1,20,20
1745828359155,MCWP 50R,B00,893769,Carter; Jennifer A,0,0,20,20
1745828359155,MCWP 50R,C00,893771,Krone; Jarret,0,3,20,20
1745828359155,MCWP 50R,D00,893772,Miller; Elizabeth Deen,3,0,20,17
1745828359155,MCWP 50R,E00,893775,Carter; Andrea L,0,0,20,20
1745828360183,MMW 11R,A01,892721,Herbst; Matthew,11,0,27,16
1745828360183,MMW 11R,A02,892722,Herbst; Matthew,0,0,0,3
1745828361210,MMW 12R,A01,892724,Herbst; Matthew,0,10,16,16
1745828361210,MMW 12R,A02,892725,Herbst; Matthew,0,9,16,16
1745828362237,MMW 13R,A01,892727,Staff,0,3,16,16
1745828362237,MMW 13R,A02,892728,Staff,0,4,16,16
1745828362237,MMW 13R,A03,958032,Staff,0,3,16,16
1745828362237,MMW 13R,A04,958033,Staff,0,2,16,16
1745828362237,MMW 13R,A05,958034,Staff,0,3,16,16
1745828363267,SIO 295LS,A00,894015,Staff,7,0,25,18
1745828364293,SIO 295S,A00,894020,Staff,7,0,25,18
1745828365326,SIOC 290S,B01,958918,Staff,0,0,0,0
1745828366352,SIOC 291S,B01,958922,Staff,0,0,0,0
1745828367385,SOCI 117,A01,895339,Staff,4,0,5,1
1745828368412,WES 237B,A00,894149,Staff,11,0,20,9
1745828370490,AESE 279B,A00,891859,Staff,13,0,35,22
1745828371519,AIP 197,001,891854,Staff,70,0,70,0
1745828372550,ANTH 289S,A00,891856,Gagneux; Pascal,12,0,12,0
1745828373580,BENG 196,001,957946,Engler; Adam J.,9996,0,9999,3
1745828374606,CAT 124RS,A01,956906,Staff,8,0,25,17
1745828375636,CAT 125RS,A01,922013,Staff,8,0,25,17
1745828376667,CLRE 250,A00,891860,Morris; Sheldon,9995,0,9999,4
1745828378726,CLRE 251R,A00,907817,Mehta; Ravindra L.,9994,0,9999,5
1745828379757,CLRE 252,A00,891864,Cuomo; Raphael Eduardo,9993,0,9999,6
1745828380783,CLRE 253,A00,891867,Vaida; Florin,9994,0,9999,5
1745828380783,CLRE 253,B00,907819,Staff,9999,0,9999,0
1745828381810,CLRE 259,A00,891868,Patel; Hemal,9998,0,9999,1
1745828382839,CLRE 260,A00,891872,Cuomo; Raphael Eduardo,9999,0,9999,0
1745828383866,CLRE 297,001,891888,Cuomo; Raphael Eduardo,9999,0,9999,0
1745828384894,CSE 191,A00,958773,Minnes Kemp; Mor Mia,9999,0,9999,0
1745828385923,CSS 201S,A01,892054,Mignozzetti; Umberto,30,0,30,0
1745828386951,CSS 202S,A01,892056,Mignozzetti; Umberto,30,0,30,0
1745828387979,DSC 197,001,956898,Eldridge; Justin Matthew,9998,0,9999,1
1745828389005,DSC 297,001,958000,Mazumdar; Arya,9998,0,9999,1
1745828390038,EAP 100,A00,905686,Staff,9776,0,9999,223
1745828391062,ECE 45,A01,892618,Staff,0,13,50,50
1745828392092,ECE 109,A01,892620,Staff,0,43,0,0
1745828393117,ECE 111,A01,892719,Staff,0,9,50,50
1745828394144,ECE 197,001,957920,Mercier; Patrick Philip,9992,0,9999,7
1745828395216,ECON 178,A01,907814,Zhu; Ying,28,0,35,7
1745828396244,EDS 115,A00,895312,Staff,41,0,45,4
1745828397271,EDS 117,A01,895337,Staff,30,0,30,0
1745828398303,EDS 125,A00,895341,Jones; Gabrielle Anastasia,43,0,45,2
1745828399331,EDS 128A,A01,895459,Fargason; Sharon Gayle,44,0,45,1
1745828400357,EDS 128B,A01,895543,Pappas; Elizabeth,44,0,45,1
1745828401395,EDS 139,A00,897203,Pappas; Elizabeth,44,0,45,1
1745828401395,EDS 139,B00,897209,Fargason; Sharon Gayle,44,0,45,1
1745828402429,EDS 201,A00,895545,Staff,43,0,45,2
1745828403456,EDS 203,A01,895581,Halter; Christopher P.,43,0,45,2
1745828404489,EDS 204R,A01,895625,Heinzman; Erica M.,43,0,45,2
1745828404489,EDS 204R,B01,895693,Halter; Christopher P.,18,0,45,27
1745828405519,EDS 206R,A00,895694,Fargason; Sharon Gayle,9,0,30,21
1745828405519,EDS 206R,B00,895695,Choi; Bailey Miyeon,20,0,30,10
1745828406552,EDS 250,A00,895697,Hemans; Patricia Ann Benitez,43,0,45,2
1745828407578,EDS 281,A00,895701,Meyerott; Theresa Ann,15,0,15,0
1745828408610,EDS 284,A00,895736,Meyerott; Theresa Ann,15,0,15,0
1745828409642,EDS 286,A00,897210,Fine; Sarah,15,0,15,0
1745828410669,EDS 289C,A01,895770,Daly; Alan J.,15,0,15,0
1745828411700,EDS 290,A00,897211,Hofstetter; Carolyn,15,0,15,0
1745828412730,LIGM 5A,A00,896162,Fischer-Grunski; Eva K,15,0,20,5
1745828413755,LIGM 5B,A00,896260,Fischer-Grunski; Eva K,17,0,20,3
1745828414782,LIGM 5C,A00,896308,Fischer-Grunski; Eva K,18,0,20,2
1745828415815,LIIT 5AS,A00,896313,Carnelos; Chiara,17,0,20,3
1745828416841,LIIT 5BS,A00,896416,Carnelos; Chiara,20,0,20,0
1745828417869,LIIT 5CS,A00,896564,Carnelos; Chiara,20,0,20,0
1745828418897,LISP 5A,A00,896588,Munoz Sanchez; Alicia,4,0,20,16
1745828419923,LISP 5B,A00,896653,Munoz Sanchez; Alicia,10,0,20,10
1745828420952,LISP 5C,A00,896655,Munoz Sanchez; Alicia,4,0,20,16
1745828421982,MAE 197,001,957918,Kleissl; Jan,9998,0,9999,1
1745828423011,MATH 2,A01,957937,Staff,34,0,35,1
1745828424037,MATH 197,001,957876,Kedlaya; Kiran S.,9993,0,9999,6
1745828425066,MCWP 40,A00,892729,Duru; Nur,13,0,20,7
1745828425066,MCWP 40,B00,893304,Montejo; Carolina,20,0,20,0
1745828426094,MCWP 40R,A00,893757,Redela; Pamela Morgan,0,7,20,20
1745828427123,MCWP 50,A00,893758,Morshed; Michael James,2,0,20,18
1745828427123,MCWP 50,B00,893761,Bartulis; Jason Michael,18,0,20,2
1745828428163,MCWP 50R,A00,893766,Compas; Sean Matthew,0,1,20,20
1745828428163,MCWP 50R,B00,893769,Carter; Jennifer A,0,0,20,20
1745828428163,MCWP 50R,C00,893771,Krone; Jarret,0,3,20,20
1745828428163,MCWP 50R,D00,893772,Miller; Elizabeth Deen,3,0,20,17
1745828428163,MCWP 50R,E00,893775,Carter; Andrea L,0,0,20,20
1745828429195,MMW 11R,A01,892721,Herbst; Matthew,11,0,27,16
1745828429195,MMW 11R,A02,892722,Herbst; Matthew,0,0,0,3
1745828430225,MMW 12R,A01,892724,Herbst; Matthew,0,10,16,16
1745828430225,MMW 12R,A02,892725,Herbst; Matthew,0,9,16,16
1745828431255,MMW 13R,A01,892727,Staff,0,3,16,16
1745828431255,MMW 13R,A02,892728,Staff,0,4,16,16
1745828431255,MMW 13R,A03,958032,Staff,0,3,16,16
1745828431255,MMW 13R,A04,958033,Staff,0,2,16,16
1745828431255,MMW 13R,A05,958034,Staff,0,3,16,16
1745828432281,SIO 295LS,A00,894015,Staff,7,0,25,18
1745828433306,SIO 295S,A00,894020,Staff,7,0,25,18
1745828434334,SIOC 290S,B01,958918,Staff,0,0,0,0
1745828435361,SIOC 291S,B01,958922,Staff,0,0,0,0
1745828436388,SOCI 117,A01,895339,Staff,4,0,5,1
1745828437412,WES 237B,A00,894149,Staff,11,0,20,9
1745828439507,AESE 279B,A00,891859,Staff,13,0,35,22
1745828440534,AIP 197,001,891854,Staff,70,0,70,0
1745828441561,ANTH 289S,A00,891856,Gagneux; Pascal,12,0,12,0
1745828442591,BENG 196,001,957946,Engler; Adam J.,9996,0,9999,3
1745828443617,CAT 124RS,A01,956906,Staff,8,0,25,17
1745828444643,CAT 125RS,A01,922013,Staff,8,0,25,17
1745828445672,CLRE 250,A00,891860,Morris; Sheldon,9995,0,9999,4
1745828447724,CLRE 251R,A00,907817,Mehta; Ravindra L.,9994,0,9999,5
1745828448751,CLRE 252,A00,891864,Cuomo; Raphael Eduardo,9993,0,9999,6
1745828449779,CLRE 253,A00,891867,Vaida; Florin,9994,0,9999,5
1745828449779,CLRE 253,B00,907819,Staff,9999,0,9999,0
1745828450810,CLRE 259,A00,891868,Patel; Hemal,9998,0,9999,1
1745828451836,CLRE 260,A00,891872,Cuomo; Raphael Eduardo,9999,0,9999,0
1745828452862,CLRE 297,001,891888,Cuomo; Raphael Eduardo,9999,0,9999,0
1745828453889,CSE 191,A00,958773,Minnes Kemp; Mor Mia,9999,0,9999,0
1745828454917,CSS 201S,A01,892054,Mignozzetti; Umberto,30,0,30,0
1745828455948,CSS 202S,A01,892056,Mignozzetti; Umberto,30,0,30,0
1745828456977,DSC 197,001,956898,Eldridge; Justin Matthew,9998,0,9999,1
1745828458005,DSC 297,001,958000,Mazumdar; Arya,9998,0,9999,1
1745828459032,EAP 100,A00,905686,Staff,9776,0,9999,223
1745828460062,ECE 45,A01,892618,Staff,0,13,50,50
1745828461088,ECE 109,A01,892620,Staff,0,43,0,0
1745828462115,ECE 111,A01,892719,Staff,0,9,50,50
1745828463147,ECE 197,001,957920,Mercier; Patrick Philip,9992,0,9999,7
1745828464186,ECON 178,A01,907814,Zhu; Ying,28,0,35,7
1745828465212,EDS 115,A00,895312,Staff,41,0,45,4
1745828466239,EDS 117,A01,895337,Staff,30,0,30,0
1745828467265,EDS 125,A00,895341,Jones; Gabrielle Anastasia,43,0,45,2
1745828468298,EDS 128A,A01,895459,Fargason; Sharon Gayle,44,0,45,1
1745828469327,EDS 128B,A01,895543,Pappas; Elizabeth,44,0,45,1
1745828470357,EDS 139,A00,897203,Pappas; Elizabeth,44,0,45,1
1745828470357,EDS 139,B00,897209,Fargason; Sharon Gayle,44,0,45,1
1745828471387,EDS 201,A00,895545,Staff,43,0,45,2
1745828472414,EDS 203,A01,895581,Halter; Christopher P.,43,0,45,2
1745828473441,EDS 204R,A01,895625,Heinzman; Erica M.,43,0,45,2
1745828473441,EDS 204R,B01,895693,Halter; Christopher P.,18,0,45,27
1745828474470,EDS 206R,A00,895694,Fargason; Sharon Gayle,9,0,30,21
1745828474470,EDS 206R,B00,895695,Choi; Bailey Miyeon,20,0,30,10
1745828475500,EDS 250,A00,895697,Hemans; Patricia Ann Benitez,43,0,45,2
1745828476528,EDS 281,A00,895701,Meyerott; Theresa Ann,15,0,15,0
1745828477552,EDS 284,A00,895736,Meyerott; Theresa Ann,15,0,15,0
1745828478584,EDS 286,A00,897210,Fine; Sarah,15,0,15,0
1745828479611,EDS 289C,A01,895770,Daly; Alan J.,15,0,15,0
1745828480637,EDS 290,A00,897211,Hofstetter; Carolyn,15,0,15,0
1745828481664,LIGM 5A,A00,896162,Fischer-Grunski; Eva K,15,0,20,5
1745828482691,LIGM 5B,A00,896260,Fischer-Grunski; Eva K,17,0,20,3
1745828483719,LIGM 5C,A00,896308,Fischer-Grunski; Eva K,18,0,20,2
1745828484747,LIIT 5AS,A00,896313,Carnelos; Chiara,17,0,20,3
1745828485775,LIIT 5BS,A00,896416,Carnelos; Chiara,20,0,20,0
1745828486808,LIIT 5CS,A00,896564,Carnelos; Chiara,20,0,20,0
1745828487835,LISP 5A,A00,896588,Munoz Sanchez; Alicia,4,0,20,16
1745828488864,LISP 5B,A00,896653,Munoz Sanchez; Alicia,10,0,20,10
1745828489894,LISP 5C,A00,896655,Munoz Sanchez; Alicia,4,0,20,16
1745828490925,MAE 197,001,957918,Kleissl; Jan,9998,0,9999,1
1745828491951,MATH 2,A01,957937,Staff,34,0,35,1
1745828492979,MATH 197,001,957876,Kedlaya; Kiran S.,9993,0,9999,6
1745828494007,MCWP 40,A00,892729,Duru; Nur,13,0,20,7
1745828494007,MCWP 40,B00,893304,Montejo; Carolina,20,0,20,0
1745828495035,MCWP 40R,A00,893757,Redela; Pamela Morgan,0,7,20,20
1745828496068,MCWP 50,A00,893758,Morshed; Michael James,2,0,20,18
1745828496068,MCWP 50,B00,893761,Bartulis; Jason Michael,18,0,20,2
1745828497102,MCWP 50R,A00,893766,Compas; Sean Matthew,0,1,20,20
1745828497102,MCWP 50R,B00,893769,Carter; Jennifer A,0,0,20,20
1745828497102,MCWP 50R,C00,893771,Krone; Jarret,0,3,20,20
1745828497102,MCWP 50R,D00,893772,Miller; Elizabeth Deen,3,0,20,17
1745828497102,MCWP 50R,E00,893775,Carter; Andrea L,0,0,20,20
1745828498135,MMW 11R,A01,892721,Herbst; Matthew,11,0,27,16
1745828498135,MMW 11R,A02,892722,Herbst; Matthew,0,0,0,3
1745828499204,MMW 12R,A01,892724,Herbst; Matthew,0,10,16,16
1745828499204,MMW 12R,A02,892725,Herbst; Matthew,0,9,16,16
1745828500234,MMW 13R,A01,892727,Staff,0,3,16,16
1745828500234,MMW 13R,A02,892728,Staff,0,4,16,16
1745828500234,MMW 13R,A03,958032,Staff,0,3,16,16
1745828500234,MMW 13R,A04,958033,Staff,0,2,16,16
1745828500234,MMW 13R,A05,958034,Staff,0,3,16,16
1745828501261,SIO 295LS,A00,894015,Staff,7,0,25,18
1745828502288,SIO 295S,A00,894020,Staff,7,0,25,18
1745828503314,SIOC 290S,B01,958918,Staff,0,0,0,0
1745828504344,SIOC 291S,B01,958922,Staff,0,0,0,0
1745828505371,SOCI 117,A01,895339,Staff,4,0,5,1
1745828506398,WES 237B,A00,894149,Staff,11,0,20,9
1745828508491,AESE 279B,A00,891859,Staff,13,0,35,22
1745828509518,AIP 197,001,891854,Staff,70,0,70,0
1745828510546,ANTH 289S,A00,891856,Gagneux; Pascal,12,0,12,0
1745828511573,BENG 196,001,957946,Engler; Adam J.,9996,0,9999,3
1745828512601,CAT 124RS,A01,956906,Staff,8,0,25,17
1745828513632,CAT 125RS,A01,922013,Staff,8,0,25,17
1745828514667,CLRE 250,A00,891860,Morris; Sheldon,9995,0,9999,4
1745828516730,CLRE 251R,A00,907817,Mehta; Ravindra L.,9994,0,9999,5
1745828517757,CLRE 252,A00,891864,Cuomo; Raphael Eduardo,9993,0,9999,6
1745828518783,CLRE 253,A00,891867,Vaida; Florin,9994,0,9999,5
1745828518783,CLRE 253,B00,907819,Staff,9999,0,9999,0
1745828519815,CLRE 259,A00,891868,Patel; Hemal,9998,0,9999,1
1745828520863,CLRE 260,A00,891872,Cuomo; Raphael Eduardo,9999,0,9999,0
1745828521890,CLRE 297,001,891888,Cuomo; Raphael Eduardo,9999,0,9999,0
1745828522921,CSE 191,A00,958773,Minnes Kemp; Mor Mia,9999,0,9999,0
1745828523955,CSS 201S,A01,892054,Mignozzetti; Umberto,30,0,30,0
1745828524981,CSS 202S,A01,892056,Mignozzetti; Umberto,30,0,30,0
1745828526010,DSC 197,001,956898,Eldridge; Justin Matthew,9998,0,9999,1
1745828527036,DSC 297,001,958000,Mazumdar; Arya,9998,0,9999,1
1745828528065,EAP 100,A00,905686,Staff,9776,0,9999,223
1745828529090,ECE 45,A01,892618,Staff,0,13,50,50
1745828530118,ECE 109,A01,892620,Staff,0,43,0,0
1745828531147,ECE 111,A01,892719,Staff,0,9,50,50
1745828532182,ECE 197,001,957920,Mercier; Patrick Philip,9992,0,9999,7
1745828533216,ECON 178,A01,907814,Zhu; Ying,28,0,35,7
1745828534243,EDS 115,A00,895312,Staff,41,0,45,4
1745828535273,EDS 117,A01,895337,Staff,30,0,30,0
1745828536303,EDS 125,A00,895341,Jones; Gabrielle Anastasia,43,0,45,2
1745828537334,EDS 128A,A01,895459,Fargason; Sharon Gayle,44,0,45,1
1745828538363,EDS 128B,A01,895543,Pappas; Elizabeth,44,0,45,1
1745828539390,EDS 139,A00,897203,Pappas; Elizabeth,44,0,45,1
1745828539390,EDS 139,B00,897209,Fargason; Sharon Gayle,44,0,45,1
1745828540420,EDS 201,A00,895545,Staff,43,0,45,2
1745828541448,EDS 203,A01,895581,Halter; Christopher P.,43,0,45,2
1745828542475,EDS 204R,A01,895625,Heinzman; Erica M.,43,0,45,2
1745828542475,EDS 204R,B01,895693,Halter; Christopher P.,18,0,45,27
1745828543502,EDS 206R,A00,895694,Fargason; Sharon Gayle,9,0,30,21
1745828543502,EDS 206R,B00,895695,Choi; Bailey Miyeon,20,0,30,10
1745828544528,EDS 250,A00,895697,Hemans; Patricia Ann Benitez,43,0,45,2
1745828545554,EDS 281,A00,895701,Meyerott; Theresa Ann,15,0,15,0
1745828546579,EDS 284,A00,895736,Meyerott; Theresa Ann,15,0,15,0
1745828547606,EDS 286,A00,897210,Fine; Sarah,15,0,15,0
1745828548637,EDS 289C,A01,895770,Daly; Alan J.,15,0,15,0
1745828549664,EDS 290,A00,897211,Hofstetter; Carolyn,15,0,15,0
1745828550699,LIGM 5A,A00,896162,Fischer-Grunski; Eva K,15,0,20,5
1745828551731,LIGM 5B,A00,896260,Fischer-Grunski; Eva K,17,0,20,3
1745828552757,LIGM 5C,A00,896308,Fischer-Grunski; Eva K,18,0,20,2
1745828553788,LIIT 5AS,A00,896313,Carnelos; Chiara,17,0,20,3
1745828554813,LIIT 5BS,A00,896416,Carnelos; Chiara,20,0,20,0
1745828555843,LIIT 5CS,A00,896564,Carnelos; Chiara,20,0,20,0
1745828556876,LISP 5A,A00,896588,Munoz Sanchez; Alicia,4,0,20,16
1745828557903,LISP 5B,A00,896653,Munoz Sanchez; Alicia,10,0,20,10
1745828558930,LISP 5C,A00,896655,Munoz Sanchez; Alicia,4,0,20,16
1745828559956,MAE 197,001,957918,Kleissl; Jan,9998,0,9999,1
1745828560983,MATH 2,A01,957937,Staff,34,0,35,1
1745828562010,MATH 197,001,957876,Kedlaya; Kiran S.,9993,0,9999,6
1745828563042,MCWP 40,A00,892729,Duru; Nur,13,0,20,7
1745828563042,MCWP 40,B00,893304,Montejo; Carolina,20,0,20,0
1745828564074,MCWP 40R,A00,893757,Redela; Pamela Morgan,0,7,20,20
1745828565103,MCWP 50,A00,893758,Morshed; Michael James,2,0,20,18
1745828565103,MCWP 50,B00,893761,Bartulis; Jason Michael,18,0,20,2
1745828566137,MCWP 50R,A00,893766,Compas; Sean Matthew,0,1,20,20
1745828566137,MCWP 50R,B00,893769,Carter; Jennifer A,0,0,20,20
1745828566137,MCWP 50R,C00,893771,Krone; Jarret,0,3,20,20
1745828566137,MCWP 50R,D00,893772,Miller; Elizabeth Deen,3,0,20,17
1745828566137,MCWP 50R,E00,893775,Carter; Andrea L,0,0,20,20
1745828567164,MMW 11R,A01,892721,Herbst; Matthew,11,0,27,16
1745828567164,MMW 11R,A02,892722,Herbst; Matthew,0,0,0,3
1745828568194,MMW 12R,A01,892724,Herbst; Matthew,0,10,16,16
1745828568194,MMW 12R,A02,892725,Herbst; Matthew,0,9,16,16
1745828569224,MMW 13R,A01,892727,Staff,0,3,16,16
1745828569224,MMW 13R,A02,892728,Staff,0,4,16,16
1745828569224,MMW 13R,A03,958032,Staff,0,3,16,16
1745828569224,MMW 13R,A04,958033,Staff,0,2,16,16
1745828569224,MMW 13R,A05,958034,Staff,0,3,16,16
1745828570254,SIO 295LS,A00,894015,Staff,7,0,25,18
1745828571280,SIO 295S,A00,894020,Staff,7,0,25,18
1745828572308,SIOC 290S,B01,958918,Staff,0,0,0,0
1745828573339,SIOC 291S,B01,958922,Staff,0,0,0,0
1745828574365,SOCI 117,A01,895339,Staff,4,0,5,1
1745828575392,WES 237B,A00,894149,Staff,11,0,20,9
1745828577467,AESE 279B,A00,891859,Staff,13,0,35,22
1745828578496,AIP 197,001,891854,Staff,70,0,70,0
1745828579524,ANTH 289S,A00,891856,Gagneux; Pascal,12,0,12,0
1745828580555,BENG 196,001,957946,Engler; Adam J.,9996,0,9999,3
1745828581581,CAT 124RS,A01,956906,Staff,8,0,25,17
1745828582611,CAT 125RS,A01,922013,Staff,8,0,25,17
1745828583643,CLRE 250,A00,891860,Morris; Sheldon,9995,0,9999,4
1745828585701,CLRE 251R,A00,907817,Mehta; Ravindra L.,9994,0,9999,5
1745828586728,CLRE 252,A00,891864,Cuomo; Raphael Eduardo,9993,0,9999,6
1745828587755,CLRE 253,A00,891867,Vaida; Florin,9994,0,9999,5
1745828587755,CLRE 253,B00,907819,Staff,9999,0,9999,0
1745828588782,CLRE 259,A00,891868,Patel; Hemal,9998,0,9999,1
1745828589809,CLRE 260,A00,891872,Cuomo; Raphael Eduardo,9999,0,9999,0
1745828590834,CLRE 297,001,891888,Cuomo; Raphael Eduardo,9999,0,9999,0
1745828591868,CSE 191,A00,958773,Minnes Kemp; Mor Mia,9999,0,9999,0
1745828592898,CSS 201S,A01,892054,Mignozzetti; Umberto,30,0,30,0
1745828593926,CSS 202S,A01,892056,Mignozzetti; Umberto,30,0,30,0
1745828594955,DSC 197,001,956898,Eldridge; Justin Matthew,9998,0,9999,1
1745828595984,DSC 297,001,958000,Mazumdar; Arya,9998,0,9999,1
1745828597011,EAP 100,A00,905686,Staff,9776,0,9999,223
1745828598037,ECE 45,A01,892618,Staff,0,13,50,50
1745828599062,ECE 109,A01,892620,Staff,0,43,0,0
1745828600092,ECE 111,A01,892719,Staff,0,9,50,50
1745828601119,ECE 197,001,957920,Mercier; Patrick Philip,9992,0,9999,7
1745828602148,ECON 178,A01,907814,Zhu; Ying,28,0,35,7
1745828603220,EDS 115,A00,895312,Staff,41,0,45,4
1745828604247,EDS 117,A01,895337,Staff,30,0,30,0
1745828605274,EDS 125,A00,895341,Jones; Gabrielle Anastasia,43,0,45,2
1745828606301,EDS 128A,A01,895459,Fargason; Sharon Gayle,44,0,45,1
1745828607328,EDS 128B,A01,895543,Pappas; Elizabeth,44,0,45,1
1745828608361,EDS 139,A00,897203,Pappas; Elizabeth,44,0,45,1
1745828608361,EDS 139,B00,897209,Fargason; Sharon Gayle,44,0,45,1
1745828609387,EDS 201,A00,895545,Staff,43,0,45,2
1745828610413,EDS 203,A01,895581,Halter; Christopher P.,43,0,45,2
1745828611441,EDS 204R,A01,895625,Heinzman; Erica M.,43,0,45,2
1745828611441,EDS 204R,B01,895693,Halter; Christopher P.,18,0,45,27
1745828612467,EDS 206R,A00,895694,Fargason; Sharon Gayle,9,0,30,21
1745828612467,EDS 206R,B00,895695,Choi; Bailey Miyeon,20,0,30,10
1745828613497,EDS 250,A00,895697,Hemans; Patricia Ann Benitez,43,0,45,2
1745828614525,EDS 281,A00,895701,Meyerott; Theresa Ann,15,0,15,0
1745828615554,EDS 284,A00,895736,Meyerott; Theresa Ann,15,0,15,0
1745828616579,EDS 286,A00,897210,Fine; Sarah,15,0,15,0
1745828617607,EDS 289C,A01,895770,Daly; Alan J.,15,0,15,0
1745828618633,EDS 290,A00,897211,Hofstetter; Carolyn,15,0,15,0
1745828619661,LIGM 5A,A00,896162,Fischer-Grunski; Eva K,15,0,20,5
1745828620689,LIGM 5B,A00,896260,Fischer-Grunski; Eva K,17,0,20,3
1745828621714,LIGM 5C,A00,896308,Fischer-Grunski; Eva K,18,0,20,2
1745828622742,LIIT 5AS,A00,896313,Carnelos; Chiara,17,0,20,3
1745828623770,LIIT 5BS,A00,896416,Carnelos; Chiara,20,0,20,0
1745828624798,LIIT 5CS,A00,896564,Carnelos; Chiara,20,0,20,0
1745828625826,LISP 5A,A00,896588,Munoz Sanchez; Alicia,4,0,20,16
1745828626853,LISP 5B,A00,896653,Munoz Sanchez; Alicia,10,0,20,10
1745828627879,LISP 5C,A00,896655,Munoz Sanchez; Alicia,4,0,20,16
1745828628909,MAE 197,001,957918,Kleissl; Jan,9998,0,9999,1
1745828629935,MATH 2,A01,957937,Staff,34,0,35,1
1745828630963,MATH 197,001,957876,Kedlaya; Kiran S.,9993,0,9999,6
1745828631996,MCWP 40,A00,892729,Duru; Nur,13,0,20,7
1745828631996,MCWP 40,B00,893304,Montejo; Carolina,20,0,20,0
1745828633029,MCWP 40R,A00,893757,Redela; Pamela Morgan,0,7,20,20
1745828634056,MCWP 50,A00,893758,Morshed; Michael James,2,0,20,18
1745828634056,MCWP 50,B00,893761,Bartulis; Jason Michael,18,0,20,2
1745828635125,MCWP 50R,A00,893766,Compas; Sean Matthew,0,1,20,20
1745828635125,MCWP 50R,B00,893769,Carter; Jennifer A,0,0,20,20
1745828635125,MCWP 50R,C00,893771,Krone; Jarret,0,3,20,20
1745828635125,MCWP 50R,D00,893772,Miller; Elizabeth Deen,3,0,20,17
1745828635125,MCWP 50R,E00,893775,Carter; Andrea L,0,0,20,20
1745828636151,MMW 11R,A01,892721,Herbst; Matthew,11,0,27,16
1745828636151,MMW 11R,A02,892722,Herbst; Matthew,0,0,0,3
1745828637181,MMW 12R,A01,892724,Herbst; Matthew,0,10,16,16
1745828637181,MMW 12R,A02,892725,Herbst; Matthew,0,9,16,16
1745828638211,MMW 13R,A01,892727,Staff,0,3,16,16
1745828638211,MMW 13R,A02,892728,Staff,0,4,16,16
1745828638211,MMW 13R,A03,958032,Staff,0,3,16,16
1745828638211,MMW 13R,A04,958033,Staff,0,2,16,16
1745828638211,MMW 13R,A05,958034,Staff,0,3,16,16
1745828639236,SIO 295LS,A00,894015,Staff,7,0,25,18
1745828640267,SIO 295S,A00,894020,Staff,7,0,25,18
1745828641301,SIOC 290S,B01,958918,Staff,0,0,0,0
1745828642330,SIOC 291S,B01,958922,Staff,0,0,0,0
1745828643362,SOCI 117,A01,895339,Staff,4,0,5,1
1745828644388,WES 237B,A00,894149,Staff,11,0,20,9
1745828646477,AESE 279B,A00,891859,Staff,13,0,35,22
1745828647501,AIP 197,001,891854,Staff,70,0,70,0
1745828648529,ANTH 289S,A00,891856,Gagneux; Pascal,12,0,12,0
1745828649557,BENG 196,001,957946,Engler; Adam J.,9996,0,9999,3
1745828650588,CAT 124RS,A01,956906,Staff,8,0,25,17
1745828651615,CAT 125RS,A01,922013,Staff,8,0,25,17
1745828652646,CLRE 250,A00,891860,Morris; Sheldon,9995,0,9999,4
1745828654698,CLRE 251R,A00,907817,Mehta; Ravindra L.,9994,0,9999,5
1745828655729,CLRE 252,A00,891864,Cuomo; Raphael Eduardo,9993,0,9999,6
1745828656762,CLRE 253,A00,891867,Vaida; Florin,9994,0,9999,5
1745828656762,CLRE 253,B00,907819,Staff,9999,0,9999,0
1745828657788,CLRE 259,A00,891868,Patel; Hemal,9998,0,9999,1
1745828658815,CLRE 260,A00,891872,Cuomo; Raphael Eduardo,9999,0,9999,0
1745828659842,CLRE 297,001,891888,Cuomo; Raphael Eduardo,9999,0,9999,0
1745828660869,CSE 191,A00,958773,Minnes Kemp; Mor Mia,9999,0,9999,0
1745828661896,CSS 201S,A01,892054,Mignozzetti; Umberto,30,0,30,0
1745828662930,CSS 202S,A01,892056,Mignozzetti; Umberto,30,0,30,0
1745828663958,DSC 197,001,956898,Eldridge; Justin Matthew,9998,0,9999,1
1745828664986,DSC 297,001,958000,Mazumdar; Arya,9998,0,9999,1
1745828666012,EAP 100,A00,905686,Staff,9776,0,9999,223
1745828667041,ECE 45,A01,892618,Staff,0,13,50,50
1745828668067,ECE 109,A01,892620,Staff,0,43,0,0
1745828669097,ECE 111,A01,892719,Staff,0,9,50,50
1745828670126,ECE 197,001,957920,Mercier; Patrick Philip,9992,0,9999,7
1745828671161,ECON 178,A01,907814,Zhu; Ying,28,0,35,7
1745828672189,EDS 115,A00,895312,Staff,41,0,45,4
1745828673218,EDS 117,A01,895337,Staff,30,0,30,0
1745828674250,EDS 125,A00,895341,Jones; Gabrielle Anastasia,43,0,45,2
1745828675278,EDS 128A,A01,895459,Fargason; Sharon Gayle,44,0,45,1
1745828676307,EDS 128B,A01,895543,Pappas; Elizabeth,44,0,45,1
1745828677333,EDS 139,A00,897203,Pappas; Elizabeth,44,0,45,1
1745828677333,EDS 139,B00,897209,Fargason; Sharon Gayle,44,0,45,1
1745828678358,EDS 201,A00,895545,Staff,43,0,45,2
1745828679388,EDS 203,A01,895581,Halter; Christopher P.,43,0,45,2
1745828680422,EDS 204R,A01,895625,Heinzman; Erica M.,43,0,45,2
1745828680422,EDS 204R,B01,895693,Halter; Christopher P.,18,0,45,27
1745828681449,EDS 206R,A00,895694,Fargason; Sharon Gayle,9,0,30,21
1745828681449,EDS 206R,B00,895695,Choi; Bailey Miyeon,20,0,30,10
1745828682477,EDS 250,A00,895697,Hemans; Patricia Ann Benitez,43,0,45,2
1745828683505,EDS 281,A00,895701,Meyerott; Theresa Ann,15,0,15,0
1745828684534,EDS 284,A00,895736,Meyerott; Theresa Ann,15,0,15,0
1745828685565,EDS 286,A00,897210,Fine; Sarah,15,0,15,0
1745828686591,EDS 289C,A01,895770,Daly; Alan J.,15,0,15,0
1745828687624,EDS 290,A00,897211,Hofstetter; Carolyn,15,0,15,0
1745828688658,LIGM 5A,A00,896162,Fischer-Grunski; Eva K,15,0,20,5
1745828689684,LIGM 5B,A00,896260,Fischer-Grunski; Eva K,17,0,20,3
1745828690714,LIGM 5C,A00,896308,Fischer-Grunski; Eva K,18,0,20,2
1745828691746,LIIT 5AS,A00,896313,Carnelos; Chiara,17,0,20,3
1745828692779,LIIT 5BS,A00,896416,Carnelos; Chiara,20,0,20,0
1745828693807,LIIT 5CS,A00,896564,Carnelos; Chiara,20,0,20,0
1745828694836,LISP 5A,A00,896588,Munoz Sanchez; Alicia,4,0,20,16
1745828695867,LISP 5B,A00,896653,Munoz Sanchez; Alicia,10,0,20,10
1745828696897,LISP 5C,A00,896655,Munoz Sanchez; Alicia,4,0,20,16
1745828697927,MAE 197,001,957918,Kleissl; Jan,9998,0,9999,1
1745828698952,MATH 2,A01,957937,Staff,34,0,35,1
1745828699984,MATH 197,001,957876,Kedlaya; Kiran S.,9993,0,9999,6
1745828701012,MCWP 40,A00,892729,Duru; Nur,13,0,20,7
1745828701012,MCWP 40,B00,893304,Montejo; Carolina,20,0,20,0
1745828702052,MCWP 40R,A00,893757,Redela; Pamela Morgan,0,7,20,20
1745828703080,MCWP 50,A00,893758,Morshed; Michael James,2,0,20,18
1745828703080,MCWP 50,B00,893761,Bartulis; Jason Michael,18,0,20,2
1745828704117,MCWP 50R,A00,893766,Compas; Sean Matthew,0,1,20,20
1745828704117,MCWP 50R,B00,893769,Carter; Jennifer A,0,0,20,20
1745828704117,MCWP 50R,C00,893771,Krone; Jarret,0,3,20,20
1745828704117,MCWP 50R,D00,893772,Miller; Elizabeth Deen,3,0,20,17
1745828704117,MCWP 50R,E00,893775,Carter; Andrea L,0,0,20,20
1745828705150,MMW 11R,A01,892721,Herbst; Matthew,11,0,27,16
1745828705150,MMW 11R,A02,892722,Herbst; Matthew,0,0,0,3
1745828706177,MMW 12R,A01,892724,Herbst; Matthew,0,10,16,16
1745828706177,MMW 12R,A02,892725,Herbst; Matthew,0,9,16,16
1745828707205,MMW 13R,A01,892727,Staff,0,3,16,16
1745828707205,MMW 13R,A02,892728,Staff,0,4,16,16
1745828707205,MMW 13R,A03,958032,Staff,0,3,16,16
1745828707205,MMW 13R,A04,958033,Staff,0,2,16,16
1745828707205,MMW 13R,A05,958034,Staff,0,3,16,16
1745828708233,SIO 295LS,A00,894015,Staff,7,0,25,18
1745828709259,SIO 295S,A00,894020,Staff,7,0,25,18
1745828710317,SIOC 290S,B01,958918,Staff,0,0,0,0
1745828711344,SIOC 291S,B01,958922,Staff,0,0,0,0
1745828712374,SOCI 117,A01,895339,Staff,4,0,5,1
1745828713402,WES 237B,A00,894149,Staff,11,0,20,9
1745828715535,AESE 279B,A00,891859,Staff,13,0,35,22
1745828716564,AIP 197,001,891854,Staff,70,0,70,0
1745828717589,ANTH 289S,A00,891856,Gagneux; Pascal,12,0,12,0
1745828718616,BENG 196,001,957946,Engler; Adam J.,9996,0,9999,3
1745828719642,CAT 124RS,A01,956906,Staff,8,0,25,17
1745828720670,CAT 125RS,A01,922013,Staff,8,0,25,17
1745828721701,CLRE 250,A00,891860,Morris; Sheldon,9995,0,9999,4
1745828723760,CLRE 251R,A00,907817,Mehta; Ravindra L.,9994,0,9999,5
1745828724790,CLRE 252,A00,891864,Cuomo; Raphael Eduardo,9993,0,9999,6
1745828725821,CLRE 253,A00,891867,Vaida; Florin,9994,0,9999,5
1745828725821,CLRE 253,B00,907819,Staff,9999,0,9999,0
1745828726847,CLRE 259,A00,891868,Patel; Hemal,9998,0,9999,1
1745828727876,CLRE 260,A00,891872,Cuomo; Raphael Eduardo,9999,0,9999,0
1745828728902,CLRE 297,001,891888,Cuomo; Raphael Eduardo,9999,0,9999,0
1745828729929,CSE 191,A00,958773,Minnes Kemp; Mor Mia,9999,0,9999,0
1745828730963,CSS 201S,A01,892054,Mignozzetti; Umberto,30,0,30,0
1745828731993,CSS 202S,A01,892056,Mignozzetti; Umberto,30,0,30,0
1745828733021,DSC 197,001,956898,Eldridge; Justin Matthew,9998,0,9999,1
1745828734048,DSC 297,001,958000,Mazumdar; Arya,9998,0,9999,1
1745828735078,EAP 100,A00,905686,Staff,9776,0,9999,223
1745828736107,ECE 45,A01,892618,Staff,0,13,50,50
1745828737133,ECE 109,A01,892620,Staff,0,43,0,0
1745828738160,ECE 111,A01,892719,Staff,0,9,50,50
1745828739188,ECE 197,001,957920,Mercier; Patrick Philip,9992,0,9999,7
1745828740223,ECON 178,A01,907814,Zhu; Ying,28,0,35,7
1745828741254,EDS 115,A00,895312,Staff,41,0,45,4
1745828742285,EDS 117,A01,895337,Staff,30,0,30,0
1745828743312,EDS 125,A00,895341,Jones; Gabrielle Anastasia,43,0,45,2
1745828744345,EDS 128A,A01,895459,Fargason; Sharon Gayle,44,0,45,1
1745828745374,EDS 128B,A01,895543,Pappas; Elizabeth,44,0,45,1
1745828746402,EDS 139,A00,897203,Pappas; Elizabeth,44,0,45,1
1745828746402,EDS 139,B00,897209,Fargason; Sharon Gayle,44,0,45,1
1745828747428,EDS 201,A00,895545,Staff,43,0,45,2
1745828748666,EDS 203,A01,895581,Halter; Christopher P.,43,0,45,2
1745828749711,EDS 204R,A01,895625,Heinzman; Erica M.,43,0,45,2
1745828749711,EDS 204R,B01,895693,Halter; Christopher P.,18,0,45,27
1745828750738,EDS 206R,A00,895694,Fargason; Sharon Gayle,9,0,30,21
1745828750738,EDS 206R,B00,895695,Choi; Bailey Miyeon,20,0,30,10
1745828751766,EDS 250,A00,895697,Hemans; Patricia Ann Benitez,43,0,45,2
1745828752791,EDS 281,A00,895701,Meyerott; Theresa Ann,15,0,15,0
1745828753817,EDS 284,A00,895736,Meyerott; Theresa Ann,15,0,15,0
1745828754845,EDS 286,A00,897210,Fine; Sarah,15,0,15,0
1745828755872,EDS 289C,A01,895770,Daly; Alan J.,15,0,15,0
1745828756899,EDS 290,A00,897211,Hofstetter; Carolyn,15,0,15,0
1745828757933,LIGM 5A,A00,896162,Fischer-Grunski; Eva K,15,0,20,5
1745828758964,LIGM 5B,A00,896260,Fischer-Grunski; Eva K,17,0,20,3
1745828759991,LIGM 5C,A00,896308,Fischer-Grunski; Eva K,18,0,20,2
1745828761021,LIIT 5AS,A00,896313,Carnelos; Chiara,17,0,20,3
1745828762052,LIIT 5BS,A00,896416,Carnelos; Chiara,20,0,20,0
1745828763084,LIIT 5CS,A00,896564,Carnelos; Chiara,20,0,20,0
1745828764113,LISP 5A,A00,896588,Munoz Sanchez; Alicia,4,0,20,16
1745828765146,LISP 5B,A00,896653,Munoz Sanchez; Alicia,10,0,20,10
1745828766173,LISP 5C,A00,896655,Munoz Sanchez; Alicia,4,0,20,16
1745828767201,MAE 197,001,957918,Kleissl; Jan,9998,0,9999,1
1745828768227,MATH 2,A01,957937,Staff,34,0,35,1
1745828769253,MATH 197,001,957876,Kedlaya; Kiran S.,9993,0,9999,6
1745828770283,MCWP 40,A00,892729,Duru; Nur,13,0,20,7
1745828770283,MCWP 40,B00,893304,Montejo; Carolina,20,0,20,0
1745828771316,MCWP 40R,A00,893757,Redela; Pamela Morgan,0,7,20,20
1745828772353,MCWP 50,A00,893758,Morshed; Michael James,2,0,20,18
1745828772353,MCWP 50,B00,893761,Bartulis; Jason Michael,18,0,20,2
1745828773382,MCWP 50R,A00,893766,Compas; Sean Matthew,0,1,20,20
1745828773382,MCWP 50R,B00,893769,Carter; Jennifer A,0,0,20,20
1745828773382,MCWP 50R,C00,893771,Krone; Jarret,0,3,20,20
1745828773382,MCWP 50R,D00,893772,Miller; Elizabeth Deen,3,0,20,17
1745828773382,MCWP 50R,E00,893775,Carter; Andrea L,0,0,20,20
1745828774409,MMW 11R,A01,892721,Herbst; Matthew,11,0,27,16
1745828774409,MMW 11R,A02,892722,Herbst; Matthew,0,0,0,3
1745828775440,MMW 12R,A01,892724,Herbst; Matthew,0,10,16,16
1745828775440,MMW 12R,A02,892725,Herbst; Matthew,0,9,16,16
1745828776465,MMW 13R,A01,892727,Staff,0,3,16,16
1745828776465,MMW 13R,A02,892728,Staff,0,4,16,16
1745828776465,MMW 13R,A03,958032,Staff,0,3,16,16
1745828776465,MMW 13R,A04,958033,Staff,0,2,16,16
1745828776465,MMW 13R,A05,958034,Staff,0,3,16,16
1745828777492,SIO 295LS,A00,894015,Staff,7,0,25,18
1745828778518,SIO 295S,A00,894020,Staff,7,0,25,18
1745828779545,SIOC 290S,B01,958918,Staff,0,0,0,0
1745828780572,SIOC 291S,B01,958922,Staff,0,0,0,0
1745828781599,SOCI 117,A01,895339,Staff,4,0,5,1
1745828782625,WES 237B,A00,894149,Staff,11,0,20,9
1745828784741,AESE 279B,A00,891859,Staff,13,0,35,22
1745828785770,AIP 197,001,891854,Staff,70,0,70,0
1745828786800,ANTH 289S,A00,891856,Gagneux; Pascal,12,0,12,0
1745828787832,BENG 196,001,957946,Engler; Adam J.,9996,0,9999,3
1745828788863,CAT 124RS,A01,956906,Staff,8,0,25,17
1745828789888,CAT 125RS,A01,922013,Staff,8,0,25,17
1745828790916,CLRE 250,A00,891860,Morris; Sheldon,9995,0,9999,4
1745828792969,CLRE 251R,A00,907817,Mehta; Ravindra L.,9994,0,9999,5
1745828793996,CLRE 252,A00,891864,Cuomo; Raphael Eduardo,9993,0,9999,6
1745828795029,CLRE 253,A00,891867,Vaida; Florin,9994,0,9999,5
1745828795029,CLRE 253,B00,907819,Staff,9999,0,9999,0
1745828796058,CLRE 259,A00,891868,Patel; Hemal,9998,0,9999,1
1745828797085,CLRE 260,A00,891872,Cuomo; Raphael Eduardo,9999,0,9999,0
1745828798115,CLRE 297,001,891888,Cuomo; Raphael Eduardo,9999,0,9999,0
1745828799147,CSE 191,A00,958773,Minnes Kemp; Mor Mia,9999,0,9999,0
1745828800176,CSS 201S,A01,892054,Mignozzetti; Umberto,30,0,30,0
1745828801209,CSS 202S,A01,892056,Mignozzetti; Umberto,30,0,30,0
1745828802237,DSC 197,001,956898,Eldridge; Justin Matthew,9998,0,9999,1
1745828803268,DSC 297,001,958000,Mazumdar; Arya,9998,0,9999,1
1745828804296,EAP 100,A00,905686,Staff,9776,0,9999,223
1745828805323,ECE 45,A01,892618,Staff,0,13,50,50
1745828806354,ECE 109,A01,892620,Staff,0,43,0,0
1745828807382,ECE 111,A01,892719,Staff,0,9,50,50
1745828808410,ECE 197,001,957920,Mercier; Patrick Philip,9992,0,9999,7
1745828809439,ECON 178,A01,907814,Zhu; Ying,28,0,35,7
1745828810465,EDS 115,A00,895312,Staff,41,0,45,4
1745828811491,EDS 117,A01,895337,Staff,30,0,30,0
1745828812524,EDS 125,A00,895341,Jones; Gabrielle Anastasia,43,0,45,2
1745828813605,EDS 128A,A01,895459,Fargason; Sharon Gayle,44,0,45,1
1745828814633,EDS 128B,A01,895543,Pappas; Elizabeth,44,0,45,1
1745828815662,EDS 139,A00,897203,Pappas; Elizabeth,44,0,45,1
1745828815662,EDS 139,B00,897209,Fargason; Sharon Gayle,44,0,45,1
1745828816689,EDS 201,A00,895545,Staff,43,0,45,2
1745828817722,EDS 203,A01,895581,Halter; Christopher P.,43,0,45,2
1745828818749,EDS 204R,A01,895625,Heinzman; Erica M.,43,0,45,2
1745828818749,EDS 204R,B01,895693,Halter; Christopher P.,18,0,45,27
1745828819782,EDS 206R,A00,895694,Fargason; Sharon Gayle,9,0,30,21
1745828819782,EDS 206R,B00,895695,Choi; Bailey Miyeon,20,0,30,10
1745828820809,EDS 250,A00,895697,Hemans; Patricia Ann Benitez,43,0,45,2
1745828821839,EDS 281,A00,895701,Meyerott; Theresa Ann,15,0,15,0
1745828822866,EDS 284,A00,895736,Meyerott; Theresa Ann,15,0,15,0
1745828823895,EDS 286,A00,897210,Fine; Sarah,15,0,15,0
1745828824929,EDS 289C,A01,895770,Daly; Alan J.,15,0,15,0
1745828825955,EDS 290,A00,897211,Hofstetter; Carolyn,15,0,15,0
1745828826987,LIGM 5A,A00,896162,Fischer-Grunski; Eva K,15,0,20,5
1745828828014,LIGM 5B,A00,896260,Fischer-Grunski; Eva K,17,0,20,3
1745828829041,LIGM 5C,A00,896308,Fischer-Grunski; Eva K,18,0,20,2
1745828830073,LIIT 5AS,A00,896313,Carnelos; Chiara,17,0,20,3
1745828831099,LIIT 5BS,A00,896416,Carnelos; Chiara,20,0,20,0
1745828832125,LIIT 5CS,A00,896564,Carnelos; Chiara,20,0,20,0
1745828833151,LISP 5A,A00,896588,Munoz Sanchez; Alicia,4,0,20,16
1745828834182,LISP 5B,A00,896653,Munoz Sanchez; Alicia,10,0,20,10
1745828835210,LISP 5C,A00,896655,Munoz Sanchez; Alicia,4,0,20,16
1745828836253,MAE 197,001,957918,Kleissl; Jan,9998,0,9999,1
1745828837279,MATH 2,A01,957937,Staff,34,0,35,1
1745828838308,MATH 197,001,957876,Kedlaya; Kiran S.,9993,0,9999,6
1745828839343,MCWP 40,A00,892729,Duru; Nur,13,0,20,7
1745828839343,MCWP 40,B00,893304,Montejo; Carolina,20,0,20,0
1745828840372,MCWP 40R,A00,893757,Redela; Pamela Morgan,0,7,20,20
1745828841404,MCWP 50,A00,893758,Morshed; Michael James,2,0,20,18
1745828841404,MCWP 50,B00,893761,Bartulis; Jason Michael,18,0,20,2
1745828842437,MCWP 50R,A00,893766,Compas; Sean Matthew,0,1,20,20
1745828842437,MCWP 50R,B00,893769,Carter; Jennifer A,0,0,20,20
1745828842437,MCWP 50R,C00,893771,Krone; Jarret,0,3,20,20
1745828842437,MCWP 50R,D00,893772,Miller; Elizabeth Deen,3,0,20,17
1745828842437,MCWP 50R,E00,893775,Carter; Andrea L,0,0,20,20
1745828843468,MMW 11R,A01,892721,Herbst; Matthew,11,0,27,16
1745828843468,MMW 11R,A02,892722,Herbst; Matthew,0,0,0,3
1745828844496,MMW 12R,A01,892724,Herbst; Matthew,0,10,16,16
1745828844496,MMW 12R,A02,892725,Herbst; Matthew,0,9,16,16
1745828845523,MMW 13R,A01,892727,Staff,0,3,16,16
1745828845523,MMW 13R,A02,892728,Staff,0,4,16,16
1745828845523,MMW 13R,A03,958032,Staff,0,3,16,16
1745828845523,MMW 13R,A04,958033,Staff,0,2,16,16
1745828845523,MMW 13R,A05,958034,Staff,0,3,16,16
1745828846550,SIO 295LS,A00,894015,Staff,7,0,25,18
1745828847577,SIO 295S,A00,894020,Staff,7,0,25,18
1745828848604,SIOC 290S,B01,958918,Staff,0,0,0,0
1745828849630,SIOC 291S,B01,958922,Staff,0,0,0,0
1745828850658,SOCI 117,A01,895339,Staff,4,0,5,1
1745828851682,WES 237B,A00,894149,Staff,11,0,20,9
1745828853771,AESE 279B,A00,891859,Staff,13,0,35,22
1745828854797,AIP 197,001,891854,Staff,70,0,70,0
1745828855822,ANTH 289S,A00,891856,Gagneux; Pascal,12,0,12,0
1745828856851,BENG 196,001,957946,Engler; Adam J.,9996,0,9999,3
1745828857877,CAT 124RS,A01,956906,Staff,8,0,25,17
1745828858905,CAT 125RS,A01,922013,Staff,8,0,25,17
1745828859936,CLRE 250,A00,891860,Morris; Sheldon,9995,0,9999,4
1745828861995,CLRE 251R,A00,907817,Mehta; Ravindra L.,9994,0,9999,5
1745828863023,CLRE 252,A00,891864,Cuomo; Raphael Eduardo,9993,0,9999,6
1745828864053,CLRE 253,A00,891867,Vaida; Florin,9994,0,9999,5
1745828864053,CLRE 253,B00,907819,Staff,9999,0,9999,0
1745828865082,CLRE 259,A00,891868,Patel; Hemal,9998,0,9999,1
1745828866108,CLRE 260,A00,891872,Cuomo; Raphael Eduardo,9999,0,9999,0
1745828867135,CLRE 297,001,891888,Cuomo; Raphael Eduardo,9999,0,9999,0
1745828868169,CSE 191,A00,958773,Minnes Kemp; Mor Mia,9999,0,9999,0
1745828869201,CSS 201S,A01,892054,Mignozzetti; Umberto,30,0,30,0
1745828870234,CSS 202S,A01,892056,Mignozzetti; Umberto,30,0,30,0
1745828871262,DSC 197,001,956898,Eldridge; Justin Matthew,9998,0,9999,1
1745828872287,DSC 297,001,958000,Mazumdar; Arya,9998,0,9999,1
1745828873313,EAP 100,A00,905686,Staff,9776,0,9999,223
1745828874340,ECE 45,A01,892618,Staff,0,13,50,50
1745828875368,ECE 109,A01,892620,Staff,0,43,0,0
1745828876395,ECE 111,A01,892719,Staff,0,9,50,50
1745828877423,ECE 197,001,957920,Mercier; Patrick Philip,9992,0,9999,7
1745828878450,ECON 178,A01,907814,Zhu; Ying,28,0,35,7
1745828879477,EDS 115,A00,895312,Staff,41,0,45,4
1745828880504,EDS 117,A01,895337,Staff,30,0,30,0
1745828881533,EDS 125,A00,895341,Jones; Gabrielle Anastasia,43,0,45,2
1745828882562,EDS 128A,A01,895459,Fargason; Sharon Gayle,44,0,45,1
1745828883591,EDS 128B,A01,895543,Pappas; Elizabeth,44,0,45,1
1745828884617,EDS 139,A00,897203,Pappas; Elizabeth,44,0,45,1
1745828884617,EDS 139,B00,897209,Fargason; Sharon Gayle,44,0,45,1
1745828885644,EDS 201,A00,895545,Staff,43,0,45,2
1745828886677,EDS 203,A01,895581,Halter; Christopher P.,43,0,45,2
1745828887704,EDS 204R,A01,895625,Heinzman; Erica M.,43,0,45,2
1745828887704,EDS 204R,B01,895693,Halter; Christopher P.,18,0,45,27
1745828888738,EDS 206R,A00,895694,Fargason; Sharon Gayle,9,0,30,21
1745828888738,EDS 206R,B00,895695,Choi; Bailey Miyeon,20,0,30,10
1745828889767,EDS 250,A00,895697,Hemans; Patricia Ann Benitez,43,0,45,2
1745828890798,EDS 281,A00,895701,Meyerott; Theresa Ann,15,0,15,0
1745828891828,EDS 284,A00,895736,Meyerott; Theresa Ann,15,0,15,0
1745828892855,EDS 286,A00,897210,Fine; Sarah,15,0,15,0
1745828893886,EDS 289C,A01,895770,Daly; Alan J.,15,0,15,0
1745828894914,EDS 290,A00,897211,Hofstetter; Carolyn,15,0,15,0
1745828895942,LIGM 5A,A00,896162,Fischer-Grunski; Eva K,15,0,20,5
1745828896975,LIGM 5B,A00,896260,Fischer-Grunski; Eva K,17,0,20,3
1745828898005,LIGM 5C,A00,896308,Fischer-Grunski; Eva K,18,0,20,2
1745828899032,LIIT 5AS,A00,896313,Carnelos; Chiara,17,0,20,3
1745828900063,LIIT 5BS,A00,896416,Carnelos; Chiara,20,0,20,0
1745828901088,LIIT 5CS,A00,896564,Carnelos; Chiara,20,0,20,0
1745828902116,LISP 5A,A00,896588,Munoz Sanchez; Alicia,4,0,20,16
1745828903147,LISP 5B,A00,896653,Munoz Sanchez; Alicia,10,0,20,10
1745828904173,LISP 5C,A00,896655,Munoz Sanchez; Alicia,4,0,20,16
1745828905200,MAE 197,001,957918,Kleissl; Jan,9998,0,9999,1
1745828906228,MATH 2,A01,957937,Staff,34,0,35,1
1745828907258,MATH 197,001,957876,Kedlaya; Kiran S.,9993,0,9999,6
1745828908295,MCWP 40,A00,892729,Duru; Nur,13,0,20,7
1745828908295,MCWP 40,B00,893304,Montejo; Carolina,20,0,20,0
1745828909323,MCWP 40R,A00,893757,Redela; Pamela Morgan,0,7,20,20
1745828910356,MCWP 50,A00,893758,Morshed; Michael James,2,0,20,18
1745828910356,MCWP 50,B00,893761,Bartulis; Jason Michael,18,0,20,2
1745828911386,MCWP 50R,A00,893766,Compas; Sean Matthew,0,1,20,20
1745828911386,MCWP 50R,B00,893769,Carter; Jennifer A,0,0,20,20
1745828911386,MCWP 50R,C00,893771,Krone; Jarret,0,3,20,20
1745828911386,MCWP 50R,D00,893772,Miller; Elizabeth Deen,3,0,20,17
1745828911386,MCWP 50R,E00,893775,Carter; Andrea L,0,0,20,20
1745828912417,MMW 11R,A01,892721,Herbst; Matthew,11,0,27,16
1745828912417,MMW 11R,A02,892722,Herbst; Matthew,0,0,0,3
1745828913444,MMW 12R,A01,892724,Herbst; Matthew,0,10,16,16
1745828913444,MMW 12R,A02,892725,Herbst; Matthew,0,9,16,16
1745828914471,MMW 13R,A01,892727,Staff,0,3,16,16
1745828914471,MMW 13R,A02,892728,Staff,0,4,16,16
1745828914471,MMW 13R,A03,958032,Staff,0,3,16,16
1745828914471,MMW 13R,A04,958033,Staff,0,2,16,16
1745828914471,MMW 13R,A05,958034,Staff,0,3,16,16
1745828915498,SIO 295LS,A00,894015,Staff,7,0,25,18
1745828916528,SIO 295S,A00,894020,Staff,7,0,25,18
1745828917554,SIOC 290S,B01,958918,Staff,0,0,0,0
1745828918582,SIOC 291S,B01,958922,Staff,0,0,0,0
1745828919614,SOCI 117,A01,895339,Staff,4,0,5,1
1745828920641,WES 237B,A00,894149,Staff,11,0,20,9
1745828922763,AESE 279B,A00,891859,Staff,13,0,35,22
1745828923789,AIP 197,001,891854,Staff,70,0,70,0
1745828924818,ANTH 289S,A00,891856,Gagneux; Pascal,12,0,12,0
1745828925845,BENG 196,001,957946,Engler; Adam J.,9996,0,9999,3
1745828926872,CAT 124RS,A01,956906,Staff,8,0,25,17
1745828927899,CAT 125RS,A01,922013,Staff,8,0,25,17
1745828928926,CLRE 250,A00,891860,Morris; Sheldon,9995,0,9999,4
1745828930984,CLRE 251R,A00,907817,Mehta; Ravindra L.,9994,0,9999,5
1745828932012,CLRE 252,A00,891864,Cuomo; Raphael Eduardo,9993,0,9999,6
1745828933040,CLRE 253,A00,891867,Vaida; Florin,9994,0,9999,5
1745828933040,CLRE 253,B00,907819,Staff,9999,0,9999,0
1745828934072,CLRE 259,A00,891868,Patel; Hemal,9998,0,9999,1
1745828935100,CLRE 260,A00,891872,Cuomo; Raphael Eduardo,9999,0,9999,0
1745828936127,CLRE 297,001,891888,Cuomo; Raphael Eduardo,9999,0,9999,0
1745828937153,CSE 191,A00,958773,Minnes Kemp; Mor Mia,9999,0,9999,0
1745828938183,CSS 201S,A01,892054,Mignozzetti; Umberto,30,0,30,0
1745828939215,CSS 202S,A01,892056,Mignozzetti; Umberto,30,0,30,0
1745828940246,DSC 197,001,956898,Eldridge; Justin Matthew,9998,0,9999,1
1745828941272,DSC 297,001,958000,Mazumdar; Arya,9998,0,9999,1
1745828942358,EAP 100,A00,905686,Staff,9776,0,9999,223
1745828943386,ECE 45,A01,892618,Staff,0,13,50,50
1745828944415,ECE 109,A01,892620,Staff,0,43,0,0
1745828945445,ECE 111,A01,892719,Staff,0,9,50,50
1745828946479,ECE 197,001,957920,Mercier; Patrick Philip,9992,0,9999,7
1745828947511,ECON 178,A01,907814,Zhu; Ying,28,0,35,7
1745828948540,EDS 115,A00,895312,Staff,41,0,45,4
1745828949568,EDS 117,A01,895337,Staff,30,0,30,0
1745828950600,EDS 125,A00,895341,Jones; Gabrielle Anastasia,43,0,45,2
1745828951626,EDS 128A,A01,895459,Fargason; Sharon Gayle,44,0,45,1
1745828952653,EDS 128B,A01,895543,Pappas; Elizabeth,44,0,45,1
1745828953681,EDS 139,A00,897203,Pappas; Elizabeth,44,0,45,1
1745828953681,EDS 139,B00,897209,Fargason; Sharon Gayle,44,0,45,1
1745828954710,EDS 201,A00,895545,Staff,43,0,45,2
1745828955737,EDS 203,A01,895581,Halter; Christopher P.,43,0,45,2
1745828956765,EDS 204R,A01,895625,Heinzman; Erica M.,43,0,45,2
1745828956765,EDS 204R,B01,895693,Halter; Christopher P.,18,0,45,27
1745828957793,EDS 206R,A00,895694,Fargason; Sharon Gayle,9,0,30,21
1745828957793,EDS 206R,B00,895695,Choi; Bailey Miyeon,20,0,30,10
1745828958825,EDS 250,A00,895697,Hemans; Patricia Ann Benitez,43,0,45,2
1745828959853,EDS 281,A00,895701,Meyerott; Theresa Ann,15,0,15,0
1745828960884,EDS 284,A00,895736,Meyerott; Theresa Ann,15,0,15,0
1745828961918,EDS 286,A00,897210,Fine; Sarah,15,0,15,0
1745828962948,EDS 289C,A01,895770,Daly; Alan J.,15,0,15,0
1745828963977,EDS 290,A00,897211,Hofstetter; Carolyn,15,0,15,0
1745828965017,LIGM 5A,A00,896162,Fischer-Grunski; Eva K,15,0,20,5
1745828966050,LIGM 5B,A00,896260,Fischer-Grunski; Eva K,17,0,20,3
1745828967079,LIGM 5C,A00,896308,Fischer-Grunski; Eva K,18,0,20,2
1745828968118,LIIT 5AS,A00,896313,Carnelos; Chiara,17,0,20,3
1745828969147,LIIT 5BS,A00,896416,Carnelos; Chiara,20,0,20,0
1745828970179,LIIT 5CS,A00,896564,Carnelos; Chiara,20,0,20,0
1745828971205,LISP 5A,A00,896588,Munoz Sanchez; Alicia,4,0,20,16
1745828972234,LISP 5B,A00,896653,Munoz Sanchez; Alicia,10,0,20,10
1745828973263,LISP 5C,A00,896655,Munoz Sanchez; Alicia,4,0,20,16
1745828974294,MAE 197,001,957918,Kleissl; Jan,9998,0,9999,1
1745828975326,MATH 2,A01,957937,Staff,34,0,35,1
1745828976359,MATH 197,001,957876,Kedlaya; Kiran S.,9993,0,9999,6
1745828977393,MCWP 40,A00,892729,Duru; Nur,13,0,20,7
1745828977393,MCWP 40,B00,893304,Montejo; Carolina,20,0,20,0
1745828978424,MCWP 40R,A00,893757,Redela; Pamela Morgan,0,7,20,20
1745828979458,MCWP 50,A00,893758,Morshed; Michael James,2,0,20,18
1745828979458,MCWP 50,B00,893761,Bartulis; Jason Michael,18,0,20,2
1745828980484,MCWP 50R,A00,893766,Compas; Sean Matthew,0,1,20,20
1745828980484,MCWP 50R,B00,893769,Carter; Jennifer A,0,0,20,20
1745828980484,MCWP 50R,C00,893771,Krone; Jarret,0,3,20,20
1745828980484,MCWP 50R,D00,893772,Miller; Elizabeth Deen,3,0,20,17
1745828980484,MCWP 50R,E00,893775,Carter; Andrea L,0,0,20,20
1745828981515,MMW 11R,A01,892721,Herbst; Matthew,11,0,27,16
1745828981515,MMW 11R,A02,892722,Herbst; Matthew,0,0,0,3
1745828982547,MMW 12R,A01,892724,Herbst; Matthew,0,10,16,16
1745828982547,MMW 12R,A02,892725,Herbst; Matthew,0,9,16,16
1745828983576,MMW 13R,A01,892727,Staff,0,3,16,16
1745828983576,MMW 13R,A02,892728,Staff,0,4,16,16
1745828983576,MMW 13R,A03,958032,Staff,0,3,16,16
1745828983576,MMW 13R,A04,958033,Staff,0,2,16,16
1745828983576,MMW 13R,A05,958034,Staff,0,3,16,16
1745828984607,SIO 295LS,A00,894015,Staff,7,0,25,18
1745828985634,SIO 295S,A00,894020,Staff,7,0,25,18
1745828986663,SIOC 290S,B01,958918,Staff,0,0,0,0
1745828987693,SIOC 291S,B01,958922,Staff,0,0,0,0
1745828988720,SOCI 117,A01,895339,Staff,4,0,5,1
1745828989748,WES 237B,A00,894149,Staff,11,0,20,9
1745828991856,AESE 279B,A00,891859,Staff,13,0,35,22
1745828992887,AIP 197,001,891854,Staff,70,0,70,0
1745828993914,ANTH 289S,A00,891856,Gagneux; Pascal,12,0,12,0
1745828994942,BENG 196,001,957946,Engler; Adam J.,9996,0,9999,3
1745828995968,CAT 124RS,A01,956906,Staff,8,0,25,17
1745828997000,CAT 125RS,A01,922013,Staff,8,0,25,17
1745828998028,CLRE 250,A00,891860,Morris; Sheldon,9995,0,9999,4
1745829000089,CLRE 251R,A00,907817,Mehta; Ravindra L.,9994,0,9999,5
1745829001122,CLRE 252,A00,891864,Cuomo; Raphael Eduardo,9993,0,9999,6
1745829002150,CLRE 253,A00,891867,Vaida; Florin,9994,0,9999,5
1745829002150,CLRE 253,B00,907819,Staff,9999,0,9999,0
1745829003180,CLRE 259,A00,891868,Patel; Hemal,9998,0,9999,1
1745829004208,CLRE 260,A00,891872,Cuomo; Raphael Eduardo,9999,0,9999,0
1745829005236,CLRE 297,001,891888,Cuomo; Raphael Eduardo,9999,0,9999,0
1745829006267,CSE 191,A00,958773,Minnes Kemp; Mor Mia,9999,0,9999,0
1745829007297,CSS 201S,A01,892054,Mignozzetti; Umberto,30,0,30,0
1745829008328,CSS 202S,A01,892056,Mignozzetti; Umberto,30,0,30,0
1745829009357,DSC 197,001,956898,Eldridge; Justin Matthew,9998,0,9999,1
1745829010384,DSC 297,001,958000,Mazumdar; Arya,9998,0,9999,1
1745829011413,EAP 100,A00,905686,Staff,9776,0,9999,223
1745829012444,ECE 45,A01,892618,Staff,0,13,50,50
1745829013472,ECE 109,A01,892620,Staff,0,43,0,0
1745829014499,ECE 111,A01,892719,Staff,0,9,50,50
1745829015526,ECE 197,001,957920,Mercier; Patrick Philip,9992,0,9999,7
1745829016553,ECON 178,A01,907814,Zhu; Ying,28,0,35,7
1745829017583,EDS 115,A00,895312,Staff,41,0,45,4
1745829018616,EDS 117,A01,895337,Staff,30,0,30,0
1745829019643,EDS 125,A00,895341,Jones; Gabrielle Anastasia,43,0,45,2
1745829020671,EDS 128A,A01,895459,Fargason; Sharon Gayle,44,0,45,1
1745829021703,EDS 128B,A01,895543,Pappas; Elizabeth,44,0,45,1
1745829022729,EDS 139,A00,897203,Pappas; Elizabeth,44,0,45,1
1745829022729,EDS 139,B00,897209,Fargason; Sharon Gayle,44,0,45,1
1745829023757,EDS 201,A00,895545,Staff,43,0,45,2
1745829024785,EDS 203,A01,895581,Halter; Christopher P.,43,0,45,2
1745829025811,EDS 204R,A01,895625,Heinzman; Erica M.,43,0,45,2
1745829025811,EDS 204R,B01,895693,Halter; Christopher P.,18,0,45,27
1745829026837,EDS 206R,A00,895694,Fargason; Sharon Gayle,9,0,30,21
1745829026837,EDS 206R,B00,895695,Choi; Bailey Miyeon,20,0,30,10
1745829027869,EDS 250,A00,895697,Hemans; Patricia Ann Benitez,43,0,45,2
1745829028900,EDS 281,A00,895701,Meyerott; Theresa Ann,15,0,15,0
1745829029925,EDS 284,A00,895736,Meyerott; Theresa Ann,15,0,15,0
1745829030952,EDS 286,A00,897210,Fine; Sarah,15,0,15,0
1745829031980,EDS 289C,A01,895770,Daly; Alan J.,15,0,15,0
1745829033005,EDS 290,A00,897211,Hofstetter; Carolyn,15,0,15,0
1745829034035,LIGM 5A,A00,896162,Fischer-Grunski; Eva K,15,0,20,5
1745829035062,LIGM 5B,A00,896260,Fischer-Grunski; Eva K,17,0,20,3
1745829036089,LIGM 5C,A00,896308,Fischer-Grunski; Eva K,18,0,20,2
1745829037116,LIIT 5AS,A00,896313,Carnelos; Chiara,17,0,20,3
1745829038143,LIIT 5BS,A00,896416,Carnelos; Chiara,20,0,20,0
1745829039173,LIIT 5CS,A00,896564,Carnelos; Chiara,20,0,20,0
1745829040204,LISP 5A,A00,896588,Munoz Sanchez; Alicia,4,0,20,16
1745829041230,LISP 5B,A00,896653,Munoz Sanchez; Alicia,10,0,20,10
1745829042261,LISP 5C,A00,896655,Munoz Sanchez; Alicia,4,0,20,16
1745829043289,MAE 197,001,957918,Kleissl; Jan,9998,0,9999,1
1745829044318,MATH 2,A01,957937,Staff,34,0,35,1
1745829045348,MATH 197,001,957876,Kedlaya; Kiran S.,9993,0,9999,6
1745829046383,MCWP 40,A00,892729,Duru; Nur,13,0,20,7
1745829046383,MCWP 40,B00,893304,Montejo; Carolina,20,0,20,0
1745829047410,MCWP 40R,A00,893757,Redela; Pamela Morgan,0,7,20,20
1745829048441,MCWP 50,A00,893758,Morshed; Michael James,2,0,20,18
1745829048441,MCWP 50,B00,893761,Bartulis; Jason Michael,18,0,20,2
1745829049468,MCWP 50R,A00,893766,Compas; Sean Matthew,0,1,20,20
1745829049468,MCWP 50R,B00,893769,Carter; Jennifer A,0,0,20,20
1745829049468,MCWP 50R,C00,893771,Krone; Jarret,0,3,20,20
1745829049468,MCWP 50R,D00,893772,Miller; Elizabeth Deen,3,0,20,17
1745829049468,MCWP 50R,E00,893775,Carter; Andrea L,0,0,20,20
1745829050496,MMW 11R,A01,892721,Herbst; Matthew,11,0,27,16
1745829050496,MMW 11R,A02,892722,Herbst; Matthew,0,0,0,3
1745829051522,MMW 12R,A01,892724,Herbst; Matthew,0,10,16,16
1745829051522,MMW 12R,A02,892725,Herbst; Matthew,0,9,16,16
1745829052548,MMW 13R,A01,892727,Staff,0,3,16,16
1745829052548,MMW 13R,A02,892728,Staff,0,4,16,16
1745829052548,MMW 13R,A03,958032,Staff,0,3,16,16
1745829052548,MMW 13R,A04,958033,Staff,0,2,16,16
1745829052548,MMW 13R,A05,958034,Staff,0,3,16,16
1745829053574,SIO 295LS,A00,894015,Staff,7,0,25,18
1745829054600,SIO 295S,A00,894020,Staff,7,0,25,18
1745829055634,SIOC 290S,B01,958918,Staff,0,0,0,0
1745829056663,SIOC 291S,B01,958922,Staff,0,0,0,0
1745829057694,SOCI 117,A01,895339,Staff,4,0,5,1
1745829058721,WES 237B,A00,894149,Staff,11,0,20,9
1745829060811,AESE 279B,A00,891859,Staff,13,0,35,22
1745829061838,AIP 197,001,891854,Staff,70,0,70,0
1745829062869,ANTH 289S,A00,891856,Gagneux; Pascal,12,0,12,0
1745829063899,BENG 196,001,957946,Engler; Adam J.,9996,0,9999,3
1745829064926,CAT 124RS,A01,956906,Staff,8,0,25,17
1745829065956,CAT 125RS,A01,922013,Staff,8,0,25,17
1745829066985,CLRE 250,A00,891860,Morris; Sheldon,9995,0,9999,4
1745829069046,CLRE 251R,A00,907817,Mehta; Ravindra L.,9994,0,9999,5
1745829070077,CLRE 252,A00,891864,Cuomo; Raphael Eduardo,9993,0,9999,6
1745829071102,CLRE 253,A00,891867,Vaida; Florin,9994,0,9999,5
1745829071102,CLRE 253,B00,907819,Staff,9999,0,9999,0
1745829072130,CLRE 259,A00,891868,Patel; Hemal,9998,0,9999,1
1745829073156,CLRE 260,A00,891872,Cuomo; Raphael Eduardo,9999,0,9999,0
1745829074184,CLRE 297,001,891888,Cuomo; Raphael Eduardo,9999,0,9999,0
1745829075210,CSE 191,A00,958773,Minnes Kemp; Mor Mia,9999,0,9999,0
1745829076237,CSS 201S,A01,892054,Mignozzetti; Umberto,30,0,30,0
1745829077263,CSS 202S,A01,892056,Mignozzetti; Umberto,30,0,30,0
1745829078290,DSC 197,001,956898,Eldridge; Justin Matthew,9998,0,9999,1
1745829079317,DSC 297,001,958000,Mazumdar; Arya,9998,0,9999,1
1745829080342,EAP 100,A00,905686,Staff,9776,0,9999,223
1745829081371,ECE 45,A01,892618,Staff,0,13,50,50
1745829082403,ECE 109,A01,892620,Staff,0,43,0,0
1745829083431,ECE 111,A01,892719,Staff,0,9,50,50
1745829084457,ECE 197,001,957920,Mercier; Patrick Philip,9992,0,9999,7
1745829085486,ECON 178,A01,907814,Zhu; Ying,28,0,35,7
1745829086512,EDS 115,A00,895312,Staff,41,0,45,4
1745829087540,EDS 117,A01,895337,Staff,30,0,30,0
1745829088569,EDS 125,A00,895341,Jones; Gabrielle Anastasia,43,0,45,2
1745829089600,EDS 128A,A01,895459,Fargason; Sharon Gayle,44,0,45,1
1745829090626,EDS 128B,A01,895543,Pappas; Elizabeth,44,0,45,1
1745829091653,EDS 139,A00,897203,Pappas; Elizabeth,44,0,45,1
1745829091653,EDS 139,B00,897209,Fargason; Sharon Gayle,44,0,45,1
1745829092679,EDS 201,A00,895545,Staff,43,0,45,2
1745829093711,EDS 203,A01,895581,Halter; Christopher P.,43,0,45,2
1745829094739,EDS 204R,A01,895625,Heinzman; Erica M.,43,0,45,2
1745829094739,EDS 204R,B01,895693,Halter; Christopher P.,18,0,45,27
1745829095770,EDS 206R,A00,895694,Fargason; Sharon Gayle,9,0,30,21
1745829095770,EDS 206R,B00,895695,Choi; Bailey Miyeon,20,0,30,10
1745829096799,EDS 250,A00,895697,Hemans; Patricia Ann Benitez,43,0,45,2
1745829097826,EDS 281,A00,895701,Meyerott; Theresa Ann,15,0,15,0
1745829098852,EDS 284,A00,895736,Meyerott; Theresa Ann,15,0,15,0
1745829099880,EDS 286,A00,897210,Fine; Sarah,15,0,15,0
1745829100915,EDS 289C,A01,895770,Daly; Alan J.,15,0,15,0
1745829101941,EDS 290,A00,897211,Hofstetter; Carolyn,15,0,15,0
1745829102969,LIGM 5A,A00,896162,Fischer-Grunski; Eva K,15,0,20,5
1745829103996,LIGM 5B,A00,896260,Fischer-Grunski; Eva K,17,0,20,3
1745829105030,LIGM 5C,A00,896308,Fischer-Grunski; Eva K,18,0,20,2
1745829106066,LIIT 5AS,A00,896313,Carnelos; Chiara,17,0,20,3
1745829107091,LIIT 5BS,A00,896416,Carnelos; Chiara,20,0,20,0
1745829108119,LIIT 5CS,A00,896564,Carnelos; Chiara,20,0,20,0
1745829109146,LISP 5A,A00,896588,Munoz Sanchez; Alicia,4,0,20,16
1745829110174,LISP 5B,A00,896653,Munoz Sanchez; Alicia,10,0,20,10
1745829111202,LISP 5C,A00,896655,Munoz Sanchez; Alicia,4,0,20,16
1745829112234,MAE 197,001,957918,Kleissl; Jan,9998,0,9999,1
1745829113272,MATH 2,A01,957937,Staff,34,0,35,1
1745829114302,MATH 197,001,957876,Kedlaya; Kiran S.,9993,0,9999,6
1745829115338,MCWP 40,A00,892729,Duru; Nur,13,0,20,7
1745829115338,MCWP 40,B00,893304,Montejo; Carolina,20,0,20,0
1745829116368,MCWP 40R,A00,893757,Redela; Pamela Morgan,0,7,20,20
1745829117395,MCWP 50,A00,893758,Morshed; Michael James,2,0,20,18
1745829117395,MCWP 50,B00,893761,Bartulis; Jason Michael,18,0,20,2
1745829118422,MCWP 50R,A00,893766,Compas; Sean Matthew,0,1,20,20
1745829118422,MCWP 50R,B00,893769,Carter; Jennifer A,0,0,20,20
1745829118422,MCWP 50R,C00,893771,Krone; Jarret,0,3,20,20
1745829118422,MCWP 50R,D00,893772,Miller; Elizabeth Deen,3,0,20,17
1745829118422,MCWP 50R,E00,893775,Carter; Andrea L,0,0,20,20
1745829119453,MMW 11R,A01,892721,Herbst; Matthew,11,0,27,16
1745829119453,MMW 11R,A02,892722,Herbst; Matthew,0,0,0,3
1745829120485,MMW 12R,A01,892724,Herbst; Matthew,0,10,16,16
1745829120485,MMW 12R,A02,892725,Herbst; Matthew,0,9,16,16
1745829121519,MMW 13R,A01,892727,Staff,0,3,16,16
1745829121519,MMW 13R,A02,892728,Staff,0,4,16,16
1745829121519,MMW 13R,A03,958032,Staff,0,3,16,16
1745829121519,MMW 13R,A04,958033,Staff,0,2,16,16
1745829121519,MMW 13R,A05,958034,Staff,0,3,16,16
1745829122547,SIO 295LS,A00,894015,Staff,7,0,25,18
1745829123573,SIO 295S,A00,894020,Staff,7,0,25,18
1745829124603,SIOC 290S,B01,958918,Staff,0,0,0,0
1745829125629,SIOC 291S,B01,958922,Staff,0,0,0,0
1745829126661,SOCI 117,A01,895339,Staff,4,0,5,1
1745829127687,WES 237B,A00,894149,Staff,11,0,20,9
1745829129777,AESE 279B,A00,891859,Staff,13,0,35,22
1745829130807,AIP 197,001,891854,Staff,70,0,70,0
1745829131835,ANTH 289S,A00,891856,Gagneux; Pascal,12,0,12,0
1745829132863,BENG 196,001,957946,Engler; Adam J.,9996,0,9999,3
1745829133889,CAT 124RS,A01,956906,Staff,8,0,25,17
1745829134920,CAT 125RS,A01,922013,Staff,8,0,25,17
1745829135945,CLRE 250,A00,891860,Morris; Sheldon,9995,0,9999,4
1745829137996,CLRE 251R,A00,907817,Mehta; Ravindra L.,9994,0,9999,5
1745829139022,CLRE 252,A00,891864,Cuomo; Raphael Eduardo,9993,0,9999,6
1745829140057,CLRE 253,A00,891867,Vaida; Florin,9994,0,9999,5
1745829140057,CLRE 253,B00,907819,Staff,9999,0,9999,0
1745829141083,CLRE 259,A00,891868,Patel; Hemal,9998,0,9999,1
1745829142110,CLRE 260,A00,891872,Cuomo; Raphael Eduardo,9999,0,9999,0
1745829143136,CLRE 297,001,891888,Cuomo; Raphael Eduardo,9999,0,9999,0
1745829144162,CSE 191,A00,958773,Minnes Kemp; Mor Mia,9999,0,9999,0
1745829145196,CSS 201S,A01,892054,Mignozzetti; Umberto,30,0,30,0
1745829146235,CSS 202S,A01,892056,Mignozzetti; Umberto,30,0,30,0
1745829147265,DSC 197,001,956898,Eldridge; Justin Matthew,9998,0,9999,1
1745829148290,DSC 297,001,958000,Mazumdar; Arya,9998,0,9999,1
1745829149315,EAP 100,A00,905686,Staff,9776,0,9999,223
1745829150342,ECE 45,A01,892618,Staff,0,13,50,50
1745829151367,ECE 109,A01,892620,Staff,0,43,0,0
1745829152402,ECE 111,A01,892719,Staff,0,9,50,50
1745829153432,ECE 197,001,957920,Mercier; Patrick Philip,9992,0,9999,7
1745829154464,ECON 178,A01,907814,Zhu; Ying,28,0,35,7
1745829155497,EDS 115,A00,895312,Staff,41,0,45,4
1745829156524,EDS 117,A01,895337,Staff,30,0,30,0
1745829157550,EDS 125,A00,895341,Jones; Gabrielle Anastasia,43,0,45,2
1745829158578,EDS 128A,A01,895459,Fargason; Sharon Gayle,44,0,45,1
1745829159608,EDS 128B,A01,895543,Pappas; Elizabeth,44,0,45,1
1745829160633,EDS 139,A00,897203,Pappas; Elizabeth,44,0,45,1
1745829160633,EDS 139,B00,897209,Fargason; Sharon Gayle,44,0,45,1
1745829161686,EDS 201,A00,895545,Staff,43,0,45,2
1745829162714,EDS 203,A01,895581,Halter; Christopher P.,43,0,45,2
1745829163750,EDS 204R,A01,895625,Heinzman; Erica M.,43,0,45,2
1745829163750,EDS 204R,B01,895693,Halter; Christopher P.,18,0,45,27
1745829164776,EDS 206R,A00,895694,Fargason; Sharon Gayle,9,0,30,21
1745829164776,EDS 206R,B00,895695,Choi; Bailey Miyeon,20,0,30,10
1745829165803,EDS 250,A00,895697,Hemans; Patricia Ann Benitez,43,0,45,2
1745829166833,EDS 281,A00,895701,Meyerott; Theresa Ann,15,0,15,0
1745829167860,EDS 284,A00,895736,Meyerott; Theresa Ann,15,0,15,0
1745829168887,EDS 286,A00,897210,Fine; Sarah,15,0,15,0
1745829169912,EDS 289C,A01,895770,Daly; Alan J.,15,0,15,0
1745829170938,EDS 290,A00,897211,Hofstetter; Carolyn,15,0,15,0
1745829171996,LIGM 5A,A00,896162,Fischer-Grunski; Eva K,15,0,20,5
1745829173024,LIGM 5B,A00,896260,Fischer-Grunski; Eva K,17,0,20,3
1745829174055,LIGM 5C,A00,896308,Fischer-Grunski; Eva K,18,0,20,2
1745829175086,LIIT 5AS,A00,896313,Carnelos; Chiara,17,0,20,3
1745829176113,LIIT 5BS,A00,896416,Carnelos; Chiara,20,0,20,0
1745829177143,LIIT 5CS,A00,896564,Carnelos; Chiara,20,0,20,0
1745829178171,LISP 5A,A00,896588,Munoz Sanchez; Alicia,4,0,20,16
1745829179199,LISP 5B,A00,896653,Munoz Sanchez; Alicia,10,0,20,10
1745829180228,LISP 5C,A00,896655,Munoz Sanchez; Alicia,4,0,20,16
1745829181255,MAE 197,001,957918,Kleissl; Jan,9998,0,9999,1
1745829182289,MATH 2,A01,957937,Staff,34,0,35,1
1745829183315,MATH 197,001,957876,Kedlaya; Kiran S.,9993,0,9999,6
1745829184344,MCWP 40,A00,892729,Duru; Nur,13,0,20,7
1745829184344,MCWP 40,B00,893304,Montejo; Carolina,20,0,20,0
1745829185371,MCWP 40R,A00,893757,Redela; Pamela Morgan,0,7,20,20
1745829186399,MCWP 50,A00,893758,Morshed; Michael James,2,0,20,18
1745829186399,MCWP 50,B00,893761,Bartulis; Jason Michael,18,0,20,2
1745829187432,MCWP 50R,A00,893766,Compas; Sean Matthew,0,1,20,20
1745829187432,MCWP 50R,B00,893769,Carter; Jennifer A,0,0,20,20
1745829187432,MCWP 50R,C00,893771,Krone; Jarret,0,3,20,20
1745829187432,MCWP 50R,D00,893772,Miller; Elizabeth Deen,3,0,20,17
1745829187432,MCWP 50R,E00,893775,Carter; Andrea L,0,0,20,20
1745829188463,MMW 11R,A01,892721,Herbst; Matthew,11,0,27,16
1745829188463,MMW 11R,A02,892722,Herbst; Matthew,0,0,0,3
1745829189491,MMW 12R,A01,892724,Herbst; Matthew,0,10,16,16
1745829189491,MMW 12R,A02,892725,Herbst; Matthew,0,9,16,16
1745829190524,MMW 13R,A01,892727,Staff,0,3,16,16
1745829190524,MMW 13R,A02,892728,Staff,0,4,16,16
1745829190524,MMW 13R,A03,958032,Staff,0,3,16,16
1745829190524,MMW 13R,A04,958033,Staff,0,2,16,16
1745829190524,MMW 13R,A05,958034,Staff,0,3,16,16
1745829191550,SIO 295LS,A00,894015,Staff,7,0,25,18
1745829192580,SIO 295S,A00,894020,Staff,7,0,25,18
1745829193613,SIOC 290S,B01,958918,Staff,0,0,0,0
1745829194641,SIOC 291S,B01,958922,Staff,0,0,0,0
1745829195672,SOCI 117,A01,895339,Staff,4,0,5,1
1745829196701,WES 237B,A00,894149,Staff,11,0,20,9
1745829198766,AESE 279B,A00,891859,Staff,13,0,35,22
1745829199796,AIP 197,001,891854,Staff,70,0,70,0
1745829200829,ANTH 289S,A00,891856,Gagneux; Pascal,12,0,12,0
1745829201854,BENG 196,001,957946,Engler; Adam J.,9996,0,9999,3
1745829202885,CAT 124RS,A01,956906,Staff,8,0,25,17
1745829203917,CAT 125RS,A01,922013,Staff,8,0,25,17
1745829204946,CLRE 250,A00,891860,Morris; Sheldon,9995,0,9999,4
1745829207008,CLRE 251R,A00,907817,Mehta; Ravindra L.,9994,0,9999,5
1745829208035,CLRE 252,A00,891864,Cuomo; Raphael Eduardo,9993,0,9999,6
1745829209062,CLRE 253,A00,891867,Vaida; Florin,9994,0,9999,5
1745829209062,CLRE 253,B00,907819,Staff,9999,0,9999,0
1745829210087,CLRE 259,A00,891868,Patel; Hemal,9998,0,9999,1
1745829211113,CLRE 260,A00,891872,Cuomo; Raphael Eduardo,9999,0,9999,0
1745829212144,CLRE 297,001,891888,Cuomo; Raphael Eduardo,9999,0,9999,0
1745829213173,CSE 191,A00,958773,Minnes Kemp; Mor Mia,9999,0,9999,0
1745829214206,CSS 201S,A01,892054,Mignozzetti; Umberto,30,0,30,0
1745829215234,CSS 202S,A01,892056,Mignozzetti; Umberto,30,0,30,0
1745829216269,DSC 197,001,956898,Eldridge; Justin Matthew,9998,0,9999,1
1745829217296,DSC 297,001,958000,Mazumdar; Arya,9998,0,9999,1
1745829218321,EAP 100,A00,905686,Staff,9776,0,9999,223
1745829219348,ECE 45,A01,892618,Staff,0,13,50,50
1745829220378,ECE 109,A01,892620,Staff,0,43,0,0
1745829221407,ECE 111,A01,892719,Staff,0,9,50,50
1745829222437,ECE 197,001,957920,Mercier; Patrick Philip,9992,0,9999,7
1745829223466,ECON 178,A01,907814,Zhu; Ying,28,0,35,7
1745829224492,EDS 115,A00,895312,Staff,41,0,45,4
1745829225518,EDS 117,A01,895337,Staff,30,0,30,0
1745829226550,EDS 125,A00,895341,Jones; Gabrielle Anastasia,43,0,45,2
1745829227576,EDS 128A,A01,895459,Fargason; Sharon Gayle,44,0,45,1
1745829228610,EDS 128B,A01,895543,Pappas; Elizabeth,44,0,45,1
1745829229636,EDS 139,A00,897203,Pappas; Elizabeth,44,0,45,1
1745829229636,EDS 139,B00,897209,Fargason; Sharon Gayle,44,0,45,1
1745829230667,EDS 201,A00,895545,Staff,43,0,45,2
1745829231700,EDS 203,A01,895581,Halter; Christopher P.,43,0,45,2
1745829232726,EDS 204R,A01,895625,Heinzman; Erica M.,43,0,45,2
1745829232726,EDS 204R,B01,895693,Halter; Christopher P.,18,0,45,27
1745829233759,EDS 206R,A00,895694,Fargason; Sharon Gayle,9,0,30,21
1745829233759,EDS 206R,B00,895695,Choi; Bailey Miyeon,20,0,30,10
1745829234792,EDS 250,A00,895697,Hemans; Patricia Ann Benitez,43,0,45,2
1745829235828,EDS 281,A00,895701,Meyerott; Theresa Ann,15,0,15,0
1745829236859,EDS 284,A00,895736,Meyerott; Theresa Ann,15,0,15,0
1745829237889,EDS 286,A00,897210,Fine; Sarah,15,0,15,0
1745829238917,EDS 289C,A01,895770,Daly; Alan J.,15,0,15,0
1745829239947,EDS 290,A00,897211,Hofstetter; Carolyn,15,0,15,0
1745829240977,LIGM 5A,A00,896162,Fischer-Grunski; Eva K,15,0,20,5
1745829242011,LIGM 5B,A00,896260,Fischer-Grunski; Eva K,17,0,20,3
1745829243038,LIGM 5C,A00,896308,Fischer-Grunski; Eva K,18,0,20,2
1745829244071,LIIT 5AS,A00,896313,Carnelos; Chiara,17,0,20,3
1745829245101,LIIT 5BS,A00,896416,Carnelos; Chiara,20,0,20,0
1745829246127,LIIT 5CS,A00,896564,Carnelos; Chiara,20,0,20,0
1745829247156,LISP 5A,A00,896588,Munoz Sanchez; Alicia,4,0,20,16
1745829248187,LISP 5B,A00,896653,Munoz Sanchez; Alicia,10,0,20,10
1745829249214,LISP 5C,A00,896655,Munoz Sanchez; Alicia,4,0,20,16
1745829250243,MAE 197,001,957918,Kleissl; Jan,9998,0,9999,1
1745829251275,MATH 2,A01,957937,Staff,34,0,35,1
1745829252304,MATH 197,001,957876,Kedlaya; Kiran S.,9993,0,9999,6
1745829253334,MCWP 40,A00,892729,Duru; Nur,13,0,20,7
1745829253334,MCWP 40,B00,893304,Montejo; Carolina,20,0,20,0
1745829254370,MCWP 40R,A00,893757,Redela; Pamela Morgan,0,7,20,20
1745829255401,MCWP 50,A00,893758,Morshed; Michael James,2,0,20,18
1745829255401,MCWP 50,B00,893761,Bartulis; Jason Michael,18,0,20,2
1745829256430,MCWP 50R,A00,893766,Compas; Sean Matthew,0,1,20,20
1745829256430,MCWP 50R,B00,893769,Carter; Jennifer A,0,0,20,20
1745829256430,MCWP 50R,C00,893771,Krone; Jarret,0,3,20,20
1745829256430,MCWP 50R,D00,893772,Miller; Elizabeth Deen,3,0,20,17
1745829256430,MCWP 50R,E00,893775,Carter; Andrea L,0,0,20,20
1745829257457,MMW 11R,A01,892721,Herbst; Matthew,11,0,27,16
1745829257457,MMW 11R,A02,892722,Herbst; Matthew,0,0,0,3
1745829258489,MMW 12R,A01,892724,Herbst; Matthew,0,10,16,16
1745829258489,MMW 12R,A02,892725,Herbst; Matthew,0,9,16,16
1745829259522,MMW 13R,A01,892727,Staff,0,3,16,16
1745829259522,MMW 13R,A02,892728,Staff,0,4,16,16
1745829259522,MMW 13R,A03,958032,Staff,0,3,16,16
1745829259522,MMW 13R,A04,958033,Staff,0,2,16,16
1745829259522,MMW 13R,A05,958034,Staff,0,3,16,16
1745829260548,SIO 295LS,A00,894015,Staff,7,0,25,18
1745829261575,SIO 295S,A00,894020,Staff,7,0,25,18
1745829262605,SIOC 290S,B01,958918,Staff,0,0,0,0
1745829263632,SIOC 291S,B01,958922,Staff,0,0,0,0
1745829264658,SOCI 117,A01,895339,Staff,4,0,5,1
1745829265689,WES 237B,A00,894149,Staff,11,0,20,9
1745829267765,AESE 279B,A00,891859,Staff,13,0,35,22
1745829268789,AIP 197,001,891854,Staff,70,0,70,0
1745829269820,ANTH 289S,A00,891856,Gagneux; Pascal,12,0,12,0
1745829270846,BENG 196,001,957946,Engler; Adam J.,9996,0,9999,3
1745829271875,CAT 124RS,A01,956906,Staff,8,0,25,17
1745829272904,CAT 125RS,A01,922013,Staff,8,0,25,17
1745829273931,CLRE 250,A00,891860,Morris; Sheldon,9995,0,9999,4
1745829275987,CLRE 251R,A00,907817,Mehta; Ravindra L.,9994,0,9999,5
1745829277015,CLRE 252,A00,891864,Cuomo; Raphael Eduardo,9993,0,9999,6
1745829278043,CLRE 253,A00,891867,Vaida; Florin,9994,0,9999,5
1745829278043,CLRE 253,B00,907819,Staff,9999,0,9999,0
1745829279070,CLRE 259,A00,891868,Patel; Hemal,9998,0,9999,1
1745829280095,CLRE 260,A00,891872,Cuomo; Raphael Eduardo,9999,0,9999,0
1745829281125,CLRE 297,001,891888,Cuomo; Raphael Eduardo,9999,0,9999,0
1745829282153,CSE 191,A00,958773,Minnes Kemp; Mor Mia,9999,0,9999,0
1745829283213,CSS 201S,A01,892054,Mignozzetti; Umberto,30,0,30,0
1745829284239,CSS 202S,A01,892056,Mignozzetti; Umberto,30,0,30,0
1745829285270,DSC 197,001,956898,Eldridge; Justin Matthew,9998,0,9999,1
1745829286298,DSC 297,001,958000,Mazumdar; Arya,9998,0,9999,1
1745829287327,EAP 100,A00,905686,Staff,9776,0,9999,223
1745829288358,ECE 45,A01,892618,Staff,0,13,50,50
1745829289385,ECE 109,A01,892620,Staff,0,43,0,0
1745829290415,ECE 111,A01,892719,Staff,0,9,50,50
1745829291442,ECE 197,001,957920,Mercier; Patrick Philip,9992,0,9999,7
1745829292469,ECON 178,A01,907814,Zhu; Ying,28,0,35,7
1745829293496,EDS 115,A00,895312,Staff,41,0,45,4
1745829294522,EDS 117,A01,895337,Staff,30,0,30,0
1745829295546,EDS 125,A00,895341,Jones; Gabrielle Anastasia,43,0,45,2
1745829296576,EDS 128A,A01,895459,Fargason; Sharon Gayle,44,0,45,1
1745829297602,EDS 128B,A01,895543,Pappas; Elizabeth,44,0,45,1
1745829298632,EDS 139,A00,897203,Pappas; Elizabeth,44,0,45,1
1745829298632,EDS 139,B00,897209,Fargason; Sharon Gayle,44,0,45,1
1745829299658,EDS 201,A00,895545,Staff,43,0,45,2
1745829300688,EDS 203,A01,895581,Halter; Christopher P.,43,0,45,2
1745829301718,EDS 204R,A01,895625,Heinzman; Erica M.,43,0,45,2
1745829301718,EDS 204R,B01,895693,Halter; Christopher P.,18,0,45,27
1745829302750,EDS 206R,A00,895694,Fargason; Sharon Gayle,9,0,30,21
1745829302750,EDS 206R,B00,895695,Choi; Bailey Miyeon,20,0,30,10
1745829303785,EDS 250,A00,895697,Hemans; Patricia Ann Benitez,43,0,45,2
1745829304813,EDS 281,A00,895701,Meyerott; Theresa Ann,15,0,15,0
1745829305843,EDS 284,A00,895736,Meyerott; Theresa Ann,15,0,15,0
1745829306874,EDS 286,A00,897210,Fine; Sarah,15,0,15,0
1745829307902,EDS 289C,A01,895770,Daly; Alan J.,15,0,15,0
1745829308928,EDS 290,A00,897211,Hofstetter; Carolyn,15,0,15,0
1745829309957,LIGM 5A,A00,896162,Fischer-Grunski; Eva K,15,0,20,5
1745829310990,LIGM 5B,A00,896260,Fischer-Grunski; Eva K,17,0,20,3
1745829312018,LIGM 5C,A00,896308,Fischer-Grunski; Eva K,18,0,20,2
1745829313052,LIIT 5AS,A00,896313,Carnelos; Chiara,17,0,20,3
1745829314079,LIIT 5BS,A00,896416,Carnelos; Chiara,20,0,20,0
1745829315107,LIIT 5CS,A00,896564,Carnelos; Chiara,20,0,20,0
1745829316143,LISP 5A,A00,896588,Munoz Sanchez; Alicia,4,0,20,16
1745829317175,LISP 5B,A00,896653,Munoz Sanchez; Alicia,10,0,20,10
1745829318206,LISP 5C,A00,896655,Munoz Sanchez; Alicia,4,0,20,16
1745829319233,MAE 197,001,957918,Kleissl; Jan,9998,0,9999,1
1745829320262,MATH 2,A01,957937,Staff,34,0,35,1
1745829321289,MATH 197,001,957876,Kedlaya; Kiran S.,9993,0,9999,6
1745829322318,MCWP 40,A00,892729,Duru; Nur,13,0,20,7
1745829322318,MCWP 40,B00,893304,Montejo; Carolina,20,0,20,0
1745829323350,MCWP 40R,A00,893757,Redela; Pamela Morgan,0,7,20,20
1745829324382,MCWP 50,A00,893758,Morshed; Michael James,2,0,20,18
1745829324382,MCWP 50,B00,893761,Bartulis; Jason Michael,18,0,20,2
1745829325411,MCWP 50R,A00,893766,Compas; Sean Matthew,0,1,20,20
1745829325411,MCWP 50R,B00,893769,Carter; Jennifer A,0,0,20,20
1745829325411,MCWP 50R,C00,893771,Krone; Jarret,0,3,20,20
1745829325411,MCWP 50R,D00,893772,Miller; Elizabeth Deen,3,0,20,17
1745829325411,MCWP 50R,E00,893775,Carter; Andrea L,0,0,20,20
1745829326439,MMW 11R,A01,892721,Herbst; Matthew,11,0,27,16
1745829326439,MMW 11R,A02,892722,Herbst; Matthew,0,0,0,3
1745829327467,MMW 12R,A01,892724,Herbst; Matthew,0,10,16,16
1745829327467,MMW 12R,A02,892725,Herbst; Matthew,0,9,16,16
1745829328494,MMW 13R,A01,892727,Staff,0,3,16,16
1745829328494,MMW 13R,A02,892728,Staff,0,4,16,16
1745829328494,MMW 13R,A03,958032,Staff,0,3,16,16
1745829328494,MMW 13R,A04,958033,Staff,0,2,16,16
1745829328494,MMW 13R,A05,958034,Staff,0,3,16,16
1745829329522,SIO 295LS,A00,894015,Staff,7,0,25,18
1745829330547,SIO 295S,A00,894020,Staff,7,0,25,18
1745829331581,SIOC 290S,B01,958918,Staff,0,0,0,0
1745829332609,SIOC 291S,B01,958922,Staff,0,0,0,0
1745829333635,SOCI 117,A01,895339,Staff,4,0,5,1
1745829334665,WES 237B,A00,894149,Staff,11,0,20,9
1745829336750,AESE 279B,A00,891859,Staff,13,0,35,22
1745829337776,AIP 197,001,891854,Staff,70,0,70,0
1745829338804,ANTH 289S,A00,891856,Gagneux; Pascal,12,0,12,0
1745829339830,BENG 196,001,957946,Engler; Adam J.,9996,0,9999,3
1745829340858,CAT 124RS,A01,956906,Staff,8,0,25,17
1745829341885,CAT 125RS,A01,922013,Staff,8,0,25,17
1745829342917,CLRE 250,A00,891860,Morris; Sheldon,9995,0,9999,4
1745829344974,CLRE 251R,A00,907817,Mehta; Ravindra L.,9994,0,9999,5
1745829346005,CLRE 252,A00,891864,Cuomo; Raphael Eduardo,9993,0,9999,6
1745829347034,CLRE 253,A00,891867,Vaida; Florin,9994,0,9999,5
1745829347034,CLRE 253,B00,907819,Staff,9999,0,9999,0
1745829348063,CLRE 259,A00,891868,Patel; Hemal,9998,0,9999,1
1745829349089,CLRE 260,A00,891872,Cuomo; Raphael Eduardo,9999,0,9999,0
1745829350122,CLRE 297,001,891888,Cuomo; Raphael Eduardo,9999,0,9999,0
1745829351147,CSE 191,A00,958773,Minnes Kemp; Mor Mia,9999,0,9999,0
1745829352174,CSS 201S,A01,892054,Mignozzetti; Umberto,30,0,30,0
1745829353205,CSS 202S,A01,892056,Mignozzetti; Umberto,30,0,30,0
1745829354232,DSC 197,001,956898,Eldridge; Justin Matthew,9998,0,9999,1
1745829355258,DSC 297,001,958000,Mazumdar; Arya,9998,0,9999,1
1745829356284,EAP 100,A00,905686,Staff,9776,0,9999,223
1745829357311,ECE 45,A01,892618,Staff,0,13,50,50
1745829358344,ECE 109,A01,892620,Staff,0,43,0,0
1745829359370,ECE 111,A01,892719,Staff,0,9,50,50
1745829360395,ECE 197,001,957920,Mercier; Patrick Philip,9992,0,9999,7
1745829361429,ECON 178,A01,907814,Zhu; Ying,28,0,35,7
1745829362513,EDS 115,A00,895312,Staff,41,0,45,4
1745829363541,EDS 117,A01,895337,Staff,30,0,30,0
1745829364567,EDS 125,A00,895341,Jones; Gabrielle Anastasia,43,0,45,2
1745829365592,EDS 128A,A01,895459,Fargason; Sharon Gayle,44,0,45,1
1745829366617,EDS 128B,A01,895543,Pappas; Elizabeth,44,0,45,1
1745829367643,EDS 139,A00,897203,Pappas; Elizabeth,44,0,45,1
1745829367643,EDS 139,B00,897209,Fargason; Sharon Gayle,44,0,45,1
1745829368673,EDS 201,A00,895545,Staff,43,0,45,2
1745829369698,EDS 203,A01,895581,Halter; Christopher P.,43,0,45,2
1745829370729,EDS 204R,A01,895625,Heinzman; Erica M.,43,0,45,2
1745829370729,EDS 204R,B01,895693,Halter; Christopher P.,18,0,45,27
1745829371758,EDS 206R,A00,895694,Fargason; Sharon Gayle,9,0,30,21
1745829371758,EDS 206R,B00,895695,Choi; Bailey Miyeon,20,0,30,10
1745829372787,EDS 250,A00,895697,Hemans; Patricia Ann Benitez,43,0,45,2
1745829373816,EDS 281,A00,895701,Meyerott; Theresa Ann,15,0,15,0
1745829374840,EDS 284,A00,895736,Meyerott; Theresa Ann,15,0,15,0
1745829375868,EDS 286,A00,897210,Fine; Sarah,15,0,15,0
1745829376893,EDS 289C,A01,895770,Daly; Alan J.,15,0,15,0
1745829377918,EDS 290,A00,897211,Hofstetter; Carolyn,15,0,15,0
1745829378949,LIGM 5A,A00,896162,Fischer-Grunski; Eva K,15,0,20,5
1745829379980,LIGM 5B,A00,896260,Fischer-Grunski; Eva K,17,0,20,3
1745829381009,LIGM 5C,A00,896308,Fischer-Grunski; Eva K,18,0,20,2
1745829382036,LIIT 5AS,A00,896313,Carnelos; Chiara,17,0,20,3
1745829383066,LIIT 5BS,A00,896416,Carnelos; Chiara,20,0,20,0
1745829384095,LIIT 5CS,A00,896564,Carnelos; Chiara,20,0,20,0
1745829385123,LISP 5A,A00,896588,Munoz Sanchez; Alicia,4,0,20,16
1745829386150,LISP 5B,A00,896653,Munoz Sanchez; Alicia,10,0,20,10
1745829387180,LISP 5C,A00,896655,Munoz Sanchez; Alicia,4,0,20,16
1745829388206,MAE 197,001,957918,Kleissl; Jan,9998,0,9999,1
1745829389232,MATH 2,A01,957937,Staff,34,0,35,1
1745829390258,MATH 197,001,957876,Kedlaya; Kiran S.,9993,0,9999,6
1745829391287,MCWP 40,A00,892729,Duru; Nur,13,0,20,7
1745829391287,MCWP 40,B00,893304,Montejo; Carolina,20,0,20,0
1745829392317,MCWP 40R,A00,893757,Redela; Pamela Morgan,0,7,20,20
1745829393344,MCWP 50,A00,893758,Morshed; Michael James,2,0,20,18
1745829393344,MCWP 50,B00,893761,Bartulis; Jason Michael,18,0,20,2
1745829394379,MCWP 50R,A00,893766,Compas; Sean Matthew,0,1,20,20
1745829394379,MCWP 50R,B00,893769,Carter; Jennifer A,0,0,20,20
1745829394379,MCWP 50R,C00,893771,Krone; Jarret,0,3,20,20
1745829394379,MCWP 50R,D00,893772,Miller; Elizabeth Deen,3,0,20,17
1745829394379,MCWP 50R,E00,893775,Carter; Andrea L,0,0,20,20
1745829395404,MMW 11R,A01,892721,Herbst; Matthew,11,0,27,16
1745829395404,MMW 11R,A02,892722,Herbst; Matthew,0,0,0,3
1745829396434,MMW 12R,A01,892724,Herbst; Matthew,0,10,16,16
1745829396434,MMW 12R,A02,892725,Herbst; Matthew,0,9,16,16
1745829397483,MMW 13R,A01,892727,Staff,0,3,16,16
1745829397483,MMW 13R,A02,892728,Staff,0,4,16,16
1745829397483,MMW 13R,A03,958032,Staff,0,3,16,16
1745829397483,MMW 13R,A04,958033,Staff,0,2,16,16
1745829397483,MMW 13R,A05,958034,Staff,0,3,16,16
1745829398514,SIO 295LS,A00,894015,Staff,7,0,25,18
1745829399542,SIO 295S,A00,894020,Staff,7,0,25,18
1745829400573,SIOC 290S,B01,958918,Staff,0,0,0,0
1745829401603,SIOC 291S,B01,958922,Staff,0,0,0,0
1745829402629,SOCI 117,A01,895339,Staff,4,0,5,1
1745829403653,WES 237B,A00,894149,Staff,11,0,20,9
1745829405769,AESE 279B,A00,891859,Staff,13,0,35,22
1745829406794,AIP 197,001,891854,Staff,70,0,70,0
1745829407824,ANTH 289S,A00,891856,Gagneux; Pascal,12,0,12,0
1745829408852,BENG 196,001,957946,Engler; Adam J.,9996,0,9999,3
1745829409879,CAT 124RS,A01,956906,Staff,8,0,25,17
1745829410910,CAT 125RS,A01,922013,Staff,8,0,25,17
1745829411938,CLRE 250,A00,891860,Morris; Sheldon,9995,0,9999,4
1745829413995,CLRE 251R,A00,907817,Mehta; Ravindra L.,9994,0,9999,5
1745829415022,CLRE 252,A00,891864,Cuomo; Raphael Eduardo,9993,0,9999,6
1745829416048,CLRE 253,A00,891867,Vaida; Florin,9994,0,9999,5
1745829416048,CLRE 253,B00,907819,Staff,9999,0,9999,0
1745829417073,CLRE 259,A00,891868,Patel; Hemal,9998,0,9999,1
1745829418101,CLRE 260,A00,891872,Cuomo; Raphael Eduardo,9999,0,9999,0
1745829419129,CLRE 297,001,891888,Cuomo; Raphael Eduardo,9999,0,9999,0
1745829420158,CSE 191,A00,958773,Minnes Kemp; Mor Mia,9999,0,9999,0
1745829421189,CSS 201S,A01,892054,Mignozzetti; Umberto,30,0,30,0
1745829422218,CSS 202S,A01,892056,Mignozzetti; Umberto,30,0,30,0
1745829423245,DSC 197,001,956898,Eldridge; Justin Matthew,9998,0,9999,1
1745829424271,DSC 297,001,958000,Mazumdar; Arya,9998,0,9999,1
1745829425305,EAP 100,A00,905686,Staff,9776,0,9999,223
1745829426331,ECE 45,A01,892618,Staff,0,13,50,50
1745829427358,ECE 109,A01,892620,Staff,0,43,0,0
1745829428388,ECE 111,A01,892719,Staff,0,9,50,50
1745829429417,ECE 197,001,957920,Mercier; Patrick Philip,9992,0,9999,7
1745829430445,ECON 178,A01,907814,Zhu; Ying,28,0,35,7
1745829431476,EDS 115,A00,895312,Staff,41,0,45,4
1745829432502,EDS 117,A01,895337,Staff,30,0,30,0
1745829433528,EDS 125,A00,895341,Jones; Gabrielle Anastasia,43,0,45,2
1745829434556,EDS 128A,A01,895459,Fargason; Sharon Gayle,44,0,45,1
1745829435590,EDS 128B,A01,895543,Pappas; Elizabeth,44,0,45,1
1745829436618,EDS 139,A00,897203,Pappas; Elizabeth,44,0,45,1
1745829436618,EDS 139,B00,897209,Fargason; Sharon Gayle,44,0,45,1
1745829437644,EDS 201,A00,895545,Staff,43,0,45,2
1745829438672,EDS 203,A01,895581,Halter; Christopher P.,43,0,45,2
1745829439699,EDS 204R,A01,895625,Heinzman; Erica M.,43,0,45,2
1745829439699,EDS 204R,B01,895693,Halter; Christopher P.,18,0,45,27
1745829440726,EDS 206R,A00,895694,Fargason; Sharon Gayle,9,0,30,21
1745829440726,EDS 206R,B00,895695,Choi; Bailey Miyeon,20,0,30,10
1745829441753,EDS 250,A00,895697,Hemans; Patricia Ann Benitez,43,0,45,2
1745829442779,EDS 281,A00,895701,Meyerott; Theresa Ann,15,0,15,0
1745829443808,EDS 284,A00,895736,Meyerott; Theresa Ann,15,0,15,0
1745829444835,EDS 286,A00,897210,Fine; Sarah,15,0,15,0
1745829445865,EDS 289C,A01,895770,Daly; Alan J.,15,0,15,0
1745829446893,EDS 290,A00,897211,Hofstetter; Carolyn,15,0,15,0
1745829447925,LIGM 5A,A00,896162,Fischer-Grunski; Eva K,15,0,20,5
1745829448958,LIGM 5B,A00,896260,Fischer-Grunski; Eva K,17,0,20,3
1745829449988,LIGM 5C,A00,896308,Fischer-Grunski; Eva K,18,0,20,2
1745829451015,LIIT 5AS,A00,896313,Carnelos; Chiara,17,0,20,3
1745829452047,LIIT 5BS,A00,896416,Carnelos; Chiara,20,0,20,0
1745829453076,LIIT 5CS,A00,896564,Carnelos; Chiara,20,0,20,0
1745829454104,LISP 5A,A00,896588,Munoz Sanchez; Alicia,4,0,20,16
1745829455130,LISP 5B,A00,896653,Munoz Sanchez; Alicia,10,0,20,10
1745829456155,LISP 5C,A00,896655,Munoz Sanchez; Alicia,4,0,20,16
1745829457186,MAE 197,001,957918,Kleissl; Jan,9998,0,9999,1
1745829458214,MATH 2,A01,957937,Staff,34,0,35,1
1745829459240,MATH 197,001,957876,Kedlaya; Kiran S.,9993,0,9999,6
1745829460268,MCWP 40,A00,892729,Duru; Nur,13,0,20,7
1745829460268,MCWP 40,B00,893304,Montejo; Carolina,20,0,20,0
1745829461299,MCWP 40R,A00,893757,Redela; Pamela Morgan,0,7,20,20
1745829462327,MCWP 50,A00,893758,Morshed; Michael James,2,0,20,18
1745829462327,MCWP 50,B00,893761,Bartulis; Jason Michael,18,0,20,2
1745829463355,MCWP 50R,A00,893766,Compas; Sean Matthew,0,1,20,20
1745829463355,MCWP 50R,B00,893769,Carter; Jennifer A,0,0,20,20
1745829463355,MCWP 50R,C00,893771,Krone; Jarret,0,3,20,20
1745829463355,MCWP 50R,D00,893772,Miller; Elizabeth Deen,3,0,20,17
1745829463355,MCWP 50R,E00,893775,Carter; Andrea L,0,0,20,20
1745829464381,MMW 11R,A01,892721,Herbst; Matthew,11,0,27,16
1745829464381,MMW 11R,A02,892722,Herbst; Matthew,0,0,0,3
1745829465410,MMW 12R,A01,892724,Herbst; Matthew,0,10,16,16
1745829465410,MMW 12R,A02,892725,Herbst; Matthew,0,9,16,16
1745829466436,MMW 13R,A01,892727,Staff,0,3,16,16
1745829466436,MMW 13R,A02,892728,Staff,0,4,16,16
1745829466436,MMW 13R,A03,958032,Staff,0,3,16,16
1745829466436,MMW 13R,A04,958033,Staff,0,2,16,16
1745829466436,MMW 13R,A05,958034,Staff,0,3,16,16
1745829467469,SIO 295LS,A00,894015,Staff,7,0,25,18
1745829468494,SIO 295S,A00,894020,Staff,7,0,25,18
1745829469522,SIOC 290S,B01,958918,Staff,0,0,0,0
1745829470554,SIOC 291S,B01,958922,Staff,0,0,0,0
1745829471587,SOCI 117,A01,895339,Staff,4,0,5,1
1745829472613,WES 237B,A00,894149,Staff,11,0,20,9
1745829474690,AESE 279B,A00,891859,Staff,13,0,35,22
1745829475719,AIP 197,001,891854,Staff,70,0,70,0
1745829476746,ANTH 289S,A00,891856,Gagneux; Pascal,12,0,12,0
1745829477772,BENG 196,001,957946,Engler; Adam J.,9996,0,9999,3
1745829478801,CAT 124RS,A01,956906,Staff,8,0,25,17
1745829479827,CAT 125RS,A01,922013,Staff,8,0,25,17
1745829480856,CLRE 250,A00,891860,Morris; Sheldon,9995,0,9999,4
1745829482908,CLRE 251R,A00,907817,Mehta; Ravindra L.,9994,0,9999,5
1745829483933,CLRE 252,A00,891864,Cuomo; Raphael Eduardo,9993,0,9999,6
1745829484960,CLRE 253,A00,891867,Vaida; Florin,9994,0,9999,5
1745829484960,CLRE 253,B00,907819,Staff,9999,0,9999,0
1745829485986,CLRE 259,A00,891868,Patel; Hemal,9998,0,9999,1
1745829487015,CLRE 260,A00,891872,Cuomo; Raphael Eduardo,9999,0,9999,0
1745829488042,CLRE 297,001,891888,Cuomo; Raphael Eduardo,9999,0,9999,0
1745829489071,CSE 191,A00,958773,Minnes Kemp; Mor Mia,9999,0,9999,0
1745829490105,CSS 201S,A01,892054,Mignozzetti; Umberto,30,0,30,0
1745829491130,CSS 202S,A01,892056,Mignozzetti; Umberto,30,0,30,0
1745829492158,DSC 197,001,956898,Eldridge; Justin Matthew,9998,0,9999,1
1745829493183,DSC 297,001,958000,Mazumdar; Arya,9998,0,9999,1
1745829494210,EAP 100,A00,905686,Staff,9776,0,9999,223
1745829495240,ECE 45,A01,892618,Staff,0,13,50,50
1745829496269,ECE 109,A01,892620,Staff,0,43,0,0
1745829497295,ECE 111,A01,892719,Staff,0,9,50,50
1745829498322,ECE 197,001,957920,Mercier; Patrick Philip,9992,0,9999,7
1745829499348,ECON 178,A01,907814,Zhu; Ying,28,0,35,7
1745829500378,EDS 115,A00,895312,Staff,41,0,45,4
1745829501404,EDS 117,A01,895337,Staff,30,0,30,0
1745829502435,EDS 125,A00,895341,Jones; Gabrielle Anastasia,43,0,45,2
1745829503467,EDS 128A,A01,895459,Fargason; Sharon Gayle,44,0,45,1
1745829504495,EDS 128B,A01,895543,Pappas; Elizabeth,44,0,45,1
1745829505523,EDS 139,A00,897203,Pappas; Elizabeth,44,0,45,1
1745829505523,EDS 139,B00,897209,Fargason; Sharon Gayle,44,0,45,1
1745829506553,EDS 201,A00,895545,Staff,43,0,45,2
1745829507584,EDS 203,A01,895581,Halter; Christopher P.,43,0,45,2
1745829508611,EDS 204R,A01,895625,Heinzman; Erica M.,43,0,45,2
1745829508611,EDS 204R,B01,895693,Halter; Christopher P.,18,0,45,27
1745829509639,EDS 206R,A00,895694,Fargason; Sharon Gayle,9,0,30,21
1745829509639,EDS 206R,B00,895695,Choi; Bailey Miyeon,20,0,30,10
1745829510666,EDS 250,A00,895697,Hemans; Patricia Ann Benitez,43,0,45,2
1745829511691,EDS 281,A00,895701,Meyerott; Theresa Ann,15,0,15,0
1745829512718,EDS 284,A00,895736,Meyerott; Theresa Ann,15,0,15,0
1745829513748,EDS 286,A00,897210,Fine; Sarah,15,0,15,0
1745829514777,EDS 289C,A01,895770,Daly; Alan J.,15,0,15,0
1745829515803,EDS 290,A00,897211,Hofstetter; Carolyn,15,0,15,0
1745829516832,LIGM 5A,A00,896162,Fischer-Grunski; Eva K,15,0,20,5
1745829517858,LIGM 5B,A00,896260,Fischer-Grunski; Eva K,17,0,20,3
1745829518888,LIGM 5C,A00,896308,Fischer-Grunski; Eva K,18,0,20,2
1745829519914,LIIT 5AS,A00,896313,Carnelos; Chiara,17,0,20,3
1745829520942,LIIT 5BS,A00,896416,Carnelos; Chiara,20,0,20,0
1745829521970,LIIT 5CS,A00,896564,Carnelos; Chiara,20,0,20,0
1745829522997,LISP 5A,A00,896588,Munoz Sanchez; Alicia,4,0,20,16
1745829524025,LISP 5B,A00,896653,Munoz Sanchez; Alicia,10,0,20,10
1745829525053,LISP 5C,A00,896655,Munoz Sanchez; Alicia,4,0,20,16
1745829526080,MAE 197,001,957918,Kleissl; Jan,9998,0,9999,1
1745829527110,MATH 2,A01,957937,Staff,34,0,35,1
1745829528137,MATH 197,001,957876,Kedlaya; Kiran S.,9993,0,9999,6
1745829529166,MCWP 40,A00,892729,Duru; Nur,13,0,20,7
1745829529166,MCWP 40,B00,893304,Montejo; Carolina,20,0,20,0
1745829530199,MCWP 40R,A00,893757,Redela; Pamela Morgan,0,7,20,20
1745829531225,MCWP 50,A00,893758,Morshed; Michael James,2,0,20,18
1745829531225,MCWP 50,B00,893761,Bartulis; Jason Michael,18,0,20,2
1745829532270,MCWP 50R,A00,893766,Compas; Sean Matthew,0,1,20,20
1745829532270,MCWP 50R,B00,893769,Carter; Jennifer A,0,0,20,20
1745829532270,MCWP 50R,C00,893771,Krone; Jarret,0,3,20,20
1745829532270,MCWP 50R,D00,893772,Miller; Elizabeth Deen,3,0,20,17
1745829532270,MCWP 50R,E00,893775,Carter; Andrea L,0,0,20,20
1745829533298,MMW 11R,A01,892721,Herbst; Matthew,11,0,27,16
1745829533298,MMW 11R,A02,892722,Herbst; Matthew,0,0,0,3
1745829534326,MMW 12R,A01,892724,Herbst; Matthew,0,10,16,16
1745829534326,MMW 12R,A02,892725,Herbst; Matthew,0,9,16,16
1745829535353,MMW 13R,A01,892727,Staff,0,3,16,16
1745829535353,MMW 13R,A02,892728,Staff,0,4,16,16
1745829535353,MMW 13R,A03,958032,Staff,0,3,16,16
1745829535353,MMW 13R,A04,958033,Staff,0,2,16,16
1745829535353,MMW 13R,A05,958034,Staff,0,3,16,16
1745829536380,SIO 295LS,A00,894015,Staff,7,0,25,18
1745829537410,SIO 295S,A00,894020,Staff,7,0,25,18
1745829538439,SIOC 290S,B01,958918,Staff,0,0,0,0
1745829539471,SIOC 291S,B01,958922,Staff,0,0,0,0
1745829540501,SOCI 117,A01,895339,Staff,4,0,5,1
1745829541526,WES 237B,A00,894149,Staff,11,0,20,9
1745829543608,AESE 279B,A00,891859,Staff,13,0,35,22
1745829544634,AIP 197,001,891854,Staff,70,0,70,0
1745829545667,ANTH 289S,A00,891856,Gagneux; Pascal,12,0,12,0
1745829546693,BENG 196,001,957946,Engler; Adam J.,9996,0,9999,3
1745829547719,CAT 124RS,A01,956906,Staff,8,0,25,17
1745829548745,CAT 125RS,A01,922013,Staff,8,0,25,17
1745829549777,CLRE 250,A00,891860,Morris; Sheldon,9995,0,9999,4
1745829551831,CLRE 251R,A00,907817,Mehta; Ravindra L.,9994,0,9999,5
1745829552861,CLRE 252,A00,891864,Cuomo; Raphael Eduardo,9993,0,9999,6
1745829553890,CLRE 253,A00,891867,Vaida; Florin,9994,0,9999,5
1745829553890,CLRE 253,B00,907819,Staff,9999,0,9999,0
1745829554919,CLRE 259,A00,891868,Patel; Hemal,9998,0,9999,1
1745829555945,CLRE 260,A00,891872,Cuomo; Raphael Eduardo,9999,0,9999,0
1745829556973,CLRE 297,001,891888,Cuomo; Raphael Eduardo,9999,0,9999,0
1745829557999,CSE 191,A00,958773,Minnes Kemp; Mor Mia,9999,0,9999,0
1745829559026,CSS 201S,A01,892054,Mignozzetti; Umberto,30,0,30,0
1745829560051,CSS 202S,A01,892056,Mignozzetti; Umberto,30,0,30,0
1745829561077,DSC 197,001,956898,Eldridge; Justin Matthew,9998,0,9999,1
1745829562105,DSC 297,001,958000,Mazumdar; Arya,9998,0,9999,1
1745829563132,EAP 100,A00,905686,Staff,9776,0,9999,223
1745829564158,ECE 45,A01,892618,Staff,0,13,50,50
1745829565195,ECE 109,A01,892620,Staff,0,43,0,0
1745829566221,ECE 111,A01,892719,Staff,0,9,50,50
1745829567252,ECE 197,001,957920,Mercier; Patrick Philip,9992,0,9999,7
1745829568284,ECON 178,A01,907814,Zhu; Ying,28,0,35,7
1745829569310,EDS 115,A00,895312,Staff,41,0,45,4
1745829570339,EDS 117,A01,895337,Staff,30,0,30,0
1745829571368,EDS 125,A00,895341,Jones; Gabrielle Anastasia,43,0,45,2
1745829572392,EDS 128A,A01,895459,Fargason; Sharon Gayle,44,0,45,1
1745829573422,EDS 128B,A01,895543,Pappas; Elizabeth,44,0,45,1
1745829574453,EDS 139,A00,897203,Pappas; Elizabeth,44,0,45,1
1745829574453,EDS 139,B00,897209,Fargason; Sharon Gayle,44,0,45,1
1745829575480,EDS 201,A00,895545,Staff,43,0,45,2
1745829576506,EDS 203,A01,895581,Halter; Christopher P.,43,0,45,2
1745829577534,EDS 204R,A01,895625,Heinzman; Erica M.,43,0,45,2
1745829577534,EDS 204R,B01,895693,Halter; Christopher P.,18,0,45,27
1745829578561,EDS 206R,A00,895694,Fargason; Sharon Gayle,9,0,30,21
1745829578561,EDS 206R,B00,895695,Choi; Bailey Miyeon,20,0,30,10
1745829579587,EDS 250,A00,895697,Hemans; Patricia Ann Benitez,43,0,45,2
1745829580614,EDS 281,A00,895701,Meyerott; Theresa Ann,15,0,15,0
1745829581639,EDS 284,A00,895736,Meyerott; Theresa Ann,15,0,15,0
1745829582668,EDS 286,A00,897210,Fine; Sarah,15,0,15,0
1745829583692,EDS 289C,A01,895770,Daly; Alan J.,15,0,15,0
1745829584719,EDS 290,A00,897211,Hofstetter; Carolyn,15,0,15,0
1745829585752,LIGM 5A,A00,896162,Fischer-Grunski; Eva K,15,0,20,5
1745829586783,LIGM 5B,A00,896260,Fischer-Grunski; Eva K,17,0,20,3
1745829587810,LIGM 5C,A00,896308,Fischer-Grunski; Eva K,18,0,20,2
1745829588838,LIIT 5AS,A00,896313,Carnelos; Chiara,17,0,20,3
1745829589867,LIIT 5BS,A00,896416,Carnelos; Chiara,20,0,20,0
1745829590897,LIIT 5CS,A00,896564,Carnelos; Chiara,20,0,20,0
1745829591922,LISP 5A,A00,896588,Munoz Sanchez; Alicia,4,0,20,16
1745829592949,LISP 5B,A00,896653,Munoz Sanchez; Alicia,10,0,20,10
1745829593976,LISP 5C,A00,896655,Munoz Sanchez; Alicia,4,0,20,16
1745829595006,MAE 197,001,957918,Kleissl; Jan,9998,0,9999,1
1745829596035,MATH 2,A01,957937,Staff,34,0,35,1
1745829597061,MATH 197,001,957876,Kedlaya; Kiran S.,9993,0,9999,6
1745829598091,MCWP 40,A00,892729,Duru; Nur,13,0,20,7
1745829598091,MCWP 40,B00,893304,Montejo; Carolina,20,0,20,0
1745829599124,MCWP 40R,A00,893757,Redela; Pamela Morgan,0,7,20,20
1745829600150,MCWP 50,A00,893758,Morshed; Michael James,2,0,20,18
1745829600150,MCWP 50,B00,893761,Bartulis; Jason Michael,18,0,20,2
1745829601184,MCWP 50R,A00,893766,Compas; Sean Matthew,0,1,20,20
1745829601184,MCWP 50R,B00,893769,Carter; Jennifer A,0,0,20,20
1745829601184,MCWP 50R,C00,893771,Krone; Jarret,0,3,20,20
1745829601184,MCWP 50R,D00,893772,Miller; Elizabeth Deen,3,0,20,17
1745829601184,MCWP 50R,E00,893775,Carter; Andrea L,0,0,20,20
1745829602210,MMW 11R,A01,892721,Herbst; Matthew,11,0,27,16
1745829602210,MMW 11R,A02,892722,Herbst; Matthew,0,0,0,3
1745829603238,MMW 12R,A01,892724,Herbst; Matthew,0,10,16,16
1745829603238,MMW 12R,A02,892725,Herbst; Matthew,0,9,16,16
1745829604266,MMW 13R,A01,892727,Staff,0,3,16,16
1745829604266,MMW 13R,A02,892728,Staff,0,4,16,16
1745829604266,MMW 13R,A03,958032,Staff,0,3,16,16
1745829604266,MMW 13R,A04,958033,Staff,0,2,16,16
1745829604266,MMW 13R,A05,958034,Staff,0,3,16,16
1745829605292,SIO 295LS,A00,894015,Staff,7,0,25,18
1745829606319,SIO 295S,A00,894020,Staff,7,0,25,18
1745829607350,SIOC 290S,B01,958918,Staff,0,0,0,0
1745829608379,SIOC 291S,B01,958922,Staff,0,0,0,0
1745829609406,SOCI 117,A01,895339,Staff,4,0,5,1
1745829610433,WES 237B,A00,894149,Staff,11,0,20,9
1745829612503,AESE 279B,A00,891859,Staff,13,0,35,22
1745829613529,AIP 197,001,891854,Staff,70,0,70,0
1745829614557,ANTH 289S,A00,891856,Gagneux; Pascal,12,0,12,0
1745829615585,BENG 196,001,957946,Engler; Adam J.,9996,0,9999,3
1745829616611,CAT 124RS,A01,956906,Staff,8,0,25,17
1745829617639,CAT 125RS,A01,922013,Staff,8,0,25,17
1745829618666,CLRE 250,A00,891860,Morris; Sheldon,9995,0,9999,4
1745829620722,CLRE 251R,A00,907817,Mehta; Ravindra L.,9994,0,9999,5
1745829621752,CLRE 252,A00,891864,Cuomo; Raphael Eduardo,9993,0,9999,6
1745829622779,CLRE 253,A00,891867,Vaida; Florin,9994,0,9999,5
1745829622779,CLRE 253,B00,907819,Staff,9999,0,9999,0
1745829623811,CLRE 259,A00,891868,Patel; Hemal,9998,0,9999,1
1745829624839,CLRE 260,A00,891872,Cuomo; Raphael Eduardo,9999,0,9999,0
1745829625867,CLRE 297,001,891888,Cuomo; Raphael Eduardo,9999,0,9999,0
1745829626892,CSE 191,A00,958773,Minnes Kemp; Mor Mia,9999,0,9999,0
1745829627919,CSS 201S,A01,892054,Mignozzetti; Umberto,30,0,30,0
1745829628949,CSS 202S,A01,892056,Mignozzetti; Umberto,30,0,30,0
1745829629979,DSC 197,001,956898,Eldridge; Justin Matthew,9998,0,9999,1
1745829631006,DSC 297,001,958000,Mazumdar; Arya,9998,0,9999,1
1745829632035,EAP 100,A00,905686,Staff,9776,0,9999,223
1745829633063,ECE 45,A01,892618,Staff,0,13,50,50
1745829634089,ECE 109,A01,892620,Staff,0,43,0,0
1745829635116,ECE 111,A01,892719,Staff,0,9,50,50
1745829636141,ECE 197,001,957920,Mercier; Patrick Philip,9992,0,9999,7
1745829637174,ECON 178,A01,907814,Zhu; Ying,28,0,35,7
1745829638202,EDS 115,A00,895312,Staff,41,0,45,4
1745829639229,EDS 117,A01,895337,Staff,30,0,30,0
1745829640257,EDS 125,A00,895341,Jones; Gabrielle Anastasia,43,0,45,2
1745829641283,EDS 128A,A01,895459,Fargason; Sharon Gayle,44,0,45,1
1745829642310,EDS 128B,A01,895543,Pappas; Elizabeth,44,0,45,1
1745829643376,EDS 139,A00,897203,Pappas; Elizabeth,44,0,45,1
1745829643376,EDS 139,B00,897209,Fargason; Sharon Gayle,44,0,45,1
1745829644401,EDS 201,A00,895545,Staff,43,0,45,2
1745829645431,EDS 203,A01,895581,Halter; Christopher P.,43,0,45,2
1745829646462,EDS 204R,A01,895625,Heinzman; Erica M.,43,0,45,2
1745829646462,EDS 204R,B01,895693,Halter; Christopher P.,18,0,45,27
1745829647490,EDS 206R,A00,895694,Fargason; Sharon Gayle,9,0,30,21
1745829647490,EDS 206R,B00,895695,Choi; Bailey Miyeon,20,0,30,10
1745829648521,EDS 250,A00,895697,Hemans; Patricia Ann Benitez,43,0,45,2
1745829649548,EDS 281,A00,895701,Meyerott; Theresa Ann,15,0,15,0
1745829650576,EDS 284,A00,895736,Meyerott; Theresa Ann,15,0,15,0
1745829651617,EDS 286,A00,897210,Fine; Sarah,15,0,15,0
1745829652647,EDS 289C,A01,895770,Daly; Alan J.,15,0,15,0
1745829653675,EDS 290,A00,897211,Hofstetter; Carolyn,15,0,15,0
1745829654729,LIGM 5A,A00,896162,Fischer-Grunski; Eva K,15,0,20,5
1745829655761,LIGM 5B,A00,896260,Fischer-Grunski; Eva K,17,0,20,3
1745829656789,LIGM 5C,A00,896308,Fischer-Grunski; Eva K,18,0,20,2
1745829657818,LIIT 5AS,A00,896313,Carnelos; Chiara,17,0,20,3
1745829658845,LIIT 5BS,A00,896416,Carnelos; Chiara,20,0,20,0
1745829659871,LIIT 5CS,A00,896564,Carnelos; Chiara,20,0,20,0
1745829660904,LISP 5A,A00,896588,Munoz Sanchez; Alicia,4,0,20,16
1745829661936,LISP 5B,A00,896653,Munoz Sanchez; Alicia,10,0,20,10
1745829662969,LISP 5C,A00,896655,Munoz Sanchez; Alicia,4,0,20,16
1745829663996,MAE 197,001,957918,Kleissl; Jan,9998,0,9999,1
1745829665029,MATH 2,A01,957937,Staff,34,0,35,1
1745829666062,MATH 197,001,957876,Kedlaya; Kiran S.,9993,0,9999,6
1745829667090,MCWP 40,A00,892729,Duru; Nur,13,0,20,7
1745829667090,MCWP 40,B00,893304,Montejo; Carolina,20,0,20,0
1745829668120,MCWP 40R,A00,893757,Redela; Pamela Morgan,0,7,20,20
1745829669152,MCWP 50,A00,893758,Morshed; Michael James,2,0,20,18
1745829669152,MCWP 50,B00,893761,Bartulis; Jason Michael,18,0,20,2
1745829670187,MCWP 50R,A00,893766,Compas; Sean Matthew,0,1,20,20
1745829670187,MCWP 50R,B00,893769,Carter; Jennifer A,0,0,20,20
1745829670187,MCWP 50R,C00,893771,Krone; Jarret,0,3,20,20
1745829670187,MCWP 50R,D00,893772,Miller; Elizabeth Deen,3,0,20,17
1745829670187,MCWP 50R,E00,893775,Carter; Andrea L,0,0,20,20
1745829671220,MMW 11R,A01,892721,Herbst; Matthew,11,0,27,16
1745829671220,MMW 11R,A02,892722,Herbst; Matthew,0,0,0,3
1745829672247,MMW 12R,A01,892724,Herbst; Matthew,0,10,16,16
1745829672247,MMW 12R,A02,892725,Herbst; Matthew,0,9,16,16
1745829673277,MMW 13R,A01,892727,Staff,0,3,16,16
1745829673277,MMW 13R,A02,892728,Staff,0,4,16,16
1745829673277,MMW 13R,A03,958032,Staff,0,3,16,16
1745829673277,MMW 13R,A04,958033,Staff,0,2,16,16
1745829673277,MMW 13R,A05,958034,Staff,0,3,16,16
1745829674308,SIO 295LS,A00,894015,Staff,7,0,25,18
1745829675333,SIO 295S,A00,894020,Staff,7,0,25,18
1745829676366,SIOC 290S,B01,958918,Staff,0,0,0,0
1745829677394,SIOC 291S,B01,958922,Staff,0,0,0,0
1745829678420,SOCI 117,A01,895339,Staff,4,0,5,1
1745829679446,WES 237B,A00,894149,Staff,11,0,20,9
1745829681506,AESE 279B,A00,891859,Staff,13,0,35,22
1745829682534,AIP 197,001,891854,Staff,70,0,70,0
1745829683565,ANTH 289S,A00,891856,Gagneux; Pascal,12,0,12,0
1745829684592,BENG 196,001,957946,Engler; Adam J.,9996,0,9999,3
1745829685621,CAT 124RS,A01,956906,Staff,8,0,25,17
1745829686651,CAT 125RS,A01,922013,Staff,8,0,25,17
1745829687679,CLRE 250,A00,891860,Morris; Sheldon,9995,0,9999,4
1745829689736,CLRE 251R,A00,907817,Mehta; Ravindra L.,9994,0,9999,5
1745829690763,CLRE 252,A00,891864,Cuomo; Raphael Eduardo,9993,0,9999,6
1745829691791,CLRE 253,A00,891867,Vaida; Florin,9994,0,9999,5
1745829691791,CLRE 253,B00,907819,Staff,9999,0,9999,0
1745829692818,CLRE 259,A00,891868,Patel; Hemal,9998,0,9999,1
1745829693844,CLRE 260,A00,891872,Cuomo; Raphael Eduardo,9999,0,9999,0
1745829694874,CLRE 297,001,891888,Cuomo; Raphael Eduardo,9999,0,9999,0
1745829695909,CSE 191,A00,958773,Minnes Kemp; Mor Mia,9999,0,9999,0
1745829696943,CSS 201S,A01,892054,Mignozzetti; Umberto,30,0,30,0
1745829697973,CSS 202S,A01,892056,Mignozzetti; Umberto,30,0,30,0
1745829698998,DSC 197,001,956898,Eldridge; Justin Matthew,9998,0,9999,1
1745829700030,DSC 297,001,958000,Mazumdar; Arya,9998,0,9999,1
1745829701060,EAP 100,A00,905686,Staff,9776,0,9999,223
1745829702092,ECE 45,A01,892618,Staff,0,13,50,50
1745829703123,ECE 109,A01,892620,Staff,0,43,0,0
1745829704154,ECE 111,A01,892719,Staff,0,9,50,50
1745829705185,ECE 197,001,957920,Mercier; Patrick Philip,9992,0,9999,7
1745829706214,ECON 178,A01,907814,Zhu; Ying,28,0,35,7
1745829707243,EDS 115,A00,895312,Staff,41,0,45,4
1745829708270,EDS 117,A01,895337,Staff,30,0,30,0
1745829709296,EDS 125,A00,895341,Jones; Gabrielle Anastasia,43,0,45,2
1745829710327,EDS 128A,A01,895459,Fargason; Sharon Gayle,44,0,45,1
1745829711355,EDS 128B,A01,895543,Pappas; Elizabeth,44,0,45,1
1745829712393,EDS 139,A00,897203,Pappas; Elizabeth,44,0,45,1
1745829712393,EDS 139,B00,897209,Fargason; Sharon Gayle,44,0,45,1
1745829713425,EDS 201,A00,895545,Staff,43,0,45,2
1745829714452,EDS 203,A01,895581,Halter; Christopher P.,43,0,45,2
1745829715483,EDS 204R,A01,895625,Heinzman; Erica M.,43,0,45,2
1745829715483,EDS 204R,B01,895693,Halter; Christopher P.,18,0,45,27
1745829716511,EDS 206R,A00,895694,Fargason; Sharon Gayle,9,0,30,21
1745829716511,EDS 206R,B00,895695,Choi; Bailey Miyeon,20,0,30,10
1745829717538,EDS 250,A00,895697,Hemans; Patricia Ann Benitez,43,0,45,2
1745829718568,EDS 281,A00,895701,Meyerott; Theresa Ann,15,0,15,0
1745829719596,EDS 284,A00,895736,Meyerott; Theresa Ann,15,0,15,0
1745829720623,EDS 286,A00,897210,Fine; Sarah,15,0,15,0
1745829721649,EDS 289C,A01,895770,Daly; Alan J.,15,0,15,0
1745829722676,EDS 290,A00,897211,Hofstetter; Carolyn,15,0,15,0
1745829723707,LIGM 5A,A00,896162,Fischer-Grunski; Eva K,15,0,20,5
1745829724741,LIGM 5B,A00,896260,Fischer-Grunski; Eva K,17,0,20,3
1745829725768,LIGM 5C,A00,896308,Fischer-Grunski; Eva K,18,0,20,2
1745829726795,LIIT 5AS,A00,896313,Carnelos; Chiara,17,0,20,3
1745829727827,LIIT 5BS,A00,896416,Carnelos; Chiara,20,0,20,0
1745829728854,LIIT 5CS,A00,896564,Carnelos; Chiara,20,0,20,0
1745829729881,LISP 5A,A00,896588,Munoz Sanchez; Alicia,4,0,20,16
1745829730913,LISP 5B,A00,896653,Munoz Sanchez; Alicia,10,0,20,10
1745829731944,LISP 5C,A00,896655,Munoz Sanchez; Alicia,4,0,20,16
1745829732973,MAE 197,001,957918,Kleissl; Jan,9998,0,9999,1
1745829734005,MATH 2,A01,957937,Staff,34,0,35,1
1745829735034,MATH 197,001,957876,Kedlaya; Kiran S.,9993,0,9999,6
1745829736064,MCWP 40,A00,892729,Duru; Nur,13,0,20,7
1745829736064,MCWP 40,B00,893304,Montejo; Carolina,20,0,20,0
1745829737091,MCWP 40R,A00,893757,Redela; Pamela Morgan,0,7,20,20
1745829738119,MCWP 50,A00,893758,Morshed; Michael James,2,0,20,18
1745829738119,MCWP 50,B00,893761,Bartulis; Jason Michael,18,0,20,2
1745829739152,MCWP 50R,A00,893766,Compas; Sean Matthew,0,1,20,20
1745829739152,MCWP 50R,B00,893769,Carter; Jennifer A,0,0,20,20
1745829739152,MCWP 50R,C00,893771,Krone; Jarret,0,3,20,20
1745829739152,MCWP 50R,D00,893772,Miller; Elizabeth Deen,3,0,20,17
1745829739152,MCWP 50R,E00,893775,Carter; Andrea L,0,0,20,20
1745829740178,MMW 11R,A01,892721,Herbst; Matthew,11,0,27,16
1745829740178,MMW 11R,A02,892722,Herbst; Matthew,0,0,0,3
1745829741209,MMW 12R,A01,892724,Herbst; Matthew,0,10,16,16
1745829741209,MMW 12R,A02,892725,Herbst; Matthew,0,9,16,16
1745829742240,MMW 13R,A01,892727,Staff,0,3,16,16
1745829742240,MMW 13R,A02,892728,Staff,0,4,16,16
1745829742240,MMW 13R,A03,958032,Staff,0,3,16,16
1745829742240,MMW 13R,A04,958033,Staff,0,2,16,16
1745829742240,MMW 13R,A05,958034,Staff,0,3,16,16
1745829743268,SIO 295LS,A00,894015,Staff,7,0,25,18
1745829744294,SIO 295S,A00,894020,Staff,7,0,25,18
1745829745323,SIOC 290S,B01,958918,Staff,0,0,0,0
1745829746355,SIOC 291S,B01,958922,Staff,0,0,0,0
1745829747437,SOCI 117,A01,895339,Staff,4,0,5,1
1745829748464,WES 237B,A00,894149,Staff,11,0,20,9
1745829750542,AESE 279B,A00,891859,Staff,13,0,35,22
1745829751570,AIP 197,001,891854,Staff,70,0,70,0
1745829752602,ANTH 289S,A00,891856,Gagneux; Pascal,12,0,12,0
1745829753634,BENG 196,001,957946,Engler; Adam J.,9996,0,9999,3
1745829754661,CAT 124RS,A01,956906,Staff,8,0,25,17
1745829755690,CAT 125RS,A01,922013,Staff,8,0,25,17
1745829756720,CLRE 250,A00,891860,Morris; Sheldon,9995,0,9999,4
1745829758774,CLRE 251R,A00,907817,Mehta; Ravindra L.,9994,0,9999,5
1745829759804,CLRE 252,A00,891864,Cuomo; Raphael Eduardo,9993,0,9999,6
1745829760833,CLRE 253,A00,891867,Vaida; Florin,9994,0,9999,5
1745829760833,CLRE 253,B00,907819,Staff,9999,0,9999,0
1745829761860,CLRE 259,A00,891868,Patel; Hemal,9998,0,9999,1
1745829762888,CLRE 260,A00,891872,Cuomo; Raphael Eduardo,9999,0,9999,0
1745829763917,CLRE 297,001,891888,Cuomo; Raphael Eduardo,9999,0,9999,0
1745829764943,CSE 191,A00,958773,Minnes Kemp; Mor Mia,9999,0,9999,0
1745829765970,CSS 201S,A01,892054,Mignozzetti; Umberto,30,0,30,0
1745829766998,CSS 202S,A01,892056,Mignozzetti; Umberto,30,0,30,0
1745829768024,DSC 197,001,956898,Eldridge; Justin Matthew,9998,0,9999,1
1745829769053,DSC 297,001,958000,Mazumdar; Arya,9998,0,9999,1
1745829770083,EAP 100,A00,905686,Staff,9776,0,9999,223
1745829771109,ECE 45,A01,892618,Staff,0,13,50,50
1745829772136,ECE 109,A01,892620,Staff,0,43,0,0
1745829773168,ECE 111,A01,892719,Staff,0,9,50,50
1745829774195,ECE 197,001,957920,Mercier; Patrick Philip,9992,0,9999,7
1745829775221,ECON 178,A01,907814,Zhu; Ying,28,0,35,7
1745829776250,EDS 115,A00,895312,Staff,41,0,45,4
1745829777280,EDS 117,A01,895337,Staff,30,0,30,0
1745829778310,EDS 125,A00,895341,Jones; Gabrielle Anastasia,43,0,45,2
1745829779336,EDS 128A,A01,895459,Fargason; Sharon Gayle,44,0,45,1
1745829780367,EDS 128B,A01,895543,Pappas; Elizabeth,44,0,45,1
1745829781398,EDS 139,A00,897203,Pappas; Elizabeth,44,0,45,1
1745829781398,EDS 139,B00,897209,Fargason; Sharon Gayle,44,0,45,1
1745829782431,EDS 201,A00,895545,Staff,43,0,45,2
1745829783460,EDS 203,A01,895581,Halter; Christopher P.,43,0,45,2
1745829784486,EDS 204R,A01,895625,Heinzman; Erica M.,43,0,45,2
1745829784486,EDS 204R,B01,895693,Halter; Christopher P.,18,0,45,27
1745829785512,EDS 206R,A00,895694,Fargason; Sharon Gayle,9,0,30,21
1745829785512,EDS 206R,B00,895695,Choi; Bailey Miyeon,20,0,30,10
1745829786545,EDS 250,A00,895697,Hemans; Patricia Ann Benitez,43,0,45,2
1745829787570,EDS 281,A00,895701,Meyerott; Theresa Ann,15,0,15,0
1745829788597,EDS 284,A00,895736,Meyerott; Theresa Ann,15,0,15,0
1745829789624,EDS 286,A00,897210,Fine; Sarah,15,0,15,0
1745829790656,EDS 289C,A01,895770,Daly; Alan J.,15,0,15,0
1745829791686,EDS 290,A00,897211,Hofstetter; Carolyn,15,0,15,0
1745829792713,LIGM 5A,A00,896162,Fischer-Grunski; Eva K,15,0,20,5
1745829793740,LIGM 5B,A00,896260,Fischer-Grunski; Eva K,17,0,20,3
1745829794769,LIGM 5C,A00,896308,Fischer-Grunski; Eva K,18,0,20,2
1745829795794,LIIT 5AS,A00,896313,Carnelos; Chiara,17,0,20,3
1745829796821,LIIT 5BS,A00,896416,Carnelos; Chiara,20,0,20,0
1745829797848,LIIT 5CS,A00,896564,Carnelos; Chiara,20,0,20,0
1745829798877,LISP 5A,A00,896588,Munoz Sanchez; Alicia,4,0,20,16
1745829799905,LISP 5B,A00,896653,Munoz Sanchez; Alicia,10,0,20,10
1745829800928,LISP 5C,A00,896655,Munoz Sanchez; Alicia,4,0,20,16
1745829801955,MAE 197,001,957918,Kleissl; Jan,9998,0,9999,1
1745829802982,MATH 2,A01,957937,Staff,34,0,35,1
1745829804009,MATH 197,001,957876,Kedlaya; Kiran S.,9993,0,9999,6
1745829805038,MCWP 40,A00,892729,Duru; Nur,13,0,20,7
1745829805038,MCWP 40,B00,893304,Montejo; Carolina,20,0,20,0
1745829806069,MCWP 40R,A00,893757,Redela; Pamela Morgan,0,7,20,20
1745829807096,MCWP 50,A00,893758,Morshed; Michael James,2,0,20,18
1745829807096,MCWP 50,B00,893761,Bartulis; Jason Michael,18,0,20,2
1745829808130,MCWP 50R,A00,893766,Compas; Sean Matthew,0,1,20,20
1745829808130,MCWP 50R,B00,893769,Carter; Jennifer A,0,0,20,20
1745829808130,MCWP 50R,C00,893771,Krone; Jarret,0,3,20,20
1745829808130,MCWP 50R,D00,893772,Miller; Elizabeth Deen,3,0,20,17
1745829808130,MCWP 50R,E00,893775,Carter; Andrea L,0,0,20,20
1745829809159,MMW 11R,A01,892721,Herbst; Matthew,11,0,27,16
1745829809159,MMW 11R,A02,892722,Herbst; Matthew,0,0,0,3
1745829810189,MMW 12R,A01,892724,Herbst; Matthew,0,10,16,16
1745829810189,MMW 12R,A02,892725,Herbst; Matthew,0,9,16,16
1745829811221,MMW 13R,A01,892727,Staff,0,3,16,16
1745829811221,MMW 13R,A02,892728,Staff,0,4,16,16
1745829811221,MMW 13R,A03,958032,Staff,0,3,16,16
1745829811221,MMW 13R,A04,958033,Staff,0,2,16,16
1745829811221,MMW 13R,A05,958034,Staff,0,3,16,16
1745829812250,SIO 295LS,A00,894015,Staff,7,0,25,18
1745829813279,SIO 295S,A00,894020,Staff,7,0,25,18
1745829814333,SIOC 290S,B01,958918,Staff,0,0,0,0
1745829815360,SIOC 291S,B01,958922,Staff,0,0,0,0
1745829816386,SOCI 117,A01,895339,Staff,4,0,5,1
1745829817412,WES 237B,A00,894149,Staff,11,0,20,9
1745829819493,AESE 279B,A00,891859,Staff,13,0,35,22
1745829820518,AIP 197,001,891854,Staff,70,0,70,0
1745829821548,ANTH 289S,A00,891856,Gagneux; Pascal,12,0,12,0
1745829822576,BENG 196,001,957946,Engler; Adam J.,9996,0,9999,3
1745829823603,CAT 124RS,A01,956906,Staff,8,0,25,17
1745829824633,CAT 125RS,A01,922013,Staff,8,0,25,17
1745829825658,CLRE 250,A00,891860,Morris; Sheldon,9995,0,9999,4
1745829827715,CLRE 251R,A00,907817,Mehta; Ravindra L.,9994,0,9999,5
1745829828743,CLRE 252,A00,891864,Cuomo; Raphael Eduardo,9993,0,9999,6
1745829829774,CLRE 253,A00,891867,Vaida; Florin,9994,0,9999,5
1745829829774,CLRE 253,B00,907819,Staff,9999,0,9999,0
1745829830801,CLRE 259,A00,891868,Patel; Hemal,9998,0,9999,1
1745829831825,CLRE 260,A00,891872,Cuomo; Raphael Eduardo,9999,0,9999,0
1745829832851,CLRE 297,001,891888,Cuomo; Raphael Eduardo,9999,0,9999,0
1745829833879,CSE 191,A00,958773,Minnes Kemp; Mor Mia,9999,0,9999,0
1745829834910,CSS 201S,A01,892054,Mignozzetti; Umberto,30,0,30,0
1745829835936,CSS 202S,A01,892056,Mignozzetti; Umberto,30,0,30,0
1745829836966,DSC 197,001,956898,Eldridge; Justin Matthew,9998,0,9999,1
1745829837994,DSC 297,001,958000,Mazumdar; Arya,9998,0,9999,1
1745829839022,EAP 100,A00,905686,Staff,9776,0,9999,223
1745829840051,ECE 45,A01,892618,Staff,0,13,50,50
1745829841080,ECE 109,A01,892620,Staff,0,43,0,0
1745829842107,ECE 111,A01,892719,Staff,0,9,50,50
1745829843134,ECE 197,001,957920,Mercier; Patrick Philip,9992,0,9999,7
1745829844164,ECON 178,A01,907814,Zhu; Ying,28,0,35,7
1745829845191,EDS 115,A00,895312,Staff,41,0,45,4
1745829846216,EDS 117,A01,895337,Staff,30,0,30,0
1745829847247,EDS 125,A00,895341,Jones; Gabrielle Anastasia,43,0,45,2
1745829848273,EDS 128A,A01,895459,Fargason; Sharon Gayle,44,0,45,1
1745829849298,EDS 128B,A01,895543,Pappas; Elizabeth,44,0,45,1
1745829850330,EDS 139,A00,897203,Pappas; Elizabeth,44,0,45,1
1745829850330,EDS 139,B00,897209,Fargason; Sharon Gayle,44,0,45,1
1745829851357,EDS 201,A00,895545,Staff,43,0,45,2
1745829852390,EDS 203,A01,895581,Halter; Christopher P.,43,0,45,2
1745829853422,EDS 204R,A01,895625,Heinzman; Erica M.,43,0,45,2
1745829853422,EDS 204R,B01,895693,Halter; Christopher P.,18,0,45,27
1745829854451,EDS 206R,A00,895694,Fargason; Sharon Gayle,9,0,30,21
1745829854451,EDS 206R,B00,895695,Choi; Bailey Miyeon,20,0,30,10
1745829855479,EDS 250,A00,895697,Hemans; Patricia Ann Benitez,43,0,45,2
1745829856505,EDS 281,A00,895701,Meyerott; Theresa Ann,15,0,15,0
1745829857535,EDS 284,A00,895736,Meyerott; Theresa Ann,15,0,15,0
1745829858565,EDS 286,A00,897210,Fine; Sarah,15,0,15,0
1745829859590,EDS 289C,A01,895770,Daly; Alan J.,15,0,15,0
1745829860616,EDS 290,A00,897211,Hofstetter; Carolyn,15,0,15,0
1745829861644,LIGM 5A,A00,896162,Fischer-Grunski; Eva K,15,0,20,5
1745829862671,LIGM 5B,A00,896260,Fischer-Grunski; Eva K,17,0,20,3
1745829863701,LIGM 5C,A00,896308,Fischer-Grunski; Eva K,18,0,20,2
1745829864732,LIIT 5AS,A00,896313,Carnelos; Chiara,17,0,20,3
1745829865761,LIIT 5BS,A00,896416,Carnelos; Chiara,20,0,20,0
1745829866789,LIIT 5CS,A00,896564,Carnelos; Chiara,20,0,20,0
1745829867820,LISP 5A,A00,896588,Munoz Sanchez; Alicia,4,0,20,16
1745829868846,LISP 5B,A00,896653,Munoz Sanchez; Alicia,10,0,20,10
1745829869878,LISP 5C,A00,896655,Munoz Sanchez; Alicia,4,0,20,16
1745829870909,MAE 197,001,957918,Kleissl; Jan,9998,0,9999,1
1745829871934,MATH 2,A01,957937,Staff,34,0,35,1
1745829872963,MATH 197,001,957876,Kedlaya; Kiran S.,9993,0,9999,6
1745829873994,MCWP 40,A00,892729,Duru; Nur,13,0,20,7
1745829873994,MCWP 40,B00,893304,Montejo; Carolina,20,0,20,0
1745829875025,MCWP 40R,A00,893757,Redela; Pamela Morgan,0,7,20,20
1745829876053,MCWP 50,A00,893758,Morshed; Michael James,2,0,20,18
1745829876053,MCWP 50,B00,893761,Bartulis; Jason Michael,18,0,20,2
1745829877085,MCWP 50R,A00,893766,Compas; Sean Matthew,0,1,20,20
1745829877085,MCWP 50R,B00,893769,Carter; Jennifer A,0,0,20,20
1745829877085,MCWP 50R,C00,893771,Krone; Jarret,0,3,20,20
1745829877085,MCWP 50R,D00,893772,Miller; Elizabeth Deen,3,0,20,17
1745829877085,MCWP 50R,E00,893775,Carter; Andrea L,0,0,20,20
1745829878115,MMW 11R,A01,892721,Herbst; Matthew,11,0,27,16
1745829878115,MMW 11R,A02,892722,Herbst; Matthew,0,0,0,3
1745829879161,MMW 12R,A01,892724,Herbst; Matthew,0,10,16,16
1745829879161,MMW 12R,A02,892725,Herbst; Matthew,0,9,16,16
1745829880186,MMW 13R,A01,892727,Staff,0,3,16,16
1745829880186,MMW 13R,A02,892728,Staff,0,4,16,16
1745829880186,MMW 13R,A03,958032,Staff,0,3,16,16
1745829880186,MMW 13R,A04,958033,Staff,0,2,16,16
1745829880186,MMW 13R,A05,958034,Staff,0,3,16,16
1745829881214,SIO 295LS,A00,894015,Staff,7,0,25,18
1745829882239,SIO 295S,A00,894020,Staff,7,0,25,18
1745829883270,SIOC 290S,B01,958918,Staff,0,0,0,0
1745829884300,SIOC 291S,B01,958922,Staff,0,0,0,0
1745829885328,SOCI 117,A01,895339,Staff,4,0,5,1
1745829886353,WES 237B,A00,894149,Staff,11,0,20,9
1745829888423,AESE 279B,A00,891859,Staff,13,0,35,22
1745829889449,AIP 197,001,891854,Staff,70,0,70,0
1745829890478,ANTH 289S,A00,891856,Gagneux; Pascal,12,0,12,0
1745829891503,BENG 196,001,957946,Engler; Adam J.,9996,0,9999,3
1745829892536,CAT 124RS,A01,956906,Staff,8,0,25,17
1745829893565,CAT 125RS,A01,922013,Staff,8,0,25,17
1745829894591,CLRE 250,A00,891860,Morris; Sheldon,9995,0,9999,4
1745829896646,CLRE 251R,A00,907817,Mehta; Ravindra L.,9994,0,9999,5
1745829897673,CLRE 252,A00,891864,Cuomo; Raphael Eduardo,9993,0,9999,6
1745829898702,CLRE 253,A00,891867,Vaida; Florin,9994,0,9999,5
1745829898702,CLRE 253,B00,907819,Staff,9999,0,9999,0
1745829899733,CLRE 259,A00,891868,Patel; Hemal,9998,0,9999,1
1745829900760,CLRE 260,A00,891872,Cuomo; Raphael Eduardo,9999,0,9999,0
1745829901786,CLRE 297,001,891888,Cuomo; Raphael Eduardo,9999,0,9999,0
1745829902814,CSE 191,A00,958773,Minnes Kemp; Mor Mia,9999,0,9999,0
1745829903840,CSS 201S,A01,892054,Mignozzetti; Umberto,30,0,30,0
1745829904867,CSS 202S,A01,892056,Mignozzetti; Umberto,30,0,30,0
1745829905894,DSC 197,001,956898,Eldridge; Justin Matthew,9998,0,9999,1
1745829906922,DSC 297,001,958000,Mazumdar; Arya,9998,0,9999,1
1745829907948,EAP 100,A00,905686,Staff,9776,0,9999,223
1745829908978,ECE 45,A01,892618,Staff,0,13,50,50
1745829910008,ECE 109,A01,892620,Staff,0,43,0,0
1745829911036,ECE 111,A01,892719,Staff,0,9,50,50
1745829912062,ECE 197,001,957920,Mercier; Patrick Philip,9992,0,9999,7
1745829913095,ECON 178,A01,907814,Zhu; Ying,28,0,35,7
1745829914121,EDS 115,A00,895312,Staff,41,0,45,4
1745829915148,EDS 117,A01,895337,Staff,30,0,30,0
1745829916178,EDS 125,A00,895341,Jones; Gabrielle Anastasia,43,0,45,2
1745829917204,EDS 128A,A01,895459,Fargason; Sharon Gayle,44,0,45,1
1745829918234,EDS 128B,A01,895543,Pappas; Elizabeth,44,0,45,1
1745829919264,EDS 139,A00,897203,Pappas; Elizabeth,44,0,45,1
1745829919264,EDS 139,B00,897209,Fargason; Sharon Gayle,44,0,45,1
1745829920291,EDS 201,A00,895545,Staff,43,0,45,2
1745829921317,EDS 203,A01,895581,Halter; Christopher P.,43,0,45,2
1745829922347,EDS 204R,A01,895625,Heinzman; Erica M.,43,0,45,2
1745829922347,EDS 204R,B01,895693,Halter; Christopher P.,18,0,45,27
1745829923373,EDS 206R,A00,895694,Fargason; Sharon Gayle,9,0,30,21
1745829923373,EDS 206R,B00,895695,Choi; Bailey Miyeon,20,0,30,10
1745829924402,EDS 250,A00,895697,Hemans; Patricia Ann Benitez,43,0,45,2
1745829925431,EDS 281,A00,895701,Meyerott; Theresa Ann,15,0,15,0
1745829926460,EDS 284,A00,895736,Meyerott; Theresa Ann,15,0,15,0
1745829927490,EDS 286,A00,897210,Fine; Sarah,15,0,15,0
1745829928516,EDS 289C,A01,895770,Daly; Alan J.,15,0,15,0
1745829929545,EDS 290,A00,897211,Hofstetter; Carolyn,15,0,15,0
1745829930573,LIGM 5A,A00,896162,Fischer-Grunski; Eva K,15,0,20,5
1745829931602,LIGM 5B,A00,896260,Fischer-Grunski; Eva K,17,0,20,3
1745829932629,LIGM 5C,A00,896308,Fischer-Grunski; Eva K,18,0,20,2
1745829933655,LIIT 5AS,A00,896313,Carnelos; Chiara,17,0,20,3
1745829934681,LIIT 5BS,A00,896416,Carnelos; Chiara,20,0,20,0
1745829935707,LIIT 5CS,A00,896564,Carnelos; Chiara,20,0,20,0
1745829936738,LISP 5A,A00,896588,Munoz Sanchez; Alicia,4,0,20,16
1745829937767,LISP 5B,A00,896653,Munoz Sanchez; Alicia,10,0,20,10
1745829938794,LISP 5C,A00,896655,Munoz Sanchez; Alicia,4,0,20,16
1745829939820,MAE 197,001,957918,Kleissl; Jan,9998,0,9999,1
1745829940851,MATH 2,A01,957937,Staff,34,0,35,1
1745829941879,MATH 197,001,957876,Kedlaya; Kiran S.,9993,0,9999,6
1745829942908,MCWP 40,A00,892729,Duru; Nur,13,0,20,7
1745829942908,MCWP 40,B00,893304,Montejo; Carolina,20,0,20,0
1745829943934,MCWP 40R,A00,893757,Redela; Pamela Morgan,0,7,20,20
1745829944964,MCWP 50,A00,893758,Morshed; Michael James,2,0,20,18
1745829944964,MCWP 50,B00,893761,Bartulis; Jason Michael,18,0,20,2
1745829945993,MCWP 50R,A00,893766,Compas; Sean Matthew,0,1,20,20
1745829945993,MCWP 50R,B00,893769,Carter; Jennifer A,0,0,20,20
1745829945993,MCWP 50R,C00,893771,Krone; Jarret,0,3,20,20
1745829945993,MCWP 50R,D00,893772,Miller; Elizabeth Deen,3,0,20,17
1745829945993,MCWP 50R,E00,893775,Carter; Andrea L,0,0,20,20
1745829947021,MMW 11R,A01,892721,Herbst; Matthew,11,0,27,16
1745829947021,MMW 11R,A02,892722,Herbst; Matthew,0,0,0,3
1745829948046,MMW 12R,A01,892724,Herbst; Matthew,0,10,16,16
1745829948046,MMW 12R,A02,892725,Herbst; Matthew,0,9,16,16
1745829949078,MMW 13R,A01,892727,Staff,0,3,16,16
1745829949078,MMW 13R,A02,892728,Staff,0,4,16,16
1745829949078,MMW 13R,A03,958032,Staff,0,3,16,16
1745829949078,MMW 13R,A04,958033,Staff,0,2,16,16
1745829949078,MMW 13R,A05,958034,Staff,0,3,16,16
1745829950107,SIO 295LS,A00,894015,Staff,7,0,25,18
1745829951136,SIO 295S,A00,894020,Staff,7,0,25,18
1745829952166,SIOC 290S,B01,958918,Staff,0,0,0,0
1745829953197,SIOC 291S,B01,958922,Staff,0,0,0,0
1745829954225,SOCI 117,A01,895339,Staff,4,0,5,1
1745829955254,WES 237B,A00,894149,Staff,11,0,20,9
1745829957358,AESE 279B,A00,891859,Staff,13,0,35,22
1745829958387,AIP 197,001,891854,Staff,70,0,70,0
1745829959413,ANTH 289S,A00,891856,Gagneux; Pascal,12,0,12,0
1745829960439,BENG 196,001,957946,Engler; Adam J.,9996,0,9999,3
1745829961469,CAT 124RS,A01,956906,Staff,8,0,25,17
1745829962500,CAT 125RS,A01,922013,Staff,8,0,25,17
1745829963528,CLRE 250,A00,891860,Morris; Sheldon,9995,0,9999,4
1745829965584,CLRE 251R,A00,907817,Mehta; Ravindra L.,9994,0,9999,5
1745829966610,CLRE 252,A00,891864,Cuomo; Raphael Eduardo,9993,0,9999,6
1745829967637,CLRE 253,A00,891867,Vaida; Florin,9994,0,9999,5
1745829967637,CLRE 253,B00,907819,Staff,9999,0,9999,0
1745829968667,CLRE 259,A00,891868,Patel; Hemal,9998,0,9999,1
1745829969698,CLRE 260,A00,891872,Cuomo; Raphael Eduardo,9999,0,9999,0
1745829970723,CLRE 297,001,891888,Cuomo; Raphael Eduardo,9999,0,9999,0
1745829971755,CSE 191,A00,958773,Minnes Kemp; Mor Mia,9999,0,9999,0
1745829972781,CSS 201S,A01,892054,Mignozzetti; Umberto,30,0,30,0
1745829973812,CSS 202S,A01,892056,Mignozzetti; Umberto,30,0,30,0
1745829974839,DSC 197,001,956898,Eldridge; Justin Matthew,9998,0,9999,1
1745829975872,DSC 297,001,958000,Mazumdar; Arya,9998,0,9999,1
1745829976899,EAP 100,A00,905686,Staff,9776,0,9999,223
1745829977925,ECE 45,A01,892618,Staff,0,13,50,50
1745829978952,ECE 109,A01,892620,Staff,0,43,0,0
1745829979983,ECE 111,A01,892719,Staff,0,9,50,50
1745829981012,ECE 197,001,957920,Mercier; Patrick Philip,9992,0,9999,7
1745829982040,ECON 178,A01,907814,Zhu; Ying,28,0,35,7
1745829983072,EDS 115,A00,895312,Staff,41,0,45,4
1745829984103,EDS 117,A01,895337,Staff,30,0,30,0
1745829985129,EDS 125,A00,895341,Jones; Gabrielle Anastasia,43,0,45,2
1745829986157,EDS 128A,A01,895459,Fargason; Sharon Gayle,44,0,45,1
1745829987188,EDS 128B,A01,895543,Pappas; Elizabeth,44,0,45,1
1745829988216,EDS 139,A00,897203,Pappas; Elizabeth,44,0,45,1
1745829988216,EDS 139,B00,897209,Fargason; Sharon Gayle,44,0,45,1
1745829989244,EDS 201,A00,895545,Staff,43,0,45,2
1745829990271,EDS 203,A01,895581,Halter; Christopher P.,43,0,45,2
1745829991304,EDS 204R,A01,895625,Heinzman; Erica M.,43,0,45,2
1745829991304,EDS 204R,B01,895693,Halter; Christopher P.,18,0,45,27
1745829992335,EDS 206R,A00,895694,Fargason; Sharon Gayle,9,0,30,21
1745829992335,EDS 206R,B00,895695,Choi; Bailey Miyeon,20,0,30,10
1745829993362,EDS 250,A00,895697,Hemans; Patricia Ann Benitez,43,0,45,2
1745829994393,EDS 281,A00,895701,Meyerott; Theresa Ann,15,0,15,0
1745829995421,EDS 284,A00,895736,Meyerott; Theresa Ann,15,0,15,0
1745829996448,EDS 286,A00,897210,Fine; Sarah,15,0,15,0
1745829997476,EDS 289C,A01,895770,Daly; Alan J.,15,0,15,0
1745829998502,EDS 290,A00,897211,Hofstetter; Carolyn,15,0,15,0
1745829999532,LIGM 5A,A00,896162,Fischer-Grunski; Eva K,15,0,20,5
1745830000564,LIGM 5B,A00,896260,Fischer-Grunski; Eva K,17,0,20,3
1745830001595,LIGM 5C,A00,896308,Fischer-Grunski; Eva K,18,0,20,2
1745830002633,LIIT 5AS,A00,896313,Carnelos; Chiara,17,0,20,3
1745830003663,LIIT 5BS,A00,896416,Carnelos; Chiara,20,0,20,0
1745830004697,LIIT 5CS,A00,896564,Carnelos; Chiara,20,0,20,0
1745830005726,LISP 5A,A00,896588,Munoz Sanchez; Alicia,4,0,20,16
1745830006758,LISP 5B,A00,896653,Munoz Sanchez; Alicia,10,0,20,10
1745830007786,LISP 5C,A00,896655,Munoz Sanchez; Alicia,4,0,20,16
1745830008817,MAE 197,001,957918,Kleissl; Jan,9998,0,9999,1
1745830009846,MATH 2,A01,957937,Staff,34,0,35,1
1745830010878,MATH 197,001,957876,Kedlaya; Kiran S.,9993,0,9999,6
1745830011904,MCWP 40,A00,892729,Duru; Nur,13,0,20,7
1745830011904,MCWP 40,B00,893304,Montejo; Carolina,20,0,20,0
1745830012931,MCWP 40R,A00,893757,Redela; Pamela Morgan,0,7,20,20
1745830013957,MCWP 50,A00,893758,Morshed; Michael James,2,0,20,18
1745830013957,MCWP 50,B00,893761,Bartulis; Jason Michael,18,0,20,2
1745830014985,MCWP 50R,A00,893766,Compas; Sean Matthew,0,1,20,20
1745830014985,MCWP 50R,B00,893769,Carter; Jennifer A,0,0,20,20
1745830014985,MCWP 50R,C00,893771,Krone; Jarret,0,3,20,20
1745830014985,MCWP 50R,D00,893772,Miller; Elizabeth Deen,3,0,20,17
1745830014985,MCWP 50R,E00,893775,Carter; Andrea L,0,0,20,20
1745830016012,MMW 11R,A01,892721,Herbst; Matthew,11,0,27,16
1745830016012,MMW 11R,A02,892722,Herbst; Matthew,0,0,0,3
1745830017040,MMW 12R,A01,892724,Herbst; Matthew,0,10,16,16
1745830017040,MMW 12R,A02,892725,Herbst; Matthew,0,9,16,16
1745830018067,MMW 13R,A01,892727,Staff,0,3,16,16
1745830018067,MMW 13R,A02,892728,Staff,0,4,16,16
1745830018067,MMW 13R,A03,958032,Staff,0,3,16,16
1745830018067,MMW 13R,A04,958033,Staff,0,2,16,16
1745830018067,MMW 13R,A05,958034,Staff,0,3,16,16
1745830019095,SIO 295LS,A00,894015,Staff,7,0,25,18
1745830020123,SIO 295S,A00,894020,Staff,7,0,25,18
1745830021150,SIOC 290S,B01,958918,Staff,0,0,0,0
1745830022186,SIOC 291S,B01,958922,Staff,0,0,0,0
1745830023218,SOCI 117,A01,895339,Staff,4,0,5,1
1745830024244,WES 237B,A00,894149,Staff,11,0,20,9
1745830026356,AESE 279B,A00,891859,Staff,13,0,35,22
1745830027383,AIP 197,001,891854,Staff,70,0,70,0
1745830028413,ANTH 289S,A00,891856,Gagneux; Pascal,12,0,12,0
1745830029440,BENG 196,001,957946,Engler; Adam J.,9996,0,9999,3
1745830030467,CAT 124RS,A01,956906,Staff,8,0,25,17
1745830031496,CAT 125RS,A01,922013,Staff,8,0,25,17
1745830032521,CLRE 250,A00,891860,Morris; Sheldon,9995,0,9999,4
1745830034575,CLRE 251R,A00,907817,Mehta; Ravindra L.,9994,0,9999,5
1745830035602,CLRE 252,A00,891864,Cuomo; Raphael Eduardo,9993,0,9999,6
1745830036628,CLRE 253,A00,891867,Vaida; Florin,9994,0,9999,5
1745830036628,CLRE 253,B00,907819,Staff,9999,0,9999,0
1745830037659,CLRE 259,A00,891868,Patel; Hemal,9998,0,9999,1
1745830038685,CLRE 260,A00,891872,Cuomo; Raphael Eduardo,9999,0,9999,0
1745830039712,CLRE 297,001,891888,Cuomo; Raphael Eduardo,9999,0,9999,0
1745830040741,CSE 191,A00,958773,Minnes Kemp; Mor Mia,9999,0,9999,0
1745830041776,CSS 201S,A01,892054,Mignozzetti; Umberto,30,0,30,0
1745830042807,CSS 202S,A01,892056,Mignozzetti; Umberto,30,0,30,0
1745830043834,DSC 197,001,956898,Eldridge; Justin Matthew,9998,0,9999,1
1745830044865,DSC 297,001,958000,Mazumdar; Arya,9998,0,9999,1
1745830045896,EAP 100,A00,905686,Staff,9776,0,9999,223
1745830046924,ECE 45,A01,892618,Staff,0,13,50,50
1745830047951,ECE 109,A01,892620,Staff,0,43,0,0
1745830048980,ECE 111,A01,892719,Staff,0,9,50,50
1745830050008,ECE 197,001,957920,Mercier; Patrick Philip,9992,0,9999,7
1745830051034,ECON 178,A01,907814,Zhu; Ying,28,0,35,7
1745830052060,EDS 115,A00,895312,Staff,41,0,45,4
1745830053086,EDS 117,A01,895337,Staff,30,0,30,0
1745830054114,EDS 125,A00,895341,Jones; Gabrielle Anastasia,43,0,45,2
1745830055142,EDS 128A,A01,895459,Fargason; Sharon Gayle,44,0,45,1
1745830056173,EDS 128B,A01,895543,Pappas; Elizabeth,44,0,45,1
1745830057200,EDS 139,A00,897203,Pappas; Elizabeth,44,0,45,1
1745830057200,EDS 139,B00,897209,Fargason; Sharon Gayle,44,0,45,1
1745830058227,EDS 201,A00,895545,Staff,43,0,45,2
1745830059259,EDS 203,A01,895581,Halter; Christopher P.,43,0,45,2
1745830060285,EDS 204R,A01,895625,Heinzman; Erica M.,43,0,45,2
1745830060285,EDS 204R,B01,895693,Halter; Christopher P.,18,0,45,27
1745830061314,EDS 206R,A00,895694,Fargason; Sharon Gayle,9,0,30,21
1745830061314,EDS 206R,B00,895695,Choi; Bailey Miyeon,20,0,30,10
1745830062341,EDS 250,A00,895697,Hemans; Patricia Ann Benitez,43,0,45,2
1745830063368,EDS 281,A00,895701,Meyerott; Theresa Ann,15,0,15,0
1745830064397,EDS 284,A00,895736,Meyerott; Theresa Ann,15,0,15,0
1745830065426,EDS 286,A00,897210,Fine; Sarah,15,0,15,0
1745830066454,EDS 289C,A01,895770,Daly; Alan J.,15,0,15,0
1745830067483,EDS 290,A00,897211,Hofstetter; Carolyn,15,0,15,0
1745830068511,LIGM 5A,A00,896162,Fischer-Grunski; Eva K,15,0,20,5
1745830069539,LIGM 5B,A00,896260,Fischer-Grunski; Eva K,17,0,20,3
1745830070564,LIGM 5C,A00,896308,Fischer-Grunski; Eva K,18,0,20,2
1745830071590,LIIT 5AS,A00,896313,Carnelos; Chiara,17,0,20,3
1745830072619,LIIT 5BS,A00,896416,Carnelos; Chiara,20,0,20,0
1745830073649,LIIT 5CS,A00,896564,Carnelos; Chiara,20,0,20,0
1745830074678,LISP 5A,A00,896588,Munoz Sanchez; Alicia,4,0,20,16
1745830075701,LISP 5B,A00,896653,Munoz Sanchez; Alicia,10,0,20,10
1745830076727,LISP 5C,A00,896655,Munoz Sanchez; Alicia,4,0,20,16
1745830077757,MAE 197,001,957918,Kleissl; Jan,9998,0,9999,1
1745830078785,MATH 2,A01,957937,Staff,34,0,35,1
1745830079811,MATH 197,001,957876,Kedlaya; Kiran S.,9993,0,9999,6
1745830080842,MCWP 40,A00,892729,Duru; Nur,13,0,20,7
1745830080842,MCWP 40,B00,893304,Montejo; Carolina,20,0,20,0
1745830081872,MCWP 40R,A00,893757,Redela; Pamela Morgan,0,7,20,20
1745830082898,MCWP 50,A00,893758,Morshed; Michael James,2,0,20,18
1745830082898,MCWP 50,B00,893761,Bartulis; Jason Michael,18,0,20,2
1745830083928,MCWP 50R,A00,893766,Compas; Sean Matthew,0,1,20,20
1745830083928,MCWP 50R,B00,893769,Carter; Jennifer A,0,0,20,20
1745830083928,MCWP 50R,C00,893771,Krone; Jarret,0,3,20,20
1745830083928,MCWP 50R,D00,893772,Miller; Elizabeth Deen,3,0,20,17
1745830083928,MCWP 50R,E00,893775,Carter; Andrea L,0,0,20,20
1745830084954,MMW 11R,A01,892721,Herbst; Matthew,11,0,27,16
1745830084954,MMW 11R,A02,892722,Herbst; Matthew,0,0,0,3
1745830085982,MMW 12R,A01,892724,Herbst; Matthew,0,10,16,16
1745830085982,MMW 12R,A02,892725,Herbst; Matthew,0,9,16,16
1745830087006,MMW 13R,A01,892727,Staff,0,3,16,16
1745830087006,MMW 13R,A02,892728,Staff,0,4,16,16
1745830087006,MMW 13R,A03,958032,Staff,0,3,16,16
1745830087006,MMW 13R,A04,958033,Staff,0,2,16,16
1745830087006,MMW 13R,A05,958034,Staff,0,3,16,16
1745830088032,SIO 295LS,A00,894015,Staff,7,0,25,18
1745830089060,SIO 295S,A00,894020,Staff,7,0,25,18
1745830090088,SIOC 290S,B01,958918,Staff,0,0,0,0
1745830091114,SIOC 291S,B01,958922,Staff,0,0,0,0
1745830092143,SOCI 117,A01,895339,Staff,4,0,5,1
1745830093169,WES 237B,A00,894149,Staff,11,0,20,9
1745830095256,AESE 279B,A00,891859,Staff,13,0,35,22
1745830096282,AIP 197,001,891854,Staff,70,0,70,0
1745830097314,ANTH 289S,A00,891856,Gagneux; Pascal,12,0,12,0
1745830098340,BENG 196,001,957946,Engler; Adam J.,9996,0,9999,3
1745830099367,CAT 124RS,A01,956906,Staff,8,0,25,17
1745830100395,CAT 125RS,A01,922013,Staff,8,0,25,17
1745830101422,CLRE 250,A00,891860,Morris; Sheldon,9995,0,9999,4
1745830103480,CLRE 251R,A00,907817,Mehta; Ravindra L.,9994,0,9999,5
1745830104507,CLRE 252,A00,891864,Cuomo; Raphael Eduardo,9993,0,9999,6
1745830105535,CLRE 253,A00,891867,Vaida; Florin,9994,0,9999,5
1745830105535,CLRE 253,B00,907819,Staff,9999,0,9999,0
1745830106564,CLRE 259,A00,891868,Patel; Hemal,9998,0,9999,1
1745830107591,CLRE 260,A00,891872,Cuomo; Raphael Eduardo,9999,0,9999,0
1745830108617,CLRE 297,001,891888,Cuomo; Raphael Eduardo,9999,0,9999,0
1745830109644,CSE 191,A00,958773,Minnes Kemp; Mor Mia,9999,0,9999,0
1745830110671,CSS 201S,A01,892054,Mignozzetti; Umberto,30,0,30,0
1745830111696,CSS 202S,A01,892056,Mignozzetti; Umberto,30,0,30,0
1745830112745,DSC 197,001,956898,Eldridge; Justin Matthew,9998,0,9999,1
1745830113772,DSC 297,001,958000,Mazumdar; Arya,9998,0,9999,1
1745830114797,EAP 100,A00,905686,Staff,9776,0,9999,223
1745830115828,ECE 45,A01,892618,Staff,0,13,50,50
1745830116859,ECE 109,A01,892620,Staff,0,43,0,0
1745830117885,ECE 111,A01,892719,Staff,0,9,50,50
1745830118911,ECE 197,001,957920,Mercier; Patrick Philip,9992,0,9999,7
1745830119938,ECON 178,A01,907814,Zhu; Ying,28,0,35,7
1745830120964,EDS 115,A00,895312,Staff,41,0,45,4
1745830121990,EDS 117,A01,895337,Staff,30,0,30,0
1745830123020,EDS 125,A00,895341,Jones; Gabrielle Anastasia,43,0,45,2
1745830124054,EDS 128A,A01,895459,Fargason; Sharon Gayle,44,0,45,1
1745830125082,EDS 128B,A01,895543,Pappas; Elizabeth,44,0,45,1
1745830126109,EDS 139,A00,897203,Pappas; Elizabeth,44,0,45,1
1745830126109,EDS 139,B00,897209,Fargason; Sharon Gayle,44,0,45,1
1745830127135,EDS 201,A00,895545,Staff,43,0,45,2
1745830128161,EDS 203,A01,895581,Halter; Christopher P.,43,0,45,2
1745830129189,EDS 204R,A01,895625,Heinzman; Erica M.,43,0,45,2
1745830129189,EDS 204R,B01,895693,Halter; Christopher P.,18,0,45,27
1745830130257,EDS 206R,A00,895694,Fargason; Sharon Gayle,9,0,30,21
1745830130257,EDS 206R,B00,895695,Choi; Bailey Miyeon,20,0,30,10
1745830131284,EDS 250,A00,895697,Hemans; Patricia Ann Benitez,43,0,45,2
1745830132310,EDS 281,A00,895701,Meyerott; Theresa Ann,15,0,15,0
1745830133337,EDS 284,A00,895736,Meyerott; Theresa Ann,15,0,15,0
1745830134362,EDS 286,A00,897210,Fine; Sarah,15,0,15,0
1745830135388,EDS 289C,A01,895770,Daly; Alan J.,15,0,15,0
1745830136417,EDS 290,A00,897211,Hofstetter; Carolyn,15,0,15,0
1745830137445,LIGM 5A,A00,896162,Fischer-Grunski; Eva K,15,0,20,5
1745830138475,LIGM 5B,A00,896260,Fischer-Grunski; Eva K,17,0,20,3
1745830139506,LIGM 5C,A00,896308,Fischer-Grunski; Eva K,18,0,20,2
1745830140538,LIIT 5AS,A00,896313,Carnelos; Chiara,17,0,20,3
1745830141566,LIIT 5BS,A00,896416,Carnelos; Chiara,20,0,20,0
1745830142599,LIIT 5CS,A00,896564,Carnelos; Chiara,20,0,20,0
1745830143627,LISP 5A,A00,896588,Munoz Sanchez; Alicia,4,0,20,16
1745830144674,LISP 5B,A00,896653,Munoz Sanchez; Alicia,10,0,20,10
1745830145704,LISP 5C,A00,896655,Munoz Sanchez; Alicia,4,0,20,16
1745830146736,MAE 197,001,957918,Kleissl; Jan,9998,0,9999,1
1745830147768,MATH 2,A01,957937,Staff,34,0,35,1
1745830148800,MATH 197,001,957876,Kedlaya; Kiran S.,9993,0,9999,6
1745830149829,MCWP 40,A00,892729,Duru; Nur,13,0,20,7
1745830149829,MCWP 40,B00,893304,Montejo; Carolina,20,0,20,0
1745830150856,MCWP 40R,A00,893757,Redela; Pamela Morgan,0,7,20,20
1745830151882,MCWP 50,A00,893758,Morshed; Michael James,2,0,20,18
1745830151882,MCWP 50,B00,893761,Bartulis; Jason Michael,18,0,20,2
1745830152915,MCWP 50R,A00,893766,Compas; Sean Matthew,0,1,20,20
1745830152915,MCWP 50R,B00,893769,Carter; Jennifer A,0,0,20,20
1745830152915,MCWP 50R,C00,893771,Krone; Jarret,0,3,20,20
1745830152915,MCWP 50R,D00,893772,Miller; Elizabeth Deen,3,0,20,17
1745830152915,MCWP 50R,E00,893775,Carter; Andrea L,0,0,20,20
1745830153942,MMW 11R,A01,892721,Herbst; Matthew,11,0,27,16
1745830153942,MMW 11R,A02,892722,Herbst; Matthew,0,0,0,3
1745830154969,MMW 12R,A01,892724,Herbst; Matthew,0,10,16,16
1745830154969,MMW 12R,A02,892725,Herbst; Matthew,0,9,16,16
1745830155996,MMW 13R,A01,892727,Staff,0,3,16,16
1745830155996,MMW 13R,A02,892728,Staff,0,4,16,16
1745830155996,MMW 13R,A03,958032,Staff,0,3,16,16
1745830155996,MMW 13R,A04,958033,Staff,0,2,16,16
1745830155996,MMW 13R,A05,958034,Staff,0,3,16,16
1745830157022,SIO 295LS,A00,894015,Staff,7,0,25,18
1745830158050,SIO 295S,A00,894020,Staff,7,0,25,18
1745830159080,SIOC 290S,B01,958918,Staff,0,0,0,0
1745830160106,SIOC 291S,B01,958922,Staff,0,0,0,0
1745830161131,SOCI 117,A01,895339,Staff,4,0,5,1
1745830162160,WES 237B,A00,894149,Staff,11,0,20,9
1745830164258,AESE 279B,A00,891859,Staff,13,0,35,22
1745830165285,AIP 197,001,891854,Staff,70,0,70,0
1745830166313,ANTH 289S,A00,891856,Gagneux; Pascal,12,0,12,0
1745830167339,BENG 196,001,957946,Engler; Adam J.,9996,0,9999,3
1745830168367,CAT 124RS,A01,956906,Staff,8,0,25,17
1745830169395,CAT 125RS,A01,922013,Staff,8,0,25,17
1745830170423,CLRE 250,A00,891860,Morris; Sheldon,9995,0,9999,4
1745830172475,CLRE 251R,A00,907817,Mehta; Ravindra L.,9994,0,9999,5
1745830173506,CLRE 252,A00,891864,Cuomo; Raphael Eduardo,9993,0,9999,6
1745830174536,CLRE 253,A00,891867,Vaida; Florin,9994,0,9999,5
1745830174536,CLRE 253,B00,907819,Staff,9999,0,9999,0
1745830175563,CLRE 259,A00,891868,Patel; Hemal,9998,0,9999,1
1745830176590,CLRE 260,A00,891872,Cuomo; Raphael Eduardo,9999,0,9999,0
1745830177615,CLRE 297,001,891888,Cuomo; Raphael Eduardo,9999,0,9999,0
1745830178648,CSE 191,A00,958773,Minnes Kemp; Mor Mia,9999,0,9999,0
1745830179675,CSS 201S,A01,892054,Mignozzetti; Umberto,30,0,30,0
1745830180702,CSS 202S,A01,892056,Mignozzetti; Umberto,30,0,30,0
1745830181731,DSC 197,001,956898,Eldridge; Justin Matthew,9998,0,9999,1
1745830182762,DSC 297,001,958000,Mazumdar; Arya,9998,0,9999,1
1745830183789,EAP 100,A00,905686,Staff,9776,0,9999,223
1745830184816,ECE 45,A01,892618,Staff,0,13,50,50
1745830185841,ECE 109,A01,892620,Staff,0,43,0,0
1745830186872,ECE 111,A01,892719,Staff,0,9,50,50
1745830187902,ECE 197,001,957920,Mercier; Patrick Philip,9992,0,9999,7
1745830188937,ECON 178,A01,907814,Zhu; Ying,28,0,35,7
1745830189963,EDS 115,A00,895312,Staff,41,0,45,4
1745830190992,EDS 117,A01,895337,Staff,30,0,30,0
1745830192023,EDS 125,A00,895341,Jones; Gabrielle Anastasia,43,0,45,2
1745830193056,EDS 128A,A01,895459,Fargason; Sharon Gayle,44,0,45,1
1745830194081,EDS 128B,A01,895543,Pappas; Elizabeth,44,0,45,1
1745830195111,EDS 139,A00,897203,Pappas; Elizabeth,44,0,45,1
1745830195111,EDS 139,B00,897209,Fargason; Sharon Gayle,44,0,45,1
1745830196138,EDS 201,A00,895545,Staff,43,0,45,2
1745830197163,EDS 203,A01,895581,Halter; Christopher P.,43,0,45,2
1745830198192,EDS 204R,A01,895625,Heinzman; Erica M.,43,0,45,2
1745830198192,EDS 204R,B01,895693,Halter; Christopher P.,18,0,45,27
1745830199220,EDS 206R,A00,895694,Fargason; Sharon Gayle,9,0,30,21
1745830199220,EDS 206R,B00,895695,Choi; Bailey Miyeon,20,0,30,10
1745830200248,EDS 250,A00,895697,Hemans; Patricia Ann Benitez,43,0,45,2
1745830201274,EDS 281,A00,895701,Meyerott; Theresa Ann,15,0,15,0
1745830202301,EDS 284,A00,895736,Meyerott; Theresa Ann,15,0,15,0
1745830203326,EDS 286,A00,897210,Fine; Sarah,15,0,15,0
1745830204362,EDS 289C,A01,895770,Daly; Alan J.,15,0,15,0
1745830205391,EDS 290,A00,897211,Hofstetter; Carolyn,15,0,15,0
1745830206424,LIGM 5A,A00,896162,Fischer-Grunski; Eva K,15,0,20,5
1745830207449,LIGM 5B,A00,896260,Fischer-Grunski; Eva K,17,0,20,3
1745830208475,LIGM 5C,A00,896308,Fischer-Grunski; Eva K,18,0,20,2
1745830209503,LIIT 5AS,A00,896313,Carnelos; Chiara,17,0,20,3
1745830210529,LIIT 5BS,A00,896416,Carnelos; Chiara,20,0,20,0
1745830211555,LIIT 5CS,A00,896564,Carnelos; Chiara,20,0,20,0
1745830212581,LISP 5A,A00,896588,Munoz Sanchez; Alicia,4,0,20,16
1745830213605,LISP 5B,A00,896653,Munoz Sanchez; Alicia,10,0,20,10
1745830214634,LISP 5C,A00,896655,Munoz Sanchez; Alicia,4,0,20,16
1745830215662,MAE 197,001,957918,Kleissl; Jan,9998,0,9999,1
1745830216690,MATH 2,A01,957937,Staff,34,0,35,1
1745830217719,MATH 197,001,957876,Kedlaya; Kiran S.,9993,0,9999,6
1745830218746,MCWP 40,A00,892729,Duru; Nur,13,0,20,7
1745830218746,MCWP 40,B00,893304,Montejo; Carolina,20,0,20,0
1745830219778,MCWP 40R,A00,893757,Redela; Pamela Morgan,0,7,20,20
1745830220803,MCWP 50,A00,893758,Morshed; Michael James,2,0,20,18
1745830220803,MCWP 50,B00,893761,Bartulis; Jason Michael,18,0,20,2
1745830221836,MCWP 50R,A00,893766,Compas; Sean Matthew,0,1,20,20
1745830221836,MCWP 50R,B00,893769,Carter; Jennifer A,0,0,20,20
1745830221836,MCWP 50R,C00,893771,Krone; Jarret,0,3,20,20
1745830221836,MCWP 50R,D00,893772,Miller; Elizabeth Deen,3,0,20,17
1745830221836,MCWP 50R,E00,893775,Carter; Andrea L,0,0,20,20
1745830222867,MMW 11R,A01,892721,Herbst; Matthew,11,0,27,16
1745830222867,MMW 11R,A02,892722,Herbst; Matthew,0,0,0,3
1745830223893,MMW 12R,A01,892724,Herbst; Matthew,0,10,16,16
1745830223893,MMW 12R,A02,892725,Herbst; Matthew,0,9,16,16
1745830224918,MMW 13R,A01,892727,Staff,0,3,16,16
1745830224918,MMW 13R,A02,892728,Staff,0,4,16,16
1745830224918,MMW 13R,A03,958032,Staff,0,3,16,16
1745830224918,MMW 13R,A04,958033,Staff,0,2,16,16
1745830224918,MMW 13R,A05,958034,Staff,0,3,16,16
1745830225946,SIO 295LS,A00,894015,Staff,7,0,25,18
1745830226971,SIO 295S,A00,894020,Staff,7,0,25,18
1745830228000,SIOC 290S,B01,958918,Staff,0,0,0,0
1745830229027,SIOC 291S,B01,958922,Staff,0,0,0,0
1745830230058,SOCI 117,A01,895339,Staff,4,0,5,1
1745830231083,WES 237B,A00,894149,Staff,11,0,20,9
1745830233165,AESE 279B,A00,891859,Staff,13,0,35,22
1745830234232,AIP 197,001,891854,Staff,70,0,70,0
1745830235258,ANTH 289S,A00,891856,Gagneux; Pascal,12,0,12,0
1745830236286,BENG 196,001,957946,Engler; Adam J.,9996,0,9999,3
1745830237312,CAT 124RS,A01,956906,Staff,8,0,25,17
1745830238339,CAT 125RS,A01,922013,Staff,8,0,25,17
1745830239364,CLRE 250,A00,891860,Morris; Sheldon,9995,0,9999,4
1745830241420,CLRE 251R,A00,907817,Mehta; Ravindra L.,9994,0,9999,5
1745830242448,CLRE 252,A00,891864,Cuomo; Raphael Eduardo,9993,0,9999,6
1745830243473,CLRE 253,A00,891867,Vaida; Florin,9994,0,9999,5
1745830243473,CLRE 253,B00,907819,Staff,9999,0,9999,0
1745830244500,CLRE 259,A00,891868,Patel; Hemal,9998,0,9999,1
1745830245527,CLRE 260,A00,891872,Cuomo; Raphael Eduardo,9999,0,9999,0
1745830246553,CLRE 297,001,891888,Cuomo; Raphael Eduardo,9999,0,9999,0
1745830247582,CSE 191,A00,958773,Minnes Kemp; Mor Mia,9999,0,9999,0
1745830248608,CSS 201S,A01,892054,Mignozzetti; Umberto,30,0,30,0
1745830249639,CSS 202S,A01,892056,Mignozzetti; Umberto,30,0,30,0
1745830250664,DSC 197,001,956898,Eldridge; Justin Matthew,9998,0,9999,1
1745830251694,DSC 297,001,958000,Mazumdar; Arya,9998,0,9999,1
1745830252722,EAP 100,A00,905686,Staff,9776,0,9999,223
1745830253753,ECE 45,A01,892618,Staff,0,13,50,50
1745830254783,ECE 109,A01,892620,Staff,0,43,0,0
1745830255811,ECE 111,A01,892719,Staff,0,9,50,50
1745830256843,ECE 197,001,957920,Mercier; Patrick Philip,9992,0,9999,7
1745830257871,ECON 178,A01,907814,Zhu; Ying,28,0,35,7
1745830258898,EDS 115,A00,895312,Staff,41,0,45,4
1745830259924,EDS 117,A01,895337,Staff,30,0,30,0
1745830260953,EDS 125,A00,895341,Jones; Gabrielle Anastasia,43,0,45,2
1745830261985,EDS 128A,A01,895459,Fargason; Sharon Gayle,44,0,45,1
1745830263016,EDS 128B,A01,895543,Pappas; Elizabeth,44,0,45,1
1745830264043,EDS 139,A00,897203,Pappas; Elizabeth,44,0,45,1
1745830264043,EDS 139,B00,897209,Fargason; Sharon Gayle,44,0,45,1
1745830265074,EDS 201,A00,895545,Staff,43,0,45,2
1745830266101,EDS 203,A01,895581,Halter; Christopher P.,43,0,45,2
1745830267129,EDS 204R,A01,895625,Heinzman; Erica M.,43,0,45,2
1745830267129,EDS 204R,B01,895693,Halter; Christopher P.,18,0,45,27
1745830268156,EDS 206R,A00,895694,Fargason; Sharon Gayle,9,0,30,21
1745830268156,EDS 206R,B00,895695,Choi; Bailey Miyeon,20,0,30,10
1745830269183,EDS 250,A00,895697,Hemans; Patricia Ann Benitez,43,0,45,2
1745830270209,EDS 281,A00,895701,Meyerott; Theresa Ann,15,0,15,0
1745830271235,EDS 284,A00,895736,Meyerott; Theresa Ann,15,0,15,0
1745830272269,EDS 286,A00,897210,Fine; Sarah,15,0,15,0
1745830273297,EDS 289C,A01,895770,Daly; Alan J.,15,0,15,0
1745830274323,EDS 290,A00,897211,Hofstetter; Carolyn,15,0,15,0
1745830275348,LIGM 5A,A00,896162,Fischer-Grunski; Eva K,15,0,20,5
1745830276375,LIGM 5B,A00,896260,Fischer-Grunski; Eva K,17,0,20,3
1745830277405,LIGM 5C,A00,896308,Fischer-Grunski; Eva K,18,0,20,2
1745830278438,LIIT 5AS,A00,896313,Carnelos; Chiara,17,0,20,3
1745830279466,LIIT 5BS,A00,896416,Carnelos; Chiara,20,0,20,0
1745830280493,LIIT 5CS,A00,896564,Carnelos; Chiara,20,0,20,0
1745830281522,LISP 5A,A00,896588,Munoz Sanchez; Alicia,4,0,20,16
1745830282552,LISP 5B,A00,896653,Munoz Sanchez; Alicia,10,0,20,10
1745830283581,LISP 5C,A00,896655,Munoz Sanchez; Alicia,4,0,20,16
1745830284607,MAE 197,001,957918,Kleissl; Jan,9998,0,9999,1
1745830285633,MATH 2,A01,957937,Staff,34,0,35,1
1745830286659,MATH 197,001,957876,Kedlaya; Kiran S.,9993,0,9999,6
1745830287690,MCWP 40,A00,892729,Duru; Nur,13,0,20,7
1745830287690,MCWP 40,B00,893304,Montejo; Carolina,20,0,20,0
1745830288714,MCWP 40R,A00,893757,Redela; Pamela Morgan,0,7,20,20
1745830289741,MCWP 50,A00,893758,Morshed; Michael James,2,0,20,18
1745830289741,MCWP 50,B00,893761,Bartulis; Jason Michael,18,0,20,2
1745830290769,MCWP 50R,A00,893766,Compas; Sean Matthew,0,1,20,20
1745830290769,MCWP 50R,B00,893769,Carter; Jennifer A,0,0,20,20
1745830290769,MCWP 50R,C00,893771,Krone; Jarret,0,3,20,20
1745830290769,MCWP 50R,D00,893772,Miller; Elizabeth Deen,3,0,20,17
1745830290769,MCWP 50R,E00,893775,Carter; Andrea L,0,0,20,20
1745830291799,MMW 11R,A01,892721,Herbst; Matthew,11,0,27,16
1745830291799,MMW 11R,A02,892722,Herbst; Matthew,0,0,0,3
1745830292826,MMW 12R,A01,892724,Herbst; Matthew,0,10,16,16
1745830292826,MMW 12R,A02,892725,Herbst; Matthew,0,9,16,16
1745830293857,MMW 13R,A01,892727,Staff,0,3,16,16
1745830293857,MMW 13R,A02,892728,Staff,0,4,16,16
1745830293857,MMW 13R,A03,958032,Staff,0,3,16,16
1745830293857,MMW 13R,A04,958033,Staff,0,2,16,16
1745830293857,MMW 13R,A05,958034,Staff,0,3,16,16
1745830294883,SIO 295LS,A00,894015,Staff,7,0,25,18
1745830295908,SIO 295S,A00,894020,Staff,7,0,25,18
1745830296939,SIOC 290S,B01,958918,Staff,0,0,0,0
1745830297967,SIOC 291S,B01,958922,Staff,0,0,0,0
1745830298991,SOCI 117,A01,895339,Staff,4,0,5,1
1745830300019,WES 237B,A00,894149,Staff,11,0,20,9
1745830302093,AESE 279B,A00,891859,Staff,13,0,35,22
1745830303118,AIP 197,001,891854,Staff,70,0,70,0
1745830304146,ANTH 289S,A00,891856,Gagneux; Pascal,12,0,12,0
1745830305178,BENG 196,001,957946,Engler; Adam J.,9996,0,9999,3
1745830306205,CAT 124RS,A01,956906,Staff,8,0,25,17
1745830307235,CAT 125RS,A01,922013,Staff,8,0,25,17
1745830308262,CLRE 250,A00,891860,Morris; Sheldon,9995,0,9999,4
1745830310315,CLRE 251R,A00,907817,Mehta; Ravindra L.,9994,0,9999,5
1745830311345,CLRE 252,A00,891864,Cuomo; Raphael Eduardo,9993,0,9999,6
1745830312382,CLRE 253,A00,891867,Vaida; Florin,9994,0,9999,5
1745830312382,CLRE 253,B00,907819,Staff,9999,0,9999,0
1745830313412,CLRE 259,A00,891868,Patel; Hemal,9998,0,9999,1
1745830314442,CLRE 260,A00,891872,Cuomo; Raphael Eduardo,9999,0,9999,0
1745830315470,CLRE 297,001,891888,Cuomo; Raphael Eduardo,9999,0,9999,0
1745830316498,CSE 191,A00,958773,Minnes Kemp; Mor Mia,9999,0,9999,0
1745830317528,CSS 201S,A01,892054,Mignozzetti; Umberto,30,0,30,0
1745830318554,CSS 202S,A01,892056,Mignozzetti; Umberto,30,0,30,0
1745830319581,DSC 197,001,956898,Eldridge; Justin Matthew,9998,0,9999,1
1745830320610,DSC 297,001,958000,Mazumdar; Arya,9998,0,9999,1
1745830321635,EAP 100,A00,905686,Staff,9776,0,9999,223
1745830322661,ECE 45,A01,892618,Staff,0,13,50,50
1745830323688,ECE 109,A01,892620,Staff,0,43,0,0
1745830324714,ECE 111,A01,892719,Staff,0,9,50,50
1745830325743,ECE 197,001,957920,Mercier; Patrick Philip,9992,0,9999,7
1745830326772,ECON 178,A01,907814,Zhu; Ying,28,0,35,7
1745830327799,EDS 115,A00,895312,Staff,41,0,45,4
1745830328831,EDS 117,A01,895337,Staff,30,0,30,0
1745830329857,EDS 125,A00,895341,Jones; Gabrielle Anastasia,43,0,45,2
1745830330882,EDS 128A,A01,895459,Fargason; Sharon Gayle,44,0,45,1
1745830331912,EDS 128B,A01,895543,Pappas; Elizabeth,44,0,45,1
1745830332938,EDS 139,A00,897203,Pappas; Elizabeth,44,0,45,1
1745830332938,EDS 139,B00,897209,Fargason; Sharon Gayle,44,0,45,1
1745830333963,EDS 201,A00,895545,Staff,43,0,45,2
1745830334991,EDS 203,A01,895581,Halter; Christopher P.,43,0,45,2
1745830336018,EDS 204R,A01,895625,Heinzman; Erica M.,43,0,45,2
1745830336018,EDS 204R,B01,895693,Halter; Christopher P.,18,0,45,27
1745830337044,EDS 206R,A00,895694,Fargason; Sharon Gayle,9,0,30,21
1745830337044,EDS 206R,B00,895695,Choi; Bailey Miyeon,20,0,30,10
1745830338110,EDS 250,A00,895697,Hemans; Patricia Ann Benitez,43,0,45,2
1745830339139,EDS 281,A00,895701,Meyerott; Theresa Ann,15,0,15,0
1745830340170,EDS 284,A00,895736,Meyerott; Theresa Ann,15,0,15,0
1745830341197,EDS 286,A00,897210,Fine; Sarah,15,0,15,0
1745830342228,EDS 289C,A01,895770,Daly; Alan J.,15,0,15,0
1745830343258,EDS 290,A00,897211,Hofstetter; Carolyn,15,0,15,0
1745830344285,LIGM 5A,A00,896162,Fischer-Grunski; Eva K,15,0,20,5
1745830345311,LIGM 5B,A00,896260,Fischer-Grunski; Eva K,17,0,20,3
1745830346338,LIGM 5C,A00,896308,Fischer-Grunski; Eva K,18,0,20,2
1745830347364,LIIT 5AS,A00,896313,Carnelos; Chiara,17,0,20,3
1745830348394,LIIT 5BS,A00,896416,Carnelos; Chiara,20,0,20,0
1745830349423,LIIT 5CS,A00,896564,Carnelos; Chiara,20,0,20,0
1745830350454,LISP 5A,A00,896588,Munoz Sanchez; Alicia,4,0,20,16
1745830351483,LISP 5B,A00,896653,Munoz Sanchez; Alicia,10,0,20,10
1745830352514,LISP 5C,A00,896655,Munoz Sanchez; Alicia,4,0,20,16
1745830353540,MAE 197,001,957918,Kleissl; Jan,9998,0,9999,1
1745830354570,MATH 2,A01,957937,Staff,34,0,35,1
1745830355599,MATH 197,001,957876,Kedlaya; Kiran S.,9993,0,9999,6
1745830356626,MCWP 40,A00,892729,Duru; Nur,13,0,20,7
1745830356626,MCWP 40,B00,893304,Montejo; Carolina,20,0,20,0
1745830357650,MCWP 40R,A00,893757,Redela; Pamela Morgan,0,7,20,20
1745830358680,MCWP 50,A00,893758,Morshed; Michael James,2,0,20,18
1745830358680,MCWP 50,B00,893761,Bartulis; Jason Michael,18,0,20,2
1745830359708,MCWP 50R,A00,893766,Compas; Sean Matthew,0,1,20,20
1745830359708,MCWP 50R,B00,893769,Carter; Jennifer A,0,0,20,20
1745830359708,MCWP 50R,C00,893771,Krone; Jarret,0,3,20,20
1745830359708,MCWP 50R,D00,893772,Miller; Elizabeth Deen,3,0,20,17
1745830359708,MCWP 50R,E00,893775,Carter; Andrea L,0,0,20,20
1745830360738,MMW 11R,A01,892721,Herbst; Matthew,11,0,27,16
1745830360738,MMW 11R,A02,892722,Herbst; Matthew,0,0,0,3
1745830361768,MMW 12R,A01,892724,Herbst; Matthew,0,10,16,16
1745830361768,MMW 12R,A02,892725,Herbst; Matthew,0,9,16,16
1745830362799,MMW 13R,A01,892727,Staff,0,3,16,16
1745830362799,MMW 13R,A02,892728,Staff,0,4,16,16
1745830362799,MMW 13R,A03,958032,Staff,0,3,16,16
1745830362799,MMW 13R,A04,958033,Staff,0,2,16,16
1745830362799,MMW 13R,A05,958034,Staff,0,3,16,16
1745830363826,SIO 295LS,A00,894015,Staff,7,0,25,18
1745830364854,SIO 295S,A00,894020,Staff,7,0,25,18
1745830365880,SIOC 290S,B01,958918,Staff,0,0,0,0
1745830366910,SIOC 291S,B01,958922,Staff,0,0,0,0
1745830367942,SOCI 117,A01,895339,Staff,4,0,5,1
1745830368968,WES 237B,A00,894149,Staff,11,0,20,9
1745830371059,AESE 279B,A00,891859,Staff,13,0,35,22
1745830372086,AIP 197,001,891854,Staff,70,0,70,0
1745830373117,ANTH 289S,A00,891856,Gagneux; Pascal,12,0,12,0
1745830374145,BENG 196,001,957946,Engler; Adam J.,9996,0,9999,3
1745830375175,CAT 124RS,A01,956906,Staff,8,0,25,17
1745830376203,CAT 125RS,A01,922013,Staff,8,0,25,17
1745830377233,CLRE 250,A00,891860,Morris; Sheldon,9995,0,9999,4
1745830379290,CLRE 251R,A00,907817,Mehta; Ravindra L.,9994,0,9999,5
1745830380321,CLRE 252,A00,891864,Cuomo; Raphael Eduardo,9993,0,9999,6
1745830381347,CLRE 253,A00,891867,Vaida; Florin,9994,0,9999,5
1745830381347,CLRE 253,B00,907819,Staff,9999,0,9999,0
1745830382375,CLRE 259,A00,891868,Patel; Hemal,9998,0,9999,1
1745830383401,CLRE 260,A00,891872,Cuomo; Raphael Eduardo,9999,0,9999,0
1745830384429,CLRE 297,001,891888,Cuomo; Raphael Eduardo,9999,0,9999,0
1745830385456,CSE 191,A00,958773,Minnes Kemp; Mor Mia,9999,0,9999,0
1745830386488,CSS 201S,A01,892054,Mignozzetti; Umberto,30,0,30,0
1745830387519,CSS 202S,A01,892056,Mignozzetti; Umberto,30,0,30,0
1745830388546,DSC 197,001,956898,Eldridge; Justin Matthew,9998,0,9999,1
1745830389574,DSC 297,001,958000,Mazumdar; Arya,9998,0,9999,1
1745830390602,EAP 100,A00,905686,Staff,9776,0,9999,223
1745830391628,ECE 45,A01,892618,Staff,0,13,50,50
1745830392658,ECE 109,A01,892620,Staff,0,43,0,0
1745830393685,ECE 111,A01,892719,Staff,0,9,50,50
1745830394711,ECE 197,001,957920,Mercier; Patrick Philip,9992,0,9999,7
1745830395743,ECON 178,A01,907814,Zhu; Ying,28,0,35,7
1745830396769,EDS 115,A00,895312,Staff,41,0,45,4
1745830397794,EDS 117,A01,895337,Staff,30,0,30,0
1745830398821,EDS 125,A00,895341,Jones; Gabrielle Anastasia,43,0,45,2
1745830399855,EDS 128A,A01,895459,Fargason; Sharon Gayle,44,0,45,1
1745830400883,EDS 128B,A01,895543,Pappas; Elizabeth,44,0,45,1
1745830401910,EDS 139,A00,897203,Pappas; Elizabeth,44,0,45,1
1745830401910,EDS 139,B00,897209,Fargason; Sharon Gayle,44,0,45,1
1745830402938,EDS 201,A00,895545,Staff,43,0,45,2
1745830403965,EDS 203,A01,895581,Halter; Christopher P.,43,0,45,2
1745830404992,EDS 204R,A01,895625,Heinzman; Erica M.,43,0,45,2
1745830404992,EDS 204R,B01,895693,Halter; Christopher P.,18,0,45,27
1745830406020,EDS 206R,A00,895694,Fargason; Sharon Gayle,9,0,30,21
1745830406020,EDS 206R,B00,895695,Choi; Bailey Miyeon,20,0,30,10
1745830407047,EDS 250,A00,895697,Hemans; Patricia Ann Benitez,43,0,45,2
1745830408074,EDS 281,A00,895701,Meyerott; Theresa Ann,15,0,15,0
1745830409100,EDS 284,A00,895736,Meyerott; Theresa Ann,15,0,15,0
1745830410126,EDS 286,A00,897210,Fine; Sarah,15,0,15,0
1745830411158,EDS 289C,A01,895770,Daly; Alan J.,15,0,15,0
1745830412187,EDS 290,A00,897211,Hofstetter; Carolyn,15,0,15,0
1745830413215,LIGM 5A,A00,896162,Fischer-Grunski; Eva K,15,0,20,5
1745830414245,LIGM 5B,A00,896260,Fischer-Grunski; Eva K,17,0,20,3
1745830415274,LIGM 5C,A00,896308,Fischer-Grunski; Eva K,18,0,20,2
1745830416301,LIIT 5AS,A00,896313,Carnelos; Chiara,17,0,20,3
1745830417331,LIIT 5BS,A00,896416,Carnelos; Chiara,20,0,20,0
1745830418359,LIIT 5CS,A00,896564,Carnelos; Chiara,20,0,20,0
1745830419387,LISP 5A,A00,896588,Munoz Sanchez; Alicia,4,0,20,16
1745830420417,LISP 5B,A00,896653,Munoz Sanchez; Alicia,10,0,20,10
1745830421447,LISP 5C,A00,896655,Munoz Sanchez; Alicia,4,0,20,16
1745830422475,MAE 197,001,957918,Kleissl; Jan,9998,0,9999,1
1745830423503,MATH 2,A01,957937,Staff,34,0,35,1
1745830424530,MATH 197,001,957876,Kedlaya; Kiran S.,9993,0,9999,6
1745830425557,MCWP 40,A00,892729,Duru; Nur,13,0,20,7
1745830425557,MCWP 40,B00,893304,Montejo; Carolina,20,0,20,0
1745830426584,MCWP 40R,A00,893757,Redela; Pamela Morgan,0,7,20,20
1745830427613,MCWP 50,A00,893758,Morshed; Michael James,2,0,20,18
1745830427613,MCWP 50,B00,893761,Bartulis; Jason Michael,18,0,20,2
1745830428641,MCWP 50R,A00,893766,Compas; Sean Matthew,0,1,20,20
1745830428641,MCWP 50R,B00,893769,Carter; Jennifer A,0,0,20,20
1745830428641,MCWP 50R,C00,893771,Krone; Jarret,0,3,20,20
1745830428641,MCWP 50R,D00,893772,Miller; Elizabeth Deen,3,0,20,17
1745830428641,MCWP 50R,E00,893775,Carter; Andrea L,0,0,20,20
1745830429667,MMW 11R,A01,892721,Herbst; Matthew,11,0,27,16
1745830429667,MMW 11R,A02,892722,Herbst; Matthew,0,0,0,3
1745830430694,MMW 12R,A01,892724,Herbst; Matthew,0,10,16,16
1745830430694,MMW 12R,A02,892725,Herbst; Matthew,0,9,16,16
1745830431724,MMW 13R,A01,892727,Staff,0,3,16,16
1745830431724,MMW 13R,A02,892728,Staff,0,4,16,16
1745830431724,MMW 13R,A03,958032,Staff,0,3,16,16
1745830431724,MMW 13R,A04,958033,Staff,0,2,16,16
1745830431724,MMW 13R,A05,958034,Staff,0,3,16,16
1745830432750,SIO 295LS,A00,894015,Staff,7,0,25,18
1745830433780,SIO 295S,A00,894020,Staff,7,0,25,18
1745830434808,SIOC 290S,B01,958918,Staff,0,0,0,0
1745830435833,SIOC 291S,B01,958922,Staff,0,0,0,0
1745830436861,SOCI 117,A01,895339,Staff,4,0,5,1
1745830437889,WES 237B,A00,894149,Staff,11,0,20,9
1745830439956,AESE 279B,A00,891859,Staff,13,0,35,22
1745830440985,AIP 197,001,891854,Staff,70,0,70,0
1745830442015,ANTH 289S,A00,891856,Gagneux; Pascal,12,0,12,0
1745830443045,BENG 196,001,957946,Engler; Adam J.,9996,0,9999,3
1745830444073,CAT 124RS,A01,956906,Staff,8,0,25,17
1745830445100,CAT 125RS,A01,922013,Staff,8,0,25,17
1745830446130,CLRE 250,A00,891860,Morris; Sheldon,9995,0,9999,4
1745830448187,CLRE 251R,A00,907817,Mehta; Ravindra L.,9994,0,9999,5
1745830449213,CLRE 252,A00,891864,Cuomo; Raphael Eduardo,9993,0,9999,6
1745830450244,CLRE 253,A00,891867,Vaida; Florin,9994,0,9999,5
1745830450244,CLRE 253,B00,907819,Staff,9999,0,9999,0
1745830451269,CLRE 259,A00,891868,Patel; Hemal,9998,0,9999,1
1745830452299,CLRE 260,A00,891872,Cuomo; Raphael Eduardo,9999,0,9999,0
1745830453327,CLRE 297,001,891888,Cuomo; Raphael Eduardo,9999,0,9999,0
1745830454353,CSE 191,A00,958773,Minnes Kemp; Mor Mia,9999,0,9999,0
1745830455379,CSS 201S,A01,892054,Mignozzetti; Umberto,30,0,30,0
1745830456406,CSS 202S,A01,892056,Mignozzetti; Umberto,30,0,30,0
1745830457437,DSC 197,001,956898,Eldridge; Justin Matthew,9998,0,9999,1
1745830458466,DSC 297,001,958000,Mazumdar; Arya,9998,0,9999,1
1745830459491,EAP 100,A00,905686,Staff,9776,0,9999,223
1745830460521,ECE 45,A01,892618,Staff,0,13,50,50
1745830461551,ECE 109,A01,892620,Staff,0,43,0,0
1745830462579,ECE 111,A01,892719,Staff,0,9,50,50
1745830463607,ECE 197,001,957920,Mercier; Patrick Philip,9992,0,9999,7
1745830464639,ECON 178,A01,907814,Zhu; Ying,28,0,35,7
1745830465668,EDS 115,A00,895312,Staff,41,0,45,4
1745830466695,EDS 117,A01,895337,Staff,30,0,30,0
1745830467723,EDS 125,A00,895341,Jones; Gabrielle Anastasia,43,0,45,2
1745830468750,EDS 128A,A01,895459,Fargason; Sharon Gayle,44,0,45,1
1745830469778,EDS 128B,A01,895543,Pappas; Elizabeth,44,0,45,1
1745830470804,EDS 139,A00,897203,Pappas; Elizabeth,44,0,45,1
1745830470804,EDS 139,B00,897209,Fargason; Sharon Gayle,44,0,45,1
1745830471830,EDS 201,A00,895545,Staff,43,0,45,2
1745830472857,EDS 203,A01,895581,Halter; Christopher P.,43,0,45,2
1745830473890,EDS 204R,A01,895625,Heinzman; Erica M.,43,0,45,2
1745830473890,EDS 204R,B01,895693,Halter; Christopher P.,18,0,45,27
1745830474916,EDS 206R,A00,895694,Fargason; Sharon Gayle,9,0,30,21
1745830474916,EDS 206R,B00,895695,Choi; Bailey Miyeon,20,0,30,10
1745830475947,EDS 250,A00,895697,Hemans; Patricia Ann Benitez,43,0,45,2
1745830476973,EDS 281,A00,895701,Meyerott; Theresa Ann,15,0,15,0
1745830478001,EDS 284,A00,895736,Meyerott; Theresa Ann,15,0,15,0
1745830479033,EDS 286,A00,897210,Fine; Sarah,15,0,15,0
1745830480060,EDS 289C,A01,895770,Daly; Alan J.,15,0,15,0
1745830481087,EDS 290,A00,897211,Hofstetter; Carolyn,15,0,15,0
1745830482115,LIGM 5A,A00,896162,Fischer-Grunski; Eva K,15,0,20,5
1745830483143,LIGM 5B,A00,896260,Fischer-Grunski; Eva K,17,0,20,3
1745830484169,LIGM 5C,A00,896308,Fischer-Grunski; Eva K,18,0,20,2
1745830485202,LIIT 5AS,A00,896313,Carnelos; Chiara,17,0,20,3
1745830486234,LIIT 5BS,A00,896416,Carnelos; Chiara,20,0,20,0
1745830487266,LIIT 5CS,A00,896564,Carnelos; Chiara,20,0,20,0
1745830488297,LISP 5A,A00,896588,Munoz Sanchez; Alicia,4,0,20,16
1745830489327,LISP 5B,A00,896653,Munoz Sanchez; Alicia,10,0,20,10
1745830490359,LISP 5C,A00,896655,Munoz Sanchez; Alicia,4,0,20,16
1745830491390,MAE 197,001,957918,Kleissl; Jan,9998,0,9999,1
1745830492417,MATH 2,A01,957937,Staff,34,0,35,1
1745830493446,MATH 197,001,957876,Kedlaya; Kiran S.,9993,0,9999,6
1745830494478,MCWP 40,A00,892729,Duru; Nur,13,0,20,7
1745830494478,MCWP 40,B00,893304,Montejo; Carolina,20,0,20,0
1745830495506,MCWP 40R,A00,893757,Redela; Pamela Morgan,0,7,20,20
1745830496534,MCWP 50,A00,893758,Morshed; Michael James,2,0,20,18
1745830496534,MCWP 50,B00,893761,Bartulis; Jason Michael,18,0,20,2
1745830497563,MCWP 50R,A00,893766,Compas; Sean Matthew,0,1,20,20
1745830497563,MCWP 50R,B00,893769,Carter; Jennifer A,0,0,20,20
1745830497563,MCWP 50R,C00,893771,Krone; Jarret,0,3,20,20
1745830497563,MCWP 50R,D00,893772,Miller; Elizabeth Deen,3,0,20,17
1745830497563,MCWP 50R,E00,893775,Carter; Andrea L,0,0,20,20
1745830498589,MMW 11R,A01,892721,Herbst; Matthew,11,0,27,16
1745830498589,MMW 11R,A02,892722,Herbst; Matthew,0,0,0,3
1745830499621,MMW 12R,A01,892724,Herbst; Matthew,0,10,16,16
1745830499621,MMW 12R,A02,892725,Herbst; Matthew,0,9,16,16
1745830500647,MMW 13R,A01,892727,Staff,0,3,16,16
1745830500647,MMW 13R,A02,892728,Staff,0,4,16,16
1745830500647,MMW 13R,A03,958032,Staff,0,3,16,16
1745830500647,MMW 13R,A04,958033,Staff,0,2,16,16
1745830500647,MMW 13R,A05,958034,Staff,0,3,16,16
1745830501677,SIO 295LS,A00,894015,Staff,7,0,25,18
1745830502706,SIO 295S,A00,894020,Staff,7,0,25,18
1745830503739,SIOC 290S,B01,958918,Staff,0,0,0,0
1745830504768,SIOC 291S,B01,958922,Staff,0,0,0,0
1745830505795,SOCI 117,A01,895339,Staff,4,0,5,1
1745830506823,WES 237B,A00,894149,Staff,11,0,20,9
1745830508906,AESE 279B,A00,891859,Staff,13,0,35,22
1745830509935,AIP 197,001,891854,Staff,70,0,70,0
1745830510961,ANTH 289S,A00,891856,Gagneux; Pascal,12,0,12,0
1745830511988,BENG 196,001,957946,Engler; Adam J.,9996,0,9999,3
1745830513018,CAT 124RS,A01,956906,Staff,8,0,25,17
1745830514046,CAT 125RS,A01,922013,Staff,8,0,25,17
1745830515073,CLRE 250,A00,891860,Morris; Sheldon,9995,0,9999,4
1745830517125,CLRE 251R,A00,907817,Mehta; Ravindra L.,9994,0,9999,5
1745830518151,CLRE 252,A00,891864,Cuomo; Raphael Eduardo,9993,0,9999,6
1745830519181,CLRE 253,A00,891867,Vaida; Florin,9994,0,9999,5
1745830519181,CLRE 253,B00,907819,Staff,9999,0,9999,0
1745830520207,CLRE 259,A00,891868,Patel; Hemal,9998,0,9999,1
1745830521235,CLRE 260,A00,891872,Cuomo; Raphael Eduardo,9999,0,9999,0
1745830522262,CLRE 297,001,891888,Cuomo; Raphael Eduardo,9999,0,9999,0
1745830523289,CSE 191,A00,958773,Minnes Kemp; Mor Mia,9999,0,9999,0
1745830524321,CSS 201S,A01,892054,Mignozzetti; Umberto,30,0,30,0
1745830525348,CSS 202S,A01,892056,Mignozzetti; Umberto,30,0,30,0
1745830526375,DSC 197,001,956898,Eldridge; Justin Matthew,9998,0,9999,1
1745830527402,DSC 297,001,958000,Mazumdar; Arya,9998,0,9999,1
1745830528427,EAP 100,A00,905686,Staff,9776,0,9999,223
1745830529457,ECE 45,A01,892618,Staff,0,13,50,50
1745830530484,ECE 109,A01,892620,Staff,0,43,0,0
1745830531508,ECE 111,A01,892719,Staff,0,9,50,50
1745830532534,ECE 197,001,957920,Mercier; Patrick Philip,9992,0,9999,7
1745830533562,ECON 178,A01,907814,Zhu; Ying,28,0,35,7
1745830534588,EDS 115,A00,895312,Staff,41,0,45,4
1745830535613,EDS 117,A01,895337,Staff,30,0,30,0
1745830536644,EDS 125,A00,895341,Jones; Gabrielle Anastasia,43,0,45,2
1745830537673,EDS 128A,A01,895459,Fargason; Sharon Gayle,44,0,45,1
1745830538701,EDS 128B,A01,895543,Pappas; Elizabeth,44,0,45,1
1745830539730,EDS 139,A00,897203,Pappas; Elizabeth,44,0,45,1
1745830539730,EDS 139,B00,897209,Fargason; Sharon Gayle,44,0,45,1
1745830540756,EDS 201,A00,895545,Staff,43,0,45,2
1745830541782,EDS 203,A01,895581,Halter; Christopher P.,43,0,45,2
1745830542812,EDS 204R,A01,895625,Heinzman; Erica M.,43,0,45,2
1745830542812,EDS 204R,B01,895693,Halter; Christopher P.,18,0,45,27
1745830543841,EDS 206R,A00,895694,Fargason; Sharon Gayle,9,0,30,21
1745830543841,EDS 206R,B00,895695,Choi; Bailey Miyeon,20,0,30,10
1745830544867,EDS 250,A00,895697,Hemans; Patricia Ann Benitez,43,0,45,2
1745830545896,EDS 281,A00,895701,Meyerott; Theresa Ann,15,0,15,0
1745830546924,EDS 284,A00,895736,Meyerott; Theresa Ann,15,0,15,0
1745830547951,EDS 286,A00,897210,Fine; Sarah,15,0,15,0
1745830548977,EDS 289C,A01,895770,Daly; Alan J.,15,0,15,0
1745830550003,EDS 290,A00,897211,Hofstetter; Carolyn,15,0,15,0
1745830551033,LIGM 5A,A00,896162,Fischer-Grunski; Eva K,15,0,20,5
1745830552058,LIGM 5B,A00,896260,Fischer-Grunski; Eva K,17,0,20,3
1745830553088,LIGM 5C,A00,896308,Fischer-Grunski; Eva K,18,0,20,2
1745830554113,LIIT 5AS,A00,896313,Carnelos; Chiara,17,0,20,3
1745830555138,LIIT 5BS,A00,896416,Carnelos; Chiara,20,0,20,0
1745830556168,LIIT 5CS,A00,896564,Carnelos; Chiara,20,0,20,0
1745830557197,LISP 5A,A00,896588,Munoz Sanchez; Alicia,4,0,20,16
1745830558225,LISP 5B,A00,896653,Munoz Sanchez; Alicia,10,0,20,10
1745830559252,LISP 5C,A00,896655,Munoz Sanchez; Alicia,4,0,20,16
1745830560281,MAE 197,001,957918,Kleissl; Jan,9998,0,9999,1
1745830561307,MATH 2,A01,957937,Staff,34,0,35,1
1745830562334,MATH 197,001,957876,Kedlaya; Kiran S.,9993,0,9999,6
1745830563406,MCWP 40,A00,892729,Duru; Nur,13,0,20,7
1745830563406,MCWP 40,B00,893304,Montejo; Carolina,20,0,20,0
1745830564434,MCWP 40R,A00,893757,Redela; Pamela Morgan,0,7,20,20
1745830565461,MCWP 50,A00,893758,Morshed; Michael James,2,0,20,18
1745830565461,MCWP 50,B00,893761,Bartulis; Jason Michael,18,0,20,2
1745830566488,MCWP 50R,A00,893766,Compas; Sean Matthew,0,1,20,20
1745830566488,MCWP 50R,B00,893769,Carter; Jennifer A,0,0,20,20
1745830566488,MCWP 50R,C00,893771,Krone; Jarret,0,3,20,20
1745830566488,MCWP 50R,D00,893772,Miller; Elizabeth Deen,3,0,20,17
1745830566488,MCWP 50R,E00,893775,Carter; Andrea L,0,0,20,20
1745830567516,MMW 11R,A01,892721,Herbst; Matthew,11,0,27,16
1745830567516,MMW 11R,A02,892722,Herbst; Matthew,0,0,0,3
1745830568544,MMW 12R,A01,892724,Herbst; Matthew,0,10,16,16
1745830568544,MMW 12R,A02,892725,Herbst; Matthew,0,9,16,16
1745830569570,MMW 13R,A01,892727,Staff,0,3,16,16
1745830569570,MMW 13R,A02,892728,Staff,0,4,16,16
1745830569570,MMW 13R,A03,958032,Staff,0,3,16,16
1745830569570,MMW 13R,A04,958033,Staff,0,2,16,16
1745830569570,MMW 13R,A05,958034,Staff,0,3,16,16
1745830570595,SIO 295LS,A00,894015,Staff,7,0,25,18
1745830571623,SIO 295S,A00,894020,Staff,7,0,25,18
1745830572651,SIOC 290S,B01,958918,Staff,0,0,0,0
1745830573677,SIOC 291S,B01,958922,Staff,0,0,0,0
1745830574702,SOCI 117,A01,895339,Staff,4,0,5,1
1745830575730,WES 237B,A00,894149,Staff,11,0,20,9
1745830577788,AESE 279B,A00,891859,Staff,13,0,35,22
1745830578818,AIP 197,001,891854,Staff,70,0,70,0
1745830579842,ANTH 289S,A00,891856,Gagneux; Pascal,12,0,12,0
1745830580869,BENG 196,001,957946,Engler; Adam J.,9996,0,9999,3
1745830581897,CAT 124RS,A01,956906,Staff,8,0,25,17
1745830582925,CAT 125RS,A01,922013,Staff,8,0,25,17
1745830583951,CLRE 250,A00,891860,Morris; Sheldon,9995,0,9999,4
1745830586006,CLRE 251R,A00,907817,Mehta; Ravindra L.,9994,0,9999,5
1745830587032,CLRE 252,A00,891864,Cuomo; Raphael Eduardo,9993,0,9999,6
1745830588062,CLRE 253,A00,891867,Vaida; Florin,9994,0,9999,5
1745830588062,CLRE 253,B00,907819,Staff,9999,0,9999,0
1745830589089,CLRE 259,A00,891868,Patel; Hemal,9998,0,9999,1
1745830590119,CLRE 260,A00,891872,Cuomo; Raphael Eduardo,9999,0,9999,0
1745830591148,CLRE 297,001,891888,Cuomo; Raphael Eduardo,9999,0,9999,0
1745830592173,CSE 191,A00,958773,Minnes Kemp; Mor Mia,9999,0,9999,0
1745830593200,CSS 201S,A01,892054,Mignozzetti; Umberto,30,0,30,0
1745830594230,CSS 202S,A01,892056,Mignozzetti; Umberto,30,0,30,0
1745830595259,DSC 197,001,956898,Eldridge; Justin Matthew,9998,0,9999,1
1745830596285,DSC 297,001,958000,Mazumdar; Arya,9998,0,9999,1
1745830597310,EAP 100,A00,905686,Staff,9776,0,9999,223
1745830598339,ECE 45,A01,892618,Staff,0,13,50,50
1745830599422,ECE 109,A01,892620,Staff,0,43,0,0
1745830600447,ECE 111,A01,892719,Staff,0,9,50,50
1745830601477,ECE 197,001,957920,Mercier; Patrick Philip,9992,0,9999,7
1745830602507,ECON 178,A01,907814,Zhu; Ying,28,0,35,7
1745830603535,EDS 115,A00,895312,Staff,41,0,45,4
1745830604564,EDS 117,A01,895337,Staff,30,0,30,0
1745830605594,EDS 125,A00,895341,Jones; Gabrielle Anastasia,43,0,45,2
1745830606619,EDS 128A,A01,895459,Fargason; Sharon Gayle,44,0,45,1
1745830607649,EDS 128B,A01,895543,Pappas; Elizabeth,44,0,45,1
1745830608675,EDS 139,A00,897203,Pappas; Elizabeth,44,0,45,1
1745830608675,EDS 139,B00,897209,Fargason; Sharon Gayle,44,0,45,1
1745830609700,EDS 201,A00,895545,Staff,43,0,45,2
1745830610730,EDS 203,A01,895581,Halter; Christopher P.,43,0,45,2
1745830611760,EDS 204R,A01,895625,Heinzman; Erica M.,43,0,45,2
1745830611760,EDS 204R,B01,895693,Halter; Christopher P.,18,0,45,27
1745830612787,EDS 206R,A00,895694,Fargason; Sharon Gayle,9,0,30,21
1745830612787,EDS 206R,B00,895695,Choi; Bailey Miyeon,20,0,30,10
1745830613816,EDS 250,A00,895697,Hemans; Patricia Ann Benitez,43,0,45,2
1745830614840,EDS 281,A00,895701,Meyerott; Theresa Ann,15,0,15,0
1745830615866,EDS 284,A00,895736,Meyerott; Theresa Ann,15,0,15,0
1745830616895,EDS 286,A00,897210,Fine; Sarah,15,0,15,0
1745830617926,EDS 289C,A01,895770,Daly; Alan J.,15,0,15,0
1745830618952,EDS 290,A00,897211,Hofstetter; Carolyn,15,0,15,0
1745830619979,LIGM 5A,A00,896162,Fischer-Grunski; Eva K,15,0,20,5
1745830621009,LIGM 5B,A00,896260,Fischer-Grunski; Eva K,17,0,20,3
1745830622035,LIGM 5C,A00,896308,Fischer-Grunski; Eva K,18,0,20,2
1745830623064,LIIT 5AS,A00,896313,Carnelos; Chiara,17,0,20,3
1745830624090,LIIT 5BS,A00,896416,Carnelos; Chiara,20,0,20,0
1745830625118,LIIT 5CS,A00,896564,Carnelos; Chiara,20,0,20,0
1745830626148,LISP 5A,A00,896588,Munoz Sanchez; Alicia,4,0,20,16
1745830627178,LISP 5B,A00,896653,Munoz Sanchez; Alicia,10,0,20,10
1745830628206,LISP 5C,A00,896655,Munoz Sanchez; Alicia,4,0,20,16
1745830629232,MAE 197,001,957918,Kleissl; Jan,9998,0,9999,1
1745830630258,MATH 2,A01,957937,Staff,34,0,35,1
1745830631285,MATH 197,001,957876,Kedlaya; Kiran S.,9993,0,9999,6
1745830632311,MCWP 40,A00,892729,Duru; Nur,13,0,20,7
1745830632311,MCWP 40,B00,893304,Montejo; Carolina,20,0,20,0
1745830633336,MCWP 40R,A00,893757,Redela; Pamela Morgan,0,7,20,20
1745830634361,MCWP 50,A00,893758,Morshed; Michael James,2,0,20,18
1745830634361,MCWP 50,B00,893761,Bartulis; Jason Michael,18,0,20,2
1745830635392,MCWP 50R,A00,893766,Compas; Sean Matthew,0,1,20,20
1745830635392,MCWP 50R,B00,893769,Carter; Jennifer A,0,0,20,20
1745830635392,MCWP 50R,C00,893771,Krone; Jarret,0,3,20,20
1745830635392,MCWP 50R,D00,893772,Miller; Elizabeth Deen,3,0,20,17
1745830635392,MCWP 50R,E00,893775,Carter; Andrea L,0,0,20,20
1745830636418,MMW 11R,A01,892721,Herbst; Matthew,11,0,27,16
1745830636418,MMW 11R,A02,892722,Herbst; Matthew,0,0,0,3
1745830637444,MMW 12R,A01,892724,Herbst; Matthew,0,10,16,16
1745830637444,MMW 12R,A02,892725,Herbst; Matthew,0,9,16,16
1745830638473,MMW 13R,A01,892727,Staff,0,3,16,16
1745830638473,MMW 13R,A02,892728,Staff,0,4,16,16
1745830638473,MMW 13R,A03,958032,Staff,0,3,16,16
1745830638473,MMW 13R,A04,958033,Staff,0,2,16,16
1745830638473,MMW 13R,A05,958034,Staff,0,3,16,16
1745830639496,SIO 295LS,A00,894015,Staff,7,0,25,18
1745830640525,SIO 295S,A00,894020,Staff,7,0,25,18
1745830641555,SIOC 290S,B01,958918,Staff,0,0,0,0
1745830642580,SIOC 291S,B01,958922,Staff,0,0,0,0
1745830643609,SOCI 117,A01,895339,Staff,4,0,5,1
1745830644636,WES 237B,A00,894149,Staff,11,0,20,9
1745830646694,AESE 279B,A00,891859,Staff,13,0,35,22
1745830647721,AIP 197,001,891854,Staff,70,0,70,0
1745830648751,ANTH 289S,A00,891856,Gagneux; Pascal,12,0,12,0
1745830649779,BENG 196,001,957946,Engler; Adam J.,9996,0,9999,3
1745830650805,CAT 124RS,A01,956906,Staff,8,0,25,17
1745830651829,CAT 125RS,A01,922013,Staff,8,0,25,17
1745830652855,CLRE 250,A00,891860,Morris; Sheldon,9995,0,9999,4
1745830654906,CLRE 251R,A00,907817,Mehta; Ravindra L.,9994,0,9999,5
1745830655932,CLRE 252,A00,891864,Cuomo; Raphael Eduardo,9993,0,9999,6
1745830656961,CLRE 253,A00,891867,Vaida; Florin,9994,0,9999,5
1745830656961,CLRE 253,B00,907819,Staff,9999,0,9999,0
1745830657988,CLRE 259,A00,891868,Patel; Hemal,9998,0,9999,1
1745830659013,CLRE 260,A00,891872,Cuomo; Raphael Eduardo,9999,0,9999,0
1745830660040,CLRE 297,001,891888,Cuomo; Raphael Eduardo,9999,0,9999,0
1745830661066,CSE 191,A00,958773,Minnes Kemp; Mor Mia,9999,0,9999,0
1745830662091,CSS 201S,A01,892054,Mignozzetti; Umberto,30,0,30,0
1745830663130,CSS 202S,A01,892056,Mignozzetti; Umberto,30,0,30,0
1745830664155,DSC 197,001,956898,Eldridge; Justin Matthew,9998,0,9999,1
1745830665181,DSC 297,001,958000,Mazumdar; Arya,9998,0,9999,1
1745830666207,EAP 100,A00,905686,Staff,9776,0,9999,223
1745830667236,ECE 45,A01,892618,Staff,0,13,50,50
1745830668262,ECE 109,A01,892620,Staff,0,43,0,0
1745830669289,ECE 111,A01,892719,Staff,0,9,50,50
1745830670315,ECE 197,001,957920,Mercier; Patrick Philip,9992,0,9999,7
1745830671341,ECON 178,A01,907814,Zhu; Ying,28,0,35,7
1745830672368,EDS 115,A00,895312,Staff,41,0,45,4
1745830673397,EDS 117,A01,895337,Staff,30,0,30,0
1745830674424,EDS 125,A00,895341,Jones; Gabrielle Anastasia,43,0,45,2
1745830675449,EDS 128A,A01,895459,Fargason; Sharon Gayle,44,0,45,1
1745830676478,EDS 128B,A01,895543,Pappas; Elizabeth,44,0,45,1
1745830677507,EDS 139,A00,897203,Pappas; Elizabeth,44,0,45,1
1745830677507,EDS 139,B00,897209,Fargason; Sharon Gayle,44,0,45,1
1745830678532,EDS 201,A00,895545,Staff,43,0,45,2
1745830679561,EDS 203,A01,895581,Halter; Christopher P.,43,0,45,2
1745830680587,EDS 204R,A01,895625,Heinzman; Erica M.,43,0,45,2
1745830680587,EDS 204R,B01,895693,Halter; Christopher P.,18,0,45,27
1745830681613,EDS 206R,A00,895694,Fargason; Sharon Gayle,9,0,30,21
1745830681613,EDS 206R,B00,895695,Choi; Bailey Miyeon,20,0,30,10
1745830682641,EDS 250,A00,895697,Hemans; Patricia Ann Benitez,43,0,45,2
1745830683667,EDS 281,A00,895701,Meyerott; Theresa Ann,15,0,15,0
1745830684691,EDS 284,A00,895736,Meyerott; Theresa Ann,15,0,15,0
1745830685716,EDS 286,A00,897210,Fine; Sarah,15,0,15,0
1745830686742,EDS 289C,A01,895770,Daly; Alan J.,15,0,15,0
1745830687768,EDS 290,A00,897211,Hofstetter; Carolyn,15,0,15,0
1745830688795,LIGM 5A,A00,896162,Fischer-Grunski; Eva K,15,0,20,5
1745830689820,LIGM 5B,A00,896260,Fischer-Grunski; Eva K,17,0,20,3
1745830690850,LIGM 5C,A00,896308,Fischer-Grunski; Eva K,18,0,20,2
1745830691878,LIIT 5AS,A00,896313,Carnelos; Chiara,17,0,20,3
1745830692903,LIIT 5BS,A00,896416,Carnelos; Chiara,20,0,20,0
1745830693928,LIIT 5CS,A00,896564,Carnelos; Chiara,20,0,20,0
1745830694955,LISP 5A,A00,896588,Munoz Sanchez; Alicia,4,0,20,16
1745830695979,LISP 5B,A00,896653,Munoz Sanchez; Alicia,10,0,20,10
1745830697008,LISP 5C,A00,896655,Munoz Sanchez; Alicia,4,0,20,16
1745830698034,MAE 197,001,957918,Kleissl; Jan,9998,0,9999,1
1745830699062,MATH 2,A01,957937,Staff,34,0,35,1
1745830700088,MATH 197,001,957876,Kedlaya; Kiran S.,9993,0,9999,6
1745830701117,MCWP 40,A00,892729,Duru; Nur,13,0,20,7
1745830701117,MCWP 40,B00,893304,Montejo; Carolina,20,0,20,0
1745830702147,MCWP 40R,A00,893757,Redela; Pamela Morgan,0,7,20,20
1745830703172,MCWP 50,A00,893758,Morshed; Michael James,2,0,20,18
1745830703172,MCWP 50,B00,893761,Bartulis; Jason Michael,18,0,20,2
1745830704199,MCWP 50R,A00,893766,Compas; Sean Matthew,0,1,20,20
1745830704199,MCWP 50R,B00,893769,Carter; Jennifer A,0,0,20,20
1745830704199,MCWP 50R,C00,893771,Krone; Jarret,0,3,20,20
1745830704199,MCWP 50R,D00,893772,Miller; Elizabeth Deen,3,0,20,17
1745830704199,MCWP 50R,E00,893775,Carter; Andrea L,0,0,20,20
1745830705225,MMW 11R,A01,892721,Herbst; Matthew,11,0,27,16
1745830705225,MMW 11R,A02,892722,Herbst; Matthew,0,0,0,3
1745830706250,MMW 12R,A01,892724,Herbst; Matthew,0,10,16,16
1745830706250,MMW 12R,A02,892725,Herbst; Matthew,0,9,16,16
1745830707276,MMW 13R,A01,892727,Staff,0,3,16,16
1745830707276,MMW 13R,A02,892728,Staff,0,4,16,16
1745830707276,MMW 13R,A03,958032,Staff,0,3,16,16
1745830707276,MMW 13R,A04,958033,Staff,0,2,16,16
1745830707276,MMW 13R,A05,958034,Staff,0,3,16,16
1745830708303,SIO 295LS,A00,894015,Staff,7,0,25,18
1745830709331,SIO 295S,A00,894020,Staff,7,0,25,18
1745830710361,SIOC 290S,B01,958918,Staff,0,0,0,0
1745830711391,SIOC 291S,B01,958922,Staff,0,0,0,0
1745830712417,SOCI 117,A01,895339,Staff,4,0,5,1
1745830713444,WES 237B,A00,894149,Staff,11,0,20,9
1745830715508,AESE 279B,A00,891859,Staff,13,0,35,22
1745830716533,AIP 197,001,891854,Staff,70,0,70,0
1745830717559,ANTH 289S,A00,891856,Gagneux; Pascal,12,0,12,0
1745830718586,BENG 196,001,957946,Engler; Adam J.,9996,0,9999,3
1745830719614,CAT 124RS,A01,956906,Staff,8,0,25,17
1745830720643,CAT 125RS,A01,922013,Staff,8,0,25,17
1745830721671,CLRE 250,A00,891860,Morris; Sheldon,9995,0,9999,4
1745830723724,CLRE 251R,A00,907817,Mehta; Ravindra L.,9994,0,9999,5
1745830724753,CLRE 252,A00,891864,Cuomo; Raphael Eduardo,9993,0,9999,6
1745830725782,CLRE 253,A00,891867,Vaida; Florin,9994,0,9999,5
1745830725782,CLRE 253,B00,907819,Staff,9999,0,9999,0
1745830726811,CLRE 259,A00,891868,Patel; Hemal,9998,0,9999,1
1745830727837,CLRE 260,A00,891872,Cuomo; Raphael Eduardo,9999,0,9999,0
1745830728863,CLRE 297,001,891888,Cuomo; Raphael Eduardo,9999,0,9999,0
1745830729892,CSE 191,A00,958773,Minnes Kemp; Mor Mia,9999,0,9999,0
1745830730926,CSS 201S,A01,892054,Mignozzetti; Umberto,30,0,30,0
1745830731953,CSS 202S,A01,892056,Mignozzetti; Umberto,30,0,30,0
1745830732981,DSC 197,001,956898,Eldridge; Justin Matthew,9998,0,9999,1
1745830734008,DSC 297,001,958000,Mazumdar; Arya,9998,0,9999,1
1745830735038,EAP 100,A00,905686,Staff,9776,0,9999,223
1745830736065,ECE 45,A01,892618,Staff,0,13,50,50
1745830737091,ECE 109,A01,892620,Staff,0,43,0,0
1745830738117,ECE 111,A01,892719,Staff,0,9,50,50
1745830739144,ECE 197,001,957920,Mercier; Patrick Philip,9992,0,9999,7
1745830740171,ECON 178,A01,907814,Zhu; Ying,28,0,35,7
1745830741196,EDS 115,A00,895312,Staff,41,0,45,4
1745830742225,EDS 117,A01,895337,Staff,30,0,30,0
1745830743254,EDS 125,A00,895341,Jones; Gabrielle Anastasia,43,0,45,2
1745830744284,EDS 128A,A01,895459,Fargason; Sharon Gayle,44,0,45,1
1745830745310,EDS 128B,A01,895543,Pappas; Elizabeth,44,0,45,1
1745830746336,EDS 139,A00,897203,Pappas; Elizabeth,44,0,45,1
1745830746336,EDS 139,B00,897209,Fargason; Sharon Gayle,44,0,45,1
1745830747362,EDS 201,A00,895545,Staff,43,0,45,2
1745830748392,EDS 203,A01,895581,Halter; Christopher P.,43,0,45,2
1745830749421,EDS 204R,A01,895625,Heinzman; Erica M.,43,0,45,2
1745830749421,EDS 204R,B01,895693,Halter; Christopher P.,18,0,45,27
1745830750448,EDS 206R,A00,895694,Fargason; Sharon Gayle,9,0,30,21
1745830750448,EDS 206R,B00,895695,Choi; Bailey Miyeon,20,0,30,10
1745830751474,EDS 250,A00,895697,Hemans; Patricia Ann Benitez,43,0,45,2
1745830752499,EDS 281,A00,895701,Meyerott; Theresa Ann,15,0,15,0
1745830753527,EDS 284,A00,895736,Meyerott; Theresa Ann,15,0,15,0
1745830754555,EDS 286,A00,897210,Fine; Sarah,15,0,15,0
1745830755580,EDS 289C,A01,895770,Daly; Alan J.,15,0,15,0
1745830756605,EDS 290,A00,897211,Hofstetter; Carolyn,15,0,15,0
1745830757635,LIGM 5A,A00,896162,Fischer-Grunski; Eva K,15,0,20,5
1745830758661,LIGM 5B,A00,896260,Fischer-Grunski; Eva K,17,0,20,3
1745830759689,LIGM 5C,A00,896308,Fischer-Grunski; Eva K,18,0,20,2
1745830760715,LIIT 5AS,A00,896313,Carnelos; Chiara,17,0,20,3
1745830761744,LIIT 5BS,A00,896416,Carnelos; Chiara,20,0,20,0
1745830762773,LIIT 5CS,A00,896564,Carnelos; Chiara,20,0,20,0
1745830763804,LISP 5A,A00,896588,Munoz Sanchez; Alicia,4,0,20,16
1745830764834,LISP 5B,A00,896653,Munoz Sanchez; Alicia,10,0,20,10
1745830765860,LISP 5C,A00,896655,Munoz Sanchez; Alicia,4,0,20,16
1745830766887,MAE 197,001,957918,Kleissl; Jan,9998,0,9999,1
1745830767913,MATH 2,A01,957937,Staff,34,0,35,1
1745830768940,MATH 197,001,957876,Kedlaya; Kiran S.,9993,0,9999,6
1745830769970,MCWP 40,A00,892729,Duru; Nur,13,0,20,7
1745830769970,MCWP 40,B00,893304,Montejo; Carolina,20,0,20,0
1745830770995,MCWP 40R,A00,893757,Redela; Pamela Morgan,0,7,20,20
1745830772022,MCWP 50,A00,893758,Morshed; Michael James,2,0,20,18
1745830772022,MCWP 50,B00,893761,Bartulis; Jason Michael,18,0,20,2
1745830773048,MCWP 50R,A00,893766,Compas; Sean Matthew,0,1,20,20
1745830773048,MCWP 50R,B00,893769,Carter; Jennifer A,0,0,20,20
1745830773048,MCWP 50R,C00,893771,Krone; Jarret,0,3,20,20
1745830773048,MCWP 50R,D00,893772,Miller; Elizabeth Deen,3,0,20,17
1745830773048,MCWP 50R,E00,893775,Carter; Andrea L,0,0,20,20
1745830774077,MMW 11R,A01,892721,Herbst; Matthew,11,0,27,16
1745830774077,MMW 11R,A02,892722,Herbst; Matthew,0,0,0,3
1745830775103,MMW 12R,A01,892724,Herbst; Matthew,0,10,16,16
1745830775103,MMW 12R,A02,892725,Herbst; Matthew,0,9,16,16
1745830776133,MMW 13R,A01,892727,Staff,0,3,16,16
1745830776133,MMW 13R,A02,892728,Staff,0,4,16,16
1745830776133,MMW 13R,A03,958032,Staff,0,3,16,16
1745830776133,MMW 13R,A04,958033,Staff,0,2,16,16
1745830776133,MMW 13R,A05,958034,Staff,0,3,16,16
1745830777160,SIO 295LS,A00,894015,Staff,7,0,25,18
1745830778187,SIO 295S,A00,894020,Staff,7,0,25,18
1745830779218,SIOC 290S,B01,958918,Staff,0,0,0,0
1745830780244,SIOC 291S,B01,958922,Staff,0,0,0,0
1745830781273,SOCI 117,A01,895339,Staff,4,0,5,1
1745830782301,WES 237B,A00,894149,Staff,11,0,20,9
1745830784372,AESE 279B,A00,891859,Staff,13,0,35,22
1745830785398,AIP 197,001,891854,Staff,70,0,70,0
1745830786426,ANTH 289S,A00,891856,Gagneux; Pascal,12,0,12,0
1745830787453,BENG 196,001,957946,Engler; Adam J.,9996,0,9999,3
1745830788480,CAT 124RS,A01,956906,Staff,8,0,25,17
1745830789503,CAT 125RS,A01,922013,Staff,8,0,25,17
1745830790532,CLRE 250,A00,891860,Morris; Sheldon,9995,0,9999,4
1745830792586,CLRE 251R,A00,907817,Mehta; Ravindra L.,9994,0,9999,5
1745830793616,CLRE 252,A00,891864,Cuomo; Raphael Eduardo,9993,0,9999,6
1745830794646,CLRE 253,A00,891867,Vaida; Florin,9994,0,9999,5
1745830794646,CLRE 253,B00,907819,Staff,9999,0,9999,0
1745830795673,CLRE 259,A00,891868,Patel; Hemal,9998,0,9999,1
1745830796703,CLRE 260,A00,891872,Cuomo; Raphael Eduardo,9999,0,9999,0
1745830797730,CLRE 297,001,891888,Cuomo; Raphael Eduardo,9999,0,9999,0
1745830798758,CSE 191,A00,958773,Minnes Kemp; Mor Mia,9999,0,9999,0
1745830799789,CSS 201S,A01,892054,Mignozzetti; Umberto,30,0,30,0
1745830800816,CSS 202S,A01,892056,Mignozzetti; Umberto,30,0,30,0
1745830801851,DSC 197,001,956898,Eldridge; Justin Matthew,9998,0,9999,1
1745830802878,DSC 297,001,958000,Mazumdar; Arya,9998,0,9999,1
1745830803912,EAP 100,A00,905686,Staff,9776,0,9999,223
1745830804937,ECE 45,A01,892618,Staff,0,13,50,50
1745830805970,ECE 109,A01,892620,Staff,0,43,0,0
1745830807003,ECE 111,A01,892719,Staff,0,9,50,50
1745830808031,ECE 197,001,957920,Mercier; Patrick Philip,9992,0,9999,7
1745830809060,ECON 178,A01,907814,Zhu; Ying,28,0,35,7
1745830810089,EDS 115,A00,895312,Staff,41,0,45,4
1745830811115,EDS 117,A01,895337,Staff,30,0,30,0
1745830812142,EDS 125,A00,895341,Jones; Gabrielle Anastasia,43,0,45,2
1745830813174,EDS 128A,A01,895459,Fargason; Sharon Gayle,44,0,45,1
1745830814201,EDS 128B,A01,895543,Pappas; Elizabeth,44,0,45,1
1745830815228,EDS 139,A00,897203,Pappas; Elizabeth,44,0,45,1
1745830815228,EDS 139,B00,897209,Fargason; Sharon Gayle,44,0,45,1
1745830816254,EDS 201,A00,895545,Staff,43,0,45,2
1745830817284,EDS 203,A01,895581,Halter; Christopher P.,43,0,45,2
1745830818313,EDS 204R,A01,895625,Heinzman; Erica M.,43,0,45,2
1745830818313,EDS 204R,B01,895693,Halter; Christopher P.,18,0,45,27
1745830819339,EDS 206R,A00,895694,Fargason; Sharon Gayle,9,0,30,21
1745830819339,EDS 206R,B00,895695,Choi; Bailey Miyeon,20,0,30,10
1745830820365,EDS 250,A00,895697,Hemans; Patricia Ann Benitez,43,0,45,2
1745830821394,EDS 281,A00,895701,Meyerott; Theresa Ann,15,0,15,0
1745830822419,EDS 284,A00,895736,Meyerott; Theresa Ann,15,0,15,0
1745830823447,EDS 286,A00,897210,Fine; Sarah,15,0,15,0
1745830824474,EDS 289C,A01,895770,Daly; Alan J.,15,0,15,0
1745830825503,EDS 290,A00,897211,Hofstetter; Carolyn,15,0,15,0
1745830826530,LIGM 5A,A00,896162,Fischer-Grunski; Eva K,15,0,20,5
1745830827559,LIGM 5B,A00,896260,Fischer-Grunski; Eva K,17,0,20,3
1745830828585,LIGM 5C,A00,896308,Fischer-Grunski; Eva K,18,0,20,2
1745830829610,LIIT 5AS,A00,896313,Carnelos; Chiara,17,0,20,3
1745830830635,LIIT 5BS,A00,896416,Carnelos; Chiara,20,0,20,0
1745830831660,LIIT 5CS,A00,896564,Carnelos; Chiara,20,0,20,0
1745830832687,LISP 5A,A00,896588,Munoz Sanchez; Alicia,4,0,20,16
1745830833714,LISP 5B,A00,896653,Munoz Sanchez; Alicia,10,0,20,10
1745830834745,LISP 5C,A00,896655,Munoz Sanchez; Alicia,4,0,20,16
1745830835771,MAE 197,001,957918,Kleissl; Jan,9998,0,9999,1
1745830836798,MATH 2,A01,957937,Staff,34,0,35,1
1745830837824,MATH 197,001,957876,Kedlaya; Kiran S.,9993,0,9999,6
1745830838851,MCWP 40,A00,892729,Duru; Nur,13,0,20,7
1745830838851,MCWP 40,B00,893304,Montejo; Carolina,20,0,20,0
1745830839876,MCWP 40R,A00,893757,Redela; Pamela Morgan,0,7,20,20
1745830840905,MCWP 50,A00,893758,Morshed; Michael James,2,0,20,18
1745830840905,MCWP 50,B00,893761,Bartulis; Jason Michael,18,0,20,2
1745830841936,MCWP 50R,A00,893766,Compas; Sean Matthew,0,1,20,20
1745830841936,MCWP 50R,B00,893769,Carter; Jennifer A,0,0,20,20
1745830841936,MCWP 50R,C00,893771,Krone; Jarret,0,3,20,20
1745830841936,MCWP 50R,D00,893772,Miller; Elizabeth Deen,3,0,20,17
1745830841936,MCWP 50R,E00,893775,Carter; Andrea L,0,0,20,20
1745830842961,MMW 11R,A01,892721,Herbst; Matthew,11,0,27,16
1745830842961,MMW 11R,A02,892722,Herbst; Matthew,0,0,0,3
1745830843989,MMW 12R,A01,892724,Herbst; Matthew,0,10,16,16
1745830843989,MMW 12R,A02,892725,Herbst; Matthew,0,9,16,16
1745830845018,MMW 13R,A01,892727,Staff,0,3,16,16
1745830845018,MMW 13R,A02,892728,Staff,0,4,16,16
1745830845018,MMW 13R,A03,958032,Staff,0,3,16,16
1745830845018,MMW 13R,A04,958033,Staff,0,2,16,16
1745830845018,MMW 13R,A05,958034,Staff,0,3,16,16
1745830846043,SIO 295LS,A00,894015,Staff,7,0,25,18
1745830847072,SIO 295S,A00,894020,Staff,7,0,25,18
1745830848098,SIOC 290S,B01,958918,Staff,0,0,0,0
1745830849131,SIOC 291S,B01,958922,Staff,0,0,0,0
1745830850156,SOCI 117,A01,895339,Staff,4,0,5,1
1745830851183,WES 237B,A00,894149,Staff,11,0,20,9
1745830853251,AESE 279B,A00,891859,Staff,13,0,35,22
1745830854278,AIP 197,001,891854,Staff,70,0,70,0
1745830855303,ANTH 289S,A00,891856,Gagneux; Pascal,12,0,12,0
1745830856329,BENG 196,001,957946,Engler; Adam J.,9996,0,9999,3
1745830857355,CAT 124RS,A01,956906,Staff,8,0,25,17
1745830858382,CAT 125RS,A01,922013,Staff,8,0,25,17
1745830859412,CLRE 250,A00,891860,Morris; Sheldon,9995,0,9999,4
1745830861469,CLRE 251R,A00,907817,Mehta; Ravindra L.,9994,0,9999,5
1745830862499,CLRE 252,A00,891864,Cuomo; Raphael Eduardo,9993,0,9999,6
1745830863526,CLRE 253,A00,891867,Vaida; Florin,9994,0,9999,5
1745830863526,CLRE 253,B00,907819,Staff,9999,0,9999,0
1745830864552,CLRE 259,A00,891868,Patel; Hemal,9998,0,9999,1
1745830865579,CLRE 260,A00,891872,Cuomo; Raphael Eduardo,9999,0,9999,0
1745830866606,CLRE 297,001,891888,Cuomo; Raphael Eduardo,9999,0,9999,0
1745830867635,CSE 191,A00,958773,Minnes Kemp; Mor Mia,9999,0,9999,0
1745830868665,CSS 201S,A01,892054,Mignozzetti; Umberto,30,0,30,0
1745830869696,CSS 202S,A01,892056,Mignozzetti; Umberto,30,0,30,0
1745830870722,DSC 197,001,956898,Eldridge; Justin Matthew,9998,0,9999,1
1745830871748,DSC 297,001,958000,Mazumdar; Arya,9998,0,9999,1
1745830872775,EAP 100,A00,905686,Staff,9776,0,9999,223
1745830873802,ECE 45,A01,892618,Staff,0,13,50,50
1745830874828,ECE 109,A01,892620,Staff,0,43,0,0
1745830875854,ECE 111,A01,892719,Staff,0,9,50,50
1745830876883,ECE 197,001,957920,Mercier; Patrick Philip,9992,0,9999,7
1745830877910,ECON 178,A01,907814,Zhu; Ying,28,0,35,7
1745830878936,EDS 115,A00,895312,Staff,41,0,45,4
1745830879967,EDS 117,A01,895337,Staff,30,0,30,0
1745830880993,EDS 125,A00,895341,Jones; Gabrielle Anastasia,43,0,45,2
1745830882022,EDS 128A,A01,895459,Fargason; Sharon Gayle,44,0,45,1
1745830883054,EDS 128B,A01,895543,Pappas; Elizabeth,44,0,45,1
1745830884082,EDS 139,A00,897203,Pappas; Elizabeth,44,0,45,1
1745830884082,EDS 139,B00,897209,Fargason; Sharon Gayle,44,0,45,1
1745830885111,EDS 201,A00,895545,Staff,43,0,45,2
1745830886137,EDS 203,A01,895581,Halter; Christopher P.,43,0,45,2
1745830887163,EDS 204R,A01,895625,Heinzman; Erica M.,43,0,45,2
1745830887163,EDS 204R,B01,895693,Halter; Christopher P.,18,0,45,27
1745830888192,EDS 206R,A00,895694,Fargason; Sharon Gayle,9,0,30,21
1745830888192,EDS 206R,B00,895695,Choi; Bailey Miyeon,20,0,30,10
1745830889221,EDS 250,A00,895697,Hemans; Patricia Ann Benitez,43,0,45,2
1745830890245,EDS 281,A00,895701,Meyerott; Theresa Ann,15,0,15,0
1745830891276,EDS 284,A00,895736,Meyerott; Theresa Ann,15,0,15,0
1745830892305,EDS 286,A00,897210,Fine; Sarah,15,0,15,0
1745830893364,EDS 289C,A01,895770,Daly; Alan J.,15,0,15,0
1745830894395,EDS 290,A00,897211,Hofstetter; Carolyn,15,0,15,0
1745830895419,LIGM 5A,A00,896162,Fischer-Grunski; Eva K,15,0,20,5
1745830896449,LIGM 5B,A00,896260,Fischer-Grunski; Eva K,17,0,20,3
1745830897478,LIGM 5C,A00,896308,Fischer-Grunski; Eva K,18,0,20,2
1745830898508,LIIT 5AS,A00,896313,Carnelos; Chiara,17,0,20,3
1745830899534,LIIT 5BS,A00,896416,Carnelos; Chiara,20,0,20,0
1745830900560,LIIT 5CS,A00,896564,Carnelos; Chiara,20,0,20,0
1745830901586,LISP 5A,A00,896588,Munoz Sanchez; Alicia,4,0,20,16
1745830902613,LISP 5B,A00,896653,Munoz Sanchez; Alicia,10,0,20,10
1745830903638,LISP 5C,A00,896655,Munoz Sanchez; Alicia,4,0,20,16
1745830904667,MAE 197,001,957918,Kleissl; Jan,9998,0,9999,1
1745830905693,MATH 2,A01,957937,Staff,34,0,35,1
1745830906721,MATH 197,001,957876,Kedlaya; Kiran S.,9993,0,9999,6
1745830907790,MCWP 40,A00,892729,Duru; Nur,13,0,20,7
1745830907790,MCWP 40,B00,893304,Montejo; Carolina,20,0,20,0
1745830908817,MCWP 40R,A00,893757,Redela; Pamela Morgan,0,7,20,20
1745830909847,MCWP 50,A00,893758,Morshed; Michael James,2,0,20,18
1745830909847,MCWP 50,B00,893761,Bartulis; Jason Michael,18,0,20,2
1745830910878,MCWP 50R,A00,893766,Compas; Sean Matthew,0,1,20,20
1745830910878,MCWP 50R,B00,893769,Carter; Jennifer A,0,0,20,20
1745830910878,MCWP 50R,C00,893771,Krone; Jarret,0,3,20,20
1745830910878,MCWP 50R,D00,893772,Miller; Elizabeth Deen,3,0,20,17
1745830910878,MCWP 50R,E00,893775,Carter; Andrea L,0,0,20,20
1745830911903,MMW 11R,A01,892721,Herbst; Matthew,11,0,27,16
1745830911903,MMW 11R,A02,892722,Herbst; Matthew,0,0,0,3
1745830912929,MMW 12R,A01,892724,Herbst; Matthew,0,10,16,16
1745830912929,MMW 12R,A02,892725,Herbst; Matthew,0,9,16,16
1745830913958,MMW 13R,A01,892727,Staff,0,3,16,16
1745830913958,MMW 13R,A02,892728,Staff,0,4,16,16
1745830913958,MMW 13R,A03,958032,Staff,0,3,16,16
1745830913958,MMW 13R,A04,958033,Staff,0,2,16,16
1745830913958,MMW 13R,A05,958034,Staff,0,3,16,16
1745830914985,SIO 295LS,A00,894015,Staff,7,0,25,18
1745830916016,SIO 295S,A00,894020,Staff,7,0,25,18
1745830917042,SIOC 290S,B01,958918,Staff,0,0,0,0
1745830918072,SIOC 291S,B01,958922,Staff,0,0,0,0
1745830919097,SOCI 117,A01,895339,Staff,4,0,5,1
1745830920128,WES 237B,A00,894149,Staff,11,0,20,9
1745830922205,AESE 279B,A00,891859,Staff,13,0,35,22
1745830923233,AIP 197,001,891854,Staff,70,0,70,0
1745830924262,ANTH 289S,A00,891856,Gagneux; Pascal,12,0,12,0
1745830925288,BENG 196,001,957946,Engler; Adam J.,9996,0,9999,3
1745830926316,CAT 124RS,A01,956906,Staff,8,0,25,17
1745830927345,CAT 125RS,A01,922013,Staff,8,0,25,17
1745830928371,CLRE 250,A00,891860,Morris; Sheldon,9995,0,9999,4
1745830930422,CLRE 251R,A00,907817,Mehta; Ravindra L.,9994,0,9999,5
1745830931450,CLRE 252,A00,891864,Cuomo; Raphael Eduardo,9993,0,9999,6
1745830932479,CLRE 253,A00,891867,Vaida; Florin,9994,0,9999,5
1745830932479,CLRE 253,B00,907819,Staff,9999,0,9999,0
1745830933509,CLRE 259,A00,891868,Patel; Hemal,9998,0,9999,1
1745830934535,CLRE 260,A00,891872,Cuomo; Raphael Eduardo,9999,0,9999,0
1745830935559,CLRE 297,001,891888,Cuomo; Raphael Eduardo,9999,0,9999,0
1745830936587,CSE 191,A00,958773,Minnes Kemp; Mor Mia,9999,0,9999,0
1745830937618,CSS 201S,A01,892054,Mignozzetti; Umberto,30,0,30,0
1745830938643,CSS 202S,A01,892056,Mignozzetti; Umberto,30,0,30,0
1745830939672,DSC 197,001,956898,Eldridge; Justin Matthew,9998,0,9999,1
1745830940701,DSC 297,001,958000,Mazumdar; Arya,9998,0,9999,1
1745830941727,EAP 100,A00,905686,Staff,9776,0,9999,223
1745830942757,ECE 45,A01,892618,Staff,0,13,50,50
1745830943785,ECE 109,A01,892620,Staff,0,43,0,0
1745830944812,ECE 111,A01,892719,Staff,0,9,50,50
1745830945839,ECE 197,001,957920,Mercier; Patrick Philip,9992,0,9999,7
1745830946871,ECON 178,A01,907814,Zhu; Ying,28,0,35,7
1745830947896,EDS 115,A00,895312,Staff,41,0,45,4
1745830948922,EDS 117,A01,895337,Staff,30,0,30,0
1745830949949,EDS 125,A00,895341,Jones; Gabrielle Anastasia,43,0,45,2
1745830950974,EDS 128A,A01,895459,Fargason; Sharon Gayle,44,0,45,1
1745830952000,EDS 128B,A01,895543,Pappas; Elizabeth,44,0,45,1
1745830953026,EDS 139,A00,897203,Pappas; Elizabeth,44,0,45,1
1745830953026,EDS 139,B00,897209,Fargason; Sharon Gayle,44,0,45,1
1745830954052,EDS 201,A00,895545,Staff,43,0,45,2
1745830955082,EDS 203,A01,895581,Halter; Christopher P.,43,0,45,2
1745830956112,EDS 204R,A01,895625,Heinzman; Erica M.,43,0,45,2
1745830956112,EDS 204R,B01,895693,Halter; Christopher P.,18,0,45,27
1745830957137,EDS 206R,A00,895694,Fargason; Sharon Gayle,9,0,30,21
1745830957137,EDS 206R,B00,895695,Choi; Bailey Miyeon,20,0,30,10
1745830958163,EDS 250,A00,895697,Hemans; Patricia Ann Benitez,43,0,45,2
1745830959191,EDS 281,A00,895701,Meyerott; Theresa Ann,15,0,15,0
1745830960217,EDS 284,A00,895736,Meyerott; Theresa Ann,15,0,15,0
1745830961242,EDS 286,A00,897210,Fine; Sarah,15,0,15,0
1745830962269,EDS 289C,A01,895770,Daly; Alan J.,15,0,15,0
1745830963295,EDS 290,A00,897211,Hofstetter; Carolyn,15,0,15,0
1745830964325,LIGM 5A,A00,896162,Fischer-Grunski; Eva K,15,0,20,5
1745830965356,LIGM 5B,A00,896260,Fischer-Grunski; Eva K,17,0,20,3
1745830966385,LIGM 5C,A00,896308,Fischer-Grunski; Eva K,18,0,20,2
1745830967415,LIIT 5AS,A00,896313,Carnelos; Chiara,17,0,20,3
1745830968441,LIIT 5BS,A00,896416,Carnelos; Chiara,20,0,20,0
1745830969469,LIIT 5CS,A00,896564,Carnelos; Chiara,20,0,20,0
1745830970496,LISP 5A,A00,896588,Munoz Sanchez; Alicia,4,0,20,16
1745830971526,LISP 5B,A00,896653,Munoz Sanchez; Alicia,10,0,20,10
1745830972555,LISP 5C,A00,896655,Munoz Sanchez; Alicia,4,0,20,16
1745830973581,MAE 197,001,957918,Kleissl; Jan,9998,0,9999,1
1745830974607,MATH 2,A01,957937,Staff,34,0,35,1
1745830975634,MATH 197,001,957876,Kedlaya; Kiran S.,9993,0,9999,6
1745830976660,MCWP 40,A00,892729,Duru; Nur,13,0,20,7
1745830976660,MCWP 40,B00,893304,Montejo; Carolina,20,0,20,0
1745830977685,MCWP 40R,A00,893757,Redela; Pamela Morgan,0,7,20,20
1745830978712,MCWP 50,A00,893758,Morshed; Michael James,2,0,20,18
1745830978712,MCWP 50,B00,893761,Bartulis; Jason Michael,18,0,20,2
1745830979741,MCWP 50R,A00,893766,Compas; Sean Matthew,0,1,20,20
1745830979741,MCWP 50R,B00,893769,Carter; Jennifer A,0,0,20,20
1745830979741,MCWP 50R,C00,893771,Krone; Jarret,0,3,20,20
1745830979741,MCWP 50R,D00,893772,Miller; Elizabeth Deen,3,0,20,17
1745830979741,MCWP 50R,E00,893775,Carter; Andrea L,0,0,20,20
1745830980767,MMW 11R,A01,892721,Herbst; Matthew,11,0,27,16
1745830980767,MMW 11R,A02,892722,Herbst; Matthew,0,0,0,3
1745830981794,MMW 12R,A01,892724,Herbst; Matthew,0,10,16,16
1745830981794,MMW 12R,A02,892725,Herbst; Matthew,0,9,16,16
1745830982820,MMW 13R,A01,892727,Staff,0,3,16,16
1745830982820,MMW 13R,A02,892728,Staff,0,4,16,16
1745830982820,MMW 13R,A03,958032,Staff,0,3,16,16
1745830982820,MMW 13R,A04,958033,Staff,0,2,16,16
1745830982820,MMW 13R,A05,958034,Staff,0,3,16,16
1745830983849,SIO 295LS,A00,894015,Staff,7,0,25,18
1745830984878,SIO 295S,A00,894020,Staff,7,0,25,18
1745830985906,SIOC 290S,B01,958918,Staff,0,0,0,0
1745830986932,SIOC 291S,B01,958922,Staff,0,0,0,0
1745830987960,SOCI 117,A01,895339,Staff,4,0,5,1
1745830988988,WES 237B,A00,894149,Staff,11,0,20,9
1745830991068,AESE 279B,A00,891859,Staff,13,0,35,22
1745830992096,AIP 197,001,891854,Staff,70,0,70,0
1745830993123,ANTH 289S,A00,891856,Gagneux; Pascal,12,0,12,0
1745830994149,BENG 196,001,957946,Engler; Adam J.,9996,0,9999,3
1745830995174,CAT 124RS,A01,956906,Staff,8,0,25,17
1745830996200,CAT 125RS,A01,922013,Staff,8,0,25,17
1745830997227,CLRE 250,A00,891860,Morris; Sheldon,9995,0,9999,4
1745830999282,CLRE 251R,A00,907817,Mehta; Ravindra L.,9994,0,9999,5
1745831000308,CLRE 252,A00,891864,Cuomo; Raphael Eduardo,9993,0,9999,6
1745831001338,CLRE 253,A00,891867,Vaida; Florin,9994,0,9999,5
1745831001338,CLRE 253,B00,907819,Staff,9999,0,9999,0
1745831002364,CLRE 259,A00,891868,Patel; Hemal,9998,0,9999,1
1745831003400,CLRE 260,A00,891872,Cuomo; Raphael Eduardo,9999,0,9999,0
1745831004425,CLRE 297,001,891888,Cuomo; Raphael Eduardo,9999,0,9999,0
1745831005453,CSE 191,A00,958773,Minnes Kemp; Mor Mia,9999,0,9999,0
1745831006479,CSS 201S,A01,892054,Mignozzetti; Umberto,30,0,30,0
1745831007508,CSS 202S,A01,892056,Mignozzetti; Umberto,30,0,30,0
1745831008535,DSC 197,001,956898,Eldridge; Justin Matthew,9998,0,9999,1
1745831009565,DSC 297,001,958000,Mazumdar; Arya,9998,0,9999,1
1745831010593,EAP 100,A00,905686,Staff,9776,0,9999,223
1745831011618,ECE 45,A01,892618,Staff,0,13,50,50
1745831012645,ECE 109,A01,892620,Staff,0,43,0,0
1745831013673,ECE 111,A01,892719,Staff,0,9,50,50
1745831014702,ECE 197,001,957920,Mercier; Patrick Philip,9992,0,9999,7
1745831015732,ECON 178,A01,907814,Zhu; Ying,28,0,35,7
1745831016760,EDS 115,A00,895312,Staff,41,0,45,4
1745831017789,EDS 117,A01,895337,Staff,30,0,30,0
1745831018818,EDS 125,A00,895341,Jones; Gabrielle Anastasia,43,0,45,2
1745831019847,EDS 128A,A01,895459,Fargason; Sharon Gayle,44,0,45,1
1745831020873,EDS 128B,A01,895543,Pappas; Elizabeth,44,0,45,1
1745831021901,EDS 139,A00,897203,Pappas; Elizabeth,44,0,45,1
1745831021901,EDS 139,B00,897209,Fargason; Sharon Gayle,44,0,45,1
1745831022930,EDS 201,A00,895545,Staff,43,0,45,2
1745831023958,EDS 203,A01,895581,Halter; Christopher P.,43,0,45,2
1745831024984,EDS 204R,A01,895625,Heinzman; Erica M.,43,0,45,2
1745831024984,EDS 204R,B01,895693,Halter; Christopher P.,18,0,45,27
1745831026010,EDS 206R,A00,895694,Fargason; Sharon Gayle,9,0,30,21
1745831026010,EDS 206R,B00,895695,Choi; Bailey Miyeon,20,0,30,10
1745831027036,EDS 250,A00,895697,Hemans; Patricia Ann Benitez,43,0,45,2
1745831028065,EDS 281,A00,895701,Meyerott; Theresa Ann,15,0,15,0
1745831029095,EDS 284,A00,895736,Meyerott; Theresa Ann,15,0,15,0
1745831030122,EDS 286,A00,897210,Fine; Sarah,15,0,15,0
1745831031152,EDS 289C,A01,895770,Daly; Alan J.,15,0,15,0
1745831032180,EDS 290,A00,897211,Hofstetter; Carolyn,15,0,15,0
1745831033205,LIGM 5A,A00,896162,Fischer-Grunski; Eva K,15,0,20,5
1745831034236,LIGM 5B,A00,896260,Fischer-Grunski; Eva K,17,0,20,3
1745831035266,LIGM 5C,A00,896308,Fischer-Grunski; Eva K,18,0,20,2
1745831036295,LIIT 5AS,A00,896313,Carnelos; Chiara,17,0,20,3
1745831037324,LIIT 5BS,A00,896416,Carnelos; Chiara,20,0,20,0
1745831038350,LIIT 5CS,A00,896564,Carnelos; Chiara,20,0,20,0
1745831039377,LISP 5A,A00,896588,Munoz Sanchez; Alicia,4,0,20,16
1745831040404,LISP 5B,A00,896653,Munoz Sanchez; Alicia,10,0,20,10
1745831041433,LISP 5C,A00,896655,Munoz Sanchez; Alicia,4,0,20,16
1745831042464,MAE 197,001,957918,Kleissl; Jan,9998,0,9999,1
1745831043491,MATH 2,A01,957937,Staff,34,0,35,1
1745831044517,MATH 197,001,957876,Kedlaya; Kiran S.,9993,0,9999,6
1745831045545,MCWP 40,A00,892729,Duru; Nur,13,0,20,7
1745831045545,MCWP 40,B00,893304,Montejo; Carolina,20,0,20,0
1745831046574,MCWP 40R,A00,893757,Redela; Pamela Morgan,0,7,20,20
1745831047599,MCWP 50,A00,893758,Morshed; Michael James,2,0,20,18
1745831047599,MCWP 50,B00,893761,Bartulis; Jason Michael,18,0,20,2
1745831048625,MCWP 50R,A00,893766,Compas; Sean Matthew,0,1,20,20
1745831048625,MCWP 50R,B00,893769,Carter; Jennifer A,0,0,20,20
1745831048625,MCWP 50R,C00,893771,Krone; Jarret,0,3,20,20
1745831048625,MCWP 50R,D00,893772,Miller; Elizabeth Deen,3,0,20,17
1745831048625,MCWP 50R,E00,893775,Carter; Andrea L,0,0,20,20
1745831049652,MMW 11R,A01,892721,Herbst; Matthew,11,0,27,16
1745831049652,MMW 11R,A02,892722,Herbst; Matthew,0,0,0,3
1745831050679,MMW 12R,A01,892724,Herbst; Matthew,0,10,16,16
1745831050679,MMW 12R,A02,892725,Herbst; Matthew,0,9,16,16
1745831051707,MMW 13R,A01,892727,Staff,0,3,16,16
1745831051707,MMW 13R,A02,892728,Staff,0,4,16,16
1745831051707,MMW 13R,A03,958032,Staff,0,3,16,16
1745831051707,MMW 13R,A04,958033,Staff,0,2,16,16
1745831051707,MMW 13R,A05,958034,Staff,0,3,16,16
1745831052735,SIO 295LS,A00,894015,Staff,7,0,25,18
1745831053764,SIO 295S,A00,894020,Staff,7,0,25,18
1745831054791,SIOC 290S,B01,958918,Staff,0,0,0,0
1745831055818,SIOC 291S,B01,958922,Staff,0,0,0,0
1745831056846,SOCI 117,A01,895339,Staff,4,0,5,1
1745831057876,WES 237B,A00,894149,Staff,11,0,20,9
1745831059942,AESE 279B,A00,891859,Staff,13,0,35,22
1745831060969,AIP 197,001,891854,Staff,70,0,70,0
1745831061996,ANTH 289S,A00,891856,Gagneux; Pascal,12,0,12,0
1745831063024,BENG 196,001,957946,Engler; Adam J.,9996,0,9999,3
1745831064053,CAT 124RS,A01,956906,Staff,8,0,25,17
1745831065078,CAT 125RS,A01,922013,Staff,8,0,25,17
1745831066108,CLRE 250,A00,891860,Morris; Sheldon,9995,0,9999,4
1745831068162,CLRE 251R,A00,907817,Mehta; Ravindra L.,9994,0,9999,5
1745831069192,CLRE 252,A00,891864,Cuomo; Raphael Eduardo,9993,0,9999,6
1745831070219,CLRE 253,A00,891867,Vaida; Florin,9994,0,9999,5
1745831070219,CLRE 253,B00,907819,Staff,9999,0,9999,0
1745831071245,CLRE 259,A00,891868,Patel; Hemal,9998,0,9999,1
1745831072272,CLRE 260,A00,891872,Cuomo; Raphael Eduardo,9999,0,9999,0
1745831073298,CLRE 297,001,891888,Cuomo; Raphael Eduardo,9999,0,9999,0
1745831074326,CSE 191,A00,958773,Minnes Kemp; Mor Mia,9999,0,9999,0
1745831075353,CSS 201S,A01,892054,Mignozzetti; Umberto,30,0,30,0
1745831076383,CSS 202S,A01,892056,Mignozzetti; Umberto,30,0,30,0
1745831077410,DSC 197,001,956898,Eldridge; Justin Matthew,9998,0,9999,1
1745831078436,DSC 297,001,958000,Mazumdar; Arya,9998,0,9999,1
1745831079462,EAP 100,A00,905686,Staff,9776,0,9999,223
1745831080492,ECE 45,A01,892618,Staff,0,13,50,50
1745831081519,ECE 109,A01,892620,Staff,0,43,0,0
1745831082549,ECE 111,A01,892719,Staff,0,9,50,50
1745831083578,ECE 197,001,957920,Mercier; Patrick Philip,9992,0,9999,7
1745831084605,ECON 178,A01,907814,Zhu; Ying,28,0,35,7
1745831085634,EDS 115,A00,895312,Staff,41,0,45,4
1745831086660,EDS 117,A01,895337,Staff,30,0,30,0
1745831087685,EDS 125,A00,895341,Jones; Gabrielle Anastasia,43,0,45,2
1745831088712,EDS 128A,A01,895459,Fargason; Sharon Gayle,44,0,45,1
1745831089738,EDS 128B,A01,895543,Pappas; Elizabeth,44,0,45,1
1745831090765,EDS 139,A00,897203,Pappas; Elizabeth,44,0,45,1
1745831090765,EDS 139,B00,897209,Fargason; Sharon Gayle,44,0,45,1
1745831091794,EDS 201,A00,895545,Staff,43,0,45,2
1745831092821,EDS 203,A01,895581,Halter; Christopher P.,43,0,45,2
1745831093847,EDS 204R,A01,895625,Heinzman; Erica M.,43,0,45,2
1745831093847,EDS 204R,B01,895693,Halter; Christopher P.,18,0,45,27
1745831094879,EDS 206R,A00,895694,Fargason; Sharon Gayle,9,0,30,21
1745831094879,EDS 206R,B00,895695,Choi; Bailey Miyeon,20,0,30,10
1745831095906,EDS 250,A00,895697,Hemans; Patricia Ann Benitez,43,0,45,2
1745831096932,EDS 281,A00,895701,Meyerott; Theresa Ann,15,0,15,0
1745831097958,EDS 284,A00,895736,Meyerott; Theresa Ann,15,0,15,0
1745831098984,EDS 286,A00,897210,Fine; Sarah,15,0,15,0
1745831100012,EDS 289C,A01,895770,Daly; Alan J.,15,0,15,0
1745831101042,EDS 290,A00,897211,Hofstetter; Carolyn,15,0,15,0
1745831102070,LIGM 5A,A00,896162,Fischer-Grunski; Eva K,15,0,20,5
1745831103101,LIGM 5B,A00,896260,Fischer-Grunski; Eva K,17,0,20,3
1745831104127,LIGM 5C,A00,896308,Fischer-Grunski; Eva K,18,0,20,2
1745831105158,LIIT 5AS,A00,896313,Carnelos; Chiara,17,0,20,3
1745831106199,LIIT 5BS,A00,896416,Carnelos; Chiara,20,0,20,0
1745831107226,LIIT 5CS,A00,896564,Carnelos; Chiara,20,0,20,0
1745831108256,LISP 5A,A00,896588,Munoz Sanchez; Alicia,4,0,20,16
1745831109288,LISP 5B,A00,896653,Munoz Sanchez; Alicia,10,0,20,10
1745831110319,LISP 5C,A00,896655,Munoz Sanchez; Alicia,4,0,20,16
1745831111345,MAE 197,001,957918,Kleissl; Jan,9998,0,9999,1
1745831112371,MATH 2,A01,957937,Staff,34,0,35,1
1745831113400,MATH 197,001,957876,Kedlaya; Kiran S.,9993,0,9999,6
1745831114428,MCWP 40,A00,892729,Duru; Nur,13,0,20,7
1745831114428,MCWP 40,B00,893304,Montejo; Carolina,20,0,20,0
1745831115453,MCWP 40R,A00,893757,Redela; Pamela Morgan,0,7,20,20
1745831116478,MCWP 50,A00,893758,Morshed; Michael James,2,0,20,18
1745831116478,MCWP 50,B00,893761,Bartulis; Jason Michael,18,0,20,2
1745831117505,MCWP 50R,A00,893766,Compas; Sean Matthew,0,1,20,20
1745831117505,MCWP 50R,B00,893769,Carter; Jennifer A,0,0,20,20
1745831117505,MCWP 50R,C00,893771,Krone; Jarret,0,3,20,20
1745831117505,MCWP 50R,D00,893772,Miller; Elizabeth Deen,3,0,20,17
1745831117505,MCWP 50R,E00,893775,Carter; Andrea L,0,0,20,20
1745831118532,MMW 11R,A01,892721,Herbst; Matthew,11,0,27,16
1745831118532,MMW 11R,A02,892722,Herbst; Matthew,0,0,0,3
1745831119562,MMW 12R,A01,892724,Herbst; Matthew,0,10,16,16
1745831119562,MMW 12R,A02,892725,Herbst; Matthew,0,9,16,16
1745831120588,MMW 13R,A01,892727,Staff,0,3,16,16
1745831120588,MMW 13R,A02,892728,Staff,0,4,16,16
1745831120588,MMW 13R,A03,958032,Staff,0,3,16,16
1745831120588,MMW 13R,A04,958033,Staff,0,2,16,16
1745831120588,MMW 13R,A05,958034,Staff,0,3,16,16
1745831121616,SIO 295LS,A00,894015,Staff,7,0,25,18
1745831122645,SIO 295S,A00,894020,Staff,7,0,25,18
1745831123672,SIOC 290S,B01,958918,Staff,0,0,0,0
1745831124706,SIOC 291S,B01,958922,Staff,0,0,0,0
1745831125732,SOCI 117,A01,895339,Staff,4,0,5,1
1745831126762,WES 237B,A00,894149,Staff,11,0,20,9
1745831128836,AESE 279B,A00,891859,Staff,13,0,35,22
1745831129861,AIP 197,001,891854,Staff,70,0,70,0
1745831130886,ANTH 289S,A00,891856,Gagneux; Pascal,12,0,12,0
1745831131912,BENG 196,001,957946,Engler; Adam J.,9996,0,9999,3
1745831132938,CAT 124RS,A01,956906,Staff,8,0,25,17
1745831133970,CAT 125RS,A01,922013,Staff,8,0,25,17
1745831135000,CLRE 250,A00,891860,Morris; Sheldon,9995,0,9999,4
1745831137058,CLRE 251R,A00,907817,Mehta; Ravindra L.,9994,0,9999,5
1745831138085,CLRE 252,A00,891864,Cuomo; Raphael Eduardo,9993,0,9999,6
1745831139114,CLRE 253,A00,891867,Vaida; Florin,9994,0,9999,5
1745831139114,CLRE 253,B00,907819,Staff,9999,0,9999,0
1745831140142,CLRE 259,A00,891868,Patel; Hemal,9998,0,9999,1
1745831141170,CLRE 260,A00,891872,Cuomo; Raphael Eduardo,9999,0,9999,0
1745831142196,CLRE 297,001,891888,Cuomo; Raphael Eduardo,9999,0,9999,0
1745831143222,CSE 191,A00,958773,Minnes Kemp; Mor Mia,9999,0,9999,0
1745831144254,CSS 201S,A01,892054,Mignozzetti; Umberto,30,0,30,0
1745831145280,CSS 202S,A01,892056,Mignozzetti; Umberto,30,0,30,0
1745831146307,DSC 197,001,956898,Eldridge; Justin Matthew,9998,0,9999,1
1745831147336,DSC 297,001,958000,Mazumdar; Arya,9998,0,9999,1
1745831148363,EAP 100,A00,905686,Staff,9776,0,9999,223
1745831149388,ECE 45,A01,892618,Staff,0,13,50,50
1745831150420,ECE 109,A01,892620,Staff,0,43,0,0
1745831151448,ECE 111,A01,892719,Staff,0,9,50,50
1745831152476,ECE 197,001,957920,Mercier; Patrick Philip,9992,0,9999,7
1745831153513,ECON 178,A01,907814,Zhu; Ying,28,0,35,7
1745831154542,EDS 115,A00,895312,Staff,41,0,45,4
1745831155566,EDS 117,A01,895337,Staff,30,0,30,0
1745831156592,EDS 125,A00,895341,Jones; Gabrielle Anastasia,43,0,45,2
1745831157618,EDS 128A,A01,895459,Fargason; Sharon Gayle,44,0,45,1
1745831158643,EDS 128B,A01,895543,Pappas; Elizabeth,44,0,45,1
1745831159672,EDS 139,A00,897203,Pappas; Elizabeth,44,0,45,1
1745831159672,EDS 139,B00,897209,Fargason; Sharon Gayle,44,0,45,1
1745831160697,EDS 201,A00,895545,Staff,43,0,45,2
1745831161728,EDS 203,A01,895581,Halter; Christopher P.,43,0,45,2
1745831162754,EDS 204R,A01,895625,Heinzman; Erica M.,43,0,45,2
1745831162754,EDS 204R,B01,895693,Halter; Christopher P.,18,0,45,27
1745831163779,EDS 206R,A00,895694,Fargason; Sharon Gayle,9,0,30,21
1745831163779,EDS 206R,B00,895695,Choi; Bailey Miyeon,20,0,30,10
1745831164806,EDS 250,A00,895697,Hemans; Patricia Ann Benitez,43,0,45,2
1745831165833,EDS 281,A00,895701,Meyerott; Theresa Ann,15,0,15,0
1745831166859,EDS 284,A00,895736,Meyerott; Theresa Ann,15,0,15,0
1745831167888,EDS 286,A00,897210,Fine; Sarah,15,0,15,0
1745831168916,EDS 289C,A01,895770,Daly; Alan J.,15,0,15,0
1745831169942,EDS 290,A00,897211,Hofstetter; Carolyn,15,0,15,0
1745831170974,LIGM 5A,A00,896162,Fischer-Grunski; Eva K,15,0,20,5
1745831171999,LIGM 5B,A00,896260,Fischer-Grunski; Eva K,17,0,20,3
1745831173025,LIGM 5C,A00,896308,Fischer-Grunski; Eva K,18,0,20,2
1745831174052,LIIT 5AS,A00,896313,Carnelos; Chiara,17,0,20,3
1745831175079,LIIT 5BS,A00,896416,Carnelos; Chiara,20,0,20,0
1745831176106,LIIT 5CS,A00,896564,Carnelos; Chiara,20,0,20,0
1745831177135,LISP 5A,A00,896588,Munoz Sanchez; Alicia,4,0,20,16
1745831178165,LISP 5B,A00,896653,Munoz Sanchez; Alicia,10,0,20,10
1745831179195,LISP 5C,A00,896655,Munoz Sanchez; Alicia,4,0,20,16
1745831180221,MAE 197,001,957918,Kleissl; Jan,9998,0,9999,1
1745831181247,MATH 2,A01,957937,Staff,34,0,35,1
1745831182273,MATH 197,001,957876,Kedlaya; Kiran S.,9993,0,9999,6
1745831183302,MCWP 40,A00,892729,Duru; Nur,13,0,20,7
1745831183302,MCWP 40,B00,893304,Montejo; Carolina,20,0,20,0
1745831184331,MCWP 40R,A00,893757,Redela; Pamela Morgan,0,7,20,20
1745831185357,MCWP 50,A00,893758,Morshed; Michael James,2,0,20,18
1745831185357,MCWP 50,B00,893761,Bartulis; Jason Michael,18,0,20,2
1745831186390,MCWP 50R,A00,893766,Compas; Sean Matthew,0,1,20,20
1745831186390,MCWP 50R,B00,893769,Carter; Jennifer A,0,0,20,20
1745831186390,MCWP 50R,C00,893771,Krone; Jarret,0,3,20,20
1745831186390,MCWP 50R,D00,893772,Miller; Elizabeth Deen,3,0,20,17
1745831186390,MCWP 50R,E00,893775,Carter; Andrea L,0,0,20,20
1745831187415,MMW 11R,A01,892721,Herbst; Matthew,11,0,27,16
1745831187415,MMW 11R,A02,892722,Herbst; Matthew,0,0,0,3
1745831188440,MMW 12R,A01,892724,Herbst; Matthew,0,10,16,16
1745831188440,MMW 12R,A02,892725,Herbst; Matthew,0,9,16,16
1745831189471,MMW 13R,A01,892727,Staff,0,3,16,16
1745831189471,MMW 13R,A02,892728,Staff,0,4,16,16
1745831189471,MMW 13R,A03,958032,Staff,0,3,16,16
1745831189471,MMW 13R,A04,958033,Staff,0,2,16,16
1745831189471,MMW 13R,A05,958034,Staff,0,3,16,16
1745831190502,SIO 295LS,A00,894015,Staff,7,0,25,18
1745831191528,SIO 295S,A00,894020,Staff,7,0,25,18
1745831192557,SIOC 290S,B01,958918,Staff,0,0,0,0
1745831193600,SIOC 291S,B01,958922,Staff,0,0,0,0
1745831194626,SOCI 117,A01,895339,Staff,4,0,5,1
1745831195655,WES 237B,A00,894149,Staff,11,0,20,9
1745831197752,AESE 279B,A00,891859,Staff,13,0,35,22
1745831198779,AIP 197,001,891854,Staff,70,0,70,0
1745831199811,ANTH 289S,A00,891856,Gagneux; Pascal,12,0,12,0
1745831200842,BENG 196,001,957946,Engler; Adam J.,9996,0,9999,3
1745831201868,CAT 124RS,A01,956906,Staff,8,0,25,17
1745831202900,CAT 125RS,A01,922013,Staff,8,0,25,17
1745831203930,CLRE 250,A00,891860,Morris; Sheldon,9995,0,9999,4
1745831205989,CLRE 251R,A00,907817,Mehta; Ravindra L.,9994,0,9999,5
1745831207017,CLRE 252,A00,891864,Cuomo; Raphael Eduardo,9993,0,9999,6
1745831208045,CLRE 253,A00,891867,Vaida; Florin,9994,0,9999,5
1745831208045,CLRE 253,B00,907819,Staff,9999,0,9999,0
1745831209072,CLRE 259,A00,891868,Patel; Hemal,9998,0,9999,1
1745831210103,CLRE 260,A00,891872,Cuomo; Raphael Eduardo,9999,0,9999,0
1745831211131,CLRE 297,001,891888,Cuomo; Raphael Eduardo,9999,0,9999,0
1745831212163,CSE 191,A00,958773,Minnes Kemp; Mor Mia,9999,0,9999,0
1745831213191,CSS 201S,A01,892054,Mignozzetti; Umberto,30,0,30,0
1745831214218,CSS 202S,A01,892056,Mignozzetti; Umberto,30,0,30,0
1745831215247,DSC 197,001,956898,Eldridge; Justin Matthew,9998,0,9999,1
1745831216275,DSC 297,001,958000,Mazumdar; Arya,9998,0,9999,1
1745831217302,EAP 100,A00,905686,Staff,9776,0,9999,223
1745831218334,ECE 45,A01,892618,Staff,0,13,50,50
1745831219367,ECE 109,A01,892620,Staff,0,43,0,0
1745831220394,ECE 111,A01,892719,Staff,0,9,50,50
1745831221424,ECE 197,001,957920,Mercier; Patrick Philip,9992,0,9999,7
1745831222456,ECON 178,A01,907814,Zhu; Ying,28,0,35,7
1745831223487,EDS 115,A00,895312,Staff,41,0,45,4
1745831224519,EDS 117,A01,895337,Staff,30,0,30,0
1745831225546,EDS 125,A00,895341,Jones; Gabrielle Anastasia,43,0,45,2
1745831226574,EDS 128A,A01,895459,Fargason; Sharon Gayle,44,0,45,1
1745831227601,EDS 128B,A01,895543,Pappas; Elizabeth,44,0,45,1
1745831228633,EDS 139,A00,897203,Pappas; Elizabeth,44,0,45,1
1745831228633,EDS 139,B00,897209,Fargason; Sharon Gayle,44,0,45,1
1745831229659,EDS 201,A00,895545,Staff,43,0,45,2
1745831230690,EDS 203,A01,895581,Halter; Christopher P.,43,0,45,2
1745831231718,EDS 204R,A01,895625,Heinzman; Erica M.,43,0,45,2
1745831231718,EDS 204R,B01,895693,Halter; Christopher P.,18,0,45,27
1745831232758,EDS 206R,A00,895694,Fargason; Sharon Gayle,9,0,30,21
1745831232758,EDS 206R,B00,895695,Choi; Bailey Miyeon,20,0,30,10
1745831233784,EDS 250,A00,895697,Hemans; Patricia Ann Benitez,43,0,45,2
1745831234812,EDS 281,A00,895701,Meyerott; Theresa Ann,15,0,15,0
1745831235840,EDS 284,A00,895736,Meyerott; Theresa Ann,15,0,15,0
1745831236872,EDS 286,A00,897210,Fine; Sarah,15,0,15,0
1745831237902,EDS 289C,A01,895770,Daly; Alan J.,15,0,15,0
1745831238932,EDS 290,A00,897211,Hofstetter; Carolyn,15,0,15,0
1745831239965,LIGM 5A,A00,896162,Fischer-Grunski; Eva K,15,0,20,5
1745831240993,LIGM 5B,A00,896260,Fischer-Grunski; Eva K,17,0,20,3
1745831242020,LIGM 5C,A00,896308,Fischer-Grunski; Eva K,18,0,20,2
1745831243053,LIIT 5AS,A00,896313,Carnelos; Chiara,17,0,20,3
1745831244081,LIIT 5BS,A00,896416,Carnelos; Chiara,20,0,20,0
1745831245113,LIIT 5CS,A00,896564,Carnelos; Chiara,20,0,20,0
1745831246142,LISP 5A,A00,896588,Munoz Sanchez; Alicia,4,0,20,16
1745831247169,LISP 5B,A00,896653,Munoz Sanchez; Alicia,10,0,20,10
1745831248200,LISP 5C,A00,896655,Munoz Sanchez; Alicia,4,0,20,16
1745831249243,MAE 197,001,957918,Kleissl; Jan,9998,0,9999,1
1745831250274,MATH 2,A01,957937,Staff,34,0,35,1
1745831251305,MATH 197,001,957876,Kedlaya; Kiran S.,9993,0,9999,6
1745831252336,MCWP 40,A00,892729,Duru; Nur,13,0,20,7
1745831252336,MCWP 40,B00,893304,Montejo; Carolina,20,0,20,0
1745831253369,MCWP 40R,A00,893757,Redela; Pamela Morgan,0,7,20,20
1745831254402,MCWP 50,A00,893758,Morshed; Michael James,2,0,20,18
1745831254402,MCWP 50,B00,893761,Bartulis; Jason Michael,18,0,20,2
1745831255441,MCWP 50R,A00,893766,Compas; Sean Matthew,0,1,20,20
1745831255441,MCWP 50R,B00,893769,Carter; Jennifer A,0,0,20,20
1745831255441,MCWP 50R,C00,893771,Krone; Jarret,0,3,20,20
1745831255441,MCWP 50R,D00,893772,Miller; Elizabeth Deen,3,0,20,17
1745831255441,MCWP 50R,E00,893775,Carter; Andrea L,0,0,20,20
1745831256469,MMW 11R,A01,892721,Herbst; Matthew,11,0,27,16
1745831256469,MMW 11R,A02,892722,Herbst; Matthew,0,0,0,3
1745831257496,MMW 12R,A01,892724,Herbst; Matthew,0,10,16,16
1745831257496,MMW 12R,A02,892725,Herbst; Matthew,0,9,16,16
1745831258524,MMW 13R,A01,892727,Staff,0,3,16,16
1745831258524,MMW 13R,A02,892728,Staff,0,4,16,16
1745831258524,MMW 13R,A03,958032,Staff,0,3,16,16
1745831258524,MMW 13R,A04,958033,Staff,0,2,16,16
1745831258524,MMW 13R,A05,958034,Staff,0,3,16,16
1745831259551,SIO 295LS,A00,894015,Staff,7,0,25,18
1745831260580,SIO 295S,A00,894020,Staff,7,0,25,18
1745831261614,SIOC 290S,B01,958918,Staff,0,0,0,0
1745831262642,SIOC 291S,B01,958922,Staff,0,0,0,0
1745831263676,SOCI 117,A01,895339,Staff,4,0,5,1
1745831264706,WES 237B,A00,894149,Staff,11,0,20,9
1745831266838,AESE 279B,A00,891859,Staff,13,0,35,22
1745831267868,AIP 197,001,891854,Staff,70,0,70,0
1745831268902,ANTH 289S,A00,891856,Gagneux; Pascal,12,0,12,0
1745831269932,BENG 196,001,957946,Engler; Adam J.,9996,0,9999,3
1745831270969,CAT 124RS,A01,956906,Staff,8,0,25,17
1745831271997,CAT 125RS,A01,922013,Staff,8,0,25,17
1745831273024,CLRE 250,A00,891860,Morris; Sheldon,9995,0,9999,4
1745831275079,CLRE 251R,A00,907817,Mehta; Ravindra L.,9994,0,9999,5
1745831276110,CLRE 252,A00,891864,Cuomo; Raphael Eduardo,9993,0,9999,6
1745831277145,CLRE 253,A00,891867,Vaida; Florin,9994,0,9999,5
1745831277145,CLRE 253,B00,907819,Staff,9999,0,9999,0
1745831278171,CLRE 259,A00,891868,Patel; Hemal,9998,0,9999,1
1745831279201,CLRE 260,A00,891872,Cuomo; Raphael Eduardo,9999,0,9999,0
1745831280232,CLRE 297,001,891888,Cuomo; Raphael Eduardo,9999,0,9999,0
1745831281266,CSE 191,A00,958773,Minnes Kemp; Mor Mia,9999,0,9999,0
1745831282299,CSS 201S,A01,892054,Mignozzetti; Umberto,30,0,30,0
1745831283330,CSS 202S,A01,892056,Mignozzetti; Umberto,30,0,30,0
1745831284357,DSC 197,001,956898,Eldridge; Justin Matthew,9998,0,9999,1
1745831285383,DSC 297,001,958000,Mazumdar; Arya,9998,0,9999,1
1745831286413,EAP 100,A00,905686,Staff,9776,0,9999,223
1745831287442,ECE 45,A01,892618,Staff,0,13,50,50
1745831288468,ECE 109,A01,892620,Staff,0,43,0,0
1745831289496,ECE 111,A01,892719,Staff,0,9,50,50
1745831290522,ECE 197,001,957920,Mercier; Patrick Philip,9992,0,9999,7
1745831291554,ECON 178,A01,907814,Zhu; Ying,28,0,35,7
1745831292583,EDS 115,A00,895312,Staff,41,0,45,4
1745831293608,EDS 117,A01,895337,Staff,30,0,30,0
1745831294642,EDS 125,A00,895341,Jones; Gabrielle Anastasia,43,0,45,2
1745831295674,EDS 128A,A01,895459,Fargason; Sharon Gayle,44,0,45,1
1745831296701,EDS 128B,A01,895543,Pappas; Elizabeth,44,0,45,1
1745831297758,EDS 139,A00,897203,Pappas; Elizabeth,44,0,45,1
1745831297758,EDS 139,B00,897209,Fargason; Sharon Gayle,44,0,45,1
1745831298785,EDS 201,A00,895545,Staff,43,0,45,2
1745831299813,EDS 203,A01,895581,Halter; Christopher P.,43,0,45,2
1745831300845,EDS 204R,A01,895625,Heinzman; Erica M.,43,0,45,2
1745831300845,EDS 204R,B01,895693,Halter; Christopher P.,18,0,45,27
1745831301875,EDS 206R,A00,895694,Fargason; Sharon Gayle,9,0,30,21
1745831301875,EDS 206R,B00,895695,Choi; Bailey Miyeon,20,0,30,10
1745831302903,EDS 250,A00,895697,Hemans; Patricia Ann Benitez,43,0,45,2
1745831303929,EDS 281,A00,895701,Meyerott; Theresa Ann,15,0,15,0
1745831304963,EDS 284,A00,895736,Meyerott; Theresa Ann,15,0,15,0
1745831305999,EDS 286,A00,897210,Fine; Sarah,15,0,15,0
1745831307025,EDS 289C,A01,895770,Daly; Alan J.,15,0,15,0
1745831308054,EDS 290,A00,897211,Hofstetter; Carolyn,15,0,15,0
1745831309087,LIGM 5A,A00,896162,Fischer-Grunski; Eva K,15,0,20,5
1745831310119,LIGM 5B,A00,896260,Fischer-Grunski; Eva K,17,0,20,3
1745831311151,LIGM 5C,A00,896308,Fischer-Grunski; Eva K,18,0,20,2
1745831312179,LIIT 5AS,A00,896313,Carnelos; Chiara,17,0,20,3
1745831313214,LIIT 5BS,A00,896416,Carnelos; Chiara,20,0,20,0
1745831314242,LIIT 5CS,A00,896564,Carnelos; Chiara,20,0,20,0
1745831315273,LISP 5A,A00,896588,Munoz Sanchez; Alicia,4,0,20,16
1745831316304,LISP 5B,A00,896653,Munoz Sanchez; Alicia,10,0,20,10
1745831317334,LISP 5C,A00,896655,Munoz Sanchez; Alicia,4,0,20,16
1745831318369,MAE 197,001,957918,Kleissl; Jan,9998,0,9999,1
1745831319403,MATH 2,A01,957937,Staff,34,0,35,1
1745831320437,MATH 197,001,957876,Kedlaya; Kiran S.,9993,0,9999,6
1745831321468,MCWP 40,A00,892729,Duru; Nur,13,0,20,7
1745831321468,MCWP 40,B00,893304,Montejo; Carolina,20,0,20,0
1745831322497,MCWP 40R,A00,893757,Redela; Pamela Morgan,0,7,20,20
1745831323526,MCWP 50,A00,893758,Morshed; Michael James,2,0,20,18
1745831323526,MCWP 50,B00,893761,Bartulis; Jason Michael,18,0,20,2
1745831324589,MCWP 50R,A00,893766,Compas; Sean Matthew,0,1,20,20
1745831324589,MCWP 50R,B00,893769,Carter; Jennifer A,0,0,20,20
1745831324589,MCWP 50R,C00,893771,Krone; Jarret,0,3,20,20
1745831324589,MCWP 50R,D00,893772,Miller; Elizabeth Deen,3,0,20,17
1745831324589,MCWP 50R,E00,893775,Carter; Andrea L,0,0,20,20
1745831325616,MMW 11R,A01,892721,Herbst; Matthew,11,0,27,16
1745831325616,MMW 11R,A02,892722,Herbst; Matthew,0,0,0,3
1745831326663,MMW 12R,A01,892724,Herbst; Matthew,0,10,16,16
1745831326663,MMW 12R,A02,892725,Herbst; Matthew,0,9,16,16
1745831327695,MMW 13R,A01,892727,Staff,0,3,16,16
1745831327695,MMW 13R,A02,892728,Staff,0,4,16,16
1745831327695,MMW 13R,A03,958032,Staff,0,3,16,16
1745831327695,MMW 13R,A04,958033,Staff,0,2,16,16
1745831327695,MMW 13R,A05,958034,Staff,0,3,16,16
1745831328723,SIO 295LS,A00,894015,Staff,7,0,25,18
1745831329752,SIO 295S,A00,894020,Staff,7,0,25,18
1745831330783,SIOC 290S,B01,958918,Staff,0,0,0,0
1745831331816,SIOC 291S,B01,958922,Staff,0,0,0,0
1745831332844,SOCI 117,A01,895339,Staff,4,0,5,1
1745831333873,WES 237B,A00,894149,Staff,11,0,20,9
1745831335969,AESE 279B,A00,891859,Staff,13,0,35,22
1745831336998,AIP 197,001,891854,Staff,70,0,70,0
1745831338027,ANTH 289S,A00,891856,Gagneux; Pascal,12,0,12,0
1745831339058,BENG 196,001,957946,Engler; Adam J.,9996,0,9999,3
1745831340095,CAT 124RS,A01,956906,Staff,8,0,25,17
1745831341128,CAT 125RS,A01,922013,Staff,8,0,25,17
1745831342167,CLRE 250,A00,891860,Morris; Sheldon,9995,0,9999,4
1745831344231,CLRE 251R,A00,907817,Mehta; Ravindra L.,9994,0,9999,5
1745831345258,CLRE 252,A00,891864,Cuomo; Raphael Eduardo,9993,0,9999,6
1745831346288,CLRE 253,A00,891867,Vaida; Florin,9994,0,9999,5
1745831346288,CLRE 253,B00,907819,Staff,9999,0,9999,0
1745831347315,CLRE 259,A00,891868,Patel; Hemal,9998,0,9999,1
1745831348345,CLRE 260,A00,891872,Cuomo; Raphael Eduardo,9999,0,9999,0
1745831349373,CLRE 297,001,891888,Cuomo; Raphael Eduardo,9999,0,9999,0
1745831350401,CSE 191,A00,958773,Minnes Kemp; Mor Mia,9999,0,9999,0
1745831351429,CSS 201S,A01,892054,Mignozzetti; Umberto,30,0,30,0
1745831352460,CSS 202S,A01,892056,Mignozzetti; Umberto,30,0,30,0
1745831353490,DSC 197,001,956898,Eldridge; Justin Matthew,9998,0,9999,1
1745831354522,DSC 297,001,958000,Mazumdar; Arya,9998,0,9999,1
1745831355555,EAP 100,A00,905686,Staff,9776,0,9999,223
1745831356583,ECE 45,A01,892618,Staff,0,13,50,50
1745831357608,ECE 109,A01,892620,Staff,0,43,0,0
1745831358636,ECE 111,A01,892719,Staff,0,9,50,50
1745831359676,ECE 197,001,957920,Mercier; Patrick Philip,9992,0,9999,7
1745831360705,ECON 178,A01,907814,Zhu; Ying,28,0,35,7
1745831361731,EDS 115,A00,895312,Staff,41,0,45,4
1745831362763,EDS 117,A01,895337,Staff,30,0,30,0
1745831363793,EDS 125,A00,895341,Jones; Gabrielle Anastasia,43,0,45,2
1745831364824,EDS 128A,A01,895459,Fargason; Sharon Gayle,44,0,45,1
1745831365852,EDS 128B,A01,895543,Pappas; Elizabeth,44,0,45,1
1745831366878,EDS 139,A00,897203,Pappas; Elizabeth,44,0,45,1
1745831366878,EDS 139,B00,897209,Fargason; Sharon Gayle,44,0,45,1
1745831367906,EDS 201,A00,895545,Staff,43,0,45,2
1745831368932,EDS 203,A01,895581,Halter; Christopher P.,43,0,45,2
1745831369964,EDS 204R,A01,895625,Heinzman; Erica M.,43,0,45,2
1745831369964,EDS 204R,B01,895693,Halter; Christopher P.,18,0,45,27
1745831371002,EDS 206R,A00,895694,Fargason; Sharon Gayle,9,0,30,21
1745831371002,EDS 206R,B00,895695,Choi; Bailey Miyeon,20,0,30,10
1745831372035,EDS 250,A00,895697,Hemans; Patricia Ann Benitez,43,0,45,2
1745831373061,EDS 281,A00,895701,Meyerott; Theresa Ann,15,0,15,0
1745831374088,EDS 284,A00,895736,Meyerott; Theresa Ann,15,0,15,0
1745831375275,EDS 286,A00,897210,Fine; Sarah,15,0,15,0
1745831376303,EDS 289C,A01,895770,Daly; Alan J.,15,0,15,0
1745831377342,EDS 290,A00,897211,Hofstetter; Carolyn,15,0,15,0
1745831378370,LIGM 5A,A00,896162,Fischer-Grunski; Eva K,15,0,20,5
1745831379398,LIGM 5B,A00,896260,Fischer-Grunski; Eva K,17,0,20,3
1745831380427,LIGM 5C,A00,896308,Fischer-Grunski; Eva K,18,0,20,2
1745831381464,LIIT 5AS,A00,896313,Carnelos; Chiara,17,0,20,3
1745831382495,LIIT 5BS,A00,896416,Carnelos; Chiara,20,0,20,0
1745831383532,LIIT 5CS,A00,896564,Carnelos; Chiara,20,0,20,0
1745831384568,LISP 5A,A00,896588,Munoz Sanchez; Alicia,4,0,20,16
1745831385601,LISP 5B,A00,896653,Munoz Sanchez; Alicia,10,0,20,10
1745831386627,LISP 5C,A00,896655,Munoz Sanchez; Alicia,4,0,20,16
1745831387653,MAE 197,001,957918,Kleissl; Jan,9998,0,9999,1
1745831388681,MATH 2,A01,957937,Staff,34,0,35,1
1745831389710,MATH 197,001,957876,Kedlaya; Kiran S.,9993,0,9999,6
1745831390738,MCWP 40,A00,892729,Duru; Nur,13,0,20,7
1745831390738,MCWP 40,B00,893304,Montejo; Carolina,20,0,20,0
1745831391766,MCWP 40R,A00,893757,Redela; Pamela Morgan,0,7,20,20
1745831392794,MCWP 50,A00,893758,Morshed; Michael James,2,0,20,18
1745831392794,MCWP 50,B00,893761,Bartulis; Jason Michael,18,0,20,2
1745831393832,MCWP 50R,A00,893766,Compas; Sean Matthew,0,1,20,20
1745831393832,MCWP 50R,B00,893769,Carter; Jennifer A,0,0,20,20
1745831393832,MCWP 50R,C00,893771,Krone; Jarret,0,3,20,20
1745831393832,MCWP 50R,D00,893772,Miller; Elizabeth Deen,3,0,20,17
1745831393832,MCWP 50R,E00,893775,Carter; Andrea L,0,0,20,20
1745831394861,MMW 11R,A01,892721,Herbst; Matthew,11,0,27,16
1745831394861,MMW 11R,A02,892722,Herbst; Matthew,0,0,0,3
1745831395887,MMW 12R,A01,892724,Herbst; Matthew,0,10,16,16
1745831395887,MMW 12R,A02,892725,Herbst; Matthew,0,9,16,16
1745831396919,MMW 13R,A01,892727,Staff,0,3,16,16
1745831396919,MMW 13R,A02,892728,Staff,0,4,16,16
1745831396919,MMW 13R,A03,958032,Staff,0,3,16,16
1745831396919,MMW 13R,A04,958033,Staff,0,2,16,16
1745831396919,MMW 13R,A05,958034,Staff,0,3,16,16
1745831397949,SIO 295LS,A00,894015,Staff,7,0,25,18
1745831398978,SIO 295S,A00,894020,Staff,7,0,25,18
1745831400007,SIOC 290S,B01,958918,Staff,0,0,0,0
1745831401033,SIOC 291S,B01,958922,Staff,0,0,0,0
1745831402059,SOCI 117,A01,895339,Staff,4,0,5,1
1745831403084,WES 237B,A00,894149,Staff,11,0,20,9
1745831405207,AESE 279B,A00,891859,Staff,13,0,35,22
1745831406238,AIP 197,001,891854,Staff,70,0,70,0
1745831407265,ANTH 289S,A00,891856,Gagneux; Pascal,12,0,12,0
1745831408294,BENG 196,001,957946,Engler; Adam J.,9996,0,9999,3
1745831409325,CAT 124RS,A01,956906,Staff,8,0,25,17
1745831410353,CAT 125RS,A01,922013,Staff,8,0,25,17
1745831411380,CLRE 250,A00,891860,Morris; Sheldon,9995,0,9999,4
1745831413432,CLRE 251R,A00,907817,Mehta; Ravindra L.,9994,0,9999,5
1745831414465,CLRE 252,A00,891864,Cuomo; Raphael Eduardo,9993,0,9999,6
1745831415497,CLRE 253,A00,891867,Vaida; Florin,9994,0,9999,5
1745831415497,CLRE 253,B00,907819,Staff,9999,0,9999,0
1745831416523,CLRE 259,A00,891868,Patel; Hemal,9998,0,9999,1
1745831417552,CLRE 260,A00,891872,Cuomo; Raphael Eduardo,9999,0,9999,0
1745831418579,CLRE 297,001,891888,Cuomo; Raphael Eduardo,9999,0,9999,0
1745831419606,CSE 191,A00,958773,Minnes Kemp; Mor Mia,9999,0,9999,0
1745831420640,CSS 201S,A01,892054,Mignozzetti; Umberto,30,0,30,0
1745831421669,CSS 202S,A01,892056,Mignozzetti; Umberto,30,0,30,0
1745831422696,DSC 197,001,956898,Eldridge; Justin Matthew,9998,0,9999,1
1745831423738,DSC 297,001,958000,Mazumdar; Arya,9998,0,9999,1
1745831424766,EAP 100,A00,905686,Staff,9776,0,9999,223
1745831425794,ECE 45,A01,892618,Staff,0,13,50,50
1745831426822,ECE 109,A01,892620,Staff,0,43,0,0
1745831427853,ECE 111,A01,892719,Staff,0,9,50,50
1745831428878,ECE 197,001,957920,Mercier; Patrick Philip,9992,0,9999,7
1745831429904,ECON 178,A01,907814,Zhu; Ying,28,0,35,7
1745831430932,EDS 115,A00,895312,Staff,41,0,45,4
1745831431959,EDS 117,A01,895337,Staff,30,0,30,0
1745831432984,EDS 125,A00,895341,Jones; Gabrielle Anastasia,43,0,45,2
1745831434016,EDS 128A,A01,895459,Fargason; Sharon Gayle,44,0,45,1
1745831435049,EDS 128B,A01,895543,Pappas; Elizabeth,44,0,45,1
1745831436080,EDS 139,A00,897203,Pappas; Elizabeth,44,0,45,1
1745831436080,EDS 139,B00,897209,Fargason; Sharon Gayle,44,0,45,1
1745831437107,EDS 201,A00,895545,Staff,43,0,45,2
1745831438137,EDS 203,A01,895581,Halter; Christopher P.,43,0,45,2
1745831439164,EDS 204R,A01,895625,Heinzman; Erica M.,43,0,45,2
1745831439164,EDS 204R,B01,895693,Halter; Christopher P.,18,0,45,27
1745831440193,EDS 206R,A00,895694,Fargason; Sharon Gayle,9,0,30,21
1745831440193,EDS 206R,B00,895695,Choi; Bailey Miyeon,20,0,30,10
1745831441221,EDS 250,A00,895697,Hemans; Patricia Ann Benitez,43,0,45,2
1745831442246,EDS 281,A00,895701,Meyerott; Theresa Ann,15,0,15,0
1745831443274,EDS 284,A00,895736,Meyerott; Theresa Ann,15,0,15,0
1745831444302,EDS 286,A00,897210,Fine; Sarah,15,0,15,0
1745831445330,EDS 289C,A01,895770,Daly; Alan J.,15,0,15,0
1745831446356,EDS 290,A00,897211,Hofstetter; Carolyn,15,0,15,0
1745831447385,LIGM 5A,A00,896162,Fischer-Grunski; Eva K,15,0,20,5
1745831448412,LIGM 5B,A00,896260,Fischer-Grunski; Eva K,17,0,20,3
1745831449441,LIGM 5C,A00,896308,Fischer-Grunski; Eva K,18,0,20,2
1745831450474,LIIT 5AS,A00,896313,Carnelos; Chiara,17,0,20,3
1745831451507,LIIT 5BS,A00,896416,Carnelos; Chiara,20,0,20,0
1745831452535,LIIT 5CS,A00,896564,Carnelos; Chiara,20,0,20,0
1745831453567,LISP 5A,A00,896588,Munoz Sanchez; Alicia,4,0,20,16
1745831454595,LISP 5B,A00,896653,Munoz Sanchez; Alicia,10,0,20,10
1745831455621,LISP 5C,A00,896655,Munoz Sanchez; Alicia,4,0,20,16
1745831456648,MAE 197,001,957918,Kleissl; Jan,9998,0,9999,1
1745831457677,MATH 2,A01,957937,Staff,34,0,35,1
1745831458703,MATH 197,001,957876,Kedlaya; Kiran S.,9993,0,9999,6
1745831459733,MCWP 40,A00,892729,Duru; Nur,13,0,20,7
1745831459733,MCWP 40,B00,893304,Montejo; Carolina,20,0,20,0
1745831460764,MCWP 40R,A00,893757,Redela; Pamela Morgan,0,7,20,20
1745831461797,MCWP 50,A00,893758,Morshed; Michael James,2,0,20,18
1745831461797,MCWP 50,B00,893761,Bartulis; Jason Michael,18,0,20,2
1745831462833,MCWP 50R,A00,893766,Compas; Sean Matthew,0,1,20,20
1745831462833,MCWP 50R,B00,893769,Carter; Jennifer A,0,0,20,20
1745831462833,MCWP 50R,C00,893771,Krone; Jarret,0,3,20,20
1745831462833,MCWP 50R,D00,893772,Miller; Elizabeth Deen,3,0,20,17
1745831462833,MCWP 50R,E00,893775,Carter; Andrea L,0,0,20,20
1745831463859,MMW 11R,A01,892721,Herbst; Matthew,11,0,27,16
1745831463859,MMW 11R,A02,892722,Herbst; Matthew,0,0,0,3
1745831464891,MMW 12R,A01,892724,Herbst; Matthew,0,10,16,16
1745831464891,MMW 12R,A02,892725,Herbst; Matthew,0,9,16,16
1745831465921,MMW 13R,A01,892727,Staff,0,3,16,16
1745831465921,MMW 13R,A02,892728,Staff,0,4,16,16
1745831465921,MMW 13R,A03,958032,Staff,0,3,16,16
1745831465921,MMW 13R,A04,958033,Staff,0,2,16,16
1745831465921,MMW 13R,A05,958034,Staff,0,3,16,16
1745831466949,SIO 295LS,A00,894015,Staff,7,0,25,18
1745831467978,SIO 295S,A00,894020,Staff,7,0,25,18
1745831469008,SIOC 290S,B01,958918,Staff,0,0,0,0
1745831470039,SIOC 291S,B01,958922,Staff,0,0,0,0
1745831471069,SOCI 117,A01,895339,Staff,4,0,5,1
1745831472097,WES 237B,A00,894149,Staff,11,0,20,9
1745831474185,AESE 279B,A00,891859,Staff,13,0,35,22
1745831475212,AIP 197,001,891854,Staff,70,0,70,0
1745831476241,ANTH 289S,A00,891856,Gagneux; Pascal,12,0,12,0
1745831477276,BENG 196,001,957946,Engler; Adam J.,9996,0,9999,3
1745831478303,CAT 124RS,A01,956906,Staff,8,0,25,17
1745831479337,CAT 125RS,A01,922013,Staff,8,0,25,17
1745831480368,CLRE 250,A00,891860,Morris; Sheldon,9995,0,9999,4
1745831482426,CLRE 251R,A00,907817,Mehta; Ravindra L.,9994,0,9999,5
1745831483456,CLRE 252,A00,891864,Cuomo; Raphael Eduardo,9993,0,9999,6
1745831484483,CLRE 253,A00,891867,Vaida; Florin,9994,0,9999,5
1745831484483,CLRE 253,B00,907819,Staff,9999,0,9999,0
1745831485510,CLRE 259,A00,891868,Patel; Hemal,9998,0,9999,1
1745831486541,CLRE 260,A00,891872,Cuomo; Raphael Eduardo,9999,0,9999,0
1745831487572,CLRE 297,001,891888,Cuomo; Raphael Eduardo,9999,0,9999,0
1745831488599,CSE 191,A00,958773,Minnes Kemp; Mor Mia,9999,0,9999,0
1745831489627,CSS 201S,A01,892054,Mignozzetti; Umberto,30,0,30,0
1745831490662,CSS 202S,A01,892056,Mignozzetti; Umberto,30,0,30,0
1745831491688,DSC 197,001,956898,Eldridge; Justin Matthew,9998,0,9999,1
1745831492719,DSC 297,001,958000,Mazumdar; Arya,9998,0,9999,1
1745831493745,EAP 100,A00,905686,Staff,9776,0,9999,223
1745831494776,ECE 45,A01,892618,Staff,0,13,50,50
1745831495804,ECE 109,A01,892620,Staff,0,43,0,0
1745831496837,ECE 111,A01,892719,Staff,0,9,50,50
1745831497916,ECE 197,001,957920,Mercier; Patrick Philip,9992,0,9999,7
1745831498952,ECON 178,A01,907814,Zhu; Ying,28,0,35,7
1745831499981,EDS 115,A00,895312,Staff,41,0,45,4
1745831501015,EDS 117,A01,895337,Staff,30,0,30,0
1745831502046,EDS 125,A00,895341,Jones; Gabrielle Anastasia,43,0,45,2
1745831503072,EDS 128A,A01,895459,Fargason; Sharon Gayle,44,0,45,1
1745831504101,EDS 128B,A01,895543,Pappas; Elizabeth,44,0,45,1
1745831505129,EDS 139,A00,897203,Pappas; Elizabeth,44,0,45,1
1745831505129,EDS 139,B00,897209,Fargason; Sharon Gayle,44,0,45,1
1745831506157,EDS 201,A00,895545,Staff,43,0,45,2
1745831507188,EDS 203,A01,895581,Halter; Christopher P.,43,0,45,2
1745831508225,EDS 204R,A01,895625,Heinzman; Erica M.,43,0,45,2
1745831508225,EDS 204R,B01,895693,Halter; Christopher P.,18,0,45,27
1745831509253,EDS 206R,A00,895694,Fargason; Sharon Gayle,9,0,30,21
1745831509253,EDS 206R,B00,895695,Choi; Bailey Miyeon,20,0,30,10
1745831510281,EDS 250,A00,895697,Hemans; Patricia Ann Benitez,43,0,45,2
1745831511311,EDS 281,A00,895701,Meyerott; Theresa Ann,15,0,15,0
1745831512338,EDS 284,A00,895736,Meyerott; Theresa Ann,15,0,15,0
1745831513365,EDS 286,A00,897210,Fine; Sarah,15,0,15,0
1745831514393,EDS 289C,A01,895770,Daly; Alan J.,15,0,15,0
1745831515423,EDS 290,A00,897211,Hofstetter; Carolyn,15,0,15,0
1745831516450,LIGM 5A,A00,896162,Fischer-Grunski; Eva K,15,0,20,5
1745831517483,LIGM 5B,A00,896260,Fischer-Grunski; Eva K,17,0,20,3
1745831518508,LIGM 5C,A00,896308,Fischer-Grunski; Eva K,18,0,20,2
1745831519542,LIIT 5AS,A00,896313,Carnelos; Chiara,17,0,20,3
1745831520576,LIIT 5BS,A00,896416,Carnelos; Chiara,20,0,20,0
1745831521606,LIIT 5CS,A00,896564,Carnelos; Chiara,20,0,20,0
1745831522636,LISP 5A,A00,896588,Munoz Sanchez; Alicia,4,0,20,16
1745831523673,LISP 5B,A00,896653,Munoz Sanchez; Alicia,10,0,20,10
1745831524715,LISP 5C,A00,896655,Munoz Sanchez; Alicia,4,0,20,16
1745831525746,MAE 197,001,957918,Kleissl; Jan,9998,0,9999,1
1745831526774,MATH 2,A01,957937,Staff,34,0,35,1
1745831527807,MATH 197,001,957876,Kedlaya; Kiran S.,9993,0,9999,6
1745831528843,MCWP 40,A00,892729,Duru; Nur,13,0,20,7
1745831528843,MCWP 40,B00,893304,Montejo; Carolina,20,0,20,0
1745831529872,MCWP 40R,A00,893757,Redela; Pamela Morgan,0,7,20,20
1745831530904,MCWP 50,A00,893758,Morshed; Michael James,2,0,20,18
1745831530904,MCWP 50,B00,893761,Bartulis; Jason Michael,18,0,20,2
1745831531935,MCWP 50R,A00,893766,Compas; Sean Matthew,0,1,20,20
1745831531935,MCWP 50R,B00,893769,Carter; Jennifer A,0,0,20,20
1745831531935,MCWP 50R,C00,893771,Krone; Jarret,0,3,20,20
1745831531935,MCWP 50R,D00,893772,Miller; Elizabeth Deen,3,0,20,17
1745831531935,MCWP 50R,E00,893775,Carter; Andrea L,0,0,20,20
1745831532964,MMW 11R,A01,892721,Herbst; Matthew,11,0,27,16
1745831532964,MMW 11R,A02,892722,Herbst; Matthew,0,0,0,3
1745831533997,MMW 12R,A01,892724,Herbst; Matthew,0,10,16,16
1745831533997,MMW 12R,A02,892725,Herbst; Matthew,0,9,16,16
1745831535030,MMW 13R,A01,892727,Staff,0,3,16,16
1745831535030,MMW 13R,A02,892728,Staff,0,4,16,16
1745831535030,MMW 13R,A03,958032,Staff,0,3,16,16
1745831535030,MMW 13R,A04,958033,Staff,0,2,16,16
1745831535030,MMW 13R,A05,958034,Staff,0,3,16,16
1745831536059,SIO 295LS,A00,894015,Staff,7,0,25,18
1745831537091,SIO 295S,A00,894020,Staff,7,0,25,18
1745831538126,SIOC 290S,B01,958918,Staff,0,0,0,0
1745831539155,SIOC 291S,B01,958922,Staff,0,0,0,0
1745831540185,SOCI 117,A01,895339,Staff,4,0,5,1
1745831541214,WES 237B,A00,894149,Staff,11,0,20,9
1745831543296,AESE 279B,A00,891859,Staff,13,0,35,22
1745831544321,AIP 197,001,891854,Staff,70,0,70,0
1745831545351,ANTH 289S,A00,891856,Gagneux; Pascal,12,0,12,0
1745831546382,BENG 196,001,957946,Engler; Adam J.,9996,0,9999,3
1745831547409,CAT 124RS,A01,956906,Staff,8,0,25,17
1745831548442,CAT 125RS,A01,922013,Staff,8,0,25,17
1745831549473,CLRE 250,A00,891860,Morris; Sheldon,9995,0,9999,4
1745831551527,CLRE 251R,A00,907817,Mehta; Ravindra L.,9994,0,9999,5
1745831552558,CLRE 252,A00,891864,Cuomo; Raphael Eduardo,9993,0,9999,6
1745831553586,CLRE 253,A00,891867,Vaida; Florin,9994,0,9999,5
1745831553586,CLRE 253,B00,907819,Staff,9999,0,9999,0
1745831554612,CLRE 259,A00,891868,Patel; Hemal,9998,0,9999,1
1745831555638,CLRE 260,A00,891872,Cuomo; Raphael Eduardo,9999,0,9999,0
1745831556665,CLRE 297,001,891888,Cuomo; Raphael Eduardo,9999,0,9999,0
1745831557690,CSE 191,A00,958773,Minnes Kemp; Mor Mia,9999,0,9999,0
1745831558723,CSS 201S,A01,892054,Mignozzetti; Umberto,30,0,30,0
1745831559751,CSS 202S,A01,892056,Mignozzetti; Umberto,30,0,30,0
1745831560780,DSC 197,001,956898,Eldridge; Justin Matthew,9998,0,9999,1
1745831561810,DSC 297,001,958000,Mazumdar; Arya,9998,0,9999,1
1745831562837,EAP 100,A00,905686,Staff,9776,0,9999,223
1745831563869,ECE 45,A01,892618,Staff,0,13,50,50
1745831564897,ECE 109,A01,892620,Staff,0,43,0,0
1745831565922,ECE 111,A01,892719,Staff,0,9,50,50
1745831566957,ECE 197,001,957920,Mercier; Patrick Philip,9992,0,9999,7
1745831567991,ECON 178,A01,907814,Zhu; Ying,28,0,35,7
1745831569021,EDS 115,A00,895312,Staff,41,0,45,4
1745831570050,EDS 117,A01,895337,Staff,30,0,30,0
1745831571083,EDS 125,A00,895341,Jones; Gabrielle Anastasia,43,0,45,2
1745831572109,EDS 128A,A01,895459,Fargason; Sharon Gayle,44,0,45,1
1745831573167,EDS 128B,A01,895543,Pappas; Elizabeth,44,0,45,1
1745831574195,EDS 139,A00,897203,Pappas; Elizabeth,44,0,45,1
1745831574195,EDS 139,B00,897209,Fargason; Sharon Gayle,44,0,45,1
1745831575225,EDS 201,A00,895545,Staff,43,0,45,2
1745831576253,EDS 203,A01,895581,Halter; Christopher P.,43,0,45,2
1745831577279,EDS 204R,A01,895625,Heinzman; Erica M.,43,0,45,2
1745831577279,EDS 204R,B01,895693,Halter; Christopher P.,18,0,45,27
1745831578306,EDS 206R,A00,895694,Fargason; Sharon Gayle,9,0,30,21
1745831578306,EDS 206R,B00,895695,Choi; Bailey Miyeon,20,0,30,10
1745831579341,EDS 250,A00,895697,Hemans; Patricia Ann Benitez,43,0,45,2
1745831580372,EDS 281,A00,895701,Meyerott; Theresa Ann,15,0,15,0
1745831581411,EDS 284,A00,895736,Meyerott; Theresa Ann,15,0,15,0
1745831582441,EDS 286,A00,897210,Fine; Sarah,15,0,15,0
1745831583473,EDS 289C,A01,895770,Daly; Alan J.,15,0,15,0
1745831584499,EDS 290,A00,897211,Hofstetter; Carolyn,15,0,15,0
1745831585527,LIGM 5A,A00,896162,Fischer-Grunski; Eva K,15,0,20,5
1745831586560,LIGM 5B,A00,896260,Fischer-Grunski; Eva K,17,0,20,3
1745831587586,LIGM 5C,A00,896308,Fischer-Grunski; Eva K,18,0,20,2
1745831588615,LIIT 5AS,A00,896313,Carnelos; Chiara,17,0,20,3
1745831589645,LIIT 5BS,A00,896416,Carnelos; Chiara,20,0,20,0
1745831590676,LIIT 5CS,A00,896564,Carnelos; Chiara,20,0,20,0
1745831591703,LISP 5A,A00,896588,Munoz Sanchez; Alicia,4,0,20,16
1745831592730,LISP 5B,A00,896653,Munoz Sanchez; Alicia,10,0,20,10
1745831593758,LISP 5C,A00,896655,Munoz Sanchez; Alicia,4,0,20,16
1745831594796,MAE 197,001,957918,Kleissl; Jan,9998,0,9999,1
1745831595823,MATH 2,A01,957937,Staff,34,0,35,1
1745831596849,MATH 197,001,957876,Kedlaya; Kiran S.,9993,0,9999,6
1745831597877,MCWP 40,A00,892729,Duru; Nur,13,0,20,7
1745831597877,MCWP 40,B00,893304,Montejo; Carolina,20,0,20,0
1745831598905,MCWP 40R,A00,893757,Redela; Pamela Morgan,0,7,20,20
1745831599932,MCWP 50,A00,893758,Morshed; Michael James,2,0,20,18
1745831599932,MCWP 50,B00,893761,Bartulis; Jason Michael,18,0,20,2
1745831600959,MCWP 50R,A00,893766,Compas; Sean Matthew,0,1,20,20
1745831600959,MCWP 50R,B00,893769,Carter; Jennifer A,0,0,20,20
1745831600959,MCWP 50R,C00,893771,Krone; Jarret,0,3,20,20
1745831600959,MCWP 50R,D00,893772,Miller; Elizabeth Deen,3,0,20,17
1745831600959,MCWP 50R,E00,893775,Carter; Andrea L,0,0,20,20
1745831601992,MMW 11R,A01,892721,Herbst; Matthew,11,0,27,16
1745831601992,MMW 11R,A02,892722,Herbst; Matthew,0,0,0,3
1745831603026,MMW 12R,A01,892724,Herbst; Matthew,0,10,16,16
1745831603026,MMW 12R,A02,892725,Herbst; Matthew,0,9,16,16
1745831604057,MMW 13R,A01,892727,Staff,0,3,16,16
1745831604057,MMW 13R,A02,892728,Staff,0,4,16,16
1745831604057,MMW 13R,A03,958032,Staff,0,3,16,16
1745831604057,MMW 13R,A04,958033,Staff,0,2,16,16
1745831604057,MMW 13R,A05,958034,Staff,0,3,16,16
1745831605085,SIO 295LS,A00,894015,Staff,7,0,25,18
1745831606115,SIO 295S,A00,894020,Staff,7,0,25,18
1745831607149,SIOC 290S,B01,958918,Staff,0,0,0,0
1745831608181,SIOC 291S,B01,958922,Staff,0,0,0,0
1745831609208,SOCI 117,A01,895339,Staff,4,0,5,1
1745831610239,WES 237B,A00,894149,Staff,11,0,20,9
1745831612325,AESE 279B,A00,891859,Staff,13,0,35,22
1745831613352,AIP 197,001,891854,Staff,70,0,70,0
1745831614380,ANTH 289S,A00,891856,Gagneux; Pascal,12,0,12,0
1745831615409,BENG 196,001,957946,Engler; Adam J.,9996,0,9999,3
1745831616443,CAT 124RS,A01,956906,Staff,8,0,25,17
1745831617472,CAT 125RS,A01,922013,Staff,8,0,25,17
1745831618498,CLRE 250,A00,891860,Morris; Sheldon,9995,0,9999,4
1745831620557,CLRE 251R,A00,907817,Mehta; Ravindra L.,9994,0,9999,5
1745831621584,CLRE 252,A00,891864,Cuomo; Raphael Eduardo,9993,0,9999,6
1745831622614,CLRE 253,A00,891867,Vaida; Florin,9994,0,9999,5
1745831622614,CLRE 253,B00,907819,Staff,9999,0,9999,0
1745831623645,CLRE 259,A00,891868,Patel; Hemal,9998,0,9999,1
1745831624686,CLRE 260,A00,891872,Cuomo; Raphael Eduardo,9999,0,9999,0
1745831625730,CLRE 297,001,891888,Cuomo; Raphael Eduardo,9999,0,9999,0
1745831626764,CSE 191,A00,958773,Minnes Kemp; Mor Mia,9999,0,9999,0
1745831627800,CSS 201S,A01,892054,Mignozzetti; Umberto,30,0,30,0
1745831628828,CSS 202S,A01,892056,Mignozzetti; Umberto,30,0,30,0
1745831629856,DSC 197,001,956898,Eldridge; Justin Matthew,9998,0,9999,1
1745831630889,DSC 297,001,958000,Mazumdar; Arya,9998,0,9999,1
1745831631915,EAP 100,A00,905686,Staff,9776,0,9999,223
1745831632950,ECE 45,A01,892618,Staff,0,13,50,50
1745831633982,ECE 109,A01,892620,Staff,0,43,0,0
1745831635016,ECE 111,A01,892719,Staff,0,9,50,50
1745831636045,ECE 197,001,957920,Mercier; Patrick Philip,9992,0,9999,7
1745831637072,ECON 178,A01,907814,Zhu; Ying,28,0,35,7
1745831638103,EDS 115,A00,895312,Staff,41,0,45,4
1745831639132,EDS 117,A01,895337,Staff,30,0,30,0
1745831640166,EDS 125,A00,895341,Jones; Gabrielle Anastasia,43,0,45,2
1745831641194,EDS 128A,A01,895459,Fargason; Sharon Gayle,44,0,45,1
1745831642221,EDS 128B,A01,895543,Pappas; Elizabeth,44,0,45,1
1745831643248,EDS 139,A00,897203,Pappas; Elizabeth,44,0,45,1
1745831643248,EDS 139,B00,897209,Fargason; Sharon Gayle,44,0,45,1
1745831644275,EDS 201,A00,895545,Staff,43,0,45,2
1745831645303,EDS 203,A01,895581,Halter; Christopher P.,43,0,45,2
1745831646340,EDS 204R,A01,895625,Heinzman; Erica M.,43,0,45,2
1745831646340,EDS 204R,B01,895693,Halter; Christopher P.,18,0,45,27
1745831647368,EDS 206R,A00,895694,Fargason; Sharon Gayle,9,0,30,21
1745831647368,EDS 206R,B00,895695,Choi; Bailey Miyeon,20,0,30,10
1745831648396,EDS 250,A00,895697,Hemans; Patricia Ann Benitez,43,0,45,2
1745831649425,EDS 281,A00,895701,Meyerott; Theresa Ann,15,0,15,0
1745831650453,EDS 284,A00,895736,Meyerott; Theresa Ann,15,0,15,0
1745831651482,EDS 286,A00,897210,Fine; Sarah,15,0,15,0
1745831652511,EDS 289C,A01,895770,Daly; Alan J.,15,0,15,0
1745831653539,EDS 290,A00,897211,Hofstetter; Carolyn,15,0,15,0
1745831654567,LIGM 5A,A00,896162,Fischer-Grunski; Eva K,15,0,20,5
1745831655593,LIGM 5B,A00,896260,Fischer-Grunski; Eva K,17,0,20,3
1745831656625,LIGM 5C,A00,896308,Fischer-Grunski; Eva K,18,0,20,2
1745831657653,LIIT 5AS,A00,896313,Carnelos; Chiara,17,0,20,3
1745831658682,LIIT 5BS,A00,896416,Carnelos; Chiara,20,0,20,0
1745831659713,LIIT 5CS,A00,896564,Carnelos; Chiara,20,0,20,0
1745831660740,LISP 5A,A00,896588,Munoz Sanchez; Alicia,4,0,20,16
1745831661766,LISP 5B,A00,896653,Munoz Sanchez; Alicia,10,0,20,10
1745831662795,LISP 5C,A00,896655,Munoz Sanchez; Alicia,4,0,20,16
1745831663826,MAE 197,001,957918,Kleissl; Jan,9998,0,9999,1
1745831664857,MATH 2,A01,957937,Staff,34,0,35,1
1745831665888,MATH 197,001,957876,Kedlaya; Kiran S.,9993,0,9999,6
1745831666918,MCWP 40,A00,892729,Duru; Nur,13,0,20,7
1745831666918,MCWP 40,B00,893304,Montejo; Carolina,20,0,20,0
1745831667950,MCWP 40R,A00,893757,Redela; Pamela Morgan,0,7,20,20
1745831668982,MCWP 50,A00,893758,Morshed; Michael James,2,0,20,18
1745831668982,MCWP 50,B00,893761,Bartulis; Jason Michael,18,0,20,2
1745831670013,MCWP 50R,A00,893766,Compas; Sean Matthew,0,1,20,20
1745831670013,MCWP 50R,B00,893769,Carter; Jennifer A,0,0,20,20
1745831670013,MCWP 50R,C00,893771,Krone; Jarret,0,3,20,20
1745831670013,MCWP 50R,D00,893772,Miller; Elizabeth Deen,3,0,20,17
1745831670013,MCWP 50R,E00,893775,Carter; Andrea L,0,0,20,20
1745831671044,MMW 11R,A01,892721,Herbst; Matthew,11,0,27,16
1745831671044,MMW 11R,A02,892722,Herbst; Matthew,0,0,0,3
1745831672070,MMW 12R,A01,892724,Herbst; Matthew,0,10,16,16
1745831672070,MMW 12R,A02,892725,Herbst; Matthew,0,9,16,16
1745831673098,MMW 13R,A01,892727,Staff,0,3,16,16
1745831673098,MMW 13R,A02,892728,Staff,0,4,16,16
1745831673098,MMW 13R,A03,958032,Staff,0,3,16,16
1745831673098,MMW 13R,A04,958033,Staff,0,2,16,16
1745831673098,MMW 13R,A05,958034,Staff,0,3,16,16
1745831674128,SIO 295LS,A00,894015,Staff,7,0,25,18
1745831675159,SIO 295S,A00,894020,Staff,7,0,25,18
1745831676192,SIOC 290S,B01,958918,Staff,0,0,0,0
1745831677225,SIOC 291S,B01,958922,Staff,0,0,0,0
1745831678253,SOCI 117,A01,895339,Staff,4,0,5,1
1745831679280,WES 237B,A00,894149,Staff,11,0,20,9
1745831681369,AESE 279B,A00,891859,Staff,13,0,35,22
1745831682395,AIP 197,001,891854,Staff,70,0,70,0
1745831683422,ANTH 289S,A00,891856,Gagneux; Pascal,12,0,12,0
1745831684450,BENG 196,001,957946,Engler; Adam J.,9996,0,9999,3
1745831685481,CAT 124RS,A01,956906,Staff,8,0,25,17
1745831686512,CAT 125RS,A01,922013,Staff,8,0,25,17
1745831687538,CLRE 250,A00,891860,Morris; Sheldon,9995,0,9999,4
1745831689597,CLRE 251R,A00,907817,Mehta; Ravindra L.,9994,0,9999,5
1745831690624,CLRE 252,A00,891864,Cuomo; Raphael Eduardo,9993,0,9999,6
1745831691651,CLRE 253,A00,891867,Vaida; Florin,9994,0,9999,5
1745831691651,CLRE 253,B00,907819,Staff,9999,0,9999,0
1745831692691,CLRE 259,A00,891868,Patel; Hemal,9998,0,9999,1
1745831693719,CLRE 260,A00,891872,Cuomo; Raphael Eduardo,9999,0,9999,0
1745831694744,CLRE 297,001,891888,Cuomo; Raphael Eduardo,9999,0,9999,0
1745831695776,CSE 191,A00,958773,Minnes Kemp; Mor Mia,9999,0,9999,0
1745831696807,CSS 201S,A01,892054,Mignozzetti; Umberto,30,0,30,0
1745831697834,CSS 202S,A01,892056,Mignozzetti; Umberto,30,0,30,0
1745831698860,DSC 197,001,956898,Eldridge; Justin Matthew,9998,0,9999,1
1745831699886,DSC 297,001,958000,Mazumdar; Arya,9998,0,9999,1
1745831700913,EAP 100,A00,905686,Staff,9776,0,9999,223
1745831701938,ECE 45,A01,892618,Staff,0,13,50,50
1745831702970,ECE 109,A01,892620,Staff,0,43,0,0
1745831703999,ECE 111,A01,892719,Staff,0,9,50,50
1745831705031,ECE 197,001,957920,Mercier; Patrick Philip,9992,0,9999,7
1745831706066,ECON 178,A01,907814,Zhu; Ying,28,0,35,7
1745831707092,EDS 115,A00,895312,Staff,41,0,45,4
1745831708120,EDS 117,A01,895337,Staff,30,0,30,0
1745831709350,EDS 125,A00,895341,Jones; Gabrielle Anastasia,43,0,45,2
1745831710379,EDS 128A,A01,895459,Fargason; Sharon Gayle,44,0,45,1
1745831711407,EDS 128B,A01,895543,Pappas; Elizabeth,44,0,45,1
1745831712434,EDS 139,A00,897203,Pappas; Elizabeth,44,0,45,1
1745831712434,EDS 139,B00,897209,Fargason; Sharon Gayle,44,0,45,1
1745831713458,EDS 201,A00,895545,Staff,43,0,45,2
1745831714489,EDS 203,A01,895581,Halter; Christopher P.,43,0,45,2
1745831715515,EDS 204R,A01,895625,Heinzman; Erica M.,43,0,45,2
1745831715515,EDS 204R,B01,895693,Halter; Christopher P.,18,0,45,27
1745831716540,EDS 206R,A00,895694,Fargason; Sharon Gayle,9,0,30,21
1745831716540,EDS 206R,B00,895695,Choi; Bailey Miyeon,20,0,30,10
1745831717566,EDS 250,A00,895697,Hemans; Patricia Ann Benitez,43,0,45,2
1745831718593,EDS 281,A00,895701,Meyerott; Theresa Ann,15,0,15,0
1745831719623,EDS 284,A00,895736,Meyerott; Theresa Ann,15,0,15,0
1745831720650,EDS 286,A00,897210,Fine; Sarah,15,0,15,0
1745831721680,EDS 289C,A01,895770,Daly; Alan J.,15,0,15,0
1745831722705,EDS 290,A00,897211,Hofstetter; Carolyn,15,0,15,0
1745831723737,LIGM 5A,A00,896162,Fischer-Grunski; Eva K,15,0,20,5
1745831724763,LIGM 5B,A00,896260,Fischer-Grunski; Eva K,17,0,20,3
1745831725788,LIGM 5C,A00,896308,Fischer-Grunski; Eva K,18,0,20,2
1745831726814,LIIT 5AS,A00,896313,Carnelos; Chiara,17,0,20,3
1745831727840,LIIT 5BS,A00,896416,Carnelos; Chiara,20,0,20,0
1745831728870,LIIT 5CS,A00,896564,Carnelos; Chiara,20,0,20,0
1745831729900,LISP 5A,A00,896588,Munoz Sanchez; Alicia,4,0,20,16
1745831730930,LISP 5B,A00,896653,Munoz Sanchez; Alicia,10,0,20,10
1745831731959,LISP 5C,A00,896655,Munoz Sanchez; Alicia,4,0,20,16
1745831732986,MAE 197,001,957918,Kleissl; Jan,9998,0,9999,1
1745831734012,MATH 2,A01,957937,Staff,34,0,35,1
1745831735040,MATH 197,001,957876,Kedlaya; Kiran S.,9993,0,9999,6
1745831736069,MCWP 40,A00,892729,Duru; Nur,13,0,20,7
1745831736069,MCWP 40,B00,893304,Montejo; Carolina,20,0,20,0
1745831737099,MCWP 40R,A00,893757,Redela; Pamela Morgan,0,7,20,20
1745831738127,MCWP 50,A00,893758,Morshed; Michael James,2,0,20,18
1745831738127,MCWP 50,B00,893761,Bartulis; Jason Michael,18,0,20,2
1745831739153,MCWP 50R,A00,893766,Compas; Sean Matthew,0,1,20,20
1745831739153,MCWP 50R,B00,893769,Carter; Jennifer A,0,0,20,20
1745831739153,MCWP 50R,C00,893771,Krone; Jarret,0,3,20,20
1745831739153,MCWP 50R,D00,893772,Miller; Elizabeth Deen,3,0,20,17
1745831739153,MCWP 50R,E00,893775,Carter; Andrea L,0,0,20,20
1745831740182,MMW 11R,A01,892721,Herbst; Matthew,11,0,27,16
1745831740182,MMW 11R,A02,892722,Herbst; Matthew,0,0,0,3
1745831741210,MMW 12R,A01,892724,Herbst; Matthew,0,10,16,16
1745831741210,MMW 12R,A02,892725,Herbst; Matthew,0,9,16,16
1745831742235,MMW 13R,A01,892727,Staff,0,3,16,16
1745831742235,MMW 13R,A02,892728,Staff,0,4,16,16
1745831742235,MMW 13R,A03,958032,Staff,0,3,16,16
1745831742235,MMW 13R,A04,958033,Staff,0,2,16,16
1745831742235,MMW 13R,A05,958034,Staff,0,3,16,16
1745831743266,SIO 295LS,A00,894015,Staff,7,0,25,18
1745831744294,SIO 295S,A00,894020,Staff,7,0,25,18
1745831745320,SIOC 290S,B01,958918,Staff,0,0,0,0
1745831746346,SIOC 291S,B01,958922,Staff,0,0,0,0
1745831747376,SOCI 117,A01,895339,Staff,4,0,5,1
1745831748402,WES 237B,A00,894149,Staff,11,0,20,9
1745831750504,AESE 279B,A00,891859,Staff,13,0,35,22
1745831751529,AIP 197,001,891854,Staff,70,0,70,0
1745831752559,ANTH 289S,A00,891856,Gagneux; Pascal,12,0,12,0
1745831753586,BENG 196,001,957946,Engler; Adam J.,9996,0,9999,3
1745831754615,CAT 124RS,A01,956906,Staff,8,0,25,17
1745831755641,CAT 125RS,A01,922013,Staff,8,0,25,17
1745831756669,CLRE 250,A00,891860,Morris; Sheldon,9995,0,9999,4
1745831758722,CLRE 251R,A00,907817,Mehta; Ravindra L.,9994,0,9999,5
1745831759753,CLRE 252,A00,891864,Cuomo; Raphael Eduardo,9993,0,9999,6
1745831760810,CLRE 253,A00,891867,Vaida; Florin,9994,0,9999,5
1745831760810,CLRE 253,B00,907819,Staff,9999,0,9999,0
1745831761840,CLRE 259,A00,891868,Patel; Hemal,9998,0,9999,1
1745831762866,CLRE 260,A00,891872,Cuomo; Raphael Eduardo,9999,0,9999,0
1745831763894,CLRE 297,001,891888,Cuomo; Raphael Eduardo,9999,0,9999,0
1745831764923,CSE 191,A00,958773,Minnes Kemp; Mor Mia,9999,0,9999,0
1745831765953,CSS 201S,A01,892054,Mignozzetti; Umberto,30,0,30,0
1745831766981,CSS 202S,A01,892056,Mignozzetti; Umberto,30,0,30,0
1745831768062,DSC 197,001,956898,Eldridge; Justin Matthew,9998,0,9999,1
1745831769086,DSC 297,001,958000,Mazumdar; Arya,9998,0,9999,1
1745831770117,EAP 100,A00,905686,Staff,9776,0,9999,223
1745831771142,ECE 45,A01,892618,Staff,0,13,50,50
1745831772172,ECE 109,A01,892620,Staff,0,43,0,0
1745831773200,ECE 111,A01,892719,Staff,0,9,50,50
1745831774225,ECE 197,001,957920,Mercier; Patrick Philip,9992,0,9999,7
1745831775259,ECON 178,A01,907814,Zhu; Ying,28,0,35,7
1745831776289,EDS 115,A00,895312,Staff,41,0,45,4
1745831777315,EDS 117,A01,895337,Staff,30,0,30,0
1745831778344,EDS 125,A00,895341,Jones; Gabrielle Anastasia,43,0,45,2
1745831779370,EDS 128A,A01,895459,Fargason; Sharon Gayle,44,0,45,1
1745831780396,EDS 128B,A01,895543,Pappas; Elizabeth,44,0,45,1
1745831781425,EDS 139,A00,897203,Pappas; Elizabeth,44,0,45,1
1745831781425,EDS 139,B00,897209,Fargason; Sharon Gayle,44,0,45,1
1745831782449,EDS 201,A00,895545,Staff,43,0,45,2
1745831783479,EDS 203,A01,895581,Halter; Christopher P.,43,0,45,2
1745831784507,EDS 204R,A01,895625,Heinzman; Erica M.,43,0,45,2
1745831784507,EDS 204R,B01,895693,Halter; Christopher P.,18,0,45,27
1745831785534,EDS 206R,A00,895694,Fargason; Sharon Gayle,9,0,30,21
1745831785534,EDS 206R,B00,895695,Choi; Bailey Miyeon,20,0,30,10
1745831786562,EDS 250,A00,895697,Hemans; Patricia Ann Benitez,43,0,45,2
1745831787590,EDS 281,A00,895701,Meyerott; Theresa Ann,15,0,15,0
1745831788618,EDS 284,A00,895736,Meyerott; Theresa Ann,15,0,15,0
1745831789648,EDS 286,A00,897210,Fine; Sarah,15,0,15,0
1745831790674,EDS 289C,A01,895770,Daly; Alan J.,15,0,15,0
1745831791700,EDS 290,A00,897211,Hofstetter; Carolyn,15,0,15,0
1745831792731,LIGM 5A,A00,896162,Fischer-Grunski; Eva K,15,0,20,5
1745831793757,LIGM 5B,A00,896260,Fischer-Grunski; Eva K,17,0,20,3
1745831794787,LIGM 5C,A00,896308,Fischer-Grunski; Eva K,18,0,20,2
1745831795813,LIIT 5AS,A00,896313,Carnelos; Chiara,17,0,20,3
1745831796844,LIIT 5BS,A00,896416,Carnelos; Chiara,20,0,20,0
1745831797873,LIIT 5CS,A00,896564,Carnelos; Chiara,20,0,20,0
1745831798901,LISP 5A,A00,896588,Munoz Sanchez; Alicia,4,0,20,16
1745831799930,LISP 5B,A00,896653,Munoz Sanchez; Alicia,10,0,20,10
1745831800956,LISP 5C,A00,896655,Munoz Sanchez; Alicia,4,0,20,16
1745831801982,MAE 197,001,957918,Kleissl; Jan,9998,0,9999,1
1745831803007,MATH 2,A01,957937,Staff,34,0,35,1
1745831804036,MATH 197,001,957876,Kedlaya; Kiran S.,9993,0,9999,6
1745831805065,MCWP 40,A00,892729,Duru; Nur,13,0,20,7
1745831805065,MCWP 40,B00,893304,Montejo; Carolina,20,0,20,0
1745831806090,MCWP 40R,A00,893757,Redela; Pamela Morgan,0,7,20,20
1745831807116,MCWP 50,A00,893758,Morshed; Michael James,2,0,20,18
1745831807116,MCWP 50,B00,893761,Bartulis; Jason Michael,18,0,20,2
1745831808144,MCWP 50R,A00,893766,Compas; Sean Matthew,0,1,20,20
1745831808144,MCWP 50R,B00,893769,Carter; Jennifer A,0,0,20,20
1745831808144,MCWP 50R,C00,893771,Krone; Jarret,0,3,20,20
1745831808144,MCWP 50R,D00,893772,Miller; Elizabeth Deen,3,0,20,17
1745831808144,MCWP 50R,E00,893775,Carter; Andrea L,0,0,20,20
1745831809171,MMW 11R,A01,892721,Herbst; Matthew,11,0,27,16
1745831809171,MMW 11R,A02,892722,Herbst; Matthew,0,0,0,3
1745831810199,MMW 12R,A01,892724,Herbst; Matthew,0,10,16,16
1745831810199,MMW 12R,A02,892725,Herbst; Matthew,0,9,16,16
1745831811225,MMW 13R,A01,892727,Staff,0,3,16,16
1745831811225,MMW 13R,A02,892728,Staff,0,4,16,16
1745831811225,MMW 13R,A03,958032,Staff,0,3,16,16
1745831811225,MMW 13R,A04,958033,Staff,0,2,16,16
1745831811225,MMW 13R,A05,958034,Staff,0,3,16,16
1745831812250,SIO 295LS,A00,894015,Staff,7,0,25,18
1745831813280,SIO 295S,A00,894020,Staff,7,0,25,18
1745831814306,SIOC 290S,B01,958918,Staff,0,0,0,0
1745831815331,SIOC 291S,B01,958922,Staff,0,0,0,0
1745831816357,SOCI 117,A01,895339,Staff,4,0,5,1
1745831817385,WES 237B,A00,894149,Staff,11,0,20,9
1745831819475,AESE 279B,A00,891859,Staff,13,0,35,22
1745831820505,AIP 197,001,891854,Staff,70,0,70,0
1745831821534,ANTH 289S,A00,891856,Gagneux; Pascal,12,0,12,0
1745831822563,BENG 196,001,957946,Engler; Adam J.,9996,0,9999,3
1745831823601,CAT 124RS,A01,956906,Staff,8,0,25,17
1745831824630,CAT 125RS,A01,922013,Staff,8,0,25,17
1745831825660,CLRE 250,A00,891860,Morris; Sheldon,9995,0,9999,4
1745831827711,CLRE 251R,A00,907817,Mehta; Ravindra L.,9994,0,9999,5
1745831828736,CLRE 252,A00,891864,Cuomo; Raphael Eduardo,9993,0,9999,6
1745831829767,CLRE 253,A00,891867,Vaida; Florin,9994,0,9999,5
1745831829767,CLRE 253,B00,907819,Staff,9999,0,9999,0
1745831830791,CLRE 259,A00,891868,Patel; Hemal,9998,0,9999,1
1745831831819,CLRE 260,A00,891872,Cuomo; Raphael Eduardo,9999,0,9999,0
1745831832847,CLRE 297,001,891888,Cuomo; Raphael Eduardo,9999,0,9999,0
1745831833872,CSE 191,A00,958773,Minnes Kemp; Mor Mia,9999,0,9999,0
1745831834898,CSS 201S,A01,892054,Mignozzetti; Umberto,30,0,30,0
1745831835922,CSS 202S,A01,892056,Mignozzetti; Umberto,30,0,30,0
1745831836950,DSC 197,001,956898,Eldridge; Justin Matthew,9998,0,9999,1
1745831837974,DSC 297,001,958000,Mazumdar; Arya,9998,0,9999,1
1745831839002,EAP 100,A00,905686,Staff,9776,0,9999,223
1745831840034,ECE 45,A01,892618,Staff,0,13,50,50
1745831841059,ECE 109,A01,892620,Staff,0,43,0,0
1745831842088,ECE 111,A01,892719,Staff,0,9,50,50
1745831843117,ECE 197,001,957920,Mercier; Patrick Philip,9992,0,9999,7
1745831844146,ECON 178,A01,907814,Zhu; Ying,28,0,35,7
1745831845174,EDS 115,A00,895312,Staff,41,0,45,4
1745831846200,EDS 117,A01,895337,Staff,30,0,30,0
1745831847227,EDS 125,A00,895341,Jones; Gabrielle Anastasia,43,0,45,2
1745831848257,EDS 128A,A01,895459,Fargason; Sharon Gayle,44,0,45,1
1745831849289,EDS 128B,A01,895543,Pappas; Elizabeth,44,0,45,1
1745831850315,EDS 139,A00,897203,Pappas; Elizabeth,44,0,45,1
1745831850315,EDS 139,B00,897209,Fargason; Sharon Gayle,44,0,45,1
1745831851343,EDS 201,A00,895545,Staff,43,0,45,2
1745831852369,EDS 203,A01,895581,Halter; Christopher P.,43,0,45,2
1745831853400,EDS 204R,A01,895625,Heinzman; Erica M.,43,0,45,2
1745831853400,EDS 204R,B01,895693,Halter; Christopher P.,18,0,45,27
1745831854425,EDS 206R,A00,895694,Fargason; Sharon Gayle,9,0,30,21
1745831854425,EDS 206R,B00,895695,Choi; Bailey Miyeon,20,0,30,10
1745831855456,EDS 250,A00,895697,Hemans; Patricia Ann Benitez,43,0,45,2
1745831856480,EDS 281,A00,895701,Meyerott; Theresa Ann,15,0,15,0
1745831857509,EDS 284,A00,895736,Meyerott; Theresa Ann,15,0,15,0
1745831858540,EDS 286,A00,897210,Fine; Sarah,15,0,15,0
1745831859568,EDS 289C,A01,895770,Daly; Alan J.,15,0,15,0
1745831860596,EDS 290,A00,897211,Hofstetter; Carolyn,15,0,15,0
1745831861628,LIGM 5A,A00,896162,Fischer-Grunski; Eva K,15,0,20,5
1745831862654,LIGM 5B,A00,896260,Fischer-Grunski; Eva K,17,0,20,3
1745831863678,LIGM 5C,A00,896308,Fischer-Grunski; Eva K,18,0,20,2
1745831864706,LIIT 5AS,A00,896313,Carnelos; Chiara,17,0,20,3
1745831865734,LIIT 5BS,A00,896416,Carnelos; Chiara,20,0,20,0
1745831866762,LIIT 5CS,A00,896564,Carnelos; Chiara,20,0,20,0
1745831867788,LISP 5A,A00,896588,Munoz Sanchez; Alicia,4,0,20,16
1745831868819,LISP 5B,A00,896653,Munoz Sanchez; Alicia,10,0,20,10
1745831869852,LISP 5C,A00,896655,Munoz Sanchez; Alicia,4,0,20,16
1745831870879,MAE 197,001,957918,Kleissl; Jan,9998,0,9999,1
1745831871905,MATH 2,A01,957937,Staff,34,0,35,1
1745831872934,MATH 197,001,957876,Kedlaya; Kiran S.,9993,0,9999,6
1745831873961,MCWP 40,A00,892729,Duru; Nur,13,0,20,7
1745831873961,MCWP 40,B00,893304,Montejo; Carolina,20,0,20,0
1745831874993,MCWP 40R,A00,893757,Redela; Pamela Morgan,0,7,20,20
1745831876019,MCWP 50,A00,893758,Morshed; Michael James,2,0,20,18
1745831876019,MCWP 50,B00,893761,Bartulis; Jason Michael,18,0,20,2
1745831877057,MCWP 50R,A00,893766,Compas; Sean Matthew,0,1,20,20
1745831877057,MCWP 50R,B00,893769,Carter; Jennifer A,0,0,20,20
1745831877057,MCWP 50R,C00,893771,Krone; Jarret,0,3,20,20
1745831877057,MCWP 50R,D00,893772,Miller; Elizabeth Deen,3,0,20,17
1745831877057,MCWP 50R,E00,893775,Carter; Andrea L,0,0,20,20
1745831878082,MMW 11R,A01,892721,Herbst; Matthew,11,0,27,16
1745831878082,MMW 11R,A02,892722,Herbst; Matthew,0,0,0,3
1745831879109,MMW 12R,A01,892724,Herbst; Matthew,0,10,16,16
1745831879109,MMW 12R,A02,892725,Herbst; Matthew,0,9,16,16
1745831880136,MMW 13R,A01,892727,Staff,0,3,16,16
1745831880136,MMW 13R,A02,892728,Staff,0,4,16,16
1745831880136,MMW 13R,A03,958032,Staff,0,3,16,16
1745831880136,MMW 13R,A04,958033,Staff,0,2,16,16
1745831880136,MMW 13R,A05,958034,Staff,0,3,16,16
1745831881161,SIO 295LS,A00,894015,Staff,7,0,25,18
1745831882190,SIO 295S,A00,894020,Staff,7,0,25,18
1745831883218,SIOC 290S,B01,958918,Staff,0,0,0,0
1745831884249,SIOC 291S,B01,958922,Staff,0,0,0,0
1745831885276,SOCI 117,A01,895339,Staff,4,0,5,1
1745831886303,WES 237B,A00,894149,Staff,11,0,20,9
1745831888388,AESE 279B,A00,891859,Staff,13,0,35,22
1745831889415,AIP 197,001,891854,Staff,70,0,70,0
1745831890443,ANTH 289S,A00,891856,Gagneux; Pascal,12,0,12,0
1745831891468,BENG 196,001,957946,Engler; Adam J.,9996,0,9999,3
1745831892497,CAT 124RS,A01,956906,Staff,8,0,25,17
1745831893523,CAT 125RS,A01,922013,Staff,8,0,25,17
1745831894549,CLRE 250,A00,891860,Morris; Sheldon,9995,0,9999,4
1745831896603,CLRE 251R,A00,907817,Mehta; Ravindra L.,9994,0,9999,5
1745831897630,CLRE 252,A00,891864,Cuomo; Raphael Eduardo,9993,0,9999,6
1745831898658,CLRE 253,A00,891867,Vaida; Florin,9994,0,9999,5
1745831898658,CLRE 253,B00,907819,Staff,9999,0,9999,0
1745831899682,CLRE 259,A00,891868,Patel; Hemal,9998,0,9999,1
1745831900707,CLRE 260,A00,891872,Cuomo; Raphael Eduardo,9999,0,9999,0
1745831901733,CLRE 297,001,891888,Cuomo; Raphael Eduardo,9999,0,9999,0
1745831902759,CSE 191,A00,958773,Minnes Kemp; Mor Mia,9999,0,9999,0
1745831903787,CSS 201S,A01,892054,Mignozzetti; Umberto,30,0,30,0
1745831904813,CSS 202S,A01,892056,Mignozzetti; Umberto,30,0,30,0
1745831905848,DSC 197,001,956898,Eldridge; Justin Matthew,9998,0,9999,1
1745831906874,DSC 297,001,958000,Mazumdar; Arya,9998,0,9999,1
1745831907901,EAP 100,A00,905686,Staff,9776,0,9999,223
1745831908928,ECE 45,A01,892618,Staff,0,13,50,50
1745831909959,ECE 109,A01,892620,Staff,0,43,0,0
1745831910985,ECE 111,A01,892719,Staff,0,9,50,50
1745831912013,ECE 197,001,957920,Mercier; Patrick Philip,9992,0,9999,7
1745831913044,ECON 178,A01,907814,Zhu; Ying,28,0,35,7
1745831914070,EDS 115,A00,895312,Staff,41,0,45,4
1745831915100,EDS 117,A01,895337,Staff,30,0,30,0
1745831916142,EDS 125,A00,895341,Jones; Gabrielle Anastasia,43,0,45,2
1745831917202,EDS 128A,A01,895459,Fargason; Sharon Gayle,44,0,45,1
1745831918228,EDS 128B,A01,895543,Pappas; Elizabeth,44,0,45,1
1745831919256,EDS 139,A00,897203,Pappas; Elizabeth,44,0,45,1
1745831919256,EDS 139,B00,897209,Fargason; Sharon Gayle,44,0,45,1
1745831920286,EDS 201,A00,895545,Staff,43,0,45,2
1745831921319,EDS 203,A01,895581,Halter; Christopher P.,43,0,45,2
1745831922350,EDS 204R,A01,895625,Heinzman; Erica M.,43,0,45,2
1745831922350,EDS 204R,B01,895693,Halter; Christopher P.,18,0,45,27
1745831923380,EDS 206R,A00,895694,Fargason; Sharon Gayle,9,0,30,21
1745831923380,EDS 206R,B00,895695,Choi; Bailey Miyeon,20,0,30,10
1745831924408,EDS 250,A00,895697,Hemans; Patricia Ann Benitez,43,0,45,2
1745831925441,EDS 281,A00,895701,Meyerott; Theresa Ann,15,0,15,0
1745831926469,EDS 284,A00,895736,Meyerott; Theresa Ann,15,0,15,0
1745831927501,EDS 286,A00,897210,Fine; Sarah,15,0,15,0
1745831928531,EDS 289C,A01,895770,Daly; Alan J.,15,0,15,0
1745831929559,EDS 290,A00,897211,Hofstetter; Carolyn,15,0,15,0
1745831930591,LIGM 5A,A00,896162,Fischer-Grunski; Eva K,15,0,20,5
1745831931630,LIGM 5B,A00,896260,Fischer-Grunski; Eva K,17,0,20,3
1745831932663,LIGM 5C,A00,896308,Fischer-Grunski; Eva K,18,0,20,2
1745831933691,LIIT 5AS,A00,896313,Carnelos; Chiara,17,0,20,3
1745831934722,LIIT 5BS,A00,896416,Carnelos; Chiara,20,0,20,0
1745831943798,LIIT 5CS,A00,896564,Carnelos; Chiara,20,0,20,0
1745831944826,LISP 5A,A00,896588,Munoz Sanchez; Alicia,4,0,20,16
1745831945854,LISP 5B,A00,896653,Munoz Sanchez; Alicia,10,0,20,10
1745831954100,LISP 5C,A00,896655,Munoz Sanchez; Alicia,4,0,20,16
1745831955165,MAE 197,001,957918,Kleissl; Jan,9998,0,9999,1
1745831956192,MATH 2,A01,957937,Staff,34,0,35,1
1745831957219,MATH 197,001,957876,Kedlaya; Kiran S.,9993,0,9999,6
1745831958249,MCWP 40,A00,892729,Duru; Nur,13,0,20,7
1745831958249,MCWP 40,B00,893304,Montejo; Carolina,20,0,20,0
1745831959277,MCWP 40R,A00,893757,Redela; Pamela Morgan,0,7,20,20
1745831960303,MCWP 50,A00,893758,Morshed; Michael James,2,0,20,18
1745831960303,MCWP 50,B00,893761,Bartulis; Jason Michael,18,0,20,2
1745831961361,MCWP 50R,A00,893766,Compas; Sean Matthew,0,1,20,20
1745831961361,MCWP 50R,B00,893769,Carter; Jennifer A,0,0,20,20
1745831961361,MCWP 50R,C00,893771,Krone; Jarret,0,3,20,20
1745831961361,MCWP 50R,D00,893772,Miller; Elizabeth Deen,3,0,20,17
1745831961361,MCWP 50R,E00,893775,Carter; Andrea L,0,0,20,20
1745831962400,MMW 11R,A01,892721,Herbst; Matthew,11,0,27,16
1745831962400,MMW 11R,A02,892722,Herbst; Matthew,0,0,0,3
1745831963427,MMW 12R,A01,892724,Herbst; Matthew,0,10,16,16
1745831963427,MMW 12R,A02,892725,Herbst; Matthew,0,9,16,16
1745831964456,MMW 13R,A01,892727,Staff,0,3,16,16
1745831964456,MMW 13R,A02,892728,Staff,0,4,16,16
1745831964456,MMW 13R,A03,958032,Staff,0,3,16,16
1745831964456,MMW 13R,A04,958033,Staff,0,2,16,16
1745831964456,MMW 13R,A05,958034,Staff,0,3,16,16
1745831965488,SIO 295LS,A00,894015,Staff,7,0,25,18
1745831966524,SIO 295S,A00,894020,Staff,7,0,25,18
1745831967555,SIOC 290S,B01,958918,Staff,0,0,0,0
1745831968581,SIOC 291S,B01,958922,Staff,0,0,0,0
1745831969620,SOCI 117,A01,895339,Staff,4,0,5,1
1745831970666,WES 237B,A00,894149,Staff,11,0,20,9
1745831972805,AESE 279B,A00,891859,Staff,13,0,35,22
1745831973835,AIP 197,001,891854,Staff,70,0,70,0
1745831974867,ANTH 289S,A00,891856,Gagneux; Pascal,12,0,12,0
1745831975895,BENG 196,001,957946,Engler; Adam J.,9996,0,9999,3
1745831976925,CAT 124RS,A01,956906,Staff,8,0,25,17
1745831977955,CAT 125RS,A01,922013,Staff,8,0,25,17
1745831978981,CLRE 250,A00,891860,Morris; Sheldon,9995,0,9999,4
1745831981043,CLRE 251R,A00,907817,Mehta; Ravindra L.,9994,0,9999,5
1745831982073,CLRE 252,A00,891864,Cuomo; Raphael Eduardo,9993,0,9999,6
1745831983104,CLRE 253,A00,891867,Vaida; Florin,9994,0,9999,5
1745831983104,CLRE 253,B00,907819,Staff,9999,0,9999,0
1745831984136,CLRE 259,A00,891868,Patel; Hemal,9998,0,9999,1
1745831985162,CLRE 260,A00,891872,Cuomo; Raphael Eduardo,9999,0,9999,0
1745831986190,CLRE 297,001,891888,Cuomo; Raphael Eduardo,9999,0,9999,0
1745831987219,CSE 191,A00,958773,Minnes Kemp; Mor Mia,9999,0,9999,0
1745831988253,CSS 201S,A01,892054,Mignozzetti; Umberto,30,0,30,0
1745831989283,CSS 202S,A01,892056,Mignozzetti; Umberto,30,0,30,0
1745831990314,DSC 197,001,956898,Eldridge; Justin Matthew,9998,0,9999,1
1745831991345,DSC 297,001,958000,Mazumdar; Arya,9998,0,9999,1
1745831992372,EAP 100,A00,905686,Staff,9776,0,9999,223
1745831993399,ECE 45,A01,892618,Staff,0,13,50,50
1745831994426,ECE 109,A01,892620,Staff,0,43,0,0
1745831995455,ECE 111,A01,892719,Staff,0,9,50,50
1745831996481,ECE 197,001,957920,Mercier; Patrick Philip,9992,0,9999,7
1745831997522,ECON 178,A01,907814,Zhu; Ying,28,0,35,7
1745831998547,EDS 115,A00,895312,Staff,41,0,45,4
1745831999588,EDS 117,A01,895337,Staff,30,0,30,0
1745832000628,EDS 125,A00,895341,Jones; Gabrielle Anastasia,43,0,45,2
1745832001654,EDS 128A,A01,895459,Fargason; Sharon Gayle,44,0,45,1
1745832002683,EDS 128B,A01,895543,Pappas; Elizabeth,44,0,45,1
1745832003710,EDS 139,A00,897203,Pappas; Elizabeth,44,0,45,1
1745832003710,EDS 139,B00,897209,Fargason; Sharon Gayle,44,0,45,1
1745832013132,EDS 201,A00,895545,Staff,43,0,45,2
1745832014160,EDS 203,A01,895581,Halter; Christopher P.,43,0,45,2
1745832015193,EDS 204R,A01,895625,Heinzman; Erica M.,43,0,45,2
1745832015193,EDS 204R,B01,895693,Halter; Christopher P.,18,0,45,27
1745832016219,EDS 206R,A00,895694,Fargason; Sharon Gayle,9,0,30,21
1745832016219,EDS 206R,B00,895695,Choi; Bailey Miyeon,20,0,30,10
1745832017245,EDS 250,A00,895697,Hemans; Patricia Ann Benitez,43,0,45,2
1745832018273,EDS 281,A00,895701,Meyerott; Theresa Ann,15,0,15,0
1745832019308,EDS 284,A00,895736,Meyerott; Theresa Ann,15,0,15,0
1745832020345,EDS 286,A00,897210,Fine; Sarah,15,0,15,0
1745832021385,EDS 289C,A01,895770,Daly; Alan J.,15,0,15,0
1745832022420,EDS 290,A00,897211,Hofstetter; Carolyn,15,0,15,0
1745832023447,LIGM 5A,A00,896162,Fischer-Grunski; Eva K,15,0,20,5
1745832024475,LIGM 5B,A00,896260,Fischer-Grunski; Eva K,17,0,20,3
1745832025502,LIGM 5C,A00,896308,Fischer-Grunski; Eva K,18,0,20,2
1745832026535,LIIT 5AS,A00,896313,Carnelos; Chiara,17,0,20,3
1745832027562,LIIT 5BS,A00,896416,Carnelos; Chiara,20,0,20,0
1745832028587,LIIT 5CS,A00,896564,Carnelos; Chiara,20,0,20,0
1745832029616,LISP 5A,A00,896588,Munoz Sanchez; Alicia,4,0,20,16
1745832030650,LISP 5B,A00,896653,Munoz Sanchez; Alicia,10,0,20,10
1745832031681,LISP 5C,A00,896655,Munoz Sanchez; Alicia,4,0,20,16
1745832032713,MAE 197,001,957918,Kleissl; Jan,9998,0,9999,1
1745832033740,MATH 2,A01,957937,Staff,34,0,35,1
1745832034767,MATH 197,001,957876,Kedlaya; Kiran S.,9993,0,9999,6
1745832035800,MCWP 40,A00,892729,Duru; Nur,13,0,20,7
1745832035800,MCWP 40,B00,893304,Montejo; Carolina,20,0,20,0
1745832036827,MCWP 40R,A00,893757,Redela; Pamela Morgan,0,7,20,20
1745832037860,MCWP 50,A00,893758,Morshed; Michael James,2,0,20,18
1745832037860,MCWP 50,B00,893761,Bartulis; Jason Michael,18,0,20,2
1745832038887,MCWP 50R,A00,893766,Compas; Sean Matthew,0,1,20,20
1745832038887,MCWP 50R,B00,893769,Carter; Jennifer A,0,0,20,20
1745832038887,MCWP 50R,C00,893771,Krone; Jarret,0,3,20,20
1745832038887,MCWP 50R,D00,893772,Miller; Elizabeth Deen,3,0,20,17
1745832038887,MCWP 50R,E00,893775,Carter; Andrea L,0,0,20,20
1745832039917,MMW 11R,A01,892721,Herbst; Matthew,11,0,27,16
1745832039917,MMW 11R,A02,892722,Herbst; Matthew,0,0,0,3
1745832040947,MMW 12R,A01,892724,Herbst; Matthew,0,10,16,16
1745832040947,MMW 12R,A02,892725,Herbst; Matthew,0,9,16,16
1745832041973,MMW 13R,A01,892727,Staff,0,3,16,16
1745832041973,MMW 13R,A02,892728,Staff,0,4,16,16
1745832041973,MMW 13R,A03,958032,Staff,0,3,16,16
1745832041973,MMW 13R,A04,958033,Staff,0,2,16,16
1745832041973,MMW 13R,A05,958034,Staff,0,3,16,16
1745832043000,SIO 295LS,A00,894015,Staff,7,0,25,18
1745832044030,SIO 295S,A00,894020,Staff,7,0,25,18
1745832045062,SIOC 290S,B01,958918,Staff,0,0,0,0
1745832046091,SIOC 291S,B01,958922,Staff,0,0,0,0
1745832047119,SOCI 117,A01,895339,Staff,4,0,5,1
1745832048148,WES 237B,A00,894149,Staff,11,0,20,9
1745832050215,AESE 279B,A00,891859,Staff,13,0,35,22
1745832051240,AIP 197,001,891854,Staff,70,0,70,0
1745832052266,ANTH 289S,A00,891856,Gagneux; Pascal,12,0,12,0
1745832053295,BENG 196,001,957946,Engler; Adam J.,9996,0,9999,3
1745832054320,CAT 124RS,A01,956906,Staff,8,0,25,17
1745832055348,CAT 125RS,A01,922013,Staff,8,0,25,17
1745832056378,CLRE 250,A00,891860,Morris; Sheldon,9995,0,9999,4
1745832058435,CLRE 251R,A00,907817,Mehta; Ravindra L.,9994,0,9999,5
1745832059461,CLRE 252,A00,891864,Cuomo; Raphael Eduardo,9993,0,9999,6
1745832060489,CLRE 253,A00,891867,Vaida; Florin,9994,0,9999,5
1745832060489,CLRE 253,B00,907819,Staff,9999,0,9999,0
1745832061515,CLRE 259,A00,891868,Patel; Hemal,9998,0,9999,1
1745832062544,CLRE 260,A00,891872,Cuomo; Raphael Eduardo,9999,0,9999,0
1745832063571,CLRE 297,001,891888,Cuomo; Raphael Eduardo,9999,0,9999,0
1745832064597,CSE 191,A00,958773,Minnes Kemp; Mor Mia,9999,0,9999,0
1745832065635,CSS 201S,A01,892054,Mignozzetti; Umberto,30,0,30,0
1745832066663,CSS 202S,A01,892056,Mignozzetti; Umberto,30,0,30,0
1745832067690,DSC 197,001,956898,Eldridge; Justin Matthew,9998,0,9999,1
1745832068719,DSC 297,001,958000,Mazumdar; Arya,9998,0,9999,1
1745832069744,EAP 100,A00,905686,Staff,9776,0,9999,223
1745832070774,ECE 45,A01,892618,Staff,0,13,50,50
1745832071806,ECE 109,A01,892620,Staff,0,43,0,0
1745832072832,ECE 111,A01,892719,Staff,0,9,50,50
1745832073862,ECE 197,001,957920,Mercier; Patrick Philip,9992,0,9999,7
1745832074894,ECON 178,A01,907814,Zhu; Ying,28,0,35,7
1745832075925,EDS 115,A00,895312,Staff,41,0,45,4
1745832076954,EDS 117,A01,895337,Staff,30,0,30,0
1745832077981,EDS 125,A00,895341,Jones; Gabrielle Anastasia,43,0,45,2
1745832079014,EDS 128A,A01,895459,Fargason; Sharon Gayle,44,0,45,1
1745832080045,EDS 128B,A01,895543,Pappas; Elizabeth,44,0,45,1
1745832081069,EDS 139,A00,897203,Pappas; Elizabeth,44,0,45,1
1745832081069,EDS 139,B00,897209,Fargason; Sharon Gayle,44,0,45,1
1745832082095,EDS 201,A00,895545,Staff,43,0,45,2
1745832083123,EDS 203,A01,895581,Halter; Christopher P.,43,0,45,2
1745832084160,EDS 204R,A01,895625,Heinzman; Erica M.,43,0,45,2
1745832084160,EDS 204R,B01,895693,Halter; Christopher P.,18,0,45,27
1745832085191,EDS 206R,A00,895694,Fargason; Sharon Gayle,9,0,30,21
1745832085191,EDS 206R,B00,895695,Choi; Bailey Miyeon,20,0,30,10
1745832086222,EDS 250,A00,895697,Hemans; Patricia Ann Benitez,43,0,45,2
1745832087247,EDS 281,A00,895701,Meyerott; Theresa Ann,15,0,15,0
1745832088279,EDS 284,A00,895736,Meyerott; Theresa Ann,15,0,15,0
1745832089306,EDS 286,A00,897210,Fine; Sarah,15,0,15,0
1745832090332,EDS 289C,A01,895770,Daly; Alan J.,15,0,15,0
1745832091360,EDS 290,A00,897211,Hofstetter; Carolyn,15,0,15,0
1745832092397,LIGM 5A,A00,896162,Fischer-Grunski; Eva K,15,0,20,5
1745832093430,LIGM 5B,A00,896260,Fischer-Grunski; Eva K,17,0,20,3
1745832094458,LIGM 5C,A00,896308,Fischer-Grunski; Eva K,18,0,20,2
1745832095484,LIIT 5AS,A00,896313,Carnelos; Chiara,17,0,20,3
1745832096518,LIIT 5BS,A00,896416,Carnelos; Chiara,20,0,20,0
1745832097547,LIIT 5CS,A00,896564,Carnelos; Chiara,20,0,20,0
1745832098574,LISP 5A,A00,896588,Munoz Sanchez; Alicia,4,0,20,16
1745832099605,LISP 5B,A00,896653,Munoz Sanchez; Alicia,10,0,20,10
1745832100635,LISP 5C,A00,896655,Munoz Sanchez; Alicia,4,0,20,16
1745832101662,MAE 197,001,957918,Kleissl; Jan,9998,0,9999,1
1745832102691,MATH 2,A01,957937,Staff,34,0,35,1
1745832103721,MATH 197,001,957876,Kedlaya; Kiran S.,9993,0,9999,6
1745832104753,MCWP 40,A00,892729,Duru; Nur,13,0,20,7
1745832104753,MCWP 40,B00,893304,Montejo; Carolina,20,0,20,0
1745832105780,MCWP 40R,A00,893757,Redela; Pamela Morgan,0,7,20,20
1745832106808,MCWP 50,A00,893758,Morshed; Michael James,2,0,20,18
1745832106808,MCWP 50,B00,893761,Bartulis; Jason Michael,18,0,20,2
1745832107835,MCWP 50R,A00,893766,Compas; Sean Matthew,0,1,20,20
1745832107835,MCWP 50R,B00,893769,Carter; Jennifer A,0,0,20,20
1745832107835,MCWP 50R,C00,893771,Krone; Jarret,0,3,20,20
1745832107835,MCWP 50R,D00,893772,Miller; Elizabeth Deen,3,0,20,17
1745832107835,MCWP 50R,E00,893775,Carter; Andrea L,0,0,20,20
1745832108861,MMW 11R,A01,892721,Herbst; Matthew,11,0,27,16
1745832108861,MMW 11R,A02,892722,Herbst; Matthew,0,0,0,3
1745832109891,MMW 12R,A01,892724,Herbst; Matthew,0,10,16,16
1745832109891,MMW 12R,A02,892725,Herbst; Matthew,0,9,16,16
1745832110921,MMW 13R,A01,892727,Staff,0,3,16,16
1745832110921,MMW 13R,A02,892728,Staff,0,4,16,16
1745832110921,MMW 13R,A03,958032,Staff,0,3,16,16
1745832110921,MMW 13R,A04,958033,Staff,0,2,16,16
1745832110921,MMW 13R,A05,958034,Staff,0,3,16,16
1745832111951,SIO 295LS,A00,894015,Staff,7,0,25,18
1745832112980,SIO 295S,A00,894020,Staff,7,0,25,18
1745832114006,SIOC 290S,B01,958918,Staff,0,0,0,0
1745832115034,SIOC 291S,B01,958922,Staff,0,0,0,0
1745832116061,SOCI 117,A01,895339,Staff,4,0,5,1
1745832117088,WES 237B,A00,894149,Staff,11,0,20,9
1745832119158,AESE 279B,A00,891859,Staff,13,0,35,22
1745832120184,AIP 197,001,891854,Staff,70,0,70,0
1745832121211,ANTH 289S,A00,891856,Gagneux; Pascal,12,0,12,0
1745832122238,BENG 196,001,957946,Engler; Adam J.,9996,0,9999,3
1745832123268,CAT 124RS,A01,956906,Staff,8,0,25,17
1745832124296,CAT 125RS,A01,922013,Staff,8,0,25,17
1745832125324,CLRE 250,A00,891860,Morris; Sheldon,9995,0,9999,4
1745832127381,CLRE 251R,A00,907817,Mehta; Ravindra L.,9994,0,9999,5
1745832128411,CLRE 252,A00,891864,Cuomo; Raphael Eduardo,9993,0,9999,6
1745832129442,CLRE 253,A00,891867,Vaida; Florin,9994,0,9999,5
1745832129442,CLRE 253,B00,907819,Staff,9999,0,9999,0
1745832130468,CLRE 259,A00,891868,Patel; Hemal,9998,0,9999,1
1745832131494,CLRE 260,A00,891872,Cuomo; Raphael Eduardo,9999,0,9999,0
1745832132519,CLRE 297,001,891888,Cuomo; Raphael Eduardo,9999,0,9999,0
1745832133547,CSE 191,A00,958773,Minnes Kemp; Mor Mia,9999,0,9999,0
1745832134581,CSS 201S,A01,892054,Mignozzetti; Umberto,30,0,30,0
1745832135614,CSS 202S,A01,892056,Mignozzetti; Umberto,30,0,30,0
1745832136642,DSC 197,001,956898,Eldridge; Justin Matthew,9998,0,9999,1
1745832137673,DSC 297,001,958000,Mazumdar; Arya,9998,0,9999,1
1745832138702,EAP 100,A00,905686,Staff,9776,0,9999,223
1745832139731,ECE 45,A01,892618,Staff,0,13,50,50
1745832140757,ECE 109,A01,892620,Staff,0,43,0,0
1745832141810,ECE 111,A01,892719,Staff,0,9,50,50
1745832142838,ECE 197,001,957920,Mercier; Patrick Philip,9992,0,9999,7
1745832143864,ECON 178,A01,907814,Zhu; Ying,28,0,35,7
1745832144891,EDS 115,A00,895312,Staff,41,0,45,4
1745832145929,EDS 117,A01,895337,Staff,30,0,30,0
1745832146955,EDS 125,A00,895341,Jones; Gabrielle Anastasia,43,0,45,2
1745832147981,EDS 128A,A01,895459,Fargason; Sharon Gayle,44,0,45,1
1745832149007,EDS 128B,A01,895543,Pappas; Elizabeth,44,0,45,1
1745832150033,EDS 139,A00,897203,Pappas; Elizabeth,44,0,45,1
1745832150033,EDS 139,B00,897209,Fargason; Sharon Gayle,44,0,45,1
1745832151060,EDS 201,A00,895545,Staff,43,0,45,2
1745832152087,EDS 203,A01,895581,Halter; Christopher P.,43,0,45,2
1745832153112,EDS 204R,A01,895625,Heinzman; Erica M.,43,0,45,2
1745832153112,EDS 204R,B01,895693,Halter; Christopher P.,18,0,45,27
1745832154137,EDS 206R,A00,895694,Fargason; Sharon Gayle,9,0,30,21
1745832154137,EDS 206R,B00,895695,Choi; Bailey Miyeon,20,0,30,10
1745832155163,EDS 250,A00,895697,Hemans; Patricia Ann Benitez,43,0,45,2
1745832156192,EDS 281,A00,895701,Meyerott; Theresa Ann,15,0,15,0
1745832157218,EDS 284,A00,895736,Meyerott; Theresa Ann,15,0,15,0
1745832158246,EDS 286,A00,897210,Fine; Sarah,15,0,15,0
1745832159274,EDS 289C,A01,895770,Daly; Alan J.,15,0,15,0
1745832160303,EDS 290,A00,897211,Hofstetter; Carolyn,15,0,15,0
1745832161333,LIGM 5A,A00,896162,Fischer-Grunski; Eva K,15,0,20,5
1745832162359,LIGM 5B,A00,896260,Fischer-Grunski; Eva K,17,0,20,3
1745832163386,LIGM 5C,A00,896308,Fischer-Grunski; Eva K,18,0,20,2
1745832164413,LIIT 5AS,A00,896313,Carnelos; Chiara,17,0,20,3
1745832165443,LIIT 5BS,A00,896416,Carnelos; Chiara,20,0,20,0
1745832166469,LIIT 5CS,A00,896564,Carnelos; Chiara,20,0,20,0
1745832167496,LISP 5A,A00,896588,Munoz Sanchez; Alicia,4,0,20,16
1745832168526,LISP 5B,A00,896653,Munoz Sanchez; Alicia,10,0,20,10
1745832169552,LISP 5C,A00,896655,Munoz Sanchez; Alicia,4,0,20,16
1745832170579,MAE 197,001,957918,Kleissl; Jan,9998,0,9999,1
1745832171605,MATH 2,A01,957937,Staff,34,0,35,1
1745832172631,MATH 197,001,957876,Kedlaya; Kiran S.,9993,0,9999,6
1745832173665,MCWP 40,A00,892729,Duru; Nur,13,0,20,7
1745832173665,MCWP 40,B00,893304,Montejo; Carolina,20,0,20,0
1745832174694,MCWP 40R,A00,893757,Redela; Pamela Morgan,0,7,20,20
1745832175720,MCWP 50,A00,893758,Morshed; Michael James,2,0,20,18
1745832175720,MCWP 50,B00,893761,Bartulis; Jason Michael,18,0,20,2
1745832176750,MCWP 50R,A00,893766,Compas; Sean Matthew,0,1,20,20
1745832176750,MCWP 50R,B00,893769,Carter; Jennifer A,0,0,20,20
1745832176750,MCWP 50R,C00,893771,Krone; Jarret,0,3,20,20
1745832176750,MCWP 50R,D00,893772,Miller; Elizabeth Deen,3,0,20,17
1745832176750,MCWP 50R,E00,893775,Carter; Andrea L,0,0,20,20
1745832177775,MMW 11R,A01,892721,Herbst; Matthew,11,0,27,16
1745832177775,MMW 11R,A02,892722,Herbst; Matthew,0,0,0,3
1745832178798,MMW 12R,A01,892724,Herbst; Matthew,0,10,16,16
1745832178798,MMW 12R,A02,892725,Herbst; Matthew,0,9,16,16
1745832179828,MMW 13R,A01,892727,Staff,0,3,16,16
1745832179828,MMW 13R,A02,892728,Staff,0,4,16,16
1745832179828,MMW 13R,A03,958032,Staff,0,3,16,16
1745832179828,MMW 13R,A04,958033,Staff,0,2,16,16
1745832179828,MMW 13R,A05,958034,Staff,0,3,16,16
1745832180855,SIO 295LS,A00,894015,Staff,7,0,25,18
1745832181884,SIO 295S,A00,894020,Staff,7,0,25,18
1745832182910,SIOC 290S,B01,958918,Staff,0,0,0,0
1745832183941,SIOC 291S,B01,958922,Staff,0,0,0,0
1745832184969,SOCI 117,A01,895339,Staff,4,0,5,1
1745832185994,WES 237B,A00,894149,Staff,11,0,20,9
1745832188052,AESE 279B,A00,891859,Staff,13,0,35,22
1745832189079,AIP 197,001,891854,Staff,70,0,70,0
1745832190104,ANTH 289S,A00,891856,Gagneux; Pascal,12,0,12,0
1745832191128,BENG 196,001,957946,Engler; Adam J.,9996,0,9999,3
1745832192156,CAT 124RS,A01,956906,Staff,8,0,25,17
1745832193184,CAT 125RS,A01,922013,Staff,8,0,25,17
1745832194211,CLRE 250,A00,891860,Morris; Sheldon,9995,0,9999,4
1745832196262,CLRE 251R,A00,907817,Mehta; Ravindra L.,9994,0,9999,5
1745832197290,CLRE 252,A00,891864,Cuomo; Raphael Eduardo,9993,0,9999,6
1745832198312,CLRE 253,A00,891867,Vaida; Florin,9994,0,9999,5
1745832198312,CLRE 253,B00,907819,Staff,9999,0,9999,0
1745832199338,CLRE 259,A00,891868,Patel; Hemal,9998,0,9999,1
1745832200367,CLRE 260,A00,891872,Cuomo; Raphael Eduardo,9999,0,9999,0
1745832201408,CLRE 297,001,891888,Cuomo; Raphael Eduardo,9999,0,9999,0
1745832202432,CSE 191,A00,958773,Minnes Kemp; Mor Mia,9999,0,9999,0
1745832203462,CSS 201S,A01,892054,Mignozzetti; Umberto,30,0,30,0
1745832204492,CSS 202S,A01,892056,Mignozzetti; Umberto,30,0,30,0
1745832205519,DSC 197,001,956898,Eldridge; Justin Matthew,9998,0,9999,1
1745832206544,DSC 297,001,958000,Mazumdar; Arya,9998,0,9999,1
1745832207570,EAP 100,A00,905686,Staff,9776,0,9999,223
1745832208594,ECE 45,A01,892618,Staff,0,13,50,50
1745832209625,ECE 109,A01,892620,Staff,0,43,0,0
1745832210655,ECE 111,A01,892719,Staff,0,9,50,50
1745832211683,ECE 197,001,957920,Mercier; Patrick Philip,9992,0,9999,7
1745832212739,ECON 178,A01,907814,Zhu; Ying,28,0,35,7
1745832213764,EDS 115,A00,895312,Staff,41,0,45,4
1745832214788,EDS 117,A01,895337,Staff,30,0,30,0
1745832215821,EDS 125,A00,895341,Jones; Gabrielle Anastasia,43,0,45,2
1745832216847,EDS 128A,A01,895459,Fargason; Sharon Gayle,44,0,45,1
1745832217874,EDS 128B,A01,895543,Pappas; Elizabeth,44,0,45,1
1745832218898,EDS 139,A00,897203,Pappas; Elizabeth,44,0,45,1
1745832218898,EDS 139,B00,897209,Fargason; Sharon Gayle,44,0,45,1
1745832219924,EDS 201,A00,895545,Staff,43,0,45,2
1745832220949,EDS 203,A01,895581,Halter; Christopher P.,43,0,45,2
1745832221979,EDS 204R,A01,895625,Heinzman; Erica M.,43,0,45,2
1745832221979,EDS 204R,B01,895693,Halter; Christopher P.,18,0,45,27
1745832223007,EDS 206R,A00,895694,Fargason; Sharon Gayle,9,0,30,21
1745832223007,EDS 206R,B00,895695,Choi; Bailey Miyeon,20,0,30,10
1745832224034,EDS 250,A00,895697,Hemans; Patricia Ann Benitez,43,0,45,2
1745832225062,EDS 281,A00,895701,Meyerott; Theresa Ann,15,0,15,0
1745832226093,EDS 284,A00,895736,Meyerott; Theresa Ann,15,0,15,0
1745832227121,EDS 286,A00,897210,Fine; Sarah,15,0,15,0
1745832228149,EDS 289C,A01,895770,Daly; Alan J.,15,0,15,0
1745832229177,EDS 290,A00,897211,Hofstetter; Carolyn,15,0,15,0
1745832230204,LIGM 5A,A00,896162,Fischer-Grunski; Eva K,15,0,20,5
1745832231231,LIGM 5B,A00,896260,Fischer-Grunski; Eva K,17,0,20,3
1745832232257,LIGM 5C,A00,896308,Fischer-Grunski; Eva K,18,0,20,2
1745832233285,LIIT 5AS,A00,896313,Carnelos; Chiara,17,0,20,3
1745832234316,LIIT 5BS,A00,896416,Carnelos; Chiara,20,0,20,0
1745832235345,LIIT 5CS,A00,896564,Carnelos; Chiara,20,0,20,0
1745832236374,LISP 5A,A00,896588,Munoz Sanchez; Alicia,4,0,20,16
1745832237401,LISP 5B,A00,896653,Munoz Sanchez; Alicia,10,0,20,10
1745832238428,LISP 5C,A00,896655,Munoz Sanchez; Alicia,4,0,20,16
1745832239457,MAE 197,001,957918,Kleissl; Jan,9998,0,9999,1
1745832240484,MATH 2,A01,957937,Staff,34,0,35,1
1745832241514,MATH 197,001,957876,Kedlaya; Kiran S.,9993,0,9999,6
1745832242543,MCWP 40,A00,892729,Duru; Nur,13,0,20,7
1745832242543,MCWP 40,B00,893304,Montejo; Carolina,20,0,20,0
1745832243572,MCWP 40R,A00,893757,Redela; Pamela Morgan,0,7,20,20
1745832244603,MCWP 50,A00,893758,Morshed; Michael James,2,0,20,18
1745832244603,MCWP 50,B00,893761,Bartulis; Jason Michael,18,0,20,2
1745832245628,MCWP 50R,A00,893766,Compas; Sean Matthew,0,1,20,20
1745832245628,MCWP 50R,B00,893769,Carter; Jennifer A,0,0,20,20
1745832245628,MCWP 50R,C00,893771,Krone; Jarret,0,3,20,20
1745832245628,MCWP 50R,D00,893772,Miller; Elizabeth Deen,3,0,20,17
1745832245628,MCWP 50R,E00,893775,Carter; Andrea L,0,0,20,20
1745832246656,MMW 11R,A01,892721,Herbst; Matthew,11,0,27,16
1745832246656,MMW 11R,A02,892722,Herbst; Matthew,0,0,0,3
1745832247685,MMW 12R,A01,892724,Herbst; Matthew,0,10,16,16
1745832247685,MMW 12R,A02,892725,Herbst; Matthew,0,9,16,16
1745832248711,MMW 13R,A01,892727,Staff,0,3,16,16
1745832248711,MMW 13R,A02,892728,Staff,0,4,16,16
1745832248711,MMW 13R,A03,958032,Staff,0,3,16,16
1745832248711,MMW 13R,A04,958033,Staff,0,2,16,16
1745832248711,MMW 13R,A05,958034,Staff,0,3,16,16
1745832249741,SIO 295LS,A00,894015,Staff,7,0,25,18
1745832250765,SIO 295S,A00,894020,Staff,7,0,25,18
1745832251795,SIOC 290S,B01,958918,Staff,0,0,0,0
1745832252825,SIOC 291S,B01,958922,Staff,0,0,0,0
1745832253851,SOCI 117,A01,895339,Staff,4,0,5,1
1745832254880,WES 237B,A00,894149,Staff,11,0,20,9
1745832256948,AESE 279B,A00,891859,Staff,13,0,35,22
1745832257972,AIP 197,001,891854,Staff,70,0,70,0
1745832259000,ANTH 289S,A00,891856,Gagneux; Pascal,12,0,12,0
1745832260029,BENG 196,001,957946,Engler; Adam J.,9996,0,9999,3
1745832261054,CAT 124RS,A01,956906,Staff,8,0,25,17
1745832262081,CAT 125RS,A01,922013,Staff,8,0,25,17
1745832263111,CLRE 250,A00,891860,Morris; Sheldon,9995,0,9999,4
1745832265164,CLRE 251R,A00,907817,Mehta; Ravindra L.,9994,0,9999,5
1745832266190,CLRE 252,A00,891864,Cuomo; Raphael Eduardo,9993,0,9999,6
1745832267214,CLRE 253,A00,891867,Vaida; Florin,9994,0,9999,5
1745832267214,CLRE 253,B00,907819,Staff,9999,0,9999,0
1745832268241,CLRE 259,A00,891868,Patel; Hemal,9998,0,9999,1
1745832269271,CLRE 260,A00,891872,Cuomo; Raphael Eduardo,9999,0,9999,0
1745832270297,CLRE 297,001,891888,Cuomo; Raphael Eduardo,9999,0,9999,0
1745832271328,CSE 191,A00,958773,Minnes Kemp; Mor Mia,9999,0,9999,0
1745832272360,CSS 201S,A01,892054,Mignozzetti; Umberto,30,0,30,0
1745832273390,CSS 202S,A01,892056,Mignozzetti; Umberto,30,0,30,0
1745832274416,DSC 197,001,956898,Eldridge; Justin Matthew,9998,0,9999,1
1745832275444,DSC 297,001,958000,Mazumdar; Arya,9998,0,9999,1
1745832276472,EAP 100,A00,905686,Staff,9776,0,9999,223
1745832277496,ECE 45,A01,892618,Staff,0,13,50,50
1745832278523,ECE 109,A01,892620,Staff,0,43,0,0
1745832279551,ECE 111,A01,892719,Staff,0,9,50,50
1745832280609,ECE 197,001,957920,Mercier; Patrick Philip,9992,0,9999,7
1745832281636,ECON 178,A01,907814,Zhu; Ying,28,0,35,7
1745832282662,EDS 115,A00,895312,Staff,41,0,45,4
1745832283687,EDS 117,A01,895337,Staff,30,0,30,0
1745832284714,EDS 125,A00,895341,Jones; Gabrielle Anastasia,43,0,45,2
1745832285739,EDS 128A,A01,895459,Fargason; Sharon Gayle,44,0,45,1
1745832286762,EDS 128B,A01,895543,Pappas; Elizabeth,44,0,45,1
1745832287787,EDS 139,A00,897203,Pappas; Elizabeth,44,0,45,1
1745832287787,EDS 139,B00,897209,Fargason; Sharon Gayle,44,0,45,1
1745832288815,EDS 201,A00,895545,Staff,43,0,45,2
1745832289846,EDS 203,A01,895581,Halter; Christopher P.,43,0,45,2
1745832290872,EDS 204R,A01,895625,Heinzman; Erica M.,43,0,45,2
1745832290872,EDS 204R,B01,895693,Halter; Christopher P.,18,0,45,27
1745832291903,EDS 206R,A00,895694,Fargason; Sharon Gayle,9,0,30,21
1745832291903,EDS 206R,B00,895695,Choi; Bailey Miyeon,20,0,30,10
1745832292928,EDS 250,A00,895697,Hemans; Patricia Ann Benitez,43,0,45,2
1745832293955,EDS 281,A00,895701,Meyerott; Theresa Ann,15,0,15,0
1745832294981,EDS 284,A00,895736,Meyerott; Theresa Ann,15,0,15,0
1745832296008,EDS 286,A00,897210,Fine; Sarah,15,0,15,0
1745832297036,EDS 289C,A01,895770,Daly; Alan J.,15,0,15,0
1745832298062,EDS 290,A00,897211,Hofstetter; Carolyn,15,0,15,0
1745832299090,LIGM 5A,A00,896162,Fischer-Grunski; Eva K,15,0,20,5
1745832300119,LIGM 5B,A00,896260,Fischer-Grunski; Eva K,17,0,20,3
1745832301148,LIGM 5C,A00,896308,Fischer-Grunski; Eva K,18,0,20,2
1745832302182,LIIT 5AS,A00,896313,Carnelos; Chiara,17,0,20,3
1745832303209,LIIT 5BS,A00,896416,Carnelos; Chiara,20,0,20,0
1745832304242,LIIT 5CS,A00,896564,Carnelos; Chiara,20,0,20,0
1745832305274,LISP 5A,A00,896588,Munoz Sanchez; Alicia,4,0,20,16
1745832306304,LISP 5B,A00,896653,Munoz Sanchez; Alicia,10,0,20,10
1745832307331,LISP 5C,A00,896655,Munoz Sanchez; Alicia,4,0,20,16
1745832308361,MAE 197,001,957918,Kleissl; Jan,9998,0,9999,1
1745832309388,MATH 2,A01,957937,Staff,34,0,35,1
1745832310418,MATH 197,001,957876,Kedlaya; Kiran S.,9993,0,9999,6
1745832311449,MCWP 40,A00,892729,Duru; Nur,13,0,20,7
1745832311449,MCWP 40,B00,893304,Montejo; Carolina,20,0,20,0
1745832312479,MCWP 40R,A00,893757,Redela; Pamela Morgan,0,7,20,20
1745832313505,MCWP 50,A00,893758,Morshed; Michael James,2,0,20,18
1745832313505,MCWP 50,B00,893761,Bartulis; Jason Michael,18,0,20,2
1745832314533,MCWP 50R,A00,893766,Compas; Sean Matthew,0,1,20,20
1745832314533,MCWP 50R,B00,893769,Carter; Jennifer A,0,0,20,20
1745832314533,MCWP 50R,C00,893771,Krone; Jarret,0,3,20,20
1745832314533,MCWP 50R,D00,893772,Miller; Elizabeth Deen,3,0,20,17
1745832314533,MCWP 50R,E00,893775,Carter; Andrea L,0,0,20,20
1745832315563,MMW 11R,A01,892721,Herbst; Matthew,11,0,27,16
1745832315563,MMW 11R,A02,892722,Herbst; Matthew,0,0,0,3
1745832316593,MMW 12R,A01,892724,Herbst; Matthew,0,10,16,16
1745832316593,MMW 12R,A02,892725,Herbst; Matthew,0,9,16,16
1745832317623,MMW 13R,A01,892727,Staff,0,3,16,16
1745832317623,MMW 13R,A02,892728,Staff,0,4,16,16
1745832317623,MMW 13R,A03,958032,Staff,0,3,16,16
1745832317623,MMW 13R,A04,958033,Staff,0,2,16,16
1745832317623,MMW 13R,A05,958034,Staff,0,3,16,16
1745832318651,SIO 295LS,A00,894015,Staff,7,0,25,18
1745832319680,SIO 295S,A00,894020,Staff,7,0,25,18
1745832320707,SIOC 290S,B01,958918,Staff,0,0,0,0
1745832321737,SIOC 291S,B01,958922,Staff,0,0,0,0
1745832322764,SOCI 117,A01,895339,Staff,4,0,5,1
1745832323790,WES 237B,A00,894149,Staff,11,0,20,9
1745832325886,AESE 279B,A00,891859,Staff,13,0,35,22
1745832326913,AIP 197,001,891854,Staff,70,0,70,0
1745832327942,ANTH 289S,A00,891856,Gagneux; Pascal,12,0,12,0
1745832328969,BENG 196,001,957946,Engler; Adam J.,9996,0,9999,3
1745832329996,CAT 124RS,A01,956906,Staff,8,0,25,17
1745832331023,CAT 125RS,A01,922013,Staff,8,0,25,17
1745832332049,CLRE 250,A00,891860,Morris; Sheldon,9995,0,9999,4
1745832334109,CLRE 251R,A00,907817,Mehta; Ravindra L.,9994,0,9999,5
1745832335138,CLRE 252,A00,891864,Cuomo; Raphael Eduardo,9993,0,9999,6
1745832336164,CLRE 253,A00,891867,Vaida; Florin,9994,0,9999,5
1745832336164,CLRE 253,B00,907819,Staff,9999,0,9999,0
1745832337190,CLRE 259,A00,891868,Patel; Hemal,9998,0,9999,1
1745832338217,CLRE 260,A00,891872,Cuomo; Raphael Eduardo,9999,0,9999,0
1745832339246,CLRE 297,001,891888,Cuomo; Raphael Eduardo,9999,0,9999,0
1745832340273,CSE 191,A00,958773,Minnes Kemp; Mor Mia,9999,0,9999,0
1745832341301,CSS 201S,A01,892054,Mignozzetti; Umberto,30,0,30,0
1745832342328,CSS 202S,A01,892056,Mignozzetti; Umberto,30,0,30,0
1745832343356,DSC 197,001,956898,Eldridge; Justin Matthew,9998,0,9999,1
1745832344384,DSC 297,001,958000,Mazumdar; Arya,9998,0,9999,1
1745832345416,EAP 100,A00,905686,Staff,9776,0,9999,223
1745832346445,ECE 45,A01,892618,Staff,0,13,50,50
1745832347470,ECE 109,A01,892620,Staff,0,43,0,0
1745832348497,ECE 111,A01,892719,Staff,0,9,50,50
1745832349521,ECE 197,001,957920,Mercier; Patrick Philip,9992,0,9999,7
1745832350550,ECON 178,A01,907814,Zhu; Ying,28,0,35,7
1745832351578,EDS 115,A00,895312,Staff,41,0,45,4
1745832352604,EDS 117,A01,895337,Staff,30,0,30,0
1745832353635,EDS 125,A00,895341,Jones; Gabrielle Anastasia,43,0,45,2
1745832354665,EDS 128A,A01,895459,Fargason; Sharon Gayle,44,0,45,1
1745832355694,EDS 128B,A01,895543,Pappas; Elizabeth,44,0,45,1
1745832356720,EDS 139,A00,897203,Pappas; Elizabeth,44,0,45,1
1745832356720,EDS 139,B00,897209,Fargason; Sharon Gayle,44,0,45,1
1745832357748,EDS 201,A00,895545,Staff,43,0,45,2
1745832358779,EDS 203,A01,895581,Halter; Christopher P.,43,0,45,2
1745832359810,EDS 204R,A01,895625,Heinzman; Erica M.,43,0,45,2
1745832359810,EDS 204R,B01,895693,Halter; Christopher P.,18,0,45,27
1745832360840,EDS 206R,A00,895694,Fargason; Sharon Gayle,9,0,30,21
1745832360840,EDS 206R,B00,895695,Choi; Bailey Miyeon,20,0,30,10
1745832361868,EDS 250,A00,895697,Hemans; Patricia Ann Benitez,43,0,45,2
1745832362897,EDS 281,A00,895701,Meyerott; Theresa Ann,15,0,15,0
1745832363926,EDS 284,A00,895736,Meyerott; Theresa Ann,15,0,15,0
1745832364953,EDS 286,A00,897210,Fine; Sarah,15,0,15,0
1745832365980,EDS 289C,A01,895770,Daly; Alan J.,15,0,15,0
1745832367011,EDS 290,A00,897211,Hofstetter; Carolyn,15,0,15,0
1745832368059,LIGM 5A,A00,896162,Fischer-Grunski; Eva K,15,0,20,5
1745832369085,LIGM 5B,A00,896260,Fischer-Grunski; Eva K,17,0,20,3
1745832370117,LIGM 5C,A00,896308,Fischer-Grunski; Eva K,18,0,20,2
1745832371143,LIIT 5AS,A00,896313,Carnelos; Chiara,17,0,20,3
1745832372173,LIIT 5BS,A00,896416,Carnelos; Chiara,20,0,20,0
1745832373201,LIIT 5CS,A00,896564,Carnelos; Chiara,20,0,20,0
1745832374233,LISP 5A,A00,896588,Munoz Sanchez; Alicia,4,0,20,16
1745832375263,LISP 5B,A00,896653,Munoz Sanchez; Alicia,10,0,20,10
1745832376290,LISP 5C,A00,896655,Munoz Sanchez; Alicia,4,0,20,16
1745832377321,MAE 197,001,957918,Kleissl; Jan,9998,0,9999,1
1745832378346,MATH 2,A01,957937,Staff,34,0,35,1
1745832379372,MATH 197,001,957876,Kedlaya; Kiran S.,9993,0,9999,6
1745832380405,MCWP 40,A00,892729,Duru; Nur,13,0,20,7
1745832380405,MCWP 40,B00,893304,Montejo; Carolina,20,0,20,0
1745832381432,MCWP 40R,A00,893757,Redela; Pamela Morgan,0,7,20,20
1745832382458,MCWP 50,A00,893758,Morshed; Michael James,2,0,20,18
1745832382458,MCWP 50,B00,893761,Bartulis; Jason Michael,18,0,20,2
1745832383484,MCWP 50R,A00,893766,Compas; Sean Matthew,0,1,20,20
1745832383484,MCWP 50R,B00,893769,Carter; Jennifer A,0,0,20,20
1745832383484,MCWP 50R,C00,893771,Krone; Jarret,0,3,20,20
1745832383484,MCWP 50R,D00,893772,Miller; Elizabeth Deen,3,0,20,17
1745832383484,MCWP 50R,E00,893775,Carter; Andrea L,0,0,20,20
1745832384516,MMW 11R,A01,892721,Herbst; Matthew,11,0,27,16
1745832384516,MMW 11R,A02,892722,Herbst; Matthew,0,0,0,3
1745832385546,MMW 12R,A01,892724,Herbst; Matthew,0,10,16,16
1745832385546,MMW 12R,A02,892725,Herbst; Matthew,0,9,16,16
1745832386574,MMW 13R,A01,892727,Staff,0,3,16,16
1745832386574,MMW 13R,A02,892728,Staff,0,4,16,16
1745832386574,MMW 13R,A03,958032,Staff,0,3,16,16
1745832386574,MMW 13R,A04,958033,Staff,0,2,16,16
1745832386574,MMW 13R,A05,958034,Staff,0,3,16,16
1745832387604,SIO 295LS,A00,894015,Staff,7,0,25,18
1745832388631,SIO 295S,A00,894020,Staff,7,0,25,18
1745832389671,SIOC 290S,B01,958918,Staff,0,0,0,0
1745832390697,SIOC 291S,B01,958922,Staff,0,0,0,0
1745832391725,SOCI 117,A01,895339,Staff,4,0,5,1
1745832392751,WES 237B,A00,894149,Staff,11,0,20,9
1745832394870,AESE 279B,A00,891859,Staff,13,0,35,22
1745832395935,AIP 197,001,891854,Staff,70,0,70,0
1745832396962,ANTH 289S,A00,891856,Gagneux; Pascal,12,0,12,0
1745832397990,BENG 196,001,957946,Engler; Adam J.,9996,0,9999,3
1745832399021,CAT 124RS,A01,956906,Staff,8,0,25,17
1745832400049,CAT 125RS,A01,922013,Staff,8,0,25,17
1745832401076,CLRE 250,A00,891860,Morris; Sheldon,9995,0,9999,4
1745832403131,CLRE 251R,A00,907817,Mehta; Ravindra L.,9994,0,9999,5
1745832404158,CLRE 252,A00,891864,Cuomo; Raphael Eduardo,9993,0,9999,6
1745832405188,CLRE 253,A00,891867,Vaida; Florin,9994,0,9999,5
1745832405188,CLRE 253,B00,907819,Staff,9999,0,9999,0
1745832406214,CLRE 259,A00,891868,Patel; Hemal,9998,0,9999,1
1745832407240,CLRE 260,A00,891872,Cuomo; Raphael Eduardo,9999,0,9999,0
1745832408269,CLRE 297,001,891888,Cuomo; Raphael Eduardo,9999,0,9999,0
1745832409298,CSE 191,A00,958773,Minnes Kemp; Mor Mia,9999,0,9999,0
1745832410326,CSS 201S,A01,892054,Mignozzetti; Umberto,30,0,30,0
1745832411354,CSS 202S,A01,892056,Mignozzetti; Umberto,30,0,30,0
1745832412395,DSC 197,001,956898,Eldridge; Justin Matthew,9998,0,9999,1
1745832413426,DSC 297,001,958000,Mazumdar; Arya,9998,0,9999,1
1745832414451,EAP 100,A00,905686,Staff,9776,0,9999,223
1745832415478,ECE 45,A01,892618,Staff,0,13,50,50
1745832416506,ECE 109,A01,892620,Staff,0,43,0,0
1745832417533,ECE 111,A01,892719,Staff,0,9,50,50
1745832418565,ECE 197,001,957920,Mercier; Patrick Philip,9992,0,9999,7
1745832419593,ECON 178,A01,907814,Zhu; Ying,28,0,35,7
1745832420623,EDS 115,A00,895312,Staff,41,0,45,4
1745832421652,EDS 117,A01,895337,Staff,30,0,30,0
1745832422683,EDS 125,A00,895341,Jones; Gabrielle Anastasia,43,0,45,2
1745832423712,EDS 128A,A01,895459,Fargason; Sharon Gayle,44,0,45,1
1745832424740,EDS 128B,A01,895543,Pappas; Elizabeth,44,0,45,1
1745832425770,EDS 139,A00,897203,Pappas; Elizabeth,44,0,45,1
1745832425770,EDS 139,B00,897209,Fargason; Sharon Gayle,44,0,45,1
1745832426798,EDS 201,A00,895545,Staff,43,0,45,2
1745832427826,EDS 203,A01,895581,Halter; Christopher P.,43,0,45,2
1745832428853,EDS 204R,A01,895625,Heinzman; Erica M.,43,0,45,2
1745832428853,EDS 204R,B01,895693,Halter; Christopher P.,18,0,45,27
1745832429880,EDS 206R,A00,895694,Fargason; Sharon Gayle,9,0,30,21
1745832429880,EDS 206R,B00,895695,Choi; Bailey Miyeon,20,0,30,10
1745832430907,EDS 250,A00,895697,Hemans; Patricia Ann Benitez,43,0,45,2
1745832431935,EDS 281,A00,895701,Meyerott; Theresa Ann,15,0,15,0
1745832432963,EDS 284,A00,895736,Meyerott; Theresa Ann,15,0,15,0
1745832433991,EDS 286,A00,897210,Fine; Sarah,15,0,15,0
1745832435022,EDS 289C,A01,895770,Daly; Alan J.,15,0,15,0
1745832436058,EDS 290,A00,897211,Hofstetter; Carolyn,15,0,15,0
1745832437084,LIGM 5A,A00,896162,Fischer-Grunski; Eva K,15,0,20,5
1745832438110,LIGM 5B,A00,896260,Fischer-Grunski; Eva K,17,0,20,3
1745832439136,LIGM 5C,A00,896308,Fischer-Grunski; Eva K,18,0,20,2
1745832440166,LIIT 5AS,A00,896313,Carnelos; Chiara,17,0,20,3
1745832441193,LIIT 5BS,A00,896416,Carnelos; Chiara,20,0,20,0
1745832442218,LIIT 5CS,A00,896564,Carnelos; Chiara,20,0,20,0
1745832443247,LISP 5A,A00,896588,Munoz Sanchez; Alicia,4,0,20,16
1745832444275,LISP 5B,A00,896653,Munoz Sanchez; Alicia,10,0,20,10
1745832445305,LISP 5C,A00,896655,Munoz Sanchez; Alicia,4,0,20,16
1745832446332,MAE 197,001,957918,Kleissl; Jan,9998,0,9999,1
1745832447359,MATH 2,A01,957937,Staff,34,0,35,1
1745832448387,MATH 197,001,957876,Kedlaya; Kiran S.,9993,0,9999,6
1745832449419,MCWP 40,A00,892729,Duru; Nur,13,0,20,7
1745832449419,MCWP 40,B00,893304,Montejo; Carolina,20,0,20,0
1745832450447,MCWP 40R,A00,893757,Redela; Pamela Morgan,0,7,20,20
1745832451472,MCWP 50,A00,893758,Morshed; Michael James,2,0,20,18
1745832451472,MCWP 50,B00,893761,Bartulis; Jason Michael,18,0,20,2
1745832452538,MCWP 50R,A00,893766,Compas; Sean Matthew,0,1,20,20
1745832452538,MCWP 50R,B00,893769,Carter; Jennifer A,0,0,20,20
1745832452538,MCWP 50R,C00,893771,Krone; Jarret,0,3,20,20
1745832452538,MCWP 50R,D00,893772,Miller; Elizabeth Deen,3,0,20,17
1745832452538,MCWP 50R,E00,893775,Carter; Andrea L,0,0,20,20
1745832453567,MMW 11R,A01,892721,Herbst; Matthew,11,0,27,16
1745832453567,MMW 11R,A02,892722,Herbst; Matthew,0,0,0,3
1745832454597,MMW 12R,A01,892724,Herbst; Matthew,0,10,16,16
1745832454597,MMW 12R,A02,892725,Herbst; Matthew,0,9,16,16
1745832455623,MMW 13R,A01,892727,Staff,0,3,16,16
1745832455623,MMW 13R,A02,892728,Staff,0,4,16,16
1745832455623,MMW 13R,A03,958032,Staff,0,3,16,16
1745832455623,MMW 13R,A04,958033,Staff,0,2,16,16
1745832455623,MMW 13R,A05,958034,Staff,0,3,16,16
1745832456648,SIO 295LS,A00,894015,Staff,7,0,25,18
1745832457673,SIO 295S,A00,894020,Staff,7,0,25,18
1745832458700,SIOC 290S,B01,958918,Staff,0,0,0,0
1745832459731,SIOC 291S,B01,958922,Staff,0,0,0,0
1745832460761,SOCI 117,A01,895339,Staff,4,0,5,1
1745832461787,WES 237B,A00,894149,Staff,11,0,20,9
1745832463864,AESE 279B,A00,891859,Staff,13,0,35,22
1745832464890,AIP 197,001,891854,Staff,70,0,70,0
1745832465918,ANTH 289S,A00,891856,Gagneux; Pascal,12,0,12,0
1745832466949,BENG 196,001,957946,Engler; Adam J.,9996,0,9999,3
1745832467975,CAT 124RS,A01,956906,Staff,8,0,25,17
1745832469000,CAT 125RS,A01,922013,Staff,8,0,25,17
1745832470026,CLRE 250,A00,891860,Morris; Sheldon,9995,0,9999,4
1745832472083,CLRE 251R,A00,907817,Mehta; Ravindra L.,9994,0,9999,5
1745832473114,CLRE 252,A00,891864,Cuomo; Raphael Eduardo,9993,0,9999,6
1745832474140,CLRE 253,A00,891867,Vaida; Florin,9994,0,9999,5
1745832474140,CLRE 253,B00,907819,Staff,9999,0,9999,0
1745832475172,CLRE 259,A00,891868,Patel; Hemal,9998,0,9999,1
1745832476197,CLRE 260,A00,891872,Cuomo; Raphael Eduardo,9999,0,9999,0
1745832477225,CLRE 297,001,891888,Cuomo; Raphael Eduardo,9999,0,9999,0
1745832478257,CSE 191,A00,958773,Minnes Kemp; Mor Mia,9999,0,9999,0
1745832479283,CSS 201S,A01,892054,Mignozzetti; Umberto,30,0,30,0
1745832480311,CSS 202S,A01,892056,Mignozzetti; Umberto,30,0,30,0
1745832481341,DSC 197,001,956898,Eldridge; Justin Matthew,9998,0,9999,1
1745832482369,DSC 297,001,958000,Mazumdar; Arya,9998,0,9999,1
1745832483395,EAP 100,A00,905686,Staff,9776,0,9999,223
1745832484421,ECE 45,A01,892618,Staff,0,13,50,50
1745832485448,ECE 109,A01,892620,Staff,0,43,0,0
1745832486478,ECE 111,A01,892719,Staff,0,9,50,50
1745832487509,ECE 197,001,957920,Mercier; Patrick Philip,9992,0,9999,7
1745832488535,ECON 178,A01,907814,Zhu; Ying,28,0,35,7
1745832489561,EDS 115,A00,895312,Staff,41,0,45,4
1745832490588,EDS 117,A01,895337,Staff,30,0,30,0
1745832491615,EDS 125,A00,895341,Jones; Gabrielle Anastasia,43,0,45,2
1745832492644,EDS 128A,A01,895459,Fargason; Sharon Gayle,44,0,45,1
1745832493673,EDS 128B,A01,895543,Pappas; Elizabeth,44,0,45,1
1745832494703,EDS 139,A00,897203,Pappas; Elizabeth,44,0,45,1
1745832494703,EDS 139,B00,897209,Fargason; Sharon Gayle,44,0,45,1
1745832495732,EDS 201,A00,895545,Staff,43,0,45,2
1745832496763,EDS 203,A01,895581,Halter; Christopher P.,43,0,45,2
1745832497794,EDS 204R,A01,895625,Heinzman; Erica M.,43,0,45,2
1745832497794,EDS 204R,B01,895693,Halter; Christopher P.,18,0,45,27
1745832498851,EDS 206R,A00,895694,Fargason; Sharon Gayle,9,0,30,21
1745832498851,EDS 206R,B00,895695,Choi; Bailey Miyeon,20,0,30,10
1745832499877,EDS 250,A00,895697,Hemans; Patricia Ann Benitez,43,0,45,2
1745832500904,EDS 281,A00,895701,Meyerott; Theresa Ann,15,0,15,0
1745832501931,EDS 284,A00,895736,Meyerott; Theresa Ann,15,0,15,0
1745832502959,EDS 286,A00,897210,Fine; Sarah,15,0,15,0
1745832503985,EDS 289C,A01,895770,Daly; Alan J.,15,0,15,0
1745832505016,EDS 290,A00,897211,Hofstetter; Carolyn,15,0,15,0
1745832506047,LIGM 5A,A00,896162,Fischer-Grunski; Eva K,15,0,20,5
1745832507074,LIGM 5B,A00,896260,Fischer-Grunski; Eva K,17,0,20,3
1745832508101,LIGM 5C,A00,896308,Fischer-Grunski; Eva K,18,0,20,2
1745832509129,LIIT 5AS,A00,896313,Carnelos; Chiara,17,0,20,3
1745832510158,LIIT 5BS,A00,896416,Carnelos; Chiara,20,0,20,0
1745832511185,LIIT 5CS,A00,896564,Carnelos; Chiara,20,0,20,0
1745832512218,LISP 5A,A00,896588,Munoz Sanchez; Alicia,4,0,20,16
1745832513249,LISP 5B,A00,896653,Munoz Sanchez; Alicia,10,0,20,10
1745832514275,LISP 5C,A00,896655,Munoz Sanchez; Alicia,4,0,20,16
1745832515305,MAE 197,001,957918,Kleissl; Jan,9998,0,9999,1
1745832516332,MATH 2,A01,957937,Staff,34,0,35,1
1745832517359,MATH 197,001,957876,Kedlaya; Kiran S.,9993,0,9999,6
1745832518387,MCWP 40,A00,892729,Duru; Nur,13,0,20,7
1745832518387,MCWP 40,B00,893304,Montejo; Carolina,20,0,20,0
1745832519416,MCWP 40R,A00,893757,Redela; Pamela Morgan,0,7,20,20
1745832520448,MCWP 50,A00,893758,Morshed; Michael James,2,0,20,18
1745832520448,MCWP 50,B00,893761,Bartulis; Jason Michael,18,0,20,2
1745832521483,MCWP 50R,A00,893766,Compas; Sean Matthew,0,1,20,20
1745832521483,MCWP 50R,B00,893769,Carter; Jennifer A,0,0,20,20
1745832521483,MCWP 50R,C00,893771,Krone; Jarret,0,3,20,20
1745832521483,MCWP 50R,D00,893772,Miller; Elizabeth Deen,3,0,20,17
1745832521483,MCWP 50R,E00,893775,Carter; Andrea L,0,0,20,20
1745832522517,MMW 11R,A01,892721,Herbst; Matthew,11,0,27,16
1745832522517,MMW 11R,A02,892722,Herbst; Matthew,0,0,0,3
1745832523547,MMW 12R,A01,892724,Herbst; Matthew,0,10,16,16
1745832523547,MMW 12R,A02,892725,Herbst; Matthew,0,9,16,16
1745832524574,MMW 13R,A01,892727,Staff,0,3,16,16
1745832524574,MMW 13R,A02,892728,Staff,0,4,16,16
1745832524574,MMW 13R,A03,958032,Staff,0,3,16,16
1745832524574,MMW 13R,A04,958033,Staff,0,2,16,16
1745832524574,MMW 13R,A05,958034,Staff,0,3,16,16
1745832525602,SIO 295LS,A00,894015,Staff,7,0,25,18
1745832526628,SIO 295S,A00,894020,Staff,7,0,25,18
1745832527655,SIOC 290S,B01,958918,Staff,0,0,0,0
1745832528682,SIOC 291S,B01,958922,Staff,0,0,0,0
1745832529711,SOCI 117,A01,895339,Staff,4,0,5,1
1745832530737,WES 237B,A00,894149,Staff,11,0,20,9
1745832532826,AESE 279B,A00,891859,Staff,13,0,35,22
1745832533855,AIP 197,001,891854,Staff,70,0,70,0
1745832534883,ANTH 289S,A00,891856,Gagneux; Pascal,12,0,12,0
1745832535911,BENG 196,001,957946,Engler; Adam J.,9996,0,9999,3
1745832536936,CAT 124RS,A01,956906,Staff,8,0,25,17
1745832537961,CAT 125RS,A01,922013,Staff,8,0,25,17
1745832538992,CLRE 250,A00,891860,Morris; Sheldon,9995,0,9999,4
1745832541046,CLRE 251R,A00,907817,Mehta; Ravindra L.,9994,0,9999,5
1745832542077,CLRE 252,A00,891864,Cuomo; Raphael Eduardo,9993,0,9999,6
1745832543106,CLRE 253,A00,891867,Vaida; Florin,9994,0,9999,5
1745832543106,CLRE 253,B00,907819,Staff,9999,0,9999,0
1745832544136,CLRE 259,A00,891868,Patel; Hemal,9998,0,9999,1
1745832545162,CLRE 260,A00,891872,Cuomo; Raphael Eduardo,9999,0,9999,0
1745832546191,CLRE 297,001,891888,Cuomo; Raphael Eduardo,9999,0,9999,0
1745832547218,CSE 191,A00,958773,Minnes Kemp; Mor Mia,9999,0,9999,0
1745832548248,CSS 201S,A01,892054,Mignozzetti; Umberto,30,0,30,0
1745832549274,CSS 202S,A01,892056,Mignozzetti; Umberto,30,0,30,0
1745832550303,DSC 197,001,956898,Eldridge; Justin Matthew,9998,0,9999,1
1745832551331,DSC 297,001,958000,Mazumdar; Arya,9998,0,9999,1
1745832552358,EAP 100,A00,905686,Staff,9776,0,9999,223
1745832553390,ECE 45,A01,892618,Staff,0,13,50,50
1745832554422,ECE 109,A01,892620,Staff,0,43,0,0
1745832555452,ECE 111,A01,892719,Staff,0,9,50,50
1745832556478,ECE 197,001,957920,Mercier; Patrick Philip,9992,0,9999,7
1745832557508,ECON 178,A01,907814,Zhu; Ying,28,0,35,7
1745832558535,EDS 115,A00,895312,Staff,41,0,45,4
1745832559564,EDS 117,A01,895337,Staff,30,0,30,0
1745832560590,EDS 125,A00,895341,Jones; Gabrielle Anastasia,43,0,45,2
1745832561632,EDS 128A,A01,895459,Fargason; Sharon Gayle,44,0,45,1
1745832562657,EDS 128B,A01,895543,Pappas; Elizabeth,44,0,45,1
1745832563686,EDS 139,A00,897203,Pappas; Elizabeth,44,0,45,1
1745832563686,EDS 139,B00,897209,Fargason; Sharon Gayle,44,0,45,1
1745832564713,EDS 201,A00,895545,Staff,43,0,45,2
1745832565738,EDS 203,A01,895581,Halter; Christopher P.,43,0,45,2
1745832566764,EDS 204R,A01,895625,Heinzman; Erica M.,43,0,45,2
1745832566764,EDS 204R,B01,895693,Halter; Christopher P.,18,0,45,27
1745832567790,EDS 206R,A00,895694,Fargason; Sharon Gayle,9,0,30,21
1745832567790,EDS 206R,B00,895695,Choi; Bailey Miyeon,20,0,30,10
1745832568816,EDS 250,A00,895697,Hemans; Patricia Ann Benitez,43,0,45,2
1745832569844,EDS 281,A00,895701,Meyerott; Theresa Ann,15,0,15,0
1745832570870,EDS 284,A00,895736,Meyerott; Theresa Ann,15,0,15,0
1745832571900,EDS 286,A00,897210,Fine; Sarah,15,0,15,0
1745832572930,EDS 289C,A01,895770,Daly; Alan J.,15,0,15,0
1745832573961,EDS 290,A00,897211,Hofstetter; Carolyn,15,0,15,0
1745832574990,LIGM 5A,A00,896162,Fischer-Grunski; Eva K,15,0,20,5
1745832576021,LIGM 5B,A00,896260,Fischer-Grunski; Eva K,17,0,20,3
1745832577077,LIGM 5C,A00,896308,Fischer-Grunski; Eva K,18,0,20,2
1745832578105,LIIT 5AS,A00,896313,Carnelos; Chiara,17,0,20,3
1745832579132,LIIT 5BS,A00,896416,Carnelos; Chiara,20,0,20,0
1745832580159,LIIT 5CS,A00,896564,Carnelos; Chiara,20,0,20,0
1745832581188,LISP 5A,A00,896588,Munoz Sanchez; Alicia,4,0,20,16
1745832582218,LISP 5B,A00,896653,Munoz Sanchez; Alicia,10,0,20,10
1745832583245,LISP 5C,A00,896655,Munoz Sanchez; Alicia,4,0,20,16
1745832584269,MAE 197,001,957918,Kleissl; Jan,9998,0,9999,1
1745832585298,MATH 2,A01,957937,Staff,34,0,35,1
1745832586323,MATH 197,001,957876,Kedlaya; Kiran S.,9993,0,9999,6
1745832587354,MCWP 40,A00,892729,Duru; Nur,13,0,20,7
1745832587354,MCWP 40,B00,893304,Montejo; Carolina,20,0,20,0
1745832588381,MCWP 40R,A00,893757,Redela; Pamela Morgan,0,7,20,20
1745832589408,MCWP 50,A00,893758,Morshed; Michael James,2,0,20,18
1745832589408,MCWP 50,B00,893761,Bartulis; Jason Michael,18,0,20,2
1745832590439,MCWP 50R,A00,893766,Compas; Sean Matthew,0,1,20,20
1745832590439,MCWP 50R,B00,893769,Carter; Jennifer A,0,0,20,20
1745832590439,MCWP 50R,C00,893771,Krone; Jarret,0,3,20,20
1745832590439,MCWP 50R,D00,893772,Miller; Elizabeth Deen,3,0,20,17
1745832590439,MCWP 50R,E00,893775,Carter; Andrea L,0,0,20,20
1745832591469,MMW 11R,A01,892721,Herbst; Matthew,11,0,27,16
1745832591469,MMW 11R,A02,892722,Herbst; Matthew,0,0,0,3
1745832592500,MMW 12R,A01,892724,Herbst; Matthew,0,10,16,16
1745832592500,MMW 12R,A02,892725,Herbst; Matthew,0,9,16,16
1745832593528,MMW 13R,A01,892727,Staff,0,3,16,16
1745832593528,MMW 13R,A02,892728,Staff,0,4,16,16
1745832593528,MMW 13R,A03,958032,Staff,0,3,16,16
1745832593528,MMW 13R,A04,958033,Staff,0,2,16,16
1745832593528,MMW 13R,A05,958034,Staff,0,3,16,16
1745832594557,SIO 295LS,A00,894015,Staff,7,0,25,18
1745832595583,SIO 295S,A00,894020,Staff,7,0,25,18
1745832596612,SIOC 290S,B01,958918,Staff,0,0,0,0
1745832597644,SIOC 291S,B01,958922,Staff,0,0,0,0
1745832598667,SOCI 117,A01,895339,Staff,4,0,5,1
1745832599694,WES 237B,A00,894149,Staff,11,0,20,9
1745832601773,AESE 279B,A00,891859,Staff,13,0,35,22
1745832602798,AIP 197,001,891854,Staff,70,0,70,0
1745832603822,ANTH 289S,A00,891856,Gagneux; Pascal,12,0,12,0
1745832604850,BENG 196,001,957946,Engler; Adam J.,9996,0,9999,3
1745832605880,CAT 124RS,A01,956906,Staff,8,0,25,17
1745832606909,CAT 125RS,A01,922013,Staff,8,0,25,17
1745832607934,CLRE 250,A00,891860,Morris; Sheldon,9995,0,9999,4
1745832609991,CLRE 251R,A00,907817,Mehta; Ravindra L.,9994,0,9999,5
1745832611027,CLRE 252,A00,891864,Cuomo; Raphael Eduardo,9993,0,9999,6
1745832612056,CLRE 253,A00,891867,Vaida; Florin,9994,0,9999,5
1745832612056,CLRE 253,B00,907819,Staff,9999,0,9999,0
1745832613080,CLRE 259,A00,891868,Patel; Hemal,9998,0,9999,1
1745832614106,CLRE 260,A00,891872,Cuomo; Raphael Eduardo,9999,0,9999,0
1745832615132,CLRE 297,001,891888,Cuomo; Raphael Eduardo,9999,0,9999,0
1745832616163,CSE 191,A00,958773,Minnes Kemp; Mor Mia,9999,0,9999,0
1745832617188,CSS 201S,A01,892054,Mignozzetti; Umberto,30,0,30,0
1745832618216,CSS 202S,A01,892056,Mignozzetti; Umberto,30,0,30,0
1745832619247,DSC 197,001,956898,Eldridge; Justin Matthew,9998,0,9999,1
1745832620274,DSC 297,001,958000,Mazumdar; Arya,9998,0,9999,1
1745832621301,EAP 100,A00,905686,Staff,9776,0,9999,223
1745832622327,ECE 45,A01,892618,Staff,0,13,50,50
1745832623359,ECE 109,A01,892620,Staff,0,43,0,0
1745832624388,ECE 111,A01,892719,Staff,0,9,50,50
1745832625414,ECE 197,001,957920,Mercier; Patrick Philip,9992,0,9999,7
1745832626447,ECON 178,A01,907814,Zhu; Ying,28,0,35,7
1745832627473,EDS 115,A00,895312,Staff,41,0,45,4
1745832628500,EDS 117,A01,895337,Staff,30,0,30,0
1745832629527,EDS 125,A00,895341,Jones; Gabrielle Anastasia,43,0,45,2
1745832630554,EDS 128A,A01,895459,Fargason; Sharon Gayle,44,0,45,1
1745832631581,EDS 128B,A01,895543,Pappas; Elizabeth,44,0,45,1
1745832632611,EDS 139,A00,897203,Pappas; Elizabeth,44,0,45,1
1745832632611,EDS 139,B00,897209,Fargason; Sharon Gayle,44,0,45,1
1745832633640,EDS 201,A00,895545,Staff,43,0,45,2
1745832634668,EDS 203,A01,895581,Halter; Christopher P.,43,0,45,2
1745832635694,EDS 204R,A01,895625,Heinzman; Erica M.,43,0,45,2
1745832635694,EDS 204R,B01,895693,Halter; Christopher P.,18,0,45,27
1745832636721,EDS 206R,A00,895694,Fargason; Sharon Gayle,9,0,30,21
1745832636721,EDS 206R,B00,895695,Choi; Bailey Miyeon,20,0,30,10
1745832637751,EDS 250,A00,895697,Hemans; Patricia Ann Benitez,43,0,45,2
1745832638778,EDS 281,A00,895701,Meyerott; Theresa Ann,15,0,15,0
1745832639807,EDS 284,A00,895736,Meyerott; Theresa Ann,15,0,15,0
1745832640835,EDS 286,A00,897210,Fine; Sarah,15,0,15,0
1745832641860,EDS 289C,A01,895770,Daly; Alan J.,15,0,15,0
1745832642884,EDS 290,A00,897211,Hofstetter; Carolyn,15,0,15,0
1745832643915,LIGM 5A,A00,896162,Fischer-Grunski; Eva K,15,0,20,5
1745832644944,LIGM 5B,A00,896260,Fischer-Grunski; Eva K,17,0,20,3
1745832645970,LIGM 5C,A00,896308,Fischer-Grunski; Eva K,18,0,20,2
1745832646997,LIIT 5AS,A00,896313,Carnelos; Chiara,17,0,20,3
1745832648024,LIIT 5BS,A00,896416,Carnelos; Chiara,20,0,20,0
1745832649054,LIIT 5CS,A00,896564,Carnelos; Chiara,20,0,20,0
1745832650085,LISP 5A,A00,896588,Munoz Sanchez; Alicia,4,0,20,16
1745832651112,LISP 5B,A00,896653,Munoz Sanchez; Alicia,10,0,20,10
1745832652140,LISP 5C,A00,896655,Munoz Sanchez; Alicia,4,0,20,16
1745832653167,MAE 197,001,957918,Kleissl; Jan,9998,0,9999,1
1745832654195,MATH 2,A01,957937,Staff,34,0,35,1
1745832655222,MATH 197,001,957876,Kedlaya; Kiran S.,9993,0,9999,6
1745832656250,MCWP 40,A00,892729,Duru; Nur,13,0,20,7
1745832656250,MCWP 40,B00,893304,Montejo; Carolina,20,0,20,0
1745832657279,MCWP 40R,A00,893757,Redela; Pamela Morgan,0,7,20,20
1745832658305,MCWP 50,A00,893758,Morshed; Michael James,2,0,20,18
1745832658305,MCWP 50,B00,893761,Bartulis; Jason Michael,18,0,20,2
1745832659332,MCWP 50R,A00,893766,Compas; Sean Matthew,0,1,20,20
1745832659332,MCWP 50R,B00,893769,Carter; Jennifer A,0,0,20,20
1745832659332,MCWP 50R,C00,893771,Krone; Jarret,0,3,20,20
1745832659332,MCWP 50R,D00,893772,Miller; Elizabeth Deen,3,0,20,17
1745832659332,MCWP 50R,E00,893775,Carter; Andrea L,0,0,20,20
1745832660358,MMW 11R,A01,892721,Herbst; Matthew,11,0,27,16
1745832660358,MMW 11R,A02,892722,Herbst; Matthew,0,0,0,3
1745832661388,MMW 12R,A01,892724,Herbst; Matthew,0,10,16,16
1745832661388,MMW 12R,A02,892725,Herbst; Matthew,0,9,16,16
1745832662416,MMW 13R,A01,892727,Staff,0,3,16,16
1745832662416,MMW 13R,A02,892728,Staff,0,4,16,16
1745832662416,MMW 13R,A03,958032,Staff,0,3,16,16
1745832662416,MMW 13R,A04,958033,Staff,0,2,16,16
1745832662416,MMW 13R,A05,958034,Staff,0,3,16,16
1745832663442,SIO 295LS,A00,894015,Staff,7,0,25,18
1745832664469,SIO 295S,A00,894020,Staff,7,0,25,18
1745832665495,SIOC 290S,B01,958918,Staff,0,0,0,0
1745832666521,SIOC 291S,B01,958922,Staff,0,0,0,0
1745832667548,SOCI 117,A01,895339,Staff,4,0,5,1
1745832668573,WES 237B,A00,894149,Staff,11,0,20,9
1745832670649,AESE 279B,A00,891859,Staff,13,0,35,22
1745832671674,AIP 197,001,891854,Staff,70,0,70,0
1745832672703,ANTH 289S,A00,891856,Gagneux; Pascal,12,0,12,0
1745832673727,BENG 196,001,957946,Engler; Adam J.,9996,0,9999,3
1745832674751,CAT 124RS,A01,956906,Staff,8,0,25,17
1745832675777,CAT 125RS,A01,922013,Staff,8,0,25,17
1745832676807,CLRE 250,A00,891860,Morris; Sheldon,9995,0,9999,4
1745832678862,CLRE 251R,A00,907817,Mehta; Ravindra L.,9994,0,9999,5
1745832679886,CLRE 252,A00,891864,Cuomo; Raphael Eduardo,9993,0,9999,6
1745832680912,CLRE 253,A00,891867,Vaida; Florin,9994,0,9999,5
1745832680912,CLRE 253,B00,907819,Staff,9999,0,9999,0
1745832681942,CLRE 259,A00,891868,Patel; Hemal,9998,0,9999,1
1745832682972,CLRE 260,A00,891872,Cuomo; Raphael Eduardo,9999,0,9999,0
1745832684001,CLRE 297,001,891888,Cuomo; Raphael Eduardo,9999,0,9999,0
1745832685032,CSE 191,A00,958773,Minnes Kemp; Mor Mia,9999,0,9999,0
1745832686066,CSS 201S,A01,892054,Mignozzetti; Umberto,30,0,30,0
1745832687092,CSS 202S,A01,892056,Mignozzetti; Umberto,30,0,30,0
1745832688118,DSC 197,001,956898,Eldridge; Justin Matthew,9998,0,9999,1
1745832689145,DSC 297,001,958000,Mazumdar; Arya,9998,0,9999,1
1745832690171,EAP 100,A00,905686,Staff,9776,0,9999,223
1745832691197,ECE 45,A01,892618,Staff,0,13,50,50
1745832692225,ECE 109,A01,892620,Staff,0,43,0,0
1745832693255,ECE 111,A01,892719,Staff,0,9,50,50
1745832694284,ECE 197,001,957920,Mercier; Patrick Philip,9992,0,9999,7
1745832695312,ECON 178,A01,907814,Zhu; Ying,28,0,35,7
1745832696340,EDS 115,A00,895312,Staff,41,0,45,4
1745832697369,EDS 117,A01,895337,Staff,30,0,30,0
1745832698396,EDS 125,A00,895341,Jones; Gabrielle Anastasia,43,0,45,2
1745832699424,EDS 128A,A01,895459,Fargason; Sharon Gayle,44,0,45,1
1745832700476,EDS 128B,A01,895543,Pappas; Elizabeth,44,0,45,1
1745832701503,EDS 139,A00,897203,Pappas; Elizabeth,44,0,45,1
1745832701503,EDS 139,B00,897209,Fargason; Sharon Gayle,44,0,45,1
1745832702530,EDS 201,A00,895545,Staff,43,0,45,2
1745832703559,EDS 203,A01,895581,Halter; Christopher P.,43,0,45,2
1745832704587,EDS 204R,A01,895625,Heinzman; Erica M.,43,0,45,2
1745832704587,EDS 204R,B01,895693,Halter; Christopher P.,18,0,45,27
1745832705613,EDS 206R,A00,895694,Fargason; Sharon Gayle,9,0,30,21
1745832705613,EDS 206R,B00,895695,Choi; Bailey Miyeon,20,0,30,10
1745832706636,EDS 250,A00,895697,Hemans; Patricia Ann Benitez,43,0,45,2
1745832707665,EDS 281,A00,895701,Meyerott; Theresa Ann,15,0,15,0
1745832708689,EDS 284,A00,895736,Meyerott; Theresa Ann,15,0,15,0
1745832709715,EDS 286,A00,897210,Fine; Sarah,15,0,15,0
1745832710743,EDS 289C,A01,895770,Daly; Alan J.,15,0,15,0
1745832711770,EDS 290,A00,897211,Hofstetter; Carolyn,15,0,15,0
1745832712795,LIGM 5A,A00,896162,Fischer-Grunski; Eva K,15,0,20,5
1745832713843,LIGM 5B,A00,896260,Fischer-Grunski; Eva K,17,0,20,3
1745832714868,LIGM 5C,A00,896308,Fischer-Grunski; Eva K,18,0,20,2
1745832715893,LIIT 5AS,A00,896313,Carnelos; Chiara,17,0,20,3
1745832716918,LIIT 5BS,A00,896416,Carnelos; Chiara,20,0,20,0
1745832717947,LIIT 5CS,A00,896564,Carnelos; Chiara,20,0,20,0
1745832718978,LISP 5A,A00,896588,Munoz Sanchez; Alicia,4,0,20,16
1745832720009,LISP 5B,A00,896653,Munoz Sanchez; Alicia,10,0,20,10
1745832721038,LISP 5C,A00,896655,Munoz Sanchez; Alicia,4,0,20,16
1745832722066,MAE 197,001,957918,Kleissl; Jan,9998,0,9999,1
1745832723115,MATH 2,A01,957937,Staff,34,0,35,1
1745832724144,MATH 197,001,957876,Kedlaya; Kiran S.,9993,0,9999,6
1745832725171,MCWP 40,A00,892729,Duru; Nur,13,0,20,7
1745832725171,MCWP 40,B00,893304,Montejo; Carolina,20,0,20,0
1745832726197,MCWP 40R,A00,893757,Redela; Pamela Morgan,0,7,20,20
1745832727227,MCWP 50,A00,893758,Morshed; Michael James,2,0,20,18
1745832727227,MCWP 50,B00,893761,Bartulis; Jason Michael,18,0,20,2
1745832728253,MCWP 50R,A00,893766,Compas; Sean Matthew,0,1,20,20
1745832728253,MCWP 50R,B00,893769,Carter; Jennifer A,0,0,20,20
1745832728253,MCWP 50R,C00,893771,Krone; Jarret,0,3,20,20
1745832728253,MCWP 50R,D00,893772,Miller; Elizabeth Deen,3,0,20,17
1745832728253,MCWP 50R,E00,893775,Carter; Andrea L,0,0,20,20
1745832729279,MMW 11R,A01,892721,Herbst; Matthew,11,0,27,16
1745832729279,MMW 11R,A02,892722,Herbst; Matthew,0,0,0,3
1745832730309,MMW 12R,A01,892724,Herbst; Matthew,0,10,16,16
1745832730309,MMW 12R,A02,892725,Herbst; Matthew,0,9,16,16
1745832731336,MMW 13R,A01,892727,Staff,0,3,16,16
1745832731336,MMW 13R,A02,892728,Staff,0,4,16,16
1745832731336,MMW 13R,A03,958032,Staff,0,3,16,16
1745832731336,MMW 13R,A04,958033,Staff,0,2,16,16
1745832731336,MMW 13R,A05,958034,Staff,0,3,16,16
1745832732362,SIO 295LS,A00,894015,Staff,7,0,25,18
1745832733390,SIO 295S,A00,894020,Staff,7,0,25,18
1745832734420,SIOC 290S,B01,958918,Staff,0,0,0,0
1745832735451,SIOC 291S,B01,958922,Staff,0,0,0,0
1745832736474,SOCI 117,A01,895339,Staff,4,0,5,1
1745832737500,WES 237B,A00,894149,Staff,11,0,20,9
1745832739590,AESE 279B,A00,891859,Staff,13,0,35,22
1745832740616,AIP 197,001,891854,Staff,70,0,70,0
1745832741645,ANTH 289S,A00,891856,Gagneux; Pascal,12,0,12,0
1745832742675,BENG 196,001,957946,Engler; Adam J.,9996,0,9999,3
1745832743700,CAT 124RS,A01,956906,Staff,8,0,25,17
1745832744725,CAT 125RS,A01,922013,Staff,8,0,25,17
1745832745751,CLRE 250,A00,891860,Morris; Sheldon,9995,0,9999,4
1745832747808,CLRE 251R,A00,907817,Mehta; Ravindra L.,9994,0,9999,5
1745832748832,CLRE 252,A00,891864,Cuomo; Raphael Eduardo,9993,0,9999,6
1745832749858,CLRE 253,A00,891867,Vaida; Florin,9994,0,9999,5
1745832749858,CLRE 253,B00,907819,Staff,9999,0,9999,0
1745832750885,CLRE 259,A00,891868,Patel; Hemal,9998,0,9999,1
1745832751910,CLRE 260,A00,891872,Cuomo; Raphael Eduardo,9999,0,9999,0
1745832752935,CLRE 297,001,891888,Cuomo; Raphael Eduardo,9999,0,9999,0
1745832753962,CSE 191,A00,958773,Minnes Kemp; Mor Mia,9999,0,9999,0
1745832754988,CSS 201S,A01,892054,Mignozzetti; Umberto,30,0,30,0
1745832756014,CSS 202S,A01,892056,Mignozzetti; Umberto,30,0,30,0
1745832757040,DSC 197,001,956898,Eldridge; Justin Matthew,9998,0,9999,1
1745832758066,DSC 297,001,958000,Mazumdar; Arya,9998,0,9999,1
1745832759090,EAP 100,A00,905686,Staff,9776,0,9999,223
1745832760117,ECE 45,A01,892618,Staff,0,13,50,50
1745832761144,ECE 109,A01,892620,Staff,0,43,0,0
1745832762174,ECE 111,A01,892719,Staff,0,9,50,50
1745832763203,ECE 197,001,957920,Mercier; Patrick Philip,9992,0,9999,7
1745832764229,ECON 178,A01,907814,Zhu; Ying,28,0,35,7
1745832765253,EDS 115,A00,895312,Staff,41,0,45,4
1745832766279,EDS 117,A01,895337,Staff,30,0,30,0
1745832767303,EDS 125,A00,895341,Jones; Gabrielle Anastasia,43,0,45,2
1745832768328,EDS 128A,A01,895459,Fargason; Sharon Gayle,44,0,45,1
1745832769352,EDS 128B,A01,895543,Pappas; Elizabeth,44,0,45,1
1745832770380,EDS 139,A00,897203,Pappas; Elizabeth,44,0,45,1
1745832770380,EDS 139,B00,897209,Fargason; Sharon Gayle,44,0,45,1
1745832771405,EDS 201,A00,895545,Staff,43,0,45,2
1745832772432,EDS 203,A01,895581,Halter; Christopher P.,43,0,45,2
1745832773460,EDS 204R,A01,895625,Heinzman; Erica M.,43,0,45,2
1745832773460,EDS 204R,B01,895693,Halter; Christopher P.,18,0,45,27
1745832774485,EDS 206R,A00,895694,Fargason; Sharon Gayle,9,0,30,21
1745832774485,EDS 206R,B00,895695,Choi; Bailey Miyeon,20,0,30,10
1745832775510,EDS 250,A00,895697,Hemans; Patricia Ann Benitez,43,0,45,2
1745832776538,EDS 281,A00,895701,Meyerott; Theresa Ann,15,0,15,0
1745832777566,EDS 284,A00,895736,Meyerott; Theresa Ann,15,0,15,0
1745832778592,EDS 286,A00,897210,Fine; Sarah,15,0,15,0
1745832779620,EDS 289C,A01,895770,Daly; Alan J.,15,0,15,0
1745832780645,EDS 290,A00,897211,Hofstetter; Carolyn,15,0,15,0
1745832781675,LIGM 5A,A00,896162,Fischer-Grunski; Eva K,15,0,20,5
1745832782707,LIGM 5B,A00,896260,Fischer-Grunski; Eva K,17,0,20,3
1745832783737,LIGM 5C,A00,896308,Fischer-Grunski; Eva K,18,0,20,2
1745832784764,LIIT 5AS,A00,896313,Carnelos; Chiara,17,0,20,3
1745832785791,LIIT 5BS,A00,896416,Carnelos; Chiara,20,0,20,0
1745832786817,LIIT 5CS,A00,896564,Carnelos; Chiara,20,0,20,0
1745832787847,LISP 5A,A00,896588,Munoz Sanchez; Alicia,4,0,20,16
1745832788874,LISP 5B,A00,896653,Munoz Sanchez; Alicia,10,0,20,10
1745832789903,LISP 5C,A00,896655,Munoz Sanchez; Alicia,4,0,20,16
1745832790931,MAE 197,001,957918,Kleissl; Jan,9998,0,9999,1
1745832791959,MATH 2,A01,957937,Staff,34,0,35,1
1745832792989,MATH 197,001,957876,Kedlaya; Kiran S.,9993,0,9999,6
1745832794015,MCWP 40,A00,892729,Duru; Nur,13,0,20,7
1745832794015,MCWP 40,B00,893304,Montejo; Carolina,20,0,20,0
1745832795043,MCWP 40R,A00,893757,Redela; Pamela Morgan,0,7,20,20
1745832796072,MCWP 50,A00,893758,Morshed; Michael James,2,0,20,18
1745832796072,MCWP 50,B00,893761,Bartulis; Jason Michael,18,0,20,2
1745832797099,MCWP 50R,A00,893766,Compas; Sean Matthew,0,1,20,20
1745832797099,MCWP 50R,B00,893769,Carter; Jennifer A,0,0,20,20
1745832797099,MCWP 50R,C00,893771,Krone; Jarret,0,3,20,20
1745832797099,MCWP 50R,D00,893772,Miller; Elizabeth Deen,3,0,20,17
1745832797099,MCWP 50R,E00,893775,Carter; Andrea L,0,0,20,20
1745832798125,MMW 11R,A01,892721,Herbst; Matthew,11,0,27,16
1745832798125,MMW 11R,A02,892722,Herbst; Matthew,0,0,0,3
1745832799149,MMW 12R,A01,892724,Herbst; Matthew,0,10,16,16
1745832799149,MMW 12R,A02,892725,Herbst; Matthew,0,9,16,16
1745832800175,MMW 13R,A01,892727,Staff,0,3,16,16
1745832800175,MMW 13R,A02,892728,Staff,0,4,16,16
1745832800175,MMW 13R,A03,958032,Staff,0,3,16,16
1745832800175,MMW 13R,A04,958033,Staff,0,2,16,16
1745832800175,MMW 13R,A05,958034,Staff,0,3,16,16
1745832801201,SIO 295LS,A00,894015,Staff,7,0,25,18
1745832802227,SIO 295S,A00,894020,Staff,7,0,25,18
1745832803254,SIOC 290S,B01,958918,Staff,0,0,0,0
1745832804282,SIOC 291S,B01,958922,Staff,0,0,0,0
1745832805310,SOCI 117,A01,895339,Staff,4,0,5,1
1745832806337,WES 237B,A00,894149,Staff,11,0,20,9
1745832808408,AESE 279B,A00,891859,Staff,13,0,35,22
1745832809436,AIP 197,001,891854,Staff,70,0,70,0
1745832810465,ANTH 289S,A00,891856,Gagneux; Pascal,12,0,12,0
1745832811489,BENG 196,001,957946,Engler; Adam J.,9996,0,9999,3
1745832812516,CAT 124RS,A01,956906,Staff,8,0,25,17
1745832813543,CAT 125RS,A01,922013,Staff,8,0,25,17
1745832814570,CLRE 250,A00,891860,Morris; Sheldon,9995,0,9999,4
1745832816662,CLRE 251R,A00,907817,Mehta; Ravindra L.,9994,0,9999,5
1745832817686,CLRE 252,A00,891864,Cuomo; Raphael Eduardo,9993,0,9999,6
1745832818712,CLRE 253,A00,891867,Vaida; Florin,9994,0,9999,5
1745832818712,CLRE 253,B00,907819,Staff,9999,0,9999,0
1745832819742,CLRE 259,A00,891868,Patel; Hemal,9998,0,9999,1
1745832820769,CLRE 260,A00,891872,Cuomo; Raphael Eduardo,9999,0,9999,0
1745832821794,CLRE 297,001,891888,Cuomo; Raphael Eduardo,9999,0,9999,0
1745832822818,CSE 191,A00,958773,Minnes Kemp; Mor Mia,9999,0,9999,0
1745832823849,CSS 201S,A01,892054,Mignozzetti; Umberto,30,0,30,0
1745832824876,CSS 202S,A01,892056,Mignozzetti; Umberto,30,0,30,0
1745832825904,DSC 197,001,956898,Eldridge; Justin Matthew,9998,0,9999,1
1745832826930,DSC 297,001,958000,Mazumdar; Arya,9998,0,9999,1
1745832827957,EAP 100,A00,905686,Staff,9776,0,9999,223
1745832828984,ECE 45,A01,892618,Staff,0,13,50,50
1745832830011,ECE 109,A01,892620,Staff,0,43,0,0
1745832831037,ECE 111,A01,892719,Staff,0,9,50,50
1745832832065,ECE 197,001,957920,Mercier; Patrick Philip,9992,0,9999,7
1745832833091,ECON 178,A01,907814,Zhu; Ying,28,0,35,7
1745832834118,EDS 115,A00,895312,Staff,41,0,45,4
1745832835147,EDS 117,A01,895337,Staff,30,0,30,0
1745832836171,EDS 125,A00,895341,Jones; Gabrielle Anastasia,43,0,45,2
1745832837197,EDS 128A,A01,895459,Fargason; Sharon Gayle,44,0,45,1
1745832838222,EDS 128B,A01,895543,Pappas; Elizabeth,44,0,45,1
1745832839249,EDS 139,A00,897203,Pappas; Elizabeth,44,0,45,1
1745832839249,EDS 139,B00,897209,Fargason; Sharon Gayle,44,0,45,1
1745832840278,EDS 201,A00,895545,Staff,43,0,45,2
1745832841305,EDS 203,A01,895581,Halter; Christopher P.,43,0,45,2
1745832842336,EDS 204R,A01,895625,Heinzman; Erica M.,43,0,45,2
1745832842336,EDS 204R,B01,895693,Halter; Christopher P.,18,0,45,27
1745832843363,EDS 206R,A00,895694,Fargason; Sharon Gayle,9,0,30,21
1745832843363,EDS 206R,B00,895695,Choi; Bailey Miyeon,20,0,30,10
1745832844390,EDS 250,A00,895697,Hemans; Patricia Ann Benitez,43,0,45,2
1745832845417,EDS 281,A00,895701,Meyerott; Theresa Ann,15,0,15,0
1745832846445,EDS 284,A00,895736,Meyerott; Theresa Ann,15,0,15,0
1745832847472,EDS 286,A00,897210,Fine; Sarah,15,0,15,0
1745832848497,EDS 289C,A01,895770,Daly; Alan J.,15,0,15,0
1745832849528,EDS 290,A00,897211,Hofstetter; Carolyn,15,0,15,0
1745832850553,LIGM 5A,A00,896162,Fischer-Grunski; Eva K,15,0,20,5
1745832851579,LIGM 5B,A00,896260,Fischer-Grunski; Eva K,17,0,20,3
1745832852604,LIGM 5C,A00,896308,Fischer-Grunski; Eva K,18,0,20,2
1745832853629,LIIT 5AS,A00,896313,Carnelos; Chiara,17,0,20,3
1745832854656,LIIT 5BS,A00,896416,Carnelos; Chiara,20,0,20,0
1745832855686,LIIT 5CS,A00,896564,Carnelos; Chiara,20,0,20,0
1745832856713,LISP 5A,A00,896588,Munoz Sanchez; Alicia,4,0,20,16
1745832857742,LISP 5B,A00,896653,Munoz Sanchez; Alicia,10,0,20,10
1745832858768,LISP 5C,A00,896655,Munoz Sanchez; Alicia,4,0,20,16
1745832859795,MAE 197,001,957918,Kleissl; Jan,9998,0,9999,1
1745832860820,MATH 2,A01,957937,Staff,34,0,35,1
1745832861847,MATH 197,001,957876,Kedlaya; Kiran S.,9993,0,9999,6
1745832862873,MCWP 40,A00,892729,Duru; Nur,13,0,20,7
1745832862873,MCWP 40,B00,893304,Montejo; Carolina,20,0,20,0
1745832863899,MCWP 40R,A00,893757,Redela; Pamela Morgan,0,7,20,20
1745832864925,MCWP 50,A00,893758,Morshed; Michael James,2,0,20,18
1745832864925,MCWP 50,B00,893761,Bartulis; Jason Michael,18,0,20,2
1745832865958,MCWP 50R,A00,893766,Compas; Sean Matthew,0,1,20,20
1745832865958,MCWP 50R,B00,893769,Carter; Jennifer A,0,0,20,20
1745832865958,MCWP 50R,C00,893771,Krone; Jarret,0,3,20,20
1745832865958,MCWP 50R,D00,893772,Miller; Elizabeth Deen,3,0,20,17
1745832865958,MCWP 50R,E00,893775,Carter; Andrea L,0,0,20,20
1745832866984,MMW 11R,A01,892721,Herbst; Matthew,11,0,27,16
1745832866984,MMW 11R,A02,892722,Herbst; Matthew,0,0,0,3
1745832868010,MMW 12R,A01,892724,Herbst; Matthew,0,10,16,16
1745832868010,MMW 12R,A02,892725,Herbst; Matthew,0,9,16,16
1745832869039,MMW 13R,A01,892727,Staff,0,3,16,16
1745832869039,MMW 13R,A02,892728,Staff,0,4,16,16
1745832869039,MMW 13R,A03,958032,Staff,0,3,16,16
1745832869039,MMW 13R,A04,958033,Staff,0,2,16,16
1745832869039,MMW 13R,A05,958034,Staff,0,3,16,16
1745832870064,SIO 295LS,A00,894015,Staff,7,0,25,18
1745832871090,SIO 295S,A00,894020,Staff,7,0,25,18
1745832872124,SIOC 290S,B01,958918,Staff,0,0,0,0
1745832873152,SIOC 291S,B01,958922,Staff,0,0,0,0
1745832874178,SOCI 117,A01,895339,Staff,4,0,5,1
1745832875207,WES 237B,A00,894149,Staff,11,0,20,9
1745832877268,AESE 279B,A00,891859,Staff,13,0,35,22
1745832878294,AIP 197,001,891854,Staff,70,0,70,0
1745832879319,ANTH 289S,A00,891856,Gagneux; Pascal,12,0,12,0
1745832880344,BENG 196,001,957946,Engler; Adam J.,9996,0,9999,3
1745832881375,CAT 124RS,A01,956906,Staff,8,0,25,17
1745832882405,CAT 125RS,A01,922013,Staff,8,0,25,17
1745832883435,CLRE 250,A00,891860,Morris; Sheldon,9995,0,9999,4
1745832885486,CLRE 251R,A00,907817,Mehta; Ravindra L.,9994,0,9999,5
1745832886512,CLRE 252,A00,891864,Cuomo; Raphael Eduardo,9993,0,9999,6
1745832887538,CLRE 253,A00,891867,Vaida; Florin,9994,0,9999,5
1745832887538,CLRE 253,B00,907819,Staff,9999,0,9999,0
1745832888567,CLRE 259,A00,891868,Patel; Hemal,9998,0,9999,1
1745832889594,CLRE 260,A00,891872,Cuomo; Raphael Eduardo,9999,0,9999,0
1745832890622,CLRE 297,001,891888,Cuomo; Raphael Eduardo,9999,0,9999,0
1745832891647,CSE 191,A00,958773,Minnes Kemp; Mor Mia,9999,0,9999,0
1745832892673,CSS 201S,A01,892054,Mignozzetti; Umberto,30,0,30,0
1745832893699,CSS 202S,A01,892056,Mignozzetti; Umberto,30,0,30,0
1745832894725,DSC 197,001,956898,Eldridge; Justin Matthew,9998,0,9999,1
1745832895753,DSC 297,001,958000,Mazumdar; Arya,9998,0,9999,1
1745832896778,EAP 100,A00,905686,Staff,9776,0,9999,223
1745832897803,ECE 45,A01,892618,Staff,0,13,50,50
1745832898831,ECE 109,A01,892620,Staff,0,43,0,0
1745832899860,ECE 111,A01,892719,Staff,0,9,50,50
1745832900886,ECE 197,001,957920,Mercier; Patrick Philip,9992,0,9999,7
1745832901910,ECON 178,A01,907814,Zhu; Ying,28,0,35,7
1745832902936,EDS 115,A00,895312,Staff,41,0,45,4
1745832903963,EDS 117,A01,895337,Staff,30,0,30,0
1745832904988,EDS 125,A00,895341,Jones; Gabrielle Anastasia,43,0,45,2
1745832906016,EDS 128A,A01,895459,Fargason; Sharon Gayle,44,0,45,1
1745832907043,EDS 128B,A01,895543,Pappas; Elizabeth,44,0,45,1
1745832908067,EDS 139,A00,897203,Pappas; Elizabeth,44,0,45,1
1745832908067,EDS 139,B00,897209,Fargason; Sharon Gayle,44,0,45,1
1745832909094,EDS 201,A00,895545,Staff,43,0,45,2
1745832910124,EDS 203,A01,895581,Halter; Christopher P.,43,0,45,2
1745832911153,EDS 204R,A01,895625,Heinzman; Erica M.,43,0,45,2
1745832911153,EDS 204R,B01,895693,Halter; Christopher P.,18,0,45,27
1745832912182,EDS 206R,A00,895694,Fargason; Sharon Gayle,9,0,30,21
1745832912182,EDS 206R,B00,895695,Choi; Bailey Miyeon,20,0,30,10
1745832913206,EDS 250,A00,895697,Hemans; Patricia Ann Benitez,43,0,45,2
1745832914231,EDS 281,A00,895701,Meyerott; Theresa Ann,15,0,15,0
1745832915257,EDS 284,A00,895736,Meyerott; Theresa Ann,15,0,15,0
1745832916282,EDS 286,A00,897210,Fine; Sarah,15,0,15,0
1745832917307,EDS 289C,A01,895770,Daly; Alan J.,15,0,15,0
1745832918335,EDS 290,A00,897211,Hofstetter; Carolyn,15,0,15,0
1745832919361,LIGM 5A,A00,896162,Fischer-Grunski; Eva K,15,0,20,5
1745832920428,LIGM 5B,A00,896260,Fischer-Grunski; Eva K,17,0,20,3
1745832921458,LIGM 5C,A00,896308,Fischer-Grunski; Eva K,18,0,20,2
1745832922487,LIIT 5AS,A00,896313,Carnelos; Chiara,17,0,20,3
1745832923513,LIIT 5BS,A00,896416,Carnelos; Chiara,20,0,20,0
1745832924540,LIIT 5CS,A00,896564,Carnelos; Chiara,20,0,20,0
1745832925569,LISP 5A,A00,896588,Munoz Sanchez; Alicia,4,0,20,16
1745832926594,LISP 5B,A00,896653,Munoz Sanchez; Alicia,10,0,20,10
1745832927623,LISP 5C,A00,896655,Munoz Sanchez; Alicia,4,0,20,16
1745832928647,MAE 197,001,957918,Kleissl; Jan,9998,0,9999,1
1745832929674,MATH 2,A01,957937,Staff,34,0,35,1
1745832930700,MATH 197,001,957876,Kedlaya; Kiran S.,9993,0,9999,6
1745832931729,MCWP 40,A00,892729,Duru; Nur,13,0,20,7
1745832931729,MCWP 40,B00,893304,Montejo; Carolina,20,0,20,0
1745832932753,MCWP 40R,A00,893757,Redela; Pamela Morgan,0,7,20,20
1745832933784,MCWP 50,A00,893758,Morshed; Michael James,2,0,20,18
1745832933784,MCWP 50,B00,893761,Bartulis; Jason Michael,18,0,20,2
1745832934809,MCWP 50R,A00,893766,Compas; Sean Matthew,0,1,20,20
1745832934809,MCWP 50R,B00,893769,Carter; Jennifer A,0,0,20,20
1745832934809,MCWP 50R,C00,893771,Krone; Jarret,0,3,20,20
1745832934809,MCWP 50R,D00,893772,Miller; Elizabeth Deen,3,0,20,17
1745832934809,MCWP 50R,E00,893775,Carter; Andrea L,0,0,20,20
1745832935835,MMW 11R,A01,892721,Herbst; Matthew,11,0,27,16
1745832935835,MMW 11R,A02,892722,Herbst; Matthew,0,0,0,3
1745832936864,MMW 12R,A01,892724,Herbst; Matthew,0,10,16,16
1745832936864,MMW 12R,A02,892725,Herbst; Matthew,0,9,16,16
1745832937889,MMW 13R,A01,892727,Staff,0,3,16,16
1745832937889,MMW 13R,A02,892728,Staff,0,4,16,16
1745832937889,MMW 13R,A03,958032,Staff,0,3,16,16
1745832937889,MMW 13R,A04,958033,Staff,0,2,16,16
1745832937889,MMW 13R,A05,958034,Staff,0,3,16,16
1745832938917,SIO 295LS,A00,894015,Staff,7,0,25,18
1745832939945,SIO 295S,A00,894020,Staff,7,0,25,18
1745832940972,SIOC 290S,B01,958918,Staff,0,0,0,0
1745832941998,SIOC 291S,B01,958922,Staff,0,0,0,0
1745832943023,SOCI 117,A01,895339,Staff,4,0,5,1
1745832944052,WES 237B,A00,894149,Staff,11,0,20,9
1745832946113,AESE 279B,A00,891859,Staff,13,0,35,22
1745832947139,AIP 197,001,891854,Staff,70,0,70,0
1745832948164,ANTH 289S,A00,891856,Gagneux; Pascal,12,0,12,0
1745832949193,BENG 196,001,957946,Engler; Adam J.,9996,0,9999,3
1745832950218,CAT 124RS,A01,956906,Staff,8,0,25,17
1745832951243,CAT 125RS,A01,922013,Staff,8,0,25,17
1745832952268,CLRE 250,A00,891860,Morris; Sheldon,9995,0,9999,4
1745832954328,CLRE 251R,A00,907817,Mehta; Ravindra L.,9994,0,9999,5
1745832955354,CLRE 252,A00,891864,Cuomo; Raphael Eduardo,9993,0,9999,6
1745832956383,CLRE 253,A00,891867,Vaida; Florin,9994,0,9999,5
1745832956383,CLRE 253,B00,907819,Staff,9999,0,9999,0
1745832957408,CLRE 259,A00,891868,Patel; Hemal,9998,0,9999,1
1745832958435,CLRE 260,A00,891872,Cuomo; Raphael Eduardo,9999,0,9999,0
1745832959460,CLRE 297,001,891888,Cuomo; Raphael Eduardo,9999,0,9999,0
1745832960489,CSE 191,A00,958773,Minnes Kemp; Mor Mia,9999,0,9999,0
1745832961518,CSS 201S,A01,892054,Mignozzetti; Umberto,30,0,30,0
1745832962545,CSS 202S,A01,892056,Mignozzetti; Umberto,30,0,30,0
1745832963575,DSC 197,001,956898,Eldridge; Justin Matthew,9998,0,9999,1
1745832964601,DSC 297,001,958000,Mazumdar; Arya,9998,0,9999,1
1745832965628,EAP 100,A00,905686,Staff,9776,0,9999,223
1745832966653,ECE 45,A01,892618,Staff,0,13,50,50
1745832967679,ECE 109,A01,892620,Staff,0,43,0,0
1745832968706,ECE 111,A01,892719,Staff,0,9,50,50
1745832969735,ECE 197,001,957920,Mercier; Patrick Philip,9992,0,9999,7
1745832970762,ECON 178,A01,907814,Zhu; Ying,28,0,35,7
1745832971790,EDS 115,A00,895312,Staff,41,0,45,4
1745832972817,EDS 117,A01,895337,Staff,30,0,30,0
1745832973844,EDS 125,A00,895341,Jones; Gabrielle Anastasia,43,0,45,2
1745832974871,EDS 128A,A01,895459,Fargason; Sharon Gayle,44,0,45,1
1745832975900,EDS 128B,A01,895543,Pappas; Elizabeth,44,0,45,1
1745832976930,EDS 139,A00,897203,Pappas; Elizabeth,44,0,45,1
1745832976930,EDS 139,B00,897209,Fargason; Sharon Gayle,44,0,45,1
1745832977958,EDS 201,A00,895545,Staff,43,0,45,2
1745832979512,EDS 203,A01,895581,Halter; Christopher P.,43,0,45,2
1745832980542,EDS 204R,A01,895625,Heinzman; Erica M.,43,0,45,2
1745832980542,EDS 204R,B01,895693,Halter; Christopher P.,18,0,45,27
1745832981571,EDS 206R,A00,895694,Fargason; Sharon Gayle,9,0,30,21
1745832981571,EDS 206R,B00,895695,Choi; Bailey Miyeon,20,0,30,10
1745832982595,EDS 250,A00,895697,Hemans; Patricia Ann Benitez,43,0,45,2
1745832983625,EDS 281,A00,895701,Meyerott; Theresa Ann,15,0,15,0
1745832984652,EDS 284,A00,895736,Meyerott; Theresa Ann,15,0,15,0
1745832985679,EDS 286,A00,897210,Fine; Sarah,15,0,15,0
1745832986705,EDS 289C,A01,895770,Daly; Alan J.,15,0,15,0
1745832987732,EDS 290,A00,897211,Hofstetter; Carolyn,15,0,15,0
1745832988763,LIGM 5A,A00,896162,Fischer-Grunski; Eva K,15,0,20,5
1745832989795,LIGM 5B,A00,896260,Fischer-Grunski; Eva K,17,0,20,3
1745832990822,LIGM 5C,A00,896308,Fischer-Grunski; Eva K,18,0,20,2
1745832991852,LIIT 5AS,A00,896313,Carnelos; Chiara,17,0,20,3
1745832992878,LIIT 5BS,A00,896416,Carnelos; Chiara,20,0,20,0
1745832993905,LIIT 5CS,A00,896564,Carnelos; Chiara,20,0,20,0
1745832994934,LISP 5A,A00,896588,Munoz Sanchez; Alicia,4,0,20,16
1745832995961,LISP 5B,A00,896653,Munoz Sanchez; Alicia,10,0,20,10
1745832996992,LISP 5C,A00,896655,Munoz Sanchez; Alicia,4,0,20,16
1745832998024,MAE 197,001,957918,Kleissl; Jan,9998,0,9999,1
1745832999050,MATH 2,A01,957937,Staff,34,0,35,1
1745833000075,MATH 197,001,957876,Kedlaya; Kiran S.,9993,0,9999,6
1745833001105,MCWP 40,A00,892729,Duru; Nur,13,0,20,7
1745833001105,MCWP 40,B00,893304,Montejo; Carolina,20,0,20,0
1745833002133,MCWP 40R,A00,893757,Redela; Pamela Morgan,0,7,20,20
1745833003159,MCWP 50,A00,893758,Morshed; Michael James,2,0,20,18
1745833003159,MCWP 50,B00,893761,Bartulis; Jason Michael,18,0,20,2
1745833004191,MCWP 50R,A00,893766,Compas; Sean Matthew,0,1,20,20
1745833004191,MCWP 50R,B00,893769,Carter; Jennifer A,0,0,20,20
1745833004191,MCWP 50R,C00,893771,Krone; Jarret,0,3,20,20
1745833004191,MCWP 50R,D00,893772,Miller; Elizabeth Deen,3,0,20,17
1745833004191,MCWP 50R,E00,893775,Carter; Andrea L,0,0,20,20
1745833005221,MMW 11R,A01,892721,Herbst; Matthew,11,0,27,16
1745833005221,MMW 11R,A02,892722,Herbst; Matthew,0,0,0,3
1745833006247,MMW 12R,A01,892724,Herbst; Matthew,0,10,16,16
1745833006247,MMW 12R,A02,892725,Herbst; Matthew,0,9,16,16
1745833007276,MMW 13R,A01,892727,Staff,0,3,16,16
1745833007276,MMW 13R,A02,892728,Staff,0,4,16,16
1745833007276,MMW 13R,A03,958032,Staff,0,3,16,16
1745833007276,MMW 13R,A04,958033,Staff,0,2,16,16
1745833007276,MMW 13R,A05,958034,Staff,0,3,16,16
1745833008303,SIO 295LS,A00,894015,Staff,7,0,25,18
1745833009327,SIO 295S,A00,894020,Staff,7,0,25,18
1745833010355,SIOC 290S,B01,958918,Staff,0,0,0,0
1745833011382,SIOC 291S,B01,958922,Staff,0,0,0,0
1745833012407,SOCI 117,A01,895339,Staff,4,0,5,1
1745833013432,WES 237B,A00,894149,Staff,11,0,20,9
1745833015500,AESE 279B,A00,891859,Staff,13,0,35,22
1745833016527,AIP 197,001,891854,Staff,70,0,70,0
1745833017554,ANTH 289S,A00,891856,Gagneux; Pascal,12,0,12,0
1745833018578,BENG 196,001,957946,Engler; Adam J.,9996,0,9999,3
1745833019605,CAT 124RS,A01,956906,Staff,8,0,25,17
1745833020633,CAT 125RS,A01,922013,Staff,8,0,25,17
1745833021658,CLRE 250,A00,891860,Morris; Sheldon,9995,0,9999,4
1745833023715,CLRE 251R,A00,907817,Mehta; Ravindra L.,9994,0,9999,5
1745833024741,CLRE 252,A00,891864,Cuomo; Raphael Eduardo,9993,0,9999,6
1745833025766,CLRE 253,A00,891867,Vaida; Florin,9994,0,9999,5
1745833025766,CLRE 253,B00,907819,Staff,9999,0,9999,0
1745833026793,CLRE 259,A00,891868,Patel; Hemal,9998,0,9999,1
1745833027820,CLRE 260,A00,891872,Cuomo; Raphael Eduardo,9999,0,9999,0
1745833028846,CLRE 297,001,891888,Cuomo; Raphael Eduardo,9999,0,9999,0
1745833029875,CSE 191,A00,958773,Minnes Kemp; Mor Mia,9999,0,9999,0
1745833030902,CSS 201S,A01,892054,Mignozzetti; Umberto,30,0,30,0
1745833031928,CSS 202S,A01,892056,Mignozzetti; Umberto,30,0,30,0
1745833032956,DSC 197,001,956898,Eldridge; Justin Matthew,9998,0,9999,1
1745833033982,DSC 297,001,958000,Mazumdar; Arya,9998,0,9999,1
1745833035010,EAP 100,A00,905686,Staff,9776,0,9999,223
1745833036039,ECE 45,A01,892618,Staff,0,13,50,50
1745833037068,ECE 109,A01,892620,Staff,0,43,0,0
1745833038094,ECE 111,A01,892719,Staff,0,9,50,50
1745833039122,ECE 197,001,957920,Mercier; Patrick Philip,9992,0,9999,7
1745833040153,ECON 178,A01,907814,Zhu; Ying,28,0,35,7
1745833041179,EDS 115,A00,895312,Staff,41,0,45,4
1745833042209,EDS 117,A01,895337,Staff,30,0,30,0
1745833043234,EDS 125,A00,895341,Jones; Gabrielle Anastasia,43,0,45,2
1745833044259,EDS 128A,A01,895459,Fargason; Sharon Gayle,44,0,45,1
1745833045286,EDS 128B,A01,895543,Pappas; Elizabeth,44,0,45,1
1745833046315,EDS 139,A00,897203,Pappas; Elizabeth,44,0,45,1
1745833046315,EDS 139,B00,897209,Fargason; Sharon Gayle,44,0,45,1
1745833047346,EDS 201,A00,895545,Staff,43,0,45,2
1745833048371,EDS 203,A01,895581,Halter; Christopher P.,43,0,45,2
1745833049398,EDS 204R,A01,895625,Heinzman; Erica M.,43,0,45,2
1745833049398,EDS 204R,B01,895693,Halter; Christopher P.,18,0,45,27
1745833050424,EDS 206R,A00,895694,Fargason; Sharon Gayle,9,0,30,21
1745833050424,EDS 206R,B00,895695,Choi; Bailey Miyeon,20,0,30,10
1745833051451,EDS 250,A00,895697,Hemans; Patricia Ann Benitez,43,0,45,2
1745833052476,EDS 281,A00,895701,Meyerott; Theresa Ann,15,0,15,0
1745833053501,EDS 284,A00,895736,Meyerott; Theresa Ann,15,0,15,0
1745833054530,EDS 286,A00,897210,Fine; Sarah,15,0,15,0
1745833055557,EDS 289C,A01,895770,Daly; Alan J.,15,0,15,0
1745833056583,EDS 290,A00,897211,Hofstetter; Carolyn,15,0,15,0
1745833057607,LIGM 5A,A00,896162,Fischer-Grunski; Eva K,15,0,20,5
1745833058634,LIGM 5B,A00,896260,Fischer-Grunski; Eva K,17,0,20,3
1745833059659,LIGM 5C,A00,896308,Fischer-Grunski; Eva K,18,0,20,2
1745833060689,LIIT 5AS,A00,896313,Carnelos; Chiara,17,0,20,3
1745833061715,LIIT 5BS,A00,896416,Carnelos; Chiara,20,0,20,0
1745833062744,LIIT 5CS,A00,896564,Carnelos; Chiara,20,0,20,0
1745833063769,LISP 5A,A00,896588,Munoz Sanchez; Alicia,4,0,20,16
1745833064827,LISP 5B,A00,896653,Munoz Sanchez; Alicia,10,0,20,10
1745833065853,LISP 5C,A00,896655,Munoz Sanchez; Alicia,4,0,20,16
1745833066881,MAE 197,001,957918,Kleissl; Jan,9998,0,9999,1
1745833067907,MATH 2,A01,957937,Staff,34,0,35,1
1745833068933,MATH 197,001,957876,Kedlaya; Kiran S.,9993,0,9999,6
1745833069962,MCWP 40,A00,892729,Duru; Nur,13,0,20,7
1745833069962,MCWP 40,B00,893304,Montejo; Carolina,20,0,20,0
1745833070987,MCWP 40R,A00,893757,Redela; Pamela Morgan,0,7,20,20
1745833072012,MCWP 50,A00,893758,Morshed; Michael James,2,0,20,18
1745833072012,MCWP 50,B00,893761,Bartulis; Jason Michael,18,0,20,2
1745833073043,MCWP 50R,A00,893766,Compas; Sean Matthew,0,1,20,20
1745833073043,MCWP 50R,B00,893769,Carter; Jennifer A,0,0,20,20
1745833073043,MCWP 50R,C00,893771,Krone; Jarret,0,3,20,20
1745833073043,MCWP 50R,D00,893772,Miller; Elizabeth Deen,3,0,20,17
1745833073043,MCWP 50R,E00,893775,Carter; Andrea L,0,0,20,20
1745833074073,MMW 11R,A01,892721,Herbst; Matthew,11,0,27,16
1745833074073,MMW 11R,A02,892722,Herbst; Matthew,0,0,0,3
1745833075098,MMW 12R,A01,892724,Herbst; Matthew,0,10,16,16
1745833075098,MMW 12R,A02,892725,Herbst; Matthew,0,9,16,16
1745833076127,MMW 13R,A01,892727,Staff,0,3,16,16
1745833076127,MMW 13R,A02,892728,Staff,0,4,16,16
1745833076127,MMW 13R,A03,958032,Staff,0,3,16,16
1745833076127,MMW 13R,A04,958033,Staff,0,2,16,16
1745833076127,MMW 13R,A05,958034,Staff,0,3,16,16
1745833077154,SIO 295LS,A00,894015,Staff,7,0,25,18
1745833078178,SIO 295S,A00,894020,Staff,7,0,25,18
1745833079205,SIOC 290S,B01,958918,Staff,0,0,0,0
1745833080235,SIOC 291S,B01,958922,Staff,0,0,0,0
1745833081260,SOCI 117,A01,895339,Staff,4,0,5,1
1745833082286,WES 237B,A00,894149,Staff,11,0,20,9
1745833084348,AESE 279B,A00,891859,Staff,13,0,35,22
1745833085376,AIP 197,001,891854,Staff,70,0,70,0
1745833086402,ANTH 289S,A00,891856,Gagneux; Pascal,12,0,12,0
1745833087431,BENG 196,001,957946,Engler; Adam J.,9996,0,9999,3
1745833088457,CAT 124RS,A01,956906,Staff,8,0,25,17
1745833089482,CAT 125RS,A01,922013,Staff,8,0,25,17
1745833090511,CLRE 250,A00,891860,Morris; Sheldon,9995,0,9999,4
1745833092563,CLRE 251R,A00,907817,Mehta; Ravindra L.,9994,0,9999,5
1745833093647,CLRE 252,A00,891864,Cuomo; Raphael Eduardo,9993,0,9999,6
1745833094672,CLRE 253,A00,891867,Vaida; Florin,9994,0,9999,5
1745833094672,CLRE 253,B00,907819,Staff,9999,0,9999,0
1745833095700,CLRE 259,A00,891868,Patel; Hemal,9998,0,9999,1
1745833096723,CLRE 260,A00,891872,Cuomo; Raphael Eduardo,9999,0,9999,0
1745833097748,CLRE 297,001,891888,Cuomo; Raphael Eduardo,9999,0,9999,0
1745833098778,CSE 191,A00,958773,Minnes Kemp; Mor Mia,9999,0,9999,0
1745833099807,CSS 201S,A01,892054,Mignozzetti; Umberto,30,0,30,0
1745833100839,CSS 202S,A01,892056,Mignozzetti; Umberto,30,0,30,0
1745833101866,DSC 197,001,956898,Eldridge; Justin Matthew,9998,0,9999,1
1745833102897,DSC 297,001,958000,Mazumdar; Arya,9998,0,9999,1
1745833103921,EAP 100,A00,905686,Staff,9776,0,9999,223
1745833104949,ECE 45,A01,892618,Staff,0,13,50,50
1745833105975,ECE 109,A01,892620,Staff,0,43,0,0
1745833107004,ECE 111,A01,892719,Staff,0,9,50,50
1745833108033,ECE 197,001,957920,Mercier; Patrick Philip,9992,0,9999,7
1745833109060,ECON 178,A01,907814,Zhu; Ying,28,0,35,7
1745833110087,EDS 115,A00,895312,Staff,41,0,45,4
1745833111112,EDS 117,A01,895337,Staff,30,0,30,0
1745833112139,EDS 125,A00,895341,Jones; Gabrielle Anastasia,43,0,45,2
1745833113165,EDS 128A,A01,895459,Fargason; Sharon Gayle,44,0,45,1
1745833114191,EDS 128B,A01,895543,Pappas; Elizabeth,44,0,45,1
1745833115217,EDS 139,A00,897203,Pappas; Elizabeth,44,0,45,1
1745833115217,EDS 139,B00,897209,Fargason; Sharon Gayle,44,0,45,1
1745833116243,EDS 201,A00,895545,Staff,43,0,45,2
1745833117271,EDS 203,A01,895581,Halter; Christopher P.,43,0,45,2
1745833118301,EDS 204R,A01,895625,Heinzman; Erica M.,43,0,45,2
1745833118301,EDS 204R,B01,895693,Halter; Christopher P.,18,0,45,27
1745833119331,EDS 206R,A00,895694,Fargason; Sharon Gayle,9,0,30,21
1745833119331,EDS 206R,B00,895695,Choi; Bailey Miyeon,20,0,30,10
1745833120357,EDS 250,A00,895697,Hemans; Patricia Ann Benitez,43,0,45,2
1745833121383,EDS 281,A00,895701,Meyerott; Theresa Ann,15,0,15,0
1745833122409,EDS 284,A00,895736,Meyerott; Theresa Ann,15,0,15,0
1745833123435,EDS 286,A00,897210,Fine; Sarah,15,0,15,0
1745833124464,EDS 289C,A01,895770,Daly; Alan J.,15,0,15,0
1745833125491,EDS 290,A00,897211,Hofstetter; Carolyn,15,0,15,0
1745833126517,LIGM 5A,A00,896162,Fischer-Grunski; Eva K,15,0,20,5
1745833127544,LIGM 5B,A00,896260,Fischer-Grunski; Eva K,17,0,20,3
1745833128569,LIGM 5C,A00,896308,Fischer-Grunski; Eva K,18,0,20,2
1745833129593,LIIT 5AS,A00,896313,Carnelos; Chiara,17,0,20,3
1745833130620,LIIT 5BS,A00,896416,Carnelos; Chiara,20,0,20,0
1745833131647,LIIT 5CS,A00,896564,Carnelos; Chiara,20,0,20,0
1745833132676,LISP 5A,A00,896588,Munoz Sanchez; Alicia,4,0,20,16
1745833133701,LISP 5B,A00,896653,Munoz Sanchez; Alicia,10,0,20,10
1745833134727,LISP 5C,A00,896655,Munoz Sanchez; Alicia,4,0,20,16
1745833135756,MAE 197,001,957918,Kleissl; Jan,9998,0,9999,1
1745833136785,MATH 2,A01,957937,Staff,34,0,35,1
1745833137810,MATH 197,001,957876,Kedlaya; Kiran S.,9993,0,9999,6
1745833138841,MCWP 40,A00,892729,Duru; Nur,13,0,20,7
1745833138841,MCWP 40,B00,893304,Montejo; Carolina,20,0,20,0
1745833139871,MCWP 40R,A00,893757,Redela; Pamela Morgan,0,7,20,20
1745833140899,MCWP 50,A00,893758,Morshed; Michael James,2,0,20,18
1745833140899,MCWP 50,B00,893761,Bartulis; Jason Michael,18,0,20,2
1745833141937,MCWP 50R,A00,893766,Compas; Sean Matthew,0,1,20,20
1745833141937,MCWP 50R,B00,893769,Carter; Jennifer A,0,0,20,20
1745833141937,MCWP 50R,C00,893771,Krone; Jarret,0,3,20,20
1745833141937,MCWP 50R,D00,893772,Miller; Elizabeth Deen,3,0,20,17
1745833141937,MCWP 50R,E00,893775,Carter; Andrea L,0,0,20,20
1745833142966,MMW 11R,A01,892721,Herbst; Matthew,11,0,27,16
1745833142966,MMW 11R,A02,892722,Herbst; Matthew,0,0,0,3
1745833143993,MMW 12R,A01,892724,Herbst; Matthew,0,10,16,16
1745833143993,MMW 12R,A02,892725,Herbst; Matthew,0,9,16,16
1745833145020,MMW 13R,A01,892727,Staff,0,3,16,16
1745833145020,MMW 13R,A02,892728,Staff,0,4,16,16
1745833145020,MMW 13R,A03,958032,Staff,0,3,16,16
1745833145020,MMW 13R,A04,958033,Staff,0,2,16,16
1745833145020,MMW 13R,A05,958034,Staff,0,3,16,16
1745833146050,SIO 295LS,A00,894015,Staff,7,0,25,18
1745833147078,SIO 295S,A00,894020,Staff,7,0,25,18
1745833148108,SIOC 290S,B01,958918,Staff,0,0,0,0
1745833149138,SIOC 291S,B01,958922,Staff,0,0,0,0
1745833150169,SOCI 117,A01,895339,Staff,4,0,5,1
1745833151196,WES 237B,A00,894149,Staff,11,0,20,9
1745833153266,AESE 279B,A00,891859,Staff,13,0,35,22
1745833154294,AIP 197,001,891854,Staff,70,0,70,0
1745833155319,ANTH 289S,A00,891856,Gagneux; Pascal,12,0,12,0
1745833156347,BENG 196,001,957946,Engler; Adam J.,9996,0,9999,3
1745833157373,CAT 124RS,A01,956906,Staff,8,0,25,17
1745833158399,CAT 125RS,A01,922013,Staff,8,0,25,17
1745833159427,CLRE 250,A00,891860,Morris; Sheldon,9995,0,9999,4
1745833161480,CLRE 251R,A00,907817,Mehta; Ravindra L.,9994,0,9999,5
1745833162507,CLRE 252,A00,891864,Cuomo; Raphael Eduardo,9993,0,9999,6
1745833163534,CLRE 253,A00,891867,Vaida; Florin,9994,0,9999,5
1745833163534,CLRE 253,B00,907819,Staff,9999,0,9999,0
1745833164560,CLRE 259,A00,891868,Patel; Hemal,9998,0,9999,1
1745833165585,CLRE 260,A00,891872,Cuomo; Raphael Eduardo,9999,0,9999,0
1745833166611,CLRE 297,001,891888,Cuomo; Raphael Eduardo,9999,0,9999,0
1745833167637,CSE 191,A00,958773,Minnes Kemp; Mor Mia,9999,0,9999,0
1745833168663,CSS 201S,A01,892054,Mignozzetti; Umberto,30,0,30,0
1745833169690,CSS 202S,A01,892056,Mignozzetti; Umberto,30,0,30,0
1745833170720,DSC 197,001,956898,Eldridge; Justin Matthew,9998,0,9999,1
1745833171747,DSC 297,001,958000,Mazumdar; Arya,9998,0,9999,1
1745833172775,EAP 100,A00,905686,Staff,9776,0,9999,223
1745833173801,ECE 45,A01,892618,Staff,0,13,50,50
1745833174829,ECE 109,A01,892620,Staff,0,43,0,0
1745833175854,ECE 111,A01,892719,Staff,0,9,50,50
1745833176883,ECE 197,001,957920,Mercier; Patrick Philip,9992,0,9999,7
1745833177913,ECON 178,A01,907814,Zhu; Ying,28,0,35,7
1745833178941,EDS 115,A00,895312,Staff,41,0,45,4
1745833179967,EDS 117,A01,895337,Staff,30,0,30,0
1745833180996,EDS 125,A00,895341,Jones; Gabrielle Anastasia,43,0,45,2
1745833182023,EDS 128A,A01,895459,Fargason; Sharon Gayle,44,0,45,1
1745833183053,EDS 128B,A01,895543,Pappas; Elizabeth,44,0,45,1
1745833184080,EDS 139,A00,897203,Pappas; Elizabeth,44,0,45,1
1745833184080,EDS 139,B00,897209,Fargason; Sharon Gayle,44,0,45,1
1745833185110,EDS 201,A00,895545,Staff,43,0,45,2
1745833186140,EDS 203,A01,895581,Halter; Christopher P.,43,0,45,2
1745833187167,EDS 204R,A01,895625,Heinzman; Erica M.,43,0,45,2
1745833187167,EDS 204R,B01,895693,Halter; Christopher P.,18,0,45,27
1745833188198,EDS 206R,A00,895694,Fargason; Sharon Gayle,9,0,30,21
1745833188198,EDS 206R,B00,895695,Choi; Bailey Miyeon,20,0,30,10
1745833189226,EDS 250,A00,895697,Hemans; Patricia Ann Benitez,43,0,45,2
1745833190255,EDS 281,A00,895701,Meyerott; Theresa Ann,15,0,15,0
1745833191282,EDS 284,A00,895736,Meyerott; Theresa Ann,15,0,15,0
1745833192308,EDS 286,A00,897210,Fine; Sarah,15,0,15,0
1745833193334,EDS 289C,A01,895770,Daly; Alan J.,15,0,15,0
1745833194362,EDS 290,A00,897211,Hofstetter; Carolyn,15,0,15,0
1745833195387,LIGM 5A,A00,896162,Fischer-Grunski; Eva K,15,0,20,5
1745833196414,LIGM 5B,A00,896260,Fischer-Grunski; Eva K,17,0,20,3
1745833197478,LIGM 5C,A00,896308,Fischer-Grunski; Eva K,18,0,20,2
1745833198504,LIIT 5AS,A00,896313,Carnelos; Chiara,17,0,20,3
1745833199534,LIIT 5BS,A00,896416,Carnelos; Chiara,20,0,20,0
1745833200560,LIIT 5CS,A00,896564,Carnelos; Chiara,20,0,20,0
1745833201589,LISP 5A,A00,896588,Munoz Sanchez; Alicia,4,0,20,16
1745833202620,LISP 5B,A00,896653,Munoz Sanchez; Alicia,10,0,20,10
1745833203646,LISP 5C,A00,896655,Munoz Sanchez; Alicia,4,0,20,16
1745833204676,MAE 197,001,957918,Kleissl; Jan,9998,0,9999,1
1745833205701,MATH 2,A01,957937,Staff,34,0,35,1
1745833206728,MATH 197,001,957876,Kedlaya; Kiran S.,9993,0,9999,6
1745833207752,MCWP 40,A00,892729,Duru; Nur,13,0,20,7
1745833207752,MCWP 40,B00,893304,Montejo; Carolina,20,0,20,0
1745833208779,MCWP 40R,A00,893757,Redela; Pamela Morgan,0,7,20,20
1745833209805,MCWP 50,A00,893758,Morshed; Michael James,2,0,20,18
1745833209805,MCWP 50,B00,893761,Bartulis; Jason Michael,18,0,20,2
1745833210834,MCWP 50R,A00,893766,Compas; Sean Matthew,0,1,20,20
1745833210834,MCWP 50R,B00,893769,Carter; Jennifer A,0,0,20,20
1745833210834,MCWP 50R,C00,893771,Krone; Jarret,0,3,20,20
1745833210834,MCWP 50R,D00,893772,Miller; Elizabeth Deen,3,0,20,17
1745833210834,MCWP 50R,E00,893775,Carter; Andrea L,0,0,20,20
1745833211862,MMW 11R,A01,892721,Herbst; Matthew,11,0,27,16
1745833211862,MMW 11R,A02,892722,Herbst; Matthew,0,0,0,3
1745833212890,MMW 12R,A01,892724,Herbst; Matthew,0,10,16,16
1745833212890,MMW 12R,A02,892725,Herbst; Matthew,0,9,16,16
1745833213916,MMW 13R,A01,892727,Staff,0,3,16,16
1745833213916,MMW 13R,A02,892728,Staff,0,4,16,16
1745833213916,MMW 13R,A03,958032,Staff,0,3,16,16
1745833213916,MMW 13R,A04,958033,Staff,0,2,16,16
1745833213916,MMW 13R,A05,958034,Staff,0,3,16,16
1745833214965,SIO 295LS,A00,894015,Staff,7,0,25,18
1745833215991,SIO 295S,A00,894020,Staff,7,0,25,18
1745833217016,SIOC 290S,B01,958918,Staff,0,0,0,0
1745833218043,SIOC 291S,B01,958922,Staff,0,0,0,0
1745833219069,SOCI 117,A01,895339,Staff,4,0,5,1
1745833220096,WES 237B,A00,894149,Staff,11,0,20,9
1745833222165,AESE 279B,A00,891859,Staff,13,0,35,22
1745833223190,AIP 197,001,891854,Staff,70,0,70,0
1745833224216,ANTH 289S,A00,891856,Gagneux; Pascal,12,0,12,0
1745833225241,BENG 196,001,957946,Engler; Adam J.,9996,0,9999,3
1745833226269,CAT 124RS,A01,956906,Staff,8,0,25,17
1745833227294,CAT 125RS,A01,922013,Staff,8,0,25,17
1745833228323,CLRE 250,A00,891860,Morris; Sheldon,9995,0,9999,4
1745833230379,CLRE 251R,A00,907817,Mehta; Ravindra L.,9994,0,9999,5
1745833231408,CLRE 252,A00,891864,Cuomo; Raphael Eduardo,9993,0,9999,6
1745833232435,CLRE 253,A00,891867,Vaida; Florin,9994,0,9999,5
1745833232435,CLRE 253,B00,907819,Staff,9999,0,9999,0
1745833233462,CLRE 259,A00,891868,Patel; Hemal,9998,0,9999,1
1745833234491,CLRE 260,A00,891872,Cuomo; Raphael Eduardo,9999,0,9999,0
1745833235520,CLRE 297,001,891888,Cuomo; Raphael Eduardo,9999,0,9999,0
1745833236547,CSE 191,A00,958773,Minnes Kemp; Mor Mia,9999,0,9999,0
1745833237577,CSS 201S,A01,892054,Mignozzetti; Umberto,30,0,30,0
1745833238607,CSS 202S,A01,892056,Mignozzetti; Umberto,30,0,30,0
1745833239635,DSC 197,001,956898,Eldridge; Justin Matthew,9998,0,9999,1
1745833240664,DSC 297,001,958000,Mazumdar; Arya,9998,0,9999,1
1745833241693,EAP 100,A00,905686,Staff,9776,0,9999,223
1745833242722,ECE 45,A01,892618,Staff,0,13,50,50
1745833243749,ECE 109,A01,892620,Staff,0,43,0,0
1745833244779,ECE 111,A01,892719,Staff,0,9,50,50
1745833245805,ECE 197,001,957920,Mercier; Patrick Philip,9992,0,9999,7
1745833246831,ECON 178,A01,907814,Zhu; Ying,28,0,35,7
1745833247857,EDS 115,A00,895312,Staff,41,0,45,4
1745833248883,EDS 117,A01,895337,Staff,30,0,30,0
1745833249909,EDS 125,A00,895341,Jones; Gabrielle Anastasia,43,0,45,2
1745833250935,EDS 128A,A01,895459,Fargason; Sharon Gayle,44,0,45,1
1745833251961,EDS 128B,A01,895543,Pappas; Elizabeth,44,0,45,1
1745833252987,EDS 139,A00,897203,Pappas; Elizabeth,44,0,45,1
1745833252987,EDS 139,B00,897209,Fargason; Sharon Gayle,44,0,45,1
1745833254013,EDS 201,A00,895545,Staff,43,0,45,2
1745833255039,EDS 203,A01,895581,Halter; Christopher P.,43,0,45,2
1745833256065,EDS 204R,A01,895625,Heinzman; Erica M.,43,0,45,2
1745833256065,EDS 204R,B01,895693,Halter; Christopher P.,18,0,45,27
1745833257093,EDS 206R,A00,895694,Fargason; Sharon Gayle,9,0,30,21
1745833257093,EDS 206R,B00,895695,Choi; Bailey Miyeon,20,0,30,10
1745833258122,EDS 250,A00,895697,Hemans; Patricia Ann Benitez,43,0,45,2
1745833259148,EDS 281,A00,895701,Meyerott; Theresa Ann,15,0,15,0
1745833260176,EDS 284,A00,895736,Meyerott; Theresa Ann,15,0,15,0
1745833261201,EDS 286,A00,897210,Fine; Sarah,15,0,15,0
1745833262227,EDS 289C,A01,895770,Daly; Alan J.,15,0,15,0
1745833263255,EDS 290,A00,897211,Hofstetter; Carolyn,15,0,15,0
1745833264285,LIGM 5A,A00,896162,Fischer-Grunski; Eva K,15,0,20,5
1745833265316,LIGM 5B,A00,896260,Fischer-Grunski; Eva K,17,0,20,3
1745833266346,LIGM 5C,A00,896308,Fischer-Grunski; Eva K,18,0,20,2
1745833267371,LIIT 5AS,A00,896313,Carnelos; Chiara,17,0,20,3
1745833268396,LIIT 5BS,A00,896416,Carnelos; Chiara,20,0,20,0
1745833269423,LIIT 5CS,A00,896564,Carnelos; Chiara,20,0,20,0
1745833270452,LISP 5A,A00,896588,Munoz Sanchez; Alicia,4,0,20,16
1745833271483,LISP 5B,A00,896653,Munoz Sanchez; Alicia,10,0,20,10
1745833272511,LISP 5C,A00,896655,Munoz Sanchez; Alicia,4,0,20,16
1745833273540,MAE 197,001,957918,Kleissl; Jan,9998,0,9999,1
1745833274568,MATH 2,A01,957937,Staff,34,0,35,1
1745833275593,MATH 197,001,957876,Kedlaya; Kiran S.,9993,0,9999,6
1745833276623,MCWP 40,A00,892729,Duru; Nur,13,0,20,7
1745833276623,MCWP 40,B00,893304,Montejo; Carolina,20,0,20,0
1745833277648,MCWP 40R,A00,893757,Redela; Pamela Morgan,0,7,20,20
1745833278675,MCWP 50,A00,893758,Morshed; Michael James,2,0,20,18
1745833278675,MCWP 50,B00,893761,Bartulis; Jason Michael,18,0,20,2
1745833279701,MCWP 50R,A00,893766,Compas; Sean Matthew,0,1,20,20
1745833279701,MCWP 50R,B00,893769,Carter; Jennifer A,0,0,20,20
1745833279701,MCWP 50R,C00,893771,Krone; Jarret,0,3,20,20
1745833279701,MCWP 50R,D00,893772,Miller; Elizabeth Deen,3,0,20,17
1745833279701,MCWP 50R,E00,893775,Carter; Andrea L,0,0,20,20
1745833280732,MMW 11R,A01,892721,Herbst; Matthew,11,0,27,16
1745833280732,MMW 11R,A02,892722,Herbst; Matthew,0,0,0,3
1745833281757,MMW 12R,A01,892724,Herbst; Matthew,0,10,16,16
1745833281757,MMW 12R,A02,892725,Herbst; Matthew,0,9,16,16
1745833282783,MMW 13R,A01,892727,Staff,0,3,16,16
1745833282783,MMW 13R,A02,892728,Staff,0,4,16,16
1745833282783,MMW 13R,A03,958032,Staff,0,3,16,16
1745833282783,MMW 13R,A04,958033,Staff,0,2,16,16
1745833282783,MMW 13R,A05,958034,Staff,0,3,16,16
1745833283808,SIO 295LS,A00,894015,Staff,7,0,25,18
1745833284834,SIO 295S,A00,894020,Staff,7,0,25,18
1745833285862,SIOC 290S,B01,958918,Staff,0,0,0,0
1745833286886,SIOC 291S,B01,958922,Staff,0,0,0,0
1745833287913,SOCI 117,A01,895339,Staff,4,0,5,1
1745833288942,WES 237B,A00,894149,Staff,11,0,20,9
1745833291007,AESE 279B,A00,891859,Staff,13,0,35,22
1745833292032,AIP 197,001,891854,Staff,70,0,70,0
1745833293056,ANTH 289S,A00,891856,Gagneux; Pascal,12,0,12,0
1745833294082,BENG 196,001,957946,Engler; Adam J.,9996,0,9999,3
1745833295107,CAT 124RS,A01,956906,Staff,8,0,25,17
1745833296149,CAT 125RS,A01,922013,Staff,8,0,25,17
1745833297175,CLRE 250,A00,891860,Morris; Sheldon,9995,0,9999,4
1745833299226,CLRE 251R,A00,907817,Mehta; Ravindra L.,9994,0,9999,5
1745833300255,CLRE 252,A00,891864,Cuomo; Raphael Eduardo,9993,0,9999,6
1745833301280,CLRE 253,A00,891867,Vaida; Florin,9994,0,9999,5
1745833301280,CLRE 253,B00,907819,Staff,9999,0,9999,0
1745833302304,CLRE 259,A00,891868,Patel; Hemal,9998,0,9999,1
1745833303333,CLRE 260,A00,891872,Cuomo; Raphael Eduardo,9999,0,9999,0
1745833304361,CLRE 297,001,891888,Cuomo; Raphael Eduardo,9999,0,9999,0
1745833305401,CSE 191,A00,958773,Minnes Kemp; Mor Mia,9999,0,9999,0
1745833306429,CSS 201S,A01,892054,Mignozzetti; Umberto,30,0,30,0
1745833307456,CSS 202S,A01,892056,Mignozzetti; Umberto,30,0,30,0
1745833308482,DSC 197,001,956898,Eldridge; Justin Matthew,9998,0,9999,1
1745833309509,DSC 297,001,958000,Mazumdar; Arya,9998,0,9999,1
1745833310535,EAP 100,A00,905686,Staff,9776,0,9999,223
1745833311566,ECE 45,A01,892618,Staff,0,13,50,50
1745833312595,ECE 109,A01,892620,Staff,0,43,0,0
1745833313621,ECE 111,A01,892719,Staff,0,9,50,50
1745833314647,ECE 197,001,957920,Mercier; Patrick Philip,9992,0,9999,7
1745833315674,ECON 178,A01,907814,Zhu; Ying,28,0,35,7
1745833316702,EDS 115,A00,895312,Staff,41,0,45,4
1745833317726,EDS 117,A01,895337,Staff,30,0,30,0
1745833318756,EDS 125,A00,895341,Jones; Gabrielle Anastasia,43,0,45,2
1745833319785,EDS 128A,A01,895459,Fargason; Sharon Gayle,44,0,45,1
1745833320813,EDS 128B,A01,895543,Pappas; Elizabeth,44,0,45,1
1745833321839,EDS 139,A00,897203,Pappas; Elizabeth,44,0,45,1
1745833321839,EDS 139,B00,897209,Fargason; Sharon Gayle,44,0,45,1
1745833322869,EDS 201,A00,895545,Staff,43,0,45,2
1745833323895,EDS 203,A01,895581,Halter; Christopher P.,43,0,45,2
1745833324923,EDS 204R,A01,895625,Heinzman; Erica M.,43,0,45,2
1745833324923,EDS 204R,B01,895693,Halter; Christopher P.,18,0,45,27
1745833325953,EDS 206R,A00,895694,Fargason; Sharon Gayle,9,0,30,21
1745833325953,EDS 206R,B00,895695,Choi; Bailey Miyeon,20,0,30,10
1745833326983,EDS 250,A00,895697,Hemans; Patricia Ann Benitez,43,0,45,2
1745833328010,EDS 281,A00,895701,Meyerott; Theresa Ann,15,0,15,0
1745833329035,EDS 284,A00,895736,Meyerott; Theresa Ann,15,0,15,0
1745833330060,EDS 286,A00,897210,Fine; Sarah,15,0,15,0
1745833331088,EDS 289C,A01,895770,Daly; Alan J.,15,0,15,0
1745833332112,EDS 290,A00,897211,Hofstetter; Carolyn,15,0,15,0
1745833333140,LIGM 5A,A00,896162,Fischer-Grunski; Eva K,15,0,20,5
1745833334168,LIGM 5B,A00,896260,Fischer-Grunski; Eva K,17,0,20,3
1745833335193,LIGM 5C,A00,896308,Fischer-Grunski; Eva K,18,0,20,2
1745833336218,LIIT 5AS,A00,896313,Carnelos; Chiara,17,0,20,3
1745833337241,LIIT 5BS,A00,896416,Carnelos; Chiara,20,0,20,0
1745833338270,LIIT 5CS,A00,896564,Carnelos; Chiara,20,0,20,0
1745833339293,LISP 5A,A00,896588,Munoz Sanchez; Alicia,4,0,20,16
1745833340318,LISP 5B,A00,896653,Munoz Sanchez; Alicia,10,0,20,10
1745833341347,LISP 5C,A00,896655,Munoz Sanchez; Alicia,4,0,20,16
1745833342372,MAE 197,001,957918,Kleissl; Jan,9998,0,9999,1
1745833343398,MATH 2,A01,957937,Staff,34,0,35,1
1745833344428,MATH 197,001,957876,Kedlaya; Kiran S.,9993,0,9999,6
1745833345456,MCWP 40,A00,892729,Duru; Nur,13,0,20,7
1745833345456,MCWP 40,B00,893304,Montejo; Carolina,20,0,20,0
1745833346481,MCWP 40R,A00,893757,Redela; Pamela Morgan,0,7,20,20
1745833347508,MCWP 50,A00,893758,Morshed; Michael James,2,0,20,18
1745833347508,MCWP 50,B00,893761,Bartulis; Jason Michael,18,0,20,2
1745833348533,MCWP 50R,A00,893766,Compas; Sean Matthew,0,1,20,20
1745833348533,MCWP 50R,B00,893769,Carter; Jennifer A,0,0,20,20
1745833348533,MCWP 50R,C00,893771,Krone; Jarret,0,3,20,20
1745833348533,MCWP 50R,D00,893772,Miller; Elizabeth Deen,3,0,20,17
1745833348533,MCWP 50R,E00,893775,Carter; Andrea L,0,0,20,20
1745833349558,MMW 11R,A01,892721,Herbst; Matthew,11,0,27,16
1745833349558,MMW 11R,A02,892722,Herbst; Matthew,0,0,0,3
1745833350585,MMW 12R,A01,892724,Herbst; Matthew,0,10,16,16
1745833350585,MMW 12R,A02,892725,Herbst; Matthew,0,9,16,16
1745833351610,MMW 13R,A01,892727,Staff,0,3,16,16
1745833351610,MMW 13R,A02,892728,Staff,0,4,16,16
1745833351610,MMW 13R,A03,958032,Staff,0,3,16,16
1745833351610,MMW 13R,A04,958033,Staff,0,2,16,16
1745833351610,MMW 13R,A05,958034,Staff,0,3,16,16
1745833352635,SIO 295LS,A00,894015,Staff,7,0,25,18
1745833353664,SIO 295S,A00,894020,Staff,7,0,25,18
1745833354688,SIOC 290S,B01,958918,Staff,0,0,0,0
1745833355716,SIOC 291S,B01,958922,Staff,0,0,0,0
1745833356741,SOCI 117,A01,895339,Staff,4,0,5,1
1745833357767,WES 237B,A00,894149,Staff,11,0,20,9
1745833359831,AESE 279B,A00,891859,Staff,13,0,35,22
1745833360855,AIP 197,001,891854,Staff,70,0,70,0
1745833361883,ANTH 289S,A00,891856,Gagneux; Pascal,12,0,12,0
1745833362910,BENG 196,001,957946,Engler; Adam J.,9996,0,9999,3
1745833363936,CAT 124RS,A01,956906,Staff,8,0,25,17
1745833364960,CAT 125RS,A01,922013,Staff,8,0,25,17
1745833365989,CLRE 250,A00,891860,Morris; Sheldon,9995,0,9999,4
1745833368038,CLRE 251R,A00,907817,Mehta; Ravindra L.,9994,0,9999,5
1745833369067,CLRE 252,A00,891864,Cuomo; Raphael Eduardo,9993,0,9999,6
1745833370093,CLRE 253,A00,891867,Vaida; Florin,9994,0,9999,5
1745833370093,CLRE 253,B00,907819,Staff,9999,0,9999,0
1745833371120,CLRE 259,A00,891868,Patel; Hemal,9998,0,9999,1
1745833372148,CLRE 260,A00,891872,Cuomo; Raphael Eduardo,9999,0,9999,0
1745833373174,CLRE 297,001,891888,Cuomo; Raphael Eduardo,9999,0,9999,0
1745833374202,CSE 191,A00,958773,Minnes Kemp; Mor Mia,9999,0,9999,0
1745833375232,CSS 201S,A01,892054,Mignozzetti; Umberto,30,0,30,0
1745833376259,CSS 202S,A01,892056,Mignozzetti; Umberto,30,0,30,0
1745833377288,DSC 197,001,956898,Eldridge; Justin Matthew,9998,0,9999,1
1745833378316,DSC 297,001,958000,Mazumdar; Arya,9998,0,9999,1
1745833379341,EAP 100,A00,905686,Staff,9776,0,9999,223
1745833380368,ECE 45,A01,892618,Staff,0,13,50,50
1745833381397,ECE 109,A01,892620,Staff,0,43,0,0
1745833382423,ECE 111,A01,892719,Staff,0,9,50,50
1745833383451,ECE 197,001,957920,Mercier; Patrick Philip,9992,0,9999,7
1745833384481,ECON 178,A01,907814,Zhu; Ying,28,0,35,7
1745833385507,EDS 115,A00,895312,Staff,41,0,45,4
1745833386536,EDS 117,A01,895337,Staff,30,0,30,0
1745833387564,EDS 125,A00,895341,Jones; Gabrielle Anastasia,43,0,45,2
1745833388591,EDS 128A,A01,895459,Fargason; Sharon Gayle,44,0,45,1
1745833389620,EDS 128B,A01,895543,Pappas; Elizabeth,44,0,45,1
1745833390645,EDS 139,A00,897203,Pappas; Elizabeth,44,0,45,1
1745833390645,EDS 139,B00,897209,Fargason; Sharon Gayle,44,0,45,1
1745833391669,EDS 201,A00,895545,Staff,43,0,45,2
1745833392695,EDS 203,A01,895581,Halter; Christopher P.,43,0,45,2
1745833393722,EDS 204R,A01,895625,Heinzman; Erica M.,43,0,45,2
1745833393722,EDS 204R,B01,895693,Halter; Christopher P.,18,0,45,27
1745833394750,EDS 206R,A00,895694,Fargason; Sharon Gayle,9,0,30,21
1745833394750,EDS 206R,B00,895695,Choi; Bailey Miyeon,20,0,30,10
1745833395775,EDS 250,A00,895697,Hemans; Patricia Ann Benitez,43,0,45,2
1745833396799,EDS 281,A00,895701,Meyerott; Theresa Ann,15,0,15,0
1745833397827,EDS 284,A00,895736,Meyerott; Theresa Ann,15,0,15,0
1745833398853,EDS 286,A00,897210,Fine; Sarah,15,0,15,0
1745833399878,EDS 289C,A01,895770,Daly; Alan J.,15,0,15,0
1745833400904,EDS 290,A00,897211,Hofstetter; Carolyn,15,0,15,0
1745833401933,LIGM 5A,A00,896162,Fischer-Grunski; Eva K,15,0,20,5
1745833402961,LIGM 5B,A00,896260,Fischer-Grunski; Eva K,17,0,20,3
1745833403992,LIGM 5C,A00,896308,Fischer-Grunski; Eva K,18,0,20,2
1745833405023,LIIT 5AS,A00,896313,Carnelos; Chiara,17,0,20,3
1745833406050,LIIT 5BS,A00,896416,Carnelos; Chiara,20,0,20,0
1745833407080,LIIT 5CS,A00,896564,Carnelos; Chiara,20,0,20,0
1745833408109,LISP 5A,A00,896588,Munoz Sanchez; Alicia,4,0,20,16
1745833409138,LISP 5B,A00,896653,Munoz Sanchez; Alicia,10,0,20,10
1745833410165,LISP 5C,A00,896655,Munoz Sanchez; Alicia,4,0,20,16
1745833411191,MAE 197,001,957918,Kleissl; Jan,9998,0,9999,1
1745833412219,MATH 2,A01,957937,Staff,34,0,35,1
1745833413245,MATH 197,001,957876,Kedlaya; Kiran S.,9993,0,9999,6
1745833414270,MCWP 40,A00,892729,Duru; Nur,13,0,20,7
1745833414270,MCWP 40,B00,893304,Montejo; Carolina,20,0,20,0
1745833415299,MCWP 40R,A00,893757,Redela; Pamela Morgan,0,7,20,20
1745833416324,MCWP 50,A00,893758,Morshed; Michael James,2,0,20,18
1745833416324,MCWP 50,B00,893761,Bartulis; Jason Michael,18,0,20,2
1745833417351,MCWP 50R,A00,893766,Compas; Sean Matthew,0,1,20,20
1745833417351,MCWP 50R,B00,893769,Carter; Jennifer A,0,0,20,20
1745833417351,MCWP 50R,C00,893771,Krone; Jarret,0,3,20,20
1745833417351,MCWP 50R,D00,893772,Miller; Elizabeth Deen,3,0,20,17
1745833417351,MCWP 50R,E00,893775,Carter; Andrea L,0,0,20,20
1745833418375,MMW 11R,A01,892721,Herbst; Matthew,11,0,27,16
1745833418375,MMW 11R,A02,892722,Herbst; Matthew,0,0,0,3
1745833419403,MMW 12R,A01,892724,Herbst; Matthew,0,10,16,16
1745833419403,MMW 12R,A02,892725,Herbst; Matthew,0,9,16,16
1745833420433,MMW 13R,A01,892727,Staff,0,3,16,16
1745833420433,MMW 13R,A02,892728,Staff,0,4,16,16
1745833420433,MMW 13R,A03,958032,Staff,0,3,16,16
1745833420433,MMW 13R,A04,958033,Staff,0,2,16,16
1745833420433,MMW 13R,A05,958034,Staff,0,3,16,16
1745833421461,SIO 295LS,A00,894015,Staff,7,0,25,18
1745833422486,SIO 295S,A00,894020,Staff,7,0,25,18
1745833423515,SIOC 290S,B01,958918,Staff,0,0,0,0
1745833424544,SIOC 291S,B01,958922,Staff,0,0,0,0
1745833425569,SOCI 117,A01,895339,Staff,4,0,5,1
1745833426596,WES 237B,A00,894149,Staff,11,0,20,9
1745833428666,AESE 279B,A00,891859,Staff,13,0,35,22
1745833429691,AIP 197,001,891854,Staff,70,0,70,0
1745833430720,ANTH 289S,A00,891856,Gagneux; Pascal,12,0,12,0
1745833431750,BENG 196,001,957946,Engler; Adam J.,9996,0,9999,3
1745833432776,CAT 124RS,A01,956906,Staff,8,0,25,17
1745833433805,CAT 125RS,A01,922013,Staff,8,0,25,17
1745833434835,CLRE 250,A00,891860,Morris; Sheldon,9995,0,9999,4
1745833436890,CLRE 251R,A00,907817,Mehta; Ravindra L.,9994,0,9999,5
1745833437914,CLRE 252,A00,891864,Cuomo; Raphael Eduardo,9993,0,9999,6
1745833438942,CLRE 253,A00,891867,Vaida; Florin,9994,0,9999,5
1745833438942,CLRE 253,B00,907819,Staff,9999,0,9999,0
1745833439970,CLRE 259,A00,891868,Patel; Hemal,9998,0,9999,1
1745833440995,CLRE 260,A00,891872,Cuomo; Raphael Eduardo,9999,0,9999,0
1745833442021,CLRE 297,001,891888,Cuomo; Raphael Eduardo,9999,0,9999,0
1745833443052,CSE 191,A00,958773,Minnes Kemp; Mor Mia,9999,0,9999,0
1745833444078,CSS 201S,A01,892054,Mignozzetti; Umberto,30,0,30,0
1745833445105,CSS 202S,A01,892056,Mignozzetti; Umberto,30,0,30,0
1745833446132,DSC 197,001,956898,Eldridge; Justin Matthew,9998,0,9999,1
1745833447161,DSC 297,001,958000,Mazumdar; Arya,9998,0,9999,1
1745833448189,EAP 100,A00,905686,Staff,9776,0,9999,223
1745833449216,ECE 45,A01,892618,Staff,0,13,50,50
1745833450242,ECE 109,A01,892620,Staff,0,43,0,0
1745833451271,ECE 111,A01,892719,Staff,0,9,50,50
1745833452301,ECE 197,001,957920,Mercier; Patrick Philip,9992,0,9999,7
1745833453330,ECON 178,A01,907814,Zhu; Ying,28,0,35,7
1745833454358,EDS 115,A00,895312,Staff,41,0,45,4
1745833455386,EDS 117,A01,895337,Staff,30,0,30,0
1745833456413,EDS 125,A00,895341,Jones; Gabrielle Anastasia,43,0,45,2
1745833457440,EDS 128A,A01,895459,Fargason; Sharon Gayle,44,0,45,1
1745833458467,EDS 128B,A01,895543,Pappas; Elizabeth,44,0,45,1
1745833459495,EDS 139,A00,897203,Pappas; Elizabeth,44,0,45,1
1745833459495,EDS 139,B00,897209,Fargason; Sharon Gayle,44,0,45,1
1745833460521,EDS 201,A00,895545,Staff,43,0,45,2
1745833461547,EDS 203,A01,895581,Halter; Christopher P.,43,0,45,2
1745833462575,EDS 204R,A01,895625,Heinzman; Erica M.,43,0,45,2
1745833462575,EDS 204R,B01,895693,Halter; Christopher P.,18,0,45,27
1745833463602,EDS 206R,A00,895694,Fargason; Sharon Gayle,9,0,30,21
1745833463602,EDS 206R,B00,895695,Choi; Bailey Miyeon,20,0,30,10
1745833464838,EDS 250,A00,895697,Hemans; Patricia Ann Benitez,43,0,45,2
1745833465863,EDS 281,A00,895701,Meyerott; Theresa Ann,15,0,15,0
1745833466892,EDS 284,A00,895736,Meyerott; Theresa Ann,15,0,15,0
1745833467921,EDS 286,A00,897210,Fine; Sarah,15,0,15,0
1745833468950,EDS 289C,A01,895770,Daly; Alan J.,15,0,15,0
1745833469977,EDS 290,A00,897211,Hofstetter; Carolyn,15,0,15,0
1745833471007,LIGM 5A,A00,896162,Fischer-Grunski; Eva K,15,0,20,5
1745833472034,LIGM 5B,A00,896260,Fischer-Grunski; Eva K,17,0,20,3
1745833473062,LIGM 5C,A00,896308,Fischer-Grunski; Eva K,18,0,20,2
1745833474089,LIIT 5AS,A00,896313,Carnelos; Chiara,17,0,20,3
1745833475117,LIIT 5BS,A00,896416,Carnelos; Chiara,20,0,20,0
1745833476147,LIIT 5CS,A00,896564,Carnelos; Chiara,20,0,20,0
1745833477176,LISP 5A,A00,896588,Munoz Sanchez; Alicia,4,0,20,16
1745833478203,LISP 5B,A00,896653,Munoz Sanchez; Alicia,10,0,20,10
1745833479228,LISP 5C,A00,896655,Munoz Sanchez; Alicia,4,0,20,16
1745833480254,MAE 197,001,957918,Kleissl; Jan,9998,0,9999,1
1745833481282,MATH 2,A01,957937,Staff,34,0,35,1
1745833482308,MATH 197,001,957876,Kedlaya; Kiran S.,9993,0,9999,6
1745833483334,MCWP 40,A00,892729,Duru; Nur,13,0,20,7
1745833483334,MCWP 40,B00,893304,Montejo; Carolina,20,0,20,0
1745833484360,MCWP 40R,A00,893757,Redela; Pamela Morgan,0,7,20,20
1745833485389,MCWP 50,A00,893758,Morshed; Michael James,2,0,20,18
1745833485389,MCWP 50,B00,893761,Bartulis; Jason Michael,18,0,20,2
1745833486415,MCWP 50R,A00,893766,Compas; Sean Matthew,0,1,20,20
1745833486415,MCWP 50R,B00,893769,Carter; Jennifer A,0,0,20,20
1745833486415,MCWP 50R,C00,893771,Krone; Jarret,0,3,20,20
1745833486415,MCWP 50R,D00,893772,Miller; Elizabeth Deen,3,0,20,17
1745833486415,MCWP 50R,E00,893775,Carter; Andrea L,0,0,20,20
1745833487443,MMW 11R,A01,892721,Herbst; Matthew,11,0,27,16
1745833487443,MMW 11R,A02,892722,Herbst; Matthew,0,0,0,3
1745833488473,MMW 12R,A01,892724,Herbst; Matthew,0,10,16,16
1745833488473,MMW 12R,A02,892725,Herbst; Matthew,0,9,16,16
1745833489501,MMW 13R,A01,892727,Staff,0,3,16,16
1745833489501,MMW 13R,A02,892728,Staff,0,4,16,16
1745833489501,MMW 13R,A03,958032,Staff,0,3,16,16
1745833489501,MMW 13R,A04,958033,Staff,0,2,16,16
1745833489501,MMW 13R,A05,958034,Staff,0,3,16,16
1745833490530,SIO 295LS,A00,894015,Staff,7,0,25,18
1745833491558,SIO 295S,A00,894020,Staff,7,0,25,18
1745833492586,SIOC 290S,B01,958918,Staff,0,0,0,0
1745833493613,SIOC 291S,B01,958922,Staff,0,0,0,0
1745833494639,SOCI 117,A01,895339,Staff,4,0,5,1
1745833495664,WES 237B,A00,894149,Staff,11,0,20,9
1745833497750,AESE 279B,A00,891859,Staff,13,0,35,22
1745833498779,AIP 197,001,891854,Staff,70,0,70,0
1745833499804,ANTH 289S,A00,891856,Gagneux; Pascal,12,0,12,0
1745833500832,BENG 196,001,957946,Engler; Adam J.,9996,0,9999,3
1745833501858,CAT 124RS,A01,956906,Staff,8,0,25,17
1745833502883,CAT 125RS,A01,922013,Staff,8,0,25,17
1745833503909,CLRE 250,A00,891860,Morris; Sheldon,9995,0,9999,4
1745833505960,CLRE 251R,A00,907817,Mehta; Ravindra L.,9994,0,9999,5
1745833506988,CLRE 252,A00,891864,Cuomo; Raphael Eduardo,9993,0,9999,6
1745833508014,CLRE 253,A00,891867,Vaida; Florin,9994,0,9999,5
1745833508014,CLRE 253,B00,907819,Staff,9999,0,9999,0
1745833509043,CLRE 259,A00,891868,Patel; Hemal,9998,0,9999,1
1745833510072,CLRE 260,A00,891872,Cuomo; Raphael Eduardo,9999,0,9999,0
1745833511098,CLRE 297,001,891888,Cuomo; Raphael Eduardo,9999,0,9999,0
1745833512124,CSE 191,A00,958773,Minnes Kemp; Mor Mia,9999,0,9999,0
1745833513152,CSS 201S,A01,892054,Mignozzetti; Umberto,30,0,30,0
1745833514177,CSS 202S,A01,892056,Mignozzetti; Umberto,30,0,30,0
1745833515207,DSC 197,001,956898,Eldridge; Justin Matthew,9998,0,9999,1
1745833516233,DSC 297,001,958000,Mazumdar; Arya,9998,0,9999,1
1745833517259,EAP 100,A00,905686,Staff,9776,0,9999,223
1745833518287,ECE 45,A01,892618,Staff,0,13,50,50
1745833519316,ECE 109,A01,892620,Staff,0,43,0,0
1745833520343,ECE 111,A01,892719,Staff,0,9,50,50
1745833521373,ECE 197,001,957920,Mercier; Patrick Philip,9992,0,9999,7
1745833522401,ECON 178,A01,907814,Zhu; Ying,28,0,35,7
1745833523428,EDS 115,A00,895312,Staff,41,0,45,4
1745833524455,EDS 117,A01,895337,Staff,30,0,30,0
1745833525480,EDS 125,A00,895341,Jones; Gabrielle Anastasia,43,0,45,2
1745833526509,EDS 128A,A01,895459,Fargason; Sharon Gayle,44,0,45,1
1745833527537,EDS 128B,A01,895543,Pappas; Elizabeth,44,0,45,1
1745833528563,EDS 139,A00,897203,Pappas; Elizabeth,44,0,45,1
1745833528563,EDS 139,B00,897209,Fargason; Sharon Gayle,44,0,45,1
1745833529589,EDS 201,A00,895545,Staff,43,0,45,2
1745833530616,EDS 203,A01,895581,Halter; Christopher P.,43,0,45,2
1745833531641,EDS 204R,A01,895625,Heinzman; Erica M.,43,0,45,2
1745833531641,EDS 204R,B01,895693,Halter; Christopher P.,18,0,45,27
1745833532671,EDS 206R,A00,895694,Fargason; Sharon Gayle,9,0,30,21
1745833532671,EDS 206R,B00,895695,Choi; Bailey Miyeon,20,0,30,10
1745833533695,EDS 250,A00,895697,Hemans; Patricia Ann Benitez,43,0,45,2
1745833534723,EDS 281,A00,895701,Meyerott; Theresa Ann,15,0,15,0
1745833535750,EDS 284,A00,895736,Meyerott; Theresa Ann,15,0,15,0
1745833536776,EDS 286,A00,897210,Fine; Sarah,15,0,15,0
1745833537805,EDS 289C,A01,895770,Daly; Alan J.,15,0,15,0
1745833538832,EDS 290,A00,897211,Hofstetter; Carolyn,15,0,15,0
1745833539859,LIGM 5A,A00,896162,Fischer-Grunski; Eva K,15,0,20,5
1745833540886,LIGM 5B,A00,896260,Fischer-Grunski; Eva K,17,0,20,3
1745833541915,LIGM 5C,A00,896308,Fischer-Grunski; Eva K,18,0,20,2
1745833542941,LIIT 5AS,A00,896313,Carnelos; Chiara,17,0,20,3
1745833543967,LIIT 5BS,A00,896416,Carnelos; Chiara,20,0,20,0
1745833545001,LIIT 5CS,A00,896564,Carnelos; Chiara,20,0,20,0
1745833546028,LISP 5A,A00,896588,Munoz Sanchez; Alicia,4,0,20,16
1745833547057,LISP 5B,A00,896653,Munoz Sanchez; Alicia,10,0,20,10
1745833548090,LISP 5C,A00,896655,Munoz Sanchez; Alicia,4,0,20,16
1745833549140,MAE 197,001,957918,Kleissl; Jan,9998,0,9999,1
1745833550167,MATH 2,A01,957937,Staff,34,0,35,1
1745833551195,MATH 197,001,957876,Kedlaya; Kiran S.,9993,0,9999,6
1745833552221,MCWP 40,A00,892729,Duru; Nur,13,0,20,7
1745833552221,MCWP 40,B00,893304,Montejo; Carolina,20,0,20,0
1745833553249,MCWP 40R,A00,893757,Redela; Pamela Morgan,0,7,20,20
1745833554275,MCWP 50,A00,893758,Morshed; Michael James,2,0,20,18
1745833554275,MCWP 50,B00,893761,Bartulis; Jason Michael,18,0,20,2
1745833555305,MCWP 50R,A00,893766,Compas; Sean Matthew,0,1,20,20
1745833555305,MCWP 50R,B00,893769,Carter; Jennifer A,0,0,20,20
1745833555305,MCWP 50R,C00,893771,Krone; Jarret,0,3,20,20
1745833555305,MCWP 50R,D00,893772,Miller; Elizabeth Deen,3,0,20,17
1745833555305,MCWP 50R,E00,893775,Carter; Andrea L,0,0,20,20
1745833556332,MMW 11R,A01,892721,Herbst; Matthew,11,0,27,16
1745833556332,MMW 11R,A02,892722,Herbst; Matthew,0,0,0,3
1745833557360,MMW 12R,A01,892724,Herbst; Matthew,0,10,16,16
1745833557360,MMW 12R,A02,892725,Herbst; Matthew,0,9,16,16
1745833558387,MMW 13R,A01,892727,Staff,0,3,16,16
1745833558387,MMW 13R,A02,892728,Staff,0,4,16,16
1745833558387,MMW 13R,A03,958032,Staff,0,3,16,16
1745833558387,MMW 13R,A04,958033,Staff,0,2,16,16
1745833558387,MMW 13R,A05,958034,Staff,0,3,16,16
1745833559415,SIO 295LS,A00,894015,Staff,7,0,25,18
1745833560440,SIO 295S,A00,894020,Staff,7,0,25,18
1745833561471,SIOC 290S,B01,958918,Staff,0,0,0,0
1745833562540,SIOC 291S,B01,958922,Staff,0,0,0,0
1745833563567,SOCI 117,A01,895339,Staff,4,0,5,1
1745833564593,WES 237B,A00,894149,Staff,11,0,20,9
1745833566666,AESE 279B,A00,891859,Staff,13,0,35,22
1745833567692,AIP 197,001,891854,Staff,70,0,70,0
1745833568718,ANTH 289S,A00,891856,Gagneux; Pascal,12,0,12,0
1745833569746,BENG 196,001,957946,Engler; Adam J.,9996,0,9999,3
1745833570774,CAT 124RS,A01,956906,Staff,8,0,25,17
1745833571801,CAT 125RS,A01,922013,Staff,8,0,25,17
1745833572830,CLRE 250,A00,891860,Morris; Sheldon,9995,0,9999,4
1745833574883,CLRE 251R,A00,907817,Mehta; Ravindra L.,9994,0,9999,5
1745833575909,CLRE 252,A00,891864,Cuomo; Raphael Eduardo,9993,0,9999,6
1745833576936,CLRE 253,A00,891867,Vaida; Florin,9994,0,9999,5
1745833576936,CLRE 253,B00,907819,Staff,9999,0,9999,0
1745833577963,CLRE 259,A00,891868,Patel; Hemal,9998,0,9999,1
1745833578989,CLRE 260,A00,891872,Cuomo; Raphael Eduardo,9999,0,9999,0
1745833580015,CLRE 297,001,891888,Cuomo; Raphael Eduardo,9999,0,9999,0
1745833581043,CSE 191,A00,958773,Minnes Kemp; Mor Mia,9999,0,9999,0
1745833582073,CSS 201S,A01,892054,Mignozzetti; Umberto,30,0,30,0
1745833583103,CSS 202S,A01,892056,Mignozzetti; Umberto,30,0,30,0
1745833584127,DSC 197,001,956898,Eldridge; Justin Matthew,9998,0,9999,1
1745833585168,DSC 297,001,958000,Mazumdar; Arya,9998,0,9999,1
1745833586194,EAP 100,A00,905686,Staff,9776,0,9999,223
1745833587222,ECE 45,A01,892618,Staff,0,13,50,50
1745833588251,ECE 109,A01,892620,Staff,0,43,0,0
1745833589277,ECE 111,A01,892719,Staff,0,9,50,50
1745833590305,ECE 197,001,957920,Mercier; Patrick Philip,9992,0,9999,7
1745833591335,ECON 178,A01,907814,Zhu; Ying,28,0,35,7
1745833592361,EDS 115,A00,895312,Staff,41,0,45,4
1745833593389,EDS 117,A01,895337,Staff,30,0,30,0
1745833594417,EDS 125,A00,895341,Jones; Gabrielle Anastasia,43,0,45,2
1745833595446,EDS 128A,A01,895459,Fargason; Sharon Gayle,44,0,45,1
1745833596473,EDS 128B,A01,895543,Pappas; Elizabeth,44,0,45,1
1745833597504,EDS 139,A00,897203,Pappas; Elizabeth,44,0,45,1
1745833597504,EDS 139,B00,897209,Fargason; Sharon Gayle,44,0,45,1
1745833598533,EDS 201,A00,895545,Staff,43,0,45,2
1745833599561,EDS 203,A01,895581,Halter; Christopher P.,43,0,45,2
1745833600590,EDS 204R,A01,895625,Heinzman; Erica M.,43,0,45,2
1745833600590,EDS 204R,B01,895693,Halter; Christopher P.,18,0,45,27
1745833601617,EDS 206R,A00,895694,Fargason; Sharon Gayle,9,0,30,21
1745833601617,EDS 206R,B00,895695,Choi; Bailey Miyeon,20,0,30,10
1745833602646,EDS 250,A00,895697,Hemans; Patricia Ann Benitez,43,0,45,2
1745833603675,EDS 281,A00,895701,Meyerott; Theresa Ann,15,0,15,0
1745833604701,EDS 284,A00,895736,Meyerott; Theresa Ann,15,0,15,0
1745833605728,EDS 286,A00,897210,Fine; Sarah,15,0,15,0
1745833606754,EDS 289C,A01,895770,Daly; Alan J.,15,0,15,0
1745833607779,EDS 290,A00,897211,Hofstetter; Carolyn,15,0,15,0
1745833608806,LIGM 5A,A00,896162,Fischer-Grunski; Eva K,15,0,20,5
1745833609833,LIGM 5B,A00,896260,Fischer-Grunski; Eva K,17,0,20,3
1745833610860,LIGM 5C,A00,896308,Fischer-Grunski; Eva K,18,0,20,2
1745833611891,LIIT 5AS,A00,896313,Carnelos; Chiara,17,0,20,3
1745833612919,LIIT 5BS,A00,896416,Carnelos; Chiara,20,0,20,0
1745833613945,LIIT 5CS,A00,896564,Carnelos; Chiara,20,0,20,0
1745833614974,LISP 5A,A00,896588,Munoz Sanchez; Alicia,4,0,20,16
1745833616002,LISP 5B,A00,896653,Munoz Sanchez; Alicia,10,0,20,10
1745833617032,LISP 5C,A00,896655,Munoz Sanchez; Alicia,4,0,20,16
1745833618058,MAE 197,001,957918,Kleissl; Jan,9998,0,9999,1
1745833619085,MATH 2,A01,957937,Staff,34,0,35,1
1745833620115,MATH 197,001,957876,Kedlaya; Kiran S.,9993,0,9999,6
1745833621150,MCWP 40,A00,892729,Duru; Nur,13,0,20,7
1745833621150,MCWP 40,B00,893304,Montejo; Carolina,20,0,20,0
1745833622178,MCWP 40R,A00,893757,Redela; Pamela Morgan,0,7,20,20
1745833623204,MCWP 50,A00,893758,Morshed; Michael James,2,0,20,18
1745833623204,MCWP 50,B00,893761,Bartulis; Jason Michael,18,0,20,2
1745833624233,MCWP 50R,A00,893766,Compas; Sean Matthew,0,1,20,20
1745833624233,MCWP 50R,B00,893769,Carter; Jennifer A,0,0,20,20
1745833624233,MCWP 50R,C00,893771,Krone; Jarret,0,3,20,20
1745833624233,MCWP 50R,D00,893772,Miller; Elizabeth Deen,3,0,20,17
1745833624233,MCWP 50R,E00,893775,Carter; Andrea L,0,0,20,20
1745833625259,MMW 11R,A01,892721,Herbst; Matthew,11,0,27,16
1745833625259,MMW 11R,A02,892722,Herbst; Matthew,0,0,0,3
1745833626287,MMW 12R,A01,892724,Herbst; Matthew,0,10,16,16
1745833626287,MMW 12R,A02,892725,Herbst; Matthew,0,9,16,16
1745833627313,MMW 13R,A01,892727,Staff,0,3,16,16
1745833627313,MMW 13R,A02,892728,Staff,0,4,16,16
1745833627313,MMW 13R,A03,958032,Staff,0,3,16,16
1745833627313,MMW 13R,A04,958033,Staff,0,2,16,16
1745833627313,MMW 13R,A05,958034,Staff,0,3,16,16
1745833628344,SIO 295LS,A00,894015,Staff,7,0,25,18
1745833629397,SIO 295S,A00,894020,Staff,7,0,25,18
1745833630428,SIOC 290S,B01,958918,Staff,0,0,0,0
1745833631458,SIOC 291S,B01,958922,Staff,0,0,0,0
1745833632483,SOCI 117,A01,895339,Staff,4,0,5,1
1745833633508,WES 237B,A00,894149,Staff,11,0,20,9
1745833635585,AESE 279B,A00,891859,Staff,13,0,35,22
1745833636609,AIP 197,001,891854,Staff,70,0,70,0
1745833637635,ANTH 289S,A00,891856,Gagneux; Pascal,12,0,12,0
1745833638663,BENG 196,001,957946,Engler; Adam J.,9996,0,9999,3
1745833639688,CAT 124RS,A01,956906,Staff,8,0,25,17
1745833640716,CAT 125RS,A01,922013,Staff,8,0,25,17
1745833641743,CLRE 250,A00,891860,Morris; Sheldon,9995,0,9999,4
1745833643795,CLRE 251R,A00,907817,Mehta; Ravindra L.,9994,0,9999,5
1745833644820,CLRE 252,A00,891864,Cuomo; Raphael Eduardo,9993,0,9999,6
1745833645846,CLRE 253,A00,891867,Vaida; Florin,9994,0,9999,5
1745833645846,CLRE 253,B00,907819,Staff,9999,0,9999,0
1745833646873,CLRE 259,A00,891868,Patel; Hemal,9998,0,9999,1
1745833647899,CLRE 260,A00,891872,Cuomo; Raphael Eduardo,9999,0,9999,0
1745833648924,CLRE 297,001,891888,Cuomo; Raphael Eduardo,9999,0,9999,0
1745833649951,CSE 191,A00,958773,Minnes Kemp; Mor Mia,9999,0,9999,0
1745833650979,CSS 201S,A01,892054,Mignozzetti; Umberto,30,0,30,0
1745833652003,CSS 202S,A01,892056,Mignozzetti; Umberto,30,0,30,0
1745833653028,DSC 197,001,956898,Eldridge; Justin Matthew,9998,0,9999,1
1745833654053,DSC 297,001,958000,Mazumdar; Arya,9998,0,9999,1
1745833655080,EAP 100,A00,905686,Staff,9776,0,9999,223
1745833656107,ECE 45,A01,892618,Staff,0,13,50,50
1745833657131,ECE 109,A01,892620,Staff,0,43,0,0
1745833658156,ECE 111,A01,892719,Staff,0,9,50,50
1745833659181,ECE 197,001,957920,Mercier; Patrick Philip,9992,0,9999,7
1745833660206,ECON 178,A01,907814,Zhu; Ying,28,0,35,7
1745833661232,EDS 115,A00,895312,Staff,41,0,45,4
1745833662256,EDS 117,A01,895337,Staff,30,0,30,0
1745833663284,EDS 125,A00,895341,Jones; Gabrielle Anastasia,43,0,45,2
1745833664309,EDS 128A,A01,895459,Fargason; Sharon Gayle,44,0,45,1
1745833665334,EDS 128B,A01,895543,Pappas; Elizabeth,44,0,45,1
1745833666358,EDS 139,A00,897203,Pappas; Elizabeth,44,0,45,1
1745833666358,EDS 139,B00,897209,Fargason; Sharon Gayle,44,0,45,1
1745833667386,EDS 201,A00,895545,Staff,43,0,45,2
1745833668413,EDS 203,A01,895581,Halter; Christopher P.,43,0,45,2
1745833669441,EDS 204R,A01,895625,Heinzman; Erica M.,43,0,45,2
1745833669441,EDS 204R,B01,895693,Halter; Christopher P.,18,0,45,27
1745833670471,EDS 206R,A00,895694,Fargason; Sharon Gayle,9,0,30,21
1745833670471,EDS 206R,B00,895695,Choi; Bailey Miyeon,20,0,30,10
1745833671497,EDS 250,A00,895697,Hemans; Patricia Ann Benitez,43,0,45,2
1745833672523,EDS 281,A00,895701,Meyerott; Theresa Ann,15,0,15,0
1745833673550,EDS 284,A00,895736,Meyerott; Theresa Ann,15,0,15,0
1745833674576,EDS 286,A00,897210,Fine; Sarah,15,0,15,0
1745833675601,EDS 289C,A01,895770,Daly; Alan J.,15,0,15,0
1745833676628,EDS 290,A00,897211,Hofstetter; Carolyn,15,0,15,0
1745833677655,LIGM 5A,A00,896162,Fischer-Grunski; Eva K,15,0,20,5
1745833678680,LIGM 5B,A00,896260,Fischer-Grunski; Eva K,17,0,20,3
1745833679706,LIGM 5C,A00,896308,Fischer-Grunski; Eva K,18,0,20,2
1745833680733,LIIT 5AS,A00,896313,Carnelos; Chiara,17,0,20,3
1745833681761,LIIT 5BS,A00,896416,Carnelos; Chiara,20,0,20,0
1745833682788,LIIT 5CS,A00,896564,Carnelos; Chiara,20,0,20,0
1745833683814,LISP 5A,A00,896588,Munoz Sanchez; Alicia,4,0,20,16
1745833684844,LISP 5B,A00,896653,Munoz Sanchez; Alicia,10,0,20,10
1745833685874,LISP 5C,A00,896655,Munoz Sanchez; Alicia,4,0,20,16
1745833686902,MAE 197,001,957918,Kleissl; Jan,9998,0,9999,1
1745833687951,MATH 2,A01,957937,Staff,34,0,35,1
1745833689037,MATH 197,001,957876,Kedlaya; Kiran S.,9993,0,9999,6
1745833690067,MCWP 40,A00,892729,Duru; Nur,13,0,20,7
1745833690067,MCWP 40,B00,893304,Montejo; Carolina,20,0,20,0
1745833691094,MCWP 40R,A00,893757,Redela; Pamela Morgan,0,7,20,20
1745833692122,MCWP 50,A00,893758,Morshed; Michael James,2,0,20,18
1745833692122,MCWP 50,B00,893761,Bartulis; Jason Michael,18,0,20,2
1745833693150,MCWP 50R,A00,893766,Compas; Sean Matthew,0,1,20,20
1745833693150,MCWP 50R,B00,893769,Carter; Jennifer A,0,0,20,20
1745833693150,MCWP 50R,C00,893771,Krone; Jarret,0,3,20,20
1745833693150,MCWP 50R,D00,893772,Miller; Elizabeth Deen,3,0,20,17
1745833693150,MCWP 50R,E00,893775,Carter; Andrea L,0,0,20,20
1745833694175,MMW 11R,A01,892721,Herbst; Matthew,11,0,27,16
1745833694175,MMW 11R,A02,892722,Herbst; Matthew,0,0,0,3
1745833695201,MMW 12R,A01,892724,Herbst; Matthew,0,10,16,16
1745833695201,MMW 12R,A02,892725,Herbst; Matthew,0,9,16,16
1745833696229,MMW 13R,A01,892727,Staff,0,3,16,16
1745833696229,MMW 13R,A02,892728,Staff,0,4,16,16
1745833696229,MMW 13R,A03,958032,Staff,0,3,16,16
1745833696229,MMW 13R,A04,958033,Staff,0,2,16,16
1745833696229,MMW 13R,A05,958034,Staff,0,3,16,16
1745833697254,SIO 295LS,A00,894015,Staff,7,0,25,18
1745833698281,SIO 295S,A00,894020,Staff,7,0,25,18
1745833699311,SIOC 290S,B01,958918,Staff,0,0,0,0
1745833700337,SIOC 291S,B01,958922,Staff,0,0,0,0
1745833701364,SOCI 117,A01,895339,Staff,4,0,5,1
1745833702391,WES 237B,A00,894149,Staff,11,0,20,9
1745833704455,AESE 279B,A00,891859,Staff,13,0,35,22
1745833705482,AIP 197,001,891854,Staff,70,0,70,0
1745833706508,ANTH 289S,A00,891856,Gagneux; Pascal,12,0,12,0
1745833707533,BENG 196,001,957946,Engler; Adam J.,9996,0,9999,3
1745833708557,CAT 124RS,A01,956906,Staff,8,0,25,17
1745833709583,CAT 125RS,A01,922013,Staff,8,0,25,17
1745833710609,CLRE 250,A00,891860,Morris; Sheldon,9995,0,9999,4
1745833712661,CLRE 251R,A00,907817,Mehta; Ravindra L.,9994,0,9999,5
1745833713691,CLRE 252,A00,891864,Cuomo; Raphael Eduardo,9993,0,9999,6
1745833714721,CLRE 253,A00,891867,Vaida; Florin,9994,0,9999,5
1745833714721,CLRE 253,B00,907819,Staff,9999,0,9999,0
1745833715747,CLRE 259,A00,891868,Patel; Hemal,9998,0,9999,1
1745833716774,CLRE 260,A00,891872,Cuomo; Raphael Eduardo,9999,0,9999,0
1745833717800,CLRE 297,001,891888,Cuomo; Raphael Eduardo,9999,0,9999,0
1745833718827,CSE 191,A00,958773,Minnes Kemp; Mor Mia,9999,0,9999,0
1745833719852,CSS 201S,A01,892054,Mignozzetti; Umberto,30,0,30,0
1745833720882,CSS 202S,A01,892056,Mignozzetti; Umberto,30,0,30,0
1745833721911,DSC 197,001,956898,Eldridge; Justin Matthew,9998,0,9999,1
1745833722938,DSC 297,001,958000,Mazumdar; Arya,9998,0,9999,1
1745833723967,EAP 100,A00,905686,Staff,9776,0,9999,223
1745833725001,ECE 45,A01,892618,Staff,0,13,50,50
1745833726026,ECE 109,A01,892620,Staff,0,43,0,0
1745833727052,ECE 111,A01,892719,Staff,0,9,50,50
1745833728079,ECE 197,001,957920,Mercier; Patrick Philip,9992,0,9999,7
1745833729105,ECON 178,A01,907814,Zhu; Ying,28,0,35,7
1745833730131,EDS 115,A00,895312,Staff,41,0,45,4
1745833731196,EDS 117,A01,895337,Staff,30,0,30,0
1745833732224,EDS 125,A00,895341,Jones; Gabrielle Anastasia,43,0,45,2
1745833733252,EDS 128A,A01,895459,Fargason; Sharon Gayle,44,0,45,1
1745833734281,EDS 128B,A01,895543,Pappas; Elizabeth,44,0,45,1
1745833735307,EDS 139,A00,897203,Pappas; Elizabeth,44,0,45,1
1745833735307,EDS 139,B00,897209,Fargason; Sharon Gayle,44,0,45,1
1745833736335,EDS 201,A00,895545,Staff,43,0,45,2
1745833737366,EDS 203,A01,895581,Halter; Christopher P.,43,0,45,2
1745833738394,EDS 204R,A01,895625,Heinzman; Erica M.,43,0,45,2
1745833738394,EDS 204R,B01,895693,Halter; Christopher P.,18,0,45,27
1745833739426,EDS 206R,A00,895694,Fargason; Sharon Gayle,9,0,30,21
1745833739426,EDS 206R,B00,895695,Choi; Bailey Miyeon,20,0,30,10
1745833740455,EDS 250,A00,895697,Hemans; Patricia Ann Benitez,43,0,45,2
1745833741481,EDS 281,A00,895701,Meyerott; Theresa Ann,15,0,15,0
1745833742507,EDS 284,A00,895736,Meyerott; Theresa Ann,15,0,15,0
1745833743534,EDS 286,A00,897210,Fine; Sarah,15,0,15,0
1745833744562,EDS 289C,A01,895770,Daly; Alan J.,15,0,15,0
1745833745589,EDS 290,A00,897211,Hofstetter; Carolyn,15,0,15,0
1745833746623,LIGM 5A,A00,896162,Fischer-Grunski; Eva K,15,0,20,5
1745833747646,LIGM 5B,A00,896260,Fischer-Grunski; Eva K,17,0,20,3
1745833748672,LIGM 5C,A00,896308,Fischer-Grunski; Eva K,18,0,20,2
1745833749703,LIIT 5AS,A00,896313,Carnelos; Chiara,17,0,20,3
1745833750733,LIIT 5BS,A00,896416,Carnelos; Chiara,20,0,20,0
1745833751759,LIIT 5CS,A00,896564,Carnelos; Chiara,20,0,20,0
1745833752791,LISP 5A,A00,896588,Munoz Sanchez; Alicia,4,0,20,16
1745833753818,LISP 5B,A00,896653,Munoz Sanchez; Alicia,10,0,20,10
1745833754846,LISP 5C,A00,896655,Munoz Sanchez; Alicia,4,0,20,16
1745833755876,MAE 197,001,957918,Kleissl; Jan,9998,0,9999,1
1745833756903,MATH 2,A01,957937,Staff,34,0,35,1
1745833757931,MATH 197,001,957876,Kedlaya; Kiran S.,9993,0,9999,6
1745833758958,MCWP 40,A00,892729,Duru; Nur,13,0,20,7
1745833758958,MCWP 40,B00,893304,Montejo; Carolina,20,0,20,0
1745833759986,MCWP 40R,A00,893757,Redela; Pamela Morgan,0,7,20,20
1745833761013,MCWP 50,A00,893758,Morshed; Michael James,2,0,20,18
1745833761013,MCWP 50,B00,893761,Bartulis; Jason Michael,18,0,20,2
1745833762042,MCWP 50R,A00,893766,Compas; Sean Matthew,0,1,20,20
1745833762042,MCWP 50R,B00,893769,Carter; Jennifer A,0,0,20,20
1745833762042,MCWP 50R,C00,893771,Krone; Jarret,0,3,20,20
1745833762042,MCWP 50R,D00,893772,Miller; Elizabeth Deen,3,0,20,17
1745833762042,MCWP 50R,E00,893775,Carter; Andrea L,0,0,20,20
1745833763070,MMW 11R,A01,892721,Herbst; Matthew,11,0,27,16
1745833763070,MMW 11R,A02,892722,Herbst; Matthew,0,0,0,3
1745833764094,MMW 12R,A01,892724,Herbst; Matthew,0,10,16,16
1745833764094,MMW 12R,A02,892725,Herbst; Matthew,0,9,16,16
1745833765121,MMW 13R,A01,892727,Staff,0,3,16,16
1745833765121,MMW 13R,A02,892728,Staff,0,4,16,16
1745833765121,MMW 13R,A03,958032,Staff,0,3,16,16
1745833765121,MMW 13R,A04,958033,Staff,0,2,16,16
1745833765121,MMW 13R,A05,958034,Staff,0,3,16,16
1745833766152,SIO 295LS,A00,894015,Staff,7,0,25,18
1745833767179,SIO 295S,A00,894020,Staff,7,0,25,18
1745833768209,SIOC 290S,B01,958918,Staff,0,0,0,0
1745833769239,SIOC 291S,B01,958922,Staff,0,0,0,0
1745833770269,SOCI 117,A01,895339,Staff,4,0,5,1
1745833771298,WES 237B,A00,894149,Staff,11,0,20,9
1745833773366,AESE 279B,A00,891859,Staff,13,0,35,22
1745833774393,AIP 197,001,891854,Staff,70,0,70,0
1745833775418,ANTH 289S,A00,891856,Gagneux; Pascal,12,0,12,0
1745833776449,BENG 196,001,957946,Engler; Adam J.,9996,0,9999,3
1745833777473,CAT 124RS,A01,956906,Staff,8,0,25,17
1745833778501,CAT 125RS,A01,922013,Staff,8,0,25,17
1745833779528,CLRE 250,A00,891860,Morris; Sheldon,9995,0,9999,4
1745833781586,CLRE 251R,A00,907817,Mehta; Ravindra L.,9994,0,9999,5
1745833782610,CLRE 252,A00,891864,Cuomo; Raphael Eduardo,9993,0,9999,6
1745833783635,CLRE 253,A00,891867,Vaida; Florin,9994,0,9999,5
1745833783635,CLRE 253,B00,907819,Staff,9999,0,9999,0
1745833784661,CLRE 259,A00,891868,Patel; Hemal,9998,0,9999,1
1745833785689,CLRE 260,A00,891872,Cuomo; Raphael Eduardo,9999,0,9999,0
1745833786715,CLRE 297,001,891888,Cuomo; Raphael Eduardo,9999,0,9999,0
1745833787743,CSE 191,A00,958773,Minnes Kemp; Mor Mia,9999,0,9999,0
1745833788771,CSS 201S,A01,892054,Mignozzetti; Umberto,30,0,30,0
1745833789797,CSS 202S,A01,892056,Mignozzetti; Umberto,30,0,30,0
1745833790823,DSC 197,001,956898,Eldridge; Justin Matthew,9998,0,9999,1
1745833791849,DSC 297,001,958000,Mazumdar; Arya,9998,0,9999,1
1745833792875,EAP 100,A00,905686,Staff,9776,0,9999,223
1745833793902,ECE 45,A01,892618,Staff,0,13,50,50
1745833794930,ECE 109,A01,892620,Staff,0,43,0,0
1745833795955,ECE 111,A01,892719,Staff,0,9,50,50
1745833796982,ECE 197,001,957920,Mercier; Patrick Philip,9992,0,9999,7
1745833798012,ECON 178,A01,907814,Zhu; Ying,28,0,35,7
1745833799039,EDS 115,A00,895312,Staff,41,0,45,4
1745833800065,EDS 117,A01,895337,Staff,30,0,30,0
1745833801093,EDS 125,A00,895341,Jones; Gabrielle Anastasia,43,0,45,2
1745833802120,EDS 128A,A01,895459,Fargason; Sharon Gayle,44,0,45,1
1745833803149,EDS 128B,A01,895543,Pappas; Elizabeth,44,0,45,1
1745833804178,EDS 139,A00,897203,Pappas; Elizabeth,44,0,45,1
1745833804178,EDS 139,B00,897209,Fargason; Sharon Gayle,44,0,45,1
1745833805205,EDS 201,A00,895545,Staff,43,0,45,2
1745833806234,EDS 203,A01,895581,Halter; Christopher P.,43,0,45,2
1745833807263,EDS 204R,A01,895625,Heinzman; Erica M.,43,0,45,2
1745833807263,EDS 204R,B01,895693,Halter; Christopher P.,18,0,45,27
1745833808290,EDS 206R,A00,895694,Fargason; Sharon Gayle,9,0,30,21
1745833808290,EDS 206R,B00,895695,Choi; Bailey Miyeon,20,0,30,10
1745833809318,EDS 250,A00,895697,Hemans; Patricia Ann Benitez,43,0,45,2
1745833810348,EDS 281,A00,895701,Meyerott; Theresa Ann,15,0,15,0
1745833811377,EDS 284,A00,895736,Meyerott; Theresa Ann,15,0,15,0
1745833812403,EDS 286,A00,897210,Fine; Sarah,15,0,15,0
1745833813428,EDS 289C,A01,895770,Daly; Alan J.,15,0,15,0
1745833814457,EDS 290,A00,897211,Hofstetter; Carolyn,15,0,15,0
1745833815483,LIGM 5A,A00,896162,Fischer-Grunski; Eva K,15,0,20,5
1745833816513,LIGM 5B,A00,896260,Fischer-Grunski; Eva K,17,0,20,3
1745833817542,LIGM 5C,A00,896308,Fischer-Grunski; Eva K,18,0,20,2
1745833818571,LIIT 5AS,A00,896313,Carnelos; Chiara,17,0,20,3
1745833819597,LIIT 5BS,A00,896416,Carnelos; Chiara,20,0,20,0
1745833820626,LIIT 5CS,A00,896564,Carnelos; Chiara,20,0,20,0
1745833821655,LISP 5A,A00,896588,Munoz Sanchez; Alicia,4,0,20,16
1745833822681,LISP 5B,A00,896653,Munoz Sanchez; Alicia,10,0,20,10
1745833823709,LISP 5C,A00,896655,Munoz Sanchez; Alicia,4,0,20,16
1745833824737,MAE 197,001,957918,Kleissl; Jan,9998,0,9999,1
1745833825763,MATH 2,A01,957937,Staff,34,0,35,1
1745833826791,MATH 197,001,957876,Kedlaya; Kiran S.,9993,0,9999,6
1745833827817,MCWP 40,A00,892729,Duru; Nur,13,0,20,7
1745833827817,MCWP 40,B00,893304,Montejo; Carolina,20,0,20,0
1745833828842,MCWP 40R,A00,893757,Redela; Pamela Morgan,0,7,20,20
1745833829871,MCWP 50,A00,893758,Morshed; Michael James,2,0,20,18
1745833829871,MCWP 50,B00,893761,Bartulis; Jason Michael,18,0,20,2
1745833830900,MCWP 50R,A00,893766,Compas; Sean Matthew,0,1,20,20
1745833830900,MCWP 50R,B00,893769,Carter; Jennifer A,0,0,20,20
1745833830900,MCWP 50R,C00,893771,Krone; Jarret,0,3,20,20
1745833830900,MCWP 50R,D00,893772,Miller; Elizabeth Deen,3,0,20,17
1745833830900,MCWP 50R,E00,893775,Carter; Andrea L,0,0,20,20
1745833831928,MMW 11R,A01,892721,Herbst; Matthew,11,0,27,16
1745833831928,MMW 11R,A02,892722,Herbst; Matthew,0,0,0,3
1745833832952,MMW 12R,A01,892724,Herbst; Matthew,0,10,16,16
1745833832952,MMW 12R,A02,892725,Herbst; Matthew,0,9,16,16
1745833833978,MMW 13R,A01,892727,Staff,0,3,16,16
1745833833978,MMW 13R,A02,892728,Staff,0,4,16,16
1745833833978,MMW 13R,A03,958032,Staff,0,3,16,16
1745833833978,MMW 13R,A04,958033,Staff,0,2,16,16
1745833833978,MMW 13R,A05,958034,Staff,0,3,16,16
1745833835008,SIO 295LS,A00,894015,Staff,7,0,25,18
1745833836038,SIO 295S,A00,894020,Staff,7,0,25,18
1745833837068,SIOC 290S,B01,958918,Staff,0,0,0,0
1745833838094,SIOC 291S,B01,958922,Staff,0,0,0,0
1745833839121,SOCI 117,A01,895339,Staff,4,0,5,1
1745833840149,WES 237B,A00,894149,Staff,11,0,20,9
1745833842213,AESE 279B,A00,891859,Staff,13,0,35,22
1745833843236,AIP 197,001,891854,Staff,70,0,70,0
1745833844264,ANTH 289S,A00,891856,Gagneux; Pascal,12,0,12,0
1745833845315,BENG 196,001,957946,Engler; Adam J.,9996,0,9999,3
1745833846340,CAT 124RS,A01,956906,Staff,8,0,25,17
1745833847374,CAT 125RS,A01,922013,Staff,8,0,25,17
1745833848404,CLRE 250,A00,891860,Morris; Sheldon,9995,0,9999,4
1745833850454,CLRE 251R,A00,907817,Mehta; Ravindra L.,9994,0,9999,5
1745833851483,CLRE 252,A00,891864,Cuomo; Raphael Eduardo,9993,0,9999,6
1745833852507,CLRE 253,A00,891867,Vaida; Florin,9994,0,9999,5
1745833852507,CLRE 253,B00,907819,Staff,9999,0,9999,0
1745833853533,CLRE 259,A00,891868,Patel; Hemal,9998,0,9999,1
1745833854558,CLRE 260,A00,891872,Cuomo; Raphael Eduardo,9999,0,9999,0
1745833855585,CLRE 297,001,891888,Cuomo; Raphael Eduardo,9999,0,9999,0
1745833856610,CSE 191,A00,958773,Minnes Kemp; Mor Mia,9999,0,9999,0
1745833857691,CSS 201S,A01,892054,Mignozzetti; Umberto,30,0,30,0
1745833858716,CSS 202S,A01,892056,Mignozzetti; Umberto,30,0,30,0
1745833859742,DSC 197,001,956898,Eldridge; Justin Matthew,9998,0,9999,1
1745833860768,DSC 297,001,958000,Mazumdar; Arya,9998,0,9999,1
1745833861794,EAP 100,A00,905686,Staff,9776,0,9999,223
1745833862819,ECE 45,A01,892618,Staff,0,13,50,50
1745833863845,ECE 109,A01,892620,Staff,0,43,0,0
1745833864874,ECE 111,A01,892719,Staff,0,9,50,50
1745833865898,ECE 197,001,957920,Mercier; Patrick Philip,9992,0,9999,7
1745833866927,ECON 178,A01,907814,Zhu; Ying,28,0,35,7
1745833867953,EDS 115,A00,895312,Staff,41,0,45,4
1745833868979,EDS 117,A01,895337,Staff,30,0,30,0
1745833870006,EDS 125,A00,895341,Jones; Gabrielle Anastasia,43,0,45,2
1745833871031,EDS 128A,A01,895459,Fargason; Sharon Gayle,44,0,45,1
1745833872057,EDS 128B,A01,895543,Pappas; Elizabeth,44,0,45,1
1745833873083,EDS 139,A00,897203,Pappas; Elizabeth,44,0,45,1
1745833873083,EDS 139,B00,897209,Fargason; Sharon Gayle,44,0,45,1
1745833874107,EDS 201,A00,895545,Staff,43,0,45,2
1745833875134,EDS 203,A01,895581,Halter; Christopher P.,43,0,45,2
1745833876161,EDS 204R,A01,895625,Heinzman; Erica M.,43,0,45,2
1745833876161,EDS 204R,B01,895693,Halter; Christopher P.,18,0,45,27
1745833877190,EDS 206R,A00,895694,Fargason; Sharon Gayle,9,0,30,21
1745833877190,EDS 206R,B00,895695,Choi; Bailey Miyeon,20,0,30,10
1745833878217,EDS 250,A00,895697,Hemans; Patricia Ann Benitez,43,0,45,2
1745833879242,EDS 281,A00,895701,Meyerott; Theresa Ann,15,0,15,0
1745833880267,EDS 284,A00,895736,Meyerott; Theresa Ann,15,0,15,0
1745833881293,EDS 286,A00,897210,Fine; Sarah,15,0,15,0
1745833882319,EDS 289C,A01,895770,Daly; Alan J.,15,0,15,0
1745833883344,EDS 290,A00,897211,Hofstetter; Carolyn,15,0,15,0
1745833884371,LIGM 5A,A00,896162,Fischer-Grunski; Eva K,15,0,20,5
1745833885399,LIGM 5B,A00,896260,Fischer-Grunski; Eva K,17,0,20,3
1745833886428,LIGM 5C,A00,896308,Fischer-Grunski; Eva K,18,0,20,2
1745833887455,LIIT 5AS,A00,896313,Carnelos; Chiara,17,0,20,3
1745833888482,LIIT 5BS,A00,896416,Carnelos; Chiara,20,0,20,0
1745833889509,LIIT 5CS,A00,896564,Carnelos; Chiara,20,0,20,0
1745833890538,LISP 5A,A00,896588,Munoz Sanchez; Alicia,4,0,20,16
1745833891565,LISP 5B,A00,896653,Munoz Sanchez; Alicia,10,0,20,10
1745833892591,LISP 5C,A00,896655,Munoz Sanchez; Alicia,4,0,20,16
1745833893620,MAE 197,001,957918,Kleissl; Jan,9998,0,9999,1
1745833894649,MATH 2,A01,957937,Staff,34,0,35,1
1745833895675,MATH 197,001,957876,Kedlaya; Kiran S.,9993,0,9999,6
1745833896703,MCWP 40,A00,892729,Duru; Nur,13,0,20,7
1745833896703,MCWP 40,B00,893304,Montejo; Carolina,20,0,20,0
1745833897729,MCWP 40R,A00,893757,Redela; Pamela Morgan,0,7,20,20
1745833898754,MCWP 50,A00,893758,Morshed; Michael James,2,0,20,18
1745833898754,MCWP 50,B00,893761,Bartulis; Jason Michael,18,0,20,2
1745833899781,MCWP 50R,A00,893766,Compas; Sean Matthew,0,1,20,20
1745833899781,MCWP 50R,B00,893769,Carter; Jennifer A,0,0,20,20
1745833899781,MCWP 50R,C00,893771,Krone; Jarret,0,3,20,20
1745833899781,MCWP 50R,D00,893772,Miller; Elizabeth Deen,3,0,20,17
1745833899781,MCWP 50R,E00,893775,Carter; Andrea L,0,0,20,20
1745833900808,MMW 11R,A01,892721,Herbst; Matthew,11,0,27,16
1745833900808,MMW 11R,A02,892722,Herbst; Matthew,0,0,0,3
1745833901835,MMW 12R,A01,892724,Herbst; Matthew,0,10,16,16
1745833901835,MMW 12R,A02,892725,Herbst; Matthew,0,9,16,16
1745833902862,MMW 13R,A01,892727,Staff,0,3,16,16
1745833902862,MMW 13R,A02,892728,Staff,0,4,16,16
1745833902862,MMW 13R,A03,958032,Staff,0,3,16,16
1745833902862,MMW 13R,A04,958033,Staff,0,2,16,16
1745833902862,MMW 13R,A05,958034,Staff,0,3,16,16
1745833903888,SIO 295LS,A00,894015,Staff,7,0,25,18
1745833904916,SIO 295S,A00,894020,Staff,7,0,25,18
1745833905942,SIOC 290S,B01,958918,Staff,0,0,0,0
1745833906968,SIOC 291S,B01,958922,Staff,0,0,0,0
1745833907995,SOCI 117,A01,895339,Staff,4,0,5,1
1745833909022,WES 237B,A00,894149,Staff,11,0,20,9
1745833911086,AESE 279B,A00,891859,Staff,13,0,35,22
1745833912114,AIP 197,001,891854,Staff,70,0,70,0
1745833913139,ANTH 289S,A00,891856,Gagneux; Pascal,12,0,12,0
1745833914166,BENG 196,001,957946,Engler; Adam J.,9996,0,9999,3
1745833915192,CAT 124RS,A01,956906,Staff,8,0,25,17
1745833916219,CAT 125RS,A01,922013,Staff,8,0,25,17
1745833917244,CLRE 250,A00,891860,Morris; Sheldon,9995,0,9999,4
1745833919296,CLRE 251R,A00,907817,Mehta; Ravindra L.,9994,0,9999,5
1745833920326,CLRE 252,A00,891864,Cuomo; Raphael Eduardo,9993,0,9999,6
1745833921352,CLRE 253,A00,891867,Vaida; Florin,9994,0,9999,5
1745833921352,CLRE 253,B00,907819,Staff,9999,0,9999,0
1745833922393,CLRE 259,A00,891868,Patel; Hemal,9998,0,9999,1
1745833923422,CLRE 260,A00,891872,Cuomo; Raphael Eduardo,9999,0,9999,0
1745833924472,CLRE 297,001,891888,Cuomo; Raphael Eduardo,9999,0,9999,0
1745833925499,CSE 191,A00,958773,Minnes Kemp; Mor Mia,9999,0,9999,0
1745833926525,CSS 201S,A01,892054,Mignozzetti; Umberto,30,0,30,0
1745833927554,CSS 202S,A01,892056,Mignozzetti; Umberto,30,0,30,0
1745833928585,DSC 197,001,956898,Eldridge; Justin Matthew,9998,0,9999,1
1745833929614,DSC 297,001,958000,Mazumdar; Arya,9998,0,9999,1
1745833930638,EAP 100,A00,905686,Staff,9776,0,9999,223
1745833931665,ECE 45,A01,892618,Staff,0,13,50,50
1745833932692,ECE 109,A01,892620,Staff,0,43,0,0
1745833933718,ECE 111,A01,892719,Staff,0,9,50,50
1745833934743,ECE 197,001,957920,Mercier; Patrick Philip,9992,0,9999,7
1745833935768,ECON 178,A01,907814,Zhu; Ying,28,0,35,7
1745833936792,EDS 115,A00,895312,Staff,41,0,45,4
1745833937817,EDS 117,A01,895337,Staff,30,0,30,0
1745833938843,EDS 125,A00,895341,Jones; Gabrielle Anastasia,43,0,45,2
1745833939870,EDS 128A,A01,895459,Fargason; Sharon Gayle,44,0,45,1
1745833940900,EDS 128B,A01,895543,Pappas; Elizabeth,44,0,45,1
1745833941926,EDS 139,A00,897203,Pappas; Elizabeth,44,0,45,1
1745833941926,EDS 139,B00,897209,Fargason; Sharon Gayle,44,0,45,1
1745833942954,EDS 201,A00,895545,Staff,43,0,45,2
1745833943979,EDS 203,A01,895581,Halter; Christopher P.,43,0,45,2
1745833945008,EDS 204R,A01,895625,Heinzman; Erica M.,43,0,45,2
1745833945008,EDS 204R,B01,895693,Halter; Christopher P.,18,0,45,27
1745833946034,EDS 206R,A00,895694,Fargason; Sharon Gayle,9,0,30,21
1745833946034,EDS 206R,B00,895695,Choi; Bailey Miyeon,20,0,30,10
1745833947061,EDS 250,A00,895697,Hemans; Patricia Ann Benitez,43,0,45,2
1745833948088,EDS 281,A00,895701,Meyerott; Theresa Ann,15,0,15,0
1745833949118,EDS 284,A00,895736,Meyerott; Theresa Ann,15,0,15,0
1745833950142,EDS 286,A00,897210,Fine; Sarah,15,0,15,0
1745833951174,EDS 289C,A01,895770,Daly; Alan J.,15,0,15,0
1745833952200,EDS 290,A00,897211,Hofstetter; Carolyn,15,0,15,0
1745833953227,LIGM 5A,A00,896162,Fischer-Grunski; Eva K,15,0,20,5
1745833954252,LIGM 5B,A00,896260,Fischer-Grunski; Eva K,17,0,20,3
1745833955279,LIGM 5C,A00,896308,Fischer-Grunski; Eva K,18,0,20,2
1745833956308,LIIT 5AS,A00,896313,Carnelos; Chiara,17,0,20,3
1745833957335,LIIT 5BS,A00,896416,Carnelos; Chiara,20,0,20,0
1745833958365,LIIT 5CS,A00,896564,Carnelos; Chiara,20,0,20,0
1745833959394,LISP 5A,A00,896588,Munoz Sanchez; Alicia,4,0,20,16
1745833960421,LISP 5B,A00,896653,Munoz Sanchez; Alicia,10,0,20,10
1745833961449,LISP 5C,A00,896655,Munoz Sanchez; Alicia,4,0,20,16
1745833962478,MAE 197,001,957918,Kleissl; Jan,9998,0,9999,1
1745833963504,MATH 2,A01,957937,Staff,34,0,35,1
1745833964532,MATH 197,001,957876,Kedlaya; Kiran S.,9993,0,9999,6
1745833965558,MCWP 40,A00,892729,Duru; Nur,13,0,20,7
1745833965558,MCWP 40,B00,893304,Montejo; Carolina,20,0,20,0
1745833966582,MCWP 40R,A00,893757,Redela; Pamela Morgan,0,7,20,20
1745833967607,MCWP 50,A00,893758,Morshed; Michael James,2,0,20,18
1745833967607,MCWP 50,B00,893761,Bartulis; Jason Michael,18,0,20,2
1745833968678,MCWP 50R,A00,893766,Compas; Sean Matthew,0,1,20,20
1745833968678,MCWP 50R,B00,893769,Carter; Jennifer A,0,0,20,20
1745833968678,MCWP 50R,C00,893771,Krone; Jarret,0,3,20,20
1745833968678,MCWP 50R,D00,893772,Miller; Elizabeth Deen,3,0,20,17
1745833968678,MCWP 50R,E00,893775,Carter; Andrea L,0,0,20,20
1745833969704,MMW 11R,A01,892721,Herbst; Matthew,11,0,27,16
1745833969704,MMW 11R,A02,892722,Herbst; Matthew,0,0,0,3
1745833970730,MMW 12R,A01,892724,Herbst; Matthew,0,10,16,16
1745833970730,MMW 12R,A02,892725,Herbst; Matthew,0,9,16,16
1745833971756,MMW 13R,A01,892727,Staff,0,3,16,16
1745833971756,MMW 13R,A02,892728,Staff,0,4,16,16
1745833971756,MMW 13R,A03,958032,Staff,0,3,16,16
1745833971756,MMW 13R,A04,958033,Staff,0,2,16,16
1745833971756,MMW 13R,A05,958034,Staff,0,3,16,16
1745833972782,SIO 295LS,A00,894015,Staff,7,0,25,18
1745833973809,SIO 295S,A00,894020,Staff,7,0,25,18
1745833974836,SIOC 290S,B01,958918,Staff,0,0,0,0
1745833975862,SIOC 291S,B01,958922,Staff,0,0,0,0
1745833976888,SOCI 117,A01,895339,Staff,4,0,5,1
1745833977917,WES 237B,A00,894149,Staff,11,0,20,9
1745833979996,AESE 279B,A00,891859,Staff,13,0,35,22
1745833981021,AIP 197,001,891854,Staff,70,0,70,0
1745833982046,ANTH 289S,A00,891856,Gagneux; Pascal,12,0,12,0
1745833983072,BENG 196,001,957946,Engler; Adam J.,9996,0,9999,3
1745833984100,CAT 124RS,A01,956906,Staff,8,0,25,17
1745833985127,CAT 125RS,A01,922013,Staff,8,0,25,17
1745833986153,CLRE 250,A00,891860,Morris; Sheldon,9995,0,9999,4
1745833988208,CLRE 251R,A00,907817,Mehta; Ravindra L.,9994,0,9999,5
1745833989235,CLRE 252,A00,891864,Cuomo; Raphael Eduardo,9993,0,9999,6
1745833990264,CLRE 253,A00,891867,Vaida; Florin,9994,0,9999,5
1745833990264,CLRE 253,B00,907819,Staff,9999,0,9999,0
1745833991293,CLRE 259,A00,891868,Patel; Hemal,9998,0,9999,1
1745833992319,CLRE 260,A00,891872,Cuomo; Raphael Eduardo,9999,0,9999,0
1745833993345,CLRE 297,001,891888,Cuomo; Raphael Eduardo,9999,0,9999,0
1745833994370,CSE 191,A00,958773,Minnes Kemp; Mor Mia,9999,0,9999,0
1745833995418,CSS 201S,A01,892054,Mignozzetti; Umberto,30,0,30,0
1745833996445,CSS 202S,A01,892056,Mignozzetti; Umberto,30,0,30,0
1745833997472,DSC 197,001,956898,Eldridge; Justin Matthew,9998,0,9999,1
1745833998500,DSC 297,001,958000,Mazumdar; Arya,9998,0,9999,1
1745833999546,EAP 100,A00,905686,Staff,9776,0,9999,223
1745834000574,ECE 45,A01,892618,Staff,0,13,50,50
1745834001602,ECE 109,A01,892620,Staff,0,43,0,0
1745834002626,ECE 111,A01,892719,Staff,0,9,50,50
1745834003656,ECE 197,001,957920,Mercier; Patrick Philip,9992,0,9999,7
1745834004692,ECON 178,A01,907814,Zhu; Ying,28,0,35,7
1745834005719,EDS 115,A00,895312,Staff,41,0,45,4
1745834006748,EDS 117,A01,895337,Staff,30,0,30,0
1745834007774,EDS 125,A00,895341,Jones; Gabrielle Anastasia,43,0,45,2
1745834008802,EDS 128A,A01,895459,Fargason; Sharon Gayle,44,0,45,1
1745834009830,EDS 128B,A01,895543,Pappas; Elizabeth,44,0,45,1
1745834010860,EDS 139,A00,897203,Pappas; Elizabeth,44,0,45,1
1745834010860,EDS 139,B00,897209,Fargason; Sharon Gayle,44,0,45,1
1745834011886,EDS 201,A00,895545,Staff,43,0,45,2
1745834012915,EDS 203,A01,895581,Halter; Christopher P.,43,0,45,2
1745834013944,EDS 204R,A01,895625,Heinzman; Erica M.,43,0,45,2
1745834013944,EDS 204R,B01,895693,Halter; Christopher P.,18,0,45,27
1745834014971,EDS 206R,A00,895694,Fargason; Sharon Gayle,9,0,30,21
1745834014971,EDS 206R,B00,895695,Choi; Bailey Miyeon,20,0,30,10
1745834015997,EDS 250,A00,895697,Hemans; Patricia Ann Benitez,43,0,45,2
1745834017025,EDS 281,A00,895701,Meyerott; Theresa Ann,15,0,15,0
1745834018050,EDS 284,A00,895736,Meyerott; Theresa Ann,15,0,15,0
1745834019076,EDS 286,A00,897210,Fine; Sarah,15,0,15,0
1745834020103,EDS 289C,A01,895770,Daly; Alan J.,15,0,15,0
1745834021130,EDS 290,A00,897211,Hofstetter; Carolyn,15,0,15,0
1745834022159,LIGM 5A,A00,896162,Fischer-Grunski; Eva K,15,0,20,5
1745834023187,LIGM 5B,A00,896260,Fischer-Grunski; Eva K,17,0,20,3
1745834024213,LIGM 5C,A00,896308,Fischer-Grunski; Eva K,18,0,20,2
1745834025243,LIIT 5AS,A00,896313,Carnelos; Chiara,17,0,20,3
1745834026268,LIIT 5BS,A00,896416,Carnelos; Chiara,20,0,20,0
1745834027295,LIIT 5CS,A00,896564,Carnelos; Chiara,20,0,20,0
1745834028324,LISP 5A,A00,896588,Munoz Sanchez; Alicia,4,0,20,16
1745834029351,LISP 5B,A00,896653,Munoz Sanchez; Alicia,10,0,20,10
1745834030379,LISP 5C,A00,896655,Munoz Sanchez; Alicia,4,0,20,16
1745834031405,MAE 197,001,957918,Kleissl; Jan,9998,0,9999,1
1745834032434,MATH 2,A01,957937,Staff,34,0,35,1
1745834033463,MATH 197,001,957876,Kedlaya; Kiran S.,9993,0,9999,6
1745834034491,MCWP 40,A00,892729,Duru; Nur,13,0,20,7
1745834034491,MCWP 40,B00,893304,Montejo; Carolina,20,0,20,0
1745834035519,MCWP 40R,A00,893757,Redela; Pamela Morgan,0,7,20,20
1745834036546,MCWP 50,A00,893758,Morshed; Michael James,2,0,20,18
1745834036546,MCWP 50,B00,893761,Bartulis; Jason Michael,18,0,20,2
1745834037573,MCWP 50R,A00,893766,Compas; Sean Matthew,0,1,20,20
1745834037573,MCWP 50R,B00,893769,Carter; Jennifer A,0,0,20,20
1745834037573,MCWP 50R,C00,893771,Krone; Jarret,0,3,20,20
1745834037573,MCWP 50R,D00,893772,Miller; Elizabeth Deen,3,0,20,17
1745834037573,MCWP 50R,E00,893775,Carter; Andrea L,0,0,20,20
1745834038598,MMW 11R,A01,892721,Herbst; Matthew,11,0,27,16
1745834038598,MMW 11R,A02,892722,Herbst; Matthew,0,0,0,3
1745834039626,MMW 12R,A01,892724,Herbst; Matthew,0,10,16,16
1745834039626,MMW 12R,A02,892725,Herbst; Matthew,0,9,16,16
1745834040652,MMW 13R,A01,892727,Staff,0,3,16,16
1745834040652,MMW 13R,A02,892728,Staff,0,4,16,16
1745834040652,MMW 13R,A03,958032,Staff,0,3,16,16
1745834040652,MMW 13R,A04,958033,Staff,0,2,16,16
1745834040652,MMW 13R,A05,958034,Staff,0,3,16,16
1745834041681,SIO 295LS,A00,894015,Staff,7,0,25,18
1745834042710,SIO 295S,A00,894020,Staff,7,0,25,18
1745834043735,SIOC 290S,B01,958918,Staff,0,0,0,0
1745834044764,SIOC 291S,B01,958922,Staff,0,0,0,0
1745834045793,SOCI 117,A01,895339,Staff,4,0,5,1
1745834046822,WES 237B,A00,894149,Staff,11,0,20,9
1745834048897,AESE 279B,A00,891859,Staff,13,0,35,22
1745834049924,AIP 197,001,891854,Staff,70,0,70,0
1745834050953,ANTH 289S,A00,891856,Gagneux; Pascal,12,0,12,0
1745834051980,BENG 196,001,957946,Engler; Adam J.,9996,0,9999,3
1745834053005,CAT 124RS,A01,956906,Staff,8,0,25,17
1745834054032,CAT 125RS,A01,922013,Staff,8,0,25,17
1745834055057,CLRE 250,A00,891860,Morris; Sheldon,9995,0,9999,4
1745834057113,CLRE 251R,A00,907817,Mehta; Ravindra L.,9994,0,9999,5
1745834058139,CLRE 252,A00,891864,Cuomo; Raphael Eduardo,9993,0,9999,6
1745834059164,CLRE 253,A00,891867,Vaida; Florin,9994,0,9999,5
1745834059164,CLRE 253,B00,907819,Staff,9999,0,9999,0
1745834060193,CLRE 259,A00,891868,Patel; Hemal,9998,0,9999,1
1745834061220,CLRE 260,A00,891872,Cuomo; Raphael Eduardo,9999,0,9999,0
1745834062246,CLRE 297,001,891888,Cuomo; Raphael Eduardo,9999,0,9999,0
1745834063276,CSE 191,A00,958773,Minnes Kemp; Mor Mia,9999,0,9999,0
1745834064302,CSS 201S,A01,892054,Mignozzetti; Umberto,30,0,30,0
1745834065329,CSS 202S,A01,892056,Mignozzetti; Umberto,30,0,30,0
1745834066355,DSC 197,001,956898,Eldridge; Justin Matthew,9998,0,9999,1
1745834067383,DSC 297,001,958000,Mazumdar; Arya,9998,0,9999,1
1745834068409,EAP 100,A00,905686,Staff,9776,0,9999,223
1745834069439,ECE 45,A01,892618,Staff,0,13,50,50
1745834070467,ECE 109,A01,892620,Staff,0,43,0,0
1745834071491,ECE 111,A01,892719,Staff,0,9,50,50
1745834072572,ECE 197,001,957920,Mercier; Patrick Philip,9992,0,9999,7
1745834073602,ECON 178,A01,907814,Zhu; Ying,28,0,35,7
1745834074626,EDS 115,A00,895312,Staff,41,0,45,4
1745834075656,EDS 117,A01,895337,Staff,30,0,30,0
1745834076686,EDS 125,A00,895341,Jones; Gabrielle Anastasia,43,0,45,2
1745834077712,EDS 128A,A01,895459,Fargason; Sharon Gayle,44,0,45,1
1745834078737,EDS 128B,A01,895543,Pappas; Elizabeth,44,0,45,1
1745834079763,EDS 139,A00,897203,Pappas; Elizabeth,44,0,45,1
1745834079763,EDS 139,B00,897209,Fargason; Sharon Gayle,44,0,45,1
1745834080789,EDS 201,A00,895545,Staff,43,0,45,2
1745834081818,EDS 203,A01,895581,Halter; Christopher P.,43,0,45,2
1745834082844,EDS 204R,A01,895625,Heinzman; Erica M.,43,0,45,2
1745834082844,EDS 204R,B01,895693,Halter; Christopher P.,18,0,45,27
1745834083873,EDS 206R,A00,895694,Fargason; Sharon Gayle,9,0,30,21
1745834083873,EDS 206R,B00,895695,Choi; Bailey Miyeon,20,0,30,10
1745834084902,EDS 250,A00,895697,Hemans; Patricia Ann Benitez,43,0,45,2
1745834085930,EDS 281,A00,895701,Meyerott; Theresa Ann,15,0,15,0
1745834086955,EDS 284,A00,895736,Meyerott; Theresa Ann,15,0,15,0
1745834087984,EDS 286,A00,897210,Fine; Sarah,15,0,15,0
1745834089013,EDS 289C,A01,895770,Daly; Alan J.,15,0,15,0
1745834090045,EDS 290,A00,897211,Hofstetter; Carolyn,15,0,15,0
1745834091072,LIGM 5A,A00,896162,Fischer-Grunski; Eva K,15,0,20,5
1745834092102,LIGM 5B,A00,896260,Fischer-Grunski; Eva K,17,0,20,3
1745834093131,LIGM 5C,A00,896308,Fischer-Grunski; Eva K,18,0,20,2
1745834094157,LIIT 5AS,A00,896313,Carnelos; Chiara,17,0,20,3
1745834095184,LIIT 5BS,A00,896416,Carnelos; Chiara,20,0,20,0
1745834096215,LIIT 5CS,A00,896564,Carnelos; Chiara,20,0,20,0
1745834097242,LISP 5A,A00,896588,Munoz Sanchez; Alicia,4,0,20,16
1745834098267,LISP 5B,A00,896653,Munoz Sanchez; Alicia,10,0,20,10
1745834099295,LISP 5C,A00,896655,Munoz Sanchez; Alicia,4,0,20,16
1745834100324,MAE 197,001,957918,Kleissl; Jan,9998,0,9999,1
1745834101352,MATH 2,A01,957937,Staff,34,0,35,1
1745834102397,MATH 197,001,957876,Kedlaya; Kiran S.,9993,0,9999,6
1745834103425,MCWP 40,A00,892729,Duru; Nur,13,0,20,7
1745834103425,MCWP 40,B00,893304,Montejo; Carolina,20,0,20,0
1745834104452,MCWP 40R,A00,893757,Redela; Pamela Morgan,0,7,20,20
1745834105481,MCWP 50,A00,893758,Morshed; Michael James,2,0,20,18
1745834105481,MCWP 50,B00,893761,Bartulis; Jason Michael,18,0,20,2
1745834106508,MCWP 50R,A00,893766,Compas; Sean Matthew,0,1,20,20
1745834106508,MCWP 50R,B00,893769,Carter; Jennifer A,0,0,20,20
1745834106508,MCWP 50R,C00,893771,Krone; Jarret,0,3,20,20
1745834106508,MCWP 50R,D00,893772,Miller; Elizabeth Deen,3,0,20,17
1745834106508,MCWP 50R,E00,893775,Carter; Andrea L,0,0,20,20
1745834107533,MMW 11R,A01,892721,Herbst; Matthew,11,0,27,16
1745834107533,MMW 11R,A02,892722,Herbst; Matthew,0,0,0,3
1745834108560,MMW 12R,A01,892724,Herbst; Matthew,0,10,16,16
1745834108560,MMW 12R,A02,892725,Herbst; Matthew,0,9,16,16
1745834109586,MMW 13R,A01,892727,Staff,0,3,16,16
1745834109586,MMW 13R,A02,892728,Staff,0,4,16,16
1745834109586,MMW 13R,A03,958032,Staff,0,3,16,16
1745834109586,MMW 13R,A04,958033,Staff,0,2,16,16
1745834109586,MMW 13R,A05,958034,Staff,0,3,16,16
1745834110616,SIO 295LS,A00,894015,Staff,7,0,25,18
1745834111641,SIO 295S,A00,894020,Staff,7,0,25,18
1745834112668,SIOC 290S,B01,958918,Staff,0,0,0,0
1745834113694,SIOC 291S,B01,958922,Staff,0,0,0,0
1745834114723,SOCI 117,A01,895339,Staff,4,0,5,1
1745834115753,WES 237B,A00,894149,Staff,11,0,20,9
1745834117828,AESE 279B,A00,891859,Staff,13,0,35,22
1745834118854,AIP 197,001,891854,Staff,70,0,70,0
1745834119881,ANTH 289S,A00,891856,Gagneux; Pascal,12,0,12,0
1745834120908,BENG 196,001,957946,Engler; Adam J.,9996,0,9999,3
1745834121936,CAT 124RS,A01,956906,Staff,8,0,25,17
1745834122963,CAT 125RS,A01,922013,Staff,8,0,25,17
1745834123992,CLRE 250,A00,891860,Morris; Sheldon,9995,0,9999,4
1745834126050,CLRE 251R,A00,907817,Mehta; Ravindra L.,9994,0,9999,5
1745834127076,CLRE 252,A00,891864,Cuomo; Raphael Eduardo,9993,0,9999,6
1745834128103,CLRE 253,A00,891867,Vaida; Florin,9994,0,9999,5
1745834128103,CLRE 253,B00,907819,Staff,9999,0,9999,0
1745834129132,CLRE 259,A00,891868,Patel; Hemal,9998,0,9999,1
1745834130160,CLRE 260,A00,891872,Cuomo; Raphael Eduardo,9999,0,9999,0
1745834131189,CLRE 297,001,891888,Cuomo; Raphael Eduardo,9999,0,9999,0
1745834132219,CSE 191,A00,958773,Minnes Kemp; Mor Mia,9999,0,9999,0
1745834133249,CSS 201S,A01,892054,Mignozzetti; Umberto,30,0,30,0
1745834134275,CSS 202S,A01,892056,Mignozzetti; Umberto,30,0,30,0
1745834135304,DSC 197,001,956898,Eldridge; Justin Matthew,9998,0,9999,1
1745834136330,DSC 297,001,958000,Mazumdar; Arya,9998,0,9999,1
1745834137360,EAP 100,A00,905686,Staff,9776,0,9999,223
1745834138385,ECE 45,A01,892618,Staff,0,13,50,50
1745834139413,ECE 109,A01,892620,Staff,0,43,0,0
1745834140441,ECE 111,A01,892719,Staff,0,9,50,50
1745834141467,ECE 197,001,957920,Mercier; Patrick Philip,9992,0,9999,7
1745834142494,ECON 178,A01,907814,Zhu; Ying,28,0,35,7
1745834143522,EDS 115,A00,895312,Staff,41,0,45,4
1745834144553,EDS 117,A01,895337,Staff,30,0,30,0
1745834145583,EDS 125,A00,895341,Jones; Gabrielle Anastasia,43,0,45,2
1745834146608,EDS 128A,A01,895459,Fargason; Sharon Gayle,44,0,45,1
1745834147637,EDS 128B,A01,895543,Pappas; Elizabeth,44,0,45,1
1745834148663,EDS 139,A00,897203,Pappas; Elizabeth,44,0,45,1
1745834148663,EDS 139,B00,897209,Fargason; Sharon Gayle,44,0,45,1
1745834149689,EDS 201,A00,895545,Staff,43,0,45,2
1745834150718,EDS 203,A01,895581,Halter; Christopher P.,43,0,45,2
1745834151747,EDS 204R,A01,895625,Heinzman; Erica M.,43,0,45,2
1745834151747,EDS 204R,B01,895693,Halter; Christopher P.,18,0,45,27
1745834152774,EDS 206R,A00,895694,Fargason; Sharon Gayle,9,0,30,21
1745834152774,EDS 206R,B00,895695,Choi; Bailey Miyeon,20,0,30,10
1745834153800,EDS 250,A00,895697,Hemans; Patricia Ann Benitez,43,0,45,2
1745834154827,EDS 281,A00,895701,Meyerott; Theresa Ann,15,0,15,0
1745834155853,EDS 284,A00,895736,Meyerott; Theresa Ann,15,0,15,0
1745834156880,EDS 286,A00,897210,Fine; Sarah,15,0,15,0
1745834157905,EDS 289C,A01,895770,Daly; Alan J.,15,0,15,0
1745834158929,EDS 290,A00,897211,Hofstetter; Carolyn,15,0,15,0
1745834159955,LIGM 5A,A00,896162,Fischer-Grunski; Eva K,15,0,20,5
1745834160982,LIGM 5B,A00,896260,Fischer-Grunski; Eva K,17,0,20,3
1745834162008,LIGM 5C,A00,896308,Fischer-Grunski; Eva K,18,0,20,2
1745834163034,LIIT 5AS,A00,896313,Carnelos; Chiara,17,0,20,3
1745834164061,LIIT 5BS,A00,896416,Carnelos; Chiara,20,0,20,0
1745834165090,LIIT 5CS,A00,896564,Carnelos; Chiara,20,0,20,0
1745834166119,LISP 5A,A00,896588,Munoz Sanchez; Alicia,4,0,20,16
1745834167145,LISP 5B,A00,896653,Munoz Sanchez; Alicia,10,0,20,10
1745834168171,LISP 5C,A00,896655,Munoz Sanchez; Alicia,4,0,20,16
1745834169197,MAE 197,001,957918,Kleissl; Jan,9998,0,9999,1
1745834170224,MATH 2,A01,957937,Staff,34,0,35,1
1745834171250,MATH 197,001,957876,Kedlaya; Kiran S.,9993,0,9999,6
1745834172276,MCWP 40,A00,892729,Duru; Nur,13,0,20,7
1745834172276,MCWP 40,B00,893304,Montejo; Carolina,20,0,20,0
1745834173299,MCWP 40R,A00,893757,Redela; Pamela Morgan,0,7,20,20
1745834174329,MCWP 50,A00,893758,Morshed; Michael James,2,0,20,18
1745834174329,MCWP 50,B00,893761,Bartulis; Jason Michael,18,0,20,2
1745834175355,MCWP 50R,A00,893766,Compas; Sean Matthew,0,1,20,20
1745834175355,MCWP 50R,B00,893769,Carter; Jennifer A,0,0,20,20
1745834175355,MCWP 50R,C00,893771,Krone; Jarret,0,3,20,20
1745834175355,MCWP 50R,D00,893772,Miller; Elizabeth Deen,3,0,20,17
1745834175355,MCWP 50R,E00,893775,Carter; Andrea L,0,0,20,20
1745834176381,MMW 11R,A01,892721,Herbst; Matthew,11,0,27,16
1745834176381,MMW 11R,A02,892722,Herbst; Matthew,0,0,0,3
1745834177409,MMW 12R,A01,892724,Herbst; Matthew,0,10,16,16
1745834177409,MMW 12R,A02,892725,Herbst; Matthew,0,9,16,16
1745834178436,MMW 13R,A01,892727,Staff,0,3,16,16
1745834178436,MMW 13R,A02,892728,Staff,0,4,16,16
1745834178436,MMW 13R,A03,958032,Staff,0,3,16,16
1745834178436,MMW 13R,A04,958033,Staff,0,2,16,16
1745834178436,MMW 13R,A05,958034,Staff,0,3,16,16
1745834180033,SIO 295LS,A00,894015,Staff,7,0,25,18
1745834181064,SIO 295S,A00,894020,Staff,7,0,25,18
1745834182091,SIOC 290S,B01,958918,Staff,0,0,0,0
1745834183121,SIOC 291S,B01,958922,Staff,0,0,0,0
1745834184146,SOCI 117,A01,895339,Staff,4,0,5,1
1745834185173,WES 237B,A00,894149,Staff,11,0,20,9
1745834187245,AESE 279B,A00,891859,Staff,13,0,35,22
1745834188270,AIP 197,001,891854,Staff,70,0,70,0
1745834189296,ANTH 289S,A00,891856,Gagneux; Pascal,12,0,12,0
1745834190324,BENG 196,001,957946,Engler; Adam J.,9996,0,9999,3
1745834191350,CAT 124RS,A01,956906,Staff,8,0,25,17
1745834192389,CAT 125RS,A01,922013,Staff,8,0,25,17
1745834193417,CLRE 250,A00,891860,Morris; Sheldon,9995,0,9999,4
1745834195476,CLRE 251R,A00,907817,Mehta; Ravindra L.,9994,0,9999,5
1745834196511,CLRE 252,A00,891864,Cuomo; Raphael Eduardo,9993,0,9999,6
1745834197538,CLRE 253,A00,891867,Vaida; Florin,9994,0,9999,5
1745834197538,CLRE 253,B00,907819,Staff,9999,0,9999,0
1745834198565,CLRE 259,A00,891868,Patel; Hemal,9998,0,9999,1
1745834199592,CLRE 260,A00,891872,Cuomo; Raphael Eduardo,9999,0,9999,0
1745834200617,CLRE 297,001,891888,Cuomo; Raphael Eduardo,9999,0,9999,0
1745834201647,CSE 191,A00,958773,Minnes Kemp; Mor Mia,9999,0,9999,0
1745834202675,CSS 201S,A01,892054,Mignozzetti; Umberto,30,0,30,0
1745834203702,CSS 202S,A01,892056,Mignozzetti; Umberto,30,0,30,0
1745834204732,DSC 197,001,956898,Eldridge; Justin Matthew,9998,0,9999,1
1745834205758,DSC 297,001,958000,Mazumdar; Arya,9998,0,9999,1
1745834206785,EAP 100,A00,905686,Staff,9776,0,9999,223
1745834207816,ECE 45,A01,892618,Staff,0,13,50,50
1745834208845,ECE 109,A01,892620,Staff,0,43,0,0
1745834209871,ECE 111,A01,892719,Staff,0,9,50,50
1745834210900,ECE 197,001,957920,Mercier; Patrick Philip,9992,0,9999,7
1745834211926,ECON 178,A01,907814,Zhu; Ying,28,0,35,7
1745834212955,EDS 115,A00,895312,Staff,41,0,45,4
1745834213981,EDS 117,A01,895337,Staff,30,0,30,0
1745834215013,EDS 125,A00,895341,Jones; Gabrielle Anastasia,43,0,45,2
1745834216041,EDS 128A,A01,895459,Fargason; Sharon Gayle,44,0,45,1
1745834217068,EDS 128B,A01,895543,Pappas; Elizabeth,44,0,45,1
1745834218096,EDS 139,A00,897203,Pappas; Elizabeth,44,0,45,1
1745834218096,EDS 139,B00,897209,Fargason; Sharon Gayle,44,0,45,1
1745834219128,EDS 201,A00,895545,Staff,43,0,45,2
1745834220156,EDS 203,A01,895581,Halter; Christopher P.,43,0,45,2
1745834221187,EDS 204R,A01,895625,Heinzman; Erica M.,43,0,45,2
1745834221187,EDS 204R,B01,895693,Halter; Christopher P.,18,0,45,27
1745834222218,EDS 206R,A00,895694,Fargason; Sharon Gayle,9,0,30,21
1745834222218,EDS 206R,B00,895695,Choi; Bailey Miyeon,20,0,30,10
1745834223251,EDS 250,A00,895697,Hemans; Patricia Ann Benitez,43,0,45,2
1745834224280,EDS 281,A00,895701,Meyerott; Theresa Ann,15,0,15,0
1745834225309,EDS 284,A00,895736,Meyerott; Theresa Ann,15,0,15,0
1745834226338,EDS 286,A00,897210,Fine; Sarah,15,0,15,0
1745834227366,EDS 289C,A01,895770,Daly; Alan J.,15,0,15,0
1745834228394,EDS 290,A00,897211,Hofstetter; Carolyn,15,0,15,0
1745834229425,LIGM 5A,A00,896162,Fischer-Grunski; Eva K,15,0,20,5
1745834230452,LIGM 5B,A00,896260,Fischer-Grunski; Eva K,17,0,20,3
1745834231481,LIGM 5C,A00,896308,Fischer-Grunski; Eva K,18,0,20,2
1745834232513,LIIT 5AS,A00,896313,Carnelos; Chiara,17,0,20,3
1745834233540,LIIT 5BS,A00,896416,Carnelos; Chiara,20,0,20,0
1745834234569,LIIT 5CS,A00,896564,Carnelos; Chiara,20,0,20,0
1745834235596,LISP 5A,A00,896588,Munoz Sanchez; Alicia,4,0,20,16
1745834236624,LISP 5B,A00,896653,Munoz Sanchez; Alicia,10,0,20,10
1745834237655,LISP 5C,A00,896655,Munoz Sanchez; Alicia,4,0,20,16
1745834238679,MAE 197,001,957918,Kleissl; Jan,9998,0,9999,1
1745834239708,MATH 2,A01,957937,Staff,34,0,35,1
1745834240738,MATH 197,001,957876,Kedlaya; Kiran S.,9993,0,9999,6
1745834241763,MCWP 40,A00,892729,Duru; Nur,13,0,20,7
1745834241763,MCWP 40,B00,893304,Montejo; Carolina,20,0,20,0
1745834242792,MCWP 40R,A00,893757,Redela; Pamela Morgan,0,7,20,20
1745834243817,MCWP 50,A00,893758,Morshed; Michael James,2,0,20,18
1745834243817,MCWP 50,B00,893761,Bartulis; Jason Michael,18,0,20,2
1745834244848,MCWP 50R,A00,893766,Compas; Sean Matthew,0,1,20,20
1745834244848,MCWP 50R,B00,893769,Carter; Jennifer A,0,0,20,20
1745834244848,MCWP 50R,C00,893771,Krone; Jarret,0,3,20,20
1745834244848,MCWP 50R,D00,893772,Miller; Elizabeth Deen,3,0,20,17
1745834244848,MCWP 50R,E00,893775,Carter; Andrea L,0,0,20,20
1745834245874,MMW 11R,A01,892721,Herbst; Matthew,11,0,27,16
1745834245874,MMW 11R,A02,892722,Herbst; Matthew,0,0,0,3
1745834246905,MMW 12R,A01,892724,Herbst; Matthew,0,10,16,16
1745834246905,MMW 12R,A02,892725,Herbst; Matthew,0,9,16,16
1745834247931,MMW 13R,A01,892727,Staff,0,3,16,16
1745834247931,MMW 13R,A02,892728,Staff,0,4,16,16
1745834247931,MMW 13R,A03,958032,Staff,0,3,16,16
1745834247931,MMW 13R,A04,958033,Staff,0,2,16,16
1745834247931,MMW 13R,A05,958034,Staff,0,3,16,16
1745834248960,SIO 295LS,A00,894015,Staff,7,0,25,18
1745834249988,SIO 295S,A00,894020,Staff,7,0,25,18
1745834251020,SIOC 290S,B01,958918,Staff,0,0,0,0
1745834252046,SIOC 291S,B01,958922,Staff,0,0,0,0
1745834253072,SOCI 117,A01,895339,Staff,4,0,5,1
1745834254097,WES 237B,A00,894149,Staff,11,0,20,9
1745834256162,AESE 279B,A00,891859,Staff,13,0,35,22
1745834257187,AIP 197,001,891854,Staff,70,0,70,0
1745834258213,ANTH 289S,A00,891856,Gagneux; Pascal,12,0,12,0
1745834259241,BENG 196,001,957946,Engler; Adam J.,9996,0,9999,3
1745834260267,CAT 124RS,A01,956906,Staff,8,0,25,17
1745834261295,CAT 125RS,A01,922013,Staff,8,0,25,17
1745834262322,CLRE 250,A00,891860,Morris; Sheldon,9995,0,9999,4
1745834264376,CLRE 251R,A00,907817,Mehta; Ravindra L.,9994,0,9999,5
1745834265402,CLRE 252,A00,891864,Cuomo; Raphael Eduardo,9993,0,9999,6
1745834266428,CLRE 253,A00,891867,Vaida; Florin,9994,0,9999,5
1745834266428,CLRE 253,B00,907819,Staff,9999,0,9999,0
1745834267456,CLRE 259,A00,891868,Patel; Hemal,9998,0,9999,1
1745834268482,CLRE 260,A00,891872,Cuomo; Raphael Eduardo,9999,0,9999,0
1745834269510,CLRE 297,001,891888,Cuomo; Raphael Eduardo,9999,0,9999,0
1745834270537,CSE 191,A00,958773,Minnes Kemp; Mor Mia,9999,0,9999,0
1745834271567,CSS 201S,A01,892054,Mignozzetti; Umberto,30,0,30,0
1745834272595,CSS 202S,A01,892056,Mignozzetti; Umberto,30,0,30,0
1745834273622,DSC 197,001,956898,Eldridge; Justin Matthew,9998,0,9999,1
1745834274651,DSC 297,001,958000,Mazumdar; Arya,9998,0,9999,1
1745834275676,EAP 100,A00,905686,Staff,9776,0,9999,223
1745834276702,ECE 45,A01,892618,Staff,0,13,50,50
1745834277730,ECE 109,A01,892620,Staff,0,43,0,0
1745834278756,ECE 111,A01,892719,Staff,0,9,50,50
1745834279782,ECE 197,001,957920,Mercier; Patrick Philip,9992,0,9999,7
1745834280812,ECON 178,A01,907814,Zhu; Ying,28,0,35,7
1745834281844,EDS 115,A00,895312,Staff,41,0,45,4
1745834282871,EDS 117,A01,895337,Staff,30,0,30,0
1745834283898,EDS 125,A00,895341,Jones; Gabrielle Anastasia,43,0,45,2
1745834285488,EDS 128A,A01,895459,Fargason; Sharon Gayle,44,0,45,1
1745834286514,EDS 128B,A01,895543,Pappas; Elizabeth,44,0,45,1
1745834287539,EDS 139,A00,897203,Pappas; Elizabeth,44,0,45,1
1745834287539,EDS 139,B00,897209,Fargason; Sharon Gayle,44,0,45,1
1745834288564,EDS 201,A00,895545,Staff,43,0,45,2
1745834289591,EDS 203,A01,895581,Halter; Christopher P.,43,0,45,2
1745834290619,EDS 204R,A01,895625,Heinzman; Erica M.,43,0,45,2
1745834290619,EDS 204R,B01,895693,Halter; Christopher P.,18,0,45,27
1745834291644,EDS 206R,A00,895694,Fargason; Sharon Gayle,9,0,30,21
1745834291644,EDS 206R,B00,895695,Choi; Bailey Miyeon,20,0,30,10
1745834292670,EDS 250,A00,895697,Hemans; Patricia Ann Benitez,43,0,45,2
1745834293696,EDS 281,A00,895701,Meyerott; Theresa Ann,15,0,15,0
1745834294721,EDS 284,A00,895736,Meyerott; Theresa Ann,15,0,15,0
1745834295750,EDS 286,A00,897210,Fine; Sarah,15,0,15,0
1745834296776,EDS 289C,A01,895770,Daly; Alan J.,15,0,15,0
1745834297803,EDS 290,A00,897211,Hofstetter; Carolyn,15,0,15,0
1745834298831,LIGM 5A,A00,896162,Fischer-Grunski; Eva K,15,0,20,5
1745834299858,LIGM 5B,A00,896260,Fischer-Grunski; Eva K,17,0,20,3
1745834300885,LIGM 5C,A00,896308,Fischer-Grunski; Eva K,18,0,20,2
1745834301914,LIIT 5AS,A00,896313,Carnelos; Chiara,17,0,20,3
1745834302940,LIIT 5BS,A00,896416,Carnelos; Chiara,20,0,20,0
1745834303968,LIIT 5CS,A00,896564,Carnelos; Chiara,20,0,20,0
1745834304995,LISP 5A,A00,896588,Munoz Sanchez; Alicia,4,0,20,16
1745834306021,LISP 5B,A00,896653,Munoz Sanchez; Alicia,10,0,20,10
1745834307057,LISP 5C,A00,896655,Munoz Sanchez; Alicia,4,0,20,16
1745834308087,MAE 197,001,957918,Kleissl; Jan,9998,0,9999,1
1745834309113,MATH 2,A01,957937,Staff,34,0,35,1
1745834310142,MATH 197,001,957876,Kedlaya; Kiran S.,9993,0,9999,6
1745834311172,MCWP 40,A00,892729,Duru; Nur,13,0,20,7
1745834311172,MCWP 40,B00,893304,Montejo; Carolina,20,0,20,0
1745834312199,MCWP 40R,A00,893757,Redela; Pamela Morgan,0,7,20,20
1745834313227,MCWP 50,A00,893758,Morshed; Michael James,2,0,20,18
1745834313227,MCWP 50,B00,893761,Bartulis; Jason Michael,18,0,20,2
1745834314258,MCWP 50R,A00,893766,Compas; Sean Matthew,0,1,20,20
1745834314258,MCWP 50R,B00,893769,Carter; Jennifer A,0,0,20,20
1745834314258,MCWP 50R,C00,893771,Krone; Jarret,0,3,20,20
1745834314258,MCWP 50R,D00,893772,Miller; Elizabeth Deen,3,0,20,17
1745834314258,MCWP 50R,E00,893775,Carter; Andrea L,0,0,20,20
1745834315287,MMW 11R,A01,892721,Herbst; Matthew,11,0,27,16
1745834315287,MMW 11R,A02,892722,Herbst; Matthew,0,0,0,3
1745834316316,MMW 12R,A01,892724,Herbst; Matthew,0,10,16,16
1745834316316,MMW 12R,A02,892725,Herbst; Matthew,0,9,16,16
1745834317342,MMW 13R,A01,892727,Staff,0,3,16,16
1745834317342,MMW 13R,A02,892728,Staff,0,4,16,16
1745834317342,MMW 13R,A03,958032,Staff,0,3,16,16
1745834317342,MMW 13R,A04,958033,Staff,0,2,16,16
1745834317342,MMW 13R,A05,958034,Staff,0,3,16,16
1745834318368,SIO 295LS,A00,894015,Staff,7,0,25,18
1745834319397,SIO 295S,A00,894020,Staff,7,0,25,18
1745834320424,SIOC 290S,B01,958918,Staff,0,0,0,0
1745834321452,SIOC 291S,B01,958922,Staff,0,0,0,0
1745834322477,SOCI 117,A01,895339,Staff,4,0,5,1
1745834323502,WES 237B,A00,894149,Staff,11,0,20,9
1745834325575,AESE 279B,A00,891859,Staff,13,0,35,22
1745834326604,AIP 197,001,891854,Staff,70,0,70,0
1745834327630,ANTH 289S,A00,891856,Gagneux; Pascal,12,0,12,0
1745834328656,BENG 196,001,957946,Engler; Adam J.,9996,0,9999,3
1745834329685,CAT 124RS,A01,956906,Staff,8,0,25,17
1745834330712,CAT 125RS,A01,922013,Staff,8,0,25,17
1745834331739,CLRE 250,A00,891860,Morris; Sheldon,9995,0,9999,4
1745834333790,CLRE 251R,A00,907817,Mehta; Ravindra L.,9994,0,9999,5
1745834334818,CLRE 252,A00,891864,Cuomo; Raphael Eduardo,9993,0,9999,6
1745834335844,CLRE 253,A00,891867,Vaida; Florin,9994,0,9999,5
1745834335844,CLRE 253,B00,907819,Staff,9999,0,9999,0
1745834336869,CLRE 259,A00,891868,Patel; Hemal,9998,0,9999,1
1745834337896,CLRE 260,A00,891872,Cuomo; Raphael Eduardo,9999,0,9999,0
1745834338923,CLRE 297,001,891888,Cuomo; Raphael Eduardo,9999,0,9999,0
1745834339951,CSE 191,A00,958773,Minnes Kemp; Mor Mia,9999,0,9999,0
1745834340981,CSS 201S,A01,892054,Mignozzetti; Umberto,30,0,30,0
1745834342012,CSS 202S,A01,892056,Mignozzetti; Umberto,30,0,30,0
1745834343038,DSC 197,001,956898,Eldridge; Justin Matthew,9998,0,9999,1
1745834344069,DSC 297,001,958000,Mazumdar; Arya,9998,0,9999,1
1745834345096,EAP 100,A00,905686,Staff,9776,0,9999,223
1745834346121,ECE 45,A01,892618,Staff,0,13,50,50
1745834347149,ECE 109,A01,892620,Staff,0,43,0,0
1745834348175,ECE 111,A01,892719,Staff,0,9,50,50
1745834349202,ECE 197,001,957920,Mercier; Patrick Philip,9992,0,9999,7
1745834350234,ECON 178,A01,907814,Zhu; Ying,28,0,35,7
1745834351259,EDS 115,A00,895312,Staff,41,0,45,4
1745834352283,EDS 117,A01,895337,Staff,30,0,30,0
1745834353311,EDS 125,A00,895341,Jones; Gabrielle Anastasia,43,0,45,2
1745834354340,EDS 128A,A01,895459,Fargason; Sharon Gayle,44,0,45,1
1745834355370,EDS 128B,A01,895543,Pappas; Elizabeth,44,0,45,1
1745834356395,EDS 139,A00,897203,Pappas; Elizabeth,44,0,45,1
1745834356395,EDS 139,B00,897209,Fargason; Sharon Gayle,44,0,45,1
1745834357425,EDS 201,A00,895545,Staff,43,0,45,2
1745834358454,EDS 203,A01,895581,Halter; Christopher P.,43,0,45,2
1745834359481,EDS 204R,A01,895625,Heinzman; Erica M.,43,0,45,2
1745834359481,EDS 204R,B01,895693,Halter; Christopher P.,18,0,45,27
1745834360511,EDS 206R,A00,895694,Fargason; Sharon Gayle,9,0,30,21
1745834360511,EDS 206R,B00,895695,Choi; Bailey Miyeon,20,0,30,10
1745834361541,EDS 250,A00,895697,Hemans; Patricia Ann Benitez,43,0,45,2
1745834362567,EDS 281,A00,895701,Meyerott; Theresa Ann,15,0,15,0
1745834363594,EDS 284,A00,895736,Meyerott; Theresa Ann,15,0,15,0
1745834364620,EDS 286,A00,897210,Fine; Sarah,15,0,15,0
1745834365646,EDS 289C,A01,895770,Daly; Alan J.,15,0,15,0
1745834366671,EDS 290,A00,897211,Hofstetter; Carolyn,15,0,15,0
1745834367697,LIGM 5A,A00,896162,Fischer-Grunski; Eva K,15,0,20,5
1745834368723,LIGM 5B,A00,896260,Fischer-Grunski; Eva K,17,0,20,3
1745834369750,LIGM 5C,A00,896308,Fischer-Grunski; Eva K,18,0,20,2
1745834370778,LIIT 5AS,A00,896313,Carnelos; Chiara,17,0,20,3
1745834371805,LIIT 5BS,A00,896416,Carnelos; Chiara,20,0,20,0
1745834372832,LIIT 5CS,A00,896564,Carnelos; Chiara,20,0,20,0
1745834373859,LISP 5A,A00,896588,Munoz Sanchez; Alicia,4,0,20,16
1745834374888,LISP 5B,A00,896653,Munoz Sanchez; Alicia,10,0,20,10
1745834375918,LISP 5C,A00,896655,Munoz Sanchez; Alicia,4,0,20,16
1745834376947,MAE 197,001,957918,Kleissl; Jan,9998,0,9999,1
1745834378029,MATH 2,A01,957937,Staff,34,0,35,1
1745834379057,MATH 197,001,957876,Kedlaya; Kiran S.,9993,0,9999,6
1745834380082,MCWP 40,A00,892729,Duru; Nur,13,0,20,7
1745834380082,MCWP 40,B00,893304,Montejo; Carolina,20,0,20,0
1745834381107,MCWP 40R,A00,893757,Redela; Pamela Morgan,0,7,20,20
1745834382134,MCWP 50,A00,893758,Morshed; Michael James,2,0,20,18
1745834382134,MCWP 50,B00,893761,Bartulis; Jason Michael,18,0,20,2
1745834383161,MCWP 50R,A00,893766,Compas; Sean Matthew,0,1,20,20
1745834383161,MCWP 50R,B00,893769,Carter; Jennifer A,0,0,20,20
1745834383161,MCWP 50R,C00,893771,Krone; Jarret,0,3,20,20
1745834383161,MCWP 50R,D00,893772,Miller; Elizabeth Deen,3,0,20,17
1745834383161,MCWP 50R,E00,893775,Carter; Andrea L,0,0,20,20
1745834384187,MMW 11R,A01,892721,Herbst; Matthew,11,0,27,16
1745834384187,MMW 11R,A02,892722,Herbst; Matthew,0,0,0,3
1745834385213,MMW 12R,A01,892724,Herbst; Matthew,0,10,16,16
1745834385213,MMW 12R,A02,892725,Herbst; Matthew,0,9,16,16
1745834386241,MMW 13R,A01,892727,Staff,0,3,16,16
1745834386241,MMW 13R,A02,892728,Staff,0,4,16,16
1745834386241,MMW 13R,A03,958032,Staff,0,3,16,16
1745834386241,MMW 13R,A04,958033,Staff,0,2,16,16
1745834386241,MMW 13R,A05,958034,Staff,0,3,16,16
1745834387267,SIO 295LS,A00,894015,Staff,7,0,25,18
1745834388296,SIO 295S,A00,894020,Staff,7,0,25,18
1745834389326,SIOC 290S,B01,958918,Staff,0,0,0,0
1745834390355,SIOC 291S,B01,958922,Staff,0,0,0,0
1745834391383,SOCI 117,A01,895339,Staff,4,0,5,1
1745834392410,WES 237B,A00,894149,Staff,11,0,20,9
1745834394470,AESE 279B,A00,891859,Staff,13,0,35,22
1745834395496,AIP 197,001,891854,Staff,70,0,70,0
1745834396523,ANTH 289S,A00,891856,Gagneux; Pascal,12,0,12,0
1745834397555,BENG 196,001,957946,Engler; Adam J.,9996,0,9999,3
1745834398580,CAT 124RS,A01,956906,Staff,8,0,25,17
1745834399608,CAT 125RS,A01,922013,Staff,8,0,25,17
1745834400632,CLRE 250,A00,891860,Morris; Sheldon,9995,0,9999,4
1745834402701,CLRE 251R,A00,907817,Mehta; Ravindra L.,9994,0,9999,5
1745834403729,CLRE 252,A00,891864,Cuomo; Raphael Eduardo,9993,0,9999,6
1745834404757,CLRE 253,A00,891867,Vaida; Florin,9994,0,9999,5
1745834404757,CLRE 253,B00,907819,Staff,9999,0,9999,0
1745834405787,CLRE 259,A00,891868,Patel; Hemal,9998,0,9999,1
1745834406813,CLRE 260,A00,891872,Cuomo; Raphael Eduardo,9999,0,9999,0
1745834407840,CLRE 297,001,891888,Cuomo; Raphael Eduardo,9999,0,9999,0
1745834408868,CSE 191,A00,958773,Minnes Kemp; Mor Mia,9999,0,9999,0
1745834409898,CSS 201S,A01,892054,Mignozzetti; Umberto,30,0,30,0
1745834410924,CSS 202S,A01,892056,Mignozzetti; Umberto,30,0,30,0
1745834411954,DSC 197,001,956898,Eldridge; Justin Matthew,9998,0,9999,1
1745834412979,DSC 297,001,958000,Mazumdar; Arya,9998,0,9999,1
1745834414009,EAP 100,A00,905686,Staff,9776,0,9999,223
1745834415036,ECE 45,A01,892618,Staff,0,13,50,50
1745834416062,ECE 109,A01,892620,Staff,0,43,0,0
1745834417091,ECE 111,A01,892719,Staff,0,9,50,50
1745834418118,ECE 197,001,957920,Mercier; Patrick Philip,9992,0,9999,7
1745834419144,ECON 178,A01,907814,Zhu; Ying,28,0,35,7
1745834420174,EDS 115,A00,895312,Staff,41,0,45,4
1745834421198,EDS 117,A01,895337,Staff,30,0,30,0
1745834422228,EDS 125,A00,895341,Jones; Gabrielle Anastasia,43,0,45,2
1745834423254,EDS 128A,A01,895459,Fargason; Sharon Gayle,44,0,45,1
1745834424283,EDS 128B,A01,895543,Pappas; Elizabeth,44,0,45,1
1745834425312,EDS 139,A00,897203,Pappas; Elizabeth,44,0,45,1
1745834425312,EDS 139,B00,897209,Fargason; Sharon Gayle,44,0,45,1
1745834426337,EDS 201,A00,895545,Staff,43,0,45,2
1745834427365,EDS 203,A01,895581,Halter; Christopher P.,43,0,45,2
1745834428393,EDS 204R,A01,895625,Heinzman; Erica M.,43,0,45,2
1745834428393,EDS 204R,B01,895693,Halter; Christopher P.,18,0,45,27
1745834429420,EDS 206R,A00,895694,Fargason; Sharon Gayle,9,0,30,21
1745834429420,EDS 206R,B00,895695,Choi; Bailey Miyeon,20,0,30,10
1745834430459,EDS 250,A00,895697,Hemans; Patricia Ann Benitez,43,0,45,2
1745834431485,EDS 281,A00,895701,Meyerott; Theresa Ann,15,0,15,0
1745834432511,EDS 284,A00,895736,Meyerott; Theresa Ann,15,0,15,0
1745834433538,EDS 286,A00,897210,Fine; Sarah,15,0,15,0
1745834434566,EDS 289C,A01,895770,Daly; Alan J.,15,0,15,0
1745834435592,EDS 290,A00,897211,Hofstetter; Carolyn,15,0,15,0
1745834436622,LIGM 5A,A00,896162,Fischer-Grunski; Eva K,15,0,20,5
1745834437645,LIGM 5B,A00,896260,Fischer-Grunski; Eva K,17,0,20,3
1745834438670,LIGM 5C,A00,896308,Fischer-Grunski; Eva K,18,0,20,2
1745834439696,LIIT 5AS,A00,896313,Carnelos; Chiara,17,0,20,3
1745834440722,LIIT 5BS,A00,896416,Carnelos; Chiara,20,0,20,0
1745834441746,LIIT 5CS,A00,896564,Carnelos; Chiara,20,0,20,0
1745834442775,LISP 5A,A00,896588,Munoz Sanchez; Alicia,4,0,20,16
1745834443800,LISP 5B,A00,896653,Munoz Sanchez; Alicia,10,0,20,10
1745834444824,LISP 5C,A00,896655,Munoz Sanchez; Alicia,4,0,20,16
1745834445848,MAE 197,001,957918,Kleissl; Jan,9998,0,9999,1
1745834446874,MATH 2,A01,957937,Staff,34,0,35,1
1745834447900,MATH 197,001,957876,Kedlaya; Kiran S.,9993,0,9999,6
1745834448926,MCWP 40,A00,892729,Duru; Nur,13,0,20,7
1745834448926,MCWP 40,B00,893304,Montejo; Carolina,20,0,20,0
1745834449955,MCWP 40R,A00,893757,Redela; Pamela Morgan,0,7,20,20
1745834450983,MCWP 50,A00,893758,Morshed; Michael James,2,0,20,18
1745834450983,MCWP 50,B00,893761,Bartulis; Jason Michael,18,0,20,2
1745834452014,MCWP 50R,A00,893766,Compas; Sean Matthew,0,1,20,20
1745834452014,MCWP 50R,B00,893769,Carter; Jennifer A,0,0,20,20
1745834452014,MCWP 50R,C00,893771,Krone; Jarret,0,3,20,20
1745834452014,MCWP 50R,D00,893772,Miller; Elizabeth Deen,3,0,20,17
1745834452014,MCWP 50R,E00,893775,Carter; Andrea L,0,0,20,20
1745834453039,MMW 11R,A01,892721,Herbst; Matthew,11,0,27,16
1745834453039,MMW 11R,A02,892722,Herbst; Matthew,0,0,0,3
1745834454067,MMW 12R,A01,892724,Herbst; Matthew,0,10,16,16
1745834454067,MMW 12R,A02,892725,Herbst; Matthew,0,9,16,16
1745834455093,MMW 13R,A01,892727,Staff,0,3,16,16
1745834455093,MMW 13R,A02,892728,Staff,0,4,16,16
1745834455093,MMW 13R,A03,958032,Staff,0,3,16,16
1745834455093,MMW 13R,A04,958033,Staff,0,2,16,16
1745834455093,MMW 13R,A05,958034,Staff,0,3,16,16
1745834456119,SIO 295LS,A00,894015,Staff,7,0,25,18
1745834457144,SIO 295S,A00,894020,Staff,7,0,25,18
1745834458171,SIOC 290S,B01,958918,Staff,0,0,0,0
1745834459313,SIOC 291S,B01,958922,Staff,0,0,0,0
1745834460339,SOCI 117,A01,895339,Staff,4,0,5,1
1745834461368,WES 237B,A00,894149,Staff,11,0,20,9
1745834463441,AESE 279B,A00,891859,Staff,13,0,35,22
1745834464467,AIP 197,001,891854,Staff,70,0,70,0
1745834465495,ANTH 289S,A00,891856,Gagneux; Pascal,12,0,12,0
1745834466522,BENG 196,001,957946,Engler; Adam J.,9996,0,9999,3
1745834467548,CAT 124RS,A01,956906,Staff,8,0,25,17
1745834468574,CAT 125RS,A01,922013,Staff,8,0,25,17
1745834469600,CLRE 250,A00,891860,Morris; Sheldon,9995,0,9999,4
1745834471657,CLRE 251R,A00,907817,Mehta; Ravindra L.,9994,0,9999,5
1745834472682,CLRE 252,A00,891864,Cuomo; Raphael Eduardo,9993,0,9999,6
1745834473713,CLRE 253,A00,891867,Vaida; Florin,9994,0,9999,5
1745834473713,CLRE 253,B00,907819,Staff,9999,0,9999,0
1745834474739,CLRE 259,A00,891868,Patel; Hemal,9998,0,9999,1
1745834475765,CLRE 260,A00,891872,Cuomo; Raphael Eduardo,9999,0,9999,0
1745834476790,CLRE 297,001,891888,Cuomo; Raphael Eduardo,9999,0,9999,0
1745834477819,CSE 191,A00,958773,Minnes Kemp; Mor Mia,9999,0,9999,0
1745834478845,CSS 201S,A01,892054,Mignozzetti; Umberto,30,0,30,0
1745834479875,CSS 202S,A01,892056,Mignozzetti; Umberto,30,0,30,0
1745834480903,DSC 197,001,956898,Eldridge; Justin Matthew,9998,0,9999,1
1745834481986,DSC 297,001,958000,Mazumdar; Arya,9998,0,9999,1
1745834483012,EAP 100,A00,905686,Staff,9776,0,9999,223
1745834484041,ECE 45,A01,892618,Staff,0,13,50,50
1745834485069,ECE 109,A01,892620,Staff,0,43,0,0
1745834486099,ECE 111,A01,892719,Staff,0,9,50,50
1745834487125,ECE 197,001,957920,Mercier; Patrick Philip,9992,0,9999,7
1745834488151,ECON 178,A01,907814,Zhu; Ying,28,0,35,7
1745834489178,EDS 115,A00,895312,Staff,41,0,45,4
1745834490203,EDS 117,A01,895337,Staff,30,0,30,0
1745834491231,EDS 125,A00,895341,Jones; Gabrielle Anastasia,43,0,45,2
1745834492260,EDS 128A,A01,895459,Fargason; Sharon Gayle,44,0,45,1
1745834493287,EDS 128B,A01,895543,Pappas; Elizabeth,44,0,45,1
1745834494314,EDS 139,A00,897203,Pappas; Elizabeth,44,0,45,1
1745834494314,EDS 139,B00,897209,Fargason; Sharon Gayle,44,0,45,1
1745834495342,EDS 201,A00,895545,Staff,43,0,45,2
1745834496368,EDS 203,A01,895581,Halter; Christopher P.,43,0,45,2
1745834497395,EDS 204R,A01,895625,Heinzman; Erica M.,43,0,45,2
1745834497395,EDS 204R,B01,895693,Halter; Christopher P.,18,0,45,27
1745834498425,EDS 206R,A00,895694,Fargason; Sharon Gayle,9,0,30,21
1745834498425,EDS 206R,B00,895695,Choi; Bailey Miyeon,20,0,30,10
1745834499454,EDS 250,A00,895697,Hemans; Patricia Ann Benitez,43,0,45,2
1745834500484,EDS 281,A00,895701,Meyerott; Theresa Ann,15,0,15,0
1745834501511,EDS 284,A00,895736,Meyerott; Theresa Ann,15,0,15,0
1745834502539,EDS 286,A00,897210,Fine; Sarah,15,0,15,0
1745834503569,EDS 289C,A01,895770,Daly; Alan J.,15,0,15,0
1745834504597,EDS 290,A00,897211,Hofstetter; Carolyn,15,0,15,0
1745834505624,LIGM 5A,A00,896162,Fischer-Grunski; Eva K,15,0,20,5
1745834506653,LIGM 5B,A00,896260,Fischer-Grunski; Eva K,17,0,20,3
1745834507681,LIGM 5C,A00,896308,Fischer-Grunski; Eva K,18,0,20,2
1745834508725,LIIT 5AS,A00,896313,Carnelos; Chiara,17,0,20,3
1745834509754,LIIT 5BS,A00,896416,Carnelos; Chiara,20,0,20,0
1745834510781,LIIT 5CS,A00,896564,Carnelos; Chiara,20,0,20,0
1745834511812,LISP 5A,A00,896588,Munoz Sanchez; Alicia,4,0,20,16
1745834512843,LISP 5B,A00,896653,Munoz Sanchez; Alicia,10,0,20,10
1745834513870,LISP 5C,A00,896655,Munoz Sanchez; Alicia,4,0,20,16
1745834514897,MAE 197,001,957918,Kleissl; Jan,9998,0,9999,1
1745834515922,MATH 2,A01,957937,Staff,34,0,35,1
1745834516950,MATH 197,001,957876,Kedlaya; Kiran S.,9993,0,9999,6
1745834517980,MCWP 40,A00,892729,Duru; Nur,13,0,20,7
1745834517980,MCWP 40,B00,893304,Montejo; Carolina,20,0,20,0
1745834519010,MCWP 40R,A00,893757,Redela; Pamela Morgan,0,7,20,20
1745834520039,MCWP 50,A00,893758,Morshed; Michael James,2,0,20,18
1745834520039,MCWP 50,B00,893761,Bartulis; Jason Michael,18,0,20,2
1745834521069,MCWP 50R,A00,893766,Compas; Sean Matthew,0,1,20,20
1745834521069,MCWP 50R,B00,893769,Carter; Jennifer A,0,0,20,20
1745834521069,MCWP 50R,C00,893771,Krone; Jarret,0,3,20,20
1745834521069,MCWP 50R,D00,893772,Miller; Elizabeth Deen,3,0,20,17
1745834521069,MCWP 50R,E00,893775,Carter; Andrea L,0,0,20,20
1745834522097,MMW 11R,A01,892721,Herbst; Matthew,11,0,27,16
1745834522097,MMW 11R,A02,892722,Herbst; Matthew,0,0,0,3
1745834523124,MMW 12R,A01,892724,Herbst; Matthew,0,10,16,16
1745834523124,MMW 12R,A02,892725,Herbst; Matthew,0,9,16,16
1745834524151,MMW 13R,A01,892727,Staff,0,3,16,16
1745834524151,MMW 13R,A02,892728,Staff,0,4,16,16
1745834524151,MMW 13R,A03,958032,Staff,0,3,16,16
1745834524151,MMW 13R,A04,958033,Staff,0,2,16,16
1745834524151,MMW 13R,A05,958034,Staff,0,3,16,16
1745834525178,SIO 295LS,A00,894015,Staff,7,0,25,18
1745834526209,SIO 295S,A00,894020,Staff,7,0,25,18
1745834527239,SIOC 290S,B01,958918,Staff,0,0,0,0
1745834528271,SIOC 291S,B01,958922,Staff,0,0,0,0
1745834529300,SOCI 117,A01,895339,Staff,4,0,5,1
1745834530329,WES 237B,A00,894149,Staff,11,0,20,9
1745834532407,AESE 279B,A00,891859,Staff,13,0,35,22
1745834533434,AIP 197,001,891854,Staff,70,0,70,0
1745834534461,ANTH 289S,A00,891856,Gagneux; Pascal,12,0,12,0
1745834535491,BENG 196,001,957946,Engler; Adam J.,9996,0,9999,3
1745834536517,CAT 124RS,A01,956906,Staff,8,0,25,17
1745834537542,CAT 125RS,A01,922013,Staff,8,0,25,17
1745834538571,CLRE 250,A00,891860,Morris; Sheldon,9995,0,9999,4
1745834540623,CLRE 251R,A00,907817,Mehta; Ravindra L.,9994,0,9999,5
1745834541649,CLRE 252,A00,891864,Cuomo; Raphael Eduardo,9993,0,9999,6
1745834542675,CLRE 253,A00,891867,Vaida; Florin,9994,0,9999,5
1745834542675,CLRE 253,B00,907819,Staff,9999,0,9999,0
1745834543702,CLRE 259,A00,891868,Patel; Hemal,9998,0,9999,1
1745834544732,CLRE 260,A00,891872,Cuomo; Raphael Eduardo,9999,0,9999,0
1745834545758,CLRE 297,001,891888,Cuomo; Raphael Eduardo,9999,0,9999,0
1745834546784,CSE 191,A00,958773,Minnes Kemp; Mor Mia,9999,0,9999,0
1745834547812,CSS 201S,A01,892054,Mignozzetti; Umberto,30,0,30,0
1745834548839,CSS 202S,A01,892056,Mignozzetti; Umberto,30,0,30,0
1745834549868,DSC 197,001,956898,Eldridge; Justin Matthew,9998,0,9999,1
1745834550893,DSC 297,001,958000,Mazumdar; Arya,9998,0,9999,1
1745834551918,EAP 100,A00,905686,Staff,9776,0,9999,223
1745834552945,ECE 45,A01,892618,Staff,0,13,50,50
1745834553971,ECE 109,A01,892620,Staff,0,43,0,0
1745834555001,ECE 111,A01,892719,Staff,0,9,50,50
1745834556029,ECE 197,001,957920,Mercier; Patrick Philip,9992,0,9999,7
1745834557057,ECON 178,A01,907814,Zhu; Ying,28,0,35,7
1745834558087,EDS 115,A00,895312,Staff,41,0,45,4
1745834559114,EDS 117,A01,895337,Staff,30,0,30,0
1745834560140,EDS 125,A00,895341,Jones; Gabrielle Anastasia,43,0,45,2
1745834561170,EDS 128A,A01,895459,Fargason; Sharon Gayle,44,0,45,1
1745834562199,EDS 128B,A01,895543,Pappas; Elizabeth,44,0,45,1
1745834563228,EDS 139,A00,897203,Pappas; Elizabeth,44,0,45,1
1745834563228,EDS 139,B00,897209,Fargason; Sharon Gayle,44,0,45,1
1745834564255,EDS 201,A00,895545,Staff,43,0,45,2
1745834565283,EDS 203,A01,895581,Halter; Christopher P.,43,0,45,2
1745834566310,EDS 204R,A01,895625,Heinzman; Erica M.,43,0,45,2
1745834566310,EDS 204R,B01,895693,Halter; Christopher P.,18,0,45,27
1745834567335,EDS 206R,A00,895694,Fargason; Sharon Gayle,9,0,30,21
1745834567335,EDS 206R,B00,895695,Choi; Bailey Miyeon,20,0,30,10
1745834568362,EDS 250,A00,895697,Hemans; Patricia Ann Benitez,43,0,45,2
1745834569390,EDS 281,A00,895701,Meyerott; Theresa Ann,15,0,15,0
1745834570417,EDS 284,A00,895736,Meyerott; Theresa Ann,15,0,15,0
1745834571442,EDS 286,A00,897210,Fine; Sarah,15,0,15,0
1745834572466,EDS 289C,A01,895770,Daly; Alan J.,15,0,15,0
1745834573497,EDS 290,A00,897211,Hofstetter; Carolyn,15,0,15,0
1745834574529,LIGM 5A,A00,896162,Fischer-Grunski; Eva K,15,0,20,5
1745834575559,LIGM 5B,A00,896260,Fischer-Grunski; Eva K,17,0,20,3
1745834576589,LIGM 5C,A00,896308,Fischer-Grunski; Eva K,18,0,20,2
1745834577615,LIIT 5AS,A00,896313,Carnelos; Chiara,17,0,20,3
1745834578645,LIIT 5BS,A00,896416,Carnelos; Chiara,20,0,20,0
1745834579671,LIIT 5CS,A00,896564,Carnelos; Chiara,20,0,20,0
1745834580698,LISP 5A,A00,896588,Munoz Sanchez; Alicia,4,0,20,16
1745834581728,LISP 5B,A00,896653,Munoz Sanchez; Alicia,10,0,20,10
1745834582756,LISP 5C,A00,896655,Munoz Sanchez; Alicia,4,0,20,16
1745834583782,MAE 197,001,957918,Kleissl; Jan,9998,0,9999,1
1745834584814,MATH 2,A01,957937,Staff,34,0,35,1
1745834585882,MATH 197,001,957876,Kedlaya; Kiran S.,9993,0,9999,6
1745834586907,MCWP 40,A00,892729,Duru; Nur,13,0,20,7
1745834586907,MCWP 40,B00,893304,Montejo; Carolina,20,0,20,0
1745834587938,MCWP 40R,A00,893757,Redela; Pamela Morgan,0,7,20,20
1745834588964,MCWP 50,A00,893758,Morshed; Michael James,2,0,20,18
1745834588964,MCWP 50,B00,893761,Bartulis; Jason Michael,18,0,20,2
1745834589991,MCWP 50R,A00,893766,Compas; Sean Matthew,0,1,20,20
1745834589991,MCWP 50R,B00,893769,Carter; Jennifer A,0,0,20,20
1745834589991,MCWP 50R,C00,893771,Krone; Jarret,0,3,20,20
1745834589991,MCWP 50R,D00,893772,Miller; Elizabeth Deen,3,0,20,17
1745834589991,MCWP 50R,E00,893775,Carter; Andrea L,0,0,20,20
1745834591022,MMW 11R,A01,892721,Herbst; Matthew,11,0,27,16
1745834591022,MMW 11R,A02,892722,Herbst; Matthew,0,0,0,3
1745834592049,MMW 12R,A01,892724,Herbst; Matthew,0,10,16,16
1745834592049,MMW 12R,A02,892725,Herbst; Matthew,0,9,16,16
1745834593077,MMW 13R,A01,892727,Staff,0,3,16,16
1745834593077,MMW 13R,A02,892728,Staff,0,4,16,16
1745834593077,MMW 13R,A03,958032,Staff,0,3,16,16
1745834593077,MMW 13R,A04,958033,Staff,0,2,16,16
1745834593077,MMW 13R,A05,958034,Staff,0,3,16,16
1745834594107,SIO 295LS,A00,894015,Staff,7,0,25,18
1745834595134,SIO 295S,A00,894020,Staff,7,0,25,18
1745834596163,SIOC 290S,B01,958918,Staff,0,0,0,0
1745834597189,SIOC 291S,B01,958922,Staff,0,0,0,0
1745834598216,SOCI 117,A01,895339,Staff,4,0,5,1
1745834599247,WES 237B,A00,894149,Staff,11,0,20,9
1745834601331,AESE 279B,A00,891859,Staff,13,0,35,22
1745834602358,AIP 197,001,891854,Staff,70,0,70,0
1745834603388,ANTH 289S,A00,891856,Gagneux; Pascal,12,0,12,0
1745834604415,BENG 196,001,957946,Engler; Adam J.,9996,0,9999,3
1745834605442,CAT 124RS,A01,956906,Staff,8,0,25,17
1745834606468,CAT 125RS,A01,922013,Staff,8,0,25,17
1745834607497,CLRE 250,A00,891860,Morris; Sheldon,9995,0,9999,4
1745834609548,CLRE 251R,A00,907817,Mehta; Ravindra L.,9994,0,9999,5
1745834610575,CLRE 252,A00,891864,Cuomo; Raphael Eduardo,9993,0,9999,6
1745834611601,CLRE 253,A00,891867,Vaida; Florin,9994,0,9999,5
1745834611601,CLRE 253,B00,907819,Staff,9999,0,9999,0
1745834612630,CLRE 259,A00,891868,Patel; Hemal,9998,0,9999,1
1745834613656,CLRE 260,A00,891872,Cuomo; Raphael Eduardo,9999,0,9999,0
1745834614684,CLRE 297,001,891888,Cuomo; Raphael Eduardo,9999,0,9999,0
1745834615711,CSE 191,A00,958773,Minnes Kemp; Mor Mia,9999,0,9999,0
1745834616739,CSS 201S,A01,892054,Mignozzetti; Umberto,30,0,30,0
1745834617766,CSS 202S,A01,892056,Mignozzetti; Umberto,30,0,30,0
1745834618790,DSC 197,001,956898,Eldridge; Justin Matthew,9998,0,9999,1
1745834619816,DSC 297,001,958000,Mazumdar; Arya,9998,0,9999,1
1745834620849,EAP 100,A00,905686,Staff,9776,0,9999,223
1745834621879,ECE 45,A01,892618,Staff,0,13,50,50
1745834622910,ECE 109,A01,892620,Staff,0,43,0,0
1745834623936,ECE 111,A01,892719,Staff,0,9,50,50
1745834624964,ECE 197,001,957920,Mercier; Patrick Philip,9992,0,9999,7
1745834625995,ECON 178,A01,907814,Zhu; Ying,28,0,35,7
1745834627025,EDS 115,A00,895312,Staff,41,0,45,4
1745834628052,EDS 117,A01,895337,Staff,30,0,30,0
1745834629080,EDS 125,A00,895341,Jones; Gabrielle Anastasia,43,0,45,2
1745834630106,EDS 128A,A01,895459,Fargason; Sharon Gayle,44,0,45,1
1745834631130,EDS 128B,A01,895543,Pappas; Elizabeth,44,0,45,1
1745834632155,EDS 139,A00,897203,Pappas; Elizabeth,44,0,45,1
1745834632155,EDS 139,B00,897209,Fargason; Sharon Gayle,44,0,45,1
1745834633184,EDS 201,A00,895545,Staff,43,0,45,2
1745834634217,EDS 203,A01,895581,Halter; Christopher P.,43,0,45,2
1745834635245,EDS 204R,A01,895625,Heinzman; Erica M.,43,0,45,2
1745834635245,EDS 204R,B01,895693,Halter; Christopher P.,18,0,45,27
1745834636275,EDS 206R,A00,895694,Fargason; Sharon Gayle,9,0,30,21
1745834636275,EDS 206R,B00,895695,Choi; Bailey Miyeon,20,0,30,10
1745834637305,EDS 250,A00,895697,Hemans; Patricia Ann Benitez,43,0,45,2
1745834638330,EDS 281,A00,895701,Meyerott; Theresa Ann,15,0,15,0
1745834639357,EDS 284,A00,895736,Meyerott; Theresa Ann,15,0,15,0
1745834640383,EDS 286,A00,897210,Fine; Sarah,15,0,15,0
1745834641414,EDS 289C,A01,895770,Daly; Alan J.,15,0,15,0
1745834642440,EDS 290,A00,897211,Hofstetter; Carolyn,15,0,15,0
1745834643471,LIGM 5A,A00,896162,Fischer-Grunski; Eva K,15,0,20,5
1745834644499,LIGM 5B,A00,896260,Fischer-Grunski; Eva K,17,0,20,3
1745834645530,LIGM 5C,A00,896308,Fischer-Grunski; Eva K,18,0,20,2
1745834646557,LIIT 5AS,A00,896313,Carnelos; Chiara,17,0,20,3
1745834647581,LIIT 5BS,A00,896416,Carnelos; Chiara,20,0,20,0
1745834648608,LIIT 5CS,A00,896564,Carnelos; Chiara,20,0,20,0
1745834649635,LISP 5A,A00,896588,Munoz Sanchez; Alicia,4,0,20,16
1745834650661,LISP 5B,A00,896653,Munoz Sanchez; Alicia,10,0,20,10
1745834651691,LISP 5C,A00,896655,Munoz Sanchez; Alicia,4,0,20,16
1745834652719,MAE 197,001,957918,Kleissl; Jan,9998,0,9999,1
1745834653747,MATH 2,A01,957937,Staff,34,0,35,1
1745834654774,MATH 197,001,957876,Kedlaya; Kiran S.,9993,0,9999,6
1745834655801,MCWP 40,A00,892729,Duru; Nur,13,0,20,7
1745834655801,MCWP 40,B00,893304,Montejo; Carolina,20,0,20,0
1745834656884,MCWP 40R,A00,893757,Redela; Pamela Morgan,0,7,20,20
1745834657911,MCWP 50,A00,893758,Morshed; Michael James,2,0,20,18
1745834657911,MCWP 50,B00,893761,Bartulis; Jason Michael,18,0,20,2
1745834658942,MCWP 50R,A00,893766,Compas; Sean Matthew,0,1,20,20
1745834658942,MCWP 50R,B00,893769,Carter; Jennifer A,0,0,20,20
1745834658942,MCWP 50R,C00,893771,Krone; Jarret,0,3,20,20
1745834658942,MCWP 50R,D00,893772,Miller; Elizabeth Deen,3,0,20,17
1745834658942,MCWP 50R,E00,893775,Carter; Andrea L,0,0,20,20
1745834659968,MMW 11R,A01,892721,Herbst; Matthew,11,0,27,16
1745834659968,MMW 11R,A02,892722,Herbst; Matthew,0,0,0,3
1745834660996,MMW 12R,A01,892724,Herbst; Matthew,0,10,16,16
1745834660996,MMW 12R,A02,892725,Herbst; Matthew,0,9,16,16
1745834662026,MMW 13R,A01,892727,Staff,0,3,16,16
1745834662026,MMW 13R,A02,892728,Staff,0,4,16,16
1745834662026,MMW 13R,A03,958032,Staff,0,3,16,16
1745834662026,MMW 13R,A04,958033,Staff,0,2,16,16
1745834662026,MMW 13R,A05,958034,Staff,0,3,16,16
1745834663056,SIO 295LS,A00,894015,Staff,7,0,25,18
1745834664084,SIO 295S,A00,894020,Staff,7,0,25,18
1745834665111,SIOC 290S,B01,958918,Staff,0,0,0,0
1745834666140,SIOC 291S,B01,958922,Staff,0,0,0,0
1745834667169,SOCI 117,A01,895339,Staff,4,0,5,1
1745834668198,WES 237B,A00,894149,Staff,11,0,20,9
1745834670291,AESE 279B,A00,891859,Staff,13,0,35,22
1745834671317,AIP 197,001,891854,Staff,70,0,70,0
1745834672345,ANTH 289S,A00,891856,Gagneux; Pascal,12,0,12,0
1745834673372,BENG 196,001,957946,Engler; Adam J.,9996,0,9999,3
1745834674397,CAT 124RS,A01,956906,Staff,8,0,25,17
1745834675423,CAT 125RS,A01,922013,Staff,8,0,25,17
1745834676448,CLRE 250,A00,891860,Morris; Sheldon,9995,0,9999,4
1745834678497,CLRE 251R,A00,907817,Mehta; Ravindra L.,9994,0,9999,5
1745834679525,CLRE 252,A00,891864,Cuomo; Raphael Eduardo,9993,0,9999,6
1745834680550,CLRE 253,A00,891867,Vaida; Florin,9994,0,9999,5
1745834680550,CLRE 253,B00,907819,Staff,9999,0,9999,0
1745834681579,CLRE 259,A00,891868,Patel; Hemal,9998,0,9999,1
1745834682604,CLRE 260,A00,891872,Cuomo; Raphael Eduardo,9999,0,9999,0
1745834683633,CLRE 297,001,891888,Cuomo; Raphael Eduardo,9999,0,9999,0
1745834684663,CSE 191,A00,958773,Minnes Kemp; Mor Mia,9999,0,9999,0
1745834685693,CSS 201S,A01,892054,Mignozzetti; Umberto,30,0,30,0
1745834686720,CSS 202S,A01,892056,Mignozzetti; Umberto,30,0,30,0
1745834687748,DSC 197,001,956898,Eldridge; Justin Matthew,9998,0,9999,1
1745834688774,DSC 297,001,958000,Mazumdar; Arya,9998,0,9999,1
1745834689842,EAP 100,A00,905686,Staff,9776,0,9999,223
1745834690867,ECE 45,A01,892618,Staff,0,13,50,50
1745834691893,ECE 109,A01,892620,Staff,0,43,0,0
1745834692919,ECE 111,A01,892719,Staff,0,9,50,50
1745834693944,ECE 197,001,957920,Mercier; Patrick Philip,9992,0,9999,7
1745834694971,ECON 178,A01,907814,Zhu; Ying,28,0,35,7
1745834695998,EDS 115,A00,895312,Staff,41,0,45,4
1745834697026,EDS 117,A01,895337,Staff,30,0,30,0
1745834698054,EDS 125,A00,895341,Jones; Gabrielle Anastasia,43,0,45,2
1745834699082,EDS 128A,A01,895459,Fargason; Sharon Gayle,44,0,45,1
1745834700108,EDS 128B,A01,895543,Pappas; Elizabeth,44,0,45,1
1745834701138,EDS 139,A00,897203,Pappas; Elizabeth,44,0,45,1
1745834701138,EDS 139,B00,897209,Fargason; Sharon Gayle,44,0,45,1
1745834702163,EDS 201,A00,895545,Staff,43,0,45,2
1745834703191,EDS 203,A01,895581,Halter; Christopher P.,43,0,45,2
1745834704218,EDS 204R,A01,895625,Heinzman; Erica M.,43,0,45,2
1745834704218,EDS 204R,B01,895693,Halter; Christopher P.,18,0,45,27
1745834705248,EDS 206R,A00,895694,Fargason; Sharon Gayle,9,0,30,21
1745834705248,EDS 206R,B00,895695,Choi; Bailey Miyeon,20,0,30,10
1745834706277,EDS 250,A00,895697,Hemans; Patricia Ann Benitez,43,0,45,2
1745834707304,EDS 281,A00,895701,Meyerott; Theresa Ann,15,0,15,0
1745834708333,EDS 284,A00,895736,Meyerott; Theresa Ann,15,0,15,0
1745834709362,EDS 286,A00,897210,Fine; Sarah,15,0,15,0
1745834710392,EDS 289C,A01,895770,Daly; Alan J.,15,0,15,0
1745834711418,EDS 290,A00,897211,Hofstetter; Carolyn,15,0,15,0
1745834712444,LIGM 5A,A00,896162,Fischer-Grunski; Eva K,15,0,20,5
1745834713475,LIGM 5B,A00,896260,Fischer-Grunski; Eva K,17,0,20,3
1745834714499,LIGM 5C,A00,896308,Fischer-Grunski; Eva K,18,0,20,2
1745834715530,LIIT 5AS,A00,896313,Carnelos; Chiara,17,0,20,3
1745834716559,LIIT 5BS,A00,896416,Carnelos; Chiara,20,0,20,0
1745834717585,LIIT 5CS,A00,896564,Carnelos; Chiara,20,0,20,0
1745834718610,LISP 5A,A00,896588,Munoz Sanchez; Alicia,4,0,20,16
1745834719635,LISP 5B,A00,896653,Munoz Sanchez; Alicia,10,0,20,10
1745834720662,LISP 5C,A00,896655,Munoz Sanchez; Alicia,4,0,20,16
1745834721691,MAE 197,001,957918,Kleissl; Jan,9998,0,9999,1
1745834722716,MATH 2,A01,957937,Staff,34,0,35,1
1745834723747,MATH 197,001,957876,Kedlaya; Kiran S.,9993,0,9999,6
1745834724779,MCWP 40,A00,892729,Duru; Nur,13,0,20,7
1745834724779,MCWP 40,B00,893304,Montejo; Carolina,20,0,20,0
1745834725804,MCWP 40R,A00,893757,Redela; Pamela Morgan,0,7,20,20
1745834726832,MCWP 50,A00,893758,Morshed; Michael James,2,0,20,18
1745834726832,MCWP 50,B00,893761,Bartulis; Jason Michael,18,0,20,2
1745834727860,MCWP 50R,A00,893766,Compas; Sean Matthew,0,1,20,20
1745834727860,MCWP 50R,B00,893769,Carter; Jennifer A,0,0,20,20
1745834727860,MCWP 50R,C00,893771,Krone; Jarret,0,3,20,20
1745834727860,MCWP 50R,D00,893772,Miller; Elizabeth Deen,3,0,20,17
1745834727860,MCWP 50R,E00,893775,Carter; Andrea L,0,0,20,20
1745834728885,MMW 11R,A01,892721,Herbst; Matthew,11,0,27,16
1745834728885,MMW 11R,A02,892722,Herbst; Matthew,0,0,0,3
1745834729915,MMW 12R,A01,892724,Herbst; Matthew,0,10,16,16
1745834729915,MMW 12R,A02,892725,Herbst; Matthew,0,9,16,16
1745834730942,MMW 13R,A01,892727,Staff,0,3,16,16
1745834730942,MMW 13R,A02,892728,Staff,0,4,16,16
1745834730942,MMW 13R,A03,958032,Staff,0,3,16,16
1745834730942,MMW 13R,A04,958033,Staff,0,2,16,16
1745834730942,MMW 13R,A05,958034,Staff,0,3,16,16
1745834731969,SIO 295LS,A00,894015,Staff,7,0,25,18
1745834732996,SIO 295S,A00,894020,Staff,7,0,25,18
1745834734021,SIOC 290S,B01,958918,Staff,0,0,0,0
1745834735052,SIOC 291S,B01,958922,Staff,0,0,0,0
1745834736080,SOCI 117,A01,895339,Staff,4,0,5,1
1745834737107,WES 237B,A00,894149,Staff,11,0,20,9
1745834739188,AESE 279B,A00,891859,Staff,13,0,35,22
1745834740214,AIP 197,001,891854,Staff,70,0,70,0
1745834741238,ANTH 289S,A00,891856,Gagneux; Pascal,12,0,12,0
1745834742263,BENG 196,001,957946,Engler; Adam J.,9996,0,9999,3
1745834743289,CAT 124RS,A01,956906,Staff,8,0,25,17
1745834744315,CAT 125RS,A01,922013,Staff,8,0,25,17
1745834745343,CLRE 250,A00,891860,Morris; Sheldon,9995,0,9999,4
1745834747396,CLRE 251R,A00,907817,Mehta; Ravindra L.,9994,0,9999,5
1745834748425,CLRE 252,A00,891864,Cuomo; Raphael Eduardo,9993,0,9999,6
1745834749451,CLRE 253,A00,891867,Vaida; Florin,9994,0,9999,5
1745834749451,CLRE 253,B00,907819,Staff,9999,0,9999,0
1745834750476,CLRE 259,A00,891868,Patel; Hemal,9998,0,9999,1
1745834751508,CLRE 260,A00,891872,Cuomo; Raphael Eduardo,9999,0,9999,0
1745834752534,CLRE 297,001,891888,Cuomo; Raphael Eduardo,9999,0,9999,0
1745834753560,CSE 191,A00,958773,Minnes Kemp; Mor Mia,9999,0,9999,0
1745834754590,CSS 201S,A01,892054,Mignozzetti; Umberto,30,0,30,0
1745834755619,CSS 202S,A01,892056,Mignozzetti; Umberto,30,0,30,0
1745834756649,DSC 197,001,956898,Eldridge; Justin Matthew,9998,0,9999,1
1745834757676,DSC 297,001,958000,Mazumdar; Arya,9998,0,9999,1
1745834758700,EAP 100,A00,905686,Staff,9776,0,9999,223
1745834759732,ECE 45,A01,892618,Staff,0,13,50,50
1745834760760,ECE 109,A01,892620,Staff,0,43,0,0
1745834761791,ECE 111,A01,892719,Staff,0,9,50,50
1745834762820,ECE 197,001,957920,Mercier; Patrick Philip,9992,0,9999,7
1745834763852,ECON 178,A01,907814,Zhu; Ying,28,0,35,7
1745834764881,EDS 115,A00,895312,Staff,41,0,45,4
1745834765907,EDS 117,A01,895337,Staff,30,0,30,0
1745834766935,EDS 125,A00,895341,Jones; Gabrielle Anastasia,43,0,45,2
1745834767962,EDS 128A,A01,895459,Fargason; Sharon Gayle,44,0,45,1
1745834768988,EDS 128B,A01,895543,Pappas; Elizabeth,44,0,45,1
1745834770015,EDS 139,A00,897203,Pappas; Elizabeth,44,0,45,1
1745834770015,EDS 139,B00,897209,Fargason; Sharon Gayle,44,0,45,1
1745834771040,EDS 201,A00,895545,Staff,43,0,45,2
1745834772067,EDS 203,A01,895581,Halter; Christopher P.,43,0,45,2
1745834773094,EDS 204R,A01,895625,Heinzman; Erica M.,43,0,45,2
1745834773094,EDS 204R,B01,895693,Halter; Christopher P.,18,0,45,27
1745834774125,EDS 206R,A00,895694,Fargason; Sharon Gayle,9,0,30,21
1745834774125,EDS 206R,B00,895695,Choi; Bailey Miyeon,20,0,30,10
1745834775150,EDS 250,A00,895697,Hemans; Patricia Ann Benitez,43,0,45,2
1745834776175,EDS 281,A00,895701,Meyerott; Theresa Ann,15,0,15,0
1745834777204,EDS 284,A00,895736,Meyerott; Theresa Ann,15,0,15,0
1745834778233,EDS 286,A00,897210,Fine; Sarah,15,0,15,0
1745834779259,EDS 289C,A01,895770,Daly; Alan J.,15,0,15,0
1745834780283,EDS 290,A00,897211,Hofstetter; Carolyn,15,0,15,0
1745834781310,LIGM 5A,A00,896162,Fischer-Grunski; Eva K,15,0,20,5
1745834782338,LIGM 5B,A00,896260,Fischer-Grunski; Eva K,17,0,20,3
1745834783366,LIGM 5C,A00,896308,Fischer-Grunski; Eva K,18,0,20,2
1745834784395,LIIT 5AS,A00,896313,Carnelos; Chiara,17,0,20,3
1745834785422,LIIT 5BS,A00,896416,Carnelos; Chiara,20,0,20,0
1745834786449,LIIT 5CS,A00,896564,Carnelos; Chiara,20,0,20,0
1745834787476,LISP 5A,A00,896588,Munoz Sanchez; Alicia,4,0,20,16
1745834788500,LISP 5B,A00,896653,Munoz Sanchez; Alicia,10,0,20,10
1745834789527,LISP 5C,A00,896655,Munoz Sanchez; Alicia,4,0,20,16
1745834790558,MAE 197,001,957918,Kleissl; Jan,9998,0,9999,1
1745834791582,MATH 2,A01,957937,Staff,34,0,35,1
1745834792612,MATH 197,001,957876,Kedlaya; Kiran S.,9993,0,9999,6
1745834793642,MCWP 40,A00,892729,Duru; Nur,13,0,20,7
1745834793642,MCWP 40,B00,893304,Montejo; Carolina,20,0,20,0
1745834794669,MCWP 40R,A00,893757,Redela; Pamela Morgan,0,7,20,20
1745834795695,MCWP 50,A00,893758,Morshed; Michael James,2,0,20,18
1745834795695,MCWP 50,B00,893761,Bartulis; Jason Michael,18,0,20,2
1745834796727,MCWP 50R,A00,893766,Compas; Sean Matthew,0,1,20,20
1745834796727,MCWP 50R,B00,893769,Carter; Jennifer A,0,0,20,20
1745834796727,MCWP 50R,C00,893771,Krone; Jarret,0,3,20,20
1745834796727,MCWP 50R,D00,893772,Miller; Elizabeth Deen,3,0,20,17
1745834796727,MCWP 50R,E00,893775,Carter; Andrea L,0,0,20,20
1745834797756,MMW 11R,A01,892721,Herbst; Matthew,11,0,27,16
1745834797756,MMW 11R,A02,892722,Herbst; Matthew,0,0,0,3
1745834798785,MMW 12R,A01,892724,Herbst; Matthew,0,10,16,16
1745834798785,MMW 12R,A02,892725,Herbst; Matthew,0,9,16,16
1745834799814,MMW 13R,A01,892727,Staff,0,3,16,16
1745834799814,MMW 13R,A02,892728,Staff,0,4,16,16
1745834799814,MMW 13R,A03,958032,Staff,0,3,16,16
1745834799814,MMW 13R,A04,958033,Staff,0,2,16,16
1745834799814,MMW 13R,A05,958034,Staff,0,3,16,16
1745834800841,SIO 295LS,A00,894015,Staff,7,0,25,18
1745834801868,SIO 295S,A00,894020,Staff,7,0,25,18
1745834802894,SIOC 290S,B01,958918,Staff,0,0,0,0
1745834803923,SIOC 291S,B01,958922,Staff,0,0,0,0
1745834804953,SOCI 117,A01,895339,Staff,4,0,5,1
1745834805982,WES 237B,A00,894149,Staff,11,0,20,9
1745834808045,AESE 279B,A00,891859,Staff,13,0,35,22
1745834809073,AIP 197,001,891854,Staff,70,0,70,0
1745834810100,ANTH 289S,A00,891856,Gagneux; Pascal,12,0,12,0
1745834811133,BENG 196,001,957946,Engler; Adam J.,9996,0,9999,3
1745834812164,CAT 124RS,A01,956906,Staff,8,0,25,17
1745834813193,CAT 125RS,A01,922013,Staff,8,0,25,17
1745834814218,CLRE 250,A00,891860,Morris; Sheldon,9995,0,9999,4
1745834816273,CLRE 251R,A00,907817,Mehta; Ravindra L.,9994,0,9999,5
1745834817299,CLRE 252,A00,891864,Cuomo; Raphael Eduardo,9993,0,9999,6
1745834818326,CLRE 253,A00,891867,Vaida; Florin,9994,0,9999,5
1745834818326,CLRE 253,B00,907819,Staff,9999,0,9999,0
1745834819356,CLRE 259,A00,891868,Patel; Hemal,9998,0,9999,1
1745834820387,CLRE 260,A00,891872,Cuomo; Raphael Eduardo,9999,0,9999,0
1745834821417,CLRE 297,001,891888,Cuomo; Raphael Eduardo,9999,0,9999,0
1745834822443,CSE 191,A00,958773,Minnes Kemp; Mor Mia,9999,0,9999,0
1745834823470,CSS 201S,A01,892054,Mignozzetti; Umberto,30,0,30,0
1745834824501,CSS 202S,A01,892056,Mignozzetti; Umberto,30,0,30,0
1745834825528,DSC 197,001,956898,Eldridge; Justin Matthew,9998,0,9999,1
1745834826553,DSC 297,001,958000,Mazumdar; Arya,9998,0,9999,1
1745834827578,EAP 100,A00,905686,Staff,9776,0,9999,223
1745834828608,ECE 45,A01,892618,Staff,0,13,50,50
1745834829633,ECE 109,A01,892620,Staff,0,43,0,0
1745834830658,ECE 111,A01,892719,Staff,0,9,50,50
1745834831684,ECE 197,001,957920,Mercier; Patrick Philip,9992,0,9999,7
1745834832708,ECON 178,A01,907814,Zhu; Ying,28,0,35,7
1745834833732,EDS 115,A00,895312,Staff,41,0,45,4
1745834834758,EDS 117,A01,895337,Staff,30,0,30,0
1745834835785,EDS 125,A00,895341,Jones; Gabrielle Anastasia,43,0,45,2
1745834836814,EDS 128A,A01,895459,Fargason; Sharon Gayle,44,0,45,1
1745834837842,EDS 128B,A01,895543,Pappas; Elizabeth,44,0,45,1
1745834838874,EDS 139,A00,897203,Pappas; Elizabeth,44,0,45,1
1745834838874,EDS 139,B00,897209,Fargason; Sharon Gayle,44,0,45,1
1745834839902,EDS 201,A00,895545,Staff,43,0,45,2
1745834840931,EDS 203,A01,895581,Halter; Christopher P.,43,0,45,2
1745834841958,EDS 204R,A01,895625,Heinzman; Erica M.,43,0,45,2
1745834841958,EDS 204R,B01,895693,Halter; Christopher P.,18,0,45,27
1745834842986,EDS 206R,A00,895694,Fargason; Sharon Gayle,9,0,30,21
1745834842986,EDS 206R,B00,895695,Choi; Bailey Miyeon,20,0,30,10
1745834844011,EDS 250,A00,895697,Hemans; Patricia Ann Benitez,43,0,45,2
1745834845042,EDS 281,A00,895701,Meyerott; Theresa Ann,15,0,15,0
1745834846071,EDS 284,A00,895736,Meyerott; Theresa Ann,15,0,15,0
1745834847100,EDS 286,A00,897210,Fine; Sarah,15,0,15,0
1745834848124,EDS 289C,A01,895770,Daly; Alan J.,15,0,15,0
1745834849153,EDS 290,A00,897211,Hofstetter; Carolyn,15,0,15,0
1745834850179,LIGM 5A,A00,896162,Fischer-Grunski; Eva K,15,0,20,5
1745834851212,LIGM 5B,A00,896260,Fischer-Grunski; Eva K,17,0,20,3
1745834852242,LIGM 5C,A00,896308,Fischer-Grunski; Eva K,18,0,20,2
1745834853268,LIIT 5AS,A00,896313,Carnelos; Chiara,17,0,20,3
1745834854298,LIIT 5BS,A00,896416,Carnelos; Chiara,20,0,20,0
1745834855325,LIIT 5CS,A00,896564,Carnelos; Chiara,20,0,20,0
1745834856354,LISP 5A,A00,896588,Munoz Sanchez; Alicia,4,0,20,16
1745834857383,LISP 5B,A00,896653,Munoz Sanchez; Alicia,10,0,20,10
1745834858414,LISP 5C,A00,896655,Munoz Sanchez; Alicia,4,0,20,16
1745834859440,MAE 197,001,957918,Kleissl; Jan,9998,0,9999,1
1745834860468,MATH 2,A01,957937,Staff,34,0,35,1
1745834861494,MATH 197,001,957876,Kedlaya; Kiran S.,9993,0,9999,6
1745834862525,MCWP 40,A00,892729,Duru; Nur,13,0,20,7
1745834862525,MCWP 40,B00,893304,Montejo; Carolina,20,0,20,0
1745834863556,MCWP 40R,A00,893757,Redela; Pamela Morgan,0,7,20,20
1745834864583,MCWP 50,A00,893758,Morshed; Michael James,2,0,20,18
1745834864583,MCWP 50,B00,893761,Bartulis; Jason Michael,18,0,20,2
1745834865618,MCWP 50R,A00,893766,Compas; Sean Matthew,0,1,20,20
1745834865618,MCWP 50R,B00,893769,Carter; Jennifer A,0,0,20,20
1745834865618,MCWP 50R,C00,893771,Krone; Jarret,0,3,20,20
1745834865618,MCWP 50R,D00,893772,Miller; Elizabeth Deen,3,0,20,17
1745834865618,MCWP 50R,E00,893775,Carter; Andrea L,0,0,20,20
1745834866643,MMW 11R,A01,892721,Herbst; Matthew,11,0,27,16
1745834866643,MMW 11R,A02,892722,Herbst; Matthew,0,0,0,3
1745834867673,MMW 12R,A01,892724,Herbst; Matthew,0,10,16,16
1745834867673,MMW 12R,A02,892725,Herbst; Matthew,0,9,16,16
1745834868938,MMW 13R,A01,892727,Staff,0,3,16,16
1745834868938,MMW 13R,A02,892728,Staff,0,4,16,16
1745834868938,MMW 13R,A03,958032,Staff,0,3,16,16
1745834868938,MMW 13R,A04,958033,Staff,0,2,16,16
1745834868938,MMW 13R,A05,958034,Staff,0,3,16,16
1745834869963,SIO 295LS,A00,894015,Staff,7,0,25,18
1745834870988,SIO 295S,A00,894020,Staff,7,0,25,18
1745834872018,SIOC 290S,B01,958918,Staff,0,0,0,0
1745834873044,SIOC 291S,B01,958922,Staff,0,0,0,0
1745834874073,SOCI 117,A01,895339,Staff,4,0,5,1
1745834875098,WES 237B,A00,894149,Staff,11,0,20,9
1745834877172,AESE 279B,A00,891859,Staff,13,0,35,22
1745834878202,AIP 197,001,891854,Staff,70,0,70,0
1745834879232,ANTH 289S,A00,891856,Gagneux; Pascal,12,0,12,0
1745834880259,BENG 196,001,957946,Engler; Adam J.,9996,0,9999,3
1745834881290,CAT 124RS,A01,956906,Staff,8,0,25,17
1745834882322,CAT 125RS,A01,922013,Staff,8,0,25,17
1745834883348,CLRE 250,A00,891860,Morris; Sheldon,9995,0,9999,4
1745834885406,CLRE 251R,A00,907817,Mehta; Ravindra L.,9994,0,9999,5
1745834886433,CLRE 252,A00,891864,Cuomo; Raphael Eduardo,9993,0,9999,6
1745834887459,CLRE 253,A00,891867,Vaida; Florin,9994,0,9999,5
1745834887459,CLRE 253,B00,907819,Staff,9999,0,9999,0
1745834888489,CLRE 259,A00,891868,Patel; Hemal,9998,0,9999,1
1745834889520,CLRE 260,A00,891872,Cuomo; Raphael Eduardo,9999,0,9999,0
1745834890546,CLRE 297,001,891888,Cuomo; Raphael Eduardo,9999,0,9999,0
1745834891577,CSE 191,A00,958773,Minnes Kemp; Mor Mia,9999,0,9999,0
1745834892603,CSS 201S,A01,892054,Mignozzetti; Umberto,30,0,30,0
1745834893632,CSS 202S,A01,892056,Mignozzetti; Umberto,30,0,30,0
1745834894667,DSC 197,001,956898,Eldridge; Justin Matthew,9998,0,9999,1
1745834895697,DSC 297,001,958000,Mazumdar; Arya,9998,0,9999,1
1745834896725,EAP 100,A00,905686,Staff,9776,0,9999,223
1745834897794,ECE 45,A01,892618,Staff,0,13,50,50
1745834898820,ECE 109,A01,892620,Staff,0,43,0,0
1745834899846,ECE 111,A01,892719,Staff,0,9,50,50
1745834900875,ECE 197,001,957920,Mercier; Patrick Philip,9992,0,9999,7
1745834901905,ECON 178,A01,907814,Zhu; Ying,28,0,35,7
1745834902934,EDS 115,A00,895312,Staff,41,0,45,4
1745834903961,EDS 117,A01,895337,Staff,30,0,30,0
1745834904988,EDS 125,A00,895341,Jones; Gabrielle Anastasia,43,0,45,2
1745834906016,EDS 128A,A01,895459,Fargason; Sharon Gayle,44,0,45,1
1745834907044,EDS 128B,A01,895543,Pappas; Elizabeth,44,0,45,1
1745834908069,EDS 139,A00,897203,Pappas; Elizabeth,44,0,45,1
1745834908069,EDS 139,B00,897209,Fargason; Sharon Gayle,44,0,45,1
1745834909099,EDS 201,A00,895545,Staff,43,0,45,2
1745834910126,EDS 203,A01,895581,Halter; Christopher P.,43,0,45,2
1745834911159,EDS 204R,A01,895625,Heinzman; Erica M.,43,0,45,2
1745834911159,EDS 204R,B01,895693,Halter; Christopher P.,18,0,45,27
1745834912185,EDS 206R,A00,895694,Fargason; Sharon Gayle,9,0,30,21
1745834912185,EDS 206R,B00,895695,Choi; Bailey Miyeon,20,0,30,10
1745834913213,EDS 250,A00,895697,Hemans; Patricia Ann Benitez,43,0,45,2
1745834914240,EDS 281,A00,895701,Meyerott; Theresa Ann,15,0,15,0
1745834915267,EDS 284,A00,895736,Meyerott; Theresa Ann,15,0,15,0
1745834916294,EDS 286,A00,897210,Fine; Sarah,15,0,15,0
1745834917321,EDS 289C,A01,895770,Daly; Alan J.,15,0,15,0
1745834918348,EDS 290,A00,897211,Hofstetter; Carolyn,15,0,15,0
1745834919380,LIGM 5A,A00,896162,Fischer-Grunski; Eva K,15,0,20,5
1745834920409,LIGM 5B,A00,896260,Fischer-Grunski; Eva K,17,0,20,3
1745834921436,LIGM 5C,A00,896308,Fischer-Grunski; Eva K,18,0,20,2
1745834922462,LIIT 5AS,A00,896313,Carnelos; Chiara,17,0,20,3
1745834923491,LIIT 5BS,A00,896416,Carnelos; Chiara,20,0,20,0
1745834924522,LIIT 5CS,A00,896564,Carnelos; Chiara,20,0,20,0
1745834925547,LISP 5A,A00,896588,Munoz Sanchez; Alicia,4,0,20,16
1745834926577,LISP 5B,A00,896653,Munoz Sanchez; Alicia,10,0,20,10
1745834927605,LISP 5C,A00,896655,Munoz Sanchez; Alicia,4,0,20,16
1745834928635,MAE 197,001,957918,Kleissl; Jan,9998,0,9999,1
1745834929661,MATH 2,A01,957937,Staff,34,0,35,1
1745834930690,MATH 197,001,957876,Kedlaya; Kiran S.,9993,0,9999,6
1745834931716,MCWP 40,A00,892729,Duru; Nur,13,0,20,7
1745834931716,MCWP 40,B00,893304,Montejo; Carolina,20,0,20,0
1745834932743,MCWP 40R,A00,893757,Redela; Pamela Morgan,0,7,20,20
1745834933769,MCWP 50,A00,893758,Morshed; Michael James,2,0,20,18
1745834933769,MCWP 50,B00,893761,Bartulis; Jason Michael,18,0,20,2
1745834934797,MCWP 50R,A00,893766,Compas; Sean Matthew,0,1,20,20
1745834934797,MCWP 50R,B00,893769,Carter; Jennifer A,0,0,20,20
1745834934797,MCWP 50R,C00,893771,Krone; Jarret,0,3,20,20
1745834934797,MCWP 50R,D00,893772,Miller; Elizabeth Deen,3,0,20,17
1745834934797,MCWP 50R,E00,893775,Carter; Andrea L,0,0,20,20
1745834935828,MMW 11R,A01,892721,Herbst; Matthew,11,0,27,16
1745834935828,MMW 11R,A02,892722,Herbst; Matthew,0,0,0,3
1745834936854,MMW 12R,A01,892724,Herbst; Matthew,0,10,16,16
1745834936854,MMW 12R,A02,892725,Herbst; Matthew,0,9,16,16
1745834937885,MMW 13R,A01,892727,Staff,0,3,16,16
1745834937885,MMW 13R,A02,892728,Staff,0,4,16,16
1745834937885,MMW 13R,A03,958032,Staff,0,3,16,16
1745834937885,MMW 13R,A04,958033,Staff,0,2,16,16
1745834937885,MMW 13R,A05,958034,Staff,0,3,16,16
1745834938912,SIO 295LS,A00,894015,Staff,7,0,25,18
1745834939939,SIO 295S,A00,894020,Staff,7,0,25,18
1745834940965,SIOC 290S,B01,958918,Staff,0,0,0,0
1745834941992,SIOC 291S,B01,958922,Staff,0,0,0,0
1745834943019,SOCI 117,A01,895339,Staff,4,0,5,1
1745834944052,WES 237B,A00,894149,Staff,11,0,20,9
1745834946141,AESE 279B,A00,891859,Staff,13,0,35,22
1745834947172,AIP 197,001,891854,Staff,70,0,70,0
1745834948198,ANTH 289S,A00,891856,Gagneux; Pascal,12,0,12,0
1745834949226,BENG 196,001,957946,Engler; Adam J.,9996,0,9999,3
1745834950252,CAT 124RS,A01,956906,Staff,8,0,25,17
1745834951283,CAT 125RS,A01,922013,Staff,8,0,25,17
1745834952308,CLRE 250,A00,891860,Morris; Sheldon,9995,0,9999,4
1745834954368,CLRE 251R,A00,907817,Mehta; Ravindra L.,9994,0,9999,5
1745834955395,CLRE 252,A00,891864,Cuomo; Raphael Eduardo,9993,0,9999,6
1745834956427,CLRE 253,A00,891867,Vaida; Florin,9994,0,9999,5
1745834956427,CLRE 253,B00,907819,Staff,9999,0,9999,0
1745834957480,CLRE 259,A00,891868,Patel; Hemal,9998,0,9999,1
1745834958509,CLRE 260,A00,891872,Cuomo; Raphael Eduardo,9999,0,9999,0
1745834959537,CLRE 297,001,891888,Cuomo; Raphael Eduardo,9999,0,9999,0
1745834960565,CSE 191,A00,958773,Minnes Kemp; Mor Mia,9999,0,9999,0
1745834961592,CSS 201S,A01,892054,Mignozzetti; Umberto,30,0,30,0
1745834962621,CSS 202S,A01,892056,Mignozzetti; Umberto,30,0,30,0
1745834963650,DSC 197,001,956898,Eldridge; Justin Matthew,9998,0,9999,1
1745834964677,DSC 297,001,958000,Mazumdar; Arya,9998,0,9999,1
1745834965707,EAP 100,A00,905686,Staff,9776,0,9999,223
1745834966737,ECE 45,A01,892618,Staff,0,13,50,50
1745834967766,ECE 109,A01,892620,Staff,0,43,0,0
1745834968793,ECE 111,A01,892719,Staff,0,9,50,50
1745834969819,ECE 197,001,957920,Mercier; Patrick Philip,9992,0,9999,7
1745834970847,ECON 178,A01,907814,Zhu; Ying,28,0,35,7
1745834971876,EDS 115,A00,895312,Staff,41,0,45,4
1745834972903,EDS 117,A01,895337,Staff,30,0,30,0
1745834973928,EDS 125,A00,895341,Jones; Gabrielle Anastasia,43,0,45,2
1745834974956,EDS 128A,A01,895459,Fargason; Sharon Gayle,44,0,45,1
1745834975986,EDS 128B,A01,895543,Pappas; Elizabeth,44,0,45,1
1745834977017,EDS 139,A00,897203,Pappas; Elizabeth,44,0,45,1
1745834977017,EDS 139,B00,897209,Fargason; Sharon Gayle,44,0,45,1
1745834978043,EDS 201,A00,895545,Staff,43,0,45,2
1745834979071,EDS 203,A01,895581,Halter; Christopher P.,43,0,45,2
1745834980103,EDS 204R,A01,895625,Heinzman; Erica M.,43,0,45,2
1745834980103,EDS 204R,B01,895693,Halter; Christopher P.,18,0,45,27
1745834981130,EDS 206R,A00,895694,Fargason; Sharon Gayle,9,0,30,21
1745834981130,EDS 206R,B00,895695,Choi; Bailey Miyeon,20,0,30,10
1745834982154,EDS 250,A00,895697,Hemans; Patricia Ann Benitez,43,0,45,2
1745834983181,EDS 281,A00,895701,Meyerott; Theresa Ann,15,0,15,0
1745834984213,EDS 284,A00,895736,Meyerott; Theresa Ann,15,0,15,0
1745834985243,EDS 286,A00,897210,Fine; Sarah,15,0,15,0
1745834986270,EDS 289C,A01,895770,Daly; Alan J.,15,0,15,0
1745834987297,EDS 290,A00,897211,Hofstetter; Carolyn,15,0,15,0
1745834988328,LIGM 5A,A00,896162,Fischer-Grunski; Eva K,15,0,20,5
1745834989355,LIGM 5B,A00,896260,Fischer-Grunski; Eva K,17,0,20,3
1745834990382,LIGM 5C,A00,896308,Fischer-Grunski; Eva K,18,0,20,2
1745834991413,LIIT 5AS,A00,896313,Carnelos; Chiara,17,0,20,3
1745834992443,LIIT 5BS,A00,896416,Carnelos; Chiara,20,0,20,0
1745834993471,LIIT 5CS,A00,896564,Carnelos; Chiara,20,0,20,0
1745834994498,LISP 5A,A00,896588,Munoz Sanchez; Alicia,4,0,20,16
1745834995527,LISP 5B,A00,896653,Munoz Sanchez; Alicia,10,0,20,10
1745834996560,LISP 5C,A00,896655,Munoz Sanchez; Alicia,4,0,20,16
1745834997647,MAE 197,001,957918,Kleissl; Jan,9998,0,9999,1
1745834998675,MATH 2,A01,957937,Staff,34,0,35,1
1745834999705,MATH 197,001,957876,Kedlaya; Kiran S.,9993,0,9999,6
1745835000732,MCWP 40,A00,892729,Duru; Nur,13,0,20,7
1745835000732,MCWP 40,B00,893304,Montejo; Carolina,20,0,20,0
1745835001814,MCWP 40R,A00,893757,Redela; Pamela Morgan,0,7,20,20
1745835002842,MCWP 50,A00,893758,Morshed; Michael James,2,0,20,18
1745835002842,MCWP 50,B00,893761,Bartulis; Jason Michael,18,0,20,2
1745835003871,MCWP 50R,A00,893766,Compas; Sean Matthew,0,1,20,20
1745835003871,MCWP 50R,B00,893769,Carter; Jennifer A,0,0,20,20
1745835003871,MCWP 50R,C00,893771,Krone; Jarret,0,3,20,20
1745835003871,MCWP 50R,D00,893772,Miller; Elizabeth Deen,3,0,20,17
1745835003871,MCWP 50R,E00,893775,Carter; Andrea L,0,0,20,20
1745835004899,MMW 11R,A01,892721,Herbst; Matthew,11,0,27,16
1745835004899,MMW 11R,A02,892722,Herbst; Matthew,0,0,0,3
1745835005925,MMW 12R,A01,892724,Herbst; Matthew,0,10,16,16
1745835005925,MMW 12R,A02,892725,Herbst; Matthew,0,9,16,16
1745835006953,MMW 13R,A01,892727,Staff,0,3,16,16
1745835006953,MMW 13R,A02,892728,Staff,0,4,16,16
1745835006953,MMW 13R,A03,958032,Staff,0,3,16,16
1745835006953,MMW 13R,A04,958033,Staff,0,2,16,16
1745835006953,MMW 13R,A05,958034,Staff,0,3,16,16
1745835007983,SIO 295LS,A00,894015,Staff,7,0,25,18
1745835009011,SIO 295S,A00,894020,Staff,7,0,25,18
1745835010044,SIOC 290S,B01,958918,Staff,0,0,0,0
1745835011075,SIOC 291S,B01,958922,Staff,0,0,0,0
1745835012105,SOCI 117,A01,895339,Staff,4,0,5,1
1745835013133,WES 237B,A00,894149,Staff,11,0,20,9
1745835015219,AESE 279B,A00,891859,Staff,13,0,35,22
1745835016246,AIP 197,001,891854,Staff,70,0,70,0
1745835017276,ANTH 289S,A00,891856,Gagneux; Pascal,12,0,12,0
1745835018302,BENG 196,001,957946,Engler; Adam J.,9996,0,9999,3
1745835019328,CAT 124RS,A01,956906,Staff,8,0,25,17
1745835020354,CAT 125RS,A01,922013,Staff,8,0,25,17
1745835021382,CLRE 250,A00,891860,Morris; Sheldon,9995,0,9999,4
1745835023438,CLRE 251R,A00,907817,Mehta; Ravindra L.,9994,0,9999,5
1745835024469,CLRE 252,A00,891864,Cuomo; Raphael Eduardo,9993,0,9999,6
1745835025496,CLRE 253,A00,891867,Vaida; Florin,9994,0,9999,5
1745835025496,CLRE 253,B00,907819,Staff,9999,0,9999,0
1745835026525,CLRE 259,A00,891868,Patel; Hemal,9998,0,9999,1
1745835027552,CLRE 260,A00,891872,Cuomo; Raphael Eduardo,9999,0,9999,0
1745835028578,CLRE 297,001,891888,Cuomo; Raphael Eduardo,9999,0,9999,0
1745835029604,CSE 191,A00,958773,Minnes Kemp; Mor Mia,9999,0,9999,0
1745835030632,CSS 201S,A01,892054,Mignozzetti; Umberto,30,0,30,0
1745835031660,CSS 202S,A01,892056,Mignozzetti; Umberto,30,0,30,0
1745835032687,DSC 197,001,956898,Eldridge; Justin Matthew,9998,0,9999,1
1745835033711,DSC 297,001,958000,Mazumdar; Arya,9998,0,9999,1
1745835034737,EAP 100,A00,905686,Staff,9776,0,9999,223
1745835035766,ECE 45,A01,892618,Staff,0,13,50,50
1745835036792,ECE 109,A01,892620,Staff,0,43,0,0
1745835037818,ECE 111,A01,892719,Staff,0,9,50,50
1745835038845,ECE 197,001,957920,Mercier; Patrick Philip,9992,0,9999,7
1745835039871,ECON 178,A01,907814,Zhu; Ying,28,0,35,7
1745835040896,EDS 115,A00,895312,Staff,41,0,45,4
1745835041923,EDS 117,A01,895337,Staff,30,0,30,0
1745835042953,EDS 125,A00,895341,Jones; Gabrielle Anastasia,43,0,45,2
1745835043982,EDS 128A,A01,895459,Fargason; Sharon Gayle,44,0,45,1
1745835045013,EDS 128B,A01,895543,Pappas; Elizabeth,44,0,45,1
1745835046038,EDS 139,A00,897203,Pappas; Elizabeth,44,0,45,1
1745835046038,EDS 139,B00,897209,Fargason; Sharon Gayle,44,0,45,1
1745835047061,EDS 201,A00,895545,Staff,43,0,45,2
1745835048087,EDS 203,A01,895581,Halter; Christopher P.,43,0,45,2
1745835049113,EDS 204R,A01,895625,Heinzman; Erica M.,43,0,45,2
1745835049113,EDS 204R,B01,895693,Halter; Christopher P.,18,0,45,27
1745835050145,EDS 206R,A00,895694,Fargason; Sharon Gayle,9,0,30,21
1745835050145,EDS 206R,B00,895695,Choi; Bailey Miyeon,20,0,30,10
1745835051171,EDS 250,A00,895697,Hemans; Patricia Ann Benitez,43,0,45,2
1745835052197,EDS 281,A00,895701,Meyerott; Theresa Ann,15,0,15,0
1745835053226,EDS 284,A00,895736,Meyerott; Theresa Ann,15,0,15,0
1745835054253,EDS 286,A00,897210,Fine; Sarah,15,0,15,0
1745835055284,EDS 289C,A01,895770,Daly; Alan J.,15,0,15,0
1745835056313,EDS 290,A00,897211,Hofstetter; Carolyn,15,0,15,0
1745835057339,LIGM 5A,A00,896162,Fischer-Grunski; Eva K,15,0,20,5
1745835058369,LIGM 5B,A00,896260,Fischer-Grunski; Eva K,17,0,20,3
1745835059394,LIGM 5C,A00,896308,Fischer-Grunski; Eva K,18,0,20,2
1745835060422,LIIT 5AS,A00,896313,Carnelos; Chiara,17,0,20,3
1745835061451,LIIT 5BS,A00,896416,Carnelos; Chiara,20,0,20,0
1745835062484,LIIT 5CS,A00,896564,Carnelos; Chiara,20,0,20,0
1745835063514,LISP 5A,A00,896588,Munoz Sanchez; Alicia,4,0,20,16
1745835064543,LISP 5B,A00,896653,Munoz Sanchez; Alicia,10,0,20,10
1745835065573,LISP 5C,A00,896655,Munoz Sanchez; Alicia,4,0,20,16
1745835066599,MAE 197,001,957918,Kleissl; Jan,9998,0,9999,1
1745835067627,MATH 2,A01,957937,Staff,34,0,35,1
1745835068657,MATH 197,001,957876,Kedlaya; Kiran S.,9993,0,9999,6
1745835069683,MCWP 40,A00,892729,Duru; Nur,13,0,20,7
1745835069683,MCWP 40,B00,893304,Montejo; Carolina,20,0,20,0
1745835070711,MCWP 40R,A00,893757,Redela; Pamela Morgan,0,7,20,20
1745835071738,MCWP 50,A00,893758,Morshed; Michael James,2,0,20,18
1745835071738,MCWP 50,B00,893761,Bartulis; Jason Michael,18,0,20,2
1745835072770,MCWP 50R,A00,893766,Compas; Sean Matthew,0,1,20,20
1745835072770,MCWP 50R,B00,893769,Carter; Jennifer A,0,0,20,20
1745835072770,MCWP 50R,C00,893771,Krone; Jarret,0,3,20,20
1745835072770,MCWP 50R,D00,893772,Miller; Elizabeth Deen,3,0,20,17
1745835072770,MCWP 50R,E00,893775,Carter; Andrea L,0,0,20,20
1745835073798,MMW 11R,A01,892721,Herbst; Matthew,11,0,27,16
1745835073798,MMW 11R,A02,892722,Herbst; Matthew,0,0,0,3
1745835074825,MMW 12R,A01,892724,Herbst; Matthew,0,10,16,16
1745835074825,MMW 12R,A02,892725,Herbst; Matthew,0,9,16,16
1745835075853,MMW 13R,A01,892727,Staff,0,3,16,16
1745835075853,MMW 13R,A02,892728,Staff,0,4,16,16
1745835075853,MMW 13R,A03,958032,Staff,0,3,16,16
1745835075853,MMW 13R,A04,958033,Staff,0,2,16,16
1745835075853,MMW 13R,A05,958034,Staff,0,3,16,16
1745835076881,SIO 295LS,A00,894015,Staff,7,0,25,18
1745835077909,SIO 295S,A00,894020,Staff,7,0,25,18
1745835078933,SIOC 290S,B01,958918,Staff,0,0,0,0
1745835079961,SIOC 291S,B01,958922,Staff,0,0,0,0
1745835080987,SOCI 117,A01,895339,Staff,4,0,5,1
1745835082012,WES 237B,A00,894149,Staff,11,0,20,9
1745835084087,AESE 279B,A00,891859,Staff,13,0,35,22
1745835085116,AIP 197,001,891854,Staff,70,0,70,0
1745835086147,ANTH 289S,A00,891856,Gagneux; Pascal,12,0,12,0
1745835087175,BENG 196,001,957946,Engler; Adam J.,9996,0,9999,3
1745835088202,CAT 124RS,A01,956906,Staff,8,0,25,17
1745835089228,CAT 125RS,A01,922013,Staff,8,0,25,17
1745835090254,CLRE 250,A00,891860,Morris; Sheldon,9995,0,9999,4
1745835092308,CLRE 251R,A00,907817,Mehta; Ravindra L.,9994,0,9999,5
1745835093335,CLRE 252,A00,891864,Cuomo; Raphael Eduardo,9993,0,9999,6
1745835094362,CLRE 253,A00,891867,Vaida; Florin,9994,0,9999,5
1745835094362,CLRE 253,B00,907819,Staff,9999,0,9999,0
1745835095389,CLRE 259,A00,891868,Patel; Hemal,9998,0,9999,1
1745835096415,CLRE 260,A00,891872,Cuomo; Raphael Eduardo,9999,0,9999,0
1745835097444,CLRE 297,001,891888,Cuomo; Raphael Eduardo,9999,0,9999,0
1745835098472,CSE 191,A00,958773,Minnes Kemp; Mor Mia,9999,0,9999,0
1745835099501,CSS 201S,A01,892054,Mignozzetti; Umberto,30,0,30,0
1745835100525,CSS 202S,A01,892056,Mignozzetti; Umberto,30,0,30,0
1745835101554,DSC 197,001,956898,Eldridge; Justin Matthew,9998,0,9999,1
1745835102584,DSC 297,001,958000,Mazumdar; Arya,9998,0,9999,1
1745835103612,EAP 100,A00,905686,Staff,9776,0,9999,223
1745835104640,ECE 45,A01,892618,Staff,0,13,50,50
1745835105671,ECE 109,A01,892620,Staff,0,43,0,0
1745835106699,ECE 111,A01,892719,Staff,0,9,50,50
1745835107726,ECE 197,001,957920,Mercier; Patrick Philip,9992,0,9999,7
1745835108754,ECON 178,A01,907814,Zhu; Ying,28,0,35,7
1745835109782,EDS 115,A00,895312,Staff,41,0,45,4
1745835110809,EDS 117,A01,895337,Staff,30,0,30,0
1745835111864,EDS 125,A00,895341,Jones; Gabrielle Anastasia,43,0,45,2
1745835112891,EDS 128A,A01,895459,Fargason; Sharon Gayle,44,0,45,1
1745835113919,EDS 128B,A01,895543,Pappas; Elizabeth,44,0,45,1
1745835114946,EDS 139,A00,897203,Pappas; Elizabeth,44,0,45,1
1745835114946,EDS 139,B00,897209,Fargason; Sharon Gayle,44,0,45,1
1745835115972,EDS 201,A00,895545,Staff,43,0,45,2
1745835117000,EDS 203,A01,895581,Halter; Christopher P.,43,0,45,2
1745835118026,EDS 204R,A01,895625,Heinzman; Erica M.,43,0,45,2
1745835118026,EDS 204R,B01,895693,Halter; Christopher P.,18,0,45,27
1745835119052,EDS 206R,A00,895694,Fargason; Sharon Gayle,9,0,30,21
1745835119052,EDS 206R,B00,895695,Choi; Bailey Miyeon,20,0,30,10
1745835120079,EDS 250,A00,895697,Hemans; Patricia Ann Benitez,43,0,45,2
1745835121107,EDS 281,A00,895701,Meyerott; Theresa Ann,15,0,15,0
1745835122136,EDS 284,A00,895736,Meyerott; Theresa Ann,15,0,15,0
1745835123165,EDS 286,A00,897210,Fine; Sarah,15,0,15,0
1745835124192,EDS 289C,A01,895770,Daly; Alan J.,15,0,15,0
1745835125223,EDS 290,A00,897211,Hofstetter; Carolyn,15,0,15,0
1745835126250,LIGM 5A,A00,896162,Fischer-Grunski; Eva K,15,0,20,5
1745835127281,LIGM 5B,A00,896260,Fischer-Grunski; Eva K,17,0,20,3
1745835128312,LIGM 5C,A00,896308,Fischer-Grunski; Eva K,18,0,20,2
1745835129345,LIIT 5AS,A00,896313,Carnelos; Chiara,17,0,20,3
1745835130373,LIIT 5BS,A00,896416,Carnelos; Chiara,20,0,20,0
1745835131397,LIIT 5CS,A00,896564,Carnelos; Chiara,20,0,20,0
1745835132423,LISP 5A,A00,896588,Munoz Sanchez; Alicia,4,0,20,16
1745835133450,LISP 5B,A00,896653,Munoz Sanchez; Alicia,10,0,20,10
1745835134479,LISP 5C,A00,896655,Munoz Sanchez; Alicia,4,0,20,16
1745835135506,MAE 197,001,957918,Kleissl; Jan,9998,0,9999,1
1745835136533,MATH 2,A01,957937,Staff,34,0,35,1
1745835137562,MATH 197,001,957876,Kedlaya; Kiran S.,9993,0,9999,6
1745835138591,MCWP 40,A00,892729,Duru; Nur,13,0,20,7
1745835138591,MCWP 40,B00,893304,Montejo; Carolina,20,0,20,0
1745835139617,MCWP 40R,A00,893757,Redela; Pamela Morgan,0,7,20,20
1745835140647,MCWP 50,A00,893758,Morshed; Michael James,2,0,20,18
1745835140647,MCWP 50,B00,893761,Bartulis; Jason Michael,18,0,20,2
1745835141677,MCWP 50R,A00,893766,Compas; Sean Matthew,0,1,20,20
1745835141677,MCWP 50R,B00,893769,Carter; Jennifer A,0,0,20,20
1745835141677,MCWP 50R,C00,893771,Krone; Jarret,0,3,20,20
1745835141677,MCWP 50R,D00,893772,Miller; Elizabeth Deen,3,0,20,17
1745835141677,MCWP 50R,E00,893775,Carter; Andrea L,0,0,20,20
1745835142704,MMW 11R,A01,892721,Herbst; Matthew,11,0,27,16
1745835142704,MMW 11R,A02,892722,Herbst; Matthew,0,0,0,3
1745835143733,MMW 12R,A01,892724,Herbst; Matthew,0,10,16,16
1745835143733,MMW 12R,A02,892725,Herbst; Matthew,0,9,16,16
1745835144763,MMW 13R,A01,892727,Staff,0,3,16,16
1745835144763,MMW 13R,A02,892728,Staff,0,4,16,16
1745835144763,MMW 13R,A03,958032,Staff,0,3,16,16
1745835144763,MMW 13R,A04,958033,Staff,0,2,16,16
1745835144763,MMW 13R,A05,958034,Staff,0,3,16,16
1745835145790,SIO 295LS,A00,894015,Staff,7,0,25,18
1745835146820,SIO 295S,A00,894020,Staff,7,0,25,18
1745835147850,SIOC 290S,B01,958918,Staff,0,0,0,0
1745835148881,SIOC 291S,B01,958922,Staff,0,0,0,0
1745835149909,SOCI 117,A01,895339,Staff,4,0,5,1
1745835150935,WES 237B,A00,894149,Staff,11,0,20,9
1745835153013,AESE 279B,A00,891859,Staff,13,0,35,22
1745835154044,AIP 197,001,891854,Staff,70,0,70,0
1745835155075,ANTH 289S,A00,891856,Gagneux; Pascal,12,0,12,0
1745835156103,BENG 196,001,957946,Engler; Adam J.,9996,0,9999,3
1745835157133,CAT 124RS,A01,956906,Staff,8,0,25,17
1745835158160,CAT 125RS,A01,922013,Staff,8,0,25,17
1745835159188,CLRE 250,A00,891860,Morris; Sheldon,9995,0,9999,4
1745835161241,CLRE 251R,A00,907817,Mehta; Ravindra L.,9994,0,9999,5
1745835162266,CLRE 252,A00,891864,Cuomo; Raphael Eduardo,9993,0,9999,6
1745835163291,CLRE 253,A00,891867,Vaida; Florin,9994,0,9999,5
1745835163291,CLRE 253,B00,907819,Staff,9999,0,9999,0
1745835164318,CLRE 259,A00,891868,Patel; Hemal,9998,0,9999,1
1745835165344,CLRE 260,A00,891872,Cuomo; Raphael Eduardo,9999,0,9999,0
1745835166371,CLRE 297,001,891888,Cuomo; Raphael Eduardo,9999,0,9999,0
1745835167396,CSE 191,A00,958773,Minnes Kemp; Mor Mia,9999,0,9999,0
1745835168423,CSS 201S,A01,892054,Mignozzetti; Umberto,30,0,30,0
1745835169449,CSS 202S,A01,892056,Mignozzetti; Umberto,30,0,30,0
1745835170476,DSC 197,001,956898,Eldridge; Justin Matthew,9998,0,9999,1
1745835171503,DSC 297,001,958000,Mazumdar; Arya,9998,0,9999,1
1745835172530,EAP 100,A00,905686,Staff,9776,0,9999,223
1745835173556,ECE 45,A01,892618,Staff,0,13,50,50
1745835174583,ECE 109,A01,892620,Staff,0,43,0,0
1745835175608,ECE 111,A01,892719,Staff,0,9,50,50
1745835176633,ECE 197,001,957920,Mercier; Patrick Philip,9992,0,9999,7
1745835177659,ECON 178,A01,907814,Zhu; Ying,28,0,35,7
1745835178685,EDS 115,A00,895312,Staff,41,0,45,4
1745835179716,EDS 117,A01,895337,Staff,30,0,30,0
1745835180741,EDS 125,A00,895341,Jones; Gabrielle Anastasia,43,0,45,2
1745835181770,EDS 128A,A01,895459,Fargason; Sharon Gayle,44,0,45,1
1745835182801,EDS 128B,A01,895543,Pappas; Elizabeth,44,0,45,1
1745835183831,EDS 139,A00,897203,Pappas; Elizabeth,44,0,45,1
1745835183831,EDS 139,B00,897209,Fargason; Sharon Gayle,44,0,45,1
1745835184857,EDS 201,A00,895545,Staff,43,0,45,2
1745835185887,EDS 203,A01,895581,Halter; Christopher P.,43,0,45,2
1745835186916,EDS 204R,A01,895625,Heinzman; Erica M.,43,0,45,2
1745835186916,EDS 204R,B01,895693,Halter; Christopher P.,18,0,45,27
1745835187946,EDS 206R,A00,895694,Fargason; Sharon Gayle,9,0,30,21
1745835187946,EDS 206R,B00,895695,Choi; Bailey Miyeon,20,0,30,10
1745835188972,EDS 250,A00,895697,Hemans; Patricia Ann Benitez,43,0,45,2
1745835190000,EDS 281,A00,895701,Meyerott; Theresa Ann,15,0,15,0
1745835191025,EDS 284,A00,895736,Meyerott; Theresa Ann,15,0,15,0
1745835192050,EDS 286,A00,897210,Fine; Sarah,15,0,15,0
1745835193076,EDS 289C,A01,895770,Daly; Alan J.,15,0,15,0
1745835194101,EDS 290,A00,897211,Hofstetter; Carolyn,15,0,15,0
1745835195131,LIGM 5A,A00,896162,Fischer-Grunski; Eva K,15,0,20,5
1745835196156,LIGM 5B,A00,896260,Fischer-Grunski; Eva K,17,0,20,3
1745835197188,LIGM 5C,A00,896308,Fischer-Grunski; Eva K,18,0,20,2
1745835198216,LIIT 5AS,A00,896313,Carnelos; Chiara,17,0,20,3
1745835199242,LIIT 5BS,A00,896416,Carnelos; Chiara,20,0,20,0
1745835200268,LIIT 5CS,A00,896564,Carnelos; Chiara,20,0,20,0
1745835201295,LISP 5A,A00,896588,Munoz Sanchez; Alicia,4,0,20,16
1745835202322,LISP 5B,A00,896653,Munoz Sanchez; Alicia,10,0,20,10
1745835203348,LISP 5C,A00,896655,Munoz Sanchez; Alicia,4,0,20,16
1745835204372,MAE 197,001,957918,Kleissl; Jan,9998,0,9999,1
1745835205399,MATH 2,A01,957937,Staff,34,0,35,1
1745835206426,MATH 197,001,957876,Kedlaya; Kiran S.,9993,0,9999,6
1745835207451,MCWP 40,A00,892729,Duru; Nur,13,0,20,7
1745835207451,MCWP 40,B00,893304,Montejo; Carolina,20,0,20,0
1745835208480,MCWP 40R,A00,893757,Redela; Pamela Morgan,0,7,20,20
1745835209505,MCWP 50,A00,893758,Morshed; Michael James,2,0,20,18
1745835209505,MCWP 50,B00,893761,Bartulis; Jason Michael,18,0,20,2
1745835210532,MCWP 50R,A00,893766,Compas; Sean Matthew,0,1,20,20
1745835210532,MCWP 50R,B00,893769,Carter; Jennifer A,0,0,20,20
1745835210532,MCWP 50R,C00,893771,Krone; Jarret,0,3,20,20
1745835210532,MCWP 50R,D00,893772,Miller; Elizabeth Deen,3,0,20,17
1745835210532,MCWP 50R,E00,893775,Carter; Andrea L,0,0,20,20
1745835211561,MMW 11R,A01,892721,Herbst; Matthew,11,0,27,16
1745835211561,MMW 11R,A02,892722,Herbst; Matthew,0,0,0,3
1745835212591,MMW 12R,A01,892724,Herbst; Matthew,0,10,16,16
1745835212591,MMW 12R,A02,892725,Herbst; Matthew,0,9,16,16
1745835213620,MMW 13R,A01,892727,Staff,0,3,16,16
1745835213620,MMW 13R,A02,892728,Staff,0,4,16,16
1745835213620,MMW 13R,A03,958032,Staff,0,3,16,16
1745835213620,MMW 13R,A04,958033,Staff,0,2,16,16
1745835213620,MMW 13R,A05,958034,Staff,0,3,16,16
1745835214647,SIO 295LS,A00,894015,Staff,7,0,25,18
1745835215674,SIO 295S,A00,894020,Staff,7,0,25,18
1745835216702,SIOC 290S,B01,958918,Staff,0,0,0,0
1745835217735,SIOC 291S,B01,958922,Staff,0,0,0,0
1745835218761,SOCI 117,A01,895339,Staff,4,0,5,1
1745835219790,WES 237B,A00,894149,Staff,11,0,20,9
1745835221867,AESE 279B,A00,891859,Staff,13,0,35,22
1745835222893,AIP 197,001,891854,Staff,70,0,70,0
1745835223919,ANTH 289S,A00,891856,Gagneux; Pascal,12,0,12,0
1745835224945,BENG 196,001,957946,Engler; Adam J.,9996,0,9999,3
1745835225971,CAT 124RS,A01,956906,Staff,8,0,25,17
1745835227040,CAT 125RS,A01,922013,Staff,8,0,25,17
1745835228072,CLRE 250,A00,891860,Morris; Sheldon,9995,0,9999,4
1745835230127,CLRE 251R,A00,907817,Mehta; Ravindra L.,9994,0,9999,5
1745835231153,CLRE 252,A00,891864,Cuomo; Raphael Eduardo,9993,0,9999,6
1745835232180,CLRE 253,A00,891867,Vaida; Florin,9994,0,9999,5
1745835232180,CLRE 253,B00,907819,Staff,9999,0,9999,0
1745835233208,CLRE 259,A00,891868,Patel; Hemal,9998,0,9999,1
1745835234235,CLRE 260,A00,891872,Cuomo; Raphael Eduardo,9999,0,9999,0
1745835235263,CLRE 297,001,891888,Cuomo; Raphael Eduardo,9999,0,9999,0
1745835236294,CSE 191,A00,958773,Minnes Kemp; Mor Mia,9999,0,9999,0
1745835237322,CSS 201S,A01,892054,Mignozzetti; Umberto,30,0,30,0
1745835238350,CSS 202S,A01,892056,Mignozzetti; Umberto,30,0,30,0
1745835239376,DSC 197,001,956898,Eldridge; Justin Matthew,9998,0,9999,1
1745835240403,DSC 297,001,958000,Mazumdar; Arya,9998,0,9999,1
1745835241430,EAP 100,A00,905686,Staff,9776,0,9999,223
1745835242458,ECE 45,A01,892618,Staff,0,13,50,50
1745835243487,ECE 109,A01,892620,Staff,0,43,0,0
1745835244511,ECE 111,A01,892719,Staff,0,9,50,50
1745835245540,ECE 197,001,957920,Mercier; Patrick Philip,9992,0,9999,7
1745835246572,ECON 178,A01,907814,Zhu; Ying,28,0,35,7
1745835247598,EDS 115,A00,895312,Staff,41,0,45,4
1745835248624,EDS 117,A01,895337,Staff,30,0,30,0
1745835249651,EDS 125,A00,895341,Jones; Gabrielle Anastasia,43,0,45,2
1745835250676,EDS 128A,A01,895459,Fargason; Sharon Gayle,44,0,45,1
1745835251702,EDS 128B,A01,895543,Pappas; Elizabeth,44,0,45,1
1745835252731,EDS 139,A00,897203,Pappas; Elizabeth,44,0,45,1
1745835252731,EDS 139,B00,897209,Fargason; Sharon Gayle,44,0,45,1
1745835253757,EDS 201,A00,895545,Staff,43,0,45,2
1745835254786,EDS 203,A01,895581,Halter; Christopher P.,43,0,45,2
1745835255812,EDS 204R,A01,895625,Heinzman; Erica M.,43,0,45,2
1745835255812,EDS 204R,B01,895693,Halter; Christopher P.,18,0,45,27
1745835256841,EDS 206R,A00,895694,Fargason; Sharon Gayle,9,0,30,21
1745835256841,EDS 206R,B00,895695,Choi; Bailey Miyeon,20,0,30,10
1745835257868,EDS 250,A00,895697,Hemans; Patricia Ann Benitez,43,0,45,2
1745835258896,EDS 281,A00,895701,Meyerott; Theresa Ann,15,0,15,0
1745835259921,EDS 284,A00,895736,Meyerott; Theresa Ann,15,0,15,0
1745835260946,EDS 286,A00,897210,Fine; Sarah,15,0,15,0
1745835261972,EDS 289C,A01,895770,Daly; Alan J.,15,0,15,0
1745835263002,EDS 290,A00,897211,Hofstetter; Carolyn,15,0,15,0
1745835264026,LIGM 5A,A00,896162,Fischer-Grunski; Eva K,15,0,20,5
1745835265058,LIGM 5B,A00,896260,Fischer-Grunski; Eva K,17,0,20,3
1745835266084,LIGM 5C,A00,896308,Fischer-Grunski; Eva K,18,0,20,2
1745835267113,LIIT 5AS,A00,896313,Carnelos; Chiara,17,0,20,3
1745835268140,LIIT 5BS,A00,896416,Carnelos; Chiara,20,0,20,0
1745835269166,LIIT 5CS,A00,896564,Carnelos; Chiara,20,0,20,0
1745835270196,LISP 5A,A00,896588,Munoz Sanchez; Alicia,4,0,20,16
1745835271222,LISP 5B,A00,896653,Munoz Sanchez; Alicia,10,0,20,10
1745835272252,LISP 5C,A00,896655,Munoz Sanchez; Alicia,4,0,20,16
1745835273279,MAE 197,001,957918,Kleissl; Jan,9998,0,9999,1
1745835274306,MATH 2,A01,957937,Staff,34,0,35,1
1745835275333,MATH 197,001,957876,Kedlaya; Kiran S.,9993,0,9999,6
1745835276359,MCWP 40,A00,892729,Duru; Nur,13,0,20,7
1745835276359,MCWP 40,B00,893304,Montejo; Carolina,20,0,20,0
1745835277388,MCWP 40R,A00,893757,Redela; Pamela Morgan,0,7,20,20
1745835278416,MCWP 50,A00,893758,Morshed; Michael James,2,0,20,18
1745835278416,MCWP 50,B00,893761,Bartulis; Jason Michael,18,0,20,2
1745835279442,MCWP 50R,A00,893766,Compas; Sean Matthew,0,1,20,20
1745835279442,MCWP 50R,B00,893769,Carter; Jennifer A,0,0,20,20
1745835279442,MCWP 50R,C00,893771,Krone; Jarret,0,3,20,20
1745835279442,MCWP 50R,D00,893772,Miller; Elizabeth Deen,3,0,20,17
1745835279442,MCWP 50R,E00,893775,Carter; Andrea L,0,0,20,20
1745835280468,MMW 11R,A01,892721,Herbst; Matthew,11,0,27,16
1745835280468,MMW 11R,A02,892722,Herbst; Matthew,0,0,0,3
1745835281492,MMW 12R,A01,892724,Herbst; Matthew,0,10,16,16
1745835281492,MMW 12R,A02,892725,Herbst; Matthew,0,9,16,16
1745835282522,MMW 13R,A01,892727,Staff,0,3,16,16
1745835282522,MMW 13R,A02,892728,Staff,0,4,16,16
1745835282522,MMW 13R,A03,958032,Staff,0,3,16,16
1745835282522,MMW 13R,A04,958033,Staff,0,2,16,16
1745835282522,MMW 13R,A05,958034,Staff,0,3,16,16
1745835283547,SIO 295LS,A00,894015,Staff,7,0,25,18
1745835284576,SIO 295S,A00,894020,Staff,7,0,25,18
1745835285602,SIOC 290S,B01,958918,Staff,0,0,0,0
1745835286632,SIOC 291S,B01,958922,Staff,0,0,0,0
1745835287661,SOCI 117,A01,895339,Staff,4,0,5,1
1745835288687,WES 237B,A00,894149,Staff,11,0,20,9
1745835290752,AESE 279B,A00,891859,Staff,13,0,35,22
1745835291778,AIP 197,001,891854,Staff,70,0,70,0
1745835292804,ANTH 289S,A00,891856,Gagneux; Pascal,12,0,12,0
1745835293831,BENG 196,001,957946,Engler; Adam J.,9996,0,9999,3
1745835294858,CAT 124RS,A01,956906,Staff,8,0,25,17
1745835295885,CAT 125RS,A01,922013,Staff,8,0,25,17
1745835296911,CLRE 250,A00,891860,Morris; Sheldon,9995,0,9999,4
1745835298966,CLRE 251R,A00,907817,Mehta; Ravindra L.,9994,0,9999,5
1745835299996,CLRE 252,A00,891864,Cuomo; Raphael Eduardo,9993,0,9999,6
1745835301024,CLRE 253,A00,891867,Vaida; Florin,9994,0,9999,5
1745835301024,CLRE 253,B00,907819,Staff,9999,0,9999,0
1745835302050,CLRE 259,A00,891868,Patel; Hemal,9998,0,9999,1
1745835303087,CLRE 260,A00,891872,Cuomo; Raphael Eduardo,9999,0,9999,0
1745835304116,CLRE 297,001,891888,Cuomo; Raphael Eduardo,9999,0,9999,0
1745835305141,CSE 191,A00,958773,Minnes Kemp; Mor Mia,9999,0,9999,0
1745835306173,CSS 201S,A01,892054,Mignozzetti; Umberto,30,0,30,0
1745835307201,CSS 202S,A01,892056,Mignozzetti; Umberto,30,0,30,0
1745835308227,DSC 197,001,956898,Eldridge; Justin Matthew,9998,0,9999,1
1745835309254,DSC 297,001,958000,Mazumdar; Arya,9998,0,9999,1
1745835310282,EAP 100,A00,905686,Staff,9776,0,9999,223
1745835311309,ECE 45,A01,892618,Staff,0,13,50,50
1745835312338,ECE 109,A01,892620,Staff,0,43,0,0
1745835313365,ECE 111,A01,892719,Staff,0,9,50,50
1745835314392,ECE 197,001,957920,Mercier; Patrick Philip,9992,0,9999,7
1745835315424,ECON 178,A01,907814,Zhu; Ying,28,0,35,7
1745835316452,EDS 115,A00,895312,Staff,41,0,45,4
1745835317478,EDS 117,A01,895337,Staff,30,0,30,0
1745835318509,EDS 125,A00,895341,Jones; Gabrielle Anastasia,43,0,45,2
1745835319539,EDS 128A,A01,895459,Fargason; Sharon Gayle,44,0,45,1
1745835320568,EDS 128B,A01,895543,Pappas; Elizabeth,44,0,45,1
1745835321595,EDS 139,A00,897203,Pappas; Elizabeth,44,0,45,1
1745835321595,EDS 139,B00,897209,Fargason; Sharon Gayle,44,0,45,1
1745835322623,EDS 201,A00,895545,Staff,43,0,45,2
1745835323649,EDS 203,A01,895581,Halter; Christopher P.,43,0,45,2
1745835324677,EDS 204R,A01,895625,Heinzman; Erica M.,43,0,45,2
1745835324677,EDS 204R,B01,895693,Halter; Christopher P.,18,0,45,27
1745835325708,EDS 206R,A00,895694,Fargason; Sharon Gayle,9,0,30,21
1745835325708,EDS 206R,B00,895695,Choi; Bailey Miyeon,20,0,30,10
1745835326735,EDS 250,A00,895697,Hemans; Patricia Ann Benitez,43,0,45,2
1745835327762,EDS 281,A00,895701,Meyerott; Theresa Ann,15,0,15,0
1745835328788,EDS 284,A00,895736,Meyerott; Theresa Ann,15,0,15,0
1745835329817,EDS 286,A00,897210,Fine; Sarah,15,0,15,0
1745835330887,EDS 289C,A01,895770,Daly; Alan J.,15,0,15,0
1745835331913,EDS 290,A00,897211,Hofstetter; Carolyn,15,0,15,0
1745835332942,LIGM 5A,A00,896162,Fischer-Grunski; Eva K,15,0,20,5
1745835333969,LIGM 5B,A00,896260,Fischer-Grunski; Eva K,17,0,20,3
1745835334997,LIGM 5C,A00,896308,Fischer-Grunski; Eva K,18,0,20,2
1745835336026,LIIT 5AS,A00,896313,Carnelos; Chiara,17,0,20,3
1745835337055,LIIT 5BS,A00,896416,Carnelos; Chiara,20,0,20,0
1745835338085,LIIT 5CS,A00,896564,Carnelos; Chiara,20,0,20,0
1745835339109,LISP 5A,A00,896588,Munoz Sanchez; Alicia,4,0,20,16
1745835340139,LISP 5B,A00,896653,Munoz Sanchez; Alicia,10,0,20,10
1745835341165,LISP 5C,A00,896655,Munoz Sanchez; Alicia,4,0,20,16
1745835342191,MAE 197,001,957918,Kleissl; Jan,9998,0,9999,1
1745835343220,MATH 2,A01,957937,Staff,34,0,35,1
1745835344247,MATH 197,001,957876,Kedlaya; Kiran S.,9993,0,9999,6
1745835345278,MCWP 40,A00,892729,Duru; Nur,13,0,20,7
1745835345278,MCWP 40,B00,893304,Montejo; Carolina,20,0,20,0
1745835346306,MCWP 40R,A00,893757,Redela; Pamela Morgan,0,7,20,20
1745835347333,MCWP 50,A00,893758,Morshed; Michael James,2,0,20,18
1745835347333,MCWP 50,B00,893761,Bartulis; Jason Michael,18,0,20,2
1745835348365,MCWP 50R,A00,893766,Compas; Sean Matthew,0,1,20,20
1745835348365,MCWP 50R,B00,893769,Carter; Jennifer A,0,0,20,20
1745835348365,MCWP 50R,C00,893771,Krone; Jarret,0,3,20,20
1745835348365,MCWP 50R,D00,893772,Miller; Elizabeth Deen,3,0,20,17
1745835348365,MCWP 50R,E00,893775,Carter; Andrea L,0,0,20,20
1745835349391,MMW 11R,A01,892721,Herbst; Matthew,11,0,27,16
1745835349391,MMW 11R,A02,892722,Herbst; Matthew,0,0,0,3
1745835350421,MMW 12R,A01,892724,Herbst; Matthew,0,10,16,16
1745835350421,MMW 12R,A02,892725,Herbst; Matthew,0,9,16,16
1745835351447,MMW 13R,A01,892727,Staff,0,3,16,16
1745835351447,MMW 13R,A02,892728,Staff,0,4,16,16
1745835351447,MMW 13R,A03,958032,Staff,0,3,16,16
1745835351447,MMW 13R,A04,958033,Staff,0,2,16,16
1745835351447,MMW 13R,A05,958034,Staff,0,3,16,16
1745835352477,SIO 295LS,A00,894015,Staff,7,0,25,18
1745835353502,SIO 295S,A00,894020,Staff,7,0,25,18
1745835354534,SIOC 290S,B01,958918,Staff,0,0,0,0
1745835355568,SIOC 291S,B01,958922,Staff,0,0,0,0
1745835356599,SOCI 117,A01,895339,Staff,4,0,5,1
1745835357628,WES 237B,A00,894149,Staff,11,0,20,9
1745835359685,AESE 279B,A00,891859,Staff,13,0,35,22
1745835360712,AIP 197,001,891854,Staff,70,0,70,0
1745835361742,ANTH 289S,A00,891856,Gagneux; Pascal,12,0,12,0
1745835362768,BENG 196,001,957946,Engler; Adam J.,9996,0,9999,3
1745835363796,CAT 124RS,A01,956906,Staff,8,0,25,17
1745835364825,CAT 125RS,A01,922013,Staff,8,0,25,17
1745835365852,CLRE 250,A00,891860,Morris; Sheldon,9995,0,9999,4
1745835367909,CLRE 251R,A00,907817,Mehta; Ravindra L.,9994,0,9999,5
1745835368934,CLRE 252,A00,891864,Cuomo; Raphael Eduardo,9993,0,9999,6
1745835369960,CLRE 253,A00,891867,Vaida; Florin,9994,0,9999,5
1745835369960,CLRE 253,B00,907819,Staff,9999,0,9999,0
1745835370995,CLRE 259,A00,891868,Patel; Hemal,9998,0,9999,1
1745835372021,CLRE 260,A00,891872,Cuomo; Raphael Eduardo,9999,0,9999,0
1745835373045,CLRE 297,001,891888,Cuomo; Raphael Eduardo,9999,0,9999,0
1745835374074,CSE 191,A00,958773,Minnes Kemp; Mor Mia,9999,0,9999,0
1745835375104,CSS 201S,A01,892054,Mignozzetti; Umberto,30,0,30,0
1745835376131,CSS 202S,A01,892056,Mignozzetti; Umberto,30,0,30,0
1745835377158,DSC 197,001,956898,Eldridge; Justin Matthew,9998,0,9999,1
1745835378186,DSC 297,001,958000,Mazumdar; Arya,9998,0,9999,1
1745835379212,EAP 100,A00,905686,Staff,9776,0,9999,223
1745835380238,ECE 45,A01,892618,Staff,0,13,50,50
1745835381268,ECE 109,A01,892620,Staff,0,43,0,0
1745835382294,ECE 111,A01,892719,Staff,0,9,50,50
1745835383322,ECE 197,001,957920,Mercier; Patrick Philip,9992,0,9999,7
1745835384347,ECON 178,A01,907814,Zhu; Ying,28,0,35,7
1745835385374,EDS 115,A00,895312,Staff,41,0,45,4
1745835386401,EDS 117,A01,895337,Staff,30,0,30,0
1745835387429,EDS 125,A00,895341,Jones; Gabrielle Anastasia,43,0,45,2
1745835388457,EDS 128A,A01,895459,Fargason; Sharon Gayle,44,0,45,1
1745835389487,EDS 128B,A01,895543,Pappas; Elizabeth,44,0,45,1
1745835390515,EDS 139,A00,897203,Pappas; Elizabeth,44,0,45,1
1745835390515,EDS 139,B00,897209,Fargason; Sharon Gayle,44,0,45,1
1745835391542,EDS 201,A00,895545,Staff,43,0,45,2
1745835392569,EDS 203,A01,895581,Halter; Christopher P.,43,0,45,2
1745835393596,EDS 204R,A01,895625,Heinzman; Erica M.,43,0,45,2
1745835393596,EDS 204R,B01,895693,Halter; Christopher P.,18,0,45,27
1745835394627,EDS 206R,A00,895694,Fargason; Sharon Gayle,9,0,30,21
1745835394627,EDS 206R,B00,895695,Choi; Bailey Miyeon,20,0,30,10
1745835395657,EDS 250,A00,895697,Hemans; Patricia Ann Benitez,43,0,45,2
1745835396680,EDS 281,A00,895701,Meyerott; Theresa Ann,15,0,15,0
1745835397710,EDS 284,A00,895736,Meyerott; Theresa Ann,15,0,15,0
1745835398738,EDS 286,A00,897210,Fine; Sarah,15,0,15,0
1745835399767,EDS 289C,A01,895770,Daly; Alan J.,15,0,15,0
1745835400793,EDS 290,A00,897211,Hofstetter; Carolyn,15,0,15,0
1745835401819,LIGM 5A,A00,896162,Fischer-Grunski; Eva K,15,0,20,5
1745835402846,LIGM 5B,A00,896260,Fischer-Grunski; Eva K,17,0,20,3
1745835403874,LIGM 5C,A00,896308,Fischer-Grunski; Eva K,18,0,20,2
1745835404905,LIIT 5AS,A00,896313,Carnelos; Chiara,17,0,20,3
1745835405933,LIIT 5BS,A00,896416,Carnelos; Chiara,20,0,20,0
1745835406964,LIIT 5CS,A00,896564,Carnelos; Chiara,20,0,20,0
1745835407991,LISP 5A,A00,896588,Munoz Sanchez; Alicia,4,0,20,16
1745835409020,LISP 5B,A00,896653,Munoz Sanchez; Alicia,10,0,20,10
1745835410048,LISP 5C,A00,896655,Munoz Sanchez; Alicia,4,0,20,16
1745835411074,MAE 197,001,957918,Kleissl; Jan,9998,0,9999,1
1745835412101,MATH 2,A01,957937,Staff,34,0,35,1
1745835413130,MATH 197,001,957876,Kedlaya; Kiran S.,9993,0,9999,6
1745835414161,MCWP 40,A00,892729,Duru; Nur,13,0,20,7
1745835414161,MCWP 40,B00,893304,Montejo; Carolina,20,0,20,0
1745835415190,MCWP 40R,A00,893757,Redela; Pamela Morgan,0,7,20,20
1745835416218,MCWP 50,A00,893758,Morshed; Michael James,2,0,20,18
1745835416218,MCWP 50,B00,893761,Bartulis; Jason Michael,18,0,20,2
1745835417249,MCWP 50R,A00,893766,Compas; Sean Matthew,0,1,20,20
1745835417249,MCWP 50R,B00,893769,Carter; Jennifer A,0,0,20,20
1745835417249,MCWP 50R,C00,893771,Krone; Jarret,0,3,20,20
1745835417249,MCWP 50R,D00,893772,Miller; Elizabeth Deen,3,0,20,17
1745835417249,MCWP 50R,E00,893775,Carter; Andrea L,0,0,20,20
1745835418275,MMW 11R,A01,892721,Herbst; Matthew,11,0,27,16
1745835418275,MMW 11R,A02,892722,Herbst; Matthew,0,0,0,3
1745835419302,MMW 12R,A01,892724,Herbst; Matthew,0,10,16,16
1745835419302,MMW 12R,A02,892725,Herbst; Matthew,0,9,16,16
1745835420332,MMW 13R,A01,892727,Staff,0,3,16,16
1745835420332,MMW 13R,A02,892728,Staff,0,4,16,16
1745835420332,MMW 13R,A03,958032,Staff,0,3,16,16
1745835420332,MMW 13R,A04,958033,Staff,0,2,16,16
1745835420332,MMW 13R,A05,958034,Staff,0,3,16,16
1745835421359,SIO 295LS,A00,894015,Staff,7,0,25,18
1745835422391,SIO 295S,A00,894020,Staff,7,0,25,18
1745835423422,SIOC 290S,B01,958918,Staff,0,0,0,0
1745835424453,SIOC 291S,B01,958922,Staff,0,0,0,0
1745835425482,SOCI 117,A01,895339,Staff,4,0,5,1
1745835426509,WES 237B,A00,894149,Staff,11,0,20,9
1745835428572,AESE 279B,A00,891859,Staff,13,0,35,22
1745835429618,AIP 197,001,891854,Staff,70,0,70,0
1745835430644,ANTH 289S,A00,891856,Gagneux; Pascal,12,0,12,0
1745835431669,BENG 196,001,957946,Engler; Adam J.,9996,0,9999,3
1745835432694,CAT 124RS,A01,956906,Staff,8,0,25,17
1745835433721,CAT 125RS,A01,922013,Staff,8,0,25,17
1745835434747,CLRE 250,A00,891860,Morris; Sheldon,9995,0,9999,4
1745835436805,CLRE 251R,A00,907817,Mehta; Ravindra L.,9994,0,9999,5
1745835437834,CLRE 252,A00,891864,Cuomo; Raphael Eduardo,9993,0,9999,6
1745835438861,CLRE 253,A00,891867,Vaida; Florin,9994,0,9999,5
1745835438861,CLRE 253,B00,907819,Staff,9999,0,9999,0
1745835439889,CLRE 259,A00,891868,Patel; Hemal,9998,0,9999,1
1745835440920,CLRE 260,A00,891872,Cuomo; Raphael Eduardo,9999,0,9999,0
1745835441947,CLRE 297,001,891888,Cuomo; Raphael Eduardo,9999,0,9999,0
1745835442977,CSE 191,A00,958773,Minnes Kemp; Mor Mia,9999,0,9999,0
1745835444004,CSS 201S,A01,892054,Mignozzetti; Umberto,30,0,30,0
1745835445030,CSS 202S,A01,892056,Mignozzetti; Umberto,30,0,30,0
1745835446059,DSC 197,001,956898,Eldridge; Justin Matthew,9998,0,9999,1
1745835447087,DSC 297,001,958000,Mazumdar; Arya,9998,0,9999,1
1745835448113,EAP 100,A00,905686,Staff,9776,0,9999,223
1745835449140,ECE 45,A01,892618,Staff,0,13,50,50
1745835450168,ECE 109,A01,892620,Staff,0,43,0,0
1745835451197,ECE 111,A01,892719,Staff,0,9,50,50
1745835452226,ECE 197,001,957920,Mercier; Patrick Philip,9992,0,9999,7
1745835453255,ECON 178,A01,907814,Zhu; Ying,28,0,35,7
1745835454281,EDS 115,A00,895312,Staff,41,0,45,4
1745835455307,EDS 117,A01,895337,Staff,30,0,30,0
1745835456335,EDS 125,A00,895341,Jones; Gabrielle Anastasia,43,0,45,2
1745835457364,EDS 128A,A01,895459,Fargason; Sharon Gayle,44,0,45,1
1745835458392,EDS 128B,A01,895543,Pappas; Elizabeth,44,0,45,1
1745835459421,EDS 139,A00,897203,Pappas; Elizabeth,44,0,45,1
1745835459421,EDS 139,B00,897209,Fargason; Sharon Gayle,44,0,45,1
1745835460450,EDS 201,A00,895545,Staff,43,0,45,2
1745835461477,EDS 203,A01,895581,Halter; Christopher P.,43,0,45,2
1745835462504,EDS 204R,A01,895625,Heinzman; Erica M.,43,0,45,2
1745835462504,EDS 204R,B01,895693,Halter; Christopher P.,18,0,45,27
1745835463529,EDS 206R,A00,895694,Fargason; Sharon Gayle,9,0,30,21
1745835463529,EDS 206R,B00,895695,Choi; Bailey Miyeon,20,0,30,10
1745835464555,EDS 250,A00,895697,Hemans; Patricia Ann Benitez,43,0,45,2
1745835465585,EDS 281,A00,895701,Meyerott; Theresa Ann,15,0,15,0
1745835466613,EDS 284,A00,895736,Meyerott; Theresa Ann,15,0,15,0
1745835467643,EDS 286,A00,897210,Fine; Sarah,15,0,15,0
1745835468671,EDS 289C,A01,895770,Daly; Alan J.,15,0,15,0
1745835469697,EDS 290,A00,897211,Hofstetter; Carolyn,15,0,15,0
1745835470727,LIGM 5A,A00,896162,Fischer-Grunski; Eva K,15,0,20,5
1745835471756,LIGM 5B,A00,896260,Fischer-Grunski; Eva K,17,0,20,3
1745835472784,LIGM 5C,A00,896308,Fischer-Grunski; Eva K,18,0,20,2
1745835473810,LIIT 5AS,A00,896313,Carnelos; Chiara,17,0,20,3
1745835474839,LIIT 5BS,A00,896416,Carnelos; Chiara,20,0,20,0
1745835475868,LIIT 5CS,A00,896564,Carnelos; Chiara,20,0,20,0
1745835476893,LISP 5A,A00,896588,Munoz Sanchez; Alicia,4,0,20,16
1745835477920,LISP 5B,A00,896653,Munoz Sanchez; Alicia,10,0,20,10
1745835478946,LISP 5C,A00,896655,Munoz Sanchez; Alicia,4,0,20,16
1745835479975,MAE 197,001,957918,Kleissl; Jan,9998,0,9999,1
1745835481002,MATH 2,A01,957937,Staff,34,0,35,1
1745835482030,MATH 197,001,957876,Kedlaya; Kiran S.,9993,0,9999,6
1745835483057,MCWP 40,A00,892729,Duru; Nur,13,0,20,7
1745835483057,MCWP 40,B00,893304,Montejo; Carolina,20,0,20,0
1745835484087,MCWP 40R,A00,893757,Redela; Pamela Morgan,0,7,20,20
1745835485113,MCWP 50,A00,893758,Morshed; Michael James,2,0,20,18
1745835485113,MCWP 50,B00,893761,Bartulis; Jason Michael,18,0,20,2
1745835486140,MCWP 50R,A00,893766,Compas; Sean Matthew,0,1,20,20
1745835486140,MCWP 50R,B00,893769,Carter; Jennifer A,0,0,20,20
1745835486140,MCWP 50R,C00,893771,Krone; Jarret,0,3,20,20
1745835486140,MCWP 50R,D00,893772,Miller; Elizabeth Deen,3,0,20,17
1745835486140,MCWP 50R,E00,893775,Carter; Andrea L,0,0,20,20
1745835487166,MMW 11R,A01,892721,Herbst; Matthew,11,0,27,16
1745835487166,MMW 11R,A02,892722,Herbst; Matthew,0,0,0,3
1745835488194,MMW 12R,A01,892724,Herbst; Matthew,0,10,16,16
1745835488194,MMW 12R,A02,892725,Herbst; Matthew,0,9,16,16
1745835489221,MMW 13R,A01,892727,Staff,0,3,16,16
1745835489221,MMW 13R,A02,892728,Staff,0,4,16,16
1745835489221,MMW 13R,A03,958032,Staff,0,3,16,16
1745835489221,MMW 13R,A04,958033,Staff,0,2,16,16
1745835489221,MMW 13R,A05,958034,Staff,0,3,16,16
1745835490247,SIO 295LS,A00,894015,Staff,7,0,25,18
1745835491275,SIO 295S,A00,894020,Staff,7,0,25,18
1745835492302,SIOC 290S,B01,958918,Staff,0,0,0,0
1745835493327,SIOC 291S,B01,958922,Staff,0,0,0,0
1745835494355,SOCI 117,A01,895339,Staff,4,0,5,1
1745835495380,WES 237B,A00,894149,Staff,11,0,20,9
1745835497459,AESE 279B,A00,891859,Staff,13,0,35,22
1745835498483,AIP 197,001,891854,Staff,70,0,70,0
1745835499534,ANTH 289S,A00,891856,Gagneux; Pascal,12,0,12,0
1745835500562,BENG 196,001,957946,Engler; Adam J.,9996,0,9999,3
1745835501590,CAT 124RS,A01,956906,Staff,8,0,25,17
1745835502617,CAT 125RS,A01,922013,Staff,8,0,25,17
1745835503643,CLRE 250,A00,891860,Morris; Sheldon,9995,0,9999,4
1745835505698,CLRE 251R,A00,907817,Mehta; Ravindra L.,9994,0,9999,5
1745835506725,CLRE 252,A00,891864,Cuomo; Raphael Eduardo,9993,0,9999,6
1745835507751,CLRE 253,A00,891867,Vaida; Florin,9994,0,9999,5
1745835507751,CLRE 253,B00,907819,Staff,9999,0,9999,0
1745835508783,CLRE 259,A00,891868,Patel; Hemal,9998,0,9999,1
1745835509808,CLRE 260,A00,891872,Cuomo; Raphael Eduardo,9999,0,9999,0
1745835510834,CLRE 297,001,891888,Cuomo; Raphael Eduardo,9999,0,9999,0
1745835511862,CSE 191,A00,958773,Minnes Kemp; Mor Mia,9999,0,9999,0
1745835512891,CSS 201S,A01,892054,Mignozzetti; Umberto,30,0,30,0
1745835513915,CSS 202S,A01,892056,Mignozzetti; Umberto,30,0,30,0
1745835514940,DSC 197,001,956898,Eldridge; Justin Matthew,9998,0,9999,1
1745835515966,DSC 297,001,958000,Mazumdar; Arya,9998,0,9999,1
1745835516991,EAP 100,A00,905686,Staff,9776,0,9999,223
1745835518014,ECE 45,A01,892618,Staff,0,13,50,50
1745835519041,ECE 109,A01,892620,Staff,0,43,0,0
1745835520067,ECE 111,A01,892719,Staff,0,9,50,50
1745835521092,ECE 197,001,957920,Mercier; Patrick Philip,9992,0,9999,7
1745835522122,ECON 178,A01,907814,Zhu; Ying,28,0,35,7
1745835523148,EDS 115,A00,895312,Staff,41,0,45,4
1745835524173,EDS 117,A01,895337,Staff,30,0,30,0
1745835525198,EDS 125,A00,895341,Jones; Gabrielle Anastasia,43,0,45,2
1745835526225,EDS 128A,A01,895459,Fargason; Sharon Gayle,44,0,45,1
1745835527255,EDS 128B,A01,895543,Pappas; Elizabeth,44,0,45,1
1745835528279,EDS 139,A00,897203,Pappas; Elizabeth,44,0,45,1
1745835528279,EDS 139,B00,897209,Fargason; Sharon Gayle,44,0,45,1
1745835529307,EDS 201,A00,895545,Staff,43,0,45,2
1745835530337,EDS 203,A01,895581,Halter; Christopher P.,43,0,45,2
1745835531365,EDS 204R,A01,895625,Heinzman; Erica M.,43,0,45,2
1745835531365,EDS 204R,B01,895693,Halter; Christopher P.,18,0,45,27
1745835532394,EDS 206R,A00,895694,Fargason; Sharon Gayle,9,0,30,21
1745835532394,EDS 206R,B00,895695,Choi; Bailey Miyeon,20,0,30,10
1745835533420,EDS 250,A00,895697,Hemans; Patricia Ann Benitez,43,0,45,2
1745835534449,EDS 281,A00,895701,Meyerott; Theresa Ann,15,0,15,0
1745835535477,EDS 284,A00,895736,Meyerott; Theresa Ann,15,0,15,0
1745835536504,EDS 286,A00,897210,Fine; Sarah,15,0,15,0
1745835537532,EDS 289C,A01,895770,Daly; Alan J.,15,0,15,0
1745835538558,EDS 290,A00,897211,Hofstetter; Carolyn,15,0,15,0
1745835539586,LIGM 5A,A00,896162,Fischer-Grunski; Eva K,15,0,20,5
1745835540614,LIGM 5B,A00,896260,Fischer-Grunski; Eva K,17,0,20,3
1745835541639,LIGM 5C,A00,896308,Fischer-Grunski; Eva K,18,0,20,2
1745835542673,LIIT 5AS,A00,896313,Carnelos; Chiara,17,0,20,3
1745835543705,LIIT 5BS,A00,896416,Carnelos; Chiara,20,0,20,0
1745835544736,LIIT 5CS,A00,896564,Carnelos; Chiara,20,0,20,0
1745835545768,LISP 5A,A00,896588,Munoz Sanchez; Alicia,4,0,20,16
1745835546796,LISP 5B,A00,896653,Munoz Sanchez; Alicia,10,0,20,10
1745835547827,LISP 5C,A00,896655,Munoz Sanchez; Alicia,4,0,20,16
1745835548856,MAE 197,001,957918,Kleissl; Jan,9998,0,9999,1
1745835549883,MATH 2,A01,957937,Staff,34,0,35,1
1745835550911,MATH 197,001,957876,Kedlaya; Kiran S.,9993,0,9999,6
1745835551936,MCWP 40,A00,892729,Duru; Nur,13,0,20,7
1745835551936,MCWP 40,B00,893304,Montejo; Carolina,20,0,20,0
1745835552961,MCWP 40R,A00,893757,Redela; Pamela Morgan,0,7,20,20
1745835553987,MCWP 50,A00,893758,Morshed; Michael James,2,0,20,18
1745835553987,MCWP 50,B00,893761,Bartulis; Jason Michael,18,0,20,2
1745835555015,MCWP 50R,A00,893766,Compas; Sean Matthew,0,1,20,20
1745835555015,MCWP 50R,B00,893769,Carter; Jennifer A,0,0,20,20
1745835555015,MCWP 50R,C00,893771,Krone; Jarret,0,3,20,20
1745835555015,MCWP 50R,D00,893772,Miller; Elizabeth Deen,3,0,20,17
1745835555015,MCWP 50R,E00,893775,Carter; Andrea L,0,0,20,20
1745835556045,MMW 11R,A01,892721,Herbst; Matthew,11,0,27,16
1745835556045,MMW 11R,A02,892722,Herbst; Matthew,0,0,0,3
1745835557071,MMW 12R,A01,892724,Herbst; Matthew,0,10,16,16
1745835557071,MMW 12R,A02,892725,Herbst; Matthew,0,9,16,16
1745835558100,MMW 13R,A01,892727,Staff,0,3,16,16
1745835558100,MMW 13R,A02,892728,Staff,0,4,16,16
1745835558100,MMW 13R,A03,958032,Staff,0,3,16,16
1745835558100,MMW 13R,A04,958033,Staff,0,2,16,16
1745835558100,MMW 13R,A05,958034,Staff,0,3,16,16
1745835559129,SIO 295LS,A00,894015,Staff,7,0,25,18
1745835560155,SIO 295S,A00,894020,Staff,7,0,25,18
1745835561180,SIOC 290S,B01,958918,Staff,0,0,0,0
1745835562210,SIOC 291S,B01,958922,Staff,0,0,0,0
1745835563238,SOCI 117,A01,895339,Staff,4,0,5,1
1745835564266,WES 237B,A00,894149,Staff,11,0,20,9
1745835566328,AESE 279B,A00,891859,Staff,13,0,35,22
1745835567356,AIP 197,001,891854,Staff,70,0,70,0
1745835568383,ANTH 289S,A00,891856,Gagneux; Pascal,12,0,12,0
1745835569410,BENG 196,001,957946,Engler; Adam J.,9996,0,9999,3
1745835570436,CAT 124RS,A01,956906,Staff,8,0,25,17
1745835571464,CAT 125RS,A01,922013,Staff,8,0,25,17
1745835572494,CLRE 250,A00,891860,Morris; Sheldon,9995,0,9999,4
1745835574586,CLRE 251R,A00,907817,Mehta; Ravindra L.,9994,0,9999,5
1745835575613,CLRE 252,A00,891864,Cuomo; Raphael Eduardo,9993,0,9999,6
1745835576641,CLRE 253,A00,891867,Vaida; Florin,9994,0,9999,5
1745835576641,CLRE 253,B00,907819,Staff,9999,0,9999,0
1745835577666,CLRE 259,A00,891868,Patel; Hemal,9998,0,9999,1
1745835578693,CLRE 260,A00,891872,Cuomo; Raphael Eduardo,9999,0,9999,0
1745835579718,CLRE 297,001,891888,Cuomo; Raphael Eduardo,9999,0,9999,0
1745835580742,CSE 191,A00,958773,Minnes Kemp; Mor Mia,9999,0,9999,0
1745835581769,CSS 201S,A01,892054,Mignozzetti; Umberto,30,0,30,0
1745835582795,CSS 202S,A01,892056,Mignozzetti; Umberto,30,0,30,0
1745835583822,DSC 197,001,956898,Eldridge; Justin Matthew,9998,0,9999,1
1745835584850,DSC 297,001,958000,Mazumdar; Arya,9998,0,9999,1
1745835585878,EAP 100,A00,905686,Staff,9776,0,9999,223
1745835586908,ECE 45,A01,892618,Staff,0,13,50,50
1745835587938,ECE 109,A01,892620,Staff,0,43,0,0
1745835588969,ECE 111,A01,892719,Staff,0,9,50,50
1745835589998,ECE 197,001,957920,Mercier; Patrick Philip,9992,0,9999,7
1745835591027,ECON 178,A01,907814,Zhu; Ying,28,0,35,7
1745835592056,EDS 115,A00,895312,Staff,41,0,45,4
1745835593083,EDS 117,A01,895337,Staff,30,0,30,0
1745835594109,EDS 125,A00,895341,Jones; Gabrielle Anastasia,43,0,45,2
1745835595136,EDS 128A,A01,895459,Fargason; Sharon Gayle,44,0,45,1
1745835596218,EDS 128B,A01,895543,Pappas; Elizabeth,44,0,45,1
1745835597245,EDS 139,A00,897203,Pappas; Elizabeth,44,0,45,1
1745835597245,EDS 139,B00,897209,Fargason; Sharon Gayle,44,0,45,1
1745835598271,EDS 201,A00,895545,Staff,43,0,45,2
1745835599306,EDS 203,A01,895581,Halter; Christopher P.,43,0,45,2
1745835600332,EDS 204R,A01,895625,Heinzman; Erica M.,43,0,45,2
1745835600332,EDS 204R,B01,895693,Halter; Christopher P.,18,0,45,27
1745835601366,EDS 206R,A00,895694,Fargason; Sharon Gayle,9,0,30,21
1745835601366,EDS 206R,B00,895695,Choi; Bailey Miyeon,20,0,30,10
1745835602399,EDS 250,A00,895697,Hemans; Patricia Ann Benitez,43,0,45,2
1745835603426,EDS 281,A00,895701,Meyerott; Theresa Ann,15,0,15,0
1745835604453,EDS 284,A00,895736,Meyerott; Theresa Ann,15,0,15,0
1745835605486,EDS 286,A00,897210,Fine; Sarah,15,0,15,0
1745835606515,EDS 289C,A01,895770,Daly; Alan J.,15,0,15,0
1745835607542,EDS 290,A00,897211,Hofstetter; Carolyn,15,0,15,0
1745835608569,LIGM 5A,A00,896162,Fischer-Grunski; Eva K,15,0,20,5
1745835609600,LIGM 5B,A00,896260,Fischer-Grunski; Eva K,17,0,20,3
1745835610626,LIGM 5C,A00,896308,Fischer-Grunski; Eva K,18,0,20,2
1745835611657,LIIT 5AS,A00,896313,Carnelos; Chiara,17,0,20,3
1745835612683,LIIT 5BS,A00,896416,Carnelos; Chiara,20,0,20,0
1745835613714,LIIT 5CS,A00,896564,Carnelos; Chiara,20,0,20,0
1745835614745,LISP 5A,A00,896588,Munoz Sanchez; Alicia,4,0,20,16
1745835615771,LISP 5B,A00,896653,Munoz Sanchez; Alicia,10,0,20,10
1745835616795,LISP 5C,A00,896655,Munoz Sanchez; Alicia,4,0,20,16
1745835617822,MAE 197,001,957918,Kleissl; Jan,9998,0,9999,1
1745835618848,MATH 2,A01,957937,Staff,34,0,35,1
1745835619880,MATH 197,001,957876,Kedlaya; Kiran S.,9993,0,9999,6
1745835620910,MCWP 40,A00,892729,Duru; Nur,13,0,20,7
1745835620910,MCWP 40,B00,893304,Montejo; Carolina,20,0,20,0
1745835621937,MCWP 40R,A00,893757,Redela; Pamela Morgan,0,7,20,20
1745835622962,MCWP 50,A00,893758,Morshed; Michael James,2,0,20,18
1745835622962,MCWP 50,B00,893761,Bartulis; Jason Michael,18,0,20,2
1745835623993,MCWP 50R,A00,893766,Compas; Sean Matthew,0,1,20,20
1745835623993,MCWP 50R,B00,893769,Carter; Jennifer A,0,0,20,20
1745835623993,MCWP 50R,C00,893771,Krone; Jarret,0,3,20,20
1745835623993,MCWP 50R,D00,893772,Miller; Elizabeth Deen,3,0,20,17
1745835623993,MCWP 50R,E00,893775,Carter; Andrea L,0,0,20,20
1745835625023,MMW 11R,A01,892721,Herbst; Matthew,11,0,27,16
1745835625023,MMW 11R,A02,892722,Herbst; Matthew,0,0,0,3
1745835626052,MMW 12R,A01,892724,Herbst; Matthew,0,10,16,16
1745835626052,MMW 12R,A02,892725,Herbst; Matthew,0,9,16,16
1745835627077,MMW 13R,A01,892727,Staff,0,3,16,16
1745835627077,MMW 13R,A02,892728,Staff,0,4,16,16
1745835627077,MMW 13R,A03,958032,Staff,0,3,16,16
1745835627077,MMW 13R,A04,958033,Staff,0,2,16,16
1745835627077,MMW 13R,A05,958034,Staff,0,3,16,16
1745835628108,SIO 295LS,A00,894015,Staff,7,0,25,18
1745835629134,SIO 295S,A00,894020,Staff,7,0,25,18
1745835630161,SIOC 290S,B01,958918,Staff,0,0,0,0
1745835631188,SIOC 291S,B01,958922,Staff,0,0,0,0
1745835632214,SOCI 117,A01,895339,Staff,4,0,5,1
1745835633241,WES 237B,A00,894149,Staff,11,0,20,9
1745835635307,AESE 279B,A00,891859,Staff,13,0,35,22
1745835636332,AIP 197,001,891854,Staff,70,0,70,0
1745835637358,ANTH 289S,A00,891856,Gagneux; Pascal,12,0,12,0
1745835638385,BENG 196,001,957946,Engler; Adam J.,9996,0,9999,3
1745835639412,CAT 124RS,A01,956906,Staff,8,0,25,17
1745835640438,CAT 125RS,A01,922013,Staff,8,0,25,17
1745835641465,CLRE 250,A00,891860,Morris; Sheldon,9995,0,9999,4
1745835643518,CLRE 251R,A00,907817,Mehta; Ravindra L.,9994,0,9999,5
1745835644545,CLRE 252,A00,891864,Cuomo; Raphael Eduardo,9993,0,9999,6
1745835645576,CLRE 253,A00,891867,Vaida; Florin,9994,0,9999,5
1745835645576,CLRE 253,B00,907819,Staff,9999,0,9999,0
1745835646604,CLRE 259,A00,891868,Patel; Hemal,9998,0,9999,1
1745835647630,CLRE 260,A00,891872,Cuomo; Raphael Eduardo,9999,0,9999,0
1745835648658,CLRE 297,001,891888,Cuomo; Raphael Eduardo,9999,0,9999,0
1745835649686,CSE 191,A00,958773,Minnes Kemp; Mor Mia,9999,0,9999,0
1745835650712,CSS 201S,A01,892054,Mignozzetti; Umberto,30,0,30,0
1745835651738,CSS 202S,A01,892056,Mignozzetti; Umberto,30,0,30,0
1745835652764,DSC 197,001,956898,Eldridge; Justin Matthew,9998,0,9999,1
1745835653790,DSC 297,001,958000,Mazumdar; Arya,9998,0,9999,1
1745835654817,EAP 100,A00,905686,Staff,9776,0,9999,223
1745835655843,ECE 45,A01,892618,Staff,0,13,50,50
1745835656869,ECE 109,A01,892620,Staff,0,43,0,0
1745835657898,ECE 111,A01,892719,Staff,0,9,50,50
1745835658925,ECE 197,001,957920,Mercier; Patrick Philip,9992,0,9999,7
1745835659957,ECON 178,A01,907814,Zhu; Ying,28,0,35,7
1745835660987,EDS 115,A00,895312,Staff,41,0,45,4
1745835662015,EDS 117,A01,895337,Staff,30,0,30,0
1745835663040,EDS 125,A00,895341,Jones; Gabrielle Anastasia,43,0,45,2
1745835664066,EDS 128A,A01,895459,Fargason; Sharon Gayle,44,0,45,1
1745835665096,EDS 128B,A01,895543,Pappas; Elizabeth,44,0,45,1
1745835666125,EDS 139,A00,897203,Pappas; Elizabeth,44,0,45,1
1745835666125,EDS 139,B00,897209,Fargason; Sharon Gayle,44,0,45,1
1745835667152,EDS 201,A00,895545,Staff,43,0,45,2
1745835668179,EDS 203,A01,895581,Halter; Christopher P.,43,0,45,2
1745835669206,EDS 204R,A01,895625,Heinzman; Erica M.,43,0,45,2
1745835669206,EDS 204R,B01,895693,Halter; Christopher P.,18,0,45,27
1745835670232,EDS 206R,A00,895694,Fargason; Sharon Gayle,9,0,30,21
1745835670232,EDS 206R,B00,895695,Choi; Bailey Miyeon,20,0,30,10
1745835671262,EDS 250,A00,895697,Hemans; Patricia Ann Benitez,43,0,45,2
1745835672345,EDS 281,A00,895701,Meyerott; Theresa Ann,15,0,15,0
1745835673375,EDS 284,A00,895736,Meyerott; Theresa Ann,15,0,15,0
1745835674402,EDS 286,A00,897210,Fine; Sarah,15,0,15,0
1745835675431,EDS 289C,A01,895770,Daly; Alan J.,15,0,15,0
1745835676457,EDS 290,A00,897211,Hofstetter; Carolyn,15,0,15,0
1745835677522,LIGM 5A,A00,896162,Fischer-Grunski; Eva K,15,0,20,5
1745835678560,LIGM 5B,A00,896260,Fischer-Grunski; Eva K,17,0,20,3
1745835679590,LIGM 5C,A00,896308,Fischer-Grunski; Eva K,18,0,20,2
1745835680615,LIIT 5AS,A00,896313,Carnelos; Chiara,17,0,20,3
1745835681647,LIIT 5BS,A00,896416,Carnelos; Chiara,20,0,20,0
1745835682673,LIIT 5CS,A00,896564,Carnelos; Chiara,20,0,20,0
1745835683701,LISP 5A,A00,896588,Munoz Sanchez; Alicia,4,0,20,16
1745835684727,LISP 5B,A00,896653,Munoz Sanchez; Alicia,10,0,20,10
1745835685752,LISP 5C,A00,896655,Munoz Sanchez; Alicia,4,0,20,16
1745835686780,MAE 197,001,957918,Kleissl; Jan,9998,0,9999,1
1745835687806,MATH 2,A01,957937,Staff,34,0,35,1
1745835688836,MATH 197,001,957876,Kedlaya; Kiran S.,9993,0,9999,6
1745835689866,MCWP 40,A00,892729,Duru; Nur,13,0,20,7
1745835689866,MCWP 40,B00,893304,Montejo; Carolina,20,0,20,0
1745835690893,MCWP 40R,A00,893757,Redela; Pamela Morgan,0,7,20,20
1745835691920,MCWP 50,A00,893758,Morshed; Michael James,2,0,20,18
1745835691920,MCWP 50,B00,893761,Bartulis; Jason Michael,18,0,20,2
1745835692951,MCWP 50R,A00,893766,Compas; Sean Matthew,0,1,20,20
1745835692951,MCWP 50R,B00,893769,Carter; Jennifer A,0,0,20,20
1745835692951,MCWP 50R,C00,893771,Krone; Jarret,0,3,20,20
1745835692951,MCWP 50R,D00,893772,Miller; Elizabeth Deen,3,0,20,17
1745835692951,MCWP 50R,E00,893775,Carter; Andrea L,0,0,20,20
1745835693981,MMW 11R,A01,892721,Herbst; Matthew,11,0,27,16
1745835693981,MMW 11R,A02,892722,Herbst; Matthew,0,0,0,3
1745835695013,MMW 12R,A01,892724,Herbst; Matthew,0,10,16,16
1745835695013,MMW 12R,A02,892725,Herbst; Matthew,0,9,16,16
1745835696042,MMW 13R,A01,892727,Staff,0,3,16,16
1745835696042,MMW 13R,A02,892728,Staff,0,4,16,16
1745835696042,MMW 13R,A03,958032,Staff,0,3,16,16
1745835696042,MMW 13R,A04,958033,Staff,0,2,16,16
1745835696042,MMW 13R,A05,958034,Staff,0,3,16,16
1745835697069,SIO 295LS,A00,894015,Staff,7,0,25,18
1745835698096,SIO 295S,A00,894020,Staff,7,0,25,18
1745835699124,SIOC 290S,B01,958918,Staff,0,0,0,0
1745835700154,SIOC 291S,B01,958922,Staff,0,0,0,0
1745835701184,SOCI 117,A01,895339,Staff,4,0,5,1
1745835702210,WES 237B,A00,894149,Staff,11,0,20,9
1745835704278,AESE 279B,A00,891859,Staff,13,0,35,22
1745835705307,AIP 197,001,891854,Staff,70,0,70,0
1745835706336,ANTH 289S,A00,891856,Gagneux; Pascal,12,0,12,0
1745835707362,BENG 196,001,957946,Engler; Adam J.,9996,0,9999,3
1745835708388,CAT 124RS,A01,956906,Staff,8,0,25,17
1745835709417,CAT 125RS,A01,922013,Staff,8,0,25,17
1745835710446,CLRE 250,A00,891860,Morris; Sheldon,9995,0,9999,4
1745835712496,CLRE 251R,A00,907817,Mehta; Ravindra L.,9994,0,9999,5
1745835713522,CLRE 252,A00,891864,Cuomo; Raphael Eduardo,9993,0,9999,6
1745835714549,CLRE 253,A00,891867,Vaida; Florin,9994,0,9999,5
1745835714549,CLRE 253,B00,907819,Staff,9999,0,9999,0
1745835715580,CLRE 259,A00,891868,Patel; Hemal,9998,0,9999,1
1745835716610,CLRE 260,A00,891872,Cuomo; Raphael Eduardo,9999,0,9999,0
1745835717638,CLRE 297,001,891888,Cuomo; Raphael Eduardo,9999,0,9999,0
1745835718664,CSE 191,A00,958773,Minnes Kemp; Mor Mia,9999,0,9999,0
1745835719693,CSS 201S,A01,892054,Mignozzetti; Umberto,30,0,30,0
1745835720721,CSS 202S,A01,892056,Mignozzetti; Umberto,30,0,30,0
1745835721749,DSC 197,001,956898,Eldridge; Justin Matthew,9998,0,9999,1
1745835722776,DSC 297,001,958000,Mazumdar; Arya,9998,0,9999,1
1745835723803,EAP 100,A00,905686,Staff,9776,0,9999,223
1745835724833,ECE 45,A01,892618,Staff,0,13,50,50
1745835725866,ECE 109,A01,892620,Staff,0,43,0,0
1745835726893,ECE 111,A01,892719,Staff,0,9,50,50
1745835727920,ECE 197,001,957920,Mercier; Patrick Philip,9992,0,9999,7
1745835728952,ECON 178,A01,907814,Zhu; Ying,28,0,35,7
1745835729978,EDS 115,A00,895312,Staff,41,0,45,4
1745835731005,EDS 117,A01,895337,Staff,30,0,30,0
1745835732035,EDS 125,A00,895341,Jones; Gabrielle Anastasia,43,0,45,2
1745835733064,EDS 128A,A01,895459,Fargason; Sharon Gayle,44,0,45,1
1745835734092,EDS 128B,A01,895543,Pappas; Elizabeth,44,0,45,1
1745835735124,EDS 139,A00,897203,Pappas; Elizabeth,44,0,45,1
1745835735124,EDS 139,B00,897209,Fargason; Sharon Gayle,44,0,45,1
1745835736150,EDS 201,A00,895545,Staff,43,0,45,2
1745835737180,EDS 203,A01,895581,Halter; Christopher P.,43,0,45,2
1745835738205,EDS 204R,A01,895625,Heinzman; Erica M.,43,0,45,2
1745835738205,EDS 204R,B01,895693,Halter; Christopher P.,18,0,45,27
1745835739229,EDS 206R,A00,895694,Fargason; Sharon Gayle,9,0,30,21
1745835739229,EDS 206R,B00,895695,Choi; Bailey Miyeon,20,0,30,10
1745835740256,EDS 250,A00,895697,Hemans; Patricia Ann Benitez,43,0,45,2
1745835741285,EDS 281,A00,895701,Meyerott; Theresa Ann,15,0,15,0
1745835742315,EDS 284,A00,895736,Meyerott; Theresa Ann,15,0,15,0
1745835743343,EDS 286,A00,897210,Fine; Sarah,15,0,15,0
1745835744370,EDS 289C,A01,895770,Daly; Alan J.,15,0,15,0
1745835745396,EDS 290,A00,897211,Hofstetter; Carolyn,15,0,15,0
1745835746426,LIGM 5A,A00,896162,Fischer-Grunski; Eva K,15,0,20,5
1745835747457,LIGM 5B,A00,896260,Fischer-Grunski; Eva K,17,0,20,3
1745835748483,LIGM 5C,A00,896308,Fischer-Grunski; Eva K,18,0,20,2
1745835749514,LIIT 5AS,A00,896313,Carnelos; Chiara,17,0,20,3
1745835750540,LIIT 5BS,A00,896416,Carnelos; Chiara,20,0,20,0
1745835751571,LIIT 5CS,A00,896564,Carnelos; Chiara,20,0,20,0
1745835752600,LISP 5A,A00,896588,Munoz Sanchez; Alicia,4,0,20,16
1745835753630,LISP 5B,A00,896653,Munoz Sanchez; Alicia,10,0,20,10
1745835754658,LISP 5C,A00,896655,Munoz Sanchez; Alicia,4,0,20,16
1745835755684,MAE 197,001,957918,Kleissl; Jan,9998,0,9999,1
1745835756714,MATH 2,A01,957937,Staff,34,0,35,1
1745835757740,MATH 197,001,957876,Kedlaya; Kiran S.,9993,0,9999,6
1745835758769,MCWP 40,A00,892729,Duru; Nur,13,0,20,7
1745835758769,MCWP 40,B00,893304,Montejo; Carolina,20,0,20,0
1745835759800,MCWP 40R,A00,893757,Redela; Pamela Morgan,0,7,20,20
1745835760827,MCWP 50,A00,893758,Morshed; Michael James,2,0,20,18
1745835760827,MCWP 50,B00,893761,Bartulis; Jason Michael,18,0,20,2
1745835761851,MCWP 50R,A00,893766,Compas; Sean Matthew,0,1,20,20
1745835761851,MCWP 50R,B00,893769,Carter; Jennifer A,0,0,20,20
1745835761851,MCWP 50R,C00,893771,Krone; Jarret,0,3,20,20
1745835761851,MCWP 50R,D00,893772,Miller; Elizabeth Deen,3,0,20,17
1745835761851,MCWP 50R,E00,893775,Carter; Andrea L,0,0,20,20
1745835762877,MMW 11R,A01,892721,Herbst; Matthew,11,0,27,16
1745835762877,MMW 11R,A02,892722,Herbst; Matthew,0,0,0,3
1745835763904,MMW 12R,A01,892724,Herbst; Matthew,0,10,16,16
1745835763904,MMW 12R,A02,892725,Herbst; Matthew,0,9,16,16
1745835764930,MMW 13R,A01,892727,Staff,0,3,16,16
1745835764930,MMW 13R,A02,892728,Staff,0,4,16,16
1745835764930,MMW 13R,A03,958032,Staff,0,3,16,16
1745835764930,MMW 13R,A04,958033,Staff,0,2,16,16
1745835764930,MMW 13R,A05,958034,Staff,0,3,16,16
1745835765960,SIO 295LS,A00,894015,Staff,7,0,25,18
1745835766986,SIO 295S,A00,894020,Staff,7,0,25,18
1745835768014,SIOC 290S,B01,958918,Staff,0,0,0,0
1745835769045,SIOC 291S,B01,958922,Staff,0,0,0,0
1745835770072,SOCI 117,A01,895339,Staff,4,0,5,1
1745835771101,WES 237B,A00,894149,Staff,11,0,20,9
1745835773180,AESE 279B,A00,891859,Staff,13,0,35,22
1745835774207,AIP 197,001,891854,Staff,70,0,70,0
1745835775234,ANTH 289S,A00,891856,Gagneux; Pascal,12,0,12,0
1745835776259,BENG 196,001,957946,Engler; Adam J.,9996,0,9999,3
1745835777287,CAT 124RS,A01,956906,Staff,8,0,25,17
1745835778316,CAT 125RS,A01,922013,Staff,8,0,25,17
1745835779348,CLRE 250,A00,891860,Morris; Sheldon,9995,0,9999,4
1745835781409,CLRE 251R,A00,907817,Mehta; Ravindra L.,9994,0,9999,5
1745835782438,CLRE 252,A00,891864,Cuomo; Raphael Eduardo,9993,0,9999,6
1745835783465,CLRE 253,A00,891867,Vaida; Florin,9994,0,9999,5
1745835783465,CLRE 253,B00,907819,Staff,9999,0,9999,0
1745835784493,CLRE 259,A00,891868,Patel; Hemal,9998,0,9999,1
1745835785524,CLRE 260,A00,891872,Cuomo; Raphael Eduardo,9999,0,9999,0
1745835786551,CLRE 297,001,891888,Cuomo; Raphael Eduardo,9999,0,9999,0
1745835787578,CSE 191,A00,958773,Minnes Kemp; Mor Mia,9999,0,9999,0
1745835788602,CSS 201S,A01,892054,Mignozzetti; Umberto,30,0,30,0
1745835789630,CSS 202S,A01,892056,Mignozzetti; Umberto,30,0,30,0
1745835790654,DSC 197,001,956898,Eldridge; Justin Matthew,9998,0,9999,1
1745835791684,DSC 297,001,958000,Mazumdar; Arya,9998,0,9999,1
1745835792709,EAP 100,A00,905686,Staff,9776,0,9999,223
1745835793736,ECE 45,A01,892618,Staff,0,13,50,50
1745835794767,ECE 109,A01,892620,Staff,0,43,0,0
1745835795792,ECE 111,A01,892719,Staff,0,9,50,50
1745835796820,ECE 197,001,957920,Mercier; Patrick Philip,9992,0,9999,7
1745835797851,ECON 178,A01,907814,Zhu; Ying,28,0,35,7
1745835798877,EDS 115,A00,895312,Staff,41,0,45,4
1745835799905,EDS 117,A01,895337,Staff,30,0,30,0
1745835800931,EDS 125,A00,895341,Jones; Gabrielle Anastasia,43,0,45,2
1745835801958,EDS 128A,A01,895459,Fargason; Sharon Gayle,44,0,45,1
1745835802988,EDS 128B,A01,895543,Pappas; Elizabeth,44,0,45,1
1745835804015,EDS 139,A00,897203,Pappas; Elizabeth,44,0,45,1
1745835804015,EDS 139,B00,897209,Fargason; Sharon Gayle,44,0,45,1
1745835805041,EDS 201,A00,895545,Staff,43,0,45,2
1745835806068,EDS 203,A01,895581,Halter; Christopher P.,43,0,45,2
1745835807095,EDS 204R,A01,895625,Heinzman; Erica M.,43,0,45,2
1745835807095,EDS 204R,B01,895693,Halter; Christopher P.,18,0,45,27
1745835808125,EDS 206R,A00,895694,Fargason; Sharon Gayle,9,0,30,21
1745835808125,EDS 206R,B00,895695,Choi; Bailey Miyeon,20,0,30,10
1745835809152,EDS 250,A00,895697,Hemans; Patricia Ann Benitez,43,0,45,2
1745835810178,EDS 281,A00,895701,Meyerott; Theresa Ann,15,0,15,0
1745835811203,EDS 284,A00,895736,Meyerott; Theresa Ann,15,0,15,0
1745835812229,EDS 286,A00,897210,Fine; Sarah,15,0,15,0
1745835813255,EDS 289C,A01,895770,Daly; Alan J.,15,0,15,0
1745835814285,EDS 290,A00,897211,Hofstetter; Carolyn,15,0,15,0
1745835815312,LIGM 5A,A00,896162,Fischer-Grunski; Eva K,15,0,20,5
1745835816344,LIGM 5B,A00,896260,Fischer-Grunski; Eva K,17,0,20,3
1745835817375,LIGM 5C,A00,896308,Fischer-Grunski; Eva K,18,0,20,2
1745835818401,LIIT 5AS,A00,896313,Carnelos; Chiara,17,0,20,3
1745835819428,LIIT 5BS,A00,896416,Carnelos; Chiara,20,0,20,0
1745835820457,LIIT 5CS,A00,896564,Carnelos; Chiara,20,0,20,0
1745835821482,LISP 5A,A00,896588,Munoz Sanchez; Alicia,4,0,20,16
1745835822509,LISP 5B,A00,896653,Munoz Sanchez; Alicia,10,0,20,10
1745835823536,LISP 5C,A00,896655,Munoz Sanchez; Alicia,4,0,20,16
1745835824563,MAE 197,001,957918,Kleissl; Jan,9998,0,9999,1
1745835825589,MATH 2,A01,957937,Staff,34,0,35,1
1745835826616,MATH 197,001,957876,Kedlaya; Kiran S.,9993,0,9999,6
1745835827641,MCWP 40,A00,892729,Duru; Nur,13,0,20,7
1745835827641,MCWP 40,B00,893304,Montejo; Carolina,20,0,20,0
1745835828666,MCWP 40R,A00,893757,Redela; Pamela Morgan,0,7,20,20
1745835829694,MCWP 50,A00,893758,Morshed; Michael James,2,0,20,18
1745835829694,MCWP 50,B00,893761,Bartulis; Jason Michael,18,0,20,2
1745835830725,MCWP 50R,A00,893766,Compas; Sean Matthew,0,1,20,20
1745835830725,MCWP 50R,B00,893769,Carter; Jennifer A,0,0,20,20
1745835830725,MCWP 50R,C00,893771,Krone; Jarret,0,3,20,20
1745835830725,MCWP 50R,D00,893772,Miller; Elizabeth Deen,3,0,20,17
1745835830725,MCWP 50R,E00,893775,Carter; Andrea L,0,0,20,20
1745835831750,MMW 11R,A01,892721,Herbst; Matthew,11,0,27,16
1745835831750,MMW 11R,A02,892722,Herbst; Matthew,0,0,0,3
1745835832777,MMW 12R,A01,892724,Herbst; Matthew,0,10,16,16
1745835832777,MMW 12R,A02,892725,Herbst; Matthew,0,9,16,16
1745835833806,MMW 13R,A01,892727,Staff,0,3,16,16
1745835833806,MMW 13R,A02,892728,Staff,0,4,16,16
1745835833806,MMW 13R,A03,958032,Staff,0,3,16,16
1745835833806,MMW 13R,A04,958033,Staff,0,2,16,16
1745835833806,MMW 13R,A05,958034,Staff,0,3,16,16
1745835834832,SIO 295LS,A00,894015,Staff,7,0,25,18
1745835835858,SIO 295S,A00,894020,Staff,7,0,25,18
1745835836887,SIOC 290S,B01,958918,Staff,0,0,0,0
1745835837917,SIOC 291S,B01,958922,Staff,0,0,0,0
1745835838943,SOCI 117,A01,895339,Staff,4,0,5,1
1745835839968,WES 237B,A00,894149,Staff,11,0,20,9
1745835842041,AESE 279B,A00,891859,Staff,13,0,35,22
1745835843066,AIP 197,001,891854,Staff,70,0,70,0
1745835844094,ANTH 289S,A00,891856,Gagneux; Pascal,12,0,12,0
1745835845125,BENG 196,001,957946,Engler; Adam J.,9996,0,9999,3
1745835846150,CAT 124RS,A01,956906,Staff,8,0,25,17
1745835847177,CAT 125RS,A01,922013,Staff,8,0,25,17
1745835848202,CLRE 250,A00,891860,Morris; Sheldon,9995,0,9999,4
1745835850253,CLRE 251R,A00,907817,Mehta; Ravindra L.,9994,0,9999,5
1745835851278,CLRE 252,A00,891864,Cuomo; Raphael Eduardo,9993,0,9999,6
1745835852306,CLRE 253,A00,891867,Vaida; Florin,9994,0,9999,5
1745835852306,CLRE 253,B00,907819,Staff,9999,0,9999,0
1745835853334,CLRE 259,A00,891868,Patel; Hemal,9998,0,9999,1
1745835854358,CLRE 260,A00,891872,Cuomo; Raphael Eduardo,9999,0,9999,0
1745835855382,CLRE 297,001,891888,Cuomo; Raphael Eduardo,9999,0,9999,0
1745835856409,CSE 191,A00,958773,Minnes Kemp; Mor Mia,9999,0,9999,0
1745835857435,CSS 201S,A01,892054,Mignozzetti; Umberto,30,0,30,0
1745835858465,CSS 202S,A01,892056,Mignozzetti; Umberto,30,0,30,0
1745835859493,DSC 197,001,956898,Eldridge; Justin Matthew,9998,0,9999,1
1745835860517,DSC 297,001,958000,Mazumdar; Arya,9998,0,9999,1
1745835861544,EAP 100,A00,905686,Staff,9776,0,9999,223
1745835862573,ECE 45,A01,892618,Staff,0,13,50,50
1745835863600,ECE 109,A01,892620,Staff,0,43,0,0
1745835864625,ECE 111,A01,892719,Staff,0,9,50,50
1745835865648,ECE 197,001,957920,Mercier; Patrick Philip,9992,0,9999,7
1745835866684,ECON 178,A01,907814,Zhu; Ying,28,0,35,7
1745835867710,EDS 115,A00,895312,Staff,41,0,45,4
1745835868736,EDS 117,A01,895337,Staff,30,0,30,0
1745835869766,EDS 125,A00,895341,Jones; Gabrielle Anastasia,43,0,45,2
1745835870792,EDS 128A,A01,895459,Fargason; Sharon Gayle,44,0,45,1
1745835871817,EDS 128B,A01,895543,Pappas; Elizabeth,44,0,45,1
1745835872842,EDS 139,A00,897203,Pappas; Elizabeth,44,0,45,1
1745835872842,EDS 139,B00,897209,Fargason; Sharon Gayle,44,0,45,1
1745835873869,EDS 201,A00,895545,Staff,43,0,45,2
1745835874896,EDS 203,A01,895581,Halter; Christopher P.,43,0,45,2
1745835875924,EDS 204R,A01,895625,Heinzman; Erica M.,43,0,45,2
1745835875924,EDS 204R,B01,895693,Halter; Christopher P.,18,0,45,27
1745835876949,EDS 206R,A00,895694,Fargason; Sharon Gayle,9,0,30,21
1745835876949,EDS 206R,B00,895695,Choi; Bailey Miyeon,20,0,30,10
1745835877979,EDS 250,A00,895697,Hemans; Patricia Ann Benitez,43,0,45,2
1745835879009,EDS 281,A00,895701,Meyerott; Theresa Ann,15,0,15,0
1745835880040,EDS 284,A00,895736,Meyerott; Theresa Ann,15,0,15,0
1745835881068,EDS 286,A00,897210,Fine; Sarah,15,0,15,0
1745835882097,EDS 289C,A01,895770,Daly; Alan J.,15,0,15,0
1745835883123,EDS 290,A00,897211,Hofstetter; Carolyn,15,0,15,0
1745835884149,LIGM 5A,A00,896162,Fischer-Grunski; Eva K,15,0,20,5
1745835885175,LIGM 5B,A00,896260,Fischer-Grunski; Eva K,17,0,20,3
1745835886202,LIGM 5C,A00,896308,Fischer-Grunski; Eva K,18,0,20,2
1745835887232,LIIT 5AS,A00,896313,Carnelos; Chiara,17,0,20,3
1745835888259,LIIT 5BS,A00,896416,Carnelos; Chiara,20,0,20,0
1745835889291,LIIT 5CS,A00,896564,Carnelos; Chiara,20,0,20,0
1745835890318,LISP 5A,A00,896588,Munoz Sanchez; Alicia,4,0,20,16
1745835891344,LISP 5B,A00,896653,Munoz Sanchez; Alicia,10,0,20,10
1745835892374,LISP 5C,A00,896655,Munoz Sanchez; Alicia,4,0,20,16
1745835893403,MAE 197,001,957918,Kleissl; Jan,9998,0,9999,1
1745835894431,MATH 2,A01,957937,Staff,34,0,35,1
1745835895456,MATH 197,001,957876,Kedlaya; Kiran S.,9993,0,9999,6
1745835896481,MCWP 40,A00,892729,Duru; Nur,13,0,20,7
1745835896481,MCWP 40,B00,893304,Montejo; Carolina,20,0,20,0
1745835897506,MCWP 40R,A00,893757,Redela; Pamela Morgan,0,7,20,20
1745835898532,MCWP 50,A00,893758,Morshed; Michael James,2,0,20,18
1745835898532,MCWP 50,B00,893761,Bartulis; Jason Michael,18,0,20,2
1745835899563,MCWP 50R,A00,893766,Compas; Sean Matthew,0,1,20,20
1745835899563,MCWP 50R,B00,893769,Carter; Jennifer A,0,0,20,20
1745835899563,MCWP 50R,C00,893771,Krone; Jarret,0,3,20,20
1745835899563,MCWP 50R,D00,893772,Miller; Elizabeth Deen,3,0,20,17
1745835899563,MCWP 50R,E00,893775,Carter; Andrea L,0,0,20,20
1745835900591,MMW 11R,A01,892721,Herbst; Matthew,11,0,27,16
1745835900591,MMW 11R,A02,892722,Herbst; Matthew,0,0,0,3
1745835901619,MMW 12R,A01,892724,Herbst; Matthew,0,10,16,16
1745835901619,MMW 12R,A02,892725,Herbst; Matthew,0,9,16,16
1745835902651,MMW 13R,A01,892727,Staff,0,3,16,16
1745835902651,MMW 13R,A02,892728,Staff,0,4,16,16
1745835902651,MMW 13R,A03,958032,Staff,0,3,16,16
1745835902651,MMW 13R,A04,958033,Staff,0,2,16,16
1745835902651,MMW 13R,A05,958034,Staff,0,3,16,16
1745835903684,SIO 295LS,A00,894015,Staff,7,0,25,18
1745835904709,SIO 295S,A00,894020,Staff,7,0,25,18
1745835905738,SIOC 290S,B01,958918,Staff,0,0,0,0
1745835906769,SIOC 291S,B01,958922,Staff,0,0,0,0
1745835907797,SOCI 117,A01,895339,Staff,4,0,5,1
1745835908826,WES 237B,A00,894149,Staff,11,0,20,9
1745835910892,AESE 279B,A00,891859,Staff,13,0,35,22
1745835911919,AIP 197,001,891854,Staff,70,0,70,0
1745835912948,ANTH 289S,A00,891856,Gagneux; Pascal,12,0,12,0
1745835913977,BENG 196,001,957946,Engler; Adam J.,9996,0,9999,3
1745835915007,CAT 124RS,A01,956906,Staff,8,0,25,17
1745835916033,CAT 125RS,A01,922013,Staff,8,0,25,17
1745835917060,CLRE 250,A00,891860,Morris; Sheldon,9995,0,9999,4
1745835919120,CLRE 251R,A00,907817,Mehta; Ravindra L.,9994,0,9999,5
1745835920149,CLRE 252,A00,891864,Cuomo; Raphael Eduardo,9993,0,9999,6
1745835921214,CLRE 253,A00,891867,Vaida; Florin,9994,0,9999,5
1745835921214,CLRE 253,B00,907819,Staff,9999,0,9999,0
1745835922241,CLRE 259,A00,891868,Patel; Hemal,9998,0,9999,1
1745835923266,CLRE 260,A00,891872,Cuomo; Raphael Eduardo,9999,0,9999,0
1745835924293,CLRE 297,001,891888,Cuomo; Raphael Eduardo,9999,0,9999,0
1745835925323,CSE 191,A00,958773,Minnes Kemp; Mor Mia,9999,0,9999,0
1745835926349,CSS 201S,A01,892054,Mignozzetti; Umberto,30,0,30,0
1745835927380,CSS 202S,A01,892056,Mignozzetti; Umberto,30,0,30,0
1745835928406,DSC 197,001,956898,Eldridge; Justin Matthew,9998,0,9999,1
1745835929439,DSC 297,001,958000,Mazumdar; Arya,9998,0,9999,1
1745835930468,EAP 100,A00,905686,Staff,9776,0,9999,223
1745835931494,ECE 45,A01,892618,Staff,0,13,50,50
1745835932521,ECE 109,A01,892620,Staff,0,43,0,0
1745835933548,ECE 111,A01,892719,Staff,0,9,50,50
1745835934572,ECE 197,001,957920,Mercier; Patrick Philip,9992,0,9999,7
1745835935603,ECON 178,A01,907814,Zhu; Ying,28,0,35,7
1745835936630,EDS 115,A00,895312,Staff,41,0,45,4
1745835937660,EDS 117,A01,895337,Staff,30,0,30,0
1745835938686,EDS 125,A00,895341,Jones; Gabrielle Anastasia,43,0,45,2
1745835939715,EDS 128A,A01,895459,Fargason; Sharon Gayle,44,0,45,1
1745835940766,EDS 128B,A01,895543,Pappas; Elizabeth,44,0,45,1
1745835941793,EDS 139,A00,897203,Pappas; Elizabeth,44,0,45,1
1745835941793,EDS 139,B00,897209,Fargason; Sharon Gayle,44,0,45,1
1745835942822,EDS 201,A00,895545,Staff,43,0,45,2
1745835943852,EDS 203,A01,895581,Halter; Christopher P.,43,0,45,2
1745835944881,EDS 204R,A01,895625,Heinzman; Erica M.,43,0,45,2
1745835944881,EDS 204R,B01,895693,Halter; Christopher P.,18,0,45,27
1745835945911,EDS 206R,A00,895694,Fargason; Sharon Gayle,9,0,30,21
1745835945911,EDS 206R,B00,895695,Choi; Bailey Miyeon,20,0,30,10
1745835946937,EDS 250,A00,895697,Hemans; Patricia Ann Benitez,43,0,45,2
1745835947967,EDS 281,A00,895701,Meyerott; Theresa Ann,15,0,15,0
1745835948997,EDS 284,A00,895736,Meyerott; Theresa Ann,15,0,15,0
1745835950025,EDS 286,A00,897210,Fine; Sarah,15,0,15,0
1745835951057,EDS 289C,A01,895770,Daly; Alan J.,15,0,15,0
1745835952085,EDS 290,A00,897211,Hofstetter; Carolyn,15,0,15,0
1745835953110,LIGM 5A,A00,896162,Fischer-Grunski; Eva K,15,0,20,5
1745835954141,LIGM 5B,A00,896260,Fischer-Grunski; Eva K,17,0,20,3
1745835955169,LIGM 5C,A00,896308,Fischer-Grunski; Eva K,18,0,20,2
1745835956199,LIIT 5AS,A00,896313,Carnelos; Chiara,17,0,20,3
1745835957226,LIIT 5BS,A00,896416,Carnelos; Chiara,20,0,20,0
1745835958253,LIIT 5CS,A00,896564,Carnelos; Chiara,20,0,20,0
1745835959280,LISP 5A,A00,896588,Munoz Sanchez; Alicia,4,0,20,16
1745835960311,LISP 5B,A00,896653,Munoz Sanchez; Alicia,10,0,20,10
1745835961342,LISP 5C,A00,896655,Munoz Sanchez; Alicia,4,0,20,16
1745835962368,MAE 197,001,957918,Kleissl; Jan,9998,0,9999,1
1745835963393,MATH 2,A01,957937,Staff,34,0,35,1
1745835964419,MATH 197,001,957876,Kedlaya; Kiran S.,9993,0,9999,6
1745835965445,MCWP 40,A00,892729,Duru; Nur,13,0,20,7
1745835965445,MCWP 40,B00,893304,Montejo; Carolina,20,0,20,0
1745835966476,MCWP 40R,A00,893757,Redela; Pamela Morgan,0,7,20,20
1745835967502,MCWP 50,A00,893758,Morshed; Michael James,2,0,20,18
1745835967502,MCWP 50,B00,893761,Bartulis; Jason Michael,18,0,20,2
1745835968531,MCWP 50R,A00,893766,Compas; Sean Matthew,0,1,20,20
1745835968531,MCWP 50R,B00,893769,Carter; Jennifer A,0,0,20,20
1745835968531,MCWP 50R,C00,893771,Krone; Jarret,0,3,20,20
1745835968531,MCWP 50R,D00,893772,Miller; Elizabeth Deen,3,0,20,17
1745835968531,MCWP 50R,E00,893775,Carter; Andrea L,0,0,20,20
1745835969560,MMW 11R,A01,892721,Herbst; Matthew,11,0,27,16
1745835969560,MMW 11R,A02,892722,Herbst; Matthew,0,0,0,3
1745835970585,MMW 12R,A01,892724,Herbst; Matthew,0,10,16,16
1745835970585,MMW 12R,A02,892725,Herbst; Matthew,0,9,16,16
1745835971611,MMW 13R,A01,892727,Staff,0,3,16,16
1745835971611,MMW 13R,A02,892728,Staff,0,4,16,16
1745835971611,MMW 13R,A03,958032,Staff,0,3,16,16
1745835971611,MMW 13R,A04,958033,Staff,0,2,16,16
1745835971611,MMW 13R,A05,958034,Staff,0,3,16,16
1745835972640,SIO 295LS,A00,894015,Staff,7,0,25,18
1745835973667,SIO 295S,A00,894020,Staff,7,0,25,18
1745835974694,SIOC 290S,B01,958918,Staff,0,0,0,0
1745835975727,SIOC 291S,B01,958922,Staff,0,0,0,0
1745835976755,SOCI 117,A01,895339,Staff,4,0,5,1
1745835977783,WES 237B,A00,894149,Staff,11,0,20,9
1745835979853,AESE 279B,A00,891859,Staff,13,0,35,22
1745835980877,AIP 197,001,891854,Staff,70,0,70,0
1745835981903,ANTH 289S,A00,891856,Gagneux; Pascal,12,0,12,0
1745835982931,BENG 196,001,957946,Engler; Adam J.,9996,0,9999,3
1745835983958,CAT 124RS,A01,956906,Staff,8,0,25,17
1745835984983,CAT 125RS,A01,922013,Staff,8,0,25,17
1745835986010,CLRE 250,A00,891860,Morris; Sheldon,9995,0,9999,4
1745835988061,CLRE 251R,A00,907817,Mehta; Ravindra L.,9994,0,9999,5
1745835989091,CLRE 252,A00,891864,Cuomo; Raphael Eduardo,9993,0,9999,6
1745835990117,CLRE 253,A00,891867,Vaida; Florin,9994,0,9999,5
1745835990117,CLRE 253,B00,907819,Staff,9999,0,9999,0
1745835991145,CLRE 259,A00,891868,Patel; Hemal,9998,0,9999,1
1745835992170,CLRE 260,A00,891872,Cuomo; Raphael Eduardo,9999,0,9999,0
1745835993198,CLRE 297,001,891888,Cuomo; Raphael Eduardo,9999,0,9999,0
1745835994223,CSE 191,A00,958773,Minnes Kemp; Mor Mia,9999,0,9999,0
1745835995253,CSS 201S,A01,892054,Mignozzetti; Umberto,30,0,30,0
1745835996281,CSS 202S,A01,892056,Mignozzetti; Umberto,30,0,30,0
1745835997307,DSC 197,001,956898,Eldridge; Justin Matthew,9998,0,9999,1
1745835998335,DSC 297,001,958000,Mazumdar; Arya,9998,0,9999,1
1745835999364,EAP 100,A00,905686,Staff,9776,0,9999,223
1745836000389,ECE 45,A01,892618,Staff,0,13,50,50
1745836001417,ECE 109,A01,892620,Staff,0,43,0,0
1745836002443,ECE 111,A01,892719,Staff,0,9,50,50
1745836003468,ECE 197,001,957920,Mercier; Patrick Philip,9992,0,9999,7
1745836004494,ECON 178,A01,907814,Zhu; Ying,28,0,35,7
1745836005522,EDS 115,A00,895312,Staff,41,0,45,4
1745836006552,EDS 117,A01,895337,Staff,30,0,30,0
1745836007579,EDS 125,A00,895341,Jones; Gabrielle Anastasia,43,0,45,2
1745836008606,EDS 128A,A01,895459,Fargason; Sharon Gayle,44,0,45,1
1745836009636,EDS 128B,A01,895543,Pappas; Elizabeth,44,0,45,1
1745836010666,EDS 139,A00,897203,Pappas; Elizabeth,44,0,45,1
1745836010666,EDS 139,B00,897209,Fargason; Sharon Gayle,44,0,45,1
1745836011708,EDS 201,A00,895545,Staff,43,0,45,2
1745836012738,EDS 203,A01,895581,Halter; Christopher P.,43,0,45,2
1745836013770,EDS 204R,A01,895625,Heinzman; Erica M.,43,0,45,2
1745836013770,EDS 204R,B01,895693,Halter; Christopher P.,18,0,45,27
1745836014797,EDS 206R,A00,895694,Fargason; Sharon Gayle,9,0,30,21
1745836014797,EDS 206R,B00,895695,Choi; Bailey Miyeon,20,0,30,10
1745836015829,EDS 250,A00,895697,Hemans; Patricia Ann Benitez,43,0,45,2
1745836016859,EDS 281,A00,895701,Meyerott; Theresa Ann,15,0,15,0
1745836017886,EDS 284,A00,895736,Meyerott; Theresa Ann,15,0,15,0
1745836018915,EDS 286,A00,897210,Fine; Sarah,15,0,15,0
1745836019944,EDS 289C,A01,895770,Daly; Alan J.,15,0,15,0
1745836020971,EDS 290,A00,897211,Hofstetter; Carolyn,15,0,15,0
1745836022004,LIGM 5A,A00,896162,Fischer-Grunski; Eva K,15,0,20,5
1745836023054,LIGM 5B,A00,896260,Fischer-Grunski; Eva K,17,0,20,3
1745836024080,LIGM 5C,A00,896308,Fischer-Grunski; Eva K,18,0,20,2
1745836025106,LIIT 5AS,A00,896313,Carnelos; Chiara,17,0,20,3
1745836026130,LIIT 5BS,A00,896416,Carnelos; Chiara,20,0,20,0
1745836027160,LIIT 5CS,A00,896564,Carnelos; Chiara,20,0,20,0
1745836028188,LISP 5A,A00,896588,Munoz Sanchez; Alicia,4,0,20,16
1745836029213,LISP 5B,A00,896653,Munoz Sanchez; Alicia,10,0,20,10
1745836030242,LISP 5C,A00,896655,Munoz Sanchez; Alicia,4,0,20,16
1745836031271,MAE 197,001,957918,Kleissl; Jan,9998,0,9999,1
1745836032296,MATH 2,A01,957937,Staff,34,0,35,1
1745836033322,MATH 197,001,957876,Kedlaya; Kiran S.,9993,0,9999,6
1745836034346,MCWP 40,A00,892729,Duru; Nur,13,0,20,7
1745836034346,MCWP 40,B00,893304,Montejo; Carolina,20,0,20,0
1745836035375,MCWP 40R,A00,893757,Redela; Pamela Morgan,0,7,20,20
1745836036405,MCWP 50,A00,893758,Morshed; Michael James,2,0,20,18
1745836036405,MCWP 50,B00,893761,Bartulis; Jason Michael,18,0,20,2
1745836037437,MCWP 50R,A00,893766,Compas; Sean Matthew,0,1,20,20
1745836037437,MCWP 50R,B00,893769,Carter; Jennifer A,0,0,20,20
1745836037437,MCWP 50R,C00,893771,Krone; Jarret,0,3,20,20
1745836037437,MCWP 50R,D00,893772,Miller; Elizabeth Deen,3,0,20,17
1745836037437,MCWP 50R,E00,893775,Carter; Andrea L,0,0,20,20
1745836038465,MMW 11R,A01,892721,Herbst; Matthew,11,0,27,16
1745836038465,MMW 11R,A02,892722,Herbst; Matthew,0,0,0,3
1745836039491,MMW 12R,A01,892724,Herbst; Matthew,0,10,16,16
1745836039491,MMW 12R,A02,892725,Herbst; Matthew,0,9,16,16
1745836040520,MMW 13R,A01,892727,Staff,0,3,16,16
1745836040520,MMW 13R,A02,892728,Staff,0,4,16,16
1745836040520,MMW 13R,A03,958032,Staff,0,3,16,16
1745836040520,MMW 13R,A04,958033,Staff,0,2,16,16
1745836040520,MMW 13R,A05,958034,Staff,0,3,16,16
1745836041548,SIO 295LS,A00,894015,Staff,7,0,25,18
1745836042576,SIO 295S,A00,894020,Staff,7,0,25,18
1745836043628,SIOC 290S,B01,958918,Staff,0,0,0,0
1745836044655,SIOC 291S,B01,958922,Staff,0,0,0,0
1745836045681,SOCI 117,A01,895339,Staff,4,0,5,1
1745836046707,WES 237B,A00,894149,Staff,11,0,20,9
1745836048772,AESE 279B,A00,891859,Staff,13,0,35,22
1745836049800,AIP 197,001,891854,Staff,70,0,70,0
1745836050826,ANTH 289S,A00,891856,Gagneux; Pascal,12,0,12,0
1745836051853,BENG 196,001,957946,Engler; Adam J.,9996,0,9999,3
1745836052878,CAT 124RS,A01,956906,Staff,8,0,25,17
1745836053907,CAT 125RS,A01,922013,Staff,8,0,25,17
1745836054936,CLRE 250,A00,891860,Morris; Sheldon,9995,0,9999,4
1745836056986,CLRE 251R,A00,907817,Mehta; Ravindra L.,9994,0,9999,5
1745836058012,CLRE 252,A00,891864,Cuomo; Raphael Eduardo,9993,0,9999,6
1745836059041,CLRE 253,A00,891867,Vaida; Florin,9994,0,9999,5
1745836059041,CLRE 253,B00,907819,Staff,9999,0,9999,0
1745836060068,CLRE 259,A00,891868,Patel; Hemal,9998,0,9999,1
1745836061093,CLRE 260,A00,891872,Cuomo; Raphael Eduardo,9999,0,9999,0
1745836062119,CLRE 297,001,891888,Cuomo; Raphael Eduardo,9999,0,9999,0
1745836063144,CSE 191,A00,958773,Minnes Kemp; Mor Mia,9999,0,9999,0
1745836064175,CSS 201S,A01,892054,Mignozzetti; Umberto,30,0,30,0
1745836065204,CSS 202S,A01,892056,Mignozzetti; Umberto,30,0,30,0
1745836066230,DSC 197,001,956898,Eldridge; Justin Matthew,9998,0,9999,1
1745836067259,DSC 297,001,958000,Mazumdar; Arya,9998,0,9999,1
1745836068289,EAP 100,A00,905686,Staff,9776,0,9999,223
1745836069319,ECE 45,A01,892618,Staff,0,13,50,50
1745836070345,ECE 109,A01,892620,Staff,0,43,0,0
1745836071374,ECE 111,A01,892719,Staff,0,9,50,50
1745836072400,ECE 197,001,957920,Mercier; Patrick Philip,9992,0,9999,7
1745836073424,ECON 178,A01,907814,Zhu; Ying,28,0,35,7
1745836074453,EDS 115,A00,895312,Staff,41,0,45,4
1745836075481,EDS 117,A01,895337,Staff,30,0,30,0
1745836076511,EDS 125,A00,895341,Jones; Gabrielle Anastasia,43,0,45,2
1745836077541,EDS 128A,A01,895459,Fargason; Sharon Gayle,44,0,45,1
1745836078565,EDS 128B,A01,895543,Pappas; Elizabeth,44,0,45,1
1745836079591,EDS 139,A00,897203,Pappas; Elizabeth,44,0,45,1
1745836079591,EDS 139,B00,897209,Fargason; Sharon Gayle,44,0,45,1
1745836080622,EDS 201,A00,895545,Staff,43,0,45,2
1745836081653,EDS 203,A01,895581,Halter; Christopher P.,43,0,45,2
1745836082679,EDS 204R,A01,895625,Heinzman; Erica M.,43,0,45,2
1745836082679,EDS 204R,B01,895693,Halter; Christopher P.,18,0,45,27
1745836083709,EDS 206R,A00,895694,Fargason; Sharon Gayle,9,0,30,21
1745836083709,EDS 206R,B00,895695,Choi; Bailey Miyeon,20,0,30,10
1745836084737,EDS 250,A00,895697,Hemans; Patricia Ann Benitez,43,0,45,2
1745836085765,EDS 281,A00,895701,Meyerott; Theresa Ann,15,0,15,0
1745836086795,EDS 284,A00,895736,Meyerott; Theresa Ann,15,0,15,0
1745836087819,EDS 286,A00,897210,Fine; Sarah,15,0,15,0
1745836088847,EDS 289C,A01,895770,Daly; Alan J.,15,0,15,0
1745836089871,EDS 290,A00,897211,Hofstetter; Carolyn,15,0,15,0
1745836090900,LIGM 5A,A00,896162,Fischer-Grunski; Eva K,15,0,20,5
1745836091928,LIGM 5B,A00,896260,Fischer-Grunski; Eva K,17,0,20,3
1745836092954,LIGM 5C,A00,896308,Fischer-Grunski; Eva K,18,0,20,2
1745836093981,LIIT 5AS,A00,896313,Carnelos; Chiara,17,0,20,3
1745836095017,LIIT 5BS,A00,896416,Carnelos; Chiara,20,0,20,0
1745836096044,LIIT 5CS,A00,896564,Carnelos; Chiara,20,0,20,0
1745836097073,LISP 5A,A00,896588,Munoz Sanchez; Alicia,4,0,20,16
1745836098099,LISP 5B,A00,896653,Munoz Sanchez; Alicia,10,0,20,10
1745836099128,LISP 5C,A00,896655,Munoz Sanchez; Alicia,4,0,20,16
1745836100158,MAE 197,001,957918,Kleissl; Jan,9998,0,9999,1
1745836101184,MATH 2,A01,957937,Staff,34,0,35,1
1745836102209,MATH 197,001,957876,Kedlaya; Kiran S.,9993,0,9999,6
1745836103234,MCWP 40,A00,892729,Duru; Nur,13,0,20,7
1745836103234,MCWP 40,B00,893304,Montejo; Carolina,20,0,20,0
1745836104260,MCWP 40R,A00,893757,Redela; Pamela Morgan,0,7,20,20
1745836105291,MCWP 50,A00,893758,Morshed; Michael James,2,0,20,18
1745836105291,MCWP 50,B00,893761,Bartulis; Jason Michael,18,0,20,2
1745836106323,MCWP 50R,A00,893766,Compas; Sean Matthew,0,1,20,20
1745836106323,MCWP 50R,B00,893769,Carter; Jennifer A,0,0,20,20
1745836106323,MCWP 50R,C00,893771,Krone; Jarret,0,3,20,20
1745836106323,MCWP 50R,D00,893772,Miller; Elizabeth Deen,3,0,20,17
1745836106323,MCWP 50R,E00,893775,Carter; Andrea L,0,0,20,20
1745836107347,MMW 11R,A01,892721,Herbst; Matthew,11,0,27,16
1745836107347,MMW 11R,A02,892722,Herbst; Matthew,0,0,0,3
1745836108375,MMW 12R,A01,892724,Herbst; Matthew,0,10,16,16
1745836108375,MMW 12R,A02,892725,Herbst; Matthew,0,9,16,16
1745836109404,MMW 13R,A01,892727,Staff,0,3,16,16
1745836109404,MMW 13R,A02,892728,Staff,0,4,16,16
1745836109404,MMW 13R,A03,958032,Staff,0,3,16,16
1745836109404,MMW 13R,A04,958033,Staff,0,2,16,16
1745836109404,MMW 13R,A05,958034,Staff,0,3,16,16
1745836110431,SIO 295LS,A00,894015,Staff,7,0,25,18
1745836111458,SIO 295S,A00,894020,Staff,7,0,25,18
1745836112487,SIOC 290S,B01,958918,Staff,0,0,0,0
1745836113519,SIOC 291S,B01,958922,Staff,0,0,0,0
1745836114545,SOCI 117,A01,895339,Staff,4,0,5,1
1745836115576,WES 237B,A00,894149,Staff,11,0,20,9
1745836117643,AESE 279B,A00,891859,Staff,13,0,35,22
1745836118671,AIP 197,001,891854,Staff,70,0,70,0
1745836119698,ANTH 289S,A00,891856,Gagneux; Pascal,12,0,12,0
1745836120724,BENG 196,001,957946,Engler; Adam J.,9996,0,9999,3
1745836121748,CAT 124RS,A01,956906,Staff,8,0,25,17
1745836122773,CAT 125RS,A01,922013,Staff,8,0,25,17
1745836123799,CLRE 250,A00,891860,Morris; Sheldon,9995,0,9999,4
1745836125850,CLRE 251R,A00,907817,Mehta; Ravindra L.,9994,0,9999,5
1745836126877,CLRE 252,A00,891864,Cuomo; Raphael Eduardo,9993,0,9999,6
1745836127903,CLRE 253,A00,891867,Vaida; Florin,9994,0,9999,5
1745836127903,CLRE 253,B00,907819,Staff,9999,0,9999,0
1745836128931,CLRE 259,A00,891868,Patel; Hemal,9998,0,9999,1
1745836129957,CLRE 260,A00,891872,Cuomo; Raphael Eduardo,9999,0,9999,0
1745836130984,CLRE 297,001,891888,Cuomo; Raphael Eduardo,9999,0,9999,0
1745836132013,CSE 191,A00,958773,Minnes Kemp; Mor Mia,9999,0,9999,0
1745836133040,CSS 201S,A01,892054,Mignozzetti; Umberto,30,0,30,0
1745836134069,CSS 202S,A01,892056,Mignozzetti; Umberto,30,0,30,0
1745836135098,DSC 197,001,956898,Eldridge; Justin Matthew,9998,0,9999,1
1745836136126,DSC 297,001,958000,Mazumdar; Arya,9998,0,9999,1
1745836137156,EAP 100,A00,905686,Staff,9776,0,9999,223
1745836138181,ECE 45,A01,892618,Staff,0,13,50,50
1745836139213,ECE 109,A01,892620,Staff,0,43,0,0
1745836140238,ECE 111,A01,892719,Staff,0,9,50,50
1745836141266,ECE 197,001,957920,Mercier; Patrick Philip,9992,0,9999,7
1745836142305,ECON 178,A01,907814,Zhu; Ying,28,0,35,7
1745836143332,EDS 115,A00,895312,Staff,41,0,45,4
1745836144377,EDS 117,A01,895337,Staff,30,0,30,0
1745836145403,EDS 125,A00,895341,Jones; Gabrielle Anastasia,43,0,45,2
1745836146429,EDS 128A,A01,895459,Fargason; Sharon Gayle,44,0,45,1
1745836147454,EDS 128B,A01,895543,Pappas; Elizabeth,44,0,45,1
1745836148482,EDS 139,A00,897203,Pappas; Elizabeth,44,0,45,1
1745836148482,EDS 139,B00,897209,Fargason; Sharon Gayle,44,0,45,1
1745836149510,EDS 201,A00,895545,Staff,43,0,45,2
1745836150537,EDS 203,A01,895581,Halter; Christopher P.,43,0,45,2
1745836151567,EDS 204R,A01,895625,Heinzman; Erica M.,43,0,45,2
1745836151567,EDS 204R,B01,895693,Halter; Christopher P.,18,0,45,27
1745836152594,EDS 206R,A00,895694,Fargason; Sharon Gayle,9,0,30,21
1745836152594,EDS 206R,B00,895695,Choi; Bailey Miyeon,20,0,30,10
1745836153622,EDS 250,A00,895697,Hemans; Patricia Ann Benitez,43,0,45,2
1745836154651,EDS 281,A00,895701,Meyerott; Theresa Ann,15,0,15,0
1745836155675,EDS 284,A00,895736,Meyerott; Theresa Ann,15,0,15,0
1745836156702,EDS 286,A00,897210,Fine; Sarah,15,0,15,0
1745836157730,EDS 289C,A01,895770,Daly; Alan J.,15,0,15,0
1745836158756,EDS 290,A00,897211,Hofstetter; Carolyn,15,0,15,0
1745836159782,LIGM 5A,A00,896162,Fischer-Grunski; Eva K,15,0,20,5
1745836160814,LIGM 5B,A00,896260,Fischer-Grunski; Eva K,17,0,20,3
1745836161840,LIGM 5C,A00,896308,Fischer-Grunski; Eva K,18,0,20,2
1745836162869,LIIT 5AS,A00,896313,Carnelos; Chiara,17,0,20,3
1745836163895,LIIT 5BS,A00,896416,Carnelos; Chiara,20,0,20,0
1745836164920,LIIT 5CS,A00,896564,Carnelos; Chiara,20,0,20,0
1745836165951,LISP 5A,A00,896588,Munoz Sanchez; Alicia,4,0,20,16
1745836166977,LISP 5B,A00,896653,Munoz Sanchez; Alicia,10,0,20,10
1745836168002,LISP 5C,A00,896655,Munoz Sanchez; Alicia,4,0,20,16
1745836169031,MAE 197,001,957918,Kleissl; Jan,9998,0,9999,1
1745836170060,MATH 2,A01,957937,Staff,34,0,35,1
1745836171086,MATH 197,001,957876,Kedlaya; Kiran S.,9993,0,9999,6
1745836172116,MCWP 40,A00,892729,Duru; Nur,13,0,20,7
1745836172116,MCWP 40,B00,893304,Montejo; Carolina,20,0,20,0
1745836173142,MCWP 40R,A00,893757,Redela; Pamela Morgan,0,7,20,20
1745836174170,MCWP 50,A00,893758,Morshed; Michael James,2,0,20,18
1745836174170,MCWP 50,B00,893761,Bartulis; Jason Michael,18,0,20,2
1745836175199,MCWP 50R,A00,893766,Compas; Sean Matthew,0,1,20,20
1745836175199,MCWP 50R,B00,893769,Carter; Jennifer A,0,0,20,20
1745836175199,MCWP 50R,C00,893771,Krone; Jarret,0,3,20,20
1745836175199,MCWP 50R,D00,893772,Miller; Elizabeth Deen,3,0,20,17
1745836175199,MCWP 50R,E00,893775,Carter; Andrea L,0,0,20,20
1745836176224,MMW 11R,A01,892721,Herbst; Matthew,11,0,27,16
1745836176224,MMW 11R,A02,892722,Herbst; Matthew,0,0,0,3
1745836177250,MMW 12R,A01,892724,Herbst; Matthew,0,10,16,16
1745836177250,MMW 12R,A02,892725,Herbst; Matthew,0,9,16,16
1745836178280,MMW 13R,A01,892727,Staff,0,3,16,16
1745836178280,MMW 13R,A02,892728,Staff,0,4,16,16
1745836178280,MMW 13R,A03,958032,Staff,0,3,16,16
1745836178280,MMW 13R,A04,958033,Staff,0,2,16,16
1745836178280,MMW 13R,A05,958034,Staff,0,3,16,16
1745836179305,SIO 295LS,A00,894015,Staff,7,0,25,18
1745836180334,SIO 295S,A00,894020,Staff,7,0,25,18
1745836181360,SIOC 290S,B01,958918,Staff,0,0,0,0
1745836182407,SIOC 291S,B01,958922,Staff,0,0,0,0
1745836183433,SOCI 117,A01,895339,Staff,4,0,5,1
1745836184460,WES 237B,A00,894149,Staff,11,0,20,9
1745836186522,AESE 279B,A00,891859,Staff,13,0,35,22
1745836187549,AIP 197,001,891854,Staff,70,0,70,0
1745836188575,ANTH 289S,A00,891856,Gagneux; Pascal,12,0,12,0
1745836189601,BENG 196,001,957946,Engler; Adam J.,9996,0,9999,3
1745836190627,CAT 124RS,A01,956906,Staff,8,0,25,17
1745836191655,CAT 125RS,A01,922013,Staff,8,0,25,17
1745836192682,CLRE 250,A00,891860,Morris; Sheldon,9995,0,9999,4
1745836194734,CLRE 251R,A00,907817,Mehta; Ravindra L.,9994,0,9999,5
1745836195762,CLRE 252,A00,891864,Cuomo; Raphael Eduardo,9993,0,9999,6
1745836196790,CLRE 253,A00,891867,Vaida; Florin,9994,0,9999,5
1745836196790,CLRE 253,B00,907819,Staff,9999,0,9999,0
1745836197816,CLRE 259,A00,891868,Patel; Hemal,9998,0,9999,1
1745836198843,CLRE 260,A00,891872,Cuomo; Raphael Eduardo,9999,0,9999,0
1745836199870,CLRE 297,001,891888,Cuomo; Raphael Eduardo,9999,0,9999,0
1745836200896,CSE 191,A00,958773,Minnes Kemp; Mor Mia,9999,0,9999,0
1745836201924,CSS 201S,A01,892054,Mignozzetti; Umberto,30,0,30,0
1745836202953,CSS 202S,A01,892056,Mignozzetti; Umberto,30,0,30,0
1745836203977,DSC 197,001,956898,Eldridge; Justin Matthew,9998,0,9999,1
1745836205004,DSC 297,001,958000,Mazumdar; Arya,9998,0,9999,1
1745836206033,EAP 100,A00,905686,Staff,9776,0,9999,223
1745836207060,ECE 45,A01,892618,Staff,0,13,50,50
1745836208088,ECE 109,A01,892620,Staff,0,43,0,0
1745836209116,ECE 111,A01,892719,Staff,0,9,50,50
1745836210147,ECE 197,001,957920,Mercier; Patrick Philip,9992,0,9999,7
1745836211175,ECON 178,A01,907814,Zhu; Ying,28,0,35,7
1745836212228,EDS 115,A00,895312,Staff,41,0,45,4
1745836213257,EDS 117,A01,895337,Staff,30,0,30,0
1745836214286,EDS 125,A00,895341,Jones; Gabrielle Anastasia,43,0,45,2
1745836215314,EDS 128A,A01,895459,Fargason; Sharon Gayle,44,0,45,1
1745836216341,EDS 128B,A01,895543,Pappas; Elizabeth,44,0,45,1
1745836217366,EDS 139,A00,897203,Pappas; Elizabeth,44,0,45,1
1745836217366,EDS 139,B00,897209,Fargason; Sharon Gayle,44,0,45,1
1745836218393,EDS 201,A00,895545,Staff,43,0,45,2
1745836219418,EDS 203,A01,895581,Halter; Christopher P.,43,0,45,2
1745836220448,EDS 204R,A01,895625,Heinzman; Erica M.,43,0,45,2
1745836220448,EDS 204R,B01,895693,Halter; Christopher P.,18,0,45,27
1745836221474,EDS 206R,A00,895694,Fargason; Sharon Gayle,9,0,30,21
1745836221474,EDS 206R,B00,895695,Choi; Bailey Miyeon,20,0,30,10
1745836222498,EDS 250,A00,895697,Hemans; Patricia Ann Benitez,43,0,45,2
1745836223526,EDS 281,A00,895701,Meyerott; Theresa Ann,15,0,15,0
1745836224550,EDS 284,A00,895736,Meyerott; Theresa Ann,15,0,15,0
1745836225575,EDS 286,A00,897210,Fine; Sarah,15,0,15,0
1745836226604,EDS 289C,A01,895770,Daly; Alan J.,15,0,15,0
1745836227632,EDS 290,A00,897211,Hofstetter; Carolyn,15,0,15,0
1745836228662,LIGM 5A,A00,896162,Fischer-Grunski; Eva K,15,0,20,5
1745836229690,LIGM 5B,A00,896260,Fischer-Grunski; Eva K,17,0,20,3
1745836230716,LIGM 5C,A00,896308,Fischer-Grunski; Eva K,18,0,20,2
1745836231744,LIIT 5AS,A00,896313,Carnelos; Chiara,17,0,20,3
1745836232768,LIIT 5BS,A00,896416,Carnelos; Chiara,20,0,20,0
1745836233795,LIIT 5CS,A00,896564,Carnelos; Chiara,20,0,20,0
1745836234820,LISP 5A,A00,896588,Munoz Sanchez; Alicia,4,0,20,16
1745836235846,LISP 5B,A00,896653,Munoz Sanchez; Alicia,10,0,20,10
1745836236871,LISP 5C,A00,896655,Munoz Sanchez; Alicia,4,0,20,16
1745836237897,MAE 197,001,957918,Kleissl; Jan,9998,0,9999,1
1745836238926,MATH 2,A01,957937,Staff,34,0,35,1
1745836239955,MATH 197,001,957876,Kedlaya; Kiran S.,9993,0,9999,6
1745836240980,MCWP 40,A00,892729,Duru; Nur,13,0,20,7
1745836240980,MCWP 40,B00,893304,Montejo; Carolina,20,0,20,0
1745836242009,MCWP 40R,A00,893757,Redela; Pamela Morgan,0,7,20,20
1745836243038,MCWP 50,A00,893758,Morshed; Michael James,2,0,20,18
1745836243038,MCWP 50,B00,893761,Bartulis; Jason Michael,18,0,20,2
1745836244065,MCWP 50R,A00,893766,Compas; Sean Matthew,0,1,20,20
1745836244065,MCWP 50R,B00,893769,Carter; Jennifer A,0,0,20,20
1745836244065,MCWP 50R,C00,893771,Krone; Jarret,0,3,20,20
1745836244065,MCWP 50R,D00,893772,Miller; Elizabeth Deen,3,0,20,17
1745836244065,MCWP 50R,E00,893775,Carter; Andrea L,0,0,20,20
1745836245094,MMW 11R,A01,892721,Herbst; Matthew,11,0,27,16
1745836245094,MMW 11R,A02,892722,Herbst; Matthew,0,0,0,3
1745836246123,MMW 12R,A01,892724,Herbst; Matthew,0,10,16,16
1745836246123,MMW 12R,A02,892725,Herbst; Matthew,0,9,16,16
1745836247151,MMW 13R,A01,892727,Staff,0,3,16,16
1745836247151,MMW 13R,A02,892728,Staff,0,4,16,16
1745836247151,MMW 13R,A03,958032,Staff,0,3,16,16
1745836247151,MMW 13R,A04,958033,Staff,0,2,16,16
1745836247151,MMW 13R,A05,958034,Staff,0,3,16,16
1745836248180,SIO 295LS,A00,894015,Staff,7,0,25,18
1745836249207,SIO 295S,A00,894020,Staff,7,0,25,18
1745836250238,SIOC 290S,B01,958918,Staff,0,0,0,0
1745836251269,SIOC 291S,B01,958922,Staff,0,0,0,0
1745836252299,SOCI 117,A01,895339,Staff,4,0,5,1
1745836253326,WES 237B,A00,894149,Staff,11,0,20,9
1745836255393,AESE 279B,A00,891859,Staff,13,0,35,22
1745836256423,AIP 197,001,891854,Staff,70,0,70,0
1745836257450,ANTH 289S,A00,891856,Gagneux; Pascal,12,0,12,0
1745836258474,BENG 196,001,957946,Engler; Adam J.,9996,0,9999,3
1745836259501,CAT 124RS,A01,956906,Staff,8,0,25,17
1745836260528,CAT 125RS,A01,922013,Staff,8,0,25,17
1745836261553,CLRE 250,A00,891860,Morris; Sheldon,9995,0,9999,4
1745836263604,CLRE 251R,A00,907817,Mehta; Ravindra L.,9994,0,9999,5
1745836264629,CLRE 252,A00,891864,Cuomo; Raphael Eduardo,9993,0,9999,6
1745836265661,CLRE 253,A00,891867,Vaida; Florin,9994,0,9999,5
1745836265661,CLRE 253,B00,907819,Staff,9999,0,9999,0
1745836266689,CLRE 259,A00,891868,Patel; Hemal,9998,0,9999,1
1745836267716,CLRE 260,A00,891872,Cuomo; Raphael Eduardo,9999,0,9999,0
1745836268744,CLRE 297,001,891888,Cuomo; Raphael Eduardo,9999,0,9999,0
1745836269773,CSE 191,A00,958773,Minnes Kemp; Mor Mia,9999,0,9999,0
1745836270806,CSS 201S,A01,892054,Mignozzetti; Umberto,30,0,30,0
1745836271833,CSS 202S,A01,892056,Mignozzetti; Umberto,30,0,30,0
1745836272858,DSC 197,001,956898,Eldridge; Justin Matthew,9998,0,9999,1
1745836273887,DSC 297,001,958000,Mazumdar; Arya,9998,0,9999,1
1745836274914,EAP 100,A00,905686,Staff,9776,0,9999,223
1745836275944,ECE 45,A01,892618,Staff,0,13,50,50
1745836276971,ECE 109,A01,892620,Staff,0,43,0,0
1745836277998,ECE 111,A01,892719,Staff,0,9,50,50
1745836279024,ECE 197,001,957920,Mercier; Patrick Philip,9992,0,9999,7
1745836280050,ECON 178,A01,907814,Zhu; Ying,28,0,35,7
1745836281078,EDS 115,A00,895312,Staff,41,0,45,4
1745836282105,EDS 117,A01,895337,Staff,30,0,30,0
1745836283135,EDS 125,A00,895341,Jones; Gabrielle Anastasia,43,0,45,2
1745836284222,EDS 128A,A01,895459,Fargason; Sharon Gayle,44,0,45,1
1745836285250,EDS 128B,A01,895543,Pappas; Elizabeth,44,0,45,1
1745836286276,EDS 139,A00,897203,Pappas; Elizabeth,44,0,45,1
1745836286276,EDS 139,B00,897209,Fargason; Sharon Gayle,44,0,45,1
1745836287304,EDS 201,A00,895545,Staff,43,0,45,2
1745836288333,EDS 203,A01,895581,Halter; Christopher P.,43,0,45,2
1745836289358,EDS 204R,A01,895625,Heinzman; Erica M.,43,0,45,2
1745836289358,EDS 204R,B01,895693,Halter; Christopher P.,18,0,45,27
1745836290388,EDS 206R,A00,895694,Fargason; Sharon Gayle,9,0,30,21
1745836290388,EDS 206R,B00,895695,Choi; Bailey Miyeon,20,0,30,10
1745836291417,EDS 250,A00,895697,Hemans; Patricia Ann Benitez,43,0,45,2
1745836292444,EDS 281,A00,895701,Meyerott; Theresa Ann,15,0,15,0
1745836293472,EDS 284,A00,895736,Meyerott; Theresa Ann,15,0,15,0
1745836294502,EDS 286,A00,897210,Fine; Sarah,15,0,15,0
1745836295530,EDS 289C,A01,895770,Daly; Alan J.,15,0,15,0
1745836296559,EDS 290,A00,897211,Hofstetter; Carolyn,15,0,15,0
1745836297584,LIGM 5A,A00,896162,Fischer-Grunski; Eva K,15,0,20,5
1745836298608,LIGM 5B,A00,896260,Fischer-Grunski; Eva K,17,0,20,3
1745836299634,LIGM 5C,A00,896308,Fischer-Grunski; Eva K,18,0,20,2
1745836300663,LIIT 5AS,A00,896313,Carnelos; Chiara,17,0,20,3
1745836301693,LIIT 5BS,A00,896416,Carnelos; Chiara,20,0,20,0
1745836302721,LIIT 5CS,A00,896564,Carnelos; Chiara,20,0,20,0
1745836303748,LISP 5A,A00,896588,Munoz Sanchez; Alicia,4,0,20,16
1745836304779,LISP 5B,A00,896653,Munoz Sanchez; Alicia,10,0,20,10
1745836305804,LISP 5C,A00,896655,Munoz Sanchez; Alicia,4,0,20,16
1745836306829,MAE 197,001,957918,Kleissl; Jan,9998,0,9999,1
1745836307859,MATH 2,A01,957937,Staff,34,0,35,1
1745836308886,MATH 197,001,957876,Kedlaya; Kiran S.,9993,0,9999,6
1745836309911,MCWP 40,A00,892729,Duru; Nur,13,0,20,7
1745836309911,MCWP 40,B00,893304,Montejo; Carolina,20,0,20,0
1745836310935,MCWP 40R,A00,893757,Redela; Pamela Morgan,0,7,20,20
1745836311965,MCWP 50,A00,893758,Morshed; Michael James,2,0,20,18
1745836311965,MCWP 50,B00,893761,Bartulis; Jason Michael,18,0,20,2
1745836312992,MCWP 50R,A00,893766,Compas; Sean Matthew,0,1,20,20
1745836312992,MCWP 50R,B00,893769,Carter; Jennifer A,0,0,20,20
1745836312992,MCWP 50R,C00,893771,Krone; Jarret,0,3,20,20
1745836312992,MCWP 50R,D00,893772,Miller; Elizabeth Deen,3,0,20,17
1745836312992,MCWP 50R,E00,893775,Carter; Andrea L,0,0,20,20
1745836314018,MMW 11R,A01,892721,Herbst; Matthew,11,0,27,16
1745836314018,MMW 11R,A02,892722,Herbst; Matthew,0,0,0,3
1745836315047,MMW 12R,A01,892724,Herbst; Matthew,0,10,16,16
1745836315047,MMW 12R,A02,892725,Herbst; Matthew,0,9,16,16
1745836316076,MMW 13R,A01,892727,Staff,0,3,16,16
1745836316076,MMW 13R,A02,892728,Staff,0,4,16,16
1745836316076,MMW 13R,A03,958032,Staff,0,3,16,16
1745836316076,MMW 13R,A04,958033,Staff,0,2,16,16
1745836316076,MMW 13R,A05,958034,Staff,0,3,16,16
1745836317101,SIO 295LS,A00,894015,Staff,7,0,25,18
1745836318128,SIO 295S,A00,894020,Staff,7,0,25,18
1745836319154,SIOC 290S,B01,958918,Staff,0,0,0,0
1745836320182,SIOC 291S,B01,958922,Staff,0,0,0,0
1745836321209,SOCI 117,A01,895339,Staff,4,0,5,1
1745836322235,WES 237B,A00,894149,Staff,11,0,20,9
1745836324299,AESE 279B,A00,891859,Staff,13,0,35,22
1745836325326,AIP 197,001,891854,Staff,70,0,70,0
1745836326351,ANTH 289S,A00,891856,Gagneux; Pascal,12,0,12,0
1745836327378,BENG 196,001,957946,Engler; Adam J.,9996,0,9999,3
1745836328404,CAT 124RS,A01,956906,Staff,8,0,25,17
1745836329432,CAT 125RS,A01,922013,Staff,8,0,25,17
1745836330456,CLRE 250,A00,891860,Morris; Sheldon,9995,0,9999,4
1745836332509,CLRE 251R,A00,907817,Mehta; Ravindra L.,9994,0,9999,5
1745836333538,CLRE 252,A00,891864,Cuomo; Raphael Eduardo,9993,0,9999,6
1745836334566,CLRE 253,A00,891867,Vaida; Florin,9994,0,9999,5
1745836334566,CLRE 253,B00,907819,Staff,9999,0,9999,0
1745836335593,CLRE 259,A00,891868,Patel; Hemal,9998,0,9999,1
1745836336621,CLRE 260,A00,891872,Cuomo; Raphael Eduardo,9999,0,9999,0
1745836337651,CLRE 297,001,891888,Cuomo; Raphael Eduardo,9999,0,9999,0
1745836338676,CSE 191,A00,958773,Minnes Kemp; Mor Mia,9999,0,9999,0
1745836339703,CSS 201S,A01,892054,Mignozzetti; Umberto,30,0,30,0
1745836340732,CSS 202S,A01,892056,Mignozzetti; Umberto,30,0,30,0
1745836341761,DSC 197,001,956898,Eldridge; Justin Matthew,9998,0,9999,1
1745836342786,DSC 297,001,958000,Mazumdar; Arya,9998,0,9999,1
1745836343813,EAP 100,A00,905686,Staff,9776,0,9999,223
1745836344839,ECE 45,A01,892618,Staff,0,13,50,50
1745836345866,ECE 109,A01,892620,Staff,0,43,0,0
1745836346894,ECE 111,A01,892719,Staff,0,9,50,50
1745836347921,ECE 197,001,957920,Mercier; Patrick Philip,9992,0,9999,7
1745836348947,ECON 178,A01,907814,Zhu; Ying,28,0,35,7
1745836349978,EDS 115,A00,895312,Staff,41,0,45,4
1745836351008,EDS 117,A01,895337,Staff,30,0,30,0
1745836352035,EDS 125,A00,895341,Jones; Gabrielle Anastasia,43,0,45,2
1745836353065,EDS 128A,A01,895459,Fargason; Sharon Gayle,44,0,45,1
1745836354097,EDS 128B,A01,895543,Pappas; Elizabeth,44,0,45,1
1745836355123,EDS 139,A00,897203,Pappas; Elizabeth,44,0,45,1
1745836355123,EDS 139,B00,897209,Fargason; Sharon Gayle,44,0,45,1
1745836356153,EDS 201,A00,895545,Staff,43,0,45,2
1745836357179,EDS 203,A01,895581,Halter; Christopher P.,43,0,45,2
1745836358205,EDS 204R,A01,895625,Heinzman; Erica M.,43,0,45,2
1745836358205,EDS 204R,B01,895693,Halter; Christopher P.,18,0,45,27
1745836359231,EDS 206R,A00,895694,Fargason; Sharon Gayle,9,0,30,21
1745836359231,EDS 206R,B00,895695,Choi; Bailey Miyeon,20,0,30,10
1745836360259,EDS 250,A00,895697,Hemans; Patricia Ann Benitez,43,0,45,2
1745836361287,EDS 281,A00,895701,Meyerott; Theresa Ann,15,0,15,0
1745836362316,EDS 284,A00,895736,Meyerott; Theresa Ann,15,0,15,0
1745836363345,EDS 286,A00,897210,Fine; Sarah,15,0,15,0
1745836364374,EDS 289C,A01,895770,Daly; Alan J.,15,0,15,0
1745836365402,EDS 290,A00,897211,Hofstetter; Carolyn,15,0,15,0
1745836366427,LIGM 5A,A00,896162,Fischer-Grunski; Eva K,15,0,20,5
1745836367453,LIGM 5B,A00,896260,Fischer-Grunski; Eva K,17,0,20,3
1745836368478,LIGM 5C,A00,896308,Fischer-Grunski; Eva K,18,0,20,2
1745836369509,LIIT 5AS,A00,896313,Carnelos; Chiara,17,0,20,3
1745836370536,LIIT 5BS,A00,896416,Carnelos; Chiara,20,0,20,0
1745836371567,LIIT 5CS,A00,896564,Carnelos; Chiara,20,0,20,0
1745836372592,LISP 5A,A00,896588,Munoz Sanchez; Alicia,4,0,20,16
1745836373622,LISP 5B,A00,896653,Munoz Sanchez; Alicia,10,0,20,10
1745836374649,LISP 5C,A00,896655,Munoz Sanchez; Alicia,4,0,20,16
1745836375675,MAE 197,001,957918,Kleissl; Jan,9998,0,9999,1
1745836376701,MATH 2,A01,957937,Staff,34,0,35,1
1745836377731,MATH 197,001,957876,Kedlaya; Kiran S.,9993,0,9999,6
1745836378756,MCWP 40,A00,892729,Duru; Nur,13,0,20,7
1745836378756,MCWP 40,B00,893304,Montejo; Carolina,20,0,20,0
1745836379785,MCWP 40R,A00,893757,Redela; Pamela Morgan,0,7,20,20
1745836380812,MCWP 50,A00,893758,Morshed; Michael James,2,0,20,18
1745836380812,MCWP 50,B00,893761,Bartulis; Jason Michael,18,0,20,2
1745836381840,MCWP 50R,A00,893766,Compas; Sean Matthew,0,1,20,20
1745836381840,MCWP 50R,B00,893769,Carter; Jennifer A,0,0,20,20
1745836381840,MCWP 50R,C00,893771,Krone; Jarret,0,3,20,20
1745836381840,MCWP 50R,D00,893772,Miller; Elizabeth Deen,3,0,20,17
1745836381840,MCWP 50R,E00,893775,Carter; Andrea L,0,0,20,20
1745836382870,MMW 11R,A01,892721,Herbst; Matthew,11,0,27,16
1745836382870,MMW 11R,A02,892722,Herbst; Matthew,0,0,0,3
1745836383900,MMW 12R,A01,892724,Herbst; Matthew,0,10,16,16
1745836383900,MMW 12R,A02,892725,Herbst; Matthew,0,9,16,16
1745836384928,MMW 13R,A01,892727,Staff,0,3,16,16
1745836384928,MMW 13R,A02,892728,Staff,0,4,16,16
1745836384928,MMW 13R,A03,958032,Staff,0,3,16,16
1745836384928,MMW 13R,A04,958033,Staff,0,2,16,16
1745836384928,MMW 13R,A05,958034,Staff,0,3,16,16
1745836385953,SIO 295LS,A00,894015,Staff,7,0,25,18
1745836386979,SIO 295S,A00,894020,Staff,7,0,25,18
1745836388007,SIOC 290S,B01,958918,Staff,0,0,0,0
1745836389034,SIOC 291S,B01,958922,Staff,0,0,0,0
1745836390064,SOCI 117,A01,895339,Staff,4,0,5,1
1745836391090,WES 237B,A00,894149,Staff,11,0,20,9
1745836393154,AESE 279B,A00,891859,Staff,13,0,35,22
1745836394180,AIP 197,001,891854,Staff,70,0,70,0
1745836395206,ANTH 289S,A00,891856,Gagneux; Pascal,12,0,12,0
1745836396231,BENG 196,001,957946,Engler; Adam J.,9996,0,9999,3
1745836397259,CAT 124RS,A01,956906,Staff,8,0,25,17
1745836398284,CAT 125RS,A01,922013,Staff,8,0,25,17
1745836399309,CLRE 250,A00,891860,Morris; Sheldon,9995,0,9999,4
1745836401360,CLRE 251R,A00,907817,Mehta; Ravindra L.,9994,0,9999,5
1745836402393,CLRE 252,A00,891864,Cuomo; Raphael Eduardo,9993,0,9999,6
1745836403420,CLRE 253,A00,891867,Vaida; Florin,9994,0,9999,5
1745836403420,CLRE 253,B00,907819,Staff,9999,0,9999,0
1745836404446,CLRE 259,A00,891868,Patel; Hemal,9998,0,9999,1
1745836405473,CLRE 260,A00,891872,Cuomo; Raphael Eduardo,9999,0,9999,0
1745836406499,CLRE 297,001,891888,Cuomo; Raphael Eduardo,9999,0,9999,0
1745836407527,CSE 191,A00,958773,Minnes Kemp; Mor Mia,9999,0,9999,0
1745836408559,CSS 201S,A01,892054,Mignozzetti; Umberto,30,0,30,0
1745836409588,CSS 202S,A01,892056,Mignozzetti; Umberto,30,0,30,0
1745836410615,DSC 197,001,956898,Eldridge; Justin Matthew,9998,0,9999,1
1745836411640,DSC 297,001,958000,Mazumdar; Arya,9998,0,9999,1
1745836412667,EAP 100,A00,905686,Staff,9776,0,9999,223
1745836413693,ECE 45,A01,892618,Staff,0,13,50,50
1745836414722,ECE 109,A01,892620,Staff,0,43,0,0
1745836415752,ECE 111,A01,892719,Staff,0,9,50,50
1745836416780,ECE 197,001,957920,Mercier; Patrick Philip,9992,0,9999,7
1745836417808,ECON 178,A01,907814,Zhu; Ying,28,0,35,7
1745836418837,EDS 115,A00,895312,Staff,41,0,45,4
1745836419864,EDS 117,A01,895337,Staff,30,0,30,0
1745836420890,EDS 125,A00,895341,Jones; Gabrielle Anastasia,43,0,45,2
1745836421917,EDS 128A,A01,895459,Fargason; Sharon Gayle,44,0,45,1
1745836422945,EDS 128B,A01,895543,Pappas; Elizabeth,44,0,45,1
1745836423971,EDS 139,A00,897203,Pappas; Elizabeth,44,0,45,1
1745836423971,EDS 139,B00,897209,Fargason; Sharon Gayle,44,0,45,1
1745836424998,EDS 201,A00,895545,Staff,43,0,45,2
1745836426024,EDS 203,A01,895581,Halter; Christopher P.,43,0,45,2
1745836427053,EDS 204R,A01,895625,Heinzman; Erica M.,43,0,45,2
1745836427053,EDS 204R,B01,895693,Halter; Christopher P.,18,0,45,27
1745836428079,EDS 206R,A00,895694,Fargason; Sharon Gayle,9,0,30,21
1745836428079,EDS 206R,B00,895695,Choi; Bailey Miyeon,20,0,30,10
1745836429106,EDS 250,A00,895697,Hemans; Patricia Ann Benitez,43,0,45,2
1745836430135,EDS 281,A00,895701,Meyerott; Theresa Ann,15,0,15,0
1745836431160,EDS 284,A00,895736,Meyerott; Theresa Ann,15,0,15,0
1745836432188,EDS 286,A00,897210,Fine; Sarah,15,0,15,0
1745836433218,EDS 289C,A01,895770,Daly; Alan J.,15,0,15,0
1745836434244,EDS 290,A00,897211,Hofstetter; Carolyn,15,0,15,0
1745836435273,LIGM 5A,A00,896162,Fischer-Grunski; Eva K,15,0,20,5
1745836436301,LIGM 5B,A00,896260,Fischer-Grunski; Eva K,17,0,20,3
1745836437329,LIGM 5C,A00,896308,Fischer-Grunski; Eva K,18,0,20,2
1745836438354,LIIT 5AS,A00,896313,Carnelos; Chiara,17,0,20,3
1745836439382,LIIT 5BS,A00,896416,Carnelos; Chiara,20,0,20,0
1745836440410,LIIT 5CS,A00,896564,Carnelos; Chiara,20,0,20,0
1745836441437,LISP 5A,A00,896588,Munoz Sanchez; Alicia,4,0,20,16
1745836442464,LISP 5B,A00,896653,Munoz Sanchez; Alicia,10,0,20,10
1745836443493,LISP 5C,A00,896655,Munoz Sanchez; Alicia,4,0,20,16
1745836444516,MAE 197,001,957918,Kleissl; Jan,9998,0,9999,1
1745836445545,MATH 2,A01,957937,Staff,34,0,35,1
1745836446571,MATH 197,001,957876,Kedlaya; Kiran S.,9993,0,9999,6
1745836447599,MCWP 40,A00,892729,Duru; Nur,13,0,20,7
1745836447599,MCWP 40,B00,893304,Montejo; Carolina,20,0,20,0
1745836448629,MCWP 40R,A00,893757,Redela; Pamela Morgan,0,7,20,20
1745836449656,MCWP 50,A00,893758,Morshed; Michael James,2,0,20,18
1745836449656,MCWP 50,B00,893761,Bartulis; Jason Michael,18,0,20,2
1745836450683,MCWP 50R,A00,893766,Compas; Sean Matthew,0,1,20,20
1745836450683,MCWP 50R,B00,893769,Carter; Jennifer A,0,0,20,20
1745836450683,MCWP 50R,C00,893771,Krone; Jarret,0,3,20,20
1745836450683,MCWP 50R,D00,893772,Miller; Elizabeth Deen,3,0,20,17
1745836450683,MCWP 50R,E00,893775,Carter; Andrea L,0,0,20,20
1745836451712,MMW 11R,A01,892721,Herbst; Matthew,11,0,27,16
1745836451712,MMW 11R,A02,892722,Herbst; Matthew,0,0,0,3
1745836452739,MMW 12R,A01,892724,Herbst; Matthew,0,10,16,16
1745836452739,MMW 12R,A02,892725,Herbst; Matthew,0,9,16,16
1745836453766,MMW 13R,A01,892727,Staff,0,3,16,16
1745836453766,MMW 13R,A02,892728,Staff,0,4,16,16
1745836453766,MMW 13R,A03,958032,Staff,0,3,16,16
1745836453766,MMW 13R,A04,958033,Staff,0,2,16,16
1745836453766,MMW 13R,A05,958034,Staff,0,3,16,16
1745836454793,SIO 295LS,A00,894015,Staff,7,0,25,18
1745836455821,SIO 295S,A00,894020,Staff,7,0,25,18
1745836456850,SIOC 290S,B01,958918,Staff,0,0,0,0
1745836457880,SIOC 291S,B01,958922,Staff,0,0,0,0
1745836458908,SOCI 117,A01,895339,Staff,4,0,5,1
1745836459934,WES 237B,A00,894149,Staff,11,0,20,9
1745836461999,AESE 279B,A00,891859,Staff,13,0,35,22
1745836463024,AIP 197,001,891854,Staff,70,0,70,0
1745836464051,ANTH 289S,A00,891856,Gagneux; Pascal,12,0,12,0
1745836465077,BENG 196,001,957946,Engler; Adam J.,9996,0,9999,3
1745836466103,CAT 124RS,A01,956906,Staff,8,0,25,17
1745836467132,CAT 125RS,A01,922013,Staff,8,0,25,17
1745836468156,CLRE 250,A00,891860,Morris; Sheldon,9995,0,9999,4
1745836470215,CLRE 251R,A00,907817,Mehta; Ravindra L.,9994,0,9999,5
1745836471239,CLRE 252,A00,891864,Cuomo; Raphael Eduardo,9993,0,9999,6
1745836472264,CLRE 253,A00,891867,Vaida; Florin,9994,0,9999,5
1745836472264,CLRE 253,B00,907819,Staff,9999,0,9999,0
1745836473291,CLRE 259,A00,891868,Patel; Hemal,9998,0,9999,1
1745836474319,CLRE 260,A00,891872,Cuomo; Raphael Eduardo,9999,0,9999,0
1745836475348,CLRE 297,001,891888,Cuomo; Raphael Eduardo,9999,0,9999,0
1745836476374,CSE 191,A00,958773,Minnes Kemp; Mor Mia,9999,0,9999,0
1745836477399,CSS 201S,A01,892054,Mignozzetti; Umberto,30,0,30,0
1745836478426,CSS 202S,A01,892056,Mignozzetti; Umberto,30,0,30,0
1745836479454,DSC 197,001,956898,Eldridge; Justin Matthew,9998,0,9999,1
1745836480481,DSC 297,001,958000,Mazumdar; Arya,9998,0,9999,1
1745836481510,EAP 100,A00,905686,Staff,9776,0,9999,223
1745836482535,ECE 45,A01,892618,Staff,0,13,50,50
1745836483562,ECE 109,A01,892620,Staff,0,43,0,0
1745836484591,ECE 111,A01,892719,Staff,0,9,50,50
1745836485618,ECE 197,001,957920,Mercier; Patrick Philip,9992,0,9999,7
1745836486644,ECON 178,A01,907814,Zhu; Ying,28,0,35,7
1745836487670,EDS 115,A00,895312,Staff,41,0,45,4
1745836488697,EDS 117,A01,895337,Staff,30,0,30,0
1745836489723,EDS 125,A00,895341,Jones; Gabrielle Anastasia,43,0,45,2
1745836490754,EDS 128A,A01,895459,Fargason; Sharon Gayle,44,0,45,1
1745836491782,EDS 128B,A01,895543,Pappas; Elizabeth,44,0,45,1
1745836492810,EDS 139,A00,897203,Pappas; Elizabeth,44,0,45,1
1745836492810,EDS 139,B00,897209,Fargason; Sharon Gayle,44,0,45,1
1745836493838,EDS 201,A00,895545,Staff,43,0,45,2
1745836494866,EDS 203,A01,895581,Halter; Christopher P.,43,0,45,2
1745836495895,EDS 204R,A01,895625,Heinzman; Erica M.,43,0,45,2
1745836495895,EDS 204R,B01,895693,Halter; Christopher P.,18,0,45,27
1745836496921,EDS 206R,A00,895694,Fargason; Sharon Gayle,9,0,30,21
1745836496921,EDS 206R,B00,895695,Choi; Bailey Miyeon,20,0,30,10
1745836497948,EDS 250,A00,895697,Hemans; Patricia Ann Benitez,43,0,45,2
1745836498976,EDS 281,A00,895701,Meyerott; Theresa Ann,15,0,15,0
1745836500002,EDS 284,A00,895736,Meyerott; Theresa Ann,15,0,15,0
1745836501028,EDS 286,A00,897210,Fine; Sarah,15,0,15,0
1745836502059,EDS 289C,A01,895770,Daly; Alan J.,15,0,15,0
1745836503087,EDS 290,A00,897211,Hofstetter; Carolyn,15,0,15,0
1745836504114,LIGM 5A,A00,896162,Fischer-Grunski; Eva K,15,0,20,5
1745836505149,LIGM 5B,A00,896260,Fischer-Grunski; Eva K,17,0,20,3
1745836506179,LIGM 5C,A00,896308,Fischer-Grunski; Eva K,18,0,20,2
1745836507207,LIIT 5AS,A00,896313,Carnelos; Chiara,17,0,20,3
1745836508236,LIIT 5BS,A00,896416,Carnelos; Chiara,20,0,20,0
1745836509265,LIIT 5CS,A00,896564,Carnelos; Chiara,20,0,20,0
1745836510296,LISP 5A,A00,896588,Munoz Sanchez; Alicia,4,0,20,16
1745836511330,LISP 5B,A00,896653,Munoz Sanchez; Alicia,10,0,20,10
1745836512358,LISP 5C,A00,896655,Munoz Sanchez; Alicia,4,0,20,16
1745836513383,MAE 197,001,957918,Kleissl; Jan,9998,0,9999,1
1745836514410,MATH 2,A01,957937,Staff,34,0,35,1
1745836515440,MATH 197,001,957876,Kedlaya; Kiran S.,9993,0,9999,6
1745836516469,MCWP 40,A00,892729,Duru; Nur,13,0,20,7
1745836516469,MCWP 40,B00,893304,Montejo; Carolina,20,0,20,0
1745836517494,MCWP 40R,A00,893757,Redela; Pamela Morgan,0,7,20,20
1745836518518,MCWP 50,A00,893758,Morshed; Michael James,2,0,20,18
1745836518518,MCWP 50,B00,893761,Bartulis; Jason Michael,18,0,20,2
1745836519544,MCWP 50R,A00,893766,Compas; Sean Matthew,0,1,20,20
1745836519544,MCWP 50R,B00,893769,Carter; Jennifer A,0,0,20,20
1745836519544,MCWP 50R,C00,893771,Krone; Jarret,0,3,20,20
1745836519544,MCWP 50R,D00,893772,Miller; Elizabeth Deen,3,0,20,17
1745836519544,MCWP 50R,E00,893775,Carter; Andrea L,0,0,20,20
1745836520569,MMW 11R,A01,892721,Herbst; Matthew,11,0,27,16
1745836520569,MMW 11R,A02,892722,Herbst; Matthew,0,0,0,3
1745836521598,MMW 12R,A01,892724,Herbst; Matthew,0,10,16,16
1745836521598,MMW 12R,A02,892725,Herbst; Matthew,0,9,16,16
1745836522622,MMW 13R,A01,892727,Staff,0,3,16,16
1745836522622,MMW 13R,A02,892728,Staff,0,4,16,16
1745836522622,MMW 13R,A03,958032,Staff,0,3,16,16
1745836522622,MMW 13R,A04,958033,Staff,0,2,16,16
1745836522622,MMW 13R,A05,958034,Staff,0,3,16,16
1745836523648,SIO 295LS,A00,894015,Staff,7,0,25,18
1745836524676,SIO 295S,A00,894020,Staff,7,0,25,18
1745836525704,SIOC 290S,B01,958918,Staff,0,0,0,0
1745836526731,SIOC 291S,B01,958922,Staff,0,0,0,0
1745836527756,SOCI 117,A01,895339,Staff,4,0,5,1
1745836528781,WES 237B,A00,894149,Staff,11,0,20,9
1745836530849,AESE 279B,A00,891859,Staff,13,0,35,22
1745836531876,AIP 197,001,891854,Staff,70,0,70,0
1745836532903,ANTH 289S,A00,891856,Gagneux; Pascal,12,0,12,0
1745836533931,BENG 196,001,957946,Engler; Adam J.,9996,0,9999,3
1745836534956,CAT 124RS,A01,956906,Staff,8,0,25,17
1745836535980,CAT 125RS,A01,922013,Staff,8,0,25,17
1745836537008,CLRE 250,A00,891860,Morris; Sheldon,9995,0,9999,4
1745836539068,CLRE 251R,A00,907817,Mehta; Ravindra L.,9994,0,9999,5
1745836540098,CLRE 252,A00,891864,Cuomo; Raphael Eduardo,9993,0,9999,6
1745836541124,CLRE 253,A00,891867,Vaida; Florin,9994,0,9999,5
1745836541124,CLRE 253,B00,907819,Staff,9999,0,9999,0
1745836542152,CLRE 259,A00,891868,Patel; Hemal,9998,0,9999,1
1745836543178,CLRE 260,A00,891872,Cuomo; Raphael Eduardo,9999,0,9999,0
1745836544206,CLRE 297,001,891888,Cuomo; Raphael Eduardo,9999,0,9999,0
1745836545234,CSE 191,A00,958773,Minnes Kemp; Mor Mia,9999,0,9999,0
1745836546259,CSS 201S,A01,892054,Mignozzetti; Umberto,30,0,30,0
1745836547286,CSS 202S,A01,892056,Mignozzetti; Umberto,30,0,30,0
1745836548312,DSC 197,001,956898,Eldridge; Justin Matthew,9998,0,9999,1
1745836549338,DSC 297,001,958000,Mazumdar; Arya,9998,0,9999,1
1745836550363,EAP 100,A00,905686,Staff,9776,0,9999,223
1745836551389,ECE 45,A01,892618,Staff,0,13,50,50
1745836552417,ECE 109,A01,892620,Staff,0,43,0,0
1745836553447,ECE 111,A01,892719,Staff,0,9,50,50
1745836554473,ECE 197,001,957920,Mercier; Patrick Philip,9992,0,9999,7
1745836555502,ECON 178,A01,907814,Zhu; Ying,28,0,35,7
1745836556530,EDS 115,A00,895312,Staff,41,0,45,4
1745836557561,EDS 117,A01,895337,Staff,30,0,30,0
1745836558589,EDS 125,A00,895341,Jones; Gabrielle Anastasia,43,0,45,2
1745836559615,EDS 128A,A01,895459,Fargason; Sharon Gayle,44,0,45,1
1745836560641,EDS 128B,A01,895543,Pappas; Elizabeth,44,0,45,1
1745836561669,EDS 139,A00,897203,Pappas; Elizabeth,44,0,45,1
1745836561669,EDS 139,B00,897209,Fargason; Sharon Gayle,44,0,45,1
1745836562697,EDS 201,A00,895545,Staff,43,0,45,2
1745836563727,EDS 203,A01,895581,Halter; Christopher P.,43,0,45,2
1745836564765,EDS 204R,A01,895625,Heinzman; Erica M.,43,0,45,2
1745836564765,EDS 204R,B01,895693,Halter; Christopher P.,18,0,45,27
1745836565793,EDS 206R,A00,895694,Fargason; Sharon Gayle,9,0,30,21
1745836565793,EDS 206R,B00,895695,Choi; Bailey Miyeon,20,0,30,10
1745836566820,EDS 250,A00,895697,Hemans; Patricia Ann Benitez,43,0,45,2
1745836567850,EDS 281,A00,895701,Meyerott; Theresa Ann,15,0,15,0
1745836568876,EDS 284,A00,895736,Meyerott; Theresa Ann,15,0,15,0
1745836569904,EDS 286,A00,897210,Fine; Sarah,15,0,15,0
1745836570931,EDS 289C,A01,895770,Daly; Alan J.,15,0,15,0
1745836571960,EDS 290,A00,897211,Hofstetter; Carolyn,15,0,15,0
1745836572990,LIGM 5A,A00,896162,Fischer-Grunski; Eva K,15,0,20,5
1745836574022,LIGM 5B,A00,896260,Fischer-Grunski; Eva K,17,0,20,3
1745836575048,LIGM 5C,A00,896308,Fischer-Grunski; Eva K,18,0,20,2
1745836576080,LIIT 5AS,A00,896313,Carnelos; Chiara,17,0,20,3
1745836577109,LIIT 5BS,A00,896416,Carnelos; Chiara,20,0,20,0
1745836578135,LIIT 5CS,A00,896564,Carnelos; Chiara,20,0,20,0
1745836579161,LISP 5A,A00,896588,Munoz Sanchez; Alicia,4,0,20,16
1745836580189,LISP 5B,A00,896653,Munoz Sanchez; Alicia,10,0,20,10
1745836581216,LISP 5C,A00,896655,Munoz Sanchez; Alicia,4,0,20,16
1745836582243,MAE 197,001,957918,Kleissl; Jan,9998,0,9999,1
1745836583273,MATH 2,A01,957937,Staff,34,0,35,1
1745836584302,MATH 197,001,957876,Kedlaya; Kiran S.,9993,0,9999,6
1745836585329,MCWP 40,A00,892729,Duru; Nur,13,0,20,7
1745836585329,MCWP 40,B00,893304,Montejo; Carolina,20,0,20,0
1745836586360,MCWP 40R,A00,893757,Redela; Pamela Morgan,0,7,20,20
1745836587386,MCWP 50,A00,893758,Morshed; Michael James,2,0,20,18
1745836587386,MCWP 50,B00,893761,Bartulis; Jason Michael,18,0,20,2
1745836588413,MCWP 50R,A00,893766,Compas; Sean Matthew,0,1,20,20
1745836588413,MCWP 50R,B00,893769,Carter; Jennifer A,0,0,20,20
1745836588413,MCWP 50R,C00,893771,Krone; Jarret,0,3,20,20
1745836588413,MCWP 50R,D00,893772,Miller; Elizabeth Deen,3,0,20,17
1745836588413,MCWP 50R,E00,893775,Carter; Andrea L,0,0,20,20
1745836589439,MMW 11R,A01,892721,Herbst; Matthew,11,0,27,16
1745836589439,MMW 11R,A02,892722,Herbst; Matthew,0,0,0,3
1745836590464,MMW 12R,A01,892724,Herbst; Matthew,0,10,16,16
1745836590464,MMW 12R,A02,892725,Herbst; Matthew,0,9,16,16
1745836591491,MMW 13R,A01,892727,Staff,0,3,16,16
1745836591491,MMW 13R,A02,892728,Staff,0,4,16,16
1745836591491,MMW 13R,A03,958032,Staff,0,3,16,16
1745836591491,MMW 13R,A04,958033,Staff,0,2,16,16
1745836591491,MMW 13R,A05,958034,Staff,0,3,16,16
1745836592518,SIO 295LS,A00,894015,Staff,7,0,25,18
1745836593544,SIO 295S,A00,894020,Staff,7,0,25,18
1745836594568,SIOC 290S,B01,958918,Staff,0,0,0,0
1745836595598,SIOC 291S,B01,958922,Staff,0,0,0,0
1745836596628,SOCI 117,A01,895339,Staff,4,0,5,1
1745836597653,WES 237B,A00,894149,Staff,11,0,20,9
1745836599712,AESE 279B,A00,891859,Staff,13,0,35,22
1745836600741,AIP 197,001,891854,Staff,70,0,70,0
1745836601766,ANTH 289S,A00,891856,Gagneux; Pascal,12,0,12,0
1745836602794,BENG 196,001,957946,Engler; Adam J.,9996,0,9999,3
1745836603821,CAT 124RS,A01,956906,Staff,8,0,25,17
1745836604850,CAT 125RS,A01,922013,Staff,8,0,25,17
1745836605875,CLRE 250,A00,891860,Morris; Sheldon,9995,0,9999,4
1745836607933,CLRE 251R,A00,907817,Mehta; Ravindra L.,9994,0,9999,5
1745836608962,CLRE 252,A00,891864,Cuomo; Raphael Eduardo,9993,0,9999,6
1745836609988,CLRE 253,A00,891867,Vaida; Florin,9994,0,9999,5
1745836609988,CLRE 253,B00,907819,Staff,9999,0,9999,0
1745836611019,CLRE 259,A00,891868,Patel; Hemal,9998,0,9999,1
1745836612046,CLRE 260,A00,891872,Cuomo; Raphael Eduardo,9999,0,9999,0
1745836613073,CLRE 297,001,891888,Cuomo; Raphael Eduardo,9999,0,9999,0
1745836614100,CSE 191,A00,958773,Minnes Kemp; Mor Mia,9999,0,9999,0
1745836615132,CSS 201S,A01,892054,Mignozzetti; Umberto,30,0,30,0
1745836616159,CSS 202S,A01,892056,Mignozzetti; Umberto,30,0,30,0
1745836617209,DSC 197,001,956898,Eldridge; Justin Matthew,9998,0,9999,1
1745836618236,DSC 297,001,958000,Mazumdar; Arya,9998,0,9999,1
1745836619262,EAP 100,A00,905686,Staff,9776,0,9999,223
1745836620293,ECE 45,A01,892618,Staff,0,13,50,50
1745836621319,ECE 109,A01,892620,Staff,0,43,0,0
1745836622357,ECE 111,A01,892719,Staff,0,9,50,50
1745836623384,ECE 197,001,957920,Mercier; Patrick Philip,9992,0,9999,7
1745836624412,ECON 178,A01,907814,Zhu; Ying,28,0,35,7
1745836625440,EDS 115,A00,895312,Staff,41,0,45,4
1745836626472,EDS 117,A01,895337,Staff,30,0,30,0
1745836627498,EDS 125,A00,895341,Jones; Gabrielle Anastasia,43,0,45,2
1745836628530,EDS 128A,A01,895459,Fargason; Sharon Gayle,44,0,45,1
1745836629556,EDS 128B,A01,895543,Pappas; Elizabeth,44,0,45,1
1745836630583,EDS 139,A00,897203,Pappas; Elizabeth,44,0,45,1
1745836630583,EDS 139,B00,897209,Fargason; Sharon Gayle,44,0,45,1
1745836631610,EDS 201,A00,895545,Staff,43,0,45,2
1745836632638,EDS 203,A01,895581,Halter; Christopher P.,43,0,45,2
1745836633666,EDS 204R,A01,895625,Heinzman; Erica M.,43,0,45,2
1745836633666,EDS 204R,B01,895693,Halter; Christopher P.,18,0,45,27
1745836634694,EDS 206R,A00,895694,Fargason; Sharon Gayle,9,0,30,21
1745836634694,EDS 206R,B00,895695,Choi; Bailey Miyeon,20,0,30,10
1745836635725,EDS 250,A00,895697,Hemans; Patricia Ann Benitez,43,0,45,2
1745836636752,EDS 281,A00,895701,Meyerott; Theresa Ann,15,0,15,0
1745836637778,EDS 284,A00,895736,Meyerott; Theresa Ann,15,0,15,0
1745836638808,EDS 286,A00,897210,Fine; Sarah,15,0,15,0
1745836639840,EDS 289C,A01,895770,Daly; Alan J.,15,0,15,0
1745836640868,EDS 290,A00,897211,Hofstetter; Carolyn,15,0,15,0
1745836641895,LIGM 5A,A00,896162,Fischer-Grunski; Eva K,15,0,20,5
1745836642924,LIGM 5B,A00,896260,Fischer-Grunski; Eva K,17,0,20,3
1745836643951,LIGM 5C,A00,896308,Fischer-Grunski; Eva K,18,0,20,2
1745836644979,LIIT 5AS,A00,896313,Carnelos; Chiara,17,0,20,3
1745836646009,LIIT 5BS,A00,896416,Carnelos; Chiara,20,0,20,0
1745836647039,LIIT 5CS,A00,896564,Carnelos; Chiara,20,0,20,0
1745836648065,LISP 5A,A00,896588,Munoz Sanchez; Alicia,4,0,20,16
1745836649096,LISP 5B,A00,896653,Munoz Sanchez; Alicia,10,0,20,10
1745836650123,LISP 5C,A00,896655,Munoz Sanchez; Alicia,4,0,20,16
1745836651150,MAE 197,001,957918,Kleissl; Jan,9998,0,9999,1
1745836652177,MATH 2,A01,957937,Staff,34,0,35,1
1745836653203,MATH 197,001,957876,Kedlaya; Kiran S.,9993,0,9999,6
1745836654230,MCWP 40,A00,892729,Duru; Nur,13,0,20,7
1745836654230,MCWP 40,B00,893304,Montejo; Carolina,20,0,20,0
1745836655266,MCWP 40R,A00,893757,Redela; Pamela Morgan,0,7,20,20
1745836656300,MCWP 50,A00,893758,Morshed; Michael James,2,0,20,18
1745836656300,MCWP 50,B00,893761,Bartulis; Jason Michael,18,0,20,2
1745836657328,MCWP 50R,A00,893766,Compas; Sean Matthew,0,1,20,20
1745836657328,MCWP 50R,B00,893769,Carter; Jennifer A,0,0,20,20
1745836657328,MCWP 50R,C00,893771,Krone; Jarret,0,3,20,20
1745836657328,MCWP 50R,D00,893772,Miller; Elizabeth Deen,3,0,20,17
1745836657328,MCWP 50R,E00,893775,Carter; Andrea L,0,0,20,20
1745836658424,MMW 11R,A01,892721,Herbst; Matthew,11,0,27,16
1745836658424,MMW 11R,A02,892722,Herbst; Matthew,0,0,0,3
1745836659452,MMW 12R,A01,892724,Herbst; Matthew,0,10,16,16
1745836659452,MMW 12R,A02,892725,Herbst; Matthew,0,9,16,16
1745836660483,MMW 13R,A01,892727,Staff,0,3,16,16
1745836660483,MMW 13R,A02,892728,Staff,0,4,16,16
1745836660483,MMW 13R,A03,958032,Staff,0,3,16,16
1745836660483,MMW 13R,A04,958033,Staff,0,2,16,16
1745836660483,MMW 13R,A05,958034,Staff,0,3,16,16
1745836661511,SIO 295LS,A00,894015,Staff,7,0,25,18
1745836662541,SIO 295S,A00,894020,Staff,7,0,25,18
1745836663567,SIOC 290S,B01,958918,Staff,0,0,0,0
1745836664597,SIOC 291S,B01,958922,Staff,0,0,0,0
1745836665624,SOCI 117,A01,895339,Staff,4,0,5,1
1745836666650,WES 237B,A00,894149,Staff,11,0,20,9
1745836668715,AESE 279B,A00,891859,Staff,13,0,35,22
1745836669737,AIP 197,001,891854,Staff,70,0,70,0
1745836670764,ANTH 289S,A00,891856,Gagneux; Pascal,12,0,12,0
1745836671790,BENG 196,001,957946,Engler; Adam J.,9996,0,9999,3
1745836672813,CAT 124RS,A01,956906,Staff,8,0,25,17
1745836673840,CAT 125RS,A01,922013,Staff,8,0,25,17
1745836674867,CLRE 250,A00,891860,Morris; Sheldon,9995,0,9999,4
1745836676925,CLRE 251R,A00,907817,Mehta; Ravindra L.,9994,0,9999,5
1745836677952,CLRE 252,A00,891864,Cuomo; Raphael Eduardo,9993,0,9999,6
1745836678982,CLRE 253,A00,891867,Vaida; Florin,9994,0,9999,5
1745836678982,CLRE 253,B00,907819,Staff,9999,0,9999,0
1745836680012,CLRE 259,A00,891868,Patel; Hemal,9998,0,9999,1
1745836681038,CLRE 260,A00,891872,Cuomo; Raphael Eduardo,9999,0,9999,0
1745836682066,CLRE 297,001,891888,Cuomo; Raphael Eduardo,9999,0,9999,0
1745836683092,CSE 191,A00,958773,Minnes Kemp; Mor Mia,9999,0,9999,0
1745836684124,CSS 201S,A01,892054,Mignozzetti; Umberto,30,0,30,0
1745836685154,CSS 202S,A01,892056,Mignozzetti; Umberto,30,0,30,0
1745836686183,DSC 197,001,956898,Eldridge; Justin Matthew,9998,0,9999,1
1745836687208,DSC 297,001,958000,Mazumdar; Arya,9998,0,9999,1
1745836688233,EAP 100,A00,905686,Staff,9776,0,9999,223
1745836689264,ECE 45,A01,892618,Staff,0,13,50,50
1745836690290,ECE 109,A01,892620,Staff,0,43,0,0
1745836691317,ECE 111,A01,892719,Staff,0,9,50,50
1745836692345,ECE 197,001,957920,Mercier; Patrick Philip,9992,0,9999,7
1745836693373,ECON 178,A01,907814,Zhu; Ying,28,0,35,7
1745836694402,EDS 115,A00,895312,Staff,41,0,45,4
1745836695431,EDS 117,A01,895337,Staff,30,0,30,0
1745836696457,EDS 125,A00,895341,Jones; Gabrielle Anastasia,43,0,45,2
1745836697486,EDS 128A,A01,895459,Fargason; Sharon Gayle,44,0,45,1
1745836698513,EDS 128B,A01,895543,Pappas; Elizabeth,44,0,45,1
1745836699537,EDS 139,A00,897203,Pappas; Elizabeth,44,0,45,1
1745836699537,EDS 139,B00,897209,Fargason; Sharon Gayle,44,0,45,1
1745836700566,EDS 201,A00,895545,Staff,43,0,45,2
1745836701593,EDS 203,A01,895581,Halter; Christopher P.,43,0,45,2
1745836702622,EDS 204R,A01,895625,Heinzman; Erica M.,43,0,45,2
1745836702622,EDS 204R,B01,895693,Halter; Christopher P.,18,0,45,27
1745836703653,EDS 206R,A00,895694,Fargason; Sharon Gayle,9,0,30,21
1745836703653,EDS 206R,B00,895695,Choi; Bailey Miyeon,20,0,30,10
1745836704680,EDS 250,A00,895697,Hemans; Patricia Ann Benitez,43,0,45,2
1745836705709,EDS 281,A00,895701,Meyerott; Theresa Ann,15,0,15,0
1745836706737,EDS 284,A00,895736,Meyerott; Theresa Ann,15,0,15,0
1745836707767,EDS 286,A00,897210,Fine; Sarah,15,0,15,0
1745836708789,EDS 289C,A01,895770,Daly; Alan J.,15,0,15,0
1745836709817,EDS 290,A00,897211,Hofstetter; Carolyn,15,0,15,0
1745836710847,LIGM 5A,A00,896162,Fischer-Grunski; Eva K,15,0,20,5
1745836711875,LIGM 5B,A00,896260,Fischer-Grunski; Eva K,17,0,20,3
1745836712906,LIGM 5C,A00,896308,Fischer-Grunski; Eva K,18,0,20,2
1745836713932,LIIT 5AS,A00,896313,Carnelos; Chiara,17,0,20,3
1745836714963,LIIT 5BS,A00,896416,Carnelos; Chiara,20,0,20,0
1745836715992,LIIT 5CS,A00,896564,Carnelos; Chiara,20,0,20,0
1745836717018,LISP 5A,A00,896588,Munoz Sanchez; Alicia,4,0,20,16
1745836718085,LISP 5B,A00,896653,Munoz Sanchez; Alicia,10,0,20,10
1745836719112,LISP 5C,A00,896655,Munoz Sanchez; Alicia,4,0,20,16
1745836720140,MAE 197,001,957918,Kleissl; Jan,9998,0,9999,1
1745836721165,MATH 2,A01,957937,Staff,34,0,35,1
1745836722200,MATH 197,001,957876,Kedlaya; Kiran S.,9993,0,9999,6
1745836723228,MCWP 40,A00,892729,Duru; Nur,13,0,20,7
1745836723228,MCWP 40,B00,893304,Montejo; Carolina,20,0,20,0
1745836724255,MCWP 40R,A00,893757,Redela; Pamela Morgan,0,7,20,20
1745836725284,MCWP 50,A00,893758,Morshed; Michael James,2,0,20,18
1745836725284,MCWP 50,B00,893761,Bartulis; Jason Michael,18,0,20,2
1745836726311,MCWP 50R,A00,893766,Compas; Sean Matthew,0,1,20,20
1745836726311,MCWP 50R,B00,893769,Carter; Jennifer A,0,0,20,20
1745836726311,MCWP 50R,C00,893771,Krone; Jarret,0,3,20,20
1745836726311,MCWP 50R,D00,893772,Miller; Elizabeth Deen,3,0,20,17
1745836726311,MCWP 50R,E00,893775,Carter; Andrea L,0,0,20,20
1745836727337,MMW 11R,A01,892721,Herbst; Matthew,11,0,27,16
1745836727337,MMW 11R,A02,892722,Herbst; Matthew,0,0,0,3
1745836728367,MMW 12R,A01,892724,Herbst; Matthew,0,10,16,16
1745836728367,MMW 12R,A02,892725,Herbst; Matthew,0,9,16,16
1745836729400,MMW 13R,A01,892727,Staff,0,3,16,16
1745836729400,MMW 13R,A02,892728,Staff,0,4,16,16
1745836729400,MMW 13R,A03,958032,Staff,0,3,16,16
1745836729400,MMW 13R,A04,958033,Staff,0,2,16,16
1745836729400,MMW 13R,A05,958034,Staff,0,3,16,16
1745836730430,SIO 295LS,A00,894015,Staff,7,0,25,18
1745836731460,SIO 295S,A00,894020,Staff,7,0,25,18
1745836732487,SIOC 290S,B01,958918,Staff,0,0,0,0
1745836733517,SIOC 291S,B01,958922,Staff,0,0,0,0
1745836734547,SOCI 117,A01,895339,Staff,4,0,5,1
1745836735575,WES 237B,A00,894149,Staff,11,0,20,9
1745836737642,AESE 279B,A00,891859,Staff,13,0,35,22
1745836738667,AIP 197,001,891854,Staff,70,0,70,0
1745836739693,ANTH 289S,A00,891856,Gagneux; Pascal,12,0,12,0
1745836740720,BENG 196,001,957946,Engler; Adam J.,9996,0,9999,3
1745836741752,CAT 124RS,A01,956906,Staff,8,0,25,17
1745836742778,CAT 125RS,A01,922013,Staff,8,0,25,17
1745836743809,CLRE 250,A00,891860,Morris; Sheldon,9995,0,9999,4
1745836745860,CLRE 251R,A00,907817,Mehta; Ravindra L.,9994,0,9999,5
1745836746889,CLRE 252,A00,891864,Cuomo; Raphael Eduardo,9993,0,9999,6
1745836747917,CLRE 253,A00,891867,Vaida; Florin,9994,0,9999,5
1745836747917,CLRE 253,B00,907819,Staff,9999,0,9999,0
1745836748943,CLRE 259,A00,891868,Patel; Hemal,9998,0,9999,1
1745836749987,CLRE 260,A00,891872,Cuomo; Raphael Eduardo,9999,0,9999,0
1745836751015,CLRE 297,001,891888,Cuomo; Raphael Eduardo,9999,0,9999,0
1745836752043,CSE 191,A00,958773,Minnes Kemp; Mor Mia,9999,0,9999,0
1745836753067,CSS 201S,A01,892054,Mignozzetti; Umberto,30,0,30,0
1745836754098,CSS 202S,A01,892056,Mignozzetti; Umberto,30,0,30,0
1745836755125,DSC 197,001,956898,Eldridge; Justin Matthew,9998,0,9999,1
1745836756150,DSC 297,001,958000,Mazumdar; Arya,9998,0,9999,1
1745836757176,EAP 100,A00,905686,Staff,9776,0,9999,223
1745836758203,ECE 45,A01,892618,Staff,0,13,50,50
1745836759232,ECE 109,A01,892620,Staff,0,43,0,0
1745836760262,ECE 111,A01,892719,Staff,0,9,50,50
1745836761289,ECE 197,001,957920,Mercier; Patrick Philip,9992,0,9999,7
1745836762315,ECON 178,A01,907814,Zhu; Ying,28,0,35,7
1745836763345,EDS 115,A00,895312,Staff,41,0,45,4
1745836764372,EDS 117,A01,895337,Staff,30,0,30,0
1745836765399,EDS 125,A00,895341,Jones; Gabrielle Anastasia,43,0,45,2
1745836766427,EDS 128A,A01,895459,Fargason; Sharon Gayle,44,0,45,1
1745836767457,EDS 128B,A01,895543,Pappas; Elizabeth,44,0,45,1
1745836768485,EDS 139,A00,897203,Pappas; Elizabeth,44,0,45,1
1745836768485,EDS 139,B00,897209,Fargason; Sharon Gayle,44,0,45,1
1745836769513,EDS 201,A00,895545,Staff,43,0,45,2
1745836770540,EDS 203,A01,895581,Halter; Christopher P.,43,0,45,2
1745836771569,EDS 204R,A01,895625,Heinzman; Erica M.,43,0,45,2
1745836771569,EDS 204R,B01,895693,Halter; Christopher P.,18,0,45,27
1745836772601,EDS 206R,A00,895694,Fargason; Sharon Gayle,9,0,30,21
1745836772601,EDS 206R,B00,895695,Choi; Bailey Miyeon,20,0,30,10
1745836773627,EDS 250,A00,895697,Hemans; Patricia Ann Benitez,43,0,45,2
1745836774656,EDS 281,A00,895701,Meyerott; Theresa Ann,15,0,15,0
1745836775683,EDS 284,A00,895736,Meyerott; Theresa Ann,15,0,15,0
1745836776713,EDS 286,A00,897210,Fine; Sarah,15,0,15,0
1745836777740,EDS 289C,A01,895770,Daly; Alan J.,15,0,15,0
1745836778772,EDS 290,A00,897211,Hofstetter; Carolyn,15,0,15,0
1745836779801,LIGM 5A,A00,896162,Fischer-Grunski; Eva K,15,0,20,5
1745836780829,LIGM 5B,A00,896260,Fischer-Grunski; Eva K,17,0,20,3
1745836781859,LIGM 5C,A00,896308,Fischer-Grunski; Eva K,18,0,20,2
1745836782888,LIIT 5AS,A00,896313,Carnelos; Chiara,17,0,20,3
1745836783913,LIIT 5BS,A00,896416,Carnelos; Chiara,20,0,20,0
1745836784939,LIIT 5CS,A00,896564,Carnelos; Chiara,20,0,20,0
1745836785966,LISP 5A,A00,896588,Munoz Sanchez; Alicia,4,0,20,16
1745836786999,LISP 5B,A00,896653,Munoz Sanchez; Alicia,10,0,20,10
1745836788028,LISP 5C,A00,896655,Munoz Sanchez; Alicia,4,0,20,16
1745836789054,MAE 197,001,957918,Kleissl; Jan,9998,0,9999,1
1745836790080,MATH 2,A01,957937,Staff,34,0,35,1
1745836791104,MATH 197,001,957876,Kedlaya; Kiran S.,9993,0,9999,6
1745836792132,MCWP 40,A00,892729,Duru; Nur,13,0,20,7
1745836792132,MCWP 40,B00,893304,Montejo; Carolina,20,0,20,0
1745836793160,MCWP 40R,A00,893757,Redela; Pamela Morgan,0,7,20,20
1745836794189,MCWP 50,A00,893758,Morshed; Michael James,2,0,20,18
1745836794189,MCWP 50,B00,893761,Bartulis; Jason Michael,18,0,20,2
1745836795219,MCWP 50R,A00,893766,Compas; Sean Matthew,0,1,20,20
1745836795219,MCWP 50R,B00,893769,Carter; Jennifer A,0,0,20,20
1745836795219,MCWP 50R,C00,893771,Krone; Jarret,0,3,20,20
1745836795219,MCWP 50R,D00,893772,Miller; Elizabeth Deen,3,0,20,17
1745836795219,MCWP 50R,E00,893775,Carter; Andrea L,0,0,20,20
1745836796250,MMW 11R,A01,892721,Herbst; Matthew,11,0,27,16
1745836796250,MMW 11R,A02,892722,Herbst; Matthew,0,0,0,3
1745836797278,MMW 12R,A01,892724,Herbst; Matthew,0,10,16,16
1745836797278,MMW 12R,A02,892725,Herbst; Matthew,0,9,16,16
1745836798307,MMW 13R,A01,892727,Staff,0,3,16,16
1745836798307,MMW 13R,A02,892728,Staff,0,4,16,16
1745836798307,MMW 13R,A03,958032,Staff,0,3,16,16
1745836798307,MMW 13R,A04,958033,Staff,0,2,16,16
1745836798307,MMW 13R,A05,958034,Staff,0,3,16,16
1745836799335,SIO 295LS,A00,894015,Staff,7,0,25,18
1745836800362,SIO 295S,A00,894020,Staff,7,0,25,18
1745836801391,SIOC 290S,B01,958918,Staff,0,0,0,0
1745836802426,SIOC 291S,B01,958922,Staff,0,0,0,0
1745836803456,SOCI 117,A01,895339,Staff,4,0,5,1
1745836804483,WES 237B,A00,894149,Staff,11,0,20,9
1745836806563,AESE 279B,A00,891859,Staff,13,0,35,22
1745836807589,AIP 197,001,891854,Staff,70,0,70,0
1745836808616,ANTH 289S,A00,891856,Gagneux; Pascal,12,0,12,0
1745836809641,BENG 196,001,957946,Engler; Adam J.,9996,0,9999,3
1745836810667,CAT 124RS,A01,956906,Staff,8,0,25,17
1745836811695,CAT 125RS,A01,922013,Staff,8,0,25,17
1745836812721,CLRE 250,A00,891860,Morris; Sheldon,9995,0,9999,4
1745836814778,CLRE 251R,A00,907817,Mehta; Ravindra L.,9994,0,9999,5
1745836815804,CLRE 252,A00,891864,Cuomo; Raphael Eduardo,9993,0,9999,6
1745836816827,CLRE 253,A00,891867,Vaida; Florin,9994,0,9999,5
1745836816827,CLRE 253,B00,907819,Staff,9999,0,9999,0
1745836817855,CLRE 259,A00,891868,Patel; Hemal,9998,0,9999,1
1745836818882,CLRE 260,A00,891872,Cuomo; Raphael Eduardo,9999,0,9999,0
1745836819907,CLRE 297,001,891888,Cuomo; Raphael Eduardo,9999,0,9999,0
1745836820935,CSE 191,A00,958773,Minnes Kemp; Mor Mia,9999,0,9999,0
1745836821967,CSS 201S,A01,892054,Mignozzetti; Umberto,30,0,30,0
1745836822994,CSS 202S,A01,892056,Mignozzetti; Umberto,30,0,30,0
1745836824022,DSC 197,001,956898,Eldridge; Justin Matthew,9998,0,9999,1
1745836825053,DSC 297,001,958000,Mazumdar; Arya,9998,0,9999,1
1745836826082,EAP 100,A00,905686,Staff,9776,0,9999,223
1745836827106,ECE 45,A01,892618,Staff,0,13,50,50
1745836828136,ECE 109,A01,892620,Staff,0,43,0,0
1745836829163,ECE 111,A01,892719,Staff,0,9,50,50
1745836830190,ECE 197,001,957920,Mercier; Patrick Philip,9992,0,9999,7
1745836831216,ECON 178,A01,907814,Zhu; Ying,28,0,35,7
1745836832242,EDS 115,A00,895312,Staff,41,0,45,4
1745836833269,EDS 117,A01,895337,Staff,30,0,30,0
1745836834296,EDS 125,A00,895341,Jones; Gabrielle Anastasia,43,0,45,2
1745836835327,EDS 128A,A01,895459,Fargason; Sharon Gayle,44,0,45,1
1745836836357,EDS 128B,A01,895543,Pappas; Elizabeth,44,0,45,1
1745836837386,EDS 139,A00,897203,Pappas; Elizabeth,44,0,45,1
1745836837386,EDS 139,B00,897209,Fargason; Sharon Gayle,44,0,45,1
1745836838411,EDS 201,A00,895545,Staff,43,0,45,2
1745836839438,EDS 203,A01,895581,Halter; Christopher P.,43,0,45,2
1745836840466,EDS 204R,A01,895625,Heinzman; Erica M.,43,0,45,2
1745836840466,EDS 204R,B01,895693,Halter; Christopher P.,18,0,45,27
1745836841494,EDS 206R,A00,895694,Fargason; Sharon Gayle,9,0,30,21
1745836841494,EDS 206R,B00,895695,Choi; Bailey Miyeon,20,0,30,10
1745836842521,EDS 250,A00,895697,Hemans; Patricia Ann Benitez,43,0,45,2
1745836843551,EDS 281,A00,895701,Meyerott; Theresa Ann,15,0,15,0
1745836844580,EDS 284,A00,895736,Meyerott; Theresa Ann,15,0,15,0
1745836845607,EDS 286,A00,897210,Fine; Sarah,15,0,15,0
1745836846636,EDS 289C,A01,895770,Daly; Alan J.,15,0,15,0
1745836847664,EDS 290,A00,897211,Hofstetter; Carolyn,15,0,15,0
1745836848690,LIGM 5A,A00,896162,Fischer-Grunski; Eva K,15,0,20,5
1745836849717,LIGM 5B,A00,896260,Fischer-Grunski; Eva K,17,0,20,3
1745836850744,LIGM 5C,A00,896308,Fischer-Grunski; Eva K,18,0,20,2
1745836851772,LIIT 5AS,A00,896313,Carnelos; Chiara,17,0,20,3
1745836852799,LIIT 5BS,A00,896416,Carnelos; Chiara,20,0,20,0
1745836853827,LIIT 5CS,A00,896564,Carnelos; Chiara,20,0,20,0
1745836854854,LISP 5A,A00,896588,Munoz Sanchez; Alicia,4,0,20,16
1745836855883,LISP 5B,A00,896653,Munoz Sanchez; Alicia,10,0,20,10
1745836856910,LISP 5C,A00,896655,Munoz Sanchez; Alicia,4,0,20,16
1745836857936,MAE 197,001,957918,Kleissl; Jan,9998,0,9999,1
1745836858962,MATH 2,A01,957937,Staff,34,0,35,1
1745836859993,MATH 197,001,957876,Kedlaya; Kiran S.,9993,0,9999,6
1745836861026,MCWP 40,A00,892729,Duru; Nur,13,0,20,7
1745836861026,MCWP 40,B00,893304,Montejo; Carolina,20,0,20,0
1745836862055,MCWP 40R,A00,893757,Redela; Pamela Morgan,0,7,20,20
1745836863086,MCWP 50,A00,893758,Morshed; Michael James,2,0,20,18
1745836863086,MCWP 50,B00,893761,Bartulis; Jason Michael,18,0,20,2
1745836864115,MCWP 50R,A00,893766,Compas; Sean Matthew,0,1,20,20
1745836864115,MCWP 50R,B00,893769,Carter; Jennifer A,0,0,20,20
1745836864115,MCWP 50R,C00,893771,Krone; Jarret,0,3,20,20
1745836864115,MCWP 50R,D00,893772,Miller; Elizabeth Deen,3,0,20,17
1745836864115,MCWP 50R,E00,893775,Carter; Andrea L,0,0,20,20
1745836865146,MMW 11R,A01,892721,Herbst; Matthew,11,0,27,16
1745836865146,MMW 11R,A02,892722,Herbst; Matthew,0,0,0,3
1745836866169,MMW 12R,A01,892724,Herbst; Matthew,0,10,16,16
1745836866169,MMW 12R,A02,892725,Herbst; Matthew,0,9,16,16
1745836867214,MMW 13R,A01,892727,Staff,0,3,16,16
1745836867214,MMW 13R,A02,892728,Staff,0,4,16,16
1745836867214,MMW 13R,A03,958032,Staff,0,3,16,16
1745836867214,MMW 13R,A04,958033,Staff,0,2,16,16
1745836867214,MMW 13R,A05,958034,Staff,0,3,16,16
1745836868238,SIO 295LS,A00,894015,Staff,7,0,25,18
1745836869264,SIO 295S,A00,894020,Staff,7,0,25,18
1745836870290,SIOC 290S,B01,958918,Staff,0,0,0,0
1745836871318,SIOC 291S,B01,958922,Staff,0,0,0,0
1745836872343,SOCI 117,A01,895339,Staff,4,0,5,1
1745836873370,WES 237B,A00,894149,Staff,11,0,20,9
1745836875437,AESE 279B,A00,891859,Staff,13,0,35,22
1745836876460,AIP 197,001,891854,Staff,70,0,70,0
1745836877486,ANTH 289S,A00,891856,Gagneux; Pascal,12,0,12,0
1745836878512,BENG 196,001,957946,Engler; Adam J.,9996,0,9999,3
1745836879538,CAT 124RS,A01,956906,Staff,8,0,25,17
1745836880565,CAT 125RS,A01,922013,Staff,8,0,25,17
1745836881590,CLRE 250,A00,891860,Morris; Sheldon,9995,0,9999,4
1745836883647,CLRE 251R,A00,907817,Mehta; Ravindra L.,9994,0,9999,5
1745836884673,CLRE 252,A00,891864,Cuomo; Raphael Eduardo,9993,0,9999,6
1745836885699,CLRE 253,A00,891867,Vaida; Florin,9994,0,9999,5
1745836885699,CLRE 253,B00,907819,Staff,9999,0,9999,0
1745836886727,CLRE 259,A00,891868,Patel; Hemal,9998,0,9999,1
1745836887756,CLRE 260,A00,891872,Cuomo; Raphael Eduardo,9999,0,9999,0
1745836888782,CLRE 297,001,891888,Cuomo; Raphael Eduardo,9999,0,9999,0
1745836889806,CSE 191,A00,958773,Minnes Kemp; Mor Mia,9999,0,9999,0
1745836890834,CSS 201S,A01,892054,Mignozzetti; Umberto,30,0,30,0
1745836891861,CSS 202S,A01,892056,Mignozzetti; Umberto,30,0,30,0
1745836892889,DSC 197,001,956898,Eldridge; Justin Matthew,9998,0,9999,1
1745836893915,DSC 297,001,958000,Mazumdar; Arya,9998,0,9999,1
1745836894941,EAP 100,A00,905686,Staff,9776,0,9999,223
1745836895966,ECE 45,A01,892618,Staff,0,13,50,50
1745836896996,ECE 109,A01,892620,Staff,0,43,0,0
1745836898025,ECE 111,A01,892719,Staff,0,9,50,50
1745836899050,ECE 197,001,957920,Mercier; Patrick Philip,9992,0,9999,7
1745836900082,ECON 178,A01,907814,Zhu; Ying,28,0,35,7
1745836901111,EDS 115,A00,895312,Staff,41,0,45,4
1745836902137,EDS 117,A01,895337,Staff,30,0,30,0
1745836903166,EDS 125,A00,895341,Jones; Gabrielle Anastasia,43,0,45,2
1745836904192,EDS 128A,A01,895459,Fargason; Sharon Gayle,44,0,45,1
1745836905218,EDS 128B,A01,895543,Pappas; Elizabeth,44,0,45,1
1745836906245,EDS 139,A00,897203,Pappas; Elizabeth,44,0,45,1
1745836906245,EDS 139,B00,897209,Fargason; Sharon Gayle,44,0,45,1
1745836907272,EDS 201,A00,895545,Staff,43,0,45,2
1745836908303,EDS 203,A01,895581,Halter; Christopher P.,43,0,45,2
1745836909333,EDS 204R,A01,895625,Heinzman; Erica M.,43,0,45,2
1745836909333,EDS 204R,B01,895693,Halter; Christopher P.,18,0,45,27
1745836910361,EDS 206R,A00,895694,Fargason; Sharon Gayle,9,0,30,21
1745836910361,EDS 206R,B00,895695,Choi; Bailey Miyeon,20,0,30,10
1745836911389,EDS 250,A00,895697,Hemans; Patricia Ann Benitez,43,0,45,2
1745836912416,EDS 281,A00,895701,Meyerott; Theresa Ann,15,0,15,0
1745836913444,EDS 284,A00,895736,Meyerott; Theresa Ann,15,0,15,0
1745836914472,EDS 286,A00,897210,Fine; Sarah,15,0,15,0
1745836915501,EDS 289C,A01,895770,Daly; Alan J.,15,0,15,0
1745836916528,EDS 290,A00,897211,Hofstetter; Carolyn,15,0,15,0
1745836917561,LIGM 5A,A00,896162,Fischer-Grunski; Eva K,15,0,20,5
1745836918586,LIGM 5B,A00,896260,Fischer-Grunski; Eva K,17,0,20,3
1745836919610,LIGM 5C,A00,896308,Fischer-Grunski; Eva K,18,0,20,2
1745836920637,LIIT 5AS,A00,896313,Carnelos; Chiara,17,0,20,3
1745836921663,LIIT 5BS,A00,896416,Carnelos; Chiara,20,0,20,0
1745836922692,LIIT 5CS,A00,896564,Carnelos; Chiara,20,0,20,0
1745836923723,LISP 5A,A00,896588,Munoz Sanchez; Alicia,4,0,20,16
1745836924751,LISP 5B,A00,896653,Munoz Sanchez; Alicia,10,0,20,10
1745836925781,LISP 5C,A00,896655,Munoz Sanchez; Alicia,4,0,20,16
1745836926810,MAE 197,001,957918,Kleissl; Jan,9998,0,9999,1
1745836927837,MATH 2,A01,957937,Staff,34,0,35,1
1745836928867,MATH 197,001,957876,Kedlaya; Kiran S.,9993,0,9999,6
1745836929894,MCWP 40,A00,892729,Duru; Nur,13,0,20,7
1745836929894,MCWP 40,B00,893304,Montejo; Carolina,20,0,20,0
1745836931466,MCWP 40R,A00,893757,Redela; Pamela Morgan,0,7,20,20
1745836932492,MCWP 50,A00,893758,Morshed; Michael James,2,0,20,18
1745836932492,MCWP 50,B00,893761,Bartulis; Jason Michael,18,0,20,2
1745836933519,MCWP 50R,A00,893766,Compas; Sean Matthew,0,1,20,20
1745836933519,MCWP 50R,B00,893769,Carter; Jennifer A,0,0,20,20
1745836933519,MCWP 50R,C00,893771,Krone; Jarret,0,3,20,20
1745836933519,MCWP 50R,D00,893772,Miller; Elizabeth Deen,3,0,20,17
1745836933519,MCWP 50R,E00,893775,Carter; Andrea L,0,0,20,20
1745836934545,MMW 11R,A01,892721,Herbst; Matthew,11,0,27,16
1745836934545,MMW 11R,A02,892722,Herbst; Matthew,0,0,0,3
1745836935571,MMW 12R,A01,892724,Herbst; Matthew,0,10,16,16
1745836935571,MMW 12R,A02,892725,Herbst; Matthew,0,9,16,16
1745836936601,MMW 13R,A01,892727,Staff,0,3,16,16
1745836936601,MMW 13R,A02,892728,Staff,0,4,16,16
1745836936601,MMW 13R,A03,958032,Staff,0,3,16,16
1745836936601,MMW 13R,A04,958033,Staff,0,2,16,16
1745836936601,MMW 13R,A05,958034,Staff,0,3,16,16
1745836937630,SIO 295LS,A00,894015,Staff,7,0,25,18
1745836938657,SIO 295S,A00,894020,Staff,7,0,25,18
1745836939687,SIOC 290S,B01,958918,Staff,0,0,0,0
1745836940715,SIOC 291S,B01,958922,Staff,0,0,0,0
1745836941742,SOCI 117,A01,895339,Staff,4,0,5,1
1745836942771,WES 237B,A00,894149,Staff,11,0,20,9
1745836944848,AESE 279B,A00,891859,Staff,13,0,35,22
1745836945874,AIP 197,001,891854,Staff,70,0,70,0
1745836946903,ANTH 289S,A00,891856,Gagneux; Pascal,12,0,12,0
1745836947928,BENG 196,001,957946,Engler; Adam J.,9996,0,9999,3
1745836948957,CAT 124RS,A01,956906,Staff,8,0,25,17
1745836949986,CAT 125RS,A01,922013,Staff,8,0,25,17
1745836951012,CLRE 250,A00,891860,Morris; Sheldon,9995,0,9999,4
1745836953072,CLRE 251R,A00,907817,Mehta; Ravindra L.,9994,0,9999,5
1745836954098,CLRE 252,A00,891864,Cuomo; Raphael Eduardo,9993,0,9999,6
1745836955126,CLRE 253,A00,891867,Vaida; Florin,9994,0,9999,5
1745836955126,CLRE 253,B00,907819,Staff,9999,0,9999,0
1745836956152,CLRE 259,A00,891868,Patel; Hemal,9998,0,9999,1
1745836957179,CLRE 260,A00,891872,Cuomo; Raphael Eduardo,9999,0,9999,0
1745836958205,CLRE 297,001,891888,Cuomo; Raphael Eduardo,9999,0,9999,0
1745836959235,CSE 191,A00,958773,Minnes Kemp; Mor Mia,9999,0,9999,0
1745836960262,CSS 201S,A01,892054,Mignozzetti; Umberto,30,0,30,0
1745836961289,CSS 202S,A01,892056,Mignozzetti; Umberto,30,0,30,0
1745836962318,DSC 197,001,956898,Eldridge; Justin Matthew,9998,0,9999,1
1745836963343,DSC 297,001,958000,Mazumdar; Arya,9998,0,9999,1
1745836964369,EAP 100,A00,905686,Staff,9776,0,9999,223
1745836965399,ECE 45,A01,892618,Staff,0,13,50,50
1745836966427,ECE 109,A01,892620,Staff,0,43,0,0
1745836967458,ECE 111,A01,892719,Staff,0,9,50,50
1745836968494,ECE 197,001,957920,Mercier; Patrick Philip,9992,0,9999,7
1745836969524,ECON 178,A01,907814,Zhu; Ying,28,0,35,7
1745836970553,EDS 115,A00,895312,Staff,41,0,45,4
1745836971580,EDS 117,A01,895337,Staff,30,0,30,0
1745836972609,EDS 125,A00,895341,Jones; Gabrielle Anastasia,43,0,45,2
1745836973639,EDS 128A,A01,895459,Fargason; Sharon Gayle,44,0,45,1
1745836974668,EDS 128B,A01,895543,Pappas; Elizabeth,44,0,45,1
1745836975697,EDS 139,A00,897203,Pappas; Elizabeth,44,0,45,1
1745836975697,EDS 139,B00,897209,Fargason; Sharon Gayle,44,0,45,1
1745836976723,EDS 201,A00,895545,Staff,43,0,45,2
1745836977749,EDS 203,A01,895581,Halter; Christopher P.,43,0,45,2
1745836978775,EDS 204R,A01,895625,Heinzman; Erica M.,43,0,45,2
1745836978775,EDS 204R,B01,895693,Halter; Christopher P.,18,0,45,27
1745836979800,EDS 206R,A00,895694,Fargason; Sharon Gayle,9,0,30,21
1745836979800,EDS 206R,B00,895695,Choi; Bailey Miyeon,20,0,30,10
1745836980827,EDS 250,A00,895697,Hemans; Patricia Ann Benitez,43,0,45,2
1745836981856,EDS 281,A00,895701,Meyerott; Theresa Ann,15,0,15,0
1745836982882,EDS 284,A00,895736,Meyerott; Theresa Ann,15,0,15,0
1745836983911,EDS 286,A00,897210,Fine; Sarah,15,0,15,0
1745836984940,EDS 289C,A01,895770,Daly; Alan J.,15,0,15,0
1745836985966,EDS 290,A00,897211,Hofstetter; Carolyn,15,0,15,0
1745836986997,LIGM 5A,A00,896162,Fischer-Grunski; Eva K,15,0,20,5
1745836988024,LIGM 5B,A00,896260,Fischer-Grunski; Eva K,17,0,20,3
1745836989054,LIGM 5C,A00,896308,Fischer-Grunski; Eva K,18,0,20,2
1745836990125,LIIT 5AS,A00,896313,Carnelos; Chiara,17,0,20,3
1745836991151,LIIT 5BS,A00,896416,Carnelos; Chiara,20,0,20,0
1745836992178,LIIT 5CS,A00,896564,Carnelos; Chiara,20,0,20,0
1745836993208,LISP 5A,A00,896588,Munoz Sanchez; Alicia,4,0,20,16
1745836994234,LISP 5B,A00,896653,Munoz Sanchez; Alicia,10,0,20,10
1745836995260,LISP 5C,A00,896655,Munoz Sanchez; Alicia,4,0,20,16
1745836996288,MAE 197,001,957918,Kleissl; Jan,9998,0,9999,1
1745836997313,MATH 2,A01,957937,Staff,34,0,35,1
1745836998339,MATH 197,001,957876,Kedlaya; Kiran S.,9993,0,9999,6
1745836999364,MCWP 40,A00,892729,Duru; Nur,13,0,20,7
1745836999364,MCWP 40,B00,893304,Montejo; Carolina,20,0,20,0
1745837000393,MCWP 40R,A00,893757,Redela; Pamela Morgan,0,7,20,20
1745837001420,MCWP 50,A00,893758,Morshed; Michael James,2,0,20,18
1745837001420,MCWP 50,B00,893761,Bartulis; Jason Michael,18,0,20,2
1745837002451,MCWP 50R,A00,893766,Compas; Sean Matthew,0,1,20,20
1745837002451,MCWP 50R,B00,893769,Carter; Jennifer A,0,0,20,20
1745837002451,MCWP 50R,C00,893771,Krone; Jarret,0,3,20,20
1745837002451,MCWP 50R,D00,893772,Miller; Elizabeth Deen,3,0,20,17
1745837002451,MCWP 50R,E00,893775,Carter; Andrea L,0,0,20,20
1745837003480,MMW 11R,A01,892721,Herbst; Matthew,11,0,27,16
1745837003480,MMW 11R,A02,892722,Herbst; Matthew,0,0,0,3
1745837004507,MMW 12R,A01,892724,Herbst; Matthew,0,10,16,16
1745837004507,MMW 12R,A02,892725,Herbst; Matthew,0,9,16,16
1745837005533,MMW 13R,A01,892727,Staff,0,3,16,16
1745837005533,MMW 13R,A02,892728,Staff,0,4,16,16
1745837005533,MMW 13R,A03,958032,Staff,0,3,16,16
1745837005533,MMW 13R,A04,958033,Staff,0,2,16,16
1745837005533,MMW 13R,A05,958034,Staff,0,3,16,16
1745837006563,SIO 295LS,A00,894015,Staff,7,0,25,18
1745837007593,SIO 295S,A00,894020,Staff,7,0,25,18
1745837008619,SIOC 290S,B01,958918,Staff,0,0,0,0
1745837009650,SIOC 291S,B01,958922,Staff,0,0,0,0
1745837010676,SOCI 117,A01,895339,Staff,4,0,5,1
1745837011702,WES 237B,A00,894149,Staff,11,0,20,9
1745837013765,AESE 279B,A00,891859,Staff,13,0,35,22
1745837014790,AIP 197,001,891854,Staff,70,0,70,0
1745837015819,ANTH 289S,A00,891856,Gagneux; Pascal,12,0,12,0
1745837016848,BENG 196,001,957946,Engler; Adam J.,9996,0,9999,3
1745837017876,CAT 124RS,A01,956906,Staff,8,0,25,17
1745837018900,CAT 125RS,A01,922013,Staff,8,0,25,17
1745837019926,CLRE 250,A00,891860,Morris; Sheldon,9995,0,9999,4
1745837021980,CLRE 251R,A00,907817,Mehta; Ravindra L.,9994,0,9999,5
1745837023007,CLRE 252,A00,891864,Cuomo; Raphael Eduardo,9993,0,9999,6
1745837024037,CLRE 253,A00,891867,Vaida; Florin,9994,0,9999,5
1745837024037,CLRE 253,B00,907819,Staff,9999,0,9999,0
1745837025064,CLRE 259,A00,891868,Patel; Hemal,9998,0,9999,1
1745837026091,CLRE 260,A00,891872,Cuomo; Raphael Eduardo,9999,0,9999,0
1745837027119,CLRE 297,001,891888,Cuomo; Raphael Eduardo,9999,0,9999,0
1745837028145,CSE 191,A00,958773,Minnes Kemp; Mor Mia,9999,0,9999,0
1745837029175,CSS 201S,A01,892054,Mignozzetti; Umberto,30,0,30,0
1745837030202,CSS 202S,A01,892056,Mignozzetti; Umberto,30,0,30,0
1745837031228,DSC 197,001,956898,Eldridge; Justin Matthew,9998,0,9999,1
1745837032255,DSC 297,001,958000,Mazumdar; Arya,9998,0,9999,1
1745837033284,EAP 100,A00,905686,Staff,9776,0,9999,223
1745837034314,ECE 45,A01,892618,Staff,0,13,50,50
1745837035341,ECE 109,A01,892620,Staff,0,43,0,0
1745837036368,ECE 111,A01,892719,Staff,0,9,50,50
1745837037393,ECE 197,001,957920,Mercier; Patrick Philip,9992,0,9999,7
1745837038423,ECON 178,A01,907814,Zhu; Ying,28,0,35,7
1745837039451,EDS 115,A00,895312,Staff,41,0,45,4
1745837040477,EDS 117,A01,895337,Staff,30,0,30,0
1745837041506,EDS 125,A00,895341,Jones; Gabrielle Anastasia,43,0,45,2
1745837042534,EDS 128A,A01,895459,Fargason; Sharon Gayle,44,0,45,1
1745837043561,EDS 128B,A01,895543,Pappas; Elizabeth,44,0,45,1
1745837044590,EDS 139,A00,897203,Pappas; Elizabeth,44,0,45,1
1745837044590,EDS 139,B00,897209,Fargason; Sharon Gayle,44,0,45,1
1745837045619,EDS 201,A00,895545,Staff,43,0,45,2
1745837046645,EDS 203,A01,895581,Halter; Christopher P.,43,0,45,2
1745837047670,EDS 204R,A01,895625,Heinzman; Erica M.,43,0,45,2
1745837047670,EDS 204R,B01,895693,Halter; Christopher P.,18,0,45,27
1745837048698,EDS 206R,A00,895694,Fargason; Sharon Gayle,9,0,30,21
1745837048698,EDS 206R,B00,895695,Choi; Bailey Miyeon,20,0,30,10
1745837049727,EDS 250,A00,895697,Hemans; Patricia Ann Benitez,43,0,45,2
1745837050751,EDS 281,A00,895701,Meyerott; Theresa Ann,15,0,15,0
1745837051781,EDS 284,A00,895736,Meyerott; Theresa Ann,15,0,15,0
1745837052806,EDS 286,A00,897210,Fine; Sarah,15,0,15,0
1745837053833,EDS 289C,A01,895770,Daly; Alan J.,15,0,15,0
1745837054860,EDS 290,A00,897211,Hofstetter; Carolyn,15,0,15,0
1745837055885,LIGM 5A,A00,896162,Fischer-Grunski; Eva K,15,0,20,5
1745837056911,LIGM 5B,A00,896260,Fischer-Grunski; Eva K,17,0,20,3
1745837057941,LIGM 5C,A00,896308,Fischer-Grunski; Eva K,18,0,20,2
1745837058971,LIIT 5AS,A00,896313,Carnelos; Chiara,17,0,20,3
1745837060001,LIIT 5BS,A00,896416,Carnelos; Chiara,20,0,20,0
1745837061028,LIIT 5CS,A00,896564,Carnelos; Chiara,20,0,20,0
1745837062056,LISP 5A,A00,896588,Munoz Sanchez; Alicia,4,0,20,16
1745837063086,LISP 5B,A00,896653,Munoz Sanchez; Alicia,10,0,20,10
1745837064115,LISP 5C,A00,896655,Munoz Sanchez; Alicia,4,0,20,16
1745837065145,MAE 197,001,957918,Kleissl; Jan,9998,0,9999,1
1745837066171,MATH 2,A01,957937,Staff,34,0,35,1
1745837067197,MATH 197,001,957876,Kedlaya; Kiran S.,9993,0,9999,6
1745837068223,MCWP 40,A00,892729,Duru; Nur,13,0,20,7
1745837068223,MCWP 40,B00,893304,Montejo; Carolina,20,0,20,0
1745837069250,MCWP 40R,A00,893757,Redela; Pamela Morgan,0,7,20,20
1745837070276,MCWP 50,A00,893758,Morshed; Michael James,2,0,20,18
1745837070276,MCWP 50,B00,893761,Bartulis; Jason Michael,18,0,20,2
1745837071310,MCWP 50R,A00,893766,Compas; Sean Matthew,0,1,20,20
1745837071310,MCWP 50R,B00,893769,Carter; Jennifer A,0,0,20,20
1745837071310,MCWP 50R,C00,893771,Krone; Jarret,0,3,20,20
1745837071310,MCWP 50R,D00,893772,Miller; Elizabeth Deen,3,0,20,17
1745837071310,MCWP 50R,E00,893775,Carter; Andrea L,0,0,20,20
1745837072340,MMW 11R,A01,892721,Herbst; Matthew,11,0,27,16
1745837072340,MMW 11R,A02,892722,Herbst; Matthew,0,0,0,3
1745837073366,MMW 12R,A01,892724,Herbst; Matthew,0,10,16,16
1745837073366,MMW 12R,A02,892725,Herbst; Matthew,0,9,16,16
1745837074396,MMW 13R,A01,892727,Staff,0,3,16,16
1745837074396,MMW 13R,A02,892728,Staff,0,4,16,16
1745837074396,MMW 13R,A03,958032,Staff,0,3,16,16
1745837074396,MMW 13R,A04,958033,Staff,0,2,16,16
1745837074396,MMW 13R,A05,958034,Staff,0,3,16,16
1745837075426,SIO 295LS,A00,894015,Staff,7,0,25,18
1745837076454,SIO 295S,A00,894020,Staff,7,0,25,18
1745837077481,SIOC 290S,B01,958918,Staff,0,0,0,0
1745837078511,SIOC 291S,B01,958922,Staff,0,0,0,0
1745837079542,SOCI 117,A01,895339,Staff,4,0,5,1
1745837080569,WES 237B,A00,894149,Staff,11,0,20,9
1745837082648,AESE 279B,A00,891859,Staff,13,0,35,22
1745837083672,AIP 197,001,891854,Staff,70,0,70,0
1745837084703,ANTH 289S,A00,891856,Gagneux; Pascal,12,0,12,0
1745837085732,BENG 196,001,957946,Engler; Adam J.,9996,0,9999,3
1745837086759,CAT 124RS,A01,956906,Staff,8,0,25,17
1745837087787,CAT 125RS,A01,922013,Staff,8,0,25,17
1745837088817,CLRE 250,A00,891860,Morris; Sheldon,9995,0,9999,4
1745837090875,CLRE 251R,A00,907817,Mehta; Ravindra L.,9994,0,9999,5
1745837091903,CLRE 252,A00,891864,Cuomo; Raphael Eduardo,9993,0,9999,6
1745837092933,CLRE 253,A00,891867,Vaida; Florin,9994,0,9999,5
1745837092933,CLRE 253,B00,907819,Staff,9999,0,9999,0
1745837093999,CLRE 259,A00,891868,Patel; Hemal,9998,0,9999,1
1745837095030,CLRE 260,A00,891872,Cuomo; Raphael Eduardo,9999,0,9999,0
1745837096057,CLRE 297,001,891888,Cuomo; Raphael Eduardo,9999,0,9999,0
1745837097087,CSE 191,A00,958773,Minnes Kemp; Mor Mia,9999,0,9999,0
1745837098116,CSS 201S,A01,892054,Mignozzetti; Umberto,30,0,30,0
1745837099145,CSS 202S,A01,892056,Mignozzetti; Umberto,30,0,30,0
1745837100170,DSC 197,001,956898,Eldridge; Justin Matthew,9998,0,9999,1
1745837101200,DSC 297,001,958000,Mazumdar; Arya,9998,0,9999,1
1745837102230,EAP 100,A00,905686,Staff,9776,0,9999,223
1745837103258,ECE 45,A01,892618,Staff,0,13,50,50
1745837104282,ECE 109,A01,892620,Staff,0,43,0,0
1745837105309,ECE 111,A01,892719,Staff,0,9,50,50
1745837106335,ECE 197,001,957920,Mercier; Patrick Philip,9992,0,9999,7
1745837107359,ECON 178,A01,907814,Zhu; Ying,28,0,35,7
1745837108386,EDS 115,A00,895312,Staff,41,0,45,4
1745837109415,EDS 117,A01,895337,Staff,30,0,30,0
1745837110445,EDS 125,A00,895341,Jones; Gabrielle Anastasia,43,0,45,2
1745837111474,EDS 128A,A01,895459,Fargason; Sharon Gayle,44,0,45,1
1745837112504,EDS 128B,A01,895543,Pappas; Elizabeth,44,0,45,1
1745837113531,EDS 139,A00,897203,Pappas; Elizabeth,44,0,45,1
1745837113531,EDS 139,B00,897209,Fargason; Sharon Gayle,44,0,45,1
1745837114559,EDS 201,A00,895545,Staff,43,0,45,2
1745837115584,EDS 203,A01,895581,Halter; Christopher P.,43,0,45,2
1745837116613,EDS 204R,A01,895625,Heinzman; Erica M.,43,0,45,2
1745837116613,EDS 204R,B01,895693,Halter; Christopher P.,18,0,45,27
1745837117643,EDS 206R,A00,895694,Fargason; Sharon Gayle,9,0,30,21
1745837117643,EDS 206R,B00,895695,Choi; Bailey Miyeon,20,0,30,10
1745837118674,EDS 250,A00,895697,Hemans; Patricia Ann Benitez,43,0,45,2
1745837119701,EDS 281,A00,895701,Meyerott; Theresa Ann,15,0,15,0
1745837120728,EDS 284,A00,895736,Meyerott; Theresa Ann,15,0,15,0
1745837121754,EDS 286,A00,897210,Fine; Sarah,15,0,15,0
1745837122780,EDS 289C,A01,895770,Daly; Alan J.,15,0,15,0
1745837123805,EDS 290,A00,897211,Hofstetter; Carolyn,15,0,15,0
1745837124836,LIGM 5A,A00,896162,Fischer-Grunski; Eva K,15,0,20,5
1745837125863,LIGM 5B,A00,896260,Fischer-Grunski; Eva K,17,0,20,3
1745837126893,LIGM 5C,A00,896308,Fischer-Grunski; Eva K,18,0,20,2
1745837127919,LIIT 5AS,A00,896313,Carnelos; Chiara,17,0,20,3
1745837128947,LIIT 5BS,A00,896416,Carnelos; Chiara,20,0,20,0
1745837129977,LIIT 5CS,A00,896564,Carnelos; Chiara,20,0,20,0
1745837131004,LISP 5A,A00,896588,Munoz Sanchez; Alicia,4,0,20,16
1745837132030,LISP 5B,A00,896653,Munoz Sanchez; Alicia,10,0,20,10
1745837133061,LISP 5C,A00,896655,Munoz Sanchez; Alicia,4,0,20,16
1745837134088,MAE 197,001,957918,Kleissl; Jan,9998,0,9999,1
1745837135118,MATH 2,A01,957937,Staff,34,0,35,1
1745837136147,MATH 197,001,957876,Kedlaya; Kiran S.,9993,0,9999,6
1745837137174,MCWP 40,A00,892729,Duru; Nur,13,0,20,7
1745837137174,MCWP 40,B00,893304,Montejo; Carolina,20,0,20,0
1745837138200,MCWP 40R,A00,893757,Redela; Pamela Morgan,0,7,20,20
1745837139226,MCWP 50,A00,893758,Morshed; Michael James,2,0,20,18
1745837139226,MCWP 50,B00,893761,Bartulis; Jason Michael,18,0,20,2
1745837140258,MCWP 50R,A00,893766,Compas; Sean Matthew,0,1,20,20
1745837140258,MCWP 50R,B00,893769,Carter; Jennifer A,0,0,20,20
1745837140258,MCWP 50R,C00,893771,Krone; Jarret,0,3,20,20
1745837140258,MCWP 50R,D00,893772,Miller; Elizabeth Deen,3,0,20,17
1745837140258,MCWP 50R,E00,893775,Carter; Andrea L,0,0,20,20
1745837141283,MMW 11R,A01,892721,Herbst; Matthew,11,0,27,16
1745837141283,MMW 11R,A02,892722,Herbst; Matthew,0,0,0,3
1745837142312,MMW 12R,A01,892724,Herbst; Matthew,0,10,16,16
1745837142312,MMW 12R,A02,892725,Herbst; Matthew,0,9,16,16
1745837143338,MMW 13R,A01,892727,Staff,0,3,16,16
1745837143338,MMW 13R,A02,892728,Staff,0,4,16,16
1745837143338,MMW 13R,A03,958032,Staff,0,3,16,16
1745837143338,MMW 13R,A04,958033,Staff,0,2,16,16
1745837143338,MMW 13R,A05,958034,Staff,0,3,16,16
1745837144365,SIO 295LS,A00,894015,Staff,7,0,25,18
1745837145390,SIO 295S,A00,894020,Staff,7,0,25,18
1745837146421,SIOC 290S,B01,958918,Staff,0,0,0,0
1745837147448,SIOC 291S,B01,958922,Staff,0,0,0,0
1745837148474,SOCI 117,A01,895339,Staff,4,0,5,1
1745837149498,WES 237B,A00,894149,Staff,11,0,20,9
1745837151578,AESE 279B,A00,891859,Staff,13,0,35,22
1745837152604,AIP 197,001,891854,Staff,70,0,70,0
1745837153630,ANTH 289S,A00,891856,Gagneux; Pascal,12,0,12,0
1745837154657,BENG 196,001,957946,Engler; Adam J.,9996,0,9999,3
1745837155682,CAT 124RS,A01,956906,Staff,8,0,25,17
1745837156706,CAT 125RS,A01,922013,Staff,8,0,25,17
1745837157736,CLRE 250,A00,891860,Morris; Sheldon,9995,0,9999,4
1745837159790,CLRE 251R,A00,907817,Mehta; Ravindra L.,9994,0,9999,5
1745837160818,CLRE 252,A00,891864,Cuomo; Raphael Eduardo,9993,0,9999,6
1745837161844,CLRE 253,A00,891867,Vaida; Florin,9994,0,9999,5
1745837161844,CLRE 253,B00,907819,Staff,9999,0,9999,0
1745837162871,CLRE 259,A00,891868,Patel; Hemal,9998,0,9999,1
1745837163897,CLRE 260,A00,891872,Cuomo; Raphael Eduardo,9999,0,9999,0
1745837164922,CLRE 297,001,891888,Cuomo; Raphael Eduardo,9999,0,9999,0
1745837165948,CSE 191,A00,958773,Minnes Kemp; Mor Mia,9999,0,9999,0
1745837166973,CSS 201S,A01,892054,Mignozzetti; Umberto,30,0,30,0
1745837168004,CSS 202S,A01,892056,Mignozzetti; Umberto,30,0,30,0
1745837169033,DSC 197,001,956898,Eldridge; Justin Matthew,9998,0,9999,1
1745837170077,DSC 297,001,958000,Mazumdar; Arya,9998,0,9999,1
1745837171102,EAP 100,A00,905686,Staff,9776,0,9999,223
1745837172129,ECE 45,A01,892618,Staff,0,13,50,50
1745837173154,ECE 109,A01,892620,Staff,0,43,0,0
1745837174180,ECE 111,A01,892719,Staff,0,9,50,50
1745837175205,ECE 197,001,957920,Mercier; Patrick Philip,9992,0,9999,7
1745837176230,ECON 178,A01,907814,Zhu; Ying,28,0,35,7
1745837177257,EDS 115,A00,895312,Staff,41,0,45,4
1745837178287,EDS 117,A01,895337,Staff,30,0,30,0
1745837179313,EDS 125,A00,895341,Jones; Gabrielle Anastasia,43,0,45,2
1745837180342,EDS 128A,A01,895459,Fargason; Sharon Gayle,44,0,45,1
1745837181372,EDS 128B,A01,895543,Pappas; Elizabeth,44,0,45,1
1745837182400,EDS 139,A00,897203,Pappas; Elizabeth,44,0,45,1
1745837182400,EDS 139,B00,897209,Fargason; Sharon Gayle,44,0,45,1
1745837183427,EDS 201,A00,895545,Staff,43,0,45,2
1745837184452,EDS 203,A01,895581,Halter; Christopher P.,43,0,45,2
1745837185479,EDS 204R,A01,895625,Heinzman; Erica M.,43,0,45,2
1745837185479,EDS 204R,B01,895693,Halter; Christopher P.,18,0,45,27
1745837186507,EDS 206R,A00,895694,Fargason; Sharon Gayle,9,0,30,21
1745837186507,EDS 206R,B00,895695,Choi; Bailey Miyeon,20,0,30,10
1745837187533,EDS 250,A00,895697,Hemans; Patricia Ann Benitez,43,0,45,2
1745837188558,EDS 281,A00,895701,Meyerott; Theresa Ann,15,0,15,0
1745837189586,EDS 284,A00,895736,Meyerott; Theresa Ann,15,0,15,0
1745837190612,EDS 286,A00,897210,Fine; Sarah,15,0,15,0
1745837191641,EDS 289C,A01,895770,Daly; Alan J.,15,0,15,0
1745837192667,EDS 290,A00,897211,Hofstetter; Carolyn,15,0,15,0
1745837193698,LIGM 5A,A00,896162,Fischer-Grunski; Eva K,15,0,20,5
1745837194725,LIGM 5B,A00,896260,Fischer-Grunski; Eva K,17,0,20,3
1745837195752,LIGM 5C,A00,896308,Fischer-Grunski; Eva K,18,0,20,2
1745837196783,LIIT 5AS,A00,896313,Carnelos; Chiara,17,0,20,3
1745837197814,LIIT 5BS,A00,896416,Carnelos; Chiara,20,0,20,0
1745837198844,LIIT 5CS,A00,896564,Carnelos; Chiara,20,0,20,0
1745837199872,LISP 5A,A00,896588,Munoz Sanchez; Alicia,4,0,20,16
1745837200901,LISP 5B,A00,896653,Munoz Sanchez; Alicia,10,0,20,10
1745837201932,LISP 5C,A00,896655,Munoz Sanchez; Alicia,4,0,20,16
1745837202960,MAE 197,001,957918,Kleissl; Jan,9998,0,9999,1
1745837203985,MATH 2,A01,957937,Staff,34,0,35,1
1745837205070,MATH 197,001,957876,Kedlaya; Kiran S.,9993,0,9999,6
1745837206100,MCWP 40,A00,892729,Duru; Nur,13,0,20,7
1745837206100,MCWP 40,B00,893304,Montejo; Carolina,20,0,20,0
1745837207127,MCWP 40R,A00,893757,Redela; Pamela Morgan,0,7,20,20
1745837208152,MCWP 50,A00,893758,Morshed; Michael James,2,0,20,18
1745837208152,MCWP 50,B00,893761,Bartulis; Jason Michael,18,0,20,2
1745837209179,MCWP 50R,A00,893766,Compas; Sean Matthew,0,1,20,20
1745837209179,MCWP 50R,B00,893769,Carter; Jennifer A,0,0,20,20
1745837209179,MCWP 50R,C00,893771,Krone; Jarret,0,3,20,20
1745837209179,MCWP 50R,D00,893772,Miller; Elizabeth Deen,3,0,20,17
1745837209179,MCWP 50R,E00,893775,Carter; Andrea L,0,0,20,20
1745837210205,MMW 11R,A01,892721,Herbst; Matthew,11,0,27,16
1745837210205,MMW 11R,A02,892722,Herbst; Matthew,0,0,0,3
1745837211232,MMW 12R,A01,892724,Herbst; Matthew,0,10,16,16
1745837211232,MMW 12R,A02,892725,Herbst; Matthew,0,9,16,16
1745837212260,MMW 13R,A01,892727,Staff,0,3,16,16
1745837212260,MMW 13R,A02,892728,Staff,0,4,16,16
1745837212260,MMW 13R,A03,958032,Staff,0,3,16,16
1745837212260,MMW 13R,A04,958033,Staff,0,2,16,16
1745837212260,MMW 13R,A05,958034,Staff,0,3,16,16
1745837213290,SIO 295LS,A00,894015,Staff,7,0,25,18
1745837214316,SIO 295S,A00,894020,Staff,7,0,25,18
1745837215346,SIOC 290S,B01,958918,Staff,0,0,0,0
1745837216374,SIOC 291S,B01,958922,Staff,0,0,0,0
1745837217401,SOCI 117,A01,895339,Staff,4,0,5,1
1745837218430,WES 237B,A00,894149,Staff,11,0,20,9
1745837220500,AESE 279B,A00,891859,Staff,13,0,35,22
1745837221526,AIP 197,001,891854,Staff,70,0,70,0
1745837222554,ANTH 289S,A00,891856,Gagneux; Pascal,12,0,12,0
1745837223597,BENG 196,001,957946,Engler; Adam J.,9996,0,9999,3
1745837224622,CAT 124RS,A01,956906,Staff,8,0,25,17
1745837225650,CAT 125RS,A01,922013,Staff,8,0,25,17
1745837226679,CLRE 250,A00,891860,Morris; Sheldon,9995,0,9999,4
1745837228734,CLRE 251R,A00,907817,Mehta; Ravindra L.,9994,0,9999,5
1745837229762,CLRE 252,A00,891864,Cuomo; Raphael Eduardo,9993,0,9999,6
1745837230789,CLRE 253,A00,891867,Vaida; Florin,9994,0,9999,5
1745837230789,CLRE 253,B00,907819,Staff,9999,0,9999,0
1745837231817,CLRE 259,A00,891868,Patel; Hemal,9998,0,9999,1
1745837232842,CLRE 260,A00,891872,Cuomo; Raphael Eduardo,9999,0,9999,0
1745837233871,CLRE 297,001,891888,Cuomo; Raphael Eduardo,9999,0,9999,0
1745837234899,CSE 191,A00,958773,Minnes Kemp; Mor Mia,9999,0,9999,0
1745837235928,CSS 201S,A01,892054,Mignozzetti; Umberto,30,0,30,0
1745837236959,CSS 202S,A01,892056,Mignozzetti; Umberto,30,0,30,0
1745837237985,DSC 197,001,956898,Eldridge; Justin Matthew,9998,0,9999,1
1745837239012,DSC 297,001,958000,Mazumdar; Arya,9998,0,9999,1
1745837240038,EAP 100,A00,905686,Staff,9776,0,9999,223
1745837241068,ECE 45,A01,892618,Staff,0,13,50,50
1745837242097,ECE 109,A01,892620,Staff,0,43,0,0
1745837243128,ECE 111,A01,892719,Staff,0,9,50,50
1745837244153,ECE 197,001,957920,Mercier; Patrick Philip,9992,0,9999,7
1745837245181,ECON 178,A01,907814,Zhu; Ying,28,0,35,7
1745837246207,EDS 115,A00,895312,Staff,41,0,45,4
1745837247234,EDS 117,A01,895337,Staff,30,0,30,0
1745837248261,EDS 125,A00,895341,Jones; Gabrielle Anastasia,43,0,45,2
1745837249287,EDS 128A,A01,895459,Fargason; Sharon Gayle,44,0,45,1
1745837250321,EDS 128B,A01,895543,Pappas; Elizabeth,44,0,45,1
1745837251348,EDS 139,A00,897203,Pappas; Elizabeth,44,0,45,1
1745837251348,EDS 139,B00,897209,Fargason; Sharon Gayle,44,0,45,1
1745837252384,EDS 201,A00,895545,Staff,43,0,45,2
1745837253413,EDS 203,A01,895581,Halter; Christopher P.,43,0,45,2
1745837254440,EDS 204R,A01,895625,Heinzman; Erica M.,43,0,45,2
1745837254440,EDS 204R,B01,895693,Halter; Christopher P.,18,0,45,27
1745837255469,EDS 206R,A00,895694,Fargason; Sharon Gayle,9,0,30,21
1745837255469,EDS 206R,B00,895695,Choi; Bailey Miyeon,20,0,30,10
1745837256496,EDS 250,A00,895697,Hemans; Patricia Ann Benitez,43,0,45,2
1745837257525,EDS 281,A00,895701,Meyerott; Theresa Ann,15,0,15,0
1745837258552,EDS 284,A00,895736,Meyerott; Theresa Ann,15,0,15,0
1745837259580,EDS 286,A00,897210,Fine; Sarah,15,0,15,0
1745837260605,EDS 289C,A01,895770,Daly; Alan J.,15,0,15,0
1745837261633,EDS 290,A00,897211,Hofstetter; Carolyn,15,0,15,0
1745837262661,LIGM 5A,A00,896162,Fischer-Grunski; Eva K,15,0,20,5
1745837263690,LIGM 5B,A00,896260,Fischer-Grunski; Eva K,17,0,20,3
1745837264720,LIGM 5C,A00,896308,Fischer-Grunski; Eva K,18,0,20,2
1745837265751,LIIT 5AS,A00,896313,Carnelos; Chiara,17,0,20,3
1745837266780,LIIT 5BS,A00,896416,Carnelos; Chiara,20,0,20,0
1745837267807,LIIT 5CS,A00,896564,Carnelos; Chiara,20,0,20,0
1745837268835,LISP 5A,A00,896588,Munoz Sanchez; Alicia,4,0,20,16
1745837269861,LISP 5B,A00,896653,Munoz Sanchez; Alicia,10,0,20,10
1745837270887,LISP 5C,A00,896655,Munoz Sanchez; Alicia,4,0,20,16
1745837271913,MAE 197,001,957918,Kleissl; Jan,9998,0,9999,1
1745837272939,MATH 2,A01,957937,Staff,34,0,35,1
1745837273966,MATH 197,001,957876,Kedlaya; Kiran S.,9993,0,9999,6
1745837274998,MCWP 40,A00,892729,Duru; Nur,13,0,20,7
1745837274998,MCWP 40,B00,893304,Montejo; Carolina,20,0,20,0
1745837276024,MCWP 40R,A00,893757,Redela; Pamela Morgan,0,7,20,20
1745837277050,MCWP 50,A00,893758,Morshed; Michael James,2,0,20,18
1745837277050,MCWP 50,B00,893761,Bartulis; Jason Michael,18,0,20,2
1745837278075,MCWP 50R,A00,893766,Compas; Sean Matthew,0,1,20,20
1745837278075,MCWP 50R,B00,893769,Carter; Jennifer A,0,0,20,20
1745837278075,MCWP 50R,C00,893771,Krone; Jarret,0,3,20,20
1745837278075,MCWP 50R,D00,893772,Miller; Elizabeth Deen,3,0,20,17
1745837278075,MCWP 50R,E00,893775,Carter; Andrea L,0,0,20,20
1745837279101,MMW 11R,A01,892721,Herbst; Matthew,11,0,27,16
1745837279101,MMW 11R,A02,892722,Herbst; Matthew,0,0,0,3
1745837280128,MMW 12R,A01,892724,Herbst; Matthew,0,10,16,16
1745837280128,MMW 12R,A02,892725,Herbst; Matthew,0,9,16,16
1745837281159,MMW 13R,A01,892727,Staff,0,3,16,16
1745837281159,MMW 13R,A02,892728,Staff,0,4,16,16
1745837281159,MMW 13R,A03,958032,Staff,0,3,16,16
1745837281159,MMW 13R,A04,958033,Staff,0,2,16,16
1745837281159,MMW 13R,A05,958034,Staff,0,3,16,16
1745837282187,SIO 295LS,A00,894015,Staff,7,0,25,18
1745837283218,SIO 295S,A00,894020,Staff,7,0,25,18
1745837284246,SIOC 290S,B01,958918,Staff,0,0,0,0
1745837285274,SIOC 291S,B01,958922,Staff,0,0,0,0
1745837286301,SOCI 117,A01,895339,Staff,4,0,5,1
1745837287328,WES 237B,A00,894149,Staff,11,0,20,9
1745837289399,AESE 279B,A00,891859,Staff,13,0,35,22
1745837290430,AIP 197,001,891854,Staff,70,0,70,0
1745837291456,ANTH 289S,A00,891856,Gagneux; Pascal,12,0,12,0
1745837292482,BENG 196,001,957946,Engler; Adam J.,9996,0,9999,3
1745837293508,CAT 124RS,A01,956906,Staff,8,0,25,17
1745837294536,CAT 125RS,A01,922013,Staff,8,0,25,17
1745837295566,CLRE 250,A00,891860,Morris; Sheldon,9995,0,9999,4
1745837297619,CLRE 251R,A00,907817,Mehta; Ravindra L.,9994,0,9999,5
1745837298649,CLRE 252,A00,891864,Cuomo; Raphael Eduardo,9993,0,9999,6
1745837299680,CLRE 253,A00,891867,Vaida; Florin,9994,0,9999,5
1745837299680,CLRE 253,B00,907819,Staff,9999,0,9999,0
1745837300706,CLRE 259,A00,891868,Patel; Hemal,9998,0,9999,1
1745837301734,CLRE 260,A00,891872,Cuomo; Raphael Eduardo,9999,0,9999,0
1745837302762,CLRE 297,001,891888,Cuomo; Raphael Eduardo,9999,0,9999,0
1745837303792,CSE 191,A00,958773,Minnes Kemp; Mor Mia,9999,0,9999,0
1745837304818,CSS 201S,A01,892054,Mignozzetti; Umberto,30,0,30,0
1745837305853,CSS 202S,A01,892056,Mignozzetti; Umberto,30,0,30,0
1745837306887,DSC 197,001,956898,Eldridge; Justin Matthew,9998,0,9999,1
1745837307917,DSC 297,001,958000,Mazumdar; Arya,9998,0,9999,1
1745837308998,EAP 100,A00,905686,Staff,9776,0,9999,223
1745837310025,ECE 45,A01,892618,Staff,0,13,50,50
1745837311054,ECE 109,A01,892620,Staff,0,43,0,0
1745837312080,ECE 111,A01,892719,Staff,0,9,50,50
1745837313108,ECE 197,001,957920,Mercier; Patrick Philip,9992,0,9999,7
1745837314134,ECON 178,A01,907814,Zhu; Ying,28,0,35,7
1745837315160,EDS 115,A00,895312,Staff,41,0,45,4
1745837316192,EDS 117,A01,895337,Staff,30,0,30,0
1745837317221,EDS 125,A00,895341,Jones; Gabrielle Anastasia,43,0,45,2
1745837318254,EDS 128A,A01,895459,Fargason; Sharon Gayle,44,0,45,1
1745837319283,EDS 128B,A01,895543,Pappas; Elizabeth,44,0,45,1
1745837320309,EDS 139,A00,897203,Pappas; Elizabeth,44,0,45,1
1745837320309,EDS 139,B00,897209,Fargason; Sharon Gayle,44,0,45,1
1745837321337,EDS 201,A00,895545,Staff,43,0,45,2
1745837322368,EDS 203,A01,895581,Halter; Christopher P.,43,0,45,2
1745837323398,EDS 204R,A01,895625,Heinzman; Erica M.,43,0,45,2
1745837323398,EDS 204R,B01,895693,Halter; Christopher P.,18,0,45,27
1745837324428,EDS 206R,A00,895694,Fargason; Sharon Gayle,9,0,30,21
1745837324428,EDS 206R,B00,895695,Choi; Bailey Miyeon,20,0,30,10
1745837325455,EDS 250,A00,895697,Hemans; Patricia Ann Benitez,43,0,45,2
1745837326482,EDS 281,A00,895701,Meyerott; Theresa Ann,15,0,15,0
1745837327508,EDS 284,A00,895736,Meyerott; Theresa Ann,15,0,15,0
1745837328537,EDS 286,A00,897210,Fine; Sarah,15,0,15,0
1745837329565,EDS 289C,A01,895770,Daly; Alan J.,15,0,15,0
1745837330596,EDS 290,A00,897211,Hofstetter; Carolyn,15,0,15,0
1745837331624,LIGM 5A,A00,896162,Fischer-Grunski; Eva K,15,0,20,5
1745837332651,LIGM 5B,A00,896260,Fischer-Grunski; Eva K,17,0,20,3
1745837333677,LIGM 5C,A00,896308,Fischer-Grunski; Eva K,18,0,20,2
1745837334704,LIIT 5AS,A00,896313,Carnelos; Chiara,17,0,20,3
1745837335732,LIIT 5BS,A00,896416,Carnelos; Chiara,20,0,20,0
1745837336759,LIIT 5CS,A00,896564,Carnelos; Chiara,20,0,20,0
1745837337786,LISP 5A,A00,896588,Munoz Sanchez; Alicia,4,0,20,16
1745837338818,LISP 5B,A00,896653,Munoz Sanchez; Alicia,10,0,20,10
1745837339849,LISP 5C,A00,896655,Munoz Sanchez; Alicia,4,0,20,16
1745837340878,MAE 197,001,957918,Kleissl; Jan,9998,0,9999,1
1745837341905,MATH 2,A01,957937,Staff,34,0,35,1
1745837342934,MATH 197,001,957876,Kedlaya; Kiran S.,9993,0,9999,6
1745837343962,MCWP 40,A00,892729,Duru; Nur,13,0,20,7
1745837343962,MCWP 40,B00,893304,Montejo; Carolina,20,0,20,0
1745837344989,MCWP 40R,A00,893757,Redela; Pamela Morgan,0,7,20,20
1745837346016,MCWP 50,A00,893758,Morshed; Michael James,2,0,20,18
1745837346016,MCWP 50,B00,893761,Bartulis; Jason Michael,18,0,20,2
1745837347045,MCWP 50R,A00,893766,Compas; Sean Matthew,0,1,20,20
1745837347045,MCWP 50R,B00,893769,Carter; Jennifer A,0,0,20,20
1745837347045,MCWP 50R,C00,893771,Krone; Jarret,0,3,20,20
1745837347045,MCWP 50R,D00,893772,Miller; Elizabeth Deen,3,0,20,17
1745837347045,MCWP 50R,E00,893775,Carter; Andrea L,0,0,20,20
1745837348072,MMW 11R,A01,892721,Herbst; Matthew,11,0,27,16
1745837348072,MMW 11R,A02,892722,Herbst; Matthew,0,0,0,3
1745837349099,MMW 12R,A01,892724,Herbst; Matthew,0,10,16,16
1745837349099,MMW 12R,A02,892725,Herbst; Matthew,0,9,16,16
1745837350127,MMW 13R,A01,892727,Staff,0,3,16,16
1745837350127,MMW 13R,A02,892728,Staff,0,4,16,16
1745837350127,MMW 13R,A03,958032,Staff,0,3,16,16
1745837350127,MMW 13R,A04,958033,Staff,0,2,16,16
1745837350127,MMW 13R,A05,958034,Staff,0,3,16,16
1745837351156,SIO 295LS,A00,894015,Staff,7,0,25,18
1745837352184,SIO 295S,A00,894020,Staff,7,0,25,18
1745837353211,SIOC 290S,B01,958918,Staff,0,0,0,0
1745837354239,SIOC 291S,B01,958922,Staff,0,0,0,0
1745837355265,SOCI 117,A01,895339,Staff,4,0,5,1
1745837356292,WES 237B,A00,894149,Staff,11,0,20,9
1745837358362,AESE 279B,A00,891859,Staff,13,0,35,22
1745837359388,AIP 197,001,891854,Staff,70,0,70,0
1745837360414,ANTH 289S,A00,891856,Gagneux; Pascal,12,0,12,0
1745837361440,BENG 196,001,957946,Engler; Adam J.,9996,0,9999,3
1745837362466,CAT 124RS,A01,956906,Staff,8,0,25,17
1745837363492,CAT 125RS,A01,922013,Staff,8,0,25,17
1745837364519,CLRE 250,A00,891860,Morris; Sheldon,9995,0,9999,4
1745837366575,CLRE 251R,A00,907817,Mehta; Ravindra L.,9994,0,9999,5
1745837367605,CLRE 252,A00,891864,Cuomo; Raphael Eduardo,9993,0,9999,6
1745837368629,CLRE 253,A00,891867,Vaida; Florin,9994,0,9999,5
1745837368629,CLRE 253,B00,907819,Staff,9999,0,9999,0
1745837369659,CLRE 259,A00,891868,Patel; Hemal,9998,0,9999,1
1745837370685,CLRE 260,A00,891872,Cuomo; Raphael Eduardo,9999,0,9999,0
1745837371713,CLRE 297,001,891888,Cuomo; Raphael Eduardo,9999,0,9999,0
1745837372739,CSE 191,A00,958773,Minnes Kemp; Mor Mia,9999,0,9999,0
1745837373765,CSS 201S,A01,892054,Mignozzetti; Umberto,30,0,30,0
1745837374791,CSS 202S,A01,892056,Mignozzetti; Umberto,30,0,30,0
1745837375817,DSC 197,001,956898,Eldridge; Justin Matthew,9998,0,9999,1
1745837376845,DSC 297,001,958000,Mazumdar; Arya,9998,0,9999,1
1745837377872,EAP 100,A00,905686,Staff,9776,0,9999,223
1745837378901,ECE 45,A01,892618,Staff,0,13,50,50
1745837379926,ECE 109,A01,892620,Staff,0,43,0,0
1745837380952,ECE 111,A01,892719,Staff,0,9,50,50
1745837381978,ECE 197,001,957920,Mercier; Patrick Philip,9992,0,9999,7
1745837383016,ECON 178,A01,907814,Zhu; Ying,28,0,35,7
1745837384047,EDS 115,A00,895312,Staff,41,0,45,4
1745837385074,EDS 117,A01,895337,Staff,30,0,30,0
1745837386100,EDS 125,A00,895341,Jones; Gabrielle Anastasia,43,0,45,2
1745837387127,EDS 128A,A01,895459,Fargason; Sharon Gayle,44,0,45,1
1745837388157,EDS 128B,A01,895543,Pappas; Elizabeth,44,0,45,1
1745837389185,EDS 139,A00,897203,Pappas; Elizabeth,44,0,45,1
1745837389185,EDS 139,B00,897209,Fargason; Sharon Gayle,44,0,45,1
1745837390214,EDS 201,A00,895545,Staff,43,0,45,2
1745837391239,EDS 203,A01,895581,Halter; Christopher P.,43,0,45,2
1745837392265,EDS 204R,A01,895625,Heinzman; Erica M.,43,0,45,2
1745837392265,EDS 204R,B01,895693,Halter; Christopher P.,18,0,45,27
1745837393292,EDS 206R,A00,895694,Fargason; Sharon Gayle,9,0,30,21
1745837393292,EDS 206R,B00,895695,Choi; Bailey Miyeon,20,0,30,10
1745837394319,EDS 250,A00,895697,Hemans; Patricia Ann Benitez,43,0,45,2
1745837395345,EDS 281,A00,895701,Meyerott; Theresa Ann,15,0,15,0
1745837396375,EDS 284,A00,895736,Meyerott; Theresa Ann,15,0,15,0
1745837397401,EDS 286,A00,897210,Fine; Sarah,15,0,15,0
1745837398428,EDS 289C,A01,895770,Daly; Alan J.,15,0,15,0
1745837399458,EDS 290,A00,897211,Hofstetter; Carolyn,15,0,15,0
1745837400489,LIGM 5A,A00,896162,Fischer-Grunski; Eva K,15,0,20,5
1745837401520,LIGM 5B,A00,896260,Fischer-Grunski; Eva K,17,0,20,3
1745837402551,LIGM 5C,A00,896308,Fischer-Grunski; Eva K,18,0,20,2
1745837403580,LIIT 5AS,A00,896313,Carnelos; Chiara,17,0,20,3
1745837404608,LIIT 5BS,A00,896416,Carnelos; Chiara,20,0,20,0
1745837405638,LIIT 5CS,A00,896564,Carnelos; Chiara,20,0,20,0
1745837406669,LISP 5A,A00,896588,Munoz Sanchez; Alicia,4,0,20,16
1745837407699,LISP 5B,A00,896653,Munoz Sanchez; Alicia,10,0,20,10
1745837408730,LISP 5C,A00,896655,Munoz Sanchez; Alicia,4,0,20,16
1745837409757,MAE 197,001,957918,Kleissl; Jan,9998,0,9999,1
1745837410787,MATH 2,A01,957937,Staff,34,0,35,1
1745837411813,MATH 197,001,957876,Kedlaya; Kiran S.,9993,0,9999,6
1745837412897,MCWP 40,A00,892729,Duru; Nur,13,0,20,7
1745837412897,MCWP 40,B00,893304,Montejo; Carolina,20,0,20,0
1745837413925,MCWP 40R,A00,893757,Redela; Pamela Morgan,0,7,20,20
1745837414950,MCWP 50,A00,893758,Morshed; Michael James,2,0,20,18
1745837414950,MCWP 50,B00,893761,Bartulis; Jason Michael,18,0,20,2
1745837415978,MCWP 50R,A00,893766,Compas; Sean Matthew,0,1,20,20
1745837415978,MCWP 50R,B00,893769,Carter; Jennifer A,0,0,20,20
1745837415978,MCWP 50R,C00,893771,Krone; Jarret,0,3,20,20
1745837415978,MCWP 50R,D00,893772,Miller; Elizabeth Deen,3,0,20,17
1745837415978,MCWP 50R,E00,893775,Carter; Andrea L,0,0,20,20
1745837417009,MMW 11R,A01,892721,Herbst; Matthew,11,0,27,16
1745837417009,MMW 11R,A02,892722,Herbst; Matthew,0,0,0,3
1745837418035,MMW 12R,A01,892724,Herbst; Matthew,0,10,16,16
1745837418035,MMW 12R,A02,892725,Herbst; Matthew,0,9,16,16
1745837419063,MMW 13R,A01,892727,Staff,0,3,16,16
1745837419063,MMW 13R,A02,892728,Staff,0,4,16,16
1745837419063,MMW 13R,A03,958032,Staff,0,3,16,16
1745837419063,MMW 13R,A04,958033,Staff,0,2,16,16
1745837419063,MMW 13R,A05,958034,Staff,0,3,16,16
1745837420090,SIO 295LS,A00,894015,Staff,7,0,25,18
1745837421117,SIO 295S,A00,894020,Staff,7,0,25,18
1745837422147,SIOC 290S,B01,958918,Staff,0,0,0,0
1745837423178,SIOC 291S,B01,958922,Staff,0,0,0,0
1745837424204,SOCI 117,A01,895339,Staff,4,0,5,1
1745837425233,WES 237B,A00,894149,Staff,11,0,20,9
1745837427307,AESE 279B,A00,891859,Staff,13,0,35,22
1745837428334,AIP 197,001,891854,Staff,70,0,70,0
1745837429366,ANTH 289S,A00,891856,Gagneux; Pascal,12,0,12,0
1745837430396,BENG 196,001,957946,Engler; Adam J.,9996,0,9999,3
1745837431423,CAT 124RS,A01,956906,Staff,8,0,25,17
1745837432449,CAT 125RS,A01,922013,Staff,8,0,25,17
1745837433481,CLRE 250,A00,891860,Morris; Sheldon,9995,0,9999,4
1745837435532,CLRE 251R,A00,907817,Mehta; Ravindra L.,9994,0,9999,5
1745837436562,CLRE 252,A00,891864,Cuomo; Raphael Eduardo,9993,0,9999,6
1745837437591,CLRE 253,A00,891867,Vaida; Florin,9994,0,9999,5
1745837437591,CLRE 253,B00,907819,Staff,9999,0,9999,0
1745837438619,CLRE 259,A00,891868,Patel; Hemal,9998,0,9999,1
1745837439649,CLRE 260,A00,891872,Cuomo; Raphael Eduardo,9999,0,9999,0
1745837440676,CLRE 297,001,891888,Cuomo; Raphael Eduardo,9999,0,9999,0
1745837441704,CSE 191,A00,958773,Minnes Kemp; Mor Mia,9999,0,9999,0
1745837442731,CSS 201S,A01,892054,Mignozzetti; Umberto,30,0,30,0
1745837443760,CSS 202S,A01,892056,Mignozzetti; Umberto,30,0,30,0
1745837444787,DSC 197,001,956898,Eldridge; Justin Matthew,9998,0,9999,1
1745837445814,DSC 297,001,958000,Mazumdar; Arya,9998,0,9999,1
1745837446841,EAP 100,A00,905686,Staff,9776,0,9999,223
1745837447868,ECE 45,A01,892618,Staff,0,13,50,50
1745837448901,ECE 109,A01,892620,Staff,0,43,0,0
1745837449930,ECE 111,A01,892719,Staff,0,9,50,50
1745837450958,ECE 197,001,957920,Mercier; Patrick Philip,9992,0,9999,7
1745837451985,ECON 178,A01,907814,Zhu; Ying,28,0,35,7
1745837453011,EDS 115,A00,895312,Staff,41,0,45,4
1745837454040,EDS 117,A01,895337,Staff,30,0,30,0
1745837455072,EDS 125,A00,895341,Jones; Gabrielle Anastasia,43,0,45,2
1745837456100,EDS 128A,A01,895459,Fargason; Sharon Gayle,44,0,45,1
1745837457132,EDS 128B,A01,895543,Pappas; Elizabeth,44,0,45,1
1745837458158,EDS 139,A00,897203,Pappas; Elizabeth,44,0,45,1
1745837458158,EDS 139,B00,897209,Fargason; Sharon Gayle,44,0,45,1
1745837459188,EDS 201,A00,895545,Staff,43,0,45,2
1745837460217,EDS 203,A01,895581,Halter; Christopher P.,43,0,45,2
1745837461243,EDS 204R,A01,895625,Heinzman; Erica M.,43,0,45,2
1745837461243,EDS 204R,B01,895693,Halter; Christopher P.,18,0,45,27
1745837462270,EDS 206R,A00,895694,Fargason; Sharon Gayle,9,0,30,21
1745837462270,EDS 206R,B00,895695,Choi; Bailey Miyeon,20,0,30,10
1745837463298,EDS 250,A00,895697,Hemans; Patricia Ann Benitez,43,0,45,2
1745837464329,EDS 281,A00,895701,Meyerott; Theresa Ann,15,0,15,0
1745837465358,EDS 284,A00,895736,Meyerott; Theresa Ann,15,0,15,0
1745837466385,EDS 286,A00,897210,Fine; Sarah,15,0,15,0
1745837467414,EDS 289C,A01,895770,Daly; Alan J.,15,0,15,0
1745837468440,EDS 290,A00,897211,Hofstetter; Carolyn,15,0,15,0
1745837469467,LIGM 5A,A00,896162,Fischer-Grunski; Eva K,15,0,20,5
1745837470499,LIGM 5B,A00,896260,Fischer-Grunski; Eva K,17,0,20,3
1745837471528,LIGM 5C,A00,896308,Fischer-Grunski; Eva K,18,0,20,2
1745837472556,LIIT 5AS,A00,896313,Carnelos; Chiara,17,0,20,3
1745837473592,LIIT 5BS,A00,896416,Carnelos; Chiara,20,0,20,0
1745837474619,LIIT 5CS,A00,896564,Carnelos; Chiara,20,0,20,0
1745837475651,LISP 5A,A00,896588,Munoz Sanchez; Alicia,4,0,20,16
1745837476682,LISP 5B,A00,896653,Munoz Sanchez; Alicia,10,0,20,10
1745837477724,LISP 5C,A00,896655,Munoz Sanchez; Alicia,4,0,20,16
1745837478754,MAE 197,001,957918,Kleissl; Jan,9998,0,9999,1
1745837479785,MATH 2,A01,957937,Staff,34,0,35,1
1745837480811,MATH 197,001,957876,Kedlaya; Kiran S.,9993,0,9999,6
1745837481844,MCWP 40,A00,892729,Duru; Nur,13,0,20,7
1745837481844,MCWP 40,B00,893304,Montejo; Carolina,20,0,20,0
1745837482870,MCWP 40R,A00,893757,Redela; Pamela Morgan,0,7,20,20
1745837483896,MCWP 50,A00,893758,Morshed; Michael James,2,0,20,18
1745837483896,MCWP 50,B00,893761,Bartulis; Jason Michael,18,0,20,2
1745837484930,MCWP 50R,A00,893766,Compas; Sean Matthew,0,1,20,20
1745837484930,MCWP 50R,B00,893769,Carter; Jennifer A,0,0,20,20
1745837484930,MCWP 50R,C00,893771,Krone; Jarret,0,3,20,20
1745837484930,MCWP 50R,D00,893772,Miller; Elizabeth Deen,3,0,20,17
1745837484930,MCWP 50R,E00,893775,Carter; Andrea L,0,0,20,20
1745837485997,MMW 11R,A01,892721,Herbst; Matthew,11,0,27,16
1745837485997,MMW 11R,A02,892722,Herbst; Matthew,0,0,0,3
1745837487024,MMW 12R,A01,892724,Herbst; Matthew,0,10,16,16
1745837487024,MMW 12R,A02,892725,Herbst; Matthew,0,9,16,16
1745837488051,MMW 13R,A01,892727,Staff,0,3,16,16
1745837488051,MMW 13R,A02,892728,Staff,0,4,16,16
1745837488051,MMW 13R,A03,958032,Staff,0,3,16,16
1745837488051,MMW 13R,A04,958033,Staff,0,2,16,16
1745837488051,MMW 13R,A05,958034,Staff,0,3,16,16
1745837489082,SIO 295LS,A00,894015,Staff,7,0,25,18
1745837490109,SIO 295S,A00,894020,Staff,7,0,25,18
1745837491136,SIOC 290S,B01,958918,Staff,0,0,0,0
1745837492164,SIOC 291S,B01,958922,Staff,0,0,0,0
1745837493192,SOCI 117,A01,895339,Staff,4,0,5,1
1745837494222,WES 237B,A00,894149,Staff,11,0,20,9
1745837496298,AESE 279B,A00,891859,Staff,13,0,35,22
1745837497325,AIP 197,001,891854,Staff,70,0,70,0
1745837498355,ANTH 289S,A00,891856,Gagneux; Pascal,12,0,12,0
1745837499384,BENG 196,001,957946,Engler; Adam J.,9996,0,9999,3
1745837500411,CAT 124RS,A01,956906,Staff,8,0,25,17
1745837501439,CAT 125RS,A01,922013,Staff,8,0,25,17
1745837502466,CLRE 250,A00,891860,Morris; Sheldon,9995,0,9999,4
1745837504527,CLRE 251R,A00,907817,Mehta; Ravindra L.,9994,0,9999,5
1745837505553,CLRE 252,A00,891864,Cuomo; Raphael Eduardo,9993,0,9999,6
1745837506580,CLRE 253,A00,891867,Vaida; Florin,9994,0,9999,5
1745837506580,CLRE 253,B00,907819,Staff,9999,0,9999,0
1745837507606,CLRE 259,A00,891868,Patel; Hemal,9998,0,9999,1
1745837508633,CLRE 260,A00,891872,Cuomo; Raphael Eduardo,9999,0,9999,0
1745837509658,CLRE 297,001,891888,Cuomo; Raphael Eduardo,9999,0,9999,0
1745837510683,CSE 191,A00,958773,Minnes Kemp; Mor Mia,9999,0,9999,0
1745837511715,CSS 201S,A01,892054,Mignozzetti; Umberto,30,0,30,0
1745837512741,CSS 202S,A01,892056,Mignozzetti; Umberto,30,0,30,0
1745837513769,DSC 197,001,956898,Eldridge; Justin Matthew,9998,0,9999,1
1745837514796,DSC 297,001,958000,Mazumdar; Arya,9998,0,9999,1
1745837515821,EAP 100,A00,905686,Staff,9776,0,9999,223
1745837516852,ECE 45,A01,892618,Staff,0,13,50,50
1745837517881,ECE 109,A01,892620,Staff,0,43,0,0
1745837518914,ECE 111,A01,892719,Staff,0,9,50,50
1745837519941,ECE 197,001,957920,Mercier; Patrick Philip,9992,0,9999,7
1745837520971,ECON 178,A01,907814,Zhu; Ying,28,0,35,7
1745837521996,EDS 115,A00,895312,Staff,41,0,45,4
1745837523024,EDS 117,A01,895337,Staff,30,0,30,0
1745837524056,EDS 125,A00,895341,Jones; Gabrielle Anastasia,43,0,45,2
1745837525083,EDS 128A,A01,895459,Fargason; Sharon Gayle,44,0,45,1
1745837526108,EDS 128B,A01,895543,Pappas; Elizabeth,44,0,45,1
1745837527138,EDS 139,A00,897203,Pappas; Elizabeth,44,0,45,1
1745837527138,EDS 139,B00,897209,Fargason; Sharon Gayle,44,0,45,1
1745837528169,EDS 201,A00,895545,Staff,43,0,45,2
1745837529203,EDS 203,A01,895581,Halter; Christopher P.,43,0,45,2
1745837530234,EDS 204R,A01,895625,Heinzman; Erica M.,43,0,45,2
1745837530234,EDS 204R,B01,895693,Halter; Christopher P.,18,0,45,27
1745837531260,EDS 206R,A00,895694,Fargason; Sharon Gayle,9,0,30,21
1745837531260,EDS 206R,B00,895695,Choi; Bailey Miyeon,20,0,30,10
1745837532876,EDS 250,A00,895697,Hemans; Patricia Ann Benitez,43,0,45,2
1745837533907,EDS 281,A00,895701,Meyerott; Theresa Ann,15,0,15,0
1745837534937,EDS 284,A00,895736,Meyerott; Theresa Ann,15,0,15,0
1745837535966,EDS 286,A00,897210,Fine; Sarah,15,0,15,0
1745837536994,EDS 289C,A01,895770,Daly; Alan J.,15,0,15,0
1745837538019,EDS 290,A00,897211,Hofstetter; Carolyn,15,0,15,0
1745837539049,LIGM 5A,A00,896162,Fischer-Grunski; Eva K,15,0,20,5
1745837540079,LIGM 5B,A00,896260,Fischer-Grunski; Eva K,17,0,20,3
1745837541111,LIGM 5C,A00,896308,Fischer-Grunski; Eva K,18,0,20,2
1745837542143,LIIT 5AS,A00,896313,Carnelos; Chiara,17,0,20,3
1745837543171,LIIT 5BS,A00,896416,Carnelos; Chiara,20,0,20,0
1745837544199,LIIT 5CS,A00,896564,Carnelos; Chiara,20,0,20,0
1745837545227,LISP 5A,A00,896588,Munoz Sanchez; Alicia,4,0,20,16
1745837546253,LISP 5B,A00,896653,Munoz Sanchez; Alicia,10,0,20,10
1745837547281,LISP 5C,A00,896655,Munoz Sanchez; Alicia,4,0,20,16
1745837548307,MAE 197,001,957918,Kleissl; Jan,9998,0,9999,1
1745837549337,MATH 2,A01,957937,Staff,34,0,35,1
1745837550363,MATH 197,001,957876,Kedlaya; Kiran S.,9993,0,9999,6
1745837551388,MCWP 40,A00,892729,Duru; Nur,13,0,20,7
1745837551388,MCWP 40,B00,893304,Montejo; Carolina,20,0,20,0
1745837552414,MCWP 40R,A00,893757,Redela; Pamela Morgan,0,7,20,20
1745837553441,MCWP 50,A00,893758,Morshed; Michael James,2,0,20,18
1745837553441,MCWP 50,B00,893761,Bartulis; Jason Michael,18,0,20,2
1745837554469,MCWP 50R,A00,893766,Compas; Sean Matthew,0,1,20,20
1745837554469,MCWP 50R,B00,893769,Carter; Jennifer A,0,0,20,20
1745837554469,MCWP 50R,C00,893771,Krone; Jarret,0,3,20,20
1745837554469,MCWP 50R,D00,893772,Miller; Elizabeth Deen,3,0,20,17
1745837554469,MCWP 50R,E00,893775,Carter; Andrea L,0,0,20,20
1745837555497,MMW 11R,A01,892721,Herbst; Matthew,11,0,27,16
1745837555497,MMW 11R,A02,892722,Herbst; Matthew,0,0,0,3
1745837556529,MMW 12R,A01,892724,Herbst; Matthew,0,10,16,16
1745837556529,MMW 12R,A02,892725,Herbst; Matthew,0,9,16,16
1745837557595,MMW 13R,A01,892727,Staff,0,3,16,16
1745837557595,MMW 13R,A02,892728,Staff,0,4,16,16
1745837557595,MMW 13R,A03,958032,Staff,0,3,16,16
1745837557595,MMW 13R,A04,958033,Staff,0,2,16,16
1745837557595,MMW 13R,A05,958034,Staff,0,3,16,16
1745837558624,SIO 295LS,A00,894015,Staff,7,0,25,18
1745837559651,SIO 295S,A00,894020,Staff,7,0,25,18
1745837560678,SIOC 290S,B01,958918,Staff,0,0,0,0
1745837561710,SIOC 291S,B01,958922,Staff,0,0,0,0
1745837562736,SOCI 117,A01,895339,Staff,4,0,5,1
1745837563767,WES 237B,A00,894149,Staff,11,0,20,9
1745837565851,AESE 279B,A00,891859,Staff,13,0,35,22
1745837566880,AIP 197,001,891854,Staff,70,0,70,0
1745837567906,ANTH 289S,A00,891856,Gagneux; Pascal,12,0,12,0
1745837568932,BENG 196,001,957946,Engler; Adam J.,9996,0,9999,3
1745837569956,CAT 124RS,A01,956906,Staff,8,0,25,17
1745837570982,CAT 125RS,A01,922013,Staff,8,0,25,17
1745837572010,CLRE 250,A00,891860,Morris; Sheldon,9995,0,9999,4
1745837574063,CLRE 251R,A00,907817,Mehta; Ravindra L.,9994,0,9999,5
1745837575092,CLRE 252,A00,891864,Cuomo; Raphael Eduardo,9993,0,9999,6
1745837576120,CLRE 253,A00,891867,Vaida; Florin,9994,0,9999,5
1745837576120,CLRE 253,B00,907819,Staff,9999,0,9999,0
1745837577149,CLRE 259,A00,891868,Patel; Hemal,9998,0,9999,1
1745837578181,CLRE 260,A00,891872,Cuomo; Raphael Eduardo,9999,0,9999,0
1745837579209,CLRE 297,001,891888,Cuomo; Raphael Eduardo,9999,0,9999,0
1745837580235,CSE 191,A00,958773,Minnes Kemp; Mor Mia,9999,0,9999,0
1745837581263,CSS 201S,A01,892054,Mignozzetti; Umberto,30,0,30,0
1745837582295,CSS 202S,A01,892056,Mignozzetti; Umberto,30,0,30,0
1745837583320,DSC 197,001,956898,Eldridge; Justin Matthew,9998,0,9999,1
1745837584346,DSC 297,001,958000,Mazumdar; Arya,9998,0,9999,1
1745837585372,EAP 100,A00,905686,Staff,9776,0,9999,223
1745837586402,ECE 45,A01,892618,Staff,0,13,50,50
1745837587435,ECE 109,A01,892620,Staff,0,43,0,0
1745837588460,ECE 111,A01,892719,Staff,0,9,50,50
1745837589489,ECE 197,001,957920,Mercier; Patrick Philip,9992,0,9999,7
1745837590521,ECON 178,A01,907814,Zhu; Ying,28,0,35,7
1745837591548,EDS 115,A00,895312,Staff,41,0,45,4
1745837592575,EDS 117,A01,895337,Staff,30,0,30,0
1745837593601,EDS 125,A00,895341,Jones; Gabrielle Anastasia,43,0,45,2
1745837594628,EDS 128A,A01,895459,Fargason; Sharon Gayle,44,0,45,1
1745837595660,EDS 128B,A01,895543,Pappas; Elizabeth,44,0,45,1
1745837596689,EDS 139,A00,897203,Pappas; Elizabeth,44,0,45,1
1745837596689,EDS 139,B00,897209,Fargason; Sharon Gayle,44,0,45,1
1745837597715,EDS 201,A00,895545,Staff,43,0,45,2
1745837598741,EDS 203,A01,895581,Halter; Christopher P.,43,0,45,2
1745837599767,EDS 204R,A01,895625,Heinzman; Erica M.,43,0,45,2
1745837599767,EDS 204R,B01,895693,Halter; Christopher P.,18,0,45,27
1745837600793,EDS 206R,A00,895694,Fargason; Sharon Gayle,9,0,30,21
1745837600793,EDS 206R,B00,895695,Choi; Bailey Miyeon,20,0,30,10
1745837601819,EDS 250,A00,895697,Hemans; Patricia Ann Benitez,43,0,45,2
1745837602850,EDS 281,A00,895701,Meyerott; Theresa Ann,15,0,15,0
1745837603877,EDS 284,A00,895736,Meyerott; Theresa Ann,15,0,15,0
1745837604905,EDS 286,A00,897210,Fine; Sarah,15,0,15,0
1745837605934,EDS 289C,A01,895770,Daly; Alan J.,15,0,15,0
1745837606970,EDS 290,A00,897211,Hofstetter; Carolyn,15,0,15,0
1745837608090,LIGM 5A,A00,896162,Fischer-Grunski; Eva K,15,0,20,5
1745837609116,LIGM 5B,A00,896260,Fischer-Grunski; Eva K,17,0,20,3
1745837610142,LIGM 5C,A00,896308,Fischer-Grunski; Eva K,18,0,20,2
1745837611167,LIIT 5AS,A00,896313,Carnelos; Chiara,17,0,20,3
1745837612191,LIIT 5BS,A00,896416,Carnelos; Chiara,20,0,20,0
1745837613232,LIIT 5CS,A00,896564,Carnelos; Chiara,20,0,20,0
1745837614262,LISP 5A,A00,896588,Munoz Sanchez; Alicia,4,0,20,16
1745837615292,LISP 5B,A00,896653,Munoz Sanchez; Alicia,10,0,20,10
1745837616318,LISP 5C,A00,896655,Munoz Sanchez; Alicia,4,0,20,16
1745837617350,MAE 197,001,957918,Kleissl; Jan,9998,0,9999,1
1745837618374,MATH 2,A01,957937,Staff,34,0,35,1
1745837619414,MATH 197,001,957876,Kedlaya; Kiran S.,9993,0,9999,6
1745837620505,MCWP 40,A00,892729,Duru; Nur,13,0,20,7
1745837620505,MCWP 40,B00,893304,Montejo; Carolina,20,0,20,0
1745837621554,MCWP 40R,A00,893757,Redela; Pamela Morgan,0,7,20,20
1745837622590,MCWP 50,A00,893758,Morshed; Michael James,2,0,20,18
1745837622590,MCWP 50,B00,893761,Bartulis; Jason Michael,18,0,20,2
1745837623616,MCWP 50R,A00,893766,Compas; Sean Matthew,0,1,20,20
1745837623616,MCWP 50R,B00,893769,Carter; Jennifer A,0,0,20,20
1745837623616,MCWP 50R,C00,893771,Krone; Jarret,0,3,20,20
1745837623616,MCWP 50R,D00,893772,Miller; Elizabeth Deen,3,0,20,17
1745837623616,MCWP 50R,E00,893775,Carter; Andrea L,0,0,20,20
1745837624640,MMW 11R,A01,892721,Herbst; Matthew,11,0,27,16
1745837624640,MMW 11R,A02,892722,Herbst; Matthew,0,0,0,3
1745837625665,MMW 12R,A01,892724,Herbst; Matthew,0,10,16,16
1745837625665,MMW 12R,A02,892725,Herbst; Matthew,0,9,16,16
1745837626691,MMW 13R,A01,892727,Staff,0,3,16,16
1745837626691,MMW 13R,A02,892728,Staff,0,4,16,16
1745837626691,MMW 13R,A03,958032,Staff,0,3,16,16
1745837626691,MMW 13R,A04,958033,Staff,0,2,16,16
1745837626691,MMW 13R,A05,958034,Staff,0,3,16,16
1745837627719,SIO 295LS,A00,894015,Staff,7,0,25,18
1745837628747,SIO 295S,A00,894020,Staff,7,0,25,18
1745837629807,SIOC 290S,B01,958918,Staff,0,0,0,0
1745837630834,SIOC 291S,B01,958922,Staff,0,0,0,0
1745837631864,SOCI 117,A01,895339,Staff,4,0,5,1
1745837632889,WES 237B,A00,894149,Staff,11,0,20,9
1745837634960,AESE 279B,A00,891859,Staff,13,0,35,22
1745837635984,AIP 197,001,891854,Staff,70,0,70,0
1745837637011,ANTH 289S,A00,891856,Gagneux; Pascal,12,0,12,0
1745837638038,BENG 196,001,957946,Engler; Adam J.,9996,0,9999,3
1745837639069,CAT 124RS,A01,956906,Staff,8,0,25,17
1745837640095,CAT 125RS,A01,922013,Staff,8,0,25,17
1745837641124,CLRE 250,A00,891860,Morris; Sheldon,9995,0,9999,4
1745837643179,CLRE 251R,A00,907817,Mehta; Ravindra L.,9994,0,9999,5
1745837644207,CLRE 252,A00,891864,Cuomo; Raphael Eduardo,9993,0,9999,6
1745837645252,CLRE 253,A00,891867,Vaida; Florin,9994,0,9999,5
1745837645252,CLRE 253,B00,907819,Staff,9999,0,9999,0
1745837646283,CLRE 259,A00,891868,Patel; Hemal,9998,0,9999,1
1745837647313,CLRE 260,A00,891872,Cuomo; Raphael Eduardo,9999,0,9999,0
1745837648341,CLRE 297,001,891888,Cuomo; Raphael Eduardo,9999,0,9999,0
1745837649371,CSE 191,A00,958773,Minnes Kemp; Mor Mia,9999,0,9999,0
1745837650490,CSS 201S,A01,892054,Mignozzetti; Umberto,30,0,30,0
1745837651519,CSS 202S,A01,892056,Mignozzetti; Umberto,30,0,30,0
1745837652543,DSC 197,001,956898,Eldridge; Justin Matthew,9998,0,9999,1
1745837653573,DSC 297,001,958000,Mazumdar; Arya,9998,0,9999,1
1745837654599,EAP 100,A00,905686,Staff,9776,0,9999,223
1745837655630,ECE 45,A01,892618,Staff,0,13,50,50
1745837656659,ECE 109,A01,892620,Staff,0,43,0,0
1745837657689,ECE 111,A01,892719,Staff,0,9,50,50
1745837658714,ECE 197,001,957920,Mercier; Patrick Philip,9992,0,9999,7
1745837659738,ECON 178,A01,907814,Zhu; Ying,28,0,35,7
1745837660771,EDS 115,A00,895312,Staff,41,0,45,4
1745837661800,EDS 117,A01,895337,Staff,30,0,30,0
1745837662879,EDS 125,A00,895341,Jones; Gabrielle Anastasia,43,0,45,2
1745837663911,EDS 128A,A01,895459,Fargason; Sharon Gayle,44,0,45,1
1745837665033,EDS 128B,A01,895543,Pappas; Elizabeth,44,0,45,1
1745837666092,EDS 139,A00,897203,Pappas; Elizabeth,44,0,45,1
1745837666092,EDS 139,B00,897209,Fargason; Sharon Gayle,44,0,45,1
1745837667118,EDS 201,A00,895545,Staff,43,0,45,2
1745837668144,EDS 203,A01,895581,Halter; Christopher P.,43,0,45,2
1745837669170,EDS 204R,A01,895625,Heinzman; Erica M.,43,0,45,2
1745837669170,EDS 204R,B01,895693,Halter; Christopher P.,18,0,45,27
1745837670195,EDS 206R,A00,895694,Fargason; Sharon Gayle,9,0,30,21
1745837670195,EDS 206R,B00,895695,Choi; Bailey Miyeon,20,0,30,10
1745837671222,EDS 250,A00,895697,Hemans; Patricia Ann Benitez,43,0,45,2
1745837672247,EDS 281,A00,895701,Meyerott; Theresa Ann,15,0,15,0
1745837673274,EDS 284,A00,895736,Meyerott; Theresa Ann,15,0,15,0
1745837674299,EDS 286,A00,897210,Fine; Sarah,15,0,15,0
1745837675329,EDS 289C,A01,895770,Daly; Alan J.,15,0,15,0
1745837676352,EDS 290,A00,897211,Hofstetter; Carolyn,15,0,15,0
1745837677382,LIGM 5A,A00,896162,Fischer-Grunski; Eva K,15,0,20,5
1745837678411,LIGM 5B,A00,896260,Fischer-Grunski; Eva K,17,0,20,3
1745837679509,LIGM 5C,A00,896308,Fischer-Grunski; Eva K,18,0,20,2
1745837680533,LIIT 5AS,A00,896313,Carnelos; Chiara,17,0,20,3
1745837681559,LIIT 5BS,A00,896416,Carnelos; Chiara,20,0,20,0
1745837682583,LIIT 5CS,A00,896564,Carnelos; Chiara,20,0,20,0
1745837683614,LISP 5A,A00,896588,Munoz Sanchez; Alicia,4,0,20,16
1745837684649,LISP 5B,A00,896653,Munoz Sanchez; Alicia,10,0,20,10
1745837685679,LISP 5C,A00,896655,Munoz Sanchez; Alicia,4,0,20,16
1745837686703,MAE 197,001,957918,Kleissl; Jan,9998,0,9999,1
1745837687729,MATH 2,A01,957937,Staff,34,0,35,1
1745837688773,MATH 197,001,957876,Kedlaya; Kiran S.,9993,0,9999,6
1745837689799,MCWP 40,A00,892729,Duru; Nur,13,0,20,7
1745837689799,MCWP 40,B00,893304,Montejo; Carolina,20,0,20,0
1745837690845,MCWP 40R,A00,893757,Redela; Pamela Morgan,0,7,20,20
1745837691875,MCWP 50,A00,893758,Morshed; Michael James,2,0,20,18
1745837691875,MCWP 50,B00,893761,Bartulis; Jason Michael,18,0,20,2
1745837692903,MCWP 50R,A00,893766,Compas; Sean Matthew,0,1,20,20
1745837692903,MCWP 50R,B00,893769,Carter; Jennifer A,0,0,20,20
1745837692903,MCWP 50R,C00,893771,Krone; Jarret,0,3,20,20
1745837692903,MCWP 50R,D00,893772,Miller; Elizabeth Deen,3,0,20,17
1745837692903,MCWP 50R,E00,893775,Carter; Andrea L,0,0,20,20
1745837693928,MMW 11R,A01,892721,Herbst; Matthew,11,0,27,16
1745837693928,MMW 11R,A02,892722,Herbst; Matthew,0,0,0,3
1745837694954,MMW 12R,A01,892724,Herbst; Matthew,0,10,16,16
1745837694954,MMW 12R,A02,892725,Herbst; Matthew,0,9,16,16
1745837695981,MMW 13R,A01,892727,Staff,0,3,16,16
1745837695981,MMW 13R,A02,892728,Staff,0,4,16,16
1745837695981,MMW 13R,A03,958032,Staff,0,3,16,16
1745837695981,MMW 13R,A04,958033,Staff,0,2,16,16
1745837695981,MMW 13R,A05,958034,Staff,0,3,16,16
1745837697005,SIO 295LS,A00,894015,Staff,7,0,25,18
1745837698051,SIO 295S,A00,894020,Staff,7,0,25,18
1745837699081,SIOC 290S,B01,958918,Staff,0,0,0,0
1745837700113,SIOC 291S,B01,958922,Staff,0,0,0,0
1745837701141,SOCI 117,A01,895339,Staff,4,0,5,1
1745837702167,WES 237B,A00,894149,Staff,11,0,20,9
1745837704239,AESE 279B,A00,891859,Staff,13,0,35,22
1745837705265,AIP 197,001,891854,Staff,70,0,70,0
1745837706292,ANTH 289S,A00,891856,Gagneux; Pascal,12,0,12,0
1745837707322,BENG 196,001,957946,Engler; Adam J.,9996,0,9999,3
1745837708351,CAT 124RS,A01,956906,Staff,8,0,25,17
1745837709381,CAT 125RS,A01,922013,Staff,8,0,25,17
1745837710406,CLRE 250,A00,891860,Morris; Sheldon,9995,0,9999,4
1745837712459,CLRE 251R,A00,907817,Mehta; Ravindra L.,9994,0,9999,5
1745837713485,CLRE 252,A00,891864,Cuomo; Raphael Eduardo,9993,0,9999,6
1745837714512,CLRE 253,A00,891867,Vaida; Florin,9994,0,9999,5
1745837714512,CLRE 253,B00,907819,Staff,9999,0,9999,0
1745837715540,CLRE 259,A00,891868,Patel; Hemal,9998,0,9999,1
1745837716569,CLRE 260,A00,891872,Cuomo; Raphael Eduardo,9999,0,9999,0
1745837717595,CLRE 297,001,891888,Cuomo; Raphael Eduardo,9999,0,9999,0
1745837718625,CSE 191,A00,958773,Minnes Kemp; Mor Mia,9999,0,9999,0
1745837719650,CSS 201S,A01,892054,Mignozzetti; Umberto,30,0,30,0
1745837720678,CSS 202S,A01,892056,Mignozzetti; Umberto,30,0,30,0
1745837721705,DSC 197,001,956898,Eldridge; Justin Matthew,9998,0,9999,1
1745837722733,DSC 297,001,958000,Mazumdar; Arya,9998,0,9999,1
1745837723762,EAP 100,A00,905686,Staff,9776,0,9999,223
1745837724792,ECE 45,A01,892618,Staff,0,13,50,50
1745837725821,ECE 109,A01,892620,Staff,0,43,0,0
1745837726847,ECE 111,A01,892719,Staff,0,9,50,50
1745837727873,ECE 197,001,957920,Mercier; Patrick Philip,9992,0,9999,7
1745837728899,ECON 178,A01,907814,Zhu; Ying,28,0,35,7
1745837729927,EDS 115,A00,895312,Staff,41,0,45,4
1745837730955,EDS 117,A01,895337,Staff,30,0,30,0
1745837731982,EDS 125,A00,895341,Jones; Gabrielle Anastasia,43,0,45,2
1745837733008,EDS 128A,A01,895459,Fargason; Sharon Gayle,44,0,45,1
1745837734036,EDS 128B,A01,895543,Pappas; Elizabeth,44,0,45,1
1745837735066,EDS 139,A00,897203,Pappas; Elizabeth,44,0,45,1
1745837735066,EDS 139,B00,897209,Fargason; Sharon Gayle,44,0,45,1
1745837736126,EDS 201,A00,895545,Staff,43,0,45,2
1745837737157,EDS 203,A01,895581,Halter; Christopher P.,43,0,45,2
1745837738187,EDS 204R,A01,895625,Heinzman; Erica M.,43,0,45,2
1745837738187,EDS 204R,B01,895693,Halter; Christopher P.,18,0,45,27
1745837739215,EDS 206R,A00,895694,Fargason; Sharon Gayle,9,0,30,21
1745837739215,EDS 206R,B00,895695,Choi; Bailey Miyeon,20,0,30,10
1745837740245,EDS 250,A00,895697,Hemans; Patricia Ann Benitez,43,0,45,2
1745837741275,EDS 281,A00,895701,Meyerott; Theresa Ann,15,0,15,0
1745837742301,EDS 284,A00,895736,Meyerott; Theresa Ann,15,0,15,0
1745837743326,EDS 286,A00,897210,Fine; Sarah,15,0,15,0
1745837744353,EDS 289C,A01,895770,Daly; Alan J.,15,0,15,0
1745837745383,EDS 290,A00,897211,Hofstetter; Carolyn,15,0,15,0
1745837746415,LIGM 5A,A00,896162,Fischer-Grunski; Eva K,15,0,20,5
1745837747442,LIGM 5B,A00,896260,Fischer-Grunski; Eva K,17,0,20,3
1745837748466,LIGM 5C,A00,896308,Fischer-Grunski; Eva K,18,0,20,2
1745837749492,LIIT 5AS,A00,896313,Carnelos; Chiara,17,0,20,3
1745837750522,LIIT 5BS,A00,896416,Carnelos; Chiara,20,0,20,0
1745837751549,LIIT 5CS,A00,896564,Carnelos; Chiara,20,0,20,0
1745837752575,LISP 5A,A00,896588,Munoz Sanchez; Alicia,4,0,20,16
1745837753602,LISP 5B,A00,896653,Munoz Sanchez; Alicia,10,0,20,10
1745837754634,LISP 5C,A00,896655,Munoz Sanchez; Alicia,4,0,20,16
1745837755659,MAE 197,001,957918,Kleissl; Jan,9998,0,9999,1
1745837756685,MATH 2,A01,957937,Staff,34,0,35,1
1745837757714,MATH 197,001,957876,Kedlaya; Kiran S.,9993,0,9999,6
1745837758740,MCWP 40,A00,892729,Duru; Nur,13,0,20,7
1745837758740,MCWP 40,B00,893304,Montejo; Carolina,20,0,20,0
1745837759767,MCWP 40R,A00,893757,Redela; Pamela Morgan,0,7,20,20
1745837760791,MCWP 50,A00,893758,Morshed; Michael James,2,0,20,18
1745837760791,MCWP 50,B00,893761,Bartulis; Jason Michael,18,0,20,2
1745837761823,MCWP 50R,A00,893766,Compas; Sean Matthew,0,1,20,20
1745837761823,MCWP 50R,B00,893769,Carter; Jennifer A,0,0,20,20
1745837761823,MCWP 50R,C00,893771,Krone; Jarret,0,3,20,20
1745837761823,MCWP 50R,D00,893772,Miller; Elizabeth Deen,3,0,20,17
1745837761823,MCWP 50R,E00,893775,Carter; Andrea L,0,0,20,20
1745837762852,MMW 11R,A01,892721,Herbst; Matthew,11,0,27,16
1745837762852,MMW 11R,A02,892722,Herbst; Matthew,0,0,0,3
1745837763879,MMW 12R,A01,892724,Herbst; Matthew,0,10,16,16
1745837763879,MMW 12R,A02,892725,Herbst; Matthew,0,9,16,16
1745837764905,MMW 13R,A01,892727,Staff,0,3,16,16
1745837764905,MMW 13R,A02,892728,Staff,0,4,16,16
1745837764905,MMW 13R,A03,958032,Staff,0,3,16,16
1745837764905,MMW 13R,A04,958033,Staff,0,2,16,16
1745837764905,MMW 13R,A05,958034,Staff,0,3,16,16
1745837765932,SIO 295LS,A00,894015,Staff,7,0,25,18
1745837766957,SIO 295S,A00,894020,Staff,7,0,25,18
1745837767983,SIOC 290S,B01,958918,Staff,0,0,0,0
1745837769013,SIOC 291S,B01,958922,Staff,0,0,0,0
1745837770046,SOCI 117,A01,895339,Staff,4,0,5,1
1745837771076,WES 237B,A00,894149,Staff,11,0,20,9
1745837773142,AESE 279B,A00,891859,Staff,13,0,35,22
1745837774169,AIP 197,001,891854,Staff,70,0,70,0
1745837775196,ANTH 289S,A00,891856,Gagneux; Pascal,12,0,12,0
1745837776223,BENG 196,001,957946,Engler; Adam J.,9996,0,9999,3
1745837777248,CAT 124RS,A01,956906,Staff,8,0,25,17
1745837778274,CAT 125RS,A01,922013,Staff,8,0,25,17
1745837779300,CLRE 250,A00,891860,Morris; Sheldon,9995,0,9999,4
1745837781356,CLRE 251R,A00,907817,Mehta; Ravindra L.,9994,0,9999,5
1745837782396,CLRE 252,A00,891864,Cuomo; Raphael Eduardo,9993,0,9999,6
1745837783426,CLRE 253,A00,891867,Vaida; Florin,9994,0,9999,5
1745837783426,CLRE 253,B00,907819,Staff,9999,0,9999,0
1745837784453,CLRE 259,A00,891868,Patel; Hemal,9998,0,9999,1
1745837785483,CLRE 260,A00,891872,Cuomo; Raphael Eduardo,9999,0,9999,0
1745837786510,CLRE 297,001,891888,Cuomo; Raphael Eduardo,9999,0,9999,0
1745837787536,CSE 191,A00,958773,Minnes Kemp; Mor Mia,9999,0,9999,0
1745837788561,CSS 201S,A01,892054,Mignozzetti; Umberto,30,0,30,0
1745837789587,CSS 202S,A01,892056,Mignozzetti; Umberto,30,0,30,0
1745837790613,DSC 197,001,956898,Eldridge; Justin Matthew,9998,0,9999,1
1745837791640,DSC 297,001,958000,Mazumdar; Arya,9998,0,9999,1
1745837792667,EAP 100,A00,905686,Staff,9776,0,9999,223
1745837793697,ECE 45,A01,892618,Staff,0,13,50,50
1745837794724,ECE 109,A01,892620,Staff,0,43,0,0
1745837795751,ECE 111,A01,892719,Staff,0,9,50,50
1745837796781,ECE 197,001,957920,Mercier; Patrick Philip,9992,0,9999,7
1745837797812,ECON 178,A01,907814,Zhu; Ying,28,0,35,7
1745837798838,EDS 115,A00,895312,Staff,41,0,45,4
1745837799865,EDS 117,A01,895337,Staff,30,0,30,0
1745837800892,EDS 125,A00,895341,Jones; Gabrielle Anastasia,43,0,45,2
1745837801923,EDS 128A,A01,895459,Fargason; Sharon Gayle,44,0,45,1
1745837802952,EDS 128B,A01,895543,Pappas; Elizabeth,44,0,45,1
1745837803979,EDS 139,A00,897203,Pappas; Elizabeth,44,0,45,1
1745837803979,EDS 139,B00,897209,Fargason; Sharon Gayle,44,0,45,1
1745837805007,EDS 201,A00,895545,Staff,43,0,45,2
1745837806033,EDS 203,A01,895581,Halter; Christopher P.,43,0,45,2
1745837807064,EDS 204R,A01,895625,Heinzman; Erica M.,43,0,45,2
1745837807064,EDS 204R,B01,895693,Halter; Christopher P.,18,0,45,27
1745837808093,EDS 206R,A00,895694,Fargason; Sharon Gayle,9,0,30,21
1745837808093,EDS 206R,B00,895695,Choi; Bailey Miyeon,20,0,30,10
1745837809118,EDS 250,A00,895697,Hemans; Patricia Ann Benitez,43,0,45,2
1745837810148,EDS 281,A00,895701,Meyerott; Theresa Ann,15,0,15,0
1745837811178,EDS 284,A00,895736,Meyerott; Theresa Ann,15,0,15,0
1745837812202,EDS 286,A00,897210,Fine; Sarah,15,0,15,0
1745837813230,EDS 289C,A01,895770,Daly; Alan J.,15,0,15,0
1745837814257,EDS 290,A00,897211,Hofstetter; Carolyn,15,0,15,0
1745837815289,LIGM 5A,A00,896162,Fischer-Grunski; Eva K,15,0,20,5
1745837816317,LIGM 5B,A00,896260,Fischer-Grunski; Eva K,17,0,20,3
1745837817347,LIGM 5C,A00,896308,Fischer-Grunski; Eva K,18,0,20,2
1745837818377,LIIT 5AS,A00,896313,Carnelos; Chiara,17,0,20,3
1745837819409,LIIT 5BS,A00,896416,Carnelos; Chiara,20,0,20,0
1745837820435,LIIT 5CS,A00,896564,Carnelos; Chiara,20,0,20,0
1745837821463,LISP 5A,A00,896588,Munoz Sanchez; Alicia,4,0,20,16
1745837822497,LISP 5B,A00,896653,Munoz Sanchez; Alicia,10,0,20,10
1745837823526,LISP 5C,A00,896655,Munoz Sanchez; Alicia,4,0,20,16
1745837824554,MAE 197,001,957918,Kleissl; Jan,9998,0,9999,1
1745837825581,MATH 2,A01,957937,Staff,34,0,35,1
1745837826606,MATH 197,001,957876,Kedlaya; Kiran S.,9993,0,9999,6
1745837827635,MCWP 40,A00,892729,Duru; Nur,13,0,20,7
1745837827635,MCWP 40,B00,893304,Montejo; Carolina,20,0,20,0
1745837828660,MCWP 40R,A00,893757,Redela; Pamela Morgan,0,7,20,20
1745837829688,MCWP 50,A00,893758,Morshed; Michael James,2,0,20,18
1745837829688,MCWP 50,B00,893761,Bartulis; Jason Michael,18,0,20,2
1745837830719,MCWP 50R,A00,893766,Compas; Sean Matthew,0,1,20,20
1745837830719,MCWP 50R,B00,893769,Carter; Jennifer A,0,0,20,20
1745837830719,MCWP 50R,C00,893771,Krone; Jarret,0,3,20,20
1745837830719,MCWP 50R,D00,893772,Miller; Elizabeth Deen,3,0,20,17
1745837830719,MCWP 50R,E00,893775,Carter; Andrea L,0,0,20,20
1745837831750,MMW 11R,A01,892721,Herbst; Matthew,11,0,27,16
1745837831750,MMW 11R,A02,892722,Herbst; Matthew,0,0,0,3
1745837832776,MMW 12R,A01,892724,Herbst; Matthew,0,10,16,16
1745837832776,MMW 12R,A02,892725,Herbst; Matthew,0,9,16,16
1745837833804,MMW 13R,A01,892727,Staff,0,3,16,16
1745837833804,MMW 13R,A02,892728,Staff,0,4,16,16
1745837833804,MMW 13R,A03,958032,Staff,0,3,16,16
1745837833804,MMW 13R,A04,958033,Staff,0,2,16,16
1745837833804,MMW 13R,A05,958034,Staff,0,3,16,16
1745837834833,SIO 295LS,A00,894015,Staff,7,0,25,18
1745837835865,SIO 295S,A00,894020,Staff,7,0,25,18
1745837836897,SIOC 290S,B01,958918,Staff,0,0,0,0
1745837837928,SIOC 291S,B01,958922,Staff,0,0,0,0
1745837838958,SOCI 117,A01,895339,Staff,4,0,5,1
1745837839989,WES 237B,A00,894149,Staff,11,0,20,9
1745837842088,AESE 279B,A00,891859,Staff,13,0,35,22
1745837843114,AIP 197,001,891854,Staff,70,0,70,0
1745837844143,ANTH 289S,A00,891856,Gagneux; Pascal,12,0,12,0
1745837845168,BENG 196,001,957946,Engler; Adam J.,9996,0,9999,3
1745837846194,CAT 124RS,A01,956906,Staff,8,0,25,17
1745837847222,CAT 125RS,A01,922013,Staff,8,0,25,17
1745837848253,CLRE 250,A00,891860,Morris; Sheldon,9995,0,9999,4
1745837850309,CLRE 251R,A00,907817,Mehta; Ravindra L.,9994,0,9999,5
1745837851339,CLRE 252,A00,891864,Cuomo; Raphael Eduardo,9993,0,9999,6
1745837852365,CLRE 253,A00,891867,Vaida; Florin,9994,0,9999,5
1745837852365,CLRE 253,B00,907819,Staff,9999,0,9999,0
1745837853391,CLRE 259,A00,891868,Patel; Hemal,9998,0,9999,1
1745837854420,CLRE 260,A00,891872,Cuomo; Raphael Eduardo,9999,0,9999,0
1745837855451,CLRE 297,001,891888,Cuomo; Raphael Eduardo,9999,0,9999,0
1745837856476,CSE 191,A00,958773,Minnes Kemp; Mor Mia,9999,0,9999,0
1745837857506,CSS 201S,A01,892054,Mignozzetti; Umberto,30,0,30,0
1745837858537,CSS 202S,A01,892056,Mignozzetti; Umberto,30,0,30,0
1745837859565,DSC 197,001,956898,Eldridge; Justin Matthew,9998,0,9999,1
1745837860593,DSC 297,001,958000,Mazumdar; Arya,9998,0,9999,1
1745837861622,EAP 100,A00,905686,Staff,9776,0,9999,223
1745837862649,ECE 45,A01,892618,Staff,0,13,50,50
1745837863675,ECE 109,A01,892620,Staff,0,43,0,0
1745837864701,ECE 111,A01,892719,Staff,0,9,50,50
1745837865727,ECE 197,001,957920,Mercier; Patrick Philip,9992,0,9999,7
1745837866753,ECON 178,A01,907814,Zhu; Ying,28,0,35,7
1745837867782,EDS 115,A00,895312,Staff,41,0,45,4
1745837868811,EDS 117,A01,895337,Staff,30,0,30,0
1745837869876,EDS 125,A00,895341,Jones; Gabrielle Anastasia,43,0,45,2
1745837870906,EDS 128A,A01,895459,Fargason; Sharon Gayle,44,0,45,1
1745837871932,EDS 128B,A01,895543,Pappas; Elizabeth,44,0,45,1
1745837872963,EDS 139,A00,897203,Pappas; Elizabeth,44,0,45,1
1745837872963,EDS 139,B00,897209,Fargason; Sharon Gayle,44,0,45,1
1745837873992,EDS 201,A00,895545,Staff,43,0,45,2
1745837875019,EDS 203,A01,895581,Halter; Christopher P.,43,0,45,2
1745837876046,EDS 204R,A01,895625,Heinzman; Erica M.,43,0,45,2
1745837876046,EDS 204R,B01,895693,Halter; Christopher P.,18,0,45,27
1745837877077,EDS 206R,A00,895694,Fargason; Sharon Gayle,9,0,30,21
1745837877077,EDS 206R,B00,895695,Choi; Bailey Miyeon,20,0,30,10
1745837878103,EDS 250,A00,895697,Hemans; Patricia Ann Benitez,43,0,45,2
1745837879136,EDS 281,A00,895701,Meyerott; Theresa Ann,15,0,15,0
1745837880165,EDS 284,A00,895736,Meyerott; Theresa Ann,15,0,15,0
1745837881190,EDS 286,A00,897210,Fine; Sarah,15,0,15,0
1745837882216,EDS 289C,A01,895770,Daly; Alan J.,15,0,15,0
1745837883244,EDS 290,A00,897211,Hofstetter; Carolyn,15,0,15,0
1745837884270,LIGM 5A,A00,896162,Fischer-Grunski; Eva K,15,0,20,5
1745837885299,LIGM 5B,A00,896260,Fischer-Grunski; Eva K,17,0,20,3
1745837886326,LIGM 5C,A00,896308,Fischer-Grunski; Eva K,18,0,20,2
1745837887357,LIIT 5AS,A00,896313,Carnelos; Chiara,17,0,20,3
1745837888386,LIIT 5BS,A00,896416,Carnelos; Chiara,20,0,20,0
1745837889412,LIIT 5CS,A00,896564,Carnelos; Chiara,20,0,20,0
1745837890437,LISP 5A,A00,896588,Munoz Sanchez; Alicia,4,0,20,16
1745837891465,LISP 5B,A00,896653,Munoz Sanchez; Alicia,10,0,20,10
1745837892492,LISP 5C,A00,896655,Munoz Sanchez; Alicia,4,0,20,16
1745837893519,MAE 197,001,957918,Kleissl; Jan,9998,0,9999,1
1745837894547,MATH 2,A01,957937,Staff,34,0,35,1
1745837895573,MATH 197,001,957876,Kedlaya; Kiran S.,9993,0,9999,6
1745837896597,MCWP 40,A00,892729,Duru; Nur,13,0,20,7
1745837896597,MCWP 40,B00,893304,Montejo; Carolina,20,0,20,0
1745837897623,MCWP 40R,A00,893757,Redela; Pamela Morgan,0,7,20,20
1745837898649,MCWP 50,A00,893758,Morshed; Michael James,2,0,20,18
1745837898649,MCWP 50,B00,893761,Bartulis; Jason Michael,18,0,20,2
1745837899673,MCWP 50R,A00,893766,Compas; Sean Matthew,0,1,20,20
1745837899673,MCWP 50R,B00,893769,Carter; Jennifer A,0,0,20,20
1745837899673,MCWP 50R,C00,893771,Krone; Jarret,0,3,20,20
1745837899673,MCWP 50R,D00,893772,Miller; Elizabeth Deen,3,0,20,17
1745837899673,MCWP 50R,E00,893775,Carter; Andrea L,0,0,20,20
1745837900699,MMW 11R,A01,892721,Herbst; Matthew,11,0,27,16
1745837900699,MMW 11R,A02,892722,Herbst; Matthew,0,0,0,3
1745837901725,MMW 12R,A01,892724,Herbst; Matthew,0,10,16,16
1745837901725,MMW 12R,A02,892725,Herbst; Matthew,0,9,16,16
1745837902755,MMW 13R,A01,892727,Staff,0,3,16,16
1745837902755,MMW 13R,A02,892728,Staff,0,4,16,16
1745837902755,MMW 13R,A03,958032,Staff,0,3,16,16
1745837902755,MMW 13R,A04,958033,Staff,0,2,16,16
1745837902755,MMW 13R,A05,958034,Staff,0,3,16,16
1745837903784,SIO 295LS,A00,894015,Staff,7,0,25,18
1745837904811,SIO 295S,A00,894020,Staff,7,0,25,18
1745837905841,SIOC 290S,B01,958918,Staff,0,0,0,0
1745837906873,SIOC 291S,B01,958922,Staff,0,0,0,0
1745837907899,SOCI 117,A01,895339,Staff,4,0,5,1
1745837908926,WES 237B,A00,894149,Staff,11,0,20,9
1745837911003,AESE 279B,A00,891859,Staff,13,0,35,22
1745837912029,AIP 197,001,891854,Staff,70,0,70,0
1745837913055,ANTH 289S,A00,891856,Gagneux; Pascal,12,0,12,0
1745837914081,BENG 196,001,957946,Engler; Adam J.,9996,0,9999,3
1745837915108,CAT 124RS,A01,956906,Staff,8,0,25,17
1745837916134,CAT 125RS,A01,922013,Staff,8,0,25,17
1745837917159,CLRE 250,A00,891860,Morris; Sheldon,9995,0,9999,4
1745837919212,CLRE 251R,A00,907817,Mehta; Ravindra L.,9994,0,9999,5
1745837920243,CLRE 252,A00,891864,Cuomo; Raphael Eduardo,9993,0,9999,6
1745837921269,CLRE 253,A00,891867,Vaida; Florin,9994,0,9999,5
1745837921269,CLRE 253,B00,907819,Staff,9999,0,9999,0
1745837922299,CLRE 259,A00,891868,Patel; Hemal,9998,0,9999,1
1745837923325,CLRE 260,A00,891872,Cuomo; Raphael Eduardo,9999,0,9999,0
1745837924353,CLRE 297,001,891888,Cuomo; Raphael Eduardo,9999,0,9999,0
1745837925379,CSE 191,A00,958773,Minnes Kemp; Mor Mia,9999,0,9999,0
1745837926404,CSS 201S,A01,892054,Mignozzetti; Umberto,30,0,30,0
1745837927430,CSS 202S,A01,892056,Mignozzetti; Umberto,30,0,30,0
1745837928455,DSC 197,001,956898,Eldridge; Justin Matthew,9998,0,9999,1
1745837929479,DSC 297,001,958000,Mazumdar; Arya,9998,0,9999,1
1745837930506,EAP 100,A00,905686,Staff,9776,0,9999,223
1745837931534,ECE 45,A01,892618,Staff,0,13,50,50
1745837932564,ECE 109,A01,892620,Staff,0,43,0,0
1745837933591,ECE 111,A01,892719,Staff,0,9,50,50
1745837934619,ECE 197,001,957920,Mercier; Patrick Philip,9992,0,9999,7
1745837935647,ECON 178,A01,907814,Zhu; Ying,28,0,35,7
1745837936677,EDS 115,A00,895312,Staff,41,0,45,4
1745837937703,EDS 117,A01,895337,Staff,30,0,30,0
1745837938728,EDS 125,A00,895341,Jones; Gabrielle Anastasia,43,0,45,2
1745837939754,EDS 128A,A01,895459,Fargason; Sharon Gayle,44,0,45,1
1745837940781,EDS 128B,A01,895543,Pappas; Elizabeth,44,0,45,1
1745837941813,EDS 139,A00,897203,Pappas; Elizabeth,44,0,45,1
1745837941813,EDS 139,B00,897209,Fargason; Sharon Gayle,44,0,45,1
1745837942840,EDS 201,A00,895545,Staff,43,0,45,2
1745837943867,EDS 203,A01,895581,Halter; Christopher P.,43,0,45,2
1745837944893,EDS 204R,A01,895625,Heinzman; Erica M.,43,0,45,2
1745837944893,EDS 204R,B01,895693,Halter; Christopher P.,18,0,45,27
1745837945918,EDS 206R,A00,895694,Fargason; Sharon Gayle,9,0,30,21
1745837945918,EDS 206R,B00,895695,Choi; Bailey Miyeon,20,0,30,10
1745837946945,EDS 250,A00,895697,Hemans; Patricia Ann Benitez,43,0,45,2
1745837947971,EDS 281,A00,895701,Meyerott; Theresa Ann,15,0,15,0
1745837948999,EDS 284,A00,895736,Meyerott; Theresa Ann,15,0,15,0
1745837950025,EDS 286,A00,897210,Fine; Sarah,15,0,15,0
1745837951052,EDS 289C,A01,895770,Daly; Alan J.,15,0,15,0
1745837952079,EDS 290,A00,897211,Hofstetter; Carolyn,15,0,15,0
1745837953108,LIGM 5A,A00,896162,Fischer-Grunski; Eva K,15,0,20,5
1745837954137,LIGM 5B,A00,896260,Fischer-Grunski; Eva K,17,0,20,3
1745837955172,LIGM 5C,A00,896308,Fischer-Grunski; Eva K,18,0,20,2
1745837956202,LIIT 5AS,A00,896313,Carnelos; Chiara,17,0,20,3
1745837957227,LIIT 5BS,A00,896416,Carnelos; Chiara,20,0,20,0
1745837958258,LIIT 5CS,A00,896564,Carnelos; Chiara,20,0,20,0
1745837959283,LISP 5A,A00,896588,Munoz Sanchez; Alicia,4,0,20,16
1745837960314,LISP 5B,A00,896653,Munoz Sanchez; Alicia,10,0,20,10
1745837961344,LISP 5C,A00,896655,Munoz Sanchez; Alicia,4,0,20,16
1745837962372,MAE 197,001,957918,Kleissl; Jan,9998,0,9999,1
1745837963402,MATH 2,A01,957937,Staff,34,0,35,1
1745837964431,MATH 197,001,957876,Kedlaya; Kiran S.,9993,0,9999,6
1745837965457,MCWP 40,A00,892729,Duru; Nur,13,0,20,7
1745837965457,MCWP 40,B00,893304,Montejo; Carolina,20,0,20,0
1745837966484,MCWP 40R,A00,893757,Redela; Pamela Morgan,0,7,20,20
1745837967511,MCWP 50,A00,893758,Morshed; Michael James,2,0,20,18
1745837967511,MCWP 50,B00,893761,Bartulis; Jason Michael,18,0,20,2
1745837968536,MCWP 50R,A00,893766,Compas; Sean Matthew,0,1,20,20
1745837968536,MCWP 50R,B00,893769,Carter; Jennifer A,0,0,20,20
1745837968536,MCWP 50R,C00,893771,Krone; Jarret,0,3,20,20
1745837968536,MCWP 50R,D00,893772,Miller; Elizabeth Deen,3,0,20,17
1745837968536,MCWP 50R,E00,893775,Carter; Andrea L,0,0,20,20
1745837969564,MMW 11R,A01,892721,Herbst; Matthew,11,0,27,16
1745837969564,MMW 11R,A02,892722,Herbst; Matthew,0,0,0,3
1745837970591,MMW 12R,A01,892724,Herbst; Matthew,0,10,16,16
1745837970591,MMW 12R,A02,892725,Herbst; Matthew,0,9,16,16
1745837971616,MMW 13R,A01,892727,Staff,0,3,16,16
1745837971616,MMW 13R,A02,892728,Staff,0,4,16,16
1745837971616,MMW 13R,A03,958032,Staff,0,3,16,16
1745837971616,MMW 13R,A04,958033,Staff,0,2,16,16
1745837971616,MMW 13R,A05,958034,Staff,0,3,16,16
1745837972643,SIO 295LS,A00,894015,Staff,7,0,25,18
1745837973713,SIO 295S,A00,894020,Staff,7,0,25,18
1745837974739,SIOC 290S,B01,958918,Staff,0,0,0,0
1745837975770,SIOC 291S,B01,958922,Staff,0,0,0,0
1745837976799,SOCI 117,A01,895339,Staff,4,0,5,1
1745837977824,WES 237B,A00,894149,Staff,11,0,20,9
1745837979894,AESE 279B,A00,891859,Staff,13,0,35,22
1745837980923,AIP 197,001,891854,Staff,70,0,70,0
1745837981951,ANTH 289S,A00,891856,Gagneux; Pascal,12,0,12,0
1745837982982,BENG 196,001,957946,Engler; Adam J.,9996,0,9999,3
1745837984010,CAT 124RS,A01,956906,Staff,8,0,25,17
1745837985037,CAT 125RS,A01,922013,Staff,8,0,25,17
1745837986068,CLRE 250,A00,891860,Morris; Sheldon,9995,0,9999,4
1745837988134,CLRE 251R,A00,907817,Mehta; Ravindra L.,9994,0,9999,5
1745837989163,CLRE 252,A00,891864,Cuomo; Raphael Eduardo,9993,0,9999,6
1745837990189,CLRE 253,A00,891867,Vaida; Florin,9994,0,9999,5
1745837990189,CLRE 253,B00,907819,Staff,9999,0,9999,0
1745837991217,CLRE 259,A00,891868,Patel; Hemal,9998,0,9999,1
1745837992247,CLRE 260,A00,891872,Cuomo; Raphael Eduardo,9999,0,9999,0
1745837993272,CLRE 297,001,891888,Cuomo; Raphael Eduardo,9999,0,9999,0
1745837994300,CSE 191,A00,958773,Minnes Kemp; Mor Mia,9999,0,9999,0
1745837995324,CSS 201S,A01,892054,Mignozzetti; Umberto,30,0,30,0
1745837996353,CSS 202S,A01,892056,Mignozzetti; Umberto,30,0,30,0
1745837997382,DSC 197,001,956898,Eldridge; Justin Matthew,9998,0,9999,1
1745837998412,DSC 297,001,958000,Mazumdar; Arya,9998,0,9999,1
1745837999437,EAP 100,A00,905686,Staff,9776,0,9999,223
1745838000466,ECE 45,A01,892618,Staff,0,13,50,50
1745838001495,ECE 109,A01,892620,Staff,0,43,0,0
1745838002528,ECE 111,A01,892719,Staff,0,9,50,50
1745838003558,ECE 197,001,957920,Mercier; Patrick Philip,9992,0,9999,7
1745838004589,ECON 178,A01,907814,Zhu; Ying,28,0,35,7
1745838005619,EDS 115,A00,895312,Staff,41,0,45,4
1745838006645,EDS 117,A01,895337,Staff,30,0,30,0
1745838007671,EDS 125,A00,895341,Jones; Gabrielle Anastasia,43,0,45,2
1745838008699,EDS 128A,A01,895459,Fargason; Sharon Gayle,44,0,45,1
1745838009725,EDS 128B,A01,895543,Pappas; Elizabeth,44,0,45,1
1745838010751,EDS 139,A00,897203,Pappas; Elizabeth,44,0,45,1
1745838010751,EDS 139,B00,897209,Fargason; Sharon Gayle,44,0,45,1
1745838011780,EDS 201,A00,895545,Staff,43,0,45,2
1745838012805,EDS 203,A01,895581,Halter; Christopher P.,43,0,45,2
1745838013832,EDS 204R,A01,895625,Heinzman; Erica M.,43,0,45,2
1745838013832,EDS 204R,B01,895693,Halter; Christopher P.,18,0,45,27
1745838014860,EDS 206R,A00,895694,Fargason; Sharon Gayle,9,0,30,21
1745838014860,EDS 206R,B00,895695,Choi; Bailey Miyeon,20,0,30,10
1745838015890,EDS 250,A00,895697,Hemans; Patricia Ann Benitez,43,0,45,2
1745838016916,EDS 281,A00,895701,Meyerott; Theresa Ann,15,0,15,0
1745838017941,EDS 284,A00,895736,Meyerott; Theresa Ann,15,0,15,0
1745838018970,EDS 286,A00,897210,Fine; Sarah,15,0,15,0
1745838020000,EDS 289C,A01,895770,Daly; Alan J.,15,0,15,0
1745838021029,EDS 290,A00,897211,Hofstetter; Carolyn,15,0,15,0
1745838022056,LIGM 5A,A00,896162,Fischer-Grunski; Eva K,15,0,20,5
1745838023082,LIGM 5B,A00,896260,Fischer-Grunski; Eva K,17,0,20,3
1745838024109,LIGM 5C,A00,896308,Fischer-Grunski; Eva K,18,0,20,2
1745838025136,LIIT 5AS,A00,896313,Carnelos; Chiara,17,0,20,3
1745838026166,LIIT 5BS,A00,896416,Carnelos; Chiara,20,0,20,0
1745838027192,LIIT 5CS,A00,896564,Carnelos; Chiara,20,0,20,0
1745838028217,LISP 5A,A00,896588,Munoz Sanchez; Alicia,4,0,20,16
1745838029243,LISP 5B,A00,896653,Munoz Sanchez; Alicia,10,0,20,10
1745838030270,LISP 5C,A00,896655,Munoz Sanchez; Alicia,4,0,20,16
1745838031296,MAE 197,001,957918,Kleissl; Jan,9998,0,9999,1
1745838032324,MATH 2,A01,957937,Staff,34,0,35,1
1745838033352,MATH 197,001,957876,Kedlaya; Kiran S.,9993,0,9999,6
1745838034378,MCWP 40,A00,892729,Duru; Nur,13,0,20,7
1745838034378,MCWP 40,B00,893304,Montejo; Carolina,20,0,20,0
1745838035404,MCWP 40R,A00,893757,Redela; Pamela Morgan,0,7,20,20
1745838036433,MCWP 50,A00,893758,Morshed; Michael James,2,0,20,18
1745838036433,MCWP 50,B00,893761,Bartulis; Jason Michael,18,0,20,2
1745838037468,MCWP 50R,A00,893766,Compas; Sean Matthew,0,1,20,20
1745838037468,MCWP 50R,B00,893769,Carter; Jennifer A,0,0,20,20
1745838037468,MCWP 50R,C00,893771,Krone; Jarret,0,3,20,20
1745838037468,MCWP 50R,D00,893772,Miller; Elizabeth Deen,3,0,20,17
1745838037468,MCWP 50R,E00,893775,Carter; Andrea L,0,0,20,20
1745838038494,MMW 11R,A01,892721,Herbst; Matthew,11,0,27,16
1745838038494,MMW 11R,A02,892722,Herbst; Matthew,0,0,0,3
1745838039523,MMW 12R,A01,892724,Herbst; Matthew,0,10,16,16
1745838039523,MMW 12R,A02,892725,Herbst; Matthew,0,9,16,16
1745838040552,MMW 13R,A01,892727,Staff,0,3,16,16
1745838040552,MMW 13R,A02,892728,Staff,0,4,16,16
1745838040552,MMW 13R,A03,958032,Staff,0,3,16,16
1745838040552,MMW 13R,A04,958033,Staff,0,2,16,16
1745838040552,MMW 13R,A05,958034,Staff,0,3,16,16
1745838041583,SIO 295LS,A00,894015,Staff,7,0,25,18
1745838042608,SIO 295S,A00,894020,Staff,7,0,25,18
1745838043637,SIOC 290S,B01,958918,Staff,0,0,0,0
1745838044670,SIOC 291S,B01,958922,Staff,0,0,0,0
1745838045697,SOCI 117,A01,895339,Staff,4,0,5,1
1745838046722,WES 237B,A00,894149,Staff,11,0,20,9
1745838048790,AESE 279B,A00,891859,Staff,13,0,35,22
1745838049816,AIP 197,001,891854,Staff,70,0,70,0
1745838050844,ANTH 289S,A00,891856,Gagneux; Pascal,12,0,12,0
1745838051872,BENG 196,001,957946,Engler; Adam J.,9996,0,9999,3
1745838052902,CAT 124RS,A01,956906,Staff,8,0,25,17
1745838053929,CAT 125RS,A01,922013,Staff,8,0,25,17
1745838054954,CLRE 250,A00,891860,Morris; Sheldon,9995,0,9999,4
1745838057010,CLRE 251R,A00,907817,Mehta; Ravindra L.,9994,0,9999,5
1745838058036,CLRE 252,A00,891864,Cuomo; Raphael Eduardo,9993,0,9999,6
1745838059062,CLRE 253,A00,891867,Vaida; Florin,9994,0,9999,5
1745838059062,CLRE 253,B00,907819,Staff,9999,0,9999,0
1745838060093,CLRE 259,A00,891868,Patel; Hemal,9998,0,9999,1
1745838061118,CLRE 260,A00,891872,Cuomo; Raphael Eduardo,9999,0,9999,0
1745838062151,CLRE 297,001,891888,Cuomo; Raphael Eduardo,9999,0,9999,0
1745838063178,CSE 191,A00,958773,Minnes Kemp; Mor Mia,9999,0,9999,0
1745838064205,CSS 201S,A01,892054,Mignozzetti; Umberto,30,0,30,0
1745838065235,CSS 202S,A01,892056,Mignozzetti; Umberto,30,0,30,0
1745838066263,DSC 197,001,956898,Eldridge; Justin Matthew,9998,0,9999,1
1745838067290,DSC 297,001,958000,Mazumdar; Arya,9998,0,9999,1
1745838068315,EAP 100,A00,905686,Staff,9776,0,9999,223
1745838069340,ECE 45,A01,892618,Staff,0,13,50,50
1745838070367,ECE 109,A01,892620,Staff,0,43,0,0
1745838071393,ECE 111,A01,892719,Staff,0,9,50,50
1745838072419,ECE 197,001,957920,Mercier; Patrick Philip,9992,0,9999,7
1745838073447,ECON 178,A01,907814,Zhu; Ying,28,0,35,7
1745838074474,EDS 115,A00,895312,Staff,41,0,45,4
1745838075502,EDS 117,A01,895337,Staff,30,0,30,0
1745838076533,EDS 125,A00,895341,Jones; Gabrielle Anastasia,43,0,45,2
1745838077560,EDS 128A,A01,895459,Fargason; Sharon Gayle,44,0,45,1
1745838078590,EDS 128B,A01,895543,Pappas; Elizabeth,44,0,45,1
1745838079615,EDS 139,A00,897203,Pappas; Elizabeth,44,0,45,1
1745838079615,EDS 139,B00,897209,Fargason; Sharon Gayle,44,0,45,1
1745838080645,EDS 201,A00,895545,Staff,43,0,45,2
1745838081674,EDS 203,A01,895581,Halter; Christopher P.,43,0,45,2
1745838082704,EDS 204R,A01,895625,Heinzman; Erica M.,43,0,45,2
1745838082704,EDS 204R,B01,895693,Halter; Christopher P.,18,0,45,27
1745838083735,EDS 206R,A00,895694,Fargason; Sharon Gayle,9,0,30,21
1745838083735,EDS 206R,B00,895695,Choi; Bailey Miyeon,20,0,30,10
1745838084766,EDS 250,A00,895697,Hemans; Patricia Ann Benitez,43,0,45,2
1745838085793,EDS 281,A00,895701,Meyerott; Theresa Ann,15,0,15,0
1745838086820,EDS 284,A00,895736,Meyerott; Theresa Ann,15,0,15,0
1745838087845,EDS 286,A00,897210,Fine; Sarah,15,0,15,0
1745838088871,EDS 289C,A01,895770,Daly; Alan J.,15,0,15,0
1745838089902,EDS 290,A00,897211,Hofstetter; Carolyn,15,0,15,0
1745838090931,LIGM 5A,A00,896162,Fischer-Grunski; Eva K,15,0,20,5
1745838091958,LIGM 5B,A00,896260,Fischer-Grunski; Eva K,17,0,20,3
1745838092989,LIGM 5C,A00,896308,Fischer-Grunski; Eva K,18,0,20,2
1745838094019,LIIT 5AS,A00,896313,Carnelos; Chiara,17,0,20,3
1745838095053,LIIT 5BS,A00,896416,Carnelos; Chiara,20,0,20,0
1745838096079,LIIT 5CS,A00,896564,Carnelos; Chiara,20,0,20,0
1745838097110,LISP 5A,A00,896588,Munoz Sanchez; Alicia,4,0,20,16
1745838098141,LISP 5B,A00,896653,Munoz Sanchez; Alicia,10,0,20,10
1745838099169,LISP 5C,A00,896655,Munoz Sanchez; Alicia,4,0,20,16
1745838100195,MAE 197,001,957918,Kleissl; Jan,9998,0,9999,1
1745838101226,MATH 2,A01,957937,Staff,34,0,35,1
1745838102255,MATH 197,001,957876,Kedlaya; Kiran S.,9993,0,9999,6
1745838103282,MCWP 40,A00,892729,Duru; Nur,13,0,20,7
1745838103282,MCWP 40,B00,893304,Montejo; Carolina,20,0,20,0
1745838104309,MCWP 40R,A00,893757,Redela; Pamela Morgan,0,7,20,20
1745838105339,MCWP 50,A00,893758,Morshed; Michael James,2,0,20,18
1745838105339,MCWP 50,B00,893761,Bartulis; Jason Michael,18,0,20,2
1745838106365,MCWP 50R,A00,893766,Compas; Sean Matthew,0,1,20,20
1745838106365,MCWP 50R,B00,893769,Carter; Jennifer A,0,0,20,20
1745838106365,MCWP 50R,C00,893771,Krone; Jarret,0,3,20,20
1745838106365,MCWP 50R,D00,893772,Miller; Elizabeth Deen,3,0,20,17
1745838106365,MCWP 50R,E00,893775,Carter; Andrea L,0,0,20,20
1745838107395,MMW 11R,A01,892721,Herbst; Matthew,11,0,27,16
1745838107395,MMW 11R,A02,892722,Herbst; Matthew,0,0,0,3
1745838108425,MMW 12R,A01,892724,Herbst; Matthew,0,10,16,16
1745838108425,MMW 12R,A02,892725,Herbst; Matthew,0,9,16,16
1745838109451,MMW 13R,A01,892727,Staff,0,3,16,16
1745838109451,MMW 13R,A02,892728,Staff,0,4,16,16
1745838109451,MMW 13R,A03,958032,Staff,0,3,16,16
1745838109451,MMW 13R,A04,958033,Staff,0,2,16,16
1745838109451,MMW 13R,A05,958034,Staff,0,3,16,16
1745838110477,SIO 295LS,A00,894015,Staff,7,0,25,18
1745838111506,SIO 295S,A00,894020,Staff,7,0,25,18
1745838112536,SIOC 290S,B01,958918,Staff,0,0,0,0
1745838113567,SIOC 291S,B01,958922,Staff,0,0,0,0
1745838114596,SOCI 117,A01,895339,Staff,4,0,5,1
1745838115625,WES 237B,A00,894149,Staff,11,0,20,9
1745838117702,AESE 279B,A00,891859,Staff,13,0,35,22
1745838118726,AIP 197,001,891854,Staff,70,0,70,0
1745838119752,ANTH 289S,A00,891856,Gagneux; Pascal,12,0,12,0
1745838120781,BENG 196,001,957946,Engler; Adam J.,9996,0,9999,3
1745838121808,CAT 124RS,A01,956906,Staff,8,0,25,17
1745838122835,CAT 125RS,A01,922013,Staff,8,0,25,17
1745838123862,CLRE 250,A00,891860,Morris; Sheldon,9995,0,9999,4
1745838125918,CLRE 251R,A00,907817,Mehta; Ravindra L.,9994,0,9999,5
1745838126947,CLRE 252,A00,891864,Cuomo; Raphael Eduardo,9993,0,9999,6
1745838127974,CLRE 253,A00,891867,Vaida; Florin,9994,0,9999,5
1745838127974,CLRE 253,B00,907819,Staff,9999,0,9999,0
1745838129000,CLRE 259,A00,891868,Patel; Hemal,9998,0,9999,1
1745838130026,CLRE 260,A00,891872,Cuomo; Raphael Eduardo,9999,0,9999,0
1745838131050,CLRE 297,001,891888,Cuomo; Raphael Eduardo,9999,0,9999,0
1745838132079,CSE 191,A00,958773,Minnes Kemp; Mor Mia,9999,0,9999,0
1745838133104,CSS 201S,A01,892054,Mignozzetti; Umberto,30,0,30,0
1745838134133,CSS 202S,A01,892056,Mignozzetti; Umberto,30,0,30,0
1745838135159,DSC 197,001,956898,Eldridge; Justin Matthew,9998,0,9999,1
1745838136186,DSC 297,001,958000,Mazumdar; Arya,9998,0,9999,1
1745838137211,EAP 100,A00,905686,Staff,9776,0,9999,223
1745838138254,ECE 45,A01,892618,Staff,0,13,50,50
1745838139282,ECE 109,A01,892620,Staff,0,43,0,0
1745838140311,ECE 111,A01,892719,Staff,0,9,50,50
1745838141335,ECE 197,001,957920,Mercier; Patrick Philip,9992,0,9999,7
1745838142367,ECON 178,A01,907814,Zhu; Ying,28,0,35,7
1745838143395,EDS 115,A00,895312,Staff,41,0,45,4
1745838144419,EDS 117,A01,895337,Staff,30,0,30,0
1745838145446,EDS 125,A00,895341,Jones; Gabrielle Anastasia,43,0,45,2
1745838146480,EDS 128A,A01,895459,Fargason; Sharon Gayle,44,0,45,1
1745838147506,EDS 128B,A01,895543,Pappas; Elizabeth,44,0,45,1
1745838148532,EDS 139,A00,897203,Pappas; Elizabeth,44,0,45,1
1745838148532,EDS 139,B00,897209,Fargason; Sharon Gayle,44,0,45,1
1745838149558,EDS 201,A00,895545,Staff,43,0,45,2
1745838150584,EDS 203,A01,895581,Halter; Christopher P.,43,0,45,2
1745838151611,EDS 204R,A01,895625,Heinzman; Erica M.,43,0,45,2
1745838151611,EDS 204R,B01,895693,Halter; Christopher P.,18,0,45,27
1745838152647,EDS 206R,A00,895694,Fargason; Sharon Gayle,9,0,30,21
1745838152647,EDS 206R,B00,895695,Choi; Bailey Miyeon,20,0,30,10
1745838153677,EDS 250,A00,895697,Hemans; Patricia Ann Benitez,43,0,45,2
1745838154711,EDS 281,A00,895701,Meyerott; Theresa Ann,15,0,15,0
1745838155740,EDS 284,A00,895736,Meyerott; Theresa Ann,15,0,15,0
1745838156767,EDS 286,A00,897210,Fine; Sarah,15,0,15,0
1745838157793,EDS 289C,A01,895770,Daly; Alan J.,15,0,15,0
1745838158824,EDS 290,A00,897211,Hofstetter; Carolyn,15,0,15,0
1745838159851,LIGM 5A,A00,896162,Fischer-Grunski; Eva K,15,0,20,5
1745838160883,LIGM 5B,A00,896260,Fischer-Grunski; Eva K,17,0,20,3
1745838161911,LIGM 5C,A00,896308,Fischer-Grunski; Eva K,18,0,20,2
1745838162935,LIIT 5AS,A00,896313,Carnelos; Chiara,17,0,20,3
1745838163962,LIIT 5BS,A00,896416,Carnelos; Chiara,20,0,20,0
1745838164987,LIIT 5CS,A00,896564,Carnelos; Chiara,20,0,20,0
1745838166013,LISP 5A,A00,896588,Munoz Sanchez; Alicia,4,0,20,16
1745838167038,LISP 5B,A00,896653,Munoz Sanchez; Alicia,10,0,20,10
1745838168064,LISP 5C,A00,896655,Munoz Sanchez; Alicia,4,0,20,16
1745838169094,MAE 197,001,957918,Kleissl; Jan,9998,0,9999,1
1745838170124,MATH 2,A01,957937,Staff,34,0,35,1
1745838171147,MATH 197,001,957876,Kedlaya; Kiran S.,9993,0,9999,6
1745838172178,MCWP 40,A00,892729,Duru; Nur,13,0,20,7
1745838172178,MCWP 40,B00,893304,Montejo; Carolina,20,0,20,0
1745838173205,MCWP 40R,A00,893757,Redela; Pamela Morgan,0,7,20,20
1745838174237,MCWP 50,A00,893758,Morshed; Michael James,2,0,20,18
1745838174237,MCWP 50,B00,893761,Bartulis; Jason Michael,18,0,20,2
1745838175276,MCWP 50R,A00,893766,Compas; Sean Matthew,0,1,20,20
1745838175276,MCWP 50R,B00,893769,Carter; Jennifer A,0,0,20,20
1745838175276,MCWP 50R,C00,893771,Krone; Jarret,0,3,20,20
1745838175276,MCWP 50R,D00,893772,Miller; Elizabeth Deen,3,0,20,17
1745838175276,MCWP 50R,E00,893775,Carter; Andrea L,0,0,20,20
1745838176309,MMW 11R,A01,892721,Herbst; Matthew,11,0,27,16
1745838176309,MMW 11R,A02,892722,Herbst; Matthew,0,0,0,3
1745838177337,MMW 12R,A01,892724,Herbst; Matthew,0,10,16,16
1745838177337,MMW 12R,A02,892725,Herbst; Matthew,0,9,16,16
1745838178366,MMW 13R,A01,892727,Staff,0,3,16,16
1745838178366,MMW 13R,A02,892728,Staff,0,4,16,16
1745838178366,MMW 13R,A03,958032,Staff,0,3,16,16
1745838178366,MMW 13R,A04,958033,Staff,0,2,16,16
1745838178366,MMW 13R,A05,958034,Staff,0,3,16,16
1745838179393,SIO 295LS,A00,894015,Staff,7,0,25,18
1745838180420,SIO 295S,A00,894020,Staff,7,0,25,18
1745838181455,SIOC 290S,B01,958918,Staff,0,0,0,0
1745838182484,SIOC 291S,B01,958922,Staff,0,0,0,0
1745838183515,SOCI 117,A01,895339,Staff,4,0,5,1
1745838184539,WES 237B,A00,894149,Staff,11,0,20,9
1745838186622,AESE 279B,A00,891859,Staff,13,0,35,22
1745838187649,AIP 197,001,891854,Staff,70,0,70,0
1745838188678,ANTH 289S,A00,891856,Gagneux; Pascal,12,0,12,0
1745838189727,BENG 196,001,957946,Engler; Adam J.,9996,0,9999,3
1745838190752,CAT 124RS,A01,956906,Staff,8,0,25,17
1745838191778,CAT 125RS,A01,922013,Staff,8,0,25,17
1745838192806,CLRE 250,A00,891860,Morris; Sheldon,9995,0,9999,4
1745838194856,CLRE 251R,A00,907817,Mehta; Ravindra L.,9994,0,9999,5
1745838195880,CLRE 252,A00,891864,Cuomo; Raphael Eduardo,9993,0,9999,6
1745838196906,CLRE 253,A00,891867,Vaida; Florin,9994,0,9999,5
1745838196906,CLRE 253,B00,907819,Staff,9999,0,9999,0
1745838197935,CLRE 259,A00,891868,Patel; Hemal,9998,0,9999,1
1745838198964,CLRE 260,A00,891872,Cuomo; Raphael Eduardo,9999,0,9999,0
1745838199992,CLRE 297,001,891888,Cuomo; Raphael Eduardo,9999,0,9999,0
1745838201021,CSE 191,A00,958773,Minnes Kemp; Mor Mia,9999,0,9999,0
1745838202054,CSS 201S,A01,892054,Mignozzetti; Umberto,30,0,30,0
1745838203080,CSS 202S,A01,892056,Mignozzetti; Umberto,30,0,30,0
1745838204107,DSC 197,001,956898,Eldridge; Justin Matthew,9998,0,9999,1
1745838205137,DSC 297,001,958000,Mazumdar; Arya,9998,0,9999,1
1745838206162,EAP 100,A00,905686,Staff,9776,0,9999,223
1745838207193,ECE 45,A01,892618,Staff,0,13,50,50
1745838208222,ECE 109,A01,892620,Staff,0,43,0,0
1745838209248,ECE 111,A01,892719,Staff,0,9,50,50
1745838210272,ECE 197,001,957920,Mercier; Patrick Philip,9992,0,9999,7
1745838211300,ECON 178,A01,907814,Zhu; Ying,28,0,35,7
1745838212332,EDS 115,A00,895312,Staff,41,0,45,4
1745838213362,EDS 117,A01,895337,Staff,30,0,30,0
1745838214392,EDS 125,A00,895341,Jones; Gabrielle Anastasia,43,0,45,2
1745838215418,EDS 128A,A01,895459,Fargason; Sharon Gayle,44,0,45,1
1745838216449,EDS 128B,A01,895543,Pappas; Elizabeth,44,0,45,1
1745838217480,EDS 139,A00,897203,Pappas; Elizabeth,44,0,45,1
1745838217480,EDS 139,B00,897209,Fargason; Sharon Gayle,44,0,45,1
1745838218504,EDS 201,A00,895545,Staff,43,0,45,2
1745838219534,EDS 203,A01,895581,Halter; Christopher P.,43,0,45,2
1745838220566,EDS 204R,A01,895625,Heinzman; Erica M.,43,0,45,2
1745838220566,EDS 204R,B01,895693,Halter; Christopher P.,18,0,45,27
1745838221596,EDS 206R,A00,895694,Fargason; Sharon Gayle,9,0,30,21
1745838221596,EDS 206R,B00,895695,Choi; Bailey Miyeon,20,0,30,10
1745838222623,EDS 250,A00,895697,Hemans; Patricia Ann Benitez,43,0,45,2
1745838223651,EDS 281,A00,895701,Meyerott; Theresa Ann,15,0,15,0
1745838224717,EDS 284,A00,895736,Meyerott; Theresa Ann,15,0,15,0
1745838225745,EDS 286,A00,897210,Fine; Sarah,15,0,15,0
1745838226772,EDS 289C,A01,895770,Daly; Alan J.,15,0,15,0
1745838227803,EDS 290,A00,897211,Hofstetter; Carolyn,15,0,15,0
1745838228832,LIGM 5A,A00,896162,Fischer-Grunski; Eva K,15,0,20,5
1745838229864,LIGM 5B,A00,896260,Fischer-Grunski; Eva K,17,0,20,3
1745838230895,LIGM 5C,A00,896308,Fischer-Grunski; Eva K,18,0,20,2
1745838231921,LIIT 5AS,A00,896313,Carnelos; Chiara,17,0,20,3
1745838232949,LIIT 5BS,A00,896416,Carnelos; Chiara,20,0,20,0
1745838233976,LIIT 5CS,A00,896564,Carnelos; Chiara,20,0,20,0
1745838235013,LISP 5A,A00,896588,Munoz Sanchez; Alicia,4,0,20,16
1745838236046,LISP 5B,A00,896653,Munoz Sanchez; Alicia,10,0,20,10
1745838237076,LISP 5C,A00,896655,Munoz Sanchez; Alicia,4,0,20,16
1745838238309,MAE 197,001,957918,Kleissl; Jan,9998,0,9999,1
1745838239336,MATH 2,A01,957937,Staff,34,0,35,1
1745838240363,MATH 197,001,957876,Kedlaya; Kiran S.,9993,0,9999,6
1745838241395,MCWP 40,A00,892729,Duru; Nur,13,0,20,7
1745838241395,MCWP 40,B00,893304,Montejo; Carolina,20,0,20,0
1745838242423,MCWP 40R,A00,893757,Redela; Pamela Morgan,0,7,20,20
1745838243450,MCWP 50,A00,893758,Morshed; Michael James,2,0,20,18
1745838243450,MCWP 50,B00,893761,Bartulis; Jason Michael,18,0,20,2
1745838244476,MCWP 50R,A00,893766,Compas; Sean Matthew,0,1,20,20
1745838244476,MCWP 50R,B00,893769,Carter; Jennifer A,0,0,20,20
1745838244476,MCWP 50R,C00,893771,Krone; Jarret,0,3,20,20
1745838244476,MCWP 50R,D00,893772,Miller; Elizabeth Deen,3,0,20,17
1745838244476,MCWP 50R,E00,893775,Carter; Andrea L,0,0,20,20
1745838245510,MMW 11R,A01,892721,Herbst; Matthew,11,0,27,16
1745838245510,MMW 11R,A02,892722,Herbst; Matthew,0,0,0,3
1745838246538,MMW 12R,A01,892724,Herbst; Matthew,0,10,16,16
1745838246538,MMW 12R,A02,892725,Herbst; Matthew,0,9,16,16
1745838247568,MMW 13R,A01,892727,Staff,0,3,16,16
1745838247568,MMW 13R,A02,892728,Staff,0,4,16,16
1745838247568,MMW 13R,A03,958032,Staff,0,3,16,16
1745838247568,MMW 13R,A04,958033,Staff,0,2,16,16
1745838247568,MMW 13R,A05,958034,Staff,0,3,16,16
1745838248598,SIO 295LS,A00,894015,Staff,7,0,25,18
1745838249625,SIO 295S,A00,894020,Staff,7,0,25,18
1745838250653,SIOC 290S,B01,958918,Staff,0,0,0,0
1745838251682,SIOC 291S,B01,958922,Staff,0,0,0,0
1745838252713,SOCI 117,A01,895339,Staff,4,0,5,1
1745838253739,WES 237B,A00,894149,Staff,11,0,20,9
1745838255873,AESE 279B,A00,891859,Staff,13,0,35,22
1745838256899,AIP 197,001,891854,Staff,70,0,70,0
1745838257925,ANTH 289S,A00,891856,Gagneux; Pascal,12,0,12,0
1745838258952,BENG 196,001,957946,Engler; Adam J.,9996,0,9999,3
1745838259982,CAT 124RS,A01,956906,Staff,8,0,25,17
1745838261010,CAT 125RS,A01,922013,Staff,8,0,25,17
1745838262038,CLRE 250,A00,891860,Morris; Sheldon,9995,0,9999,4
1745838264106,CLRE 251R,A00,907817,Mehta; Ravindra L.,9994,0,9999,5
1745838265132,CLRE 252,A00,891864,Cuomo; Raphael Eduardo,9993,0,9999,6
1745838266160,CLRE 253,A00,891867,Vaida; Florin,9994,0,9999,5
1745838266160,CLRE 253,B00,907819,Staff,9999,0,9999,0
1745838267189,CLRE 259,A00,891868,Patel; Hemal,9998,0,9999,1
1745838268216,CLRE 260,A00,891872,Cuomo; Raphael Eduardo,9999,0,9999,0
1745838269245,CLRE 297,001,891888,Cuomo; Raphael Eduardo,9999,0,9999,0
1745838270278,CSE 191,A00,958773,Minnes Kemp; Mor Mia,9999,0,9999,0
1745838271307,CSS 201S,A01,892054,Mignozzetti; Umberto,30,0,30,0
1745838272335,CSS 202S,A01,892056,Mignozzetti; Umberto,30,0,30,0
1745838273367,DSC 197,001,956898,Eldridge; Justin Matthew,9998,0,9999,1
1745838274394,DSC 297,001,958000,Mazumdar; Arya,9998,0,9999,1
1745838275423,EAP 100,A00,905686,Staff,9776,0,9999,223
1745838276453,ECE 45,A01,892618,Staff,0,13,50,50
1745838277483,ECE 109,A01,892620,Staff,0,43,0,0
1745838278510,ECE 111,A01,892719,Staff,0,9,50,50
1745838279542,ECE 197,001,957920,Mercier; Patrick Philip,9992,0,9999,7
1745838280569,ECON 178,A01,907814,Zhu; Ying,28,0,35,7
1745838281598,EDS 115,A00,895312,Staff,41,0,45,4
1745838282624,EDS 117,A01,895337,Staff,30,0,30,0
1745838283655,EDS 125,A00,895341,Jones; Gabrielle Anastasia,43,0,45,2
1745838284709,EDS 128A,A01,895459,Fargason; Sharon Gayle,44,0,45,1
1745838285737,EDS 128B,A01,895543,Pappas; Elizabeth,44,0,45,1
1745838286768,EDS 139,A00,897203,Pappas; Elizabeth,44,0,45,1
1745838286768,EDS 139,B00,897209,Fargason; Sharon Gayle,44,0,45,1
1745838287795,EDS 201,A00,895545,Staff,43,0,45,2
1745838288821,EDS 203,A01,895581,Halter; Christopher P.,43,0,45,2
1745838289855,EDS 204R,A01,895625,Heinzman; Erica M.,43,0,45,2
1745838289855,EDS 204R,B01,895693,Halter; Christopher P.,18,0,45,27
1745838290884,EDS 206R,A00,895694,Fargason; Sharon Gayle,9,0,30,21
1745838290884,EDS 206R,B00,895695,Choi; Bailey Miyeon,20,0,30,10
1745838291910,EDS 250,A00,895697,Hemans; Patricia Ann Benitez,43,0,45,2
1745838292941,EDS 281,A00,895701,Meyerott; Theresa Ann,15,0,15,0
1745838293972,EDS 284,A00,895736,Meyerott; Theresa Ann,15,0,15,0
1745838294999,EDS 286,A00,897210,Fine; Sarah,15,0,15,0
1745838296028,EDS 289C,A01,895770,Daly; Alan J.,15,0,15,0
1745838297056,EDS 290,A00,897211,Hofstetter; Carolyn,15,0,15,0
1745838298090,LIGM 5A,A00,896162,Fischer-Grunski; Eva K,15,0,20,5
1745838299116,LIGM 5B,A00,896260,Fischer-Grunski; Eva K,17,0,20,3
1745838300145,LIGM 5C,A00,896308,Fischer-Grunski; Eva K,18,0,20,2
1745838301172,LIIT 5AS,A00,896313,Carnelos; Chiara,17,0,20,3
1745838302207,LIIT 5BS,A00,896416,Carnelos; Chiara,20,0,20,0
1745838303234,LIIT 5CS,A00,896564,Carnelos; Chiara,20,0,20,0
1745838304265,LISP 5A,A00,896588,Munoz Sanchez; Alicia,4,0,20,16
1745838305296,LISP 5B,A00,896653,Munoz Sanchez; Alicia,10,0,20,10
1745838306322,LISP 5C,A00,896655,Munoz Sanchez; Alicia,4,0,20,16
1745838307356,MAE 197,001,957918,Kleissl; Jan,9998,0,9999,1
1745838308400,MATH 2,A01,957937,Staff,34,0,35,1
1745838309432,MATH 197,001,957876,Kedlaya; Kiran S.,9993,0,9999,6
1745838310460,MCWP 40,A00,892729,Duru; Nur,13,0,20,7
1745838310460,MCWP 40,B00,893304,Montejo; Carolina,20,0,20,0
1745838311494,MCWP 40R,A00,893757,Redela; Pamela Morgan,0,7,20,20
1745838312526,MCWP 50,A00,893758,Morshed; Michael James,2,0,20,18
1745838312526,MCWP 50,B00,893761,Bartulis; Jason Michael,18,0,20,2
1745838313554,MCWP 50R,A00,893766,Compas; Sean Matthew,0,1,20,20
1745838313554,MCWP 50R,B00,893769,Carter; Jennifer A,0,0,20,20
1745838313554,MCWP 50R,C00,893771,Krone; Jarret,0,3,20,20
1745838313554,MCWP 50R,D00,893772,Miller; Elizabeth Deen,3,0,20,17
1745838313554,MCWP 50R,E00,893775,Carter; Andrea L,0,0,20,20
1745838314582,MMW 11R,A01,892721,Herbst; Matthew,11,0,27,16
1745838314582,MMW 11R,A02,892722,Herbst; Matthew,0,0,0,3
1745838315608,MMW 12R,A01,892724,Herbst; Matthew,0,10,16,16
1745838315608,MMW 12R,A02,892725,Herbst; Matthew,0,9,16,16
1745838316635,MMW 13R,A01,892727,Staff,0,3,16,16
1745838316635,MMW 13R,A02,892728,Staff,0,4,16,16
1745838316635,MMW 13R,A03,958032,Staff,0,3,16,16
1745838316635,MMW 13R,A04,958033,Staff,0,2,16,16
1745838316635,MMW 13R,A05,958034,Staff,0,3,16,16
1745838317663,SIO 295LS,A00,894015,Staff,7,0,25,18
1745838318690,SIO 295S,A00,894020,Staff,7,0,25,18
1745838319719,SIOC 290S,B01,958918,Staff,0,0,0,0
1745838320749,SIOC 291S,B01,958922,Staff,0,0,0,0
1745838321776,SOCI 117,A01,895339,Staff,4,0,5,1
1745838322802,WES 237B,A00,894149,Staff,11,0,20,9
1745838324882,AESE 279B,A00,891859,Staff,13,0,35,22
1745838325909,AIP 197,001,891854,Staff,70,0,70,0
1745838326937,ANTH 289S,A00,891856,Gagneux; Pascal,12,0,12,0
1745838327965,BENG 196,001,957946,Engler; Adam J.,9996,0,9999,3
1745838328995,CAT 124RS,A01,956906,Staff,8,0,25,17
1745838330023,CAT 125RS,A01,922013,Staff,8,0,25,17
1745838331050,CLRE 250,A00,891860,Morris; Sheldon,9995,0,9999,4
1745838333106,CLRE 251R,A00,907817,Mehta; Ravindra L.,9994,0,9999,5
1745838334135,CLRE 252,A00,891864,Cuomo; Raphael Eduardo,9993,0,9999,6
1745838335166,CLRE 253,A00,891867,Vaida; Florin,9994,0,9999,5
1745838335166,CLRE 253,B00,907819,Staff,9999,0,9999,0
1745838336193,CLRE 259,A00,891868,Patel; Hemal,9998,0,9999,1
1745838337223,CLRE 260,A00,891872,Cuomo; Raphael Eduardo,9999,0,9999,0
1745838338254,CLRE 297,001,891888,Cuomo; Raphael Eduardo,9999,0,9999,0
1745838339284,CSE 191,A00,958773,Minnes Kemp; Mor Mia,9999,0,9999,0
1745838340314,CSS 201S,A01,892054,Mignozzetti; Umberto,30,0,30,0
1745838341342,CSS 202S,A01,892056,Mignozzetti; Umberto,30,0,30,0
1745838342370,DSC 197,001,956898,Eldridge; Justin Matthew,9998,0,9999,1
1745838343398,DSC 297,001,958000,Mazumdar; Arya,9998,0,9999,1
1745838344423,EAP 100,A00,905686,Staff,9776,0,9999,223
1745838345453,ECE 45,A01,892618,Staff,0,13,50,50
1745838346482,ECE 109,A01,892620,Staff,0,43,0,0
1745838347509,ECE 111,A01,892719,Staff,0,9,50,50
1745838348535,ECE 197,001,957920,Mercier; Patrick Philip,9992,0,9999,7
1745838349566,ECON 178,A01,907814,Zhu; Ying,28,0,35,7
1745838350593,EDS 115,A00,895312,Staff,41,0,45,4
1745838351622,EDS 117,A01,895337,Staff,30,0,30,0
1745838352651,EDS 125,A00,895341,Jones; Gabrielle Anastasia,43,0,45,2
1745838353680,EDS 128A,A01,895459,Fargason; Sharon Gayle,44,0,45,1
1745838354708,EDS 128B,A01,895543,Pappas; Elizabeth,44,0,45,1
1745838355734,EDS 139,A00,897203,Pappas; Elizabeth,44,0,45,1
1745838355734,EDS 139,B00,897209,Fargason; Sharon Gayle,44,0,45,1
1745838356762,EDS 201,A00,895545,Staff,43,0,45,2
1745838357789,EDS 203,A01,895581,Halter; Christopher P.,43,0,45,2
1745838358820,EDS 204R,A01,895625,Heinzman; Erica M.,43,0,45,2
1745838358820,EDS 204R,B01,895693,Halter; Christopher P.,18,0,45,27
1745838359850,EDS 206R,A00,895694,Fargason; Sharon Gayle,9,0,30,21
1745838359850,EDS 206R,B00,895695,Choi; Bailey Miyeon,20,0,30,10
1745838360881,EDS 250,A00,895697,Hemans; Patricia Ann Benitez,43,0,45,2
1745838361911,EDS 281,A00,895701,Meyerott; Theresa Ann,15,0,15,0
1745838362941,EDS 284,A00,895736,Meyerott; Theresa Ann,15,0,15,0
1745838363969,EDS 286,A00,897210,Fine; Sarah,15,0,15,0
1745838364995,EDS 289C,A01,895770,Daly; Alan J.,15,0,15,0
1745838366026,EDS 290,A00,897211,Hofstetter; Carolyn,15,0,15,0
1745838367060,LIGM 5A,A00,896162,Fischer-Grunski; Eva K,15,0,20,5
1745838368087,LIGM 5B,A00,896260,Fischer-Grunski; Eva K,17,0,20,3
1745838369114,LIGM 5C,A00,896308,Fischer-Grunski; Eva K,18,0,20,2
1745838370143,LIIT 5AS,A00,896313,Carnelos; Chiara,17,0,20,3
1745838371174,LIIT 5BS,A00,896416,Carnelos; Chiara,20,0,20,0
1745838372201,LIIT 5CS,A00,896564,Carnelos; Chiara,20,0,20,0
1745838373229,LISP 5A,A00,896588,Munoz Sanchez; Alicia,4,0,20,16
1745838374261,LISP 5B,A00,896653,Munoz Sanchez; Alicia,10,0,20,10
1745838375286,LISP 5C,A00,896655,Munoz Sanchez; Alicia,4,0,20,16
1745838376313,MAE 197,001,957918,Kleissl; Jan,9998,0,9999,1
1745838377341,MATH 2,A01,957937,Staff,34,0,35,1
1745838378369,MATH 197,001,957876,Kedlaya; Kiran S.,9993,0,9999,6
1745838379398,MCWP 40,A00,892729,Duru; Nur,13,0,20,7
1745838379398,MCWP 40,B00,893304,Montejo; Carolina,20,0,20,0
1745838380423,MCWP 40R,A00,893757,Redela; Pamela Morgan,0,7,20,20
1745838381451,MCWP 50,A00,893758,Morshed; Michael James,2,0,20,18
1745838381451,MCWP 50,B00,893761,Bartulis; Jason Michael,18,0,20,2
1745838382483,MCWP 50R,A00,893766,Compas; Sean Matthew,0,1,20,20
1745838382483,MCWP 50R,B00,893769,Carter; Jennifer A,0,0,20,20
1745838382483,MCWP 50R,C00,893771,Krone; Jarret,0,3,20,20
1745838382483,MCWP 50R,D00,893772,Miller; Elizabeth Deen,3,0,20,17
1745838382483,MCWP 50R,E00,893775,Carter; Andrea L,0,0,20,20
1745838383512,MMW 11R,A01,892721,Herbst; Matthew,11,0,27,16
1745838383512,MMW 11R,A02,892722,Herbst; Matthew,0,0,0,3
1745838384543,MMW 12R,A01,892724,Herbst; Matthew,0,10,16,16
1745838384543,MMW 12R,A02,892725,Herbst; Matthew,0,9,16,16
1745838385570,MMW 13R,A01,892727,Staff,0,3,16,16
1745838385570,MMW 13R,A02,892728,Staff,0,4,16,16
1745838385570,MMW 13R,A03,958032,Staff,0,3,16,16
1745838385570,MMW 13R,A04,958033,Staff,0,2,16,16
1745838385570,MMW 13R,A05,958034,Staff,0,3,16,16
1745838386600,SIO 295LS,A00,894015,Staff,7,0,25,18
1745838387627,SIO 295S,A00,894020,Staff,7,0,25,18
1745838388659,SIOC 290S,B01,958918,Staff,0,0,0,0
1745838389687,SIOC 291S,B01,958922,Staff,0,0,0,0
1745838390721,SOCI 117,A01,895339,Staff,4,0,5,1
1745838391747,WES 237B,A00,894149,Staff,11,0,20,9
1745838393877,AESE 279B,A00,891859,Staff,13,0,35,22
1745838394906,AIP 197,001,891854,Staff,70,0,70,0
1745838395938,ANTH 289S,A00,891856,Gagneux; Pascal,12,0,12,0
1745838396968,BENG 196,001,957946,Engler; Adam J.,9996,0,9999,3
1745838397993,CAT 124RS,A01,956906,Staff,8,0,25,17
1745838399020,CAT 125RS,A01,922013,Staff,8,0,25,17
1745838400052,CLRE 250,A00,891860,Morris; Sheldon,9995,0,9999,4
1745838402111,CLRE 251R,A00,907817,Mehta; Ravindra L.,9994,0,9999,5
1745838403137,CLRE 252,A00,891864,Cuomo; Raphael Eduardo,9993,0,9999,6
1745838404169,CLRE 253,A00,891867,Vaida; Florin,9994,0,9999,5
1745838404169,CLRE 253,B00,907819,Staff,9999,0,9999,0
1745838405194,CLRE 259,A00,891868,Patel; Hemal,9998,0,9999,1
1745838406224,CLRE 260,A00,891872,Cuomo; Raphael Eduardo,9999,0,9999,0
1745838407249,CLRE 297,001,891888,Cuomo; Raphael Eduardo,9999,0,9999,0
1745838408275,CSE 191,A00,958773,Minnes Kemp; Mor Mia,9999,0,9999,0
1745838409302,CSS 201S,A01,892054,Mignozzetti; Umberto,30,0,30,0
1745838410330,CSS 202S,A01,892056,Mignozzetti; Umberto,30,0,30,0
1745838411361,DSC 197,001,956898,Eldridge; Justin Matthew,9998,0,9999,1
1745838412396,DSC 297,001,958000,Mazumdar; Arya,9998,0,9999,1
1745838413423,EAP 100,A00,905686,Staff,9776,0,9999,223
1745838414452,ECE 45,A01,892618,Staff,0,13,50,50
1745838415481,ECE 109,A01,892620,Staff,0,43,0,0
1745838416507,ECE 111,A01,892719,Staff,0,9,50,50
1745838417539,ECE 197,001,957920,Mercier; Patrick Philip,9992,0,9999,7
1745838418571,ECON 178,A01,907814,Zhu; Ying,28,0,35,7
1745838419596,EDS 115,A00,895312,Staff,41,0,45,4
1745838420621,EDS 117,A01,895337,Staff,30,0,30,0
1745838421648,EDS 125,A00,895341,Jones; Gabrielle Anastasia,43,0,45,2
1745838422676,EDS 128A,A01,895459,Fargason; Sharon Gayle,44,0,45,1
1745838423704,EDS 128B,A01,895543,Pappas; Elizabeth,44,0,45,1
1745838424790,EDS 139,A00,897203,Pappas; Elizabeth,44,0,45,1
1745838424790,EDS 139,B00,897209,Fargason; Sharon Gayle,44,0,45,1
1745838425819,EDS 201,A00,895545,Staff,43,0,45,2
1745838426850,EDS 203,A01,895581,Halter; Christopher P.,43,0,45,2
1745838427878,EDS 204R,A01,895625,Heinzman; Erica M.,43,0,45,2
1745838427878,EDS 204R,B01,895693,Halter; Christopher P.,18,0,45,27
1745838428905,EDS 206R,A00,895694,Fargason; Sharon Gayle,9,0,30,21
1745838428905,EDS 206R,B00,895695,Choi; Bailey Miyeon,20,0,30,10
1745838429932,EDS 250,A00,895697,Hemans; Patricia Ann Benitez,43,0,45,2
1745838430963,EDS 281,A00,895701,Meyerott; Theresa Ann,15,0,15,0
1745838431989,EDS 284,A00,895736,Meyerott; Theresa Ann,15,0,15,0
1745838433019,EDS 286,A00,897210,Fine; Sarah,15,0,15,0
1745838434050,EDS 289C,A01,895770,Daly; Alan J.,15,0,15,0
1745838435077,EDS 290,A00,897211,Hofstetter; Carolyn,15,0,15,0
1745838436110,LIGM 5A,A00,896162,Fischer-Grunski; Eva K,15,0,20,5
1745838437136,LIGM 5B,A00,896260,Fischer-Grunski; Eva K,17,0,20,3
1745838438167,LIGM 5C,A00,896308,Fischer-Grunski; Eva K,18,0,20,2
1745838439194,LIIT 5AS,A00,896313,Carnelos; Chiara,17,0,20,3
1745838440221,LIIT 5BS,A00,896416,Carnelos; Chiara,20,0,20,0
1745838441247,LIIT 5CS,A00,896564,Carnelos; Chiara,20,0,20,0
1745838442280,LISP 5A,A00,896588,Munoz Sanchez; Alicia,4,0,20,16
1745838443307,LISP 5B,A00,896653,Munoz Sanchez; Alicia,10,0,20,10
1745838444337,LISP 5C,A00,896655,Munoz Sanchez; Alicia,4,0,20,16
1745838445364,MAE 197,001,957918,Kleissl; Jan,9998,0,9999,1
1745838446391,MATH 2,A01,957937,Staff,34,0,35,1
1745838447422,MATH 197,001,957876,Kedlaya; Kiran S.,9993,0,9999,6
1745838448449,MCWP 40,A00,892729,Duru; Nur,13,0,20,7
1745838448449,MCWP 40,B00,893304,Montejo; Carolina,20,0,20,0
1745838449477,MCWP 40R,A00,893757,Redela; Pamela Morgan,0,7,20,20
1745838450503,MCWP 50,A00,893758,Morshed; Michael James,2,0,20,18
1745838450503,MCWP 50,B00,893761,Bartulis; Jason Michael,18,0,20,2
1745838451537,MCWP 50R,A00,893766,Compas; Sean Matthew,0,1,20,20
1745838451537,MCWP 50R,B00,893769,Carter; Jennifer A,0,0,20,20
1745838451537,MCWP 50R,C00,893771,Krone; Jarret,0,3,20,20
1745838451537,MCWP 50R,D00,893772,Miller; Elizabeth Deen,3,0,20,17
1745838451537,MCWP 50R,E00,893775,Carter; Andrea L,0,0,20,20
1745838452570,MMW 11R,A01,892721,Herbst; Matthew,11,0,27,16
1745838452570,MMW 11R,A02,892722,Herbst; Matthew,0,0,0,3
1745838453598,MMW 12R,A01,892724,Herbst; Matthew,0,10,16,16
1745838453598,MMW 12R,A02,892725,Herbst; Matthew,0,9,16,16
1745838454627,MMW 13R,A01,892727,Staff,0,3,16,16
1745838454627,MMW 13R,A02,892728,Staff,0,4,16,16
1745838454627,MMW 13R,A03,958032,Staff,0,3,16,16
1745838454627,MMW 13R,A04,958033,Staff,0,2,16,16
1745838454627,MMW 13R,A05,958034,Staff,0,3,16,16
1745838455656,SIO 295LS,A00,894015,Staff,7,0,25,18
1745838456686,SIO 295S,A00,894020,Staff,7,0,25,18
1745838457720,SIOC 290S,B01,958918,Staff,0,0,0,0
1745838458752,SIOC 291S,B01,958922,Staff,0,0,0,0
1745838459779,SOCI 117,A01,895339,Staff,4,0,5,1
1745838460805,WES 237B,A00,894149,Staff,11,0,20,9
1745838462894,AESE 279B,A00,891859,Staff,13,0,35,22
1745838463922,AIP 197,001,891854,Staff,70,0,70,0
1745838464954,ANTH 289S,A00,891856,Gagneux; Pascal,12,0,12,0
1745838465983,BENG 196,001,957946,Engler; Adam J.,9996,0,9999,3
1745838467012,CAT 124RS,A01,956906,Staff,8,0,25,17
1745838468042,CAT 125RS,A01,922013,Staff,8,0,25,17
1745838469067,CLRE 250,A00,891860,Morris; Sheldon,9995,0,9999,4
1745838471124,CLRE 251R,A00,907817,Mehta; Ravindra L.,9994,0,9999,5
1745838472151,CLRE 252,A00,891864,Cuomo; Raphael Eduardo,9993,0,9999,6
1745838473180,CLRE 253,A00,891867,Vaida; Florin,9994,0,9999,5
1745838473180,CLRE 253,B00,907819,Staff,9999,0,9999,0
1745838474207,CLRE 259,A00,891868,Patel; Hemal,9998,0,9999,1
1745838475236,CLRE 260,A00,891872,Cuomo; Raphael Eduardo,9999,0,9999,0
1745838476266,CLRE 297,001,891888,Cuomo; Raphael Eduardo,9999,0,9999,0
1745838477294,CSE 191,A00,958773,Minnes Kemp; Mor Mia,9999,0,9999,0
1745838478320,CSS 201S,A01,892054,Mignozzetti; Umberto,30,0,30,0
1745838479348,CSS 202S,A01,892056,Mignozzetti; Umberto,30,0,30,0
1745838480379,DSC 197,001,956898,Eldridge; Justin Matthew,9998,0,9999,1
1745838481406,DSC 297,001,958000,Mazumdar; Arya,9998,0,9999,1
1745838482433,EAP 100,A00,905686,Staff,9776,0,9999,223
1745838483459,ECE 45,A01,892618,Staff,0,13,50,50
1745838484489,ECE 109,A01,892620,Staff,0,43,0,0
1745838485521,ECE 111,A01,892719,Staff,0,9,50,50
1745838486547,ECE 197,001,957920,Mercier; Patrick Philip,9992,0,9999,7
1745838487579,ECON 178,A01,907814,Zhu; Ying,28,0,35,7
1745838488653,EDS 115,A00,895312,Staff,41,0,45,4
1745838489684,EDS 117,A01,895337,Staff,30,0,30,0
1745838490712,EDS 125,A00,895341,Jones; Gabrielle Anastasia,43,0,45,2
1745838491740,EDS 128A,A01,895459,Fargason; Sharon Gayle,44,0,45,1
1745838492767,EDS 128B,A01,895543,Pappas; Elizabeth,44,0,45,1
1745838493791,EDS 139,A00,897203,Pappas; Elizabeth,44,0,45,1
1745838493791,EDS 139,B00,897209,Fargason; Sharon Gayle,44,0,45,1
1745838494818,EDS 201,A00,895545,Staff,43,0,45,2
1745838495848,EDS 203,A01,895581,Halter; Christopher P.,43,0,45,2
1745838496881,EDS 204R,A01,895625,Heinzman; Erica M.,43,0,45,2
1745838496881,EDS 204R,B01,895693,Halter; Christopher P.,18,0,45,27
1745838497909,EDS 206R,A00,895694,Fargason; Sharon Gayle,9,0,30,21
1745838497909,EDS 206R,B00,895695,Choi; Bailey Miyeon,20,0,30,10
1745838498937,EDS 250,A00,895697,Hemans; Patricia Ann Benitez,43,0,45,2
1745838499963,EDS 281,A00,895701,Meyerott; Theresa Ann,15,0,15,0
1745838500990,EDS 284,A00,895736,Meyerott; Theresa Ann,15,0,15,0
1745838502265,EDS 286,A00,897210,Fine; Sarah,15,0,15,0
1745838503291,EDS 289C,A01,895770,Daly; Alan J.,15,0,15,0
1745838504318,EDS 290,A00,897211,Hofstetter; Carolyn,15,0,15,0
1745838505345,LIGM 5A,A00,896162,Fischer-Grunski; Eva K,15,0,20,5
1745838506372,LIGM 5B,A00,896260,Fischer-Grunski; Eva K,17,0,20,3
1745838507399,LIGM 5C,A00,896308,Fischer-Grunski; Eva K,18,0,20,2
1745838508426,LIIT 5AS,A00,896313,Carnelos; Chiara,17,0,20,3
1745838509453,LIIT 5BS,A00,896416,Carnelos; Chiara,20,0,20,0
1745838510483,LIIT 5CS,A00,896564,Carnelos; Chiara,20,0,20,0
1745838511514,LISP 5A,A00,896588,Munoz Sanchez; Alicia,4,0,20,16
1745838512541,LISP 5B,A00,896653,Munoz Sanchez; Alicia,10,0,20,10
1745838513567,LISP 5C,A00,896655,Munoz Sanchez; Alicia,4,0,20,16
1745838514599,MAE 197,001,957918,Kleissl; Jan,9998,0,9999,1
1745838515625,MATH 2,A01,957937,Staff,34,0,35,1
1745838516654,MATH 197,001,957876,Kedlaya; Kiran S.,9993,0,9999,6
1745838517686,MCWP 40,A00,892729,Duru; Nur,13,0,20,7
1745838517686,MCWP 40,B00,893304,Montejo; Carolina,20,0,20,0
1745838518713,MCWP 40R,A00,893757,Redela; Pamela Morgan,0,7,20,20
1745838519746,MCWP 50,A00,893758,Morshed; Michael James,2,0,20,18
1745838519746,MCWP 50,B00,893761,Bartulis; Jason Michael,18,0,20,2
1745838520775,MCWP 50R,A00,893766,Compas; Sean Matthew,0,1,20,20
1745838520775,MCWP 50R,B00,893769,Carter; Jennifer A,0,0,20,20
1745838520775,MCWP 50R,C00,893771,Krone; Jarret,0,3,20,20
1745838520775,MCWP 50R,D00,893772,Miller; Elizabeth Deen,3,0,20,17
1745838520775,MCWP 50R,E00,893775,Carter; Andrea L,0,0,20,20
1745838521803,MMW 11R,A01,892721,Herbst; Matthew,11,0,27,16
1745838521803,MMW 11R,A02,892722,Herbst; Matthew,0,0,0,3
1745838522831,MMW 12R,A01,892724,Herbst; Matthew,0,10,16,16
1745838522831,MMW 12R,A02,892725,Herbst; Matthew,0,9,16,16
1745838523857,MMW 13R,A01,892727,Staff,0,3,16,16
1745838523857,MMW 13R,A02,892728,Staff,0,4,16,16
1745838523857,MMW 13R,A03,958032,Staff,0,3,16,16
1745838523857,MMW 13R,A04,958033,Staff,0,2,16,16
1745838523857,MMW 13R,A05,958034,Staff,0,3,16,16
1745838524885,SIO 295LS,A00,894015,Staff,7,0,25,18
1745838525914,SIO 295S,A00,894020,Staff,7,0,25,18
1745838526946,SIOC 290S,B01,958918,Staff,0,0,0,0
1745838527972,SIOC 291S,B01,958922,Staff,0,0,0,0
1745838529001,SOCI 117,A01,895339,Staff,4,0,5,1
1745838530030,WES 237B,A00,894149,Staff,11,0,20,9
1745838532106,AESE 279B,A00,891859,Staff,13,0,35,22
1745838533133,AIP 197,001,891854,Staff,70,0,70,0
1745838534158,ANTH 289S,A00,891856,Gagneux; Pascal,12,0,12,0
1745838535427,BENG 196,001,957946,Engler; Adam J.,9996,0,9999,3
1745838536453,CAT 124RS,A01,956906,Staff,8,0,25,17
1745838537479,CAT 125RS,A01,922013,Staff,8,0,25,17
1745838538509,CLRE 250,A00,891860,Morris; Sheldon,9995,0,9999,4
1745838540562,CLRE 251R,A00,907817,Mehta; Ravindra L.,9994,0,9999,5
1745838541588,CLRE 252,A00,891864,Cuomo; Raphael Eduardo,9993,0,9999,6
1745838542616,CLRE 253,A00,891867,Vaida; Florin,9994,0,9999,5
1745838542616,CLRE 253,B00,907819,Staff,9999,0,9999,0
1745838543642,CLRE 259,A00,891868,Patel; Hemal,9998,0,9999,1
1745838544668,CLRE 260,A00,891872,Cuomo; Raphael Eduardo,9999,0,9999,0
1745838545699,CLRE 297,001,891888,Cuomo; Raphael Eduardo,9999,0,9999,0
1745838546726,CSE 191,A00,958773,Minnes Kemp; Mor Mia,9999,0,9999,0
1745838547759,CSS 201S,A01,892054,Mignozzetti; Umberto,30,0,30,0
1745838548787,CSS 202S,A01,892056,Mignozzetti; Umberto,30,0,30,0
1745838549817,DSC 197,001,956898,Eldridge; Justin Matthew,9998,0,9999,1
1745838550844,DSC 297,001,958000,Mazumdar; Arya,9998,0,9999,1
1745838551870,EAP 100,A00,905686,Staff,9776,0,9999,223
1745838552900,ECE 45,A01,892618,Staff,0,13,50,50
1745838553927,ECE 109,A01,892620,Staff,0,43,0,0
1745838554953,ECE 111,A01,892719,Staff,0,9,50,50
1745838555980,ECE 197,001,957920,Mercier; Patrick Philip,9992,0,9999,7
1745838557007,ECON 178,A01,907814,Zhu; Ying,28,0,35,7
1745838558035,EDS 115,A00,895312,Staff,41,0,45,4
1745838559065,EDS 117,A01,895337,Staff,30,0,30,0
1745838560098,EDS 125,A00,895341,Jones; Gabrielle Anastasia,43,0,45,2
1745838561127,EDS 128A,A01,895459,Fargason; Sharon Gayle,44,0,45,1
1745838562155,EDS 128B,A01,895543,Pappas; Elizabeth,44,0,45,1
1745838563184,EDS 139,A00,897203,Pappas; Elizabeth,44,0,45,1
1745838563184,EDS 139,B00,897209,Fargason; Sharon Gayle,44,0,45,1
1745838564214,EDS 201,A00,895545,Staff,43,0,45,2
1745838565243,EDS 203,A01,895581,Halter; Christopher P.,43,0,45,2
1745838566272,EDS 204R,A01,895625,Heinzman; Erica M.,43,0,45,2
1745838566272,EDS 204R,B01,895693,Halter; Christopher P.,18,0,45,27
1745838567301,EDS 206R,A00,895694,Fargason; Sharon Gayle,9,0,30,21
1745838567301,EDS 206R,B00,895695,Choi; Bailey Miyeon,20,0,30,10
1745838568329,EDS 250,A00,895697,Hemans; Patricia Ann Benitez,43,0,45,2
1745838569355,EDS 281,A00,895701,Meyerott; Theresa Ann,15,0,15,0
1745838570382,EDS 284,A00,895736,Meyerott; Theresa Ann,15,0,15,0
1745838571411,EDS 286,A00,897210,Fine; Sarah,15,0,15,0
1745838572437,EDS 289C,A01,895770,Daly; Alan J.,15,0,15,0
1745838573464,EDS 290,A00,897211,Hofstetter; Carolyn,15,0,15,0
1745838574492,LIGM 5A,A00,896162,Fischer-Grunski; Eva K,15,0,20,5
1745838575519,LIGM 5B,A00,896260,Fischer-Grunski; Eva K,17,0,20,3
1745838576551,LIGM 5C,A00,896308,Fischer-Grunski; Eva K,18,0,20,2
1745838577577,LIIT 5AS,A00,896313,Carnelos; Chiara,17,0,20,3
1745838578649,LIIT 5BS,A00,896416,Carnelos; Chiara,20,0,20,0
1745838579676,LIIT 5CS,A00,896564,Carnelos; Chiara,20,0,20,0
1745838580703,LISP 5A,A00,896588,Munoz Sanchez; Alicia,4,0,20,16
1745838581735,LISP 5B,A00,896653,Munoz Sanchez; Alicia,10,0,20,10
1745838582762,LISP 5C,A00,896655,Munoz Sanchez; Alicia,4,0,20,16
1745838583791,MAE 197,001,957918,Kleissl; Jan,9998,0,9999,1
1745838584817,MATH 2,A01,957937,Staff,34,0,35,1
1745838585848,MATH 197,001,957876,Kedlaya; Kiran S.,9993,0,9999,6
1745838586875,MCWP 40,A00,892729,Duru; Nur,13,0,20,7
1745838586875,MCWP 40,B00,893304,Montejo; Carolina,20,0,20,0
1745838587901,MCWP 40R,A00,893757,Redela; Pamela Morgan,0,7,20,20
1745838588935,MCWP 50,A00,893758,Morshed; Michael James,2,0,20,18
1745838588935,MCWP 50,B00,893761,Bartulis; Jason Michael,18,0,20,2
1745838589969,MCWP 50R,A00,893766,Compas; Sean Matthew,0,1,20,20
1745838589969,MCWP 50R,B00,893769,Carter; Jennifer A,0,0,20,20
1745838589969,MCWP 50R,C00,893771,Krone; Jarret,0,3,20,20
1745838589969,MCWP 50R,D00,893772,Miller; Elizabeth Deen,3,0,20,17
1745838589969,MCWP 50R,E00,893775,Carter; Andrea L,0,0,20,20
1745838590997,MMW 11R,A01,892721,Herbst; Matthew,11,0,27,16
1745838590997,MMW 11R,A02,892722,Herbst; Matthew,0,0,0,3
1745838592026,MMW 12R,A01,892724,Herbst; Matthew,0,10,16,16
1745838592026,MMW 12R,A02,892725,Herbst; Matthew,0,9,16,16
1745838593055,MMW 13R,A01,892727,Staff,0,3,16,16
1745838593055,MMW 13R,A02,892728,Staff,0,4,16,16
1745838593055,MMW 13R,A03,958032,Staff,0,3,16,16
1745838593055,MMW 13R,A04,958033,Staff,0,2,16,16
1745838593055,MMW 13R,A05,958034,Staff,0,3,16,16
1745838594081,SIO 295LS,A00,894015,Staff,7,0,25,18
1745838595111,SIO 295S,A00,894020,Staff,7,0,25,18
1745838596143,SIOC 290S,B01,958918,Staff,0,0,0,0
1745838597174,SIOC 291S,B01,958922,Staff,0,0,0,0
1745838598200,SOCI 117,A01,895339,Staff,4,0,5,1
1745838599228,WES 237B,A00,894149,Staff,11,0,20,9
1745838601308,AESE 279B,A00,891859,Staff,13,0,35,22
1745838602338,AIP 197,001,891854,Staff,70,0,70,0
1745838603364,ANTH 289S,A00,891856,Gagneux; Pascal,12,0,12,0
1745838604390,BENG 196,001,957946,Engler; Adam J.,9996,0,9999,3
1745838605419,CAT 124RS,A01,956906,Staff,8,0,25,17
1745838606454,CAT 125RS,A01,922013,Staff,8,0,25,17
1745838607481,CLRE 250,A00,891860,Morris; Sheldon,9995,0,9999,4
1745838609536,CLRE 251R,A00,907817,Mehta; Ravindra L.,9994,0,9999,5
1745838610566,CLRE 252,A00,891864,Cuomo; Raphael Eduardo,9993,0,9999,6
1745838611594,CLRE 253,A00,891867,Vaida; Florin,9994,0,9999,5
1745838611594,CLRE 253,B00,907819,Staff,9999,0,9999,0
1745838612626,CLRE 259,A00,891868,Patel; Hemal,9998,0,9999,1
1745838613654,CLRE 260,A00,891872,Cuomo; Raphael Eduardo,9999,0,9999,0
1745838614681,CLRE 297,001,891888,Cuomo; Raphael Eduardo,9999,0,9999,0
1745838615708,CSE 191,A00,958773,Minnes Kemp; Mor Mia,9999,0,9999,0
1745838616735,CSS 201S,A01,892054,Mignozzetti; Umberto,30,0,30,0
1745838617767,CSS 202S,A01,892056,Mignozzetti; Umberto,30,0,30,0
1745838618794,DSC 197,001,956898,Eldridge; Justin Matthew,9998,0,9999,1
1745838619824,DSC 297,001,958000,Mazumdar; Arya,9998,0,9999,1
1745838620850,EAP 100,A00,905686,Staff,9776,0,9999,223
1745838621878,ECE 45,A01,892618,Staff,0,13,50,50
1745838622904,ECE 109,A01,892620,Staff,0,43,0,0
1745838623932,ECE 111,A01,892719,Staff,0,9,50,50
1745838624959,ECE 197,001,957920,Mercier; Patrick Philip,9992,0,9999,7
1745838625993,ECON 178,A01,907814,Zhu; Ying,28,0,35,7
1745838627019,EDS 115,A00,895312,Staff,41,0,45,4
1745838628046,EDS 117,A01,895337,Staff,30,0,30,0
1745838629074,EDS 125,A00,895341,Jones; Gabrielle Anastasia,43,0,45,2
1745838630101,EDS 128A,A01,895459,Fargason; Sharon Gayle,44,0,45,1
1745838631129,EDS 128B,A01,895543,Pappas; Elizabeth,44,0,45,1
1745838632159,EDS 139,A00,897203,Pappas; Elizabeth,44,0,45,1
1745838632159,EDS 139,B00,897209,Fargason; Sharon Gayle,44,0,45,1
1745838633187,EDS 201,A00,895545,Staff,43,0,45,2
1745838634219,EDS 203,A01,895581,Halter; Christopher P.,43,0,45,2
1745838635251,EDS 204R,A01,895625,Heinzman; Erica M.,43,0,45,2
1745838635251,EDS 204R,B01,895693,Halter; Christopher P.,18,0,45,27
1745838636277,EDS 206R,A00,895694,Fargason; Sharon Gayle,9,0,30,21
1745838636277,EDS 206R,B00,895695,Choi; Bailey Miyeon,20,0,30,10
1745838637303,EDS 250,A00,895697,Hemans; Patricia Ann Benitez,43,0,45,2
1745838638332,EDS 281,A00,895701,Meyerott; Theresa Ann,15,0,15,0
1745838639360,EDS 284,A00,895736,Meyerott; Theresa Ann,15,0,15,0
1745838640392,EDS 286,A00,897210,Fine; Sarah,15,0,15,0
1745838641419,EDS 289C,A01,895770,Daly; Alan J.,15,0,15,0
1745838642449,EDS 290,A00,897211,Hofstetter; Carolyn,15,0,15,0
1745838643476,LIGM 5A,A00,896162,Fischer-Grunski; Eva K,15,0,20,5
1745838644502,LIGM 5B,A00,896260,Fischer-Grunski; Eva K,17,0,20,3
1745838645529,LIGM 5C,A00,896308,Fischer-Grunski; Eva K,18,0,20,2
1745838646555,LIIT 5AS,A00,896313,Carnelos; Chiara,17,0,20,3
1745838647581,LIIT 5BS,A00,896416,Carnelos; Chiara,20,0,20,0
1745838648611,LIIT 5CS,A00,896564,Carnelos; Chiara,20,0,20,0
1745838649643,LISP 5A,A00,896588,Munoz Sanchez; Alicia,4,0,20,16
1745838650672,LISP 5B,A00,896653,Munoz Sanchez; Alicia,10,0,20,10
1745838651699,LISP 5C,A00,896655,Munoz Sanchez; Alicia,4,0,20,16
1745838652726,MAE 197,001,957918,Kleissl; Jan,9998,0,9999,1
1745838653754,MATH 2,A01,957937,Staff,34,0,35,1
1745838654786,MATH 197,001,957876,Kedlaya; Kiran S.,9993,0,9999,6
1745838655814,MCWP 40,A00,892729,Duru; Nur,13,0,20,7
1745838655814,MCWP 40,B00,893304,Montejo; Carolina,20,0,20,0
1745838656844,MCWP 40R,A00,893757,Redela; Pamela Morgan,0,7,20,20
1745838657870,MCWP 50,A00,893758,Morshed; Michael James,2,0,20,18
1745838657870,MCWP 50,B00,893761,Bartulis; Jason Michael,18,0,20,2
1745838658904,MCWP 50R,A00,893766,Compas; Sean Matthew,0,1,20,20
1745838658904,MCWP 50R,B00,893769,Carter; Jennifer A,0,0,20,20
1745838658904,MCWP 50R,C00,893771,Krone; Jarret,0,3,20,20
1745838658904,MCWP 50R,D00,893772,Miller; Elizabeth Deen,3,0,20,17
1745838658904,MCWP 50R,E00,893775,Carter; Andrea L,0,0,20,20
1745838659930,MMW 11R,A01,892721,Herbst; Matthew,11,0,27,16
1745838659930,MMW 11R,A02,892722,Herbst; Matthew,0,0,0,3
1745838660957,MMW 12R,A01,892724,Herbst; Matthew,0,10,16,16
1745838660957,MMW 12R,A02,892725,Herbst; Matthew,0,9,16,16
1745838661984,MMW 13R,A01,892727,Staff,0,3,16,16
1745838661984,MMW 13R,A02,892728,Staff,0,4,16,16
1745838661984,MMW 13R,A03,958032,Staff,0,3,16,16
1745838661984,MMW 13R,A04,958033,Staff,0,2,16,16
1745838661984,MMW 13R,A05,958034,Staff,0,3,16,16
1745838663010,SIO 295LS,A00,894015,Staff,7,0,25,18
1745838664040,SIO 295S,A00,894020,Staff,7,0,25,18
1745838665067,SIOC 290S,B01,958918,Staff,0,0,0,0
1745838666099,SIOC 291S,B01,958922,Staff,0,0,0,0
1745838667128,SOCI 117,A01,895339,Staff,4,0,5,1
1745838668154,WES 237B,A00,894149,Staff,11,0,20,9
1745838670223,AESE 279B,A00,891859,Staff,13,0,35,22
1745838671252,AIP 197,001,891854,Staff,70,0,70,0
1745838672284,ANTH 289S,A00,891856,Gagneux; Pascal,12,0,12,0
1745838673310,BENG 196,001,957946,Engler; Adam J.,9996,0,9999,3
1745838674339,CAT 124RS,A01,956906,Staff,8,0,25,17
1745838675365,CAT 125RS,A01,922013,Staff,8,0,25,17
1745838676393,CLRE 250,A00,891860,Morris; Sheldon,9995,0,9999,4
1745838678449,CLRE 251R,A00,907817,Mehta; Ravindra L.,9994,0,9999,5
1745838679473,CLRE 252,A00,891864,Cuomo; Raphael Eduardo,9993,0,9999,6
1745838680498,CLRE 253,A00,891867,Vaida; Florin,9994,0,9999,5
1745838680498,CLRE 253,B00,907819,Staff,9999,0,9999,0
1745838681527,CLRE 259,A00,891868,Patel; Hemal,9998,0,9999,1
1745838682551,CLRE 260,A00,891872,Cuomo; Raphael Eduardo,9999,0,9999,0
1745838683579,CLRE 297,001,891888,Cuomo; Raphael Eduardo,9999,0,9999,0
1745838684609,CSE 191,A00,958773,Minnes Kemp; Mor Mia,9999,0,9999,0
1745838685642,CSS 201S,A01,892054,Mignozzetti; Umberto,30,0,30,0
1745838686669,CSS 202S,A01,892056,Mignozzetti; Umberto,30,0,30,0
1745838687697,DSC 197,001,956898,Eldridge; Justin Matthew,9998,0,9999,1
1745838688724,DSC 297,001,958000,Mazumdar; Arya,9998,0,9999,1
1745838689750,EAP 100,A00,905686,Staff,9776,0,9999,223
1745838690777,ECE 45,A01,892618,Staff,0,13,50,50
1745838691803,ECE 109,A01,892620,Staff,0,43,0,0
1745838692830,ECE 111,A01,892719,Staff,0,9,50,50
1745838693859,ECE 197,001,957920,Mercier; Patrick Philip,9992,0,9999,7
1745838694889,ECON 178,A01,907814,Zhu; Ying,28,0,35,7
1745838695919,EDS 115,A00,895312,Staff,41,0,45,4
1745838696948,EDS 117,A01,895337,Staff,30,0,30,0
1745838697975,EDS 125,A00,895341,Jones; Gabrielle Anastasia,43,0,45,2
1745838699003,EDS 128A,A01,895459,Fargason; Sharon Gayle,44,0,45,1
1745838700030,EDS 128B,A01,895543,Pappas; Elizabeth,44,0,45,1
1745838701058,EDS 139,A00,897203,Pappas; Elizabeth,44,0,45,1
1745838701058,EDS 139,B00,897209,Fargason; Sharon Gayle,44,0,45,1
1745838702083,EDS 201,A00,895545,Staff,43,0,45,2
1745838703115,EDS 203,A01,895581,Halter; Christopher P.,43,0,45,2
1745838704149,EDS 204R,A01,895625,Heinzman; Erica M.,43,0,45,2
1745838704149,EDS 204R,B01,895693,Halter; Christopher P.,18,0,45,27
1745838705182,EDS 206R,A00,895694,Fargason; Sharon Gayle,9,0,30,21
1745838705182,EDS 206R,B00,895695,Choi; Bailey Miyeon,20,0,30,10
1745838706208,EDS 250,A00,895697,Hemans; Patricia Ann Benitez,43,0,45,2
1745838707238,EDS 281,A00,895701,Meyerott; Theresa Ann,15,0,15,0
1745838708267,EDS 284,A00,895736,Meyerott; Theresa Ann,15,0,15,0
1745838709298,EDS 286,A00,897210,Fine; Sarah,15,0,15,0
1745838710324,EDS 289C,A01,895770,Daly; Alan J.,15,0,15,0
1745838711350,EDS 290,A00,897211,Hofstetter; Carolyn,15,0,15,0
1745838712385,LIGM 5A,A00,896162,Fischer-Grunski; Eva K,15,0,20,5
1745838713411,LIGM 5B,A00,896260,Fischer-Grunski; Eva K,17,0,20,3
1745838714439,LIGM 5C,A00,896308,Fischer-Grunski; Eva K,18,0,20,2
1745838715465,LIIT 5AS,A00,896313,Carnelos; Chiara,17,0,20,3
1745838716490,LIIT 5BS,A00,896416,Carnelos; Chiara,20,0,20,0
1745838717513,LIIT 5CS,A00,896564,Carnelos; Chiara,20,0,20,0
1745838718544,LISP 5A,A00,896588,Munoz Sanchez; Alicia,4,0,20,16
1745838719574,LISP 5B,A00,896653,Munoz Sanchez; Alicia,10,0,20,10
1745838720614,LISP 5C,A00,896655,Munoz Sanchez; Alicia,4,0,20,16
1745838721639,MAE 197,001,957918,Kleissl; Jan,9998,0,9999,1
1745838722671,MATH 2,A01,957937,Staff,34,0,35,1
1745838723696,MATH 197,001,957876,Kedlaya; Kiran S.,9993,0,9999,6
1745838724724,MCWP 40,A00,892729,Duru; Nur,13,0,20,7
1745838724724,MCWP 40,B00,893304,Montejo; Carolina,20,0,20,0
1745838725791,MCWP 40R,A00,893757,Redela; Pamela Morgan,0,7,20,20
1745838726816,MCWP 50,A00,893758,Morshed; Michael James,2,0,20,18
1745838726816,MCWP 50,B00,893761,Bartulis; Jason Michael,18,0,20,2
1745838727842,MCWP 50R,A00,893766,Compas; Sean Matthew,0,1,20,20
1745838727842,MCWP 50R,B00,893769,Carter; Jennifer A,0,0,20,20
1745838727842,MCWP 50R,C00,893771,Krone; Jarret,0,3,20,20
1745838727842,MCWP 50R,D00,893772,Miller; Elizabeth Deen,3,0,20,17
1745838727842,MCWP 50R,E00,893775,Carter; Andrea L,0,0,20,20
1745838728880,MMW 11R,A01,892721,Herbst; Matthew,11,0,27,16
1745838728880,MMW 11R,A02,892722,Herbst; Matthew,0,0,0,3
1745838729904,MMW 12R,A01,892724,Herbst; Matthew,0,10,16,16
1745838729904,MMW 12R,A02,892725,Herbst; Matthew,0,9,16,16
1745838730930,MMW 13R,A01,892727,Staff,0,3,16,16
1745838730930,MMW 13R,A02,892728,Staff,0,4,16,16
1745838730930,MMW 13R,A03,958032,Staff,0,3,16,16
1745838730930,MMW 13R,A04,958033,Staff,0,2,16,16
1745838730930,MMW 13R,A05,958034,Staff,0,3,16,16
1745838731955,SIO 295LS,A00,894015,Staff,7,0,25,18
1745838732979,SIO 295S,A00,894020,Staff,7,0,25,18
1745838734011,SIOC 290S,B01,958918,Staff,0,0,0,0
1745838735039,SIOC 291S,B01,958922,Staff,0,0,0,0
1745838736064,SOCI 117,A01,895339,Staff,4,0,5,1
1745838737092,WES 237B,A00,894149,Staff,11,0,20,9
1745838739210,AESE 279B,A00,891859,Staff,13,0,35,22
1745838740237,AIP 197,001,891854,Staff,70,0,70,0
1745838741267,ANTH 289S,A00,891856,Gagneux; Pascal,12,0,12,0
1745838742295,BENG 196,001,957946,Engler; Adam J.,9996,0,9999,3
1745838743320,CAT 124RS,A01,956906,Staff,8,0,25,17
1745838744348,CAT 125RS,A01,922013,Staff,8,0,25,17
1745838745376,CLRE 250,A00,891860,Morris; Sheldon,9995,0,9999,4
1745838747427,CLRE 251R,A00,907817,Mehta; Ravindra L.,9994,0,9999,5
1745838748453,CLRE 252,A00,891864,Cuomo; Raphael Eduardo,9993,0,9999,6
1745838749487,CLRE 253,A00,891867,Vaida; Florin,9994,0,9999,5
1745838749487,CLRE 253,B00,907819,Staff,9999,0,9999,0
1745838750514,CLRE 259,A00,891868,Patel; Hemal,9998,0,9999,1
1745838751544,CLRE 260,A00,891872,Cuomo; Raphael Eduardo,9999,0,9999,0
1745838752574,CLRE 297,001,891888,Cuomo; Raphael Eduardo,9999,0,9999,0
1745838753606,CSE 191,A00,958773,Minnes Kemp; Mor Mia,9999,0,9999,0
1745838754633,CSS 201S,A01,892054,Mignozzetti; Umberto,30,0,30,0
1745838755667,CSS 202S,A01,892056,Mignozzetti; Umberto,30,0,30,0
1745838756693,DSC 197,001,956898,Eldridge; Justin Matthew,9998,0,9999,1
1745838757721,DSC 297,001,958000,Mazumdar; Arya,9998,0,9999,1
1745838758787,EAP 100,A00,905686,Staff,9776,0,9999,223
1745838759824,ECE 45,A01,892618,Staff,0,13,50,50
1745838760849,ECE 109,A01,892620,Staff,0,43,0,0
1745838761874,ECE 111,A01,892719,Staff,0,9,50,50
1745838762906,ECE 197,001,957920,Mercier; Patrick Philip,9992,0,9999,7
1745838763934,ECON 178,A01,907814,Zhu; Ying,28,0,35,7
1745838764959,EDS 115,A00,895312,Staff,41,0,45,4
1745838765986,EDS 117,A01,895337,Staff,30,0,30,0
1745838767013,EDS 125,A00,895341,Jones; Gabrielle Anastasia,43,0,45,2
1745838768042,EDS 128A,A01,895459,Fargason; Sharon Gayle,44,0,45,1
1745838769068,EDS 128B,A01,895543,Pappas; Elizabeth,44,0,45,1
1745838770098,EDS 139,A00,897203,Pappas; Elizabeth,44,0,45,1
1745838770098,EDS 139,B00,897209,Fargason; Sharon Gayle,44,0,45,1
1745838771128,EDS 201,A00,895545,Staff,43,0,45,2
1745838772159,EDS 203,A01,895581,Halter; Christopher P.,43,0,45,2
1745838773192,EDS 204R,A01,895625,Heinzman; Erica M.,43,0,45,2
1745838773192,EDS 204R,B01,895693,Halter; Christopher P.,18,0,45,27
1745838774223,EDS 206R,A00,895694,Fargason; Sharon Gayle,9,0,30,21
1745838774223,EDS 206R,B00,895695,Choi; Bailey Miyeon,20,0,30,10
1745838775255,EDS 250,A00,895697,Hemans; Patricia Ann Benitez,43,0,45,2
1745838776286,EDS 281,A00,895701,Meyerott; Theresa Ann,15,0,15,0
1745838777315,EDS 284,A00,895736,Meyerott; Theresa Ann,15,0,15,0
1745838778346,EDS 286,A00,897210,Fine; Sarah,15,0,15,0
1745838779372,EDS 289C,A01,895770,Daly; Alan J.,15,0,15,0
1745838780397,EDS 290,A00,897211,Hofstetter; Carolyn,15,0,15,0
1745838781610,LIGM 5A,A00,896162,Fischer-Grunski; Eva K,15,0,20,5
1745838782638,LIGM 5B,A00,896260,Fischer-Grunski; Eva K,17,0,20,3
1745838783667,LIGM 5C,A00,896308,Fischer-Grunski; Eva K,18,0,20,2
1745838784703,LIIT 5AS,A00,896313,Carnelos; Chiara,17,0,20,3
1745838785729,LIIT 5BS,A00,896416,Carnelos; Chiara,20,0,20,0
1745838786756,LIIT 5CS,A00,896564,Carnelos; Chiara,20,0,20,0
1745838787788,LISP 5A,A00,896588,Munoz Sanchez; Alicia,4,0,20,16
1745838788818,LISP 5B,A00,896653,Munoz Sanchez; Alicia,10,0,20,10
1745838789845,LISP 5C,A00,896655,Munoz Sanchez; Alicia,4,0,20,16
1745838790872,MAE 197,001,957918,Kleissl; Jan,9998,0,9999,1
1745838791899,MATH 2,A01,957937,Staff,34,0,35,1
1745838792927,MATH 197,001,957876,Kedlaya; Kiran S.,9993,0,9999,6
1745838793966,MCWP 40,A00,892729,Duru; Nur,13,0,20,7
1745838793966,MCWP 40,B00,893304,Montejo; Carolina,20,0,20,0
1745838794998,MCWP 40R,A00,893757,Redela; Pamela Morgan,0,7,20,20
1745838796029,MCWP 50,A00,893758,Morshed; Michael James,2,0,20,18
1745838796029,MCWP 50,B00,893761,Bartulis; Jason Michael,18,0,20,2
1745838797057,MCWP 50R,A00,893766,Compas; Sean Matthew,0,1,20,20
1745838797057,MCWP 50R,B00,893769,Carter; Jennifer A,0,0,20,20
1745838797057,MCWP 50R,C00,893771,Krone; Jarret,0,3,20,20
1745838797057,MCWP 50R,D00,893772,Miller; Elizabeth Deen,3,0,20,17
1745838797057,MCWP 50R,E00,893775,Carter; Andrea L,0,0,20,20
1745838798100,MMW 11R,A01,892721,Herbst; Matthew,11,0,27,16
1745838798100,MMW 11R,A02,892722,Herbst; Matthew,0,0,0,3
1745838799125,MMW 12R,A01,892724,Herbst; Matthew,0,10,16,16
1745838799125,MMW 12R,A02,892725,Herbst; Matthew,0,9,16,16
1745838800170,MMW 13R,A01,892727,Staff,0,3,16,16
1745838800170,MMW 13R,A02,892728,Staff,0,4,16,16
1745838800170,MMW 13R,A03,958032,Staff,0,3,16,16
1745838800170,MMW 13R,A04,958033,Staff,0,2,16,16
1745838800170,MMW 13R,A05,958034,Staff,0,3,16,16
1745838801196,SIO 295LS,A00,894015,Staff,7,0,25,18
1745838802221,SIO 295S,A00,894020,Staff,7,0,25,18
1745838803247,SIOC 290S,B01,958918,Staff,0,0,0,0
1745838804273,SIOC 291S,B01,958922,Staff,0,0,0,0
1745838805299,SOCI 117,A01,895339,Staff,4,0,5,1
1745838806326,WES 237B,A00,894149,Staff,11,0,20,9
1745838808410,AESE 279B,A00,891859,Staff,13,0,35,22
1745838809435,AIP 197,001,891854,Staff,70,0,70,0
1745838810466,ANTH 289S,A00,891856,Gagneux; Pascal,12,0,12,0
1745838811498,BENG 196,001,957946,Engler; Adam J.,9996,0,9999,3
1745838812522,CAT 124RS,A01,956906,Staff,8,0,25,17
1745838813551,CAT 125RS,A01,922013,Staff,8,0,25,17
1745838814581,CLRE 250,A00,891860,Morris; Sheldon,9995,0,9999,4
1745838816631,CLRE 251R,A00,907817,Mehta; Ravindra L.,9994,0,9999,5
1745838817657,CLRE 252,A00,891864,Cuomo; Raphael Eduardo,9993,0,9999,6
1745838818688,CLRE 253,A00,891867,Vaida; Florin,9994,0,9999,5
1745838818688,CLRE 253,B00,907819,Staff,9999,0,9999,0
1745838819715,CLRE 259,A00,891868,Patel; Hemal,9998,0,9999,1
1745838820740,CLRE 260,A00,891872,Cuomo; Raphael Eduardo,9999,0,9999,0
1745838821768,CLRE 297,001,891888,Cuomo; Raphael Eduardo,9999,0,9999,0
1745838822795,CSE 191,A00,958773,Minnes Kemp; Mor Mia,9999,0,9999,0
1745838823823,CSS 201S,A01,892054,Mignozzetti; Umberto,30,0,30,0
1745838824850,CSS 202S,A01,892056,Mignozzetti; Umberto,30,0,30,0
1745838825883,DSC 197,001,956898,Eldridge; Justin Matthew,9998,0,9999,1
1745838826913,DSC 297,001,958000,Mazumdar; Arya,9998,0,9999,1
1745838827941,EAP 100,A00,905686,Staff,9776,0,9999,223
1745838829011,ECE 45,A01,892618,Staff,0,13,50,50
1745838830037,ECE 109,A01,892620,Staff,0,43,0,0
1745838831066,ECE 111,A01,892719,Staff,0,9,50,50
1745838832093,ECE 197,001,957920,Mercier; Patrick Philip,9992,0,9999,7
1745838833121,ECON 178,A01,907814,Zhu; Ying,28,0,35,7
1745838834153,EDS 115,A00,895312,Staff,41,0,45,4
1745838835184,EDS 117,A01,895337,Staff,30,0,30,0
1745838836217,EDS 125,A00,895341,Jones; Gabrielle Anastasia,43,0,45,2
1745838837243,EDS 128A,A01,895459,Fargason; Sharon Gayle,44,0,45,1
1745838838270,EDS 128B,A01,895543,Pappas; Elizabeth,44,0,45,1
1745838839302,EDS 139,A00,897203,Pappas; Elizabeth,44,0,45,1
1745838839302,EDS 139,B00,897209,Fargason; Sharon Gayle,44,0,45,1
1745838840329,EDS 201,A00,895545,Staff,43,0,45,2
1745838841354,EDS 203,A01,895581,Halter; Christopher P.,43,0,45,2
1745838842405,EDS 204R,A01,895625,Heinzman; Erica M.,43,0,45,2
1745838842405,EDS 204R,B01,895693,Halter; Christopher P.,18,0,45,27
1745838843432,EDS 206R,A00,895694,Fargason; Sharon Gayle,9,0,30,21
1745838843432,EDS 206R,B00,895695,Choi; Bailey Miyeon,20,0,30,10
1745838844457,EDS 250,A00,895697,Hemans; Patricia Ann Benitez,43,0,45,2
1745838845487,EDS 281,A00,895701,Meyerott; Theresa Ann,15,0,15,0
1745838846519,EDS 284,A00,895736,Meyerott; Theresa Ann,15,0,15,0
1745838847545,EDS 286,A00,897210,Fine; Sarah,15,0,15,0
1745838848573,EDS 289C,A01,895770,Daly; Alan J.,15,0,15,0
1745838849605,EDS 290,A00,897211,Hofstetter; Carolyn,15,0,15,0
1745838850631,LIGM 5A,A00,896162,Fischer-Grunski; Eva K,15,0,20,5
1745838851664,LIGM 5B,A00,896260,Fischer-Grunski; Eva K,17,0,20,3
1745838852694,LIGM 5C,A00,896308,Fischer-Grunski; Eva K,18,0,20,2
1745838853721,LIIT 5AS,A00,896313,Carnelos; Chiara,17,0,20,3
1745838854753,LIIT 5BS,A00,896416,Carnelos; Chiara,20,0,20,0
1745838855786,LIIT 5CS,A00,896564,Carnelos; Chiara,20,0,20,0
1745838856818,LISP 5A,A00,896588,Munoz Sanchez; Alicia,4,0,20,16
1745838857846,LISP 5B,A00,896653,Munoz Sanchez; Alicia,10,0,20,10
1745838858872,LISP 5C,A00,896655,Munoz Sanchez; Alicia,4,0,20,16
1745838859899,MAE 197,001,957918,Kleissl; Jan,9998,0,9999,1
1745838860927,MATH 2,A01,957937,Staff,34,0,35,1
1745838861953,MATH 197,001,957876,Kedlaya; Kiran S.,9993,0,9999,6
1745838862985,MCWP 40,A00,892729,Duru; Nur,13,0,20,7
1745838862985,MCWP 40,B00,893304,Montejo; Carolina,20,0,20,0
1745838864014,MCWP 40R,A00,893757,Redela; Pamela Morgan,0,7,20,20
1745838865048,MCWP 50,A00,893758,Morshed; Michael James,2,0,20,18
1745838865048,MCWP 50,B00,893761,Bartulis; Jason Michael,18,0,20,2
1745838866075,MCWP 50R,A00,893766,Compas; Sean Matthew,0,1,20,20
1745838866075,MCWP 50R,B00,893769,Carter; Jennifer A,0,0,20,20
1745838866075,MCWP 50R,C00,893771,Krone; Jarret,0,3,20,20
1745838866075,MCWP 50R,D00,893772,Miller; Elizabeth Deen,3,0,20,17
1745838866075,MCWP 50R,E00,893775,Carter; Andrea L,0,0,20,20
1745838867103,MMW 11R,A01,892721,Herbst; Matthew,11,0,27,16
1745838867103,MMW 11R,A02,892722,Herbst; Matthew,0,0,0,3
1745838868130,MMW 12R,A01,892724,Herbst; Matthew,0,10,16,16
1745838868130,MMW 12R,A02,892725,Herbst; Matthew,0,9,16,16
1745838869156,MMW 13R,A01,892727,Staff,0,3,16,16
1745838869156,MMW 13R,A02,892728,Staff,0,4,16,16
1745838869156,MMW 13R,A03,958032,Staff,0,3,16,16
1745838869156,MMW 13R,A04,958033,Staff,0,2,16,16
1745838869156,MMW 13R,A05,958034,Staff,0,3,16,16
1745838870188,SIO 295LS,A00,894015,Staff,7,0,25,18
1745838871219,SIO 295S,A00,894020,Staff,7,0,25,18
1745838872249,SIOC 290S,B01,958918,Staff,0,0,0,0
1745838873274,SIOC 291S,B01,958922,Staff,0,0,0,0
1745838874306,SOCI 117,A01,895339,Staff,4,0,5,1
1745838875333,WES 237B,A00,894149,Staff,11,0,20,9
1745838877416,AESE 279B,A00,891859,Staff,13,0,35,22
1745838878450,AIP 197,001,891854,Staff,70,0,70,0
1745838879476,ANTH 289S,A00,891856,Gagneux; Pascal,12,0,12,0
1745838880504,BENG 196,001,957946,Engler; Adam J.,9996,0,9999,3
1745838881534,CAT 124RS,A01,956906,Staff,8,0,25,17
1745838882564,CAT 125RS,A01,922013,Staff,8,0,25,17
1745838883590,CLRE 250,A00,891860,Morris; Sheldon,9995,0,9999,4
1745838885645,CLRE 251R,A00,907817,Mehta; Ravindra L.,9994,0,9999,5
1745838886670,CLRE 252,A00,891864,Cuomo; Raphael Eduardo,9993,0,9999,6
1745838887700,CLRE 253,A00,891867,Vaida; Florin,9994,0,9999,5
1745838887700,CLRE 253,B00,907819,Staff,9999,0,9999,0
1745838888726,CLRE 259,A00,891868,Patel; Hemal,9998,0,9999,1
1745838889753,CLRE 260,A00,891872,Cuomo; Raphael Eduardo,9999,0,9999,0
1745838890780,CLRE 297,001,891888,Cuomo; Raphael Eduardo,9999,0,9999,0
1745838891805,CSE 191,A00,958773,Minnes Kemp; Mor Mia,9999,0,9999,0
1745838892832,CSS 201S,A01,892054,Mignozzetti; Umberto,30,0,30,0
1745838893863,CSS 202S,A01,892056,Mignozzetti; Umberto,30,0,30,0
1745838894886,DSC 197,001,956898,Eldridge; Justin Matthew,9998,0,9999,1
1745838895914,DSC 297,001,958000,Mazumdar; Arya,9998,0,9999,1
1745838896943,EAP 100,A00,905686,Staff,9776,0,9999,223
1745838897975,ECE 45,A01,892618,Staff,0,13,50,50
1745838899001,ECE 109,A01,892620,Staff,0,43,0,0
1745838900078,ECE 111,A01,892719,Staff,0,9,50,50
1745838901105,ECE 197,001,957920,Mercier; Patrick Philip,9992,0,9999,7
1745838902138,ECON 178,A01,907814,Zhu; Ying,28,0,35,7
1745838903170,EDS 115,A00,895312,Staff,41,0,45,4
1745838904215,EDS 117,A01,895337,Staff,30,0,30,0
1745838905245,EDS 125,A00,895341,Jones; Gabrielle Anastasia,43,0,45,2
1745838906273,EDS 128A,A01,895459,Fargason; Sharon Gayle,44,0,45,1
1745838907302,EDS 128B,A01,895543,Pappas; Elizabeth,44,0,45,1
1745838908330,EDS 139,A00,897203,Pappas; Elizabeth,44,0,45,1
1745838908330,EDS 139,B00,897209,Fargason; Sharon Gayle,44,0,45,1
1745838909362,EDS 201,A00,895545,Staff,43,0,45,2
1745838910388,EDS 203,A01,895581,Halter; Christopher P.,43,0,45,2
1745838911420,EDS 204R,A01,895625,Heinzman; Erica M.,43,0,45,2
1745838911420,EDS 204R,B01,895693,Halter; Christopher P.,18,0,45,27
1745838912446,EDS 206R,A00,895694,Fargason; Sharon Gayle,9,0,30,21
1745838912446,EDS 206R,B00,895695,Choi; Bailey Miyeon,20,0,30,10
1745838913474,EDS 250,A00,895697,Hemans; Patricia Ann Benitez,43,0,45,2
1745838914504,EDS 281,A00,895701,Meyerott; Theresa Ann,15,0,15,0
1745838915531,EDS 284,A00,895736,Meyerott; Theresa Ann,15,0,15,0
1745838916561,EDS 286,A00,897210,Fine; Sarah,15,0,15,0
1745838917586,EDS 289C,A01,895770,Daly; Alan J.,15,0,15,0
1745838918620,EDS 290,A00,897211,Hofstetter; Carolyn,15,0,15,0
1745838919663,LIGM 5A,A00,896162,Fischer-Grunski; Eva K,15,0,20,5
1745838920696,LIGM 5B,A00,896260,Fischer-Grunski; Eva K,17,0,20,3
1745838921725,LIGM 5C,A00,896308,Fischer-Grunski; Eva K,18,0,20,2
1745838922757,LIIT 5AS,A00,896313,Carnelos; Chiara,17,0,20,3
1745838923784,LIIT 5BS,A00,896416,Carnelos; Chiara,20,0,20,0
1745838924810,LIIT 5CS,A00,896564,Carnelos; Chiara,20,0,20,0
1745838925842,LISP 5A,A00,896588,Munoz Sanchez; Alicia,4,0,20,16
1745838926875,LISP 5B,A00,896653,Munoz Sanchez; Alicia,10,0,20,10
1745838927905,LISP 5C,A00,896655,Munoz Sanchez; Alicia,4,0,20,16
1745838928931,MAE 197,001,957918,Kleissl; Jan,9998,0,9999,1
1745838929958,MATH 2,A01,957937,Staff,34,0,35,1
1745838930985,MATH 197,001,957876,Kedlaya; Kiran S.,9993,0,9999,6
1745838932015,MCWP 40,A00,892729,Duru; Nur,13,0,20,7
1745838932015,MCWP 40,B00,893304,Montejo; Carolina,20,0,20,0
1745838933097,MCWP 40R,A00,893757,Redela; Pamela Morgan,0,7,20,20
1745838934128,MCWP 50,A00,893758,Morshed; Michael James,2,0,20,18
1745838934128,MCWP 50,B00,893761,Bartulis; Jason Michael,18,0,20,2
1745838935163,MCWP 50R,A00,893766,Compas; Sean Matthew,0,1,20,20
1745838935163,MCWP 50R,B00,893769,Carter; Jennifer A,0,0,20,20
1745838935163,MCWP 50R,C00,893771,Krone; Jarret,0,3,20,20
1745838935163,MCWP 50R,D00,893772,Miller; Elizabeth Deen,3,0,20,17
1745838935163,MCWP 50R,E00,893775,Carter; Andrea L,0,0,20,20
1745838936191,MMW 11R,A01,892721,Herbst; Matthew,11,0,27,16
1745838936191,MMW 11R,A02,892722,Herbst; Matthew,0,0,0,3
1745838937219,MMW 12R,A01,892724,Herbst; Matthew,0,10,16,16
1745838937219,MMW 12R,A02,892725,Herbst; Matthew,0,9,16,16
1745838938246,MMW 13R,A01,892727,Staff,0,3,16,16
1745838938246,MMW 13R,A02,892728,Staff,0,4,16,16
1745838938246,MMW 13R,A03,958032,Staff,0,3,16,16
1745838938246,MMW 13R,A04,958033,Staff,0,2,16,16
1745838938246,MMW 13R,A05,958034,Staff,0,3,16,16
1745838939272,SIO 295LS,A00,894015,Staff,7,0,25,18
1745838940301,SIO 295S,A00,894020,Staff,7,0,25,18
1745838941344,SIOC 290S,B01,958918,Staff,0,0,0,0
1745838942384,SIOC 291S,B01,958922,Staff,0,0,0,0
1745838943420,SOCI 117,A01,895339,Staff,4,0,5,1
1745838944447,WES 237B,A00,894149,Staff,11,0,20,9
1745838946519,AESE 279B,A00,891859,Staff,13,0,35,22
1745838947546,AIP 197,001,891854,Staff,70,0,70,0
1745838948572,ANTH 289S,A00,891856,Gagneux; Pascal,12,0,12,0
1745838949598,BENG 196,001,957946,Engler; Adam J.,9996,0,9999,3
1745838950627,CAT 124RS,A01,956906,Staff,8,0,25,17
1745838951652,CAT 125RS,A01,922013,Staff,8,0,25,17
1745838952683,CLRE 250,A00,891860,Morris; Sheldon,9995,0,9999,4
1745838954737,CLRE 251R,A00,907817,Mehta; Ravindra L.,9994,0,9999,5
1745838955766,CLRE 252,A00,891864,Cuomo; Raphael Eduardo,9993,0,9999,6
1745838956793,CLRE 253,A00,891867,Vaida; Florin,9994,0,9999,5
1745838956793,CLRE 253,B00,907819,Staff,9999,0,9999,0
1745838957822,CLRE 259,A00,891868,Patel; Hemal,9998,0,9999,1
1745838958849,CLRE 260,A00,891872,Cuomo; Raphael Eduardo,9999,0,9999,0
1745838959878,CLRE 297,001,891888,Cuomo; Raphael Eduardo,9999,0,9999,0
1745838960905,CSE 191,A00,958773,Minnes Kemp; Mor Mia,9999,0,9999,0
1745838961934,CSS 201S,A01,892054,Mignozzetti; Umberto,30,0,30,0
1745838962967,CSS 202S,A01,892056,Mignozzetti; Umberto,30,0,30,0
1745838963997,DSC 197,001,956898,Eldridge; Justin Matthew,9998,0,9999,1
1745838965023,DSC 297,001,958000,Mazumdar; Arya,9998,0,9999,1
1745838966051,EAP 100,A00,905686,Staff,9776,0,9999,223
1745838967078,ECE 45,A01,892618,Staff,0,13,50,50
1745838968106,ECE 109,A01,892620,Staff,0,43,0,0
1745838969133,ECE 111,A01,892719,Staff,0,9,50,50
1745838970160,ECE 197,001,957920,Mercier; Patrick Philip,9992,0,9999,7
1745838971192,ECON 178,A01,907814,Zhu; Ying,28,0,35,7
1745838972222,EDS 115,A00,895312,Staff,41,0,45,4
1745838973251,EDS 117,A01,895337,Staff,30,0,30,0
1745838974280,EDS 125,A00,895341,Jones; Gabrielle Anastasia,43,0,45,2
1745838975308,EDS 128A,A01,895459,Fargason; Sharon Gayle,44,0,45,1
1745838976333,EDS 128B,A01,895543,Pappas; Elizabeth,44,0,45,1
1745838977363,EDS 139,A00,897203,Pappas; Elizabeth,44,0,45,1
1745838977363,EDS 139,B00,897209,Fargason; Sharon Gayle,44,0,45,1
1745838978391,EDS 201,A00,895545,Staff,43,0,45,2
1745838979419,EDS 203,A01,895581,Halter; Christopher P.,43,0,45,2
1745838980449,EDS 204R,A01,895625,Heinzman; Erica M.,43,0,45,2
1745838980449,EDS 204R,B01,895693,Halter; Christopher P.,18,0,45,27
1745838981478,EDS 206R,A00,895694,Fargason; Sharon Gayle,9,0,30,21
1745838981478,EDS 206R,B00,895695,Choi; Bailey Miyeon,20,0,30,10
1745838982502,EDS 250,A00,895697,Hemans; Patricia Ann Benitez,43,0,45,2
1745838983529,EDS 281,A00,895701,Meyerott; Theresa Ann,15,0,15,0
1745838984557,EDS 284,A00,895736,Meyerott; Theresa Ann,15,0,15,0
1745838985581,EDS 286,A00,897210,Fine; Sarah,15,0,15,0
1745838986612,EDS 289C,A01,895770,Daly; Alan J.,15,0,15,0
1745838987642,EDS 290,A00,897211,Hofstetter; Carolyn,15,0,15,0
1745838988667,LIGM 5A,A00,896162,Fischer-Grunski; Eva K,15,0,20,5
1745838989696,LIGM 5B,A00,896260,Fischer-Grunski; Eva K,17,0,20,3
1745838990723,LIGM 5C,A00,896308,Fischer-Grunski; Eva K,18,0,20,2
1745838991749,LIIT 5AS,A00,896313,Carnelos; Chiara,17,0,20,3
1745838992778,LIIT 5BS,A00,896416,Carnelos; Chiara,20,0,20,0
1745838993806,LIIT 5CS,A00,896564,Carnelos; Chiara,20,0,20,0
1745838994835,LISP 5A,A00,896588,Munoz Sanchez; Alicia,4,0,20,16
1745838995862,LISP 5B,A00,896653,Munoz Sanchez; Alicia,10,0,20,10
1745838996896,LISP 5C,A00,896655,Munoz Sanchez; Alicia,4,0,20,16
1745838997924,MAE 197,001,957918,Kleissl; Jan,9998,0,9999,1
1745838998952,MATH 2,A01,957937,Staff,34,0,35,1
1745838999985,MATH 197,001,957876,Kedlaya; Kiran S.,9993,0,9999,6
1745839001012,MCWP 40,A00,892729,Duru; Nur,13,0,20,7
1745839001012,MCWP 40,B00,893304,Montejo; Carolina,20,0,20,0
1745839002043,MCWP 40R,A00,893757,Redela; Pamela Morgan,0,7,20,20
1745839003073,MCWP 50,A00,893758,Morshed; Michael James,2,0,20,18
1745839003073,MCWP 50,B00,893761,Bartulis; Jason Michael,18,0,20,2
1745839004109,MCWP 50R,A00,893766,Compas; Sean Matthew,0,1,20,20
1745839004109,MCWP 50R,B00,893769,Carter; Jennifer A,0,0,20,20
1745839004109,MCWP 50R,C00,893771,Krone; Jarret,0,3,20,20
1745839004109,MCWP 50R,D00,893772,Miller; Elizabeth Deen,3,0,20,17
1745839004109,MCWP 50R,E00,893775,Carter; Andrea L,0,0,20,20
1745839005135,MMW 11R,A01,892721,Herbst; Matthew,11,0,27,16
1745839005135,MMW 11R,A02,892722,Herbst; Matthew,0,0,0,3
1745839006168,MMW 12R,A01,892724,Herbst; Matthew,0,10,16,16
1745839006168,MMW 12R,A02,892725,Herbst; Matthew,0,9,16,16
1745839007195,MMW 13R,A01,892727,Staff,0,3,16,16
1745839007195,MMW 13R,A02,892728,Staff,0,4,16,16
1745839007195,MMW 13R,A03,958032,Staff,0,3,16,16
1745839007195,MMW 13R,A04,958033,Staff,0,2,16,16
1745839007195,MMW 13R,A05,958034,Staff,0,3,16,16
1745839008243,SIO 295LS,A00,894015,Staff,7,0,25,18
1745839009274,SIO 295S,A00,894020,Staff,7,0,25,18
1745839010303,SIOC 290S,B01,958918,Staff,0,0,0,0
1745839011328,SIOC 291S,B01,958922,Staff,0,0,0,0
1745839012353,SOCI 117,A01,895339,Staff,4,0,5,1
1745839013379,WES 237B,A00,894149,Staff,11,0,20,9
1745839015456,AESE 279B,A00,891859,Staff,13,0,35,22
1745839016481,AIP 197,001,891854,Staff,70,0,70,0
1745839017506,ANTH 289S,A00,891856,Gagneux; Pascal,12,0,12,0
1745839018530,BENG 196,001,957946,Engler; Adam J.,9996,0,9999,3
1745839019556,CAT 124RS,A01,956906,Staff,8,0,25,17
1745839020585,CAT 125RS,A01,922013,Staff,8,0,25,17
1745839021609,CLRE 250,A00,891860,Morris; Sheldon,9995,0,9999,4
1745839023665,CLRE 251R,A00,907817,Mehta; Ravindra L.,9994,0,9999,5
1745839024693,CLRE 252,A00,891864,Cuomo; Raphael Eduardo,9993,0,9999,6
1745839025718,CLRE 253,A00,891867,Vaida; Florin,9994,0,9999,5
1745839025718,CLRE 253,B00,907819,Staff,9999,0,9999,0
1745839026749,CLRE 259,A00,891868,Patel; Hemal,9998,0,9999,1
1745839027779,CLRE 260,A00,891872,Cuomo; Raphael Eduardo,9999,0,9999,0
1745839028807,CLRE 297,001,891888,Cuomo; Raphael Eduardo,9999,0,9999,0
1745839029836,CSE 191,A00,958773,Minnes Kemp; Mor Mia,9999,0,9999,0
1745839030864,CSS 201S,A01,892054,Mignozzetti; Umberto,30,0,30,0
1745839031896,CSS 202S,A01,892056,Mignozzetti; Umberto,30,0,30,0
1745839032922,DSC 197,001,956898,Eldridge; Justin Matthew,9998,0,9999,1
1745839033949,DSC 297,001,958000,Mazumdar; Arya,9998,0,9999,1
1745839034975,EAP 100,A00,905686,Staff,9776,0,9999,223
1745839036001,ECE 45,A01,892618,Staff,0,13,50,50
1745839037026,ECE 109,A01,892620,Staff,0,43,0,0
1745839038052,ECE 111,A01,892719,Staff,0,9,50,50
1745839039077,ECE 197,001,957920,Mercier; Patrick Philip,9992,0,9999,7
1745839040106,ECON 178,A01,907814,Zhu; Ying,28,0,35,7
1745839041133,EDS 115,A00,895312,Staff,41,0,45,4
1745839042163,EDS 117,A01,895337,Staff,30,0,30,0
1745839043192,EDS 125,A00,895341,Jones; Gabrielle Anastasia,43,0,45,2
1745839044222,EDS 128A,A01,895459,Fargason; Sharon Gayle,44,0,45,1
1745839045247,EDS 128B,A01,895543,Pappas; Elizabeth,44,0,45,1
1745839046276,EDS 139,A00,897203,Pappas; Elizabeth,44,0,45,1
1745839046276,EDS 139,B00,897209,Fargason; Sharon Gayle,44,0,45,1
1745839047308,EDS 201,A00,895545,Staff,43,0,45,2
1745839048339,EDS 203,A01,895581,Halter; Christopher P.,43,0,45,2
1745839049368,EDS 204R,A01,895625,Heinzman; Erica M.,43,0,45,2
1745839049368,EDS 204R,B01,895693,Halter; Christopher P.,18,0,45,27
1745839050396,EDS 206R,A00,895694,Fargason; Sharon Gayle,9,0,30,21
1745839050396,EDS 206R,B00,895695,Choi; Bailey Miyeon,20,0,30,10
1745839051423,EDS 250,A00,895697,Hemans; Patricia Ann Benitez,43,0,45,2
1745839052451,EDS 281,A00,895701,Meyerott; Theresa Ann,15,0,15,0
1745839053477,EDS 284,A00,895736,Meyerott; Theresa Ann,15,0,15,0
1745839054504,EDS 286,A00,897210,Fine; Sarah,15,0,15,0
1745839055531,EDS 289C,A01,895770,Daly; Alan J.,15,0,15,0
1745839056561,EDS 290,A00,897211,Hofstetter; Carolyn,15,0,15,0
1745839057587,LIGM 5A,A00,896162,Fischer-Grunski; Eva K,15,0,20,5
1745839058616,LIGM 5B,A00,896260,Fischer-Grunski; Eva K,17,0,20,3
1745839059648,LIGM 5C,A00,896308,Fischer-Grunski; Eva K,18,0,20,2
1745839060674,LIIT 5AS,A00,896313,Carnelos; Chiara,17,0,20,3
1745839061700,LIIT 5BS,A00,896416,Carnelos; Chiara,20,0,20,0
1745839062732,LIIT 5CS,A00,896564,Carnelos; Chiara,20,0,20,0
1745839063762,LISP 5A,A00,896588,Munoz Sanchez; Alicia,4,0,20,16
1745839064788,LISP 5B,A00,896653,Munoz Sanchez; Alicia,10,0,20,10
1745839065818,LISP 5C,A00,896655,Munoz Sanchez; Alicia,4,0,20,16
1745839066847,MAE 197,001,957918,Kleissl; Jan,9998,0,9999,1
1745839067875,MATH 2,A01,957937,Staff,34,0,35,1
1745839068906,MATH 197,001,957876,Kedlaya; Kiran S.,9993,0,9999,6
1745839069937,MCWP 40,A00,892729,Duru; Nur,13,0,20,7
1745839069937,MCWP 40,B00,893304,Montejo; Carolina,20,0,20,0
1745839070969,MCWP 40R,A00,893757,Redela; Pamela Morgan,0,7,20,20
1745839071998,MCWP 50,A00,893758,Morshed; Michael James,2,0,20,18
1745839071998,MCWP 50,B00,893761,Bartulis; Jason Michael,18,0,20,2
1745839073029,MCWP 50R,A00,893766,Compas; Sean Matthew,0,1,20,20
1745839073029,MCWP 50R,B00,893769,Carter; Jennifer A,0,0,20,20
1745839073029,MCWP 50R,C00,893771,Krone; Jarret,0,3,20,20
1745839073029,MCWP 50R,D00,893772,Miller; Elizabeth Deen,3,0,20,17
1745839073029,MCWP 50R,E00,893775,Carter; Andrea L,0,0,20,20
1745839074054,MMW 11R,A01,892721,Herbst; Matthew,11,0,27,16
1745839074054,MMW 11R,A02,892722,Herbst; Matthew,0,0,0,3
1745839075083,MMW 12R,A01,892724,Herbst; Matthew,0,10,16,16
1745839075083,MMW 12R,A02,892725,Herbst; Matthew,0,9,16,16
1745839076108,MMW 13R,A01,892727,Staff,0,3,16,16
1745839076108,MMW 13R,A02,892728,Staff,0,4,16,16
1745839076108,MMW 13R,A03,958032,Staff,0,3,16,16
1745839076108,MMW 13R,A04,958033,Staff,0,2,16,16
1745839076108,MMW 13R,A05,958034,Staff,0,3,16,16
1745839077136,SIO 295LS,A00,894015,Staff,7,0,25,18
1745839078161,SIO 295S,A00,894020,Staff,7,0,25,18
1745839079189,SIOC 290S,B01,958918,Staff,0,0,0,0
1745839080216,SIOC 291S,B01,958922,Staff,0,0,0,0
1745839081243,SOCI 117,A01,895339,Staff,4,0,5,1
1745839082270,WES 237B,A00,894149,Staff,11,0,20,9
1745839084349,AESE 279B,A00,891859,Staff,13,0,35,22
1745839085379,AIP 197,001,891854,Staff,70,0,70,0
1745839086408,ANTH 289S,A00,891856,Gagneux; Pascal,12,0,12,0
1745839087438,BENG 196,001,957946,Engler; Adam J.,9996,0,9999,3
1745839088466,CAT 124RS,A01,956906,Staff,8,0,25,17
1745839089497,CAT 125RS,A01,922013,Staff,8,0,25,17
1745839090523,CLRE 250,A00,891860,Morris; Sheldon,9995,0,9999,4
1745839092581,CLRE 251R,A00,907817,Mehta; Ravindra L.,9994,0,9999,5
1745839093613,CLRE 252,A00,891864,Cuomo; Raphael Eduardo,9993,0,9999,6
1745839094639,CLRE 253,A00,891867,Vaida; Florin,9994,0,9999,5
1745839094639,CLRE 253,B00,907819,Staff,9999,0,9999,0
1745839095665,CLRE 259,A00,891868,Patel; Hemal,9998,0,9999,1
1745839096692,CLRE 260,A00,891872,Cuomo; Raphael Eduardo,9999,0,9999,0
1745839097720,CLRE 297,001,891888,Cuomo; Raphael Eduardo,9999,0,9999,0
1745839098747,CSE 191,A00,958773,Minnes Kemp; Mor Mia,9999,0,9999,0
